PooledFundId,PooledFundName,AllocationYear,ProjectCode,ReportApprovedDate,BeneficiaryName,TargetMen,TargetWomen,TargetBoys,TargetGirls,TargetTotal,ReachedMen,ReachedWomen,ReachedBoys,ReachedGirls,ReachedTotal
23,Afghanistan,2014,AFG-14/ER/CCS/UN/298,11/10/2015 9:11:59 AM,Overall,1250,1250,0,0,2500,1011,1010,0,0,2021
23,Afghanistan,2014,AFG-14/ER/H/INGO/291,8/18/2015 5:16:34 AM,Host Communities,2336,3292,1178,1036,7842,2384,3555,1264,1135,8338
23,Afghanistan,2014,AFG-14/ER/H/INGO/291,8/18/2015 5:16:34 AM,Internally Displaced People,1954,2420,898,734,6006,1901,2586,916,768,6171
23,Afghanistan,2014,AFG-14/ER/H/INGO/291,8/18/2015 5:16:34 AM,Overall,4290,5712,2076,1770,13848,4285,6141,2180,1903,14509
23,Afghanistan,2014,AFG-14/ER/H/INGO/292,8/11/2015 9:07:27 AM,Host Communities,3794,3794,871,871,9330,2307,3281,1073,994,7655
23,Afghanistan,2014,AFG-14/ER/H/INGO/292,8/11/2015 9:07:27 AM,Overall,3794,3794,871,871,9330,2307,3281,1073,994,7655
23,Afghanistan,2014,AFG-14/ER/H/NGO/289,8/15/2015 10:38:39 AM,Other,27,3,0,0,30,26,4,0,0,30
23,Afghanistan,2014,AFG-14/ER/H/NGO/289,8/15/2015 10:38:39 AM,Overall,3144,3096,3438,3290,12968,4099,4324,4125,4010,16558
23,Afghanistan,2014,AFG-14/ER/H/UN/288,7/12/2016 6:27:55 AM,Host Communities,84042,87479,21007,21868,214396,76146,79254,19036,19814,194250
23,Afghanistan,2014,AFG-14/ER/H/UN/288,7/12/2016 6:27:55 AM,Overall,12006,12497,3001,3124,30628,10878,11322,2719,2831,27750
23,Afghanistan,2014,AFG-14/ER/MS/INGO/301,8/10/2015 11:06:27 AM,Host Communities,941,941,1673,1673,5228,5308,5308,18874,18874,48364
23,Afghanistan,2014,AFG-14/ER/MS/INGO/301,8/10/2015 11:06:27 AM,Overall,7016,7016,12473,12473,38978,11383,11383,29674,29674,82114
23,Afghanistan,2014,AFG-14/ER/MS/INGO/301,8/10/2015 11:06:27 AM,Refugees,6075,6075,10800,10800,33750,6075,6075,10800,10800,33750
23,Afghanistan,2014,AFG-14/ER/MS/INGO/303,6/27/2015 9:20:08 AM,Host Communities,290,322,334,334,1280,120,119,215,234,688
23,Afghanistan,2014,AFG-14/ER/MS/INGO/303,6/27/2015 9:20:08 AM,Overall,2901,3215,3342,3342,12800,2178,2278,4112,4133,12701
23,Afghanistan,2014,AFG-14/ER/MS/INGO/303,6/27/2015 9:20:08 AM,Refugees,2611,2893,3008,3008,11520,2058,2159,3897,3899,12013
23,Afghanistan,2014,AFG-14/ER/MS/UN/305,6/24/2015 10:12:15 AM,Overall,18900,18900,28350,28350,94500,32784,32784,49176,49176,163920
23,Afghanistan,2014,AFG-14/ER/MS/UN/305,6/24/2015 10:12:15 AM,Refugees,18900,18900,28350,28350,94500,32784,32784,49176,49176,163920
23,Afghanistan,2014,AFG-14/ER/MS/UN/306,12/8/2015 9:37:32 AM,Overall,7000,7000,28000,28000,70000,37754,36272,52137,50090,176253
23,Afghanistan,2014,AFG-14/ER/MS/UN/306,12/8/2015 9:37:32 AM,Refugees,7000,7000,28000,28000,70000,37754,36272,52137,50090,176253
23,Afghanistan,2014,AFG-14/ER/MS/UN/308,10/18/2015 11:07:14 AM,Other,1130,959,1496,1275,4860,1021,1094,2045,1695,5855
23,Afghanistan,2014,AFG-14/ER/MS/UN/308,10/18/2015 11:07:14 AM,Overall,1130,959,1496,1275,4860,1021,1094,2045,1695,5855
23,Afghanistan,2014,AFG-14/ER/NFI/INGO/294,8/6/2015 7:01:16 AM,Overall,377,468,404,527,1776,306,380,328,429,1443
23,Afghanistan,2014,AFG-14/ER/NFI/INGO/296,7/28/2015 9:01:33 AM,Overall,5307,5307,3538,3538,17690,5307,5307,3538,3538,17690
23,Afghanistan,2014,AFG-14/S1/CCS/UN/213,4/16/2015 2:18:15 PM,Other,75,0,0,0,75,75,0,0,0,75
23,Afghanistan,2014,AFG-14/S1/CCS/UN/213,4/16/2015 2:18:15 PM,Overall,75,0,0,0,75,75,0,0,0,75
23,Afghanistan,2014,AFG-14/S1/H/INGO/225,10/4/2015 6:58:56 AM,Other,138,11,3730,2070,5949,138,11,4442,2392,6983
23,Afghanistan,2014,AFG-14/S1/H/INGO/225,10/4/2015 6:58:56 AM,Overall,21618,3081,10660,4790,40149,21484,3210,18201,5310,48205
23,Afghanistan,2014,AFG-14/S1/H/INGO/235,10/29/2015 10:24:50 AM,Other,535,1730,2005,2005,6275,535,126,1780,987,3428
23,Afghanistan,2014,AFG-14/S1/H/INGO/235,10/29/2015 10:24:50 AM,Overall,8555,8146,2005,2005,20711,9789,6765,1780,987,19321
23,Afghanistan,2014,AFG-14/S1/H/INGO/243,9/9/2015 5:38:44 AM,Other,80,40,553,594,1267,267,65,3538,3067,6937
23,Afghanistan,2014,AFG-14/S1/H/INGO/243,9/9/2015 5:38:44 AM,Overall,9693,1770,553,594,12610,35397,8667,3538,3067,50669
23,Afghanistan,2014,AFG-14/S1/H/INGO/250,9/14/2015 9:48:44 AM,Other,7377,11251,14176,13621,46425,14473,30174,17370,36880,98897
23,Afghanistan,2014,AFG-14/S1/H/INGO/250,9/14/2015 9:48:44 AM,Overall,17825,17125,17541,16853,69344,14473,30174,17370,36880,98897
23,Afghanistan,2014,AFG-14/S1/H/NGO/254,9/21/2015 11:55:56 AM,Other,293,253,0,0,546,356,236,0,0,592
23,Afghanistan,2014,AFG-14/S1/H/NGO/254,9/21/2015 11:55:56 AM,Overall,12265,6285,998,998,20546,6011,2600,3009,2249,13869
23,Afghanistan,2014,AFG-14/S1/H/UN/236,12/20/2015 12:21:52 PM,Internally Displaced People,17827,17127,4456,4281,43691,17849,18499,4577,4792,45717
23,Afghanistan,2014,AFG-14/S1/H/UN/236,12/20/2015 12:21:52 PM,Other,1000,200,40058,41694,82952,660,140,41256,42941,84997
23,Afghanistan,2014,AFG-14/S1/H/UN/236,12/20/2015 12:21:52 PM,Overall,160759,166477,41450,43141,411827,164343,170195,42359,44086,420983
23,Afghanistan,2014,AFG-14/S1/H/UN/252,11/2/2015 6:25:26 AM,Other,80,260178,0,0,260258,78,240070,0,0,240148
23,Afghanistan,2014,AFG-14/S1/H/UN/252,11/2/2015 6:25:26 AM,Overall,80,260178,0,0,260258,78,240070,0,0,240148
23,Afghanistan,2014,AFG-14/S1/N/INGO/231,2/29/2016 4:48:57 AM,Other,181,130,0,0,311,232,88,0,0,320
23,Afghanistan,2014,AFG-14/S1/N/INGO/231,2/29/2016 4:48:57 AM,Overall,181,130,0,0,311,232,88,0,0,320
23,Afghanistan,2014,AFG-14/S1/N/INGO/234,9/9/2015 5:15:41 AM,Other,210,36042,12560,12561,61373,639,46227,53232,52397,152495
23,Afghanistan,2014,AFG-14/S1/N/INGO/234,9/9/2015 5:15:41 AM,Overall,210,36042,12560,12561,61373,639,46227,53232,52397,152495
23,Afghanistan,2014,AFG-14/S1/N/INGO/238,10/18/2015 9:30:13 AM,Other,428,1404,2014,2014,5860,431,2125,1881,1887,6324
23,Afghanistan,2014,AFG-14/S1/N/INGO/238,10/18/2015 9:30:13 AM,Overall,428,1401,2014,2014,5857,431,2125,1881,1887,6324
23,Afghanistan,2014,AFG-14/S1/N/INGO/240,9/13/2015 5:14:50 AM,Other,342,9918,13193,13193,36646,336,20436,12623,17257,50652
23,Afghanistan,2014,AFG-14/S1/N/INGO/240,9/13/2015 5:14:50 AM,Overall,342,9918,13193,13193,36646,336,20436,12623,17257,50652
23,Afghanistan,2014,AFG-14/S1/N/INGO/247,9/21/2015 3:31:46 AM,Other,20,11987,4674,4674,21355,26,16055,1346,1758,19185
23,Afghanistan,2014,AFG-14/S1/N/INGO/247,9/21/2015 3:31:46 AM,Overall,20,6400,4674,4674,15768,26,16055,1346,1758,19185
23,Afghanistan,2014,AFG-14/S1/N/INGO/251,11/4/2015 5:54:09 AM,Other,412,700,704,639,2455,442,3780,1068,1060,6350
23,Afghanistan,2014,AFG-14/S1/N/INGO/251,11/4/2015 5:54:09 AM,Overall,412,700,704,639,2455,442,279,1120,1108,2949
23,Afghanistan,2014,AFG-14/S1/N/NGO/248,6/12/2016 6:51:27 AM,Host Communities,344,4063,6799,6799,18005,0,0,0,0,0
23,Afghanistan,2014,AFG-14/S1/N/NGO/248,6/12/2016 6:51:27 AM,Other,344,4063,6799,6799,18005,344,5230,9626,10869,26069
23,Afghanistan,2014,AFG-14/S1/N/NGO/248,6/12/2016 6:51:27 AM,Overall,344,4063,6799,6799,18005,344,5230,9626,10869,26069
23,Afghanistan,2014,AFG-14/S1/N/UN/223,11/10/2015 8:40:08 AM,Other,380,80300,71352,68554,220586,2027,117514,37335,35871,192747
23,Afghanistan,2014,AFG-14/S1/N/UN/223,11/10/2015 8:40:08 AM,Overall,380,80300,71352,68554,220586,2027,117506,37335,35871,192739
23,Afghanistan,2014,AFG-14/SA2/CCS/UN/269,3/31/2015 6:29:59 AM,Overall,2500,2500,0,0,5000,2456,2456,0,0,4912
23,Afghanistan,2014,AFG-14/SA2/N/INGO/264,6/20/2016 4:47:37 AM,Other,102,8676,4974,5387,19139,10369,12011,11104,12198,45682
23,Afghanistan,2014,AFG-14/SA2/N/INGO/264,6/20/2016 4:47:37 AM,Overall,102,8676,4974,5387,19139,10369,12011,9810,10545,42735
23,Afghanistan,2014,AFG-14/SA2/N/INGO/275,3/10/2016 6:31:34 AM,Host Communities,239577,240391,47521,47520,575009,245621,245621,49764,49764,590770
23,Afghanistan,2014,AFG-14/SA2/N/INGO/275,3/10/2016 6:31:34 AM,Other,634,354,0,0,988,634,354,0,0,988
23,Afghanistan,2014,AFG-14/SA2/N/INGO/275,3/10/2016 6:31:34 AM,Overall,97699,97559,22843,22843,240944,129252,131559,25612,25612,312035
23,Afghanistan,2014,AFG-14/SA2/N/INGO/275,3/10/2016 6:31:34 AM,Refugees,20910,22160,4541,4542,52153,20543,22191,4094,4123,50951
23,Afghanistan,2014,AFG-14/SA2/N/NGO/284,6/19/2016 9:25:54 AM,Other,527,438,0,0,965,513,501,0,0,1014
23,Afghanistan,2014,AFG-14/SA2/N/NGO/284,6/19/2016 9:25:54 AM,Overall,527,3238,14626,16905,35296,513,3431,15166,16365,35475
23,Afghanistan,2014,AFG-14/SA2/N/UN/272,10/18/2016 1:12:21 PM,Overall,0,0,50380,48405,98785,0,0,53932,51817,105749
23,Afghanistan,2014,AFG-14/SA2/N/UN/287,7/4/2016 7:55:45 AM,Host Communities,86,4624,8143,7823,20676,105,4121,7174,7145,18545
23,Afghanistan,2014,AFG-14/SA2/N/UN/287,7/4/2016 7:55:45 AM,Internally Displaced People,0,41,69,66,176,0,34,53,49,136
23,Afghanistan,2014,AFG-14/SA2/N/UN/287,7/4/2016 7:55:45 AM,Overall,86,4856,8538,8202,21682,105,4334,7522,7445,19406
23,Afghanistan,2014,AFG-14/SA2/N/UN/287,7/4/2016 7:55:45 AM,Refugees,0,192,326,312,830,0,179,295,251,725
23,Afghanistan,2015,AFG-15/3481/AFG/CCS/UN/454,5/25/2016 11:03:11 AM,Overall,1000,1000,0,0,2000,4149,4149,0,0,8298
23,Afghanistan,2015,AFG-15/3481/AFG/ESNFI/INGO/458,5/29/2016 5:11:57 AM,Host Communities,2047,1984,1497,1436,6964,990,1080,1313,1436,4819
23,Afghanistan,2015,AFG-15/3481/AFG/ESNFI/INGO/458,5/29/2016 5:11:57 AM,Overall,2047,1984,1497,1436,6964,990,1080,1313,1324,4707
23,Afghanistan,2015,AFG-15/3481/AFG/ESNFI/INGO/459,6/27/2016 6:02:24 AM,Internally Displaced People,3191,3483,4034,4267,14975,3191,3483,4034,4267,14975
23,Afghanistan,2015,AFG-15/3481/AFG/ESNFI/INGO/459,6/27/2016 6:02:24 AM,Overall,3191,3483,4034,4267,14975,3191,3483,4034,4267,14975
23,Afghanistan,2015,AFG-15/3481/AFG/ESNFI/INGO/461,5/17/2016 7:08:45 AM,Host Communities,1147,1226,1864,2006,6243,1406,1495,3606,3371,9878
23,Afghanistan,2015,AFG-15/3481/AFG/ESNFI/INGO/461,5/17/2016 7:08:45 AM,Internally Displaced People,486,520,789,852,2647,0,0,0,0,0
23,Afghanistan,2015,AFG-15/3481/AFG/ESNFI/INGO/461,5/17/2016 7:08:45 AM,Overall,1633,1746,2653,2858,8890,1406,1495,3606,3371,9878
23,Afghanistan,2015,AFG-15/3481/AFG/ESNFI/INGO/464,6/1/2016 10:41:06 AM,Internally Displaced People,4417,3914,1004,703,10038,1402,1600,2009,1653,6664
23,Afghanistan,2015,AFG-15/3481/AFG/ESNFI/INGO/464,6/1/2016 10:41:06 AM,Overall,4417,3914,1004,703,10038,1402,1600,2009,1653,6664
23,Afghanistan,2015,AFG-15/3481/AFG/ESNFI/INGO/465,8/3/2016 2:49:22 AM,Internally Displaced People,1231,1231,1846,1845,6153,1123,1983,2011,1194,6311
23,Afghanistan,2015,AFG-15/3481/AFG/ESNFI/INGO/465,8/3/2016 2:49:22 AM,Overall,1231,1231,1846,1846,6154,1123,1983,2011,1194,6311
23,Afghanistan,2015,AFG-15/3481/AFG/ESNFI/INGO/469,6/9/2016 9:30:20 AM,Internally Displaced People,381,382,465,466,1694,196,204,240,249,889
23,Afghanistan,2015,AFG-15/3481/AFG/ESNFI/INGO/469,6/9/2016 9:30:20 AM,Overall,494,495,604,605,2198,387,404,474,492,1757
23,Afghanistan,2015,AFG-15/3481/AFG/ESNFI/INGO/471,6/2/2016 11:55:15 AM,Internally Displaced People,1641,1641,2461,2461,8204,1995,2137,4630,3830,12592
23,Afghanistan,2015,AFG-15/3481/AFG/ESNFI/INGO/471,6/2/2016 11:55:15 AM,Overall,1641,1641,2461,2461,8204,1995,2137,4630,3830,12592
23,Afghanistan,2015,AFG-15/3481/AFG-15/3481/RA3//ESNFI/INGO/477,8/15/2016 4:34:38 AM,Host Communities,1120,1120,286,274,2800,548,519,1409,1206,3682
23,Afghanistan,2015,AFG-15/3481/AFG-15/3481/RA3//ESNFI/INGO/477,8/15/2016 4:34:38 AM,Internally Displaced People,1400,1400,357,343,3500,622,663,1447,1101,3833
23,Afghanistan,2015,AFG-15/3481/AFG-15/3481/RA3//ESNFI/INGO/477,8/15/2016 4:34:38 AM,Overall,2520,2520,643,617,6300,1170,1182,2856,2307,7515
23,Afghanistan,2015,AFG-15/3481/SA2/APC/INGO/441,2/13/2017 6:16:25 AM,Host Communities,600,700,400,400,2100,830,848,850,661,3189
23,Afghanistan,2015,AFG-15/3481/SA2/APC/INGO/441,2/13/2017 6:16:25 AM,Internally Displaced People,600,1000,850,850,3300,2076,2180,1719,1570,7545
23,Afghanistan,2015,AFG-15/3481/SA2/APC/INGO/441,2/13/2017 6:16:25 AM,Overall,1200,1700,1250,1250,5400,2906,3028,2767,2411,11112
23,Afghanistan,2015,AFG-15/3481/SA2/APC/INGO/451,2/21/2017 10:58:41 AM,Host Communities,47,39,299,303,688,83,144,165,148,540
23,Afghanistan,2015,AFG-15/3481/SA2/APC/INGO/451,2/21/2017 10:58:41 AM,Internally Displaced People,186,154,1195,1210,2745,163,156,1415,1364,3098
23,Afghanistan,2015,AFG-15/3481/SA2/APC/INGO/451,2/21/2017 10:58:41 AM,Overall,233,193,1494,1513,3433,246,300,1580,1512,3638
23,Afghanistan,2015,AFG-15/3481/SA2/APC/NGO/404,3/1/2017 5:28:41 AM,Host Communities,2397,2538,4511,4652,14098,5107,3517,7672,5640,21936
23,Afghanistan,2015,AFG-15/3481/SA2/APC/NGO/404,3/1/2017 5:28:41 AM,Internally Displaced People,32392,34297,60973,62878,190540,32402,34303,60967,62877,190549
23,Afghanistan,2015,AFG-15/3481/SA2/APC/NGO/404,3/1/2017 5:28:41 AM,Other,602,638,1134,1170,3544,3292,5583,4167,3998,17040
23,Afghanistan,2015,AFG-15/3481/SA2/APC/NGO/404,3/1/2017 5:28:41 AM,Overall,23460,24840,44160,45540,138000,23667,26892,57188,40796,148543
23,Afghanistan,2015,AFG-15/3481/SA2/APC/NGO/404,3/1/2017 5:28:41 AM,Refugees,5443,5763,10246,10566,32018,5437,5755,10252,10574,32018
23,Afghanistan,2015,AFG-15/3481/SA2/APC-H/INGO/422,2/16/2017 4:41:05 AM,Internally Displaced People,14889,14742,3753,4014,37398,5321,15381,5434,5062,31198
23,Afghanistan,2015,AFG-15/3481/SA2/APC-H/INGO/422,2/16/2017 4:41:05 AM,Other,11,7,0,0,18,10,8,0,0,18
23,Afghanistan,2015,AFG-15/3481/SA2/APC-H/INGO/422,2/16/2017 4:41:05 AM,Overall,14900,14749,3753,4014,37416,5331,15389,5434,5062,31216
23,Afghanistan,2015,AFG-15/3481/SA2/ESNFI/INGO/399,7/5/2016 7:10:37 AM,Internally Displaced People,2298,2490,3750,4062,12600,1739,2221,2353,3249,9562
23,Afghanistan,2015,AFG-15/3481/SA2/ESNFI/INGO/399,7/5/2016 7:10:37 AM,Overall,2298,2490,3750,4062,12600,1739,2221,2353,3249,9562
23,Afghanistan,2015,AFG-15/3481/SA2/ESNFI/INGO/432,8/9/2016 9:00:25 AM,Internally Displaced People,2660,2660,3990,3990,13300,366,486,733,757,2342
23,Afghanistan,2015,AFG-15/3481/SA2/ESNFI/INGO/432,8/9/2016 9:00:25 AM,Overall,2699,2699,4049,4049,13496,366,486,733,757,2342
23,Afghanistan,2015,AFG-15/3481/SA2/ESNFI/INGO/434,8/2/2016 9:55:00 AM,Internally Displaced People,3150,3150,3850,3850,14000,2863,2980,3500,3642,12985
23,Afghanistan,2015,AFG-15/3481/SA2/ESNFI/INGO/434,8/2/2016 9:55:00 AM,Overall,3150,3150,3850,3850,14000,2863,2980,3500,3642,12985
23,Afghanistan,2015,AFG-15/3481/SA2/FSAC/INGO/406,6/12/2016 3:55:22 AM,Host Communities,844,812,1119,1075,3850,581,622,1239,1196,3638
23,Afghanistan,2015,AFG-15/3481/SA2/FSAC/INGO/406,6/12/2016 3:55:22 AM,Internally Displaced People,2534,2434,3357,3225,11550,1743,1867,3717,3586,10913
23,Afghanistan,2015,AFG-15/3481/SA2/FSAC/INGO/406,6/12/2016 3:55:22 AM,Overall,3378,3245,4476,4301,15400,2324,2489,4956,4782,14551
23,Afghanistan,2015,AFG-15/3481/SA2/FSAC/INGO/440,8/1/2016 6:10:08 AM,Internally Displaced People,5985,5985,7315,7315,26600,5799,6036,7087,7377,26299
23,Afghanistan,2015,AFG-15/3481/SA2/FSAC/INGO/440,8/1/2016 6:10:08 AM,Overall,5985,5985,7315,7315,26600,5799,6036,7087,7377,26299
23,Afghanistan,2015,AFG-15/3481/SA2/H/INGO/387,1/30/2017 4:49:36 AM,Host Communities,10452,10452,1759,1759,24422,9171,6807,4288,4002,24268
23,Afghanistan,2015,AFG-15/3481/SA2/H/INGO/387,1/30/2017 4:49:36 AM,Other,30,12,0,0,42,39,0,0,0,39
23,Afghanistan,2015,AFG-15/3481/SA2/H/INGO/387,1/30/2017 4:49:36 AM,Overall,10482,10464,1759,1759,24464,9210,6807,4288,4002,24307
23,Afghanistan,2015,AFG-15/3481/SA2/H/INGO/402,8/26/2018 11:04:36 AM,Host Communities,13154,10762,3288,2690,29894,2545,439,199,91,3274
23,Afghanistan,2015,AFG-15/3481/SA2/H/INGO/402,8/26/2018 11:04:36 AM,Other,12,6,0,0,18,18,1,0,0,19
23,Afghanistan,2015,AFG-15/3481/SA2/H/INGO/402,8/26/2018 11:04:36 AM,Overall,13166,10768,3288,2690,29912,2563,440,199,91,3293
23,Afghanistan,2015,AFG-15/3481/SA2/H/NGO/398,2/27/2017 10:41:52 AM,Host Communities,1286,1238,220,220,2964,249,401,142,135,927
23,Afghanistan,2015,AFG-15/3481/SA2/H/NGO/398,2/27/2017 10:41:52 AM,Internally Displaced People,138,152,53,56,399,2705,1445,520,417,5087
23,Afghanistan,2015,AFG-15/3481/SA2/H/NGO/398,2/27/2017 10:41:52 AM,Overall,1425,1390,273,276,3364,2954,1846,662,552,6014
23,Afghanistan,2015,AFG-15/3481/SA2/H/NGO/411,4/5/2017 4:31:38 AM,Internally Displaced People,674,701,551,574,2500,603,693,561,784,2641
23,Afghanistan,2015,AFG-15/3481/SA2/H/NGO/411,4/5/2017 4:31:38 AM,Other,12047,12538,9856,10259,44700,10287,21614,10520,12850,55271
23,Afghanistan,2015,AFG-15/3481/SA2/H/NGO/411,4/5/2017 4:31:38 AM,Overall,12721,13239,10407,10833,47200,10530,21699,12575,10360,55164
23,Afghanistan,2015,AFG-15/3481/SA2/MS/INGO/410,2/1/2017 9:50:54 AM,Host Communities,3018,3142,755,785,7700,890,1317,1644,1715,5566
23,Afghanistan,2015,AFG-15/3481/SA2/MS/INGO/410,2/1/2017 9:50:54 AM,Internally Displaced People,796,828,199,207,2030,410,597,800,835,2642
23,Afghanistan,2015,AFG-15/3481/SA2/MS/INGO/410,2/1/2017 9:50:54 AM,Other,40,0,0,0,40,50,0,0,0,50
23,Afghanistan,2015,AFG-15/3481/SA2/MS/INGO/410,2/1/2017 9:50:54 AM,Overall,9476,9821,2358,2455,24110,5563,6511,6171,5986,24231
23,Afghanistan,2015,AFG-15/3481/SA2/MS/INGO/410,2/1/2017 9:50:54 AM,Refugees,3018,3142,755,785,7700,1588,1901,2613,2717,8819
23,Afghanistan,2015,AFG-15/3481/SA2/MS/INGO/444,6/15/2017 4:21:20 AM,Host Communities,200,95,4000,6800,11095,0,0,0,0,0
23,Afghanistan,2015,AFG-15/3481/SA2/MS/INGO/444,6/15/2017 4:21:20 AM,Overall,11375,11744,26669,28923,78711,10331,10667,24222,26274,71494
23,Afghanistan,2015,AFG-15/3481/SA2/MS/INGO/444,6/15/2017 4:21:20 AM,Refugees,11175,11649,22669,22123,67616,10331,10667,24222,26274,71494
23,Afghanistan,2015,AFG-15/3481/SA2/MS/UN/450,5/8/2016 10:38:04 AM,Other,1338,585,1715,544,4182,2183,506,2080,411,5180
23,Afghanistan,2015,AFG-15/3481/SA2/MS/UN/450,5/8/2016 10:38:04 AM,Overall,1338,585,1715,544,4182,2183,506,2080,411,5180
23,Afghanistan,2015,AFG-15/3481/SA2/N/UN/400,2/19/2017 7:29:43 AM,Overall,0,0,7543,7247,14790,0,0,7746,7442,15188
23,Afghanistan,2015,AFG-15/3481/SA2/N/UN/431,5/9/2017 4:52:32 AM,Overall,0,0,19421,18638,38059,0,0,19400,18639,38039
23,Afghanistan,2015,AFG-15/3481/SA2/WASH/INGO/405,1/23/2017 10:44:12 AM,Internally Displaced People,6993,9303,3045,3934,23275,4935,5476,6158,6725,23294
23,Afghanistan,2015,AFG-15/3481/SA2/WASH/INGO/405,1/23/2017 10:44:12 AM,Overall,6993,9303,3045,3934,23275,4935,5476,6158,6725,23294
23,Afghanistan,2015,AFG-15/3481/SA2/WASH/INGO/425,1/31/2017 5:53:28 AM,Internally Displaced People,1900,2000,1400,1700,7000,983,1059,2258,2433,6733
23,Afghanistan,2015,AFG-15/3481/SA2/WASH/INGO/425,1/31/2017 5:53:28 AM,Overall,1900,2000,1400,1700,7000,983,1059,2258,2433,6733
23,Afghanistan,2015,AFG-15/3481/SA2/WASH-FSAC/INGO/401,5/29/2016 10:35:47 AM,Internally Displaced People,3423,3699,3959,4292,15373,3217,3224,843,918,8202
23,Afghanistan,2015,AFG-15/3481/SA2/WASH-FSAC/INGO/401,5/29/2016 10:35:47 AM,Overall,3423,3699,3959,4292,15373,3217,3224,843,918,8202
23,Afghanistan,2015,AFG-15/O580/SA1/H/INGO/325,8/3/2016 6:21:35 AM,Other,166097,159583,39896,41524,407100,157932,114172,27018,1482,300604
23,Afghanistan,2015,AFG-15/O580/SA1/H/INGO/325,8/3/2016 6:21:35 AM,Overall,4204,4376,1051,1094,10725,4376,2485,2056,1482,10399
23,Afghanistan,2015,AFG-15/O580/SA1/H/INGO/325,8/3/2016 6:21:35 AM,Refugees,17362,18070,4340,4517,44289,14622,3786,13900,11550,43858
23,Afghanistan,2015,AFG-15/O580/SA1/H/INGO/328,8/15/2016 10:02:43 AM,Other,117,33,0,0,150,123,34,0,0,157
23,Afghanistan,2015,AFG-15/O580/SA1/H/INGO/328,8/15/2016 10:02:43 AM,Overall,16104,3846,13928,4672,38550,17684,3940,15744,4460,41828
23,Afghanistan,2015,AFG-15/O580/SA1/H/INGO/338,8/3/2016 6:30:16 AM,Host Communities,37702,37702,9425,9425,94254,19491,45825,17561,17765,100642
23,Afghanistan,2015,AFG-15/O580/SA1/H/INGO/338,8/3/2016 6:30:16 AM,Overall,37702,37702,9425,9425,94254,19491,45825,17561,17765,100642
23,Afghanistan,2015,AFG-15/O580/SA1/H/INGO/340,9/25/2016 5:01:20 AM,Host Communities,25391,6606,1968,1053,35018,27024,4922,3066,2206,37218
23,Afghanistan,2015,AFG-15/O580/SA1/H/INGO/340,9/25/2016 5:01:20 AM,Overall,25391,27816,12573,11658,77438,51858,34158,21219,19661,126896
23,Afghanistan,2015,AFG-15/O580/SA1/H/INGO/340,9/25/2016 5:01:20 AM,Refugees,0,21210,10605,10605,42420,24834,29236,18153,17455,89678
23,Afghanistan,2015,AFG-15/O580/SA1/H/INGO/342,9/1/2016 10:05:14 AM,Internally Displaced People,2352,2449,588,612,6001,3527,5598,1590,1557,12272
23,Afghanistan,2015,AFG-15/O580/SA1/H/INGO/342,9/1/2016 10:05:14 AM,Overall,64309,43996,10990,11101,130396,42762,44283,15322,15075,117442
23,Afghanistan,2015,AFG-15/O580/SA1/H/INGO/350,11/9/2016 5:25:41 AM,Host Communities,12219,11613,3055,2903,29790,30312,31468,16268,14165,92213
23,Afghanistan,2015,AFG-15/O580/SA1/H/INGO/350,11/9/2016 5:25:41 AM,Other,12,4,0,0,16,13,2,0,0,15
23,Afghanistan,2015,AFG-15/O580/SA1/H/INGO/350,11/9/2016 5:25:41 AM,Overall,12227,11617,3055,2903,29802,30325,31500,16268,14165,92258
23,Afghanistan,2015,AFG-15/O580/SA1/H/NGO/320,9/15/2016 5:29:05 AM,Other,84,26,0,0,110,156,0,0,0,156
23,Afghanistan,2015,AFG-15/O580/SA1/H/NGO/320,9/15/2016 5:29:05 AM,Overall,5681,2952,2099,2098,12830,10755,2690,3362,1865,18672
23,Afghanistan,2015,AFG-15/O580/SA1/H/UN/332,2/6/2017 10:10:49 AM,Internally Displaced People,11914,12400,2979,3100,30393,31042,32634,7163,8755,79594
23,Afghanistan,2015,AFG-15/O580/SA1/H/UN/332,2/6/2017 10:10:49 AM,Other,334668,347934,83567,86933,853102,343521,360458,79110,96690,879779
23,Afghanistan,2015,AFG-15/O580/SA1/H/UN/332,2/6/2017 10:10:49 AM,Overall,346649,360267,86546,90033,883495,374156,393343,86343,105531,959373
23,Afghanistan,2015,AFG-15/O580/SA1/MS/INGO/322,1/5/2016 7:34:51 AM,Host Communities,3748,3748,6662,6662,20820,4735,4735,8416,8416,26302
23,Afghanistan,2015,AFG-15/O580/SA1/MS/INGO/322,1/5/2016 7:34:51 AM,Overall,15223,15223,27062,27062,84570,16210,16210,28816,28816,90052
23,Afghanistan,2015,AFG-15/O580/SA1/MS/INGO/322,1/5/2016 7:34:51 AM,Refugees,11475,11475,20400,20400,63750,11475,11475,20400,20400,63750
23,Afghanistan,2015,AFG-15/O580/SA1/MS/INGO/323,6/8/2016 5:48:22 AM,Overall,8492,8751,19118,18639,55000,10967,11300,24689,24071,71027
23,Afghanistan,2015,AFG-15/O580/SA1/MS/INGO/323,6/8/2016 5:48:22 AM,Refugees,8492,8751,19118,18639,55000,10967,11300,24689,24071,71027
23,Afghanistan,2015,AFG-15/O580/SA1/MS/INGO/359,8/3/2016 8:42:15 AM,Host Communities,167,163,294,295,919,128,188,306,377,999
23,Afghanistan,2015,AFG-15/O580/SA1/MS/INGO/359,8/3/2016 8:42:15 AM,Overall,1656,1627,2944,2952,9179,1638,1738,2913,2888,9177
23,Afghanistan,2015,AFG-15/O580/SA1/MS/INGO/359,8/3/2016 8:42:15 AM,Refugees,1489,1464,2650,2657,8260,1510,1550,2607,2511,8178
23,Afghanistan,2015,AFG-15/O580/SA1/MS/INGO/363,7/13/2016 10:22:33 AM,Host Communities,81,88,5077,5090,10336,40,39,59,56,194
23,Afghanistan,2015,AFG-15/O580/SA1/MS/INGO/363,7/13/2016 10:22:33 AM,Other,87,81,77,90,335,529,477,2582,1732,5320
23,Afghanistan,2015,AFG-15/O580/SA1/MS/INGO/363,7/13/2016 10:22:33 AM,Overall,897,880,7704,6918,16399,602,547,8189,6335,15673
23,Afghanistan,2015,AFG-15/O580/SA1/MS/INGO/363,7/13/2016 10:22:33 AM,Refugees,729,711,2550,1738,5728,33,31,5548,4547,10159
23,Afghanistan,2015,AFG-15/O580/SA1/MS/UN/367,2/29/2016 6:18:55 AM,Other,2156,2156,3832,3832,11976,3172,2934,5112,4533,15751
23,Afghanistan,2015,AFG-15/O580/SA1/MS/UN/367,2/29/2016 6:18:55 AM,Overall,2156,2156,3832,3832,11976,3172,2934,5112,4533,15751
23,Afghanistan,2015,AFG-15/O580/SA1/MS/UN/372,3/29/2016 9:05:54 AM,Overall,13675,13675,20513,20513,68376,13675,13675,20513,20513,68376
23,Afghanistan,2015,AFG-15/O580/SA1/MS/UN/372,3/29/2016 9:05:54 AM,Refugees,13675,13675,20512,20513,68375,13675,13675,20513,20513,68376
23,Afghanistan,2015,AFG-15/O580/SA1/MS/UN/381,2/1/2016 5:24:56 AM,Overall,6153,6153,24613,24613,61532,22454,21573,31007,29790,104824
23,Afghanistan,2015,AFG-15/O580/SA1/MS/UN/381,2/1/2016 5:24:56 AM,Refugees,6153,6153,24613,24613,61532,22454,21573,31007,29790,104824
23,Afghanistan,2015,AFG-15/O580/SA1/N/INGO/327,9/15/2016 4:21:15 AM,Other,115,45,0,0,160,189,71,0,0,260
23,Afghanistan,2015,AFG-15/O580/SA1/N/INGO/327,9/15/2016 4:21:15 AM,Overall,115,45,0,0,160,189,71,0,0,260
23,Afghanistan,2015,AFG-15/O580/SA1/N/INGO/364,8/17/2016 11:54:29 AM,Other,0,0,0,0,0,66,357,26563,28257,55243
23,Afghanistan,2015,AFG-15/O580/SA1/N/INGO/364,8/17/2016 11:54:29 AM,Overall,27,747,20456,19294,40524,66,357,26563,28257,55243
23,Afghanistan,2015,AFG-15/O580/SA1/N/UN/352,9/26/2016 10:53:21 AM,Overall,0,0,22297,21423,43720,0,0,30730,29525,60255
23,Afghanistan,2015,AFG-15/O580/SA1/N/UN/357,8/15/2016 9:27:32 AM,Overall,0,0,12291,11809,24100,0,0,12604,12109,24713
23,Afghanistan,2015,AFG-15/O580/SA1/WASH/INGO/326,9/15/2016 4:17:11 AM,Host Communities,12202,8390,4840,2493,27925,20951,14100,10350,5982,51383
23,Afghanistan,2015,AFG-15/O580/SA1/WASH/INGO/326,9/15/2016 4:17:11 AM,Overall,12202,8390,4840,2493,27925,20951,14100,10350,5982,51383
23,Afghanistan,2015,AFG-15/O580/SA1/WASH/INGO/330,8/7/2016 9:20:24 AM,Host Communities,2533,2339,1836,1694,8402,2533,2339,1836,1694,8402
23,Afghanistan,2015,AFG-15/O580/SA1/WASH/INGO/330,8/7/2016 9:20:24 AM,Internally Displaced People,633,584,458,423,2098,633,584,458,423,2098
23,Afghanistan,2015,AFG-15/O580/SA1/WASH/INGO/330,8/7/2016 9:20:24 AM,Overall,3166,2923,2294,2117,10500,3166,2923,2294,2117,10500
23,Afghanistan,2015,AFG-15/O580/SA1/WASH/INGO/331,8/11/2016 1:41:17 PM,Host Communities,3847,3847,3847,3846,15387,3846,3855,3855,3855,15411
23,Afghanistan,2015,AFG-15/O580/SA1/WASH/INGO/331,8/11/2016 1:41:17 PM,Internally Displaced People,3874,3873,3873,3873,15493,3938,3937,3937,3937,15749
23,Afghanistan,2015,AFG-15/O580/SA1/WASH/INGO/331,8/11/2016 1:41:17 PM,Other,328,328,328,328,1312,328,328,328,328,1312
23,Afghanistan,2015,AFG-15/O580/SA1/WASH/INGO/331,8/11/2016 1:41:17 PM,Overall,8097,8097,8097,8096,32387,8203,8203,8202,8202,32810
23,Afghanistan,2015,AFG-15/O580/SA1/WASH/INGO/331,8/11/2016 1:41:17 PM,Refugees,49,48,49,48,194,82,82,82,82,328
23,Afghanistan,2015,AFG-15/O580/SA1/WASH/INGO/344,7/5/2016 8:06:09 AM,Host Communities,705,934,288,313,2240,1610,1495,795,333,4233
23,Afghanistan,2015,AFG-15/O580/SA1/WASH/INGO/344,7/5/2016 8:06:09 AM,Internally Displaced People,2600,3442,1062,1156,8260,1797,1454,40,655,3946
23,Afghanistan,2015,AFG-15/O580/SA1/WASH/INGO/344,7/5/2016 8:06:09 AM,Other,60,60,0,0,120,0,0,0,0,0
23,Afghanistan,2015,AFG-15/O580/SA1/WASH/INGO/344,7/5/2016 8:06:09 AM,Overall,6449,8520,2610,2841,20420,4625,4103,4231,3027,15986
23,Afghanistan,2015,AFG-15/O580/SA1/WASH/INGO/344,7/5/2016 8:06:09 AM,Refugees,3084,4086,1260,1370,9800,1218,1154,2781,2654,7807
23,Afghanistan,2015,AFG-15/O580/SA1/WASH/INGO/355,7/17/2016 4:25:27 AM,Host Communities,2278,2188,1649,1585,7700,2749,3513,2970,3187,12419
23,Afghanistan,2015,AFG-15/O580/SA1/WASH/INGO/355,7/17/2016 4:25:27 AM,Internally Displaced People,3106,2984,2249,2161,10500,1465,1991,1177,1332,5965
23,Afghanistan,2015,AFG-15/O580/SA1/WASH/INGO/355,7/17/2016 4:25:27 AM,Other,2898,2792,2093,2017,9800,2396,3052,2800,3132,11380
23,Afghanistan,2015,AFG-15/O580/SA1/WASH/INGO/355,7/17/2016 4:25:27 AM,Overall,8288,7868,6064,5780,28000,6610,8556,6947,7651,29764
23,Afghanistan,2015,AFG-15/O580/SA1/WASH/INGO/376,9/21/2016 5:03:29 AM,Other,13857,13529,24636,21438,73460,0,0,0,0,0
23,Afghanistan,2015,AFG-15/O580/SA1/WASH/INGO/376,9/21/2016 5:03:29 AM,Overall,13782,13242,34456,33104,94584,18743,18742,19507,18008,75000
23,Afghanistan,2015,AFG-15/O580/SA1/WASH/UN/360,7/14/2016 6:56:25 AM,Host Communities,11959,11490,2695,2805,28949,12677,11601,2914,2801,29993
23,Afghanistan,2015,AFG-15/O580/SA1/WASH/UN/360,7/14/2016 6:56:25 AM,Internally Displaced People,3574,3434,838,805,8651,3748,3602,870,837,9057
23,Afghanistan,2015,AFG-15/O580/SA1/WASH/UN/360,7/14/2016 6:56:25 AM,Other,150,150,0,0,300,256,70,0,0,326
23,Afghanistan,2015,AFG-15/O580/SA1/WASH/UN/360,7/14/2016 6:56:25 AM,Overall,15683,15073,3643,3501,37900,16294,15660,3784,3638,39376
23,Afghanistan,2015,AFG-15/O580/SA1/WASH/UN/366,10/23/2016 5:26:14 AM,Other,0,0,0,0,0,26833,26833,29070,29070,111806
23,Afghanistan,2015,AFG-15/O580/SA1/WASH/UN/366,10/23/2016 5:26:14 AM,Overall,24000,24000,26000,26000,100000,26833,26833,29070,29070,111806
23,Afghanistan,2016,AFG-16/3481/AFG/APC/INGO/3784,5/7/2020 8:43:14 AM,Host Communities,223,273,443,443,1382,1476,2426,1473,1944,7319
23,Afghanistan,2016,AFG-16/3481/AFG/APC/INGO/3784,5/7/2020 8:43:14 AM,Internally Displaced People,274,421,525,524,1744,804,1836,852,1125,4617
23,Afghanistan,2016,AFG-16/3481/AFG/APC/INGO/3784,5/7/2020 8:43:14 AM,Overall,1000,1250,1875,1875,6000,2934,5452,3044,4019,15449
23,Afghanistan,2016,AFG-16/3481/AFG/APC/INGO/3784,5/7/2020 8:43:14 AM,Refugees,503,556,907,908,2874,654,1190,719,950,3513
23,Afghanistan,2016,AFG-16/3481/AFG/APC/INGO/3865,12/21/2017 4:56:53 AM,Overall,2534,2656,3801,3938,12929,2482,2602,3749,3886,12719
23,Afghanistan,2016,AFG-16/3481/AFG/APC/INGO/3865,12/21/2017 4:56:53 AM,Refugees,2534,2656,3801,3938,12929,2482,2602,3749,3886,12719
23,Afghanistan,2016,AFG-16/3481/AFG/ESNFI/INGO/3856,5/24/2017 4:13:20 AM,Other,1138,1200,2454,2290,7082,1229,1252,2421,2383,7285
23,Afghanistan,2016,AFG-16/3481/AFG/ESNFI/INGO/3856,5/24/2017 4:13:20 AM,Overall,1138,1200,2454,2290,7082,1229,1252,2421,2383,7285
23,Afghanistan,2016,AFG-16/3481/AFG/ESNFI/NGO/3833,5/22/2017 3:46:08 AM,Other,2781,2795,3899,3965,13440,2781,2795,3899,3965,13440
23,Afghanistan,2016,AFG-16/3481/AFG/ESNFI/NGO/3833,5/22/2017 3:46:08 AM,Overall,2781,2795,3899,3965,13440,2781,2795,3899,3965,13440
23,Afghanistan,2016,AFG-16/3481/AFG/FSAC/INGO/3812,5/11/2017 4:51:00 AM,Overall,1826,1826,2738,2738,9128,1299,1299,1950,1950,6498
23,Afghanistan,2016,AFG-16/3481/AFG/FSAC/INGO/3812,5/11/2017 4:51:00 AM,Refugees,1826,1826,2738,2738,9128,1299,1299,1950,1950,6498
23,Afghanistan,2016,AFG-16/3481/AFG/FSAC/NGO/3839,3/28/2017 5:36:00 AM,Other,2230,2242,3124,3177,10773,2230,2242,3124,3177,10773
23,Afghanistan,2016,AFG-16/3481/AFG/FSAC/NGO/3839,3/28/2017 5:36:00 AM,Overall,2230,2242,3124,3177,10773,2230,2242,3124,3177,10773
23,Afghanistan,2016,AFG-16/3481/AFG/H-APC/INGO/3829,5/20/2018 10:45:30 AM,Internally Displaced People,7912,7912,5275,5275,26374,8019,5516,1335,1458,16328
23,Afghanistan,2016,AFG-16/3481/AFG/H-APC/INGO/3829,5/20/2018 10:45:30 AM,Other,20389,20374,13566,13566,67895,21561,21004,20201,15997,78763
23,Afghanistan,2016,AFG-16/3481/AFG/H-APC/INGO/3829,5/20/2018 10:45:30 AM,Overall,28301,28286,18841,18841,94269,29580,26520,21536,17455,95091
23,Afghanistan,2016,AFG-16/3481/AFG/H-WASH-ESNFI/INGO/3811,9/24/2017 5:50:30 AM,Internally Displaced People,3457,3584,2816,2944,12801,4088,6314,3603,3611,17616
23,Afghanistan,2016,AFG-16/3481/AFG/H-WASH-ESNFI/INGO/3811,9/24/2017 5:50:30 AM,Other,12960,13440,10560,11040,48000,16352,25256,14412,14444,70464
23,Afghanistan,2016,AFG-16/3481/AFG/H-WASH-ESNFI/INGO/3811,9/24/2017 5:50:30 AM,Overall,17282,17922,14082,14720,64006,20441,31570,18014,18055,88080
23,Afghanistan,2016,AFG-16/3481/AFG/N/NGO/3816,6/18/2017 7:37:39 AM,Host Communities,0,23843,19822,19045,62710,0,39986,22770,24032,86788
23,Afghanistan,2016,AFG-16/3481/AFG/N/NGO/3816,6/18/2017 7:37:39 AM,Internally Displaced People,0,2117,1724,1656,5497,0,7581,4204,4437,16222
23,Afghanistan,2016,AFG-16/3481/AFG/N/NGO/3816,6/18/2017 7:37:39 AM,Other,421,1008,0,0,1429,904,1555,0,0,2459
23,Afghanistan,2016,AFG-16/3481/AFG/N/NGO/3816,6/18/2017 7:37:39 AM,Overall,421,52928,43092,41402,137843,904,63179,35030,36972,136085
23,Afghanistan,2016,AFG-16/3481/AFG/N/NGO/3816,6/18/2017 7:37:39 AM,Refugees,0,25960,21546,20701,68207,0,14531,8057,8504,31092
23,Afghanistan,2016,AFG-16/3481/RA2/CCS/UN/4432,10/9/2017 3:33:26 AM,Overall,360,0,0,0,360,74,0,0,0,74
23,Afghanistan,2016,AFG-16/3481/RA3/MS/INGO/4491,9/10/2017 4:14:46 AM,Overall,2,2,2,2,8,2,2,2,2,8
23,Afghanistan,2016,AFG-16/3481/SA1/APC/INGO/507,5/11/2017 5:43:11 AM,Internally Displaced People,1000,7000,600,3000,11600,2566,14107,884,7042,24599
23,Afghanistan,2016,AFG-16/3481/SA1/APC/INGO/507,5/11/2017 5:43:11 AM,Overall,1000,7000,600,3000,11600,2366,14107,884,7042,24399
23,Afghanistan,2016,AFG-16/3481/SA1/ESNFI/INGO/492,5/15/2017 6:35:53 AM,Host Communities,112,112,168,168,560,0,0,0,0,0
23,Afghanistan,2016,AFG-16/3481/SA1/ESNFI/INGO/492,5/15/2017 6:35:53 AM,Internally Displaced People,1008,1008,1512,1512,5040,821,943,1553,1473,4790
23,Afghanistan,2016,AFG-16/3481/SA1/ESNFI/INGO/492,5/15/2017 6:35:53 AM,Overall,1120,1120,1680,1680,5600,821,943,1553,1473,4790
23,Afghanistan,2016,AFG-16/3481/SA1/ESNFI-FSAC/INGO/493,4/26/2017 9:20:16 AM,Host Communities,1600,1600,4000,4000,11200,1534,1882,1854,2132,7402
23,Afghanistan,2016,AFG-16/3481/SA1/ESNFI-FSAC/INGO/493,4/26/2017 9:20:16 AM,Internally Displaced People,2400,2400,6000,6000,16800,3306,3622,5987,5182,18097
23,Afghanistan,2016,AFG-16/3481/SA1/ESNFI-FSAC/INGO/493,4/26/2017 9:20:16 AM,Overall,4000,4000,10000,10000,28000,4840,5504,7841,7314,25499
23,Afghanistan,2016,AFG-16/3481/SA1/ESNFI-FSAC-N-APC-WASH/INGO/491,6/8/2017 12:47:26 PM,Other,23,23,23,23,92,23,23,23,23,92
23,Afghanistan,2016,AFG-16/3481/SA1/ESNFI-FSAC-N-APC-WASH/INGO/491,6/8/2017 12:47:26 PM,Overall,23,23,23,23,92,23,23,23,23,92
23,Afghanistan,2016,AFG-16/3481/SA1/ESNFI-FSAC-N-APC-WASH/INGO/511,6/20/2018 9:06:31 AM,Overall,1,1,1,1,4,1,1,1,1,4
23,Afghanistan,2016,AFG-16/3481/SA1/ESNFI-FSAC-N-APC-WASH/INGO/514,9/24/2017 11:52:14 AM,Overall,1,1,1,1,4,1,1,1,1,4
23,Afghanistan,2016,AFG-16/3481/SA1/FSAC-ESNFI/NGO/517,6/14/2017 5:34:09 AM,Internally Displaced People,3505,3502,3499,3494,14000,3259,3359,5032,4856,16506
23,Afghanistan,2016,AFG-16/3481/SA1/FSAC-ESNFI/NGO/517,6/14/2017 5:34:09 AM,Overall,3505,3502,3499,3494,14000,3259,3359,5032,4856,16506
23,Afghanistan,2016,AFG-16/3481/SA1/FSAC-WASH/INGO/531,5/16/2017 6:57:26 AM,Host Communities,722,722,958,958,3360,722,722,958,958,3360
23,Afghanistan,2016,AFG-16/3481/SA1/FSAC-WASH/INGO/531,5/16/2017 6:57:26 AM,Internally Displaced People,2890,2890,3830,3830,13440,2890,2890,3830,3830,13440
23,Afghanistan,2016,AFG-16/3481/SA1/FSAC-WASH/INGO/531,5/16/2017 6:57:26 AM,Overall,3612,3612,4788,4788,16800,3612,3612,4788,4788,16800
23,Afghanistan,2016,AFG-16/3481/SA1/H/INGO/481,8/10/2017 4:00:33 AM,Host Communities,6599,2793,2605,1921,13918,8448,3747,1656,1173,15024
23,Afghanistan,2016,AFG-16/3481/SA1/H/INGO/481,8/10/2017 4:00:33 AM,Other,144,23,0,0,167,314,7,0,0,321
23,Afghanistan,2016,AFG-16/3481/SA1/H/INGO/481,8/10/2017 4:00:33 AM,Overall,6743,2816,2605,1921,14085,8762,3757,1656,1173,15348
23,Afghanistan,2016,AFG-16/3481/SA1/H/INGO/485,8/23/2017 4:23:22 AM,Overall,15892,3469,13880,3725,36966,18008,2935,13030,4208,38181
23,Afghanistan,2016,AFG-16/3481/SA1/H/INGO/505,9/10/2017 10:38:27 AM,Host Communities,32997,7208,4498,3474,48177,41660,10405,8726,5449,66240
23,Afghanistan,2016,AFG-16/3481/SA1/H/INGO/505,9/10/2017 10:38:27 AM,Other,104,39,0,0,143,175,74,0,0,249
23,Afghanistan,2016,AFG-16/3481/SA1/H/INGO/505,9/10/2017 10:38:27 AM,Overall,33101,7247,4498,3474,48320,41835,10479,8726,5449,66489
23,Afghanistan,2016,AFG-16/3481/SA1/H/INGO/515,9/12/2017 4:36:17 AM,Internally Displaced People,2602,2698,838,862,7000,1998,0,0,0,1998
23,Afghanistan,2016,AFG-16/3481/SA1/H/INGO/515,9/12/2017 4:36:17 AM,Overall,20577,20454,4950,5076,51057,23529,47871,15030,15192,101622
23,Afghanistan,2016,AFG-16/3481/SA1/H/NGO/488,9/24/2017 5:15:10 AM,Host Communities,70628,73232,22744,23396,190000,12747,5989,3253,2771,24760
23,Afghanistan,2016,AFG-16/3481/SA1/H/NGO/488,9/24/2017 5:15:10 AM,Internally Displaced People,0,0,0,0,0,2179,1015,847,707,4748
23,Afghanistan,2016,AFG-16/3481/SA1/H/NGO/488,9/24/2017 5:15:10 AM,Overall,70628,73232,22744,23396,190000,14926,7004,4100,3478,29508
23,Afghanistan,2016,AFG-16/3481/SA1/H/NGO/502,8/21/2017 3:05:53 AM,Host Communities,3947,1802,1544,1287,8580,6671,1449,1144,870,10134
23,Afghanistan,2016,AFG-16/3481/SA1/H/NGO/502,8/21/2017 3:05:53 AM,Internally Displaced People,3229,1474,1264,1053,7020,1645,361,244,160,2410
23,Afghanistan,2016,AFG-16/3481/SA1/H/NGO/502,8/21/2017 3:05:53 AM,Other,56,0,0,0,56,0,0,0,0,0
23,Afghanistan,2016,AFG-16/3481/SA1/H/NGO/502,8/21/2017 3:05:53 AM,Overall,7232,3276,2808,2340,15656,8316,1810,1388,1030,12544
23,Afghanistan,2016,AFG-16/3481/SA1/H/NGO/506,9/11/2017 4:30:28 AM,Other,72,15,0,0,87,67,10,0,0,77
23,Afghanistan,2016,AFG-16/3481/SA1/H/NGO/506,9/11/2017 4:30:28 AM,Overall,11703,6120,7998,790,26611,16423,4480,5309,3151,29363
23,Afghanistan,2016,AFG-16/3481/SA1/H/NGO/509,10/19/2017 5:16:41 AM,Internally Displaced People,1084,1042,1325,1273,4724,39820,70358,34369,33788,178335
23,Afghanistan,2016,AFG-16/3481/SA1/H/NGO/509,10/19/2017 5:16:41 AM,Other,51663,49636,63143,60668,225110,1231,710,1262,631,3834
23,Afghanistan,2016,AFG-16/3481/SA1/H/NGO/509,10/19/2017 5:16:41 AM,Overall,52747,50678,64468,61941,229834,41051,71068,35631,34419,182169
23,Afghanistan,2016,AFG-16/3481/SA1/H/NGO/518,8/10/2017 11:34:42 AM,Host Communities,3483,1160,826,274,5743,1422,1405,1504,1111,5442
23,Afghanistan,2016,AFG-16/3481/SA1/H/NGO/518,8/10/2017 11:34:42 AM,Overall,3483,1160,826,274,5743,1422,1405,1504,1111,5442
23,Afghanistan,2016,AFG-16/3481/SA1/H/UN/482,1/14/2018 8:50:17 AM,Host Communities,159077,152713,165438,159077,636305,155037,148835,161237,155037,620146
23,Afghanistan,2016,AFG-16/3481/SA1/H/UN/482,1/14/2018 8:50:17 AM,Internally Displaced People,10131,9726,10537,10131,40525,9455,9076,9834,9455,37820
23,Afghanistan,2016,AFG-16/3481/SA1/H/UN/482,1/14/2018 8:50:17 AM,Overall,169208,162439,175975,169208,676830,164492,157912,171070,164492,657966
23,Afghanistan,2016,AFG-16/3481/SA1/N/INGO/486,10/11/2017 9:42:12 AM,Other,260,110,0,0,370,184,83,0,0,267
23,Afghanistan,2016,AFG-16/3481/SA1/N/INGO/486,10/11/2017 9:42:12 AM,Overall,260,110,0,0,370,184,83,0,0,267
23,Afghanistan,2016,AFG-16/3481/SA2/APC/INGO/3294,6/20/2018 9:23:50 AM,Host Communities,0,0,0,0,0,469,157,0,0,626
23,Afghanistan,2016,AFG-16/3481/SA2/APC/INGO/3294,6/20/2018 9:23:50 AM,Overall,1,1,1,1,4,469,157,0,0,626
23,Afghanistan,2016,AFG-16/3481/SA2/APC/INGO/3301,6/18/2017 5:31:45 AM,Internally Displaced People,13613,13614,17327,1737,46291,8065,10286,9153,8428,35932
23,Afghanistan,2016,AFG-16/3481/SA2/APC/INGO/3301,6/18/2017 5:31:45 AM,Other,13771,13771,17528,17528,62598,25878,21991,58930,51083,157882
23,Afghanistan,2016,AFG-16/3481/SA2/APC/INGO/3301,6/18/2017 5:31:45 AM,Overall,27384,27385,34855,34855,124479,33943,32277,68083,59511,193814
23,Afghanistan,2016,AFG-16/3481/SA2/APC/INGO/3334,6/7/2017 8:10:09 AM,Internally Displaced People,6407,2135,5638,2904,17084,4083,1126,47862,18828,71899
23,Afghanistan,2016,AFG-16/3481/SA2/APC/INGO/3334,6/7/2017 8:10:09 AM,Overall,18218,6074,16035,8258,48585,9271,3741,62156,24773,99941
23,Afghanistan,2016,AFG-16/3481/SA2/APC/NGO/3272,11/8/2017 7:26:07 AM,Internally Displaced People,2755,4932,693,776,9156,3557,7639,628,1077,12901
23,Afghanistan,2016,AFG-16/3481/SA2/APC/NGO/3272,11/8/2017 7:26:07 AM,Overall,2755,4932,693,776,9156,3557,7639,628,1077,12901
23,Afghanistan,2016,AFG-16/3481/SA2/APC/NGO/3328,6/13/2017 5:50:27 AM,Host Communities,11742,13066,19103,18685,62596,21418,20510,23551,22766,88245
23,Afghanistan,2016,AFG-16/3481/SA2/APC/NGO/3328,6/13/2017 5:50:27 AM,Internally Displaced People,12200,13800,16781,17200,59981,13399,12443,14212,13182,53236
23,Afghanistan,2016,AFG-16/3481/SA2/APC/NGO/3328,6/13/2017 5:50:27 AM,Overall,23942,26866,35884,35885,122577,34817,32953,37763,35948,141481
23,Afghanistan,2016,AFG-16/3481/SA2/APC/NGO/3598,5/24/2017 4:42:12 AM,Host Communities,3213,3214,3928,3927,14282,2635,1833,5800,5218,15486
23,Afghanistan,2016,AFG-16/3481/SA2/APC/NGO/3598,5/24/2017 4:42:12 AM,Internally Displaced People,26166,26167,31984,31984,116301,21955,18267,42196,40219,122637
23,Afghanistan,2016,AFG-16/3481/SA2/APC/NGO/3598,5/24/2017 4:42:12 AM,Overall,29379,29381,35912,35911,130583,24590,20100,45437,47996,138123
23,Afghanistan,2016,AFG-16/3481/SA2/APC/NGO/3667,12/18/2017 7:29:33 AM,Host Communities,800,796,300,270,2166,800,796,300,270,2166
23,Afghanistan,2016,AFG-16/3481/SA2/APC/NGO/3667,12/18/2017 7:29:33 AM,Internally Displaced People,1027,993,350,330,2700,1027,993,350,330,2700
23,Afghanistan,2016,AFG-16/3481/SA2/APC/NGO/3667,12/18/2017 7:29:33 AM,Other,200,199,77,58,534,200,199,77,58,534
23,Afghanistan,2016,AFG-16/3481/SA2/APC/NGO/3667,12/18/2017 7:29:33 AM,Overall,2027,1988,727,658,5400,2027,1988,727,658,5400
23,Afghanistan,2016,AFG-16/3481/SA2/APC-H/INGO/3487,12/11/2017 5:47:25 AM,Internally Displaced People,18227,18971,13199,13737,64134,20932,34007,15263,27609,97811
23,Afghanistan,2016,AFG-16/3481/SA2/APC-H/INGO/3487,12/11/2017 5:47:25 AM,Other,37,21,0,0,58,29,8,0,0,37
23,Afghanistan,2016,AFG-16/3481/SA2/APC-H/INGO/3487,12/11/2017 5:47:25 AM,Overall,18264,18992,13199,13737,64192,20932,34007,15263,27609,97811
23,Afghanistan,2016,AFG-16/3481/SA2/ESNFI/INGO/3259,7/24/2017 5:08:14 AM,Internally Displaced People,248,256,385,379,1268,248,256,385,379,1268
23,Afghanistan,2016,AFG-16/3481/SA2/ESNFI/INGO/3259,7/24/2017 5:08:14 AM,Other,78,52,0,0,130,78,52,0,0,130
23,Afghanistan,2016,AFG-16/3481/SA2/ESNFI/INGO/3259,7/24/2017 5:08:14 AM,Overall,326,308,385,379,1398,326,308,385,379,1398
23,Afghanistan,2016,AFG-16/3481/SA2/ESNFI/INGO/3266,10/11/2017 9:00:36 AM,Other,519,519,608,608,2254,568,622,838,791,2819
23,Afghanistan,2016,AFG-16/3481/SA2/ESNFI/INGO/3266,10/11/2017 9:00:36 AM,Overall,519,519,608,608,2254,568,622,838,791,2819
23,Afghanistan,2016,AFG-16/3481/SA2/ESNFI/INGO/3420,10/10/2017 3:35:58 AM,Internally Displaced People,241,263,305,321,1130,550,602,752,785,2689
23,Afghanistan,2016,AFG-16/3481/SA2/ESNFI/INGO/3420,10/10/2017 3:35:58 AM,Overall,241,263,305,321,1130,550,602,752,785,2689
23,Afghanistan,2016,AFG-16/3481/SA2/ESNFI/INGO/3504,7/4/2017 5:22:51 AM,Other,7,7,7,7,28,8,9,9,9,35
23,Afghanistan,2016,AFG-16/3481/SA2/ESNFI/INGO/3504,7/4/2017 5:22:51 AM,Overall,7,7,7,7,28,8,9,9,9,35
23,Afghanistan,2016,AFG-16/3481/SA2/ESNFI/INGO/3535,9/10/2017 9:35:14 AM,Internally Displaced People,232,230,429,322,1213,230,231,431,324,1216
23,Afghanistan,2016,AFG-16/3481/SA2/ESNFI/INGO/3535,9/10/2017 9:35:14 AM,Overall,232,230,429,322,1213,230,231,431,324,1216
23,Afghanistan,2016,AFG-16/3481/SA2/FSAC/INGO/3267,6/5/2017 5:19:37 AM,Other,2121,1838,1626,1485,7070,2075,2171,3526,2935,10707
23,Afghanistan,2016,AFG-16/3481/SA2/FSAC/INGO/3267,6/5/2017 5:19:37 AM,Overall,2121,1838,1626,1485,7070,2075,2171,3526,2935,10707
23,Afghanistan,2016,AFG-16/3481/SA2/FSAC/INGO/3347,12/12/2017 4:55:16 AM,Host Communities,2797,2320,3332,3451,11900,2737,2933,3964,3978,13612
23,Afghanistan,2016,AFG-16/3481/SA2/FSAC/INGO/3347,12/12/2017 4:55:16 AM,Overall,2797,2320,3332,3451,11900,2737,2933,3964,3978,13612
23,Afghanistan,2016,AFG-16/3481/SA2/FSAC/INGO/3357,5/29/2017 5:39:01 AM,Internally Displaced People,908,990,1919,1784,5601,908,990,1919,1784,5601
23,Afghanistan,2016,AFG-16/3481/SA2/FSAC/INGO/3357,5/29/2017 5:39:01 AM,Overall,908,990,1919,1784,5601,908,990,1919,1784,5601
23,Afghanistan,2016,AFG-16/3481/SA2/FSAC/INGO/3421,9/7/2017 11:31:08 AM,Other,3363,3471,6573,6613,20020,4863,4890,6716,6646,23115
23,Afghanistan,2016,AFG-16/3481/SA2/FSAC/INGO/3421,9/7/2017 11:31:08 AM,Overall,3363,3471,6573,6613,20020,4863,4890,6716,6646,23115
23,Afghanistan,2016,AFG-16/3481/SA2/FSAC/INGO/3662,1/2/2018 6:44:08 AM,Internally Displaced People,2835,3045,2100,2520,10500,3385,3151,2801,2334,11671
23,Afghanistan,2016,AFG-16/3481/SA2/FSAC/INGO/3662,1/2/2018 6:44:08 AM,Overall,2835,3045,2100,2520,10500,3385,3151,2801,2334,11671
23,Afghanistan,2016,AFG-16/3481/SA2/FSAC/UN/3425,8/1/2017 10:31:58 AM,Internally Displaced People,5730,5730,14350,14300,40110,5730,5730,14350,14300,40110
23,Afghanistan,2016,AFG-16/3481/SA2/FSAC/UN/3425,8/1/2017 10:31:58 AM,Overall,5730,5730,14350,14300,40110,5730,5730,14350,14300,40110
23,Afghanistan,2016,AFG-16/3481/SA2/H/INGO/3327,1/2/2018 4:48:40 AM,Host Communities,24250,16167,6063,4042,50522,4967,1450,756,534,7707
23,Afghanistan,2016,AFG-16/3481/SA2/H/INGO/3327,1/2/2018 4:48:40 AM,Other,31,6,0,0,37,31,6,0,0,37
23,Afghanistan,2016,AFG-16/3481/SA2/H/INGO/3327,1/2/2018 4:48:40 AM,Overall,24281,16173,6063,4042,50559,4998,1456,756,534,7744
23,Afghanistan,2016,AFG-16/3481/SA2/H/INGO/3448,12/26/2017 6:48:50 AM,Host Communities,3110,1954,925,840,6829,5049,1442,1238,623,8352
23,Afghanistan,2016,AFG-16/3481/SA2/H/INGO/3448,12/26/2017 6:48:50 AM,Other,30,0,0,0,30,27,6,0,0,33
23,Afghanistan,2016,AFG-16/3481/SA2/H/INGO/3448,12/26/2017 6:48:50 AM,Overall,3140,1954,925,840,6859,5076,1448,1238,623,8385
23,Afghanistan,2016,AFG-16/3481/SA2/H/INGO/3658,8/1/2017 11:55:03 AM,Other,380,420,992,1008,2800,703,714,907,944,3268
23,Afghanistan,2016,AFG-16/3481/SA2/H/INGO/3658,8/1/2017 11:55:03 AM,Overall,380,420,992,1008,2800,703,714,907,944,3268
23,Afghanistan,2016,AFG-16/3481/SA2/H/NGO/3285,2/19/2018 12:19:19 PM,Host Communities,20210,19545,3904,3754,47413,10574,8144,4747,4755,28220
23,Afghanistan,2016,AFG-16/3481/SA2/H/NGO/3285,2/19/2018 12:19:19 PM,Overall,20210,19545,3904,3754,47413,13998,12168,6021,5800,37987
23,Afghanistan,2016,AFG-16/3481/SA2/H/NGO/3423,12/31/2017 4:29:02 AM,Internally Displaced People,221,63,35,32,351,235,150,134,78,597
23,Afghanistan,2016,AFG-16/3481/SA2/H/NGO/3423,12/31/2017 4:29:02 AM,Other,4164,1190,661,594,6609,2356,1175,1522,971,6024
23,Afghanistan,2016,AFG-16/3481/SA2/H/NGO/3423,12/31/2017 4:29:02 AM,Overall,4385,1253,696,626,6960,2591,1325,1656,1049,6621
23,Afghanistan,2016,AFG-16/3481/SA2/H/UN/3412,8/6/2018 5:26:22 AM,Host Communities,71293,66934,71584,68754,278565,0,0,0,0,0
23,Afghanistan,2016,AFG-16/3481/SA2/H/UN/3412,8/6/2018 5:26:22 AM,Internally Displaced People,4623,6787,4230,3241,18881,0,0,0,0,0
23,Afghanistan,2016,AFG-16/3481/SA2/H/UN/3412,8/6/2018 5:26:22 AM,Other,500,43,0,0,543,75237,72626,74644,70885,293392
23,Afghanistan,2016,AFG-16/3481/SA2/H/UN/3412,8/6/2018 5:26:22 AM,Overall,76416,73764,75814,71995,297989,75237,72626,74645,70885,293393
23,Afghanistan,2016,AFG-16/3481/SA2/H-APC/INGO/3571,12/11/2017 7:00:46 AM,Other,26,28,0,0,54,26,28,0,0,54
23,Afghanistan,2016,AFG-16/3481/SA2/H-APC/INGO/3571,12/11/2017 7:00:46 AM,Overall,27069,26262,6598,8348,68277,20866,29006,12367,12519,74758
23,Afghanistan,2016,AFG-16/3481/SA2/H-APC/INGO/3571,12/11/2017 7:00:46 AM,Refugees,27043,26234,6598,8348,68223,20840,28978,12367,12519,74704
23,Afghanistan,2016,AFG-16/3481/SA2/N/INGO/3605,12/18/2017 7:39:24 AM,Internally Displaced People,2320,2887,2740,2700,10647,2828,4214,5082,4922,17046
23,Afghanistan,2016,AFG-16/3481/SA2/N/INGO/3605,12/18/2017 7:39:24 AM,Other,55,55,0,0,110,26,101,0,0,127
23,Afghanistan,2016,AFG-16/3481/SA2/N/INGO/3605,12/18/2017 7:39:24 AM,Overall,2375,2942,2740,2700,10757,2854,4315,5082,4922,17173
23,Afghanistan,2016,AFG-16/3481/SA2/N/INGO/3606,3/20/2018 8:57:16 AM,Host Communities,127,49,0,0,176,202,78,0,0,280
23,Afghanistan,2016,AFG-16/3481/SA2/N/INGO/3606,3/20/2018 8:57:16 AM,Overall,127,49,0,0,176,202,78,0,0,280
23,Afghanistan,2016,AFG-16/3481/SA2/N/INGO/3607,12/3/2017 11:21:22 AM,Internally Displaced People,2494,2446,4297,4403,13640,2260,4199,4074,3872,14405
23,Afghanistan,2016,AFG-16/3481/SA2/N/INGO/3607,12/3/2017 11:21:22 AM,Overall,2494,2446,4297,4403,13640,2260,4199,4074,3872,14405
23,Afghanistan,2016,AFG-16/3481/SA2/N/INGO/3666,12/6/2017 11:51:37 AM,Internally Displaced People,0,1400,1430,1488,4318,204,5740,3826,4351,14121
23,Afghanistan,2016,AFG-16/3481/SA2/N/INGO/3666,12/6/2017 11:51:37 AM,Other,184,126,0,0,310,0,0,0,0,0
23,Afghanistan,2016,AFG-16/3481/SA2/N/INGO/3666,12/6/2017 11:51:37 AM,Overall,184,1526,1430,1488,4628,204,5740,3826,4351,14121
23,Afghanistan,2016,AFG-16/3481/SA2/N/UN/3264,12/12/2017 4:31:09 AM,Host Communities,74,74,6800,6534,13482,78,6527,3264,3042,12911
23,Afghanistan,2016,AFG-16/3481/SA2/N/UN/3264,12/12/2017 4:31:09 AM,Internally Displaced People,0,0,89,86,175,0,0,0,0,0
23,Afghanistan,2016,AFG-16/3481/SA2/N/UN/3264,12/12/2017 4:31:09 AM,Overall,74,74,6971,6698,13817,82,6527,3264,3042,12915
23,Afghanistan,2016,AFG-16/3481/SA2/N/UN/3264,12/12/2017 4:31:09 AM,Refugees,0,0,82,78,160,4,0,0,0,4
23,Afghanistan,2016,AFG-16/3481/SA2/N/UN/3488,6/11/2018 9:56:36 AM,Overall,0,30100,21616,21084,72800,0,70131,22364,26053,118548
23,Afghanistan,2016,AFG-16/3481/SA2/WASH/INGO/3397,12/7/2017 7:13:01 AM,Internally Displaced People,14141,12613,25226,24460,76440,3449,3813,8421,8010,23693
23,Afghanistan,2016,AFG-16/3481/SA2/WASH/INGO/3397,12/7/2017 7:13:01 AM,Overall,14141,12613,25226,24460,76440,3449,3813,8421,8010,23693
23,Afghanistan,2016,AFG-16/3481/SA2/WASH/INGO/3613,12/5/2017 7:39:40 AM,Overall,3959,5278,1847,2111,13195,2240,2288,4828,3834,13190
23,Afghanistan,2016,AFG-16/3481/SA2/WASH/INGO/3613,12/5/2017 7:39:40 AM,Refugees,3959,5278,1847,2111,13195,2240,2288,4828,3834,13190
23,Afghanistan,2016,AFG-16/3481/SA2/WASH/NGO/3534,12/10/2017 11:08:51 AM,Internally Displaced People,38,47,69,87,241,544,546,1608,1126,3824
23,Afghanistan,2016,AFG-16/3481/SA2/WASH/NGO/3534,12/10/2017 11:08:51 AM,Overall,689,886,3937,4330,9842,1404,1413,4318,3267,10402
23,Afghanistan,2016,AFG-16/3481/SA2/WASH/NGO/3534,12/10/2017 11:08:51 AM,Refugees,651,839,3868,4243,9601,860,867,2710,2141,6578
23,Afghanistan,2016,AFG-16/3481/SA2/WASH-H/INGO/3342,12/21/2017 7:03:16 AM,Host Communities,2382,2478,597,619,6076,6432,6003,2705,2169,17309
23,Afghanistan,2016,AFG-16/3481/SA2/WASH-H/INGO/3342,12/21/2017 7:03:16 AM,Internally Displaced People,200,208,50,53,511,204,308,88,80,680
23,Afghanistan,2016,AFG-16/3481/SA2/WASH-H/INGO/3342,12/21/2017 7:03:16 AM,Overall,12051,12499,3004,3125,30679,10927,14468,8770,7696,41861
23,Afghanistan,2016,AFG-16/3481/SA2/WASH-H/INGO/3342,12/21/2017 7:03:16 AM,Refugees,9469,9813,2357,2453,24092,4291,8157,5977,5447,23872
23,Afghanistan,2017,AFG-17/3481/1SA/APC/INGO/4980,8/7/2018 11:15:28 AM,Host Communities,50,50,600,400,1100,0,0,0,0,0
23,Afghanistan,2017,AFG-17/3481/1SA/APC/INGO/4980,8/7/2018 11:15:28 AM,Internally Displaced People,50,50,600,400,1100,0,0,0,0,0
23,Afghanistan,2017,AFG-17/3481/1SA/APC/INGO/4980,8/7/2018 11:15:28 AM,Overall,150,150,2430,2070,4800,104,46,2197,2086,4433
23,Afghanistan,2017,AFG-17/3481/1SA/APC/INGO/4980,8/7/2018 11:15:28 AM,Refugees,50,50,1230,1270,2600,0,0,0,0,0
23,Afghanistan,2017,AFG-17/3481/1SA/APC/INGO/5006,6/13/2018 5:30:22 AM,Other,42,43,2650,2650,5385,0,0,0,0,0
23,Afghanistan,2017,AFG-17/3481/1SA/APC/INGO/5006,6/13/2018 5:30:22 AM,Overall,42,43,2650,2650,5385,42,43,2220,2280,4585
23,Afghanistan,2017,AFG-17/3481/1SA/APC/NGO/5020,3/6/2018 5:51:19 AM,Host Communities,24982,26171,33309,34498,118960,35454,34281,43995,41572,155302
23,Afghanistan,2017,AFG-17/3481/1SA/APC/NGO/5020,3/6/2018 5:51:19 AM,Internally Displaced People,28095,29433,37460,38798,133786,28119,27540,30774,30009,116442
23,Afghanistan,2017,AFG-17/3481/1SA/APC/NGO/5020,3/6/2018 5:51:19 AM,Overall,53077,55604,70769,73296,252746,63573,61821,74769,71581,271744
23,Afghanistan,2017,AFG-17/3481/1SA/APC/NGO/5131,2/22/2018 8:03:25 AM,Host Communities,25920,25920,31680,31680,115200,18213,15534,56585,45766,136098
23,Afghanistan,2017,AFG-17/3481/1SA/APC/NGO/5131,2/22/2018 8:03:25 AM,Internally Displaced People,20925,20925,25575,25575,93000,19872,10498,42098,32726,105194
23,Afghanistan,2017,AFG-17/3481/1SA/APC/NGO/5131,2/22/2018 8:03:25 AM,Overall,46845,46845,57255,57255,208200,38085,26032,98683,78492,241292
23,Afghanistan,2017,AFG-17/3481/1SA/APC-ESNFI/INGO/5015,1/15/2018 8:59:10 AM,Overall,1792,1904,3774,3730,11200,2128,2261,4480,4431,13300
23,Afghanistan,2017,AFG-17/3481/1SA/APC-H/INGO/4985,8/15/2018 12:36:34 PM,Host Communities,366,1642,700,700,3408,6688,5594,462,495,13239
23,Afghanistan,2017,AFG-17/3481/1SA/APC-H/INGO/4985,8/15/2018 12:36:34 PM,Internally Displaced People,419,1876,800,800,3895,8552,7059,755,614,16980
23,Afghanistan,2017,AFG-17/3481/1SA/APC-H/INGO/4985,8/15/2018 12:36:34 PM,Overall,1309,5863,2500,2500,12172,25016,21264,2574,2566,51420
23,Afghanistan,2017,AFG-17/3481/1SA/APC-H/INGO/4985,8/15/2018 12:36:34 PM,Refugees,524,2345,1000,1000,4869,9776,8611,1357,1457,21201
23,Afghanistan,2017,AFG-17/3481/1SA/ESNFI/INGO/5024,1/14/2018 3:49:00 AM,Internally Displaced People,2182,2129,3246,3087,10644,2349,2292,3495,3324,11460
23,Afghanistan,2017,AFG-17/3481/1SA/ESNFI/INGO/5024,1/14/2018 3:49:00 AM,Overall,2182,2129,3246,3087,10644,2349,2292,3495,3324,11460
23,Afghanistan,2017,AFG-17/3481/1SA/ESNFI/INGO/5075,1/5/2018 7:39:31 AM,Host Communities,175,175,0,0,350,0,0,0,0,0
23,Afghanistan,2017,AFG-17/3481/1SA/ESNFI/INGO/5075,1/5/2018 7:39:31 AM,Internally Displaced People,3500,3500,0,0,7000,1123,1124,0,0,2247
23,Afghanistan,2017,AFG-17/3481/1SA/ESNFI/INGO/5075,1/5/2018 7:39:31 AM,Overall,3675,3675,0,0,7350,0,0,0,0,0
23,Afghanistan,2017,AFG-17/3481/1SA/ESNFI-APC/INGO/4961,7/16/2018 9:52:29 AM,Host Communities,131,93,2064,2066,4354,480,237,9230,5536,15483
23,Afghanistan,2017,AFG-17/3481/1SA/ESNFI-APC/INGO/4961,7/16/2018 9:52:29 AM,Internally Displaced People,888,771,1242,1225,4126,1775,1681,6612,5212,15280
23,Afghanistan,2017,AFG-17/3481/1SA/ESNFI-APC/INGO/4961,7/16/2018 9:52:29 AM,Other,521,817,4980,5549,11867,1645,1661,3361,3015,9682
23,Afghanistan,2017,AFG-17/3481/1SA/ESNFI-APC/INGO/4961,7/16/2018 9:52:29 AM,Overall,1540,1681,8928,8840,20989,3910,3577,19237,13765,40489
23,Afghanistan,2017,AFG-17/3481/1SA/ESNFI-APC/INGO/4961,7/16/2018 9:52:29 AM,Refugees,0,0,0,0,0,0,0,33,1,34
23,Afghanistan,2017,AFG-17/3481/1SA/FSAC/INGO/5031,4/9/2018 5:28:32 AM,Internally Displaced People,1827,1938,3671,3079,10515,2017,2295,4045,4136,12493
23,Afghanistan,2017,AFG-17/3481/1SA/FSAC/INGO/5031,4/9/2018 5:28:32 AM,Overall,1827,1938,3671,3079,10515,2107,2295,4045,4136,12583
23,Afghanistan,2017,AFG-17/3481/1SA/FSAC/INGO/5172,2/22/2018 7:22:22 AM,Internally Displaced People,3147,3123,3483,2157,11910,1575,1901,4217,4243,11936
23,Afghanistan,2017,AFG-17/3481/1SA/FSAC/INGO/5172,2/22/2018 7:22:22 AM,Overall,3147,3123,3483,2157,11910,1575,1901,4217,4243,11936
23,Afghanistan,2017,AFG-17/3481/1SA/FSAC-ESNFI-WASH-APC-N/INGO/5032,10/29/2018 9:44:04 AM,Other,43,44,44,44,175,43,44,44,44,175
23,Afghanistan,2017,AFG-17/3481/1SA/FSAC-ESNFI-WASH-APC-N/INGO/5032,10/29/2018 9:44:04 AM,Overall,43,44,44,44,175,43,44,44,44,175
23,Afghanistan,2017,AFG-17/3481/1SA/H/INGO/5000,10/11/2018 9:56:55 AM,Internally Displaced People,3763,3917,979,941,9600,0,0,0,0,0
23,Afghanistan,2017,AFG-17/3481/1SA/H/INGO/5000,10/11/2018 9:56:55 AM,Overall,13899,13443,3399,3194,33935,7055,14642,3843,4244,29784
23,Afghanistan,2017,AFG-17/3481/1SA/H/INGO/5000,10/11/2018 9:56:55 AM,Refugees,8781,9139,2285,2195,22400,0,0,0,0,0
23,Afghanistan,2017,AFG-17/3481/1SA/H/INGO/5005,7/1/2018 7:29:56 AM,Other,11112,1928,8495,2475,24010,12299,2453,11248,3511,29511
23,Afghanistan,2017,AFG-17/3481/1SA/H/INGO/5005,7/1/2018 7:29:56 AM,Overall,11112,1928,8495,2475,24010,12299,2453,11248,3511,29511
23,Afghanistan,2017,AFG-17/3481/1SA/H/INGO/5022,8/7/2018 7:17:55 AM,Host Communities,9080,20680,7394,7726,44880,0,0,0,0,0
23,Afghanistan,2017,AFG-17/3481/1SA/H/INGO/5022,8/7/2018 7:17:55 AM,Internally Displaced People,4539,10341,3695,3864,22439,0,0,0,0,0
23,Afghanistan,2017,AFG-17/3481/1SA/H/INGO/5022,8/7/2018 7:17:55 AM,Other,4539,10341,3695,3864,22439,0,0,0,0,0
23,Afghanistan,2017,AFG-17/3481/1SA/H/INGO/5022,8/7/2018 7:17:55 AM,Overall,18159,41362,14784,15456,89761,16862,33527,10046,9631,70066
23,Afghanistan,2017,AFG-17/3481/1SA/H/NGO/4966,9/8/2018 9:45:43 AM,Other,28,5,0,0,33,13469,10916,10117,8328,42830
23,Afghanistan,2017,AFG-17/3481/1SA/H/NGO/4966,9/8/2018 9:45:43 AM,Overall,9650,5044,3619,3619,21932,13469,10916,10117,8328,42830
23,Afghanistan,2017,AFG-17/3481/1SA/H/UN/4987,1/31/2020 10:48:14 AM,Host Communities,3000,18000,1500,7500,30000,12340,65220,4496,28160,110216
23,Afghanistan,2017,AFG-17/3481/1SA/H/UN/4987,1/31/2020 10:48:14 AM,Internally Displaced People,12000,72000,6000,30000,120000,10530,63280,3826,22820,100456
23,Afghanistan,2017,AFG-17/3481/1SA/H/UN/4987,1/31/2020 10:48:14 AM,Other,15000,90000,7500,37500,150000,7030,45740,3164,15800,71734
23,Afghanistan,2017,AFG-17/3481/1SA/H/UN/4987,1/31/2020 10:48:14 AM,Overall,30000,180000,15000,75000,300000,29900,174240,11486,66780,282406
23,Afghanistan,2017,AFG-17/3481/1SA/H/UN/5183,10/16/2018 10:35:42 AM,Host Communities,56133,58424,68606,71407,254570,33244,34586,40634,42284,150748
23,Afghanistan,2017,AFG-17/3481/1SA/H/UN/5183,10/16/2018 10:35:42 AM,Internally Displaced People,4410,4590,5390,5610,20000,33244,34586,40634,42284,150748
23,Afghanistan,2017,AFG-17/3481/1SA/H/UN/5183,10/16/2018 10:35:42 AM,Overall,121402,126355,148379,154435,550571,65170,67830,79652,82932,295584
23,Afghanistan,2017,AFG-17/3481/1SA/N/INGO/5040,10/17/2018 5:45:01 AM,Host Communities,3831,23444,6888,8086,42249,4627,38084,6330,7957,56998
23,Afghanistan,2017,AFG-17/3481/1SA/N/INGO/5040,10/17/2018 5:45:01 AM,Internally Displaced People,269,1646,484,567,2966,304,2506,416,524,3750
23,Afghanistan,2017,AFG-17/3481/1SA/N/INGO/5040,10/17/2018 5:45:01 AM,Other,967,5923,1740,2043,10673,1157,9521,1583,1990,14251
23,Afghanistan,2017,AFG-17/3481/1SA/N/INGO/5040,10/17/2018 5:45:01 AM,Overall,5067,31013,9112,10696,55888,6088,50111,8329,10471,74999
23,Afghanistan,2017,AFG-17/3481/1SA/N/INGO/5146,7/17/2018 9:50:04 AM,Other,70,12054,6941,7827,26892,95,10270,5349,7398,23112
23,Afghanistan,2017,AFG-17/3481/1SA/N/INGO/5146,7/17/2018 9:50:04 AM,Overall,70,12054,6941,7827,26892,95,10270,5349,7398,23112
23,Afghanistan,2017,AFG-17/3481/1SA/N/UN/5194,7/3/2018 4:42:38 AM,Host Communities,0,0,8280,9720,18000,0,0,12311,14454,26765
23,Afghanistan,2017,AFG-17/3481/1SA/N/UN/5194,7/3/2018 4:42:38 AM,Internally Displaced People,0,0,5750,6750,12500,0,0,2101,2476,4577
23,Afghanistan,2017,AFG-17/3481/1SA/N/UN/5194,7/3/2018 4:42:38 AM,Overall,0,0,15180,17820,33000,0,0,15271,17926,33197
23,Afghanistan,2017,AFG-17/3481/1SA/N/UN/5194,7/3/2018 4:42:38 AM,Refugees,0,0,1150,1350,2500,0,0,849,997,1846
23,Afghanistan,2017,AFG-17/3481/1SA/N/UN/5212,9/27/2018 9:48:56 AM,Overall,0,21069,14625,14065,49759,0,21297,9378,12529,43204
23,Afghanistan,2017,AFG-17/3481/1SA/WASH/INGO/5023,1/3/2018 9:52:47 AM,Internally Displaced People,6475,5775,11550,11200,35000,8296,8584,12665,13097,42642
23,Afghanistan,2017,AFG-17/3481/1SA/WASH/INGO/5023,1/3/2018 9:52:47 AM,Other,6475,5775,11550,11200,35000,0,0,0,0,0
23,Afghanistan,2017,AFG-17/3481/1SA/WASH/INGO/5023,1/3/2018 9:52:47 AM,Overall,12950,11550,23100,22400,70000,8296,8584,12665,13097,42642
23,Afghanistan,2017,AFG-17/3481/1SA/WASH/NGO/5042,12/31/2017 9:15:26 AM,Internally Displaced People,2274,2755,5267,6189,16485,2284,2755,5266,6180,16485
23,Afghanistan,2017,AFG-17/3481/1SA/WASH/NGO/5042,12/31/2017 9:15:26 AM,Other,1787,2134,3364,4195,11480,1758,2146,3378,4198,11480
23,Afghanistan,2017,AFG-17/3481/1SA/WASH/NGO/5042,12/31/2017 9:15:26 AM,Overall,4061,4889,8631,10384,27965,4042,4901,8644,10378,27965
23,Afghanistan,2017,AFG-17/3481/1SA/WASH-ESNFI-APC/INGO/5014,6/4/2018 8:12:37 AM,Host Communities,399,866,1102,1710,4077,529,428,610,722,2289
23,Afghanistan,2017,AFG-17/3481/1SA/WASH-ESNFI-APC/INGO/5014,6/4/2018 8:12:37 AM,Other,1093,2222,3172,4690,11177,915,2758,1082,3033,7788
23,Afghanistan,2017,AFG-17/3481/1SA/WASH-ESNFI-APC/INGO/5014,6/4/2018 8:12:37 AM,Overall,1492,3088,4274,6400,15254,2624,3331,4487,7074,17516
23,Afghanistan,2017,AFG-17/3481/RA1/APC/INGO/6304,11/7/2017 9:02:14 AM,Other,28000,28000,42000,42000,140000,9177,7710,15904,12786,45577
23,Afghanistan,2017,AFG-17/3481/RA1/APC/INGO/6304,11/7/2017 9:02:14 AM,Overall,28000,28000,42000,42000,140000,9177,7710,15904,12786,45577
23,Afghanistan,2017,AFG-17/3481/RA2/H/UN/6886,7/3/2018 5:14:52 AM,Internally Displaced People,15424,14364,11439,10982,52209,0,0,0,0,0
23,Afghanistan,2017,AFG-17/3481/RA2/H/UN/6886,7/3/2018 5:14:52 AM,Overall,24347,22001,16860,15750,78958,4000,3700,2800,2500,13000
23,Afghanistan,2017,AFG-17/3481/RA2/H/UN/6886,7/3/2018 5:14:52 AM,Refugees,8923,7637,5421,4768,26749,0,0,0,0,0
23,Afghanistan,2017,AFG-17/3481/RA3/N/UN/7319,1/31/2019 11:58:17 AM,Host Communities,0,0,20738,24344,45082,0,0,20850,25160,46010
23,Afghanistan,2017,AFG-17/3481/RA3/N/UN/7319,1/31/2019 11:58:17 AM,Overall,0,0,20738,24344,45082,0,0,20828,25137,45965
23,Afghanistan,2017,AFG-17/3481/RA4/APC/UN/7613,9/6/2018 7:43:44 AM,Overall,2020,1940,2570,2470,9000,1819,2190,3598,3264,10871
23,Afghanistan,2017,AFG-17/3481/RA4/FSAC/INGO/7611,8/12/2018 7:14:23 AM,Host Communities,1800,1800,2400,2400,8400,1771,1876,4743,4693,13083
23,Afghanistan,2017,AFG-17/3481/RA4/FSAC/INGO/7611,8/12/2018 7:14:23 AM,Internally Displaced People,450,450,600,600,2100,13,13,31,34,91
23,Afghanistan,2017,AFG-17/3481/RA4/FSAC/INGO/7611,8/12/2018 7:14:23 AM,Overall,2250,2250,3000,3000,10500,2584,2600,3990,4000,13174
23,Afghanistan,2017,AFG-17/3481/RA4/H/INGO/7609,9/5/2018 7:43:43 AM,Other,6221,581,2183,751,9736,6979,649,2978,895,11501
23,Afghanistan,2017,AFG-17/3481/RA4/H/INGO/7609,9/5/2018 7:43:43 AM,Overall,6221,581,2183,751,9736,6979,649,2978,895,11501
23,Afghanistan,2017,AFG-17/3481/SA2/APC/NGO/6821,7/23/2018 8:58:24 AM,Host Communities,46289,34717,92578,57860,231444,53454,35788,101369,59028,249639
23,Afghanistan,2017,AFG-17/3481/SA2/APC/NGO/6821,7/23/2018 8:58:24 AM,Internally Displaced People,19287,14465,38574,24109,96435,22101,17953,43383,29313,112750
23,Afghanistan,2017,AFG-17/3481/SA2/APC/NGO/6821,7/23/2018 8:58:24 AM,Other,3857,2893,7715,4822,19287,579,724,1269,1118,3690
23,Afghanistan,2017,AFG-17/3481/SA2/APC/NGO/6821,7/23/2018 8:58:24 AM,Overall,77148,57861,154296,96435,385740,84884,62018,162220,98956,408078
23,Afghanistan,2017,AFG-17/3481/SA2/APC/NGO/6821,7/23/2018 8:58:24 AM,Refugees,7715,5786,15429,9644,38574,8750,7553,16199,9497,41999
23,Afghanistan,2017,AFG-17/3481/SA2/APC/NGO/6828,8/26/2018 12:00:57 PM,Host Communities,52969,55617,76805,79454,264845,67432,65408,72407,68689,273936
23,Afghanistan,2017,AFG-17/3481/SA2/APC/NGO/6828,8/26/2018 12:00:57 PM,Internally Displaced People,10364,10882,15027,15545,51818,14106,13709,15162,14444,57421
23,Afghanistan,2017,AFG-17/3481/SA2/APC/NGO/6828,8/26/2018 12:00:57 PM,Overall,63333,66499,91832,94999,316663,81538,79117,87569,83133,331357
23,Afghanistan,2017,AFG-17/3481/SA2/APC-FSAC-WASH/INGO/6739,5/6/2019 9:07:07 AM,Host Communities,26242,27702,48104,43740,145788,0,0,0,0,0
23,Afghanistan,2017,AFG-17/3481/SA2/APC-FSAC-WASH/INGO/6739,5/6/2019 9:07:07 AM,Internally Displaced People,61232,64637,112244,102059,340172,0,0,0,0,0
23,Afghanistan,2017,AFG-17/3481/SA2/APC-FSAC-WASH/INGO/6739,5/6/2019 9:07:07 AM,Overall,87474,92339,160348,145799,485960,153428,161960,281247,255728,852363
23,Afghanistan,2017,AFG-17/3481/SA2/APC-H-N/INGO/6797,1/6/2019 7:52:11 PM,Host Communities,4439,4620,3348,3485,15892,6041,11622,6951,7627,32241
23,Afghanistan,2017,AFG-17/3481/SA2/APC-H-N/INGO/6797,1/6/2019 7:52:11 PM,Internally Displaced People,44385,46196,33483,34850,158914,54362,104591,62557,68632,290142
23,Afghanistan,2017,AFG-17/3481/SA2/APC-H-N/INGO/6797,1/6/2019 7:52:11 PM,Other,86,50,0,0,136,63,35,0,0,98
23,Afghanistan,2017,AFG-17/3481/SA2/APC-H-N/INGO/6797,1/6/2019 7:52:11 PM,Overall,48910,50866,36831,38335,174942,60465,116248,69506,76259,322478
23,Afghanistan,2017,AFG-17/3481/SA2/APC-WASH-ESNFI/NGO/6863,1/23/2019 6:14:28 AM,Host Communities,1645,2555,1820,1908,7928,2091,3830,2752,3341,12014
23,Afghanistan,2017,AFG-17/3481/SA2/APC-WASH-ESNFI/NGO/6863,1/23/2019 6:14:28 AM,Internally Displaced People,2350,3450,2600,2724,11124,3031,4151,2942,2806,12930
23,Afghanistan,2017,AFG-17/3481/SA2/APC-WASH-ESNFI/NGO/6863,1/23/2019 6:14:28 AM,Other,705,1095,780,818,3398,11,0,0,0,11
23,Afghanistan,2017,AFG-17/3481/SA2/APC-WASH-ESNFI/NGO/6863,1/23/2019 6:14:28 AM,Overall,4700,7300,5200,5450,22650,4935,7665,5460,5722,23782
23,Afghanistan,2017,AFG-17/3481/SA2/CCS/INGO/6852,10/29/2018 9:41:17 AM,Other,12,12,12,12,48,0,0,0,0,0
23,Afghanistan,2017,AFG-17/3481/SA2/CCS/INGO/6852,10/29/2018 9:41:17 AM,Overall,12,12,12,12,48,12,12,12,12,48
23,Afghanistan,2017,AFG-17/3481/SA2/FSAC-CCS-APC/NGO/6788,6/3/2018 3:35:32 AM,Host Communities,55,65,82,91,293,60,71,91,96,318
23,Afghanistan,2017,AFG-17/3481/SA2/FSAC-CCS-APC/NGO/6788,6/3/2018 3:35:32 AM,Internally Displaced People,12515,14501,18382,20501,65899,12570,14566,18464,20592,66192
23,Afghanistan,2017,AFG-17/3481/SA2/FSAC-CCS-APC/NGO/6788,6/3/2018 3:35:32 AM,Overall,12570,14566,18464,20592,66192,13543,15573,19604,21360,70080
23,Afghanistan,2017,AFG-17/3481/SA2/FSAC-WASH-APC/INGO/6794,6/10/2018 9:33:10 AM,Internally Displaced People,1230,1230,1395,1395,5250,2462,2518,3100,3711,11791
23,Afghanistan,2017,AFG-17/3481/SA2/FSAC-WASH-APC/INGO/6794,6/10/2018 9:33:10 AM,Overall,1230,1230,1395,1395,5250,2462,2518,3100,3711,11791
23,Afghanistan,2017,AFG-17/3481/SA2/FSAC-WASH-APC/NGO/6784,12/26/2018 10:06:41 AM,Internally Displaced People,3941,4271,9154,8451,25817,2435,2357,10722,10303,25817
23,Afghanistan,2017,AFG-17/3481/SA2/FSAC-WASH-APC/NGO/6784,12/26/2018 10:06:41 AM,Overall,3941,4271,9154,8451,25817,3941,4271,9154,8451,25817
23,Afghanistan,2017,AFG-17/3481/SA2/H-APC-N/NGO/6792,12/27/2018 11:15:58 AM,Host Communities,4408,6958,2759,4937,19062,9510,12731,7248,6995,36484
23,Afghanistan,2017,AFG-17/3481/SA2/H-APC-N/NGO/6792,12/27/2018 11:15:58 AM,Internally Displaced People,2203,3479,1379,2468,9529,1483,2805,1817,1647,7752
23,Afghanistan,2017,AFG-17/3481/SA2/H-APC-N/NGO/6792,12/27/2018 11:15:58 AM,Other,735,1160,460,823,3178,382,672,559,520,2133
23,Afghanistan,2017,AFG-17/3481/SA2/H-APC-N/NGO/6792,12/27/2018 11:15:58 AM,Overall,7346,11597,4598,8228,31769,11375,16208,9624,9162,46369
23,Afghanistan,2017,AFG-17/3481/SA2/H-APC-WASH/INGO/6777,12/30/2018 8:49:45 AM,Host Communities,9155,16731,2841,2841,31568,4744,6995,2992,2605,17336
23,Afghanistan,2017,AFG-17/3481/SA2/H-APC-WASH/INGO/6777,12/30/2018 8:49:45 AM,Internally Displaced People,3231,5906,1003,1003,11143,1414,2487,917,799,5617
23,Afghanistan,2017,AFG-17/3481/SA2/H-APC-WASH/INGO/6777,12/30/2018 8:49:45 AM,Other,1077,1969,334,334,3714,0,0,0,0,0
23,Afghanistan,2017,AFG-17/3481/SA2/H-APC-WASH/INGO/6777,12/30/2018 8:49:45 AM,Overall,13464,24606,4178,4178,46426,6158,9482,3909,3404,22953
23,Afghanistan,2017,AFG-17/3481/SA2/H-FSAC-APC-ESNFI-WASH-CCS/INGO/6861,12/26/2018 11:37:05 AM,Host Communities,4960,5197,6614,6850,23621,6827,14464,3660,4113,29064
23,Afghanistan,2017,AFG-17/3481/SA2/H-FSAC-APC-ESNFI-WASH-CCS/INGO/6861,12/26/2018 11:37:05 AM,Internally Displaced People,5375,5632,7167,7423,25597,5616,10559,3678,3824,23677
23,Afghanistan,2017,AFG-17/3481/SA2/H-FSAC-APC-ESNFI-WASH-CCS/INGO/6861,12/26/2018 11:37:05 AM,Overall,10335,10829,13781,14273,49218,12442,25024,7338,7937,52741
23,Afghanistan,2017,AFG-17/3481/SA2/H-N-APC/INGO/6860,9/16/2019 8:29:04 AM,Host Communities,6258,5686,1644,1532,15120,18374,22664,9535,8621,59194
23,Afghanistan,2017,AFG-17/3481/SA2/H-N-APC/INGO/6860,9/16/2019 8:29:04 AM,Internally Displaced People,888,930,297,275,2390,487,415,244,187,1333
23,Afghanistan,2017,AFG-17/3481/SA2/H-N-APC/INGO/6860,9/16/2019 8:29:04 AM,Other,888,930,297,275,2390,807,993,389,420,2609
23,Afghanistan,2017,AFG-17/3481/SA2/H-N-APC/INGO/6860,9/16/2019 8:29:04 AM,Overall,8034,7546,2238,2082,19900,19668,24072,10168,9228,63136
23,Afghanistan,2017,AFG-17/3481/SA2/H-N-APC/NGO/6764,12/26/2018 8:54:49 AM,Host Communities,2247,2517,7600,7400,19764,10837,14899,14113,13726,53575
23,Afghanistan,2017,AFG-17/3481/SA2/H-N-APC/NGO/6764,12/26/2018 8:54:49 AM,Internally Displaced People,838,830,166,166,2000,943,1295,286,282,2806
23,Afghanistan,2017,AFG-17/3481/SA2/H-N-APC/NGO/6764,12/26/2018 8:54:49 AM,Overall,3085,3347,7766,7566,21764,11780,16194,14300,14107,56381
23,Afghanistan,2017,AFG-17/3481/SA2/H-N-APC/NGO/6817,1/4/2019 5:03:05 PM,Host Communities,7088,7425,9788,9450,33751,32870,27248,7856,3880,71854
23,Afghanistan,2017,AFG-17/3481/SA2/H-N-APC/NGO/6817,1/4/2019 5:03:05 PM,Internally Displaced People,877,919,1211,1169,4176,6544,8981,3145,2036,20706
23,Afghanistan,2017,AFG-17/3481/SA2/H-N-APC/NGO/6817,1/4/2019 5:03:05 PM,Other,39,12,0,0,51,9,0,0,0,9
23,Afghanistan,2017,AFG-17/3481/SA2/H-N-APC/NGO/6817,1/4/2019 5:03:05 PM,Overall,8004,8356,10999,10619,37978,39414,36229,11001,5916,92560
23,Afghanistan,2017,AFG-17/3481/SA2/H-N-WASH-APC-CCS/UN/6829,11/1/2019 11:05:04 AM,Host Communities,141410,203607,245958,81502,672477,0,0,0,0,0
23,Afghanistan,2017,AFG-17/3481/SA2/H-N-WASH-APC-CCS/UN/6829,11/1/2019 11:05:04 AM,Internally Displaced People,89824,220923,78392,51928,441067,341700,627326,479300,197148,1645474
23,Afghanistan,2017,AFG-17/3481/SA2/H-N-WASH-APC-CCS/UN/6829,11/1/2019 11:05:04 AM,Overall,231234,424530,324350,133430,1113544,341692,627324,479289,197169,1645474
23,Afghanistan,2017,AFG-17/3481/SA2/H-WASH-APC/INGO/6787,11/5/2019 7:32:58 AM,Host Communities,21930,24306,15430,16157,77823,17966,30381,18199,16225,82771
23,Afghanistan,2017,AFG-17/3481/SA2/H-WASH-APC/INGO/6787,11/5/2019 7:32:58 AM,Internally Displaced People,3120,3228,2152,2259,10759,2099,2032,3144,3345,10620
23,Afghanistan,2017,AFG-17/3481/SA2/H-WASH-APC/INGO/6787,11/5/2019 7:32:58 AM,Other,220,221,55,53,549,47,7,0,0,54
23,Afghanistan,2017,AFG-17/3481/SA2/H-WASH-APC/INGO/6787,11/5/2019 7:32:58 AM,Overall,25270,27755,17637,18469,89131,20112,32420,21343,19570,93445
23,Afghanistan,2017,AFG-17/3481/SA2/N-APC-FSAC-WASH-CCS/INGO/6749,9/12/2019 8:01:46 AM,Host Communities,4198,4045,14479,17861,40583,1795,2009,20185,19619,43608
23,Afghanistan,2017,AFG-17/3481/SA2/N-APC-FSAC-WASH-CCS/INGO/6749,9/12/2019 8:01:46 AM,Internally Displaced People,1050,900,2551,2499,7000,1298,1409,2836,3060,8603
23,Afghanistan,2017,AFG-17/3481/SA2/N-APC-FSAC-WASH-CCS/INGO/6749,9/12/2019 8:01:46 AM,Other,226,72,0,0,298,132,45,0,0,177
23,Afghanistan,2017,AFG-17/3481/SA2/N-APC-FSAC-WASH-CCS/INGO/6749,9/12/2019 8:01:46 AM,Overall,5474,5017,17030,20360,47881,3225,3463,23021,22679,52388
23,Afghanistan,2017,AFG-17/3481/SA2/WASH-FSAC-APC/NGO/6825,6/23/2018 5:17:18 AM,Host Communities,435,437,609,619,2100,435,437,609,619,2100
23,Afghanistan,2017,AFG-17/3481/SA2/WASH-FSAC-APC/NGO/6825,6/23/2018 5:17:18 AM,Internally Displaced People,4204,4224,5888,5991,20307,4673,4696,6546,6660,22575
23,Afghanistan,2017,AFG-17/3481/SA2/WASH-FSAC-APC/NGO/6825,6/23/2018 5:17:18 AM,Other,4419,4441,6191,6298,21349,4663,4685,6533,6645,22526
23,Afghanistan,2017,AFG-17/3481/SA2/WASH-FSAC-APC/NGO/6825,6/23/2018 5:17:18 AM,Overall,9058,9102,12688,12908,43756,9771,9818,13688,13924,47201
23,Afghanistan,2017,AFG-17/3481/SA2/WASH-N-APC/INGO/6849,1/21/2019 11:37:42 AM,Host Communities,12385,11839,6470,6502,37196,12385,11839,6470,6502,37196
23,Afghanistan,2017,AFG-17/3481/SA2/WASH-N-APC/INGO/6849,1/21/2019 11:37:42 AM,Internally Displaced People,6959,6740,3490,3530,20719,7609,7583,3805,3646,22643
23,Afghanistan,2017,AFG-17/3481/SA2/WASH-N-APC/INGO/6849,1/21/2019 11:37:42 AM,Overall,19344,18579,9960,10032,57915,18694,19422,10275,11448,59839
23,Afghanistan,2018,AFG-18/3481/6RA/H/INGO/11417,11/5/2019 6:13:32 AM,Host Communities,1608,1230,1274,1019,5131,267,140,174,90,671
23,Afghanistan,2018,AFG-18/3481/6RA/H/INGO/11417,11/5/2019 6:13:32 AM,Internally Displaced People,4226,3223,3386,2709,13544,6855,5372,5568,4504,22299
23,Afghanistan,2018,AFG-18/3481/6RA/H/INGO/11417,11/5/2019 6:13:32 AM,Overall,5834,4453,4660,3728,18675,7122,5512,5742,4594,22970
23,Afghanistan,2018,AFG-18/3481/6RA/H/UN/11419,11/1/2019 12:12:15 PM,Other,2100,1300,700,540,4640,2640,1700,848,650,5838
23,Afghanistan,2018,AFG-18/3481/6RA/H/UN/11419,11/1/2019 12:12:15 PM,Overall,2100,1300,700,540,4640,2638,1700,850,650,5838
23,Afghanistan,2018,AFG-18/3481/6RA/H-N/NGO/11412,11/7/2019 10:34:43 AM,Host Communities,9408,29214,5836,6361,50819,3772,25190,12412,12430,53804
23,Afghanistan,2018,AFG-18/3481/6RA/H-N/NGO/11412,11/7/2019 10:34:43 AM,Other,86,76,0,0,162,71,151,0,0,222
23,Afghanistan,2018,AFG-18/3481/6RA/H-N/NGO/11412,11/7/2019 10:34:43 AM,Overall,9494,29290,5836,6361,50981,3843,25341,12412,12430,54026
23,Afghanistan,2018,AFG-18/3481/6RA/H-N/NGO/11413,12/24/2019 4:55:10 AM,Host Communities,4525,13147,5098,5688,28458,8947,8571,8826,8460,34804
23,Afghanistan,2018,AFG-18/3481/6RA/H-N/NGO/11413,12/24/2019 4:55:10 AM,Internally Displaced People,975,3042,1169,1356,6542,538,886,242,205,1871
23,Afghanistan,2018,AFG-18/3481/6RA/H-N/NGO/11413,12/24/2019 4:55:10 AM,Overall,5500,16189,6267,7044,35000,9485,9457,9068,8665,36675
23,Afghanistan,2018,AFG-18/3481/6RA/H-N/NGO/11416,9/15/2019 5:23:36 AM,Host Communities,47887,49960,65856,63586,227289,63511,71488,75015,72717,282731
23,Afghanistan,2018,AFG-18/3481/6RA/H-N/NGO/11416,9/15/2019 5:23:36 AM,Internally Displaced People,12677,13281,17506,16902,60366,16883,19003,19940,19330,75156
23,Afghanistan,2018,AFG-18/3481/6RA/H-N/NGO/11416,9/15/2019 5:23:36 AM,Other,34,20,0,0,54,0,0,0,0,0
23,Afghanistan,2018,AFG-18/3481/6RA/H-N/NGO/11416,9/15/2019 5:23:36 AM,Overall,60598,63261,83362,80488,287709,80394,90491,94955,92047,357887
23,Afghanistan,2018,AFG-18/3481/6RA/H-N/NGO/11418,10/22/2019 5:11:59 PM,Host Communities,6453,6175,1613,1544,15785,11311,19605,7480,7403,45799
23,Afghanistan,2018,AFG-18/3481/6RA/H-N/NGO/11418,10/22/2019 5:11:59 PM,Internally Displaced People,269,257,67,63,656,1652,1286,679,588,4205
23,Afghanistan,2018,AFG-18/3481/6RA/H-N/NGO/11418,10/22/2019 5:11:59 PM,Overall,6722,6433,1681,1607,16443,12963,20891,8159,7991,50004
23,Afghanistan,2018,AFG-18/3481/6RA/H-N/NGO/11424,11/17/2019 3:55:33 AM,Host Communities,14860,16908,4557,4734,41059,9310,17498,9386,9784,45978
23,Afghanistan,2018,AFG-18/3481/6RA/H-N/NGO/11424,11/17/2019 3:55:33 AM,Internally Displaced People,2192,2296,679,733,5900,2050,7870,2800,2292,15012
23,Afghanistan,2018,AFG-18/3481/6RA/H-N/NGO/11424,11/17/2019 3:55:33 AM,Overall,17052,19204,5236,5467,46959,11360,25368,12186,12076,60990
23,Afghanistan,2018,AFG-18/3481/6RA/N/UN/11421,11/5/2019 5:15:21 AM,Host Communities,0,0,4260,5207,9467,0,0,4883,5740,10623
23,Afghanistan,2018,AFG-18/3481/6RA/N/UN/11421,11/5/2019 5:15:21 AM,Internally Displaced People,0,0,405,495,900,0,0,242,277,519
23,Afghanistan,2018,AFG-18/3481/6RA/N/UN/11421,11/5/2019 5:15:21 AM,Overall,0,0,4665,5702,10367,0,0,5125,6017,11142
23,Afghanistan,2018,AFG-18/3481/6RA/N-H/INGO/11415,11/6/2019 6:26:43 AM,Host Communities,0,1860,1410,1530,4800,0,0,0,0,0
23,Afghanistan,2018,AFG-18/3481/6RA/N-H/INGO/11415,11/6/2019 6:26:43 AM,Internally Displaced People,12000,16740,12690,13770,55200,14403,43612,15574,18743,92332
23,Afghanistan,2018,AFG-18/3481/6RA/N-H/INGO/11415,11/6/2019 6:26:43 AM,Overall,12000,18600,14100,15300,60000,14403,43612,15574,18743,92332
23,Afghanistan,2018,AFG-18/3481/6RA/WASH/INGO/11414,9/12/2019 6:17:25 AM,Internally Displaced People,4279,5093,8457,7171,25000,5700,6784,11265,9551,33300
23,Afghanistan,2018,AFG-18/3481/6RA/WASH/INGO/11414,9/12/2019 6:17:25 AM,Overall,4279,5093,8457,7171,25000,5700,6784,11265,9551,33300
23,Afghanistan,2018,AFG-18/3481/6RA/WASH/UN/11422,12/29/2020 3:43:40 PM,Host Communities,0,0,0,0,0,33765,35150,27940,28445,125300
23,Afghanistan,2018,AFG-18/3481/6RA/WASH/UN/11422,12/29/2020 3:43:40 PM,Overall,19354,17542,28887,29555,95338,33765,35150,27940,28445,125300
23,Afghanistan,2018,AFG-18/3481/RA1/WASH/INGO/8807,1/23/2019 6:30:55 AM,Host Communities,18778,19939,15363,16314,70394,11400,12919,19269,20117,63705
23,Afghanistan,2018,AFG-18/3481/RA1/WASH/INGO/8807,1/23/2019 6:30:55 AM,Overall,18778,19939,15363,16314,70394,11400,12919,19269,20117,63705
23,Afghanistan,2018,AFG-18/3481/RA2/CCS/INGO/9487,5/6/2019 9:16:14 AM,Overall,3213,1377,0,0,4590,3213,1377,0,0,4590
23,Afghanistan,2018,AFG-18/3481/RA2/CCS/UN/9472,11/4/2019 11:24:01 AM,Host Communities,2149,544,14,14,2721,9530,1908,1796,683,13917
23,Afghanistan,2018,AFG-18/3481/RA2/CCS/UN/9472,11/4/2019 11:24:01 AM,Internally Displaced People,9480,2400,60,60,12000,6041,890,201,62,7194
23,Afghanistan,2018,AFG-18/3481/RA2/CCS/UN/9472,11/4/2019 11:24:01 AM,Other,379,96,2,2,479,2571,283,155,32,3041
23,Afghanistan,2018,AFG-18/3481/RA2/CCS/UN/9472,11/4/2019 11:24:01 AM,Overall,12640,3200,80,80,16000,18170,3081,2152,777,24180
23,Afghanistan,2018,AFG-18/3481/RA2/CCS/UN/9472,11/4/2019 11:24:01 AM,Refugees,632,160,4,4,800,28,0,0,0,28
23,Afghanistan,2018,AFG-18/3481/RA3/ESNFI/INGO/10481,9/12/2019 8:42:23 AM,Internally Displaced People,2608,2898,4637,4347,14490,1365,1958,2961,2762,9046
23,Afghanistan,2018,AFG-18/3481/RA3/ESNFI/INGO/10481,9/12/2019 8:42:23 AM,Overall,2608,2898,4637,4347,14490,1365,1958,2961,2762,9046
23,Afghanistan,2018,AFG-18/3481/RA3/ESNFI/INGO/10483,11/3/2019 6:29:01 AM,Internally Displaced People,2660,2800,4620,3920,14000,2565,2643,4150,3867,13225
23,Afghanistan,2018,AFG-18/3481/RA3/ESNFI/INGO/10483,11/3/2019 6:29:01 AM,Overall,2660,2800,4620,3920,14000,2565,2643,4150,3867,13225
23,Afghanistan,2018,AFG-18/3481/RA3/ESNFI/INGO/10484,11/3/2019 10:50:21 AM,Internally Displaced People,1808,2009,3214,3014,10045,1387,1273,1622,1753,6035
23,Afghanistan,2018,AFG-18/3481/RA3/ESNFI/INGO/10484,11/3/2019 10:50:21 AM,Overall,1808,2009,3214,3014,10045,1387,1273,1622,1753,6035
23,Afghanistan,2018,AFG-18/3481/RA3/ESNFI/NGO/10485,11/30/2019 11:28:13 AM,Internally Displaced People,3412,2594,3958,3686,13650,2660,2022,3086,2874,10642
23,Afghanistan,2018,AFG-18/3481/RA3/ESNFI/NGO/10485,11/30/2019 11:28:13 AM,Overall,3412,2594,3958,3686,13650,2660,2022,3086,2874,10642
23,Afghanistan,2018,AFG-18/3481/RA3/H/INGO/10482,11/3/2019 8:46:10 AM,Host Communities,5040,10080,4788,5292,25200,6103,15195,3896,3431,28625
23,Afghanistan,2018,AFG-18/3481/RA3/H/INGO/10482,11/3/2019 8:46:10 AM,Internally Displaced People,560,1120,532,588,2800,0,0,0,0,0
23,Afghanistan,2018,AFG-18/3481/RA3/H/INGO/10482,11/3/2019 8:46:10 AM,Overall,5600,11200,5320,5880,28000,6103,15195,3896,3431,28625
23,Afghanistan,2018,AFG-18/3481/RA3/H/INGO/10491,11/8/2019 5:57:00 AM,Host Communities,14037,35078,36565,34551,120231,15097,44774,20926,18391,99188
23,Afghanistan,2018,AFG-18/3481/RA3/H/INGO/10491,11/8/2019 5:57:00 AM,Internally Displaced People,2707,2992,4417,4132,14248,4579,15966,5772,6039,32356
23,Afghanistan,2018,AFG-18/3481/RA3/H/INGO/10491,11/8/2019 5:57:00 AM,Overall,16744,38070,40982,38683,134479,19676,60740,26698,24430,131544
23,Afghanistan,2018,AFG-18/3481/RA3/H/INGO/10495,10/1/2019 5:15:27 AM,Host Communities,13,1935,3271,3566,8785,279,3159,5467,4564,13469
23,Afghanistan,2018,AFG-18/3481/RA3/H/INGO/10495,10/1/2019 5:15:27 AM,Internally Displaced People,0,464,363,396,1223,0,0,0,0,0
23,Afghanistan,2018,AFG-18/3481/RA3/H/INGO/10495,10/1/2019 5:15:27 AM,Overall,13,2399,3634,3962,10008,279,3159,5467,4564,13469
23,Afghanistan,2018,AFG-18/3481/RA3/H/NGO/10486,11/1/2019 12:00:25 PM,Host Communities,20728,21931,9133,8145,59937,9288,21240,6468,6260,43256
23,Afghanistan,2018,AFG-18/3481/RA3/H/NGO/10486,11/1/2019 12:00:25 PM,Internally Displaced People,1803,1940,877,813,5433,1078,1399,774,887,4138
23,Afghanistan,2018,AFG-18/3481/RA3/H/NGO/10486,11/1/2019 12:00:25 PM,Overall,22531,23871,10010,8958,65370,10366,22639,7242,7147,47394
23,Afghanistan,2018,AFG-18/3481/RA3/H/NGO/10487,11/4/2019 4:08:50 AM,Host Communities,5510,5290,1377,1323,13500,13453,25468,7390,7524,53835
23,Afghanistan,2018,AFG-18/3481/RA3/H/NGO/10487,11/4/2019 4:08:50 AM,Internally Displaced People,2755,2645,689,661,6750,1734,2950,739,725,6148
23,Afghanistan,2018,AFG-18/3481/RA3/H/NGO/10487,11/4/2019 4:08:50 AM,Other,918,882,230,220,2250,993,2167,452,528,4140
23,Afghanistan,2018,AFG-18/3481/RA3/H/NGO/10487,11/4/2019 4:08:50 AM,Overall,9183,8817,2296,2204,22500,16180,30585,8581,8777,64123
23,Afghanistan,2018,AFG-18/3481/RA3/H/UN/10498,11/8/2019 10:43:53 AM,Host Communities,47847,36704,24718,14668,123937,0,0,0,0,0
23,Afghanistan,2018,AFG-18/3481/RA3/H/UN/10498,11/8/2019 10:43:53 AM,Other,47847,36708,24721,14662,123938,103300,94445,53125,44272,295142
23,Afghanistan,2018,AFG-18/3481/RA3/H/UN/10498,11/8/2019 10:43:53 AM,Overall,95694,73412,49439,29330,247875,103300,94445,53125,44272,295142
23,Afghanistan,2018,AFG-18/3481/RA4/FSAC/INGO/10790,9/22/2019 12:37:34 PM,Host Communities,19040,18564,4284,5712,47600,18119,16700,6889,7403,49111
23,Afghanistan,2018,AFG-18/3481/RA4/FSAC/INGO/10790,9/22/2019 12:37:34 PM,Overall,19040,18564,4284,5712,47600,18119,16700,6889,7403,49111
23,Afghanistan,2018,AFG-18/3481/RA4/FSAC/INGO/10805,11/8/2019 11:12:54 AM,Host Communities,15175,14575,14815,14935,59500,15887,15264,15513,15637,62301
23,Afghanistan,2018,AFG-18/3481/RA4/FSAC/INGO/10805,11/8/2019 11:12:54 AM,Overall,15175,14575,14815,14935,59500,15887,15264,15513,15637,62301
23,Afghanistan,2018,AFG-18/3481/RA4/FSAC/UN/10816,1/22/2020 7:49:25 AM,Other,15570,15854,21776,23030,76230,16969,17031,25733,25319,85052
23,Afghanistan,2018,AFG-18/3481/RA4/FSAC/UN/10816,1/22/2020 7:49:25 AM,Overall,15570,15854,21776,23030,76230,16969,17031,25733,25319,85052
23,Afghanistan,2018,AFG-18/3481/RA5/ESNFI/INGO/11271,11/12/2019 4:27:40 AM,Internally Displaced People,4850,4848,2078,2077,13853,4850,4848,2078,2077,13853
23,Afghanistan,2018,AFG-18/3481/RA5/ESNFI/INGO/11271,11/12/2019 4:27:40 AM,Overall,4850,4848,2078,2077,13853,4850,4848,2078,2077,13853
23,Afghanistan,2018,AFG-18/3481/RA5/ESNFI/INGO/11273,9/12/2019 6:45:50 AM,Internally Displaced People,6415,7484,11403,10335,35637,6402,7593,9770,8872,32637
23,Afghanistan,2018,AFG-18/3481/RA5/ESNFI/INGO/11273,9/12/2019 6:45:50 AM,Overall,6415,7484,11403,10335,35637,6402,7593,9770,8872,32637
23,Afghanistan,2018,AFG-18/3481/RA5/ESNFI/INGO/11279,11/6/2019 5:45:30 AM,Internally Displaced People,9548,10609,16975,15914,53046,5041,7668,11504,10408,34621
23,Afghanistan,2018,AFG-18/3481/RA5/ESNFI/INGO/11279,11/6/2019 5:45:30 AM,Overall,9548,10609,16975,15914,53046,5041,7668,11504,10408,34621
23,Afghanistan,2018,AFG-18/3481/RA5/ESNFI/INGO/11280,11/4/2019 10:33:10 AM,Internally Displaced People,2140,2228,437,655,5460,1471,1532,1228,1229,5460
23,Afghanistan,2018,AFG-18/3481/RA5/ESNFI/INGO/11280,11/4/2019 10:33:10 AM,Overall,2140,2228,437,655,5460,1471,1532,1228,1229,5460
23,Afghanistan,2018,AFG-18/3481/RA5/ESNFI/INGO/11284,9/12/2019 8:04:16 AM,Internally Displaced People,4993,5271,8697,7394,26355,3907,3950,5694,5409,18960
23,Afghanistan,2018,AFG-18/3481/RA5/ESNFI/INGO/11284,9/12/2019 8:04:16 AM,Overall,4993,5271,8697,7394,26355,3907,3950,5694,5409,18960
23,Afghanistan,2018,AFG-18/3481/RA5/ESNFI/INGO/11292,9/12/2019 8:16:55 AM,Host Communities,1903,2220,3383,3066,10572,0,0,0,0,0
23,Afghanistan,2018,AFG-18/3481/RA5/ESNFI/INGO/11292,9/12/2019 8:16:55 AM,Internally Displaced People,7740,9029,13758,12468,42995,8776,9786,12622,12455,43639
23,Afghanistan,2018,AFG-18/3481/RA5/ESNFI/INGO/11292,9/12/2019 8:16:55 AM,Overall,9643,11249,17141,15534,53567,8776,9786,12622,12455,43639
23,Afghanistan,2018,AFG-18/3481/RA5/ESNFI/NGO/11276,1/24/2020 10:08:05 AM,Internally Displaced People,4847,5876,3713,4807,19243,4847,5876,3713,4807,19243
23,Afghanistan,2018,AFG-18/3481/RA5/ESNFI/NGO/11276,1/24/2020 10:08:05 AM,Overall,4847,5876,3713,4807,19243,4847,5876,3713,4807,19243
23,Afghanistan,2018,AFG-18/3481/RA5/ESNFI/NGO/11277,12/1/2019 7:36:42 AM,Internally Displaced People,6601,5017,7657,7129,26404,5770,4386,6693,6231,23080
23,Afghanistan,2018,AFG-18/3481/RA5/ESNFI/NGO/11277,12/1/2019 7:36:42 AM,Overall,6601,5017,7657,7129,26404,5770,4386,6693,6231,23080
23,Afghanistan,2018,AFG-18/3481/RA5/ESNFI/NGO/11278,1/23/2020 4:10:36 AM,Internally Displaced People,2171,2181,3040,3094,10486,2171,2181,3040,3094,10486
23,Afghanistan,2018,AFG-18/3481/RA5/ESNFI/NGO/11278,1/23/2020 4:10:36 AM,Overall,2171,2181,3040,3094,10486,2171,2181,3040,3094,10486
23,Afghanistan,2018,AFG-18/3481/RA5/ESNFI/UN/11275,12/27/2020 6:11:59 AM,Internally Displaced People,22760,27020,37480,34340,121600,17721,20056,22056,20185,80018
23,Afghanistan,2018,AFG-18/3481/RA5/ESNFI/UN/11275,12/27/2020 6:11:59 AM,Overall,22760,27020,37480,34340,121600,17721,20056,22056,20185,80018
23,Afghanistan,2018,AFG-18/3481/RA5/ESNFI/UN/11282,11/6/2019 7:02:54 AM,Internally Displaced People,22197,23254,31710,28539,105700,14183,8051,19605,23788,65627
23,Afghanistan,2018,AFG-18/3481/RA5/ESNFI/UN/11282,11/6/2019 7:02:54 AM,Overall,22197,23254,31710,28539,105700,14183,8051,19605,23788,65627
23,Afghanistan,2018,AFG-18/3481/SA1/EIE/INGO/7706,11/2/2019 5:57:59 AM,Host Communities,70,71,1114,1159,2414,243,110,4079,3508,7940
23,Afghanistan,2018,AFG-18/3481/SA1/EIE/INGO/7706,11/2/2019 5:57:59 AM,Internally Displaced People,493,496,7797,8116,16902,78,36,4900,3773,8787
23,Afghanistan,2018,AFG-18/3481/SA1/EIE/INGO/7706,11/2/2019 5:57:59 AM,Other,141,141,2228,2319,4829,127,31,1892,1652,3702
23,Afghanistan,2018,AFG-18/3481/SA1/EIE/INGO/7706,11/2/2019 5:57:59 AM,Overall,704,708,11139,11594,24145,830,495,12088,9998,23411
23,Afghanistan,2018,AFG-18/3481/SA1/EIE-CPiE/INGO/7670,11/1/2019 1:46:37 PM,Host Communities,115,120,865,901,2001,0,0,144,127,271
23,Afghanistan,2018,AFG-18/3481/SA1/EIE-CPiE/INGO/7670,11/1/2019 1:46:37 PM,Internally Displaced People,460,478,3463,3604,8005,970,543,1075,1488,4076
23,Afghanistan,2018,AFG-18/3481/SA1/EIE-CPiE/INGO/7670,11/1/2019 1:46:37 PM,Overall,575,598,4328,4505,10006,970,543,3603,4890,10006
23,Afghanistan,2018,AFG-18/3481/SA1/ESNFI/INGO/7690,12/16/2018 9:00:31 AM,Host Communities,291,266,380,329,1266,26,27,59,44,156
23,Afghanistan,2018,AFG-18/3481/SA1/ESNFI/INGO/7690,12/16/2018 9:00:31 AM,Internally Displaced People,1165,1063,1519,1317,5064,1912,1875,3730,2955,10472
23,Afghanistan,2018,AFG-18/3481/SA1/ESNFI/INGO/7690,12/16/2018 9:00:31 AM,Overall,1456,1329,1899,1646,6330,1938,1902,3789,2999,10628
23,Afghanistan,2018,AFG-18/3481/SA1/ESNFI/INGO/7693,10/22/2018 5:47:57 AM,Host Communities,265,282,487,446,1480,109,139,206,252,706
23,Afghanistan,2018,AFG-18/3481/SA1/ESNFI/INGO/7693,10/22/2018 5:47:57 AM,Internally Displaced People,687,732,1264,1160,3843,507,615,1184,1073,3379
23,Afghanistan,2018,AFG-18/3481/SA1/ESNFI/INGO/7693,10/22/2018 5:47:57 AM,Other,106,113,195,178,592,0,0,0,0,0
23,Afghanistan,2018,AFG-18/3481/SA1/ESNFI/INGO/7693,10/22/2018 5:47:57 AM,Overall,1058,1127,1946,1784,5915,926,1123,1973,2095,6117
23,Afghanistan,2018,AFG-18/3481/SA1/ESNFI/INGO/7703,12/26/2018 8:47:59 AM,Host Communities,52,55,70,72,249,25,35,40,54,154
23,Afghanistan,2018,AFG-18/3481/SA1/ESNFI/INGO/7703,12/26/2018 8:47:59 AM,Internally Displaced People,992,1038,1322,1369,4721,696,874,1374,1596,4540
23,Afghanistan,2018,AFG-18/3481/SA1/ESNFI/INGO/7703,12/26/2018 8:47:59 AM,Overall,1044,1093,1392,1441,4970,721,909,1414,1650,4694
23,Afghanistan,2018,AFG-18/3481/SA1/ESNFI/NGO/7669,10/22/2018 5:38:05 AM,Host Communities,756,1008,252,504,2520,758,1008,252,506,2524
23,Afghanistan,2018,AFG-18/3481/SA1/ESNFI/NGO/7669,10/22/2018 5:38:05 AM,Internally Displaced People,2268,3024,756,1512,7560,2268,3022,758,1512,7560
23,Afghanistan,2018,AFG-18/3481/SA1/ESNFI/NGO/7669,10/22/2018 5:38:05 AM,Other,756,1008,252,504,2520,758,1008,252,506,2524
23,Afghanistan,2018,AFG-18/3481/SA1/ESNFI/NGO/7669,10/22/2018 5:38:05 AM,Overall,3780,5040,1260,2520,12600,3780,5040,1260,2520,12600
23,Afghanistan,2018,AFG-18/3481/SA1/ESNFI-WASH/NGO/7688,10/23/2018 10:24:17 AM,Host Communities,1231,1238,1726,1755,5950,1303,1311,1828,1858,6300
23,Afghanistan,2018,AFG-18/3481/SA1/ESNFI-WASH/NGO/7688,10/23/2018 10:24:17 AM,Internally Displaced People,3796,3814,5320,5410,18340,3649,3666,5111,5200,17626
23,Afghanistan,2018,AFG-18/3481/SA1/ESNFI-WASH/NGO/7688,10/23/2018 10:24:17 AM,Overall,5027,5052,7046,7165,24290,4952,4977,6939,7058,23926
23,Afghanistan,2018,AFG-18/3481/SA1/GBV-CPiE-ESNFI/NGO/7714,1/23/2019 6:09:37 AM,Host Communities,1801,2646,2387,2318,9152,3561,5281,3294,3154,15290
23,Afghanistan,2018,AFG-18/3481/SA1/GBV-CPiE-ESNFI/NGO/7714,1/23/2019 6:09:37 AM,Internally Displaced People,2572,3780,3412,3311,13075,1917,2658,2663,1532,8770
23,Afghanistan,2018,AFG-18/3481/SA1/GBV-CPiE-ESNFI/NGO/7714,1/23/2019 6:09:37 AM,Other,772,1134,1024,993,3923,225,225,115,67,632
23,Afghanistan,2018,AFG-18/3481/SA1/GBV-CPiE-ESNFI/NGO/7714,1/23/2019 6:09:37 AM,Overall,5145,7560,6823,6622,26150,5402,7938,7164,6953,27457
23,Afghanistan,2018,AFG-18/3481/SA1/H/INGO/7685,11/1/2019 10:43:18 AM,Other,6429,637,2085,526,9677,9435,1001,3073,786,14295
23,Afghanistan,2018,AFG-18/3481/SA1/H/INGO/7685,11/1/2019 10:43:18 AM,Overall,6429,637,2085,526,9677,9435,1001,3073,786,14295
23,Afghanistan,2018,AFG-18/3481/SA1/H/UN/7678,11/8/2019 11:00:06 AM,Internally Displaced People,88426,81847,24245,23861,218379,99854,98927,49413,39845,288039
23,Afghanistan,2018,AFG-18/3481/SA1/H/UN/7678,11/8/2019 11:00:06 AM,Overall,88426,81847,24245,23861,218379,99854,98927,49413,39845,288039
23,Afghanistan,2018,AFG-18/3481/SA1/H-APC/INGO/7705,10/14/2019 6:53:35 AM,Host Communities,2971,2908,1895,1511,9285,4338,2946,2436,1991,11711
23,Afghanistan,2018,AFG-18/3481/SA1/H-APC/INGO/7705,10/14/2019 6:53:35 AM,Internally Displaced People,264,597,210,229,1300,482,327,270,221,1300
23,Afghanistan,2018,AFG-18/3481/SA1/H-APC/INGO/7705,10/14/2019 6:53:35 AM,Overall,3235,3505,2105,1740,10585,4804,3284,2709,2215,13012
23,Afghanistan,2018,AFG-18/3481/SA1/H-N/NGO/7702,11/6/2019 7:30:28 AM,Host Communities,2270,8276,11718,12416,34680,7631,30594,40482,37572,116279
23,Afghanistan,2018,AFG-18/3481/SA1/H-N/NGO/7702,11/6/2019 7:30:28 AM,Internally Displaced People,739,6116,8232,9234,24321,1358,5779,7235,6899,21271
23,Afghanistan,2018,AFG-18/3481/SA1/H-N/NGO/7702,11/6/2019 7:30:28 AM,Other,38,42,0,0,80,33,38,0,0,71
23,Afghanistan,2018,AFG-18/3481/SA1/H-N/NGO/7702,11/6/2019 7:30:28 AM,Overall,3047,20351,30257,33752,87407,9022,36411,47717,44471,137621
23,Afghanistan,2018,AFG-18/3481/SA1/H-N/NGO/7702,11/6/2019 7:30:28 AM,Refugees,0,5917,10307,12102,28326,0,0,0,0,0
23,Afghanistan,2018,AFG-18/3481/SA1/H-N-GBV-CPiE/INGO/7691,11/8/2019 6:21:46 AM,Host Communities,6125,4116,5587,5390,21218,5417,22183,19993,18751,66344
23,Afghanistan,2018,AFG-18/3481/SA1/H-N-GBV-CPiE/INGO/7691,11/8/2019 6:21:46 AM,Internally Displaced People,1698,1768,2548,2652,8666,2207,9037,8146,7612,27002
23,Afghanistan,2018,AFG-18/3481/SA1/H-N-GBV-CPiE/INGO/7691,11/8/2019 6:21:46 AM,Other,1905,1922,2688,2797,9312,2407,9860,8886,8333,29486
23,Afghanistan,2018,AFG-18/3481/SA1/H-N-GBV-CPiE/INGO/7691,11/8/2019 6:21:46 AM,Overall,9728,7806,10823,10839,39196,10032,40575,37024,34725,122356
23,Afghanistan,2018,AFG-18/3481/SA1/H-WASH/INGO/7671,11/8/2019 11:25:39 AM,Host Communities,3186,3094,2125,2012,10417,3234,836,2044,622,6736
23,Afghanistan,2018,AFG-18/3481/SA1/H-WASH/INGO/7671,11/8/2019 11:25:39 AM,Internally Displaced People,223,231,154,162,770,1971,2667,4738,4796,14172
23,Afghanistan,2018,AFG-18/3481/SA1/H-WASH/INGO/7671,11/8/2019 11:25:39 AM,Other,1406,1344,896,941,4587,2097,1899,3941,3700,11637
23,Afghanistan,2018,AFG-18/3481/SA1/H-WASH/INGO/7671,11/8/2019 11:25:39 AM,Overall,4815,4669,3175,3115,15774,7302,5402,10723,9118,32545
23,Afghanistan,2018,AFG-18/3481/SA1/N/UN/7665,11/2/2019 6:28:55 AM,Overall,0,0,18751,22918,41669,0,0,20947,25213,46160
23,Afghanistan,2018,AFG-18/3481/SA1/N/UN/7668,11/1/2019 4:01:52 PM,Overall,0,10215,30474,28284,68973,0,15840,38023,36532,90395
23,Afghanistan,2018,AFG-18/3481/SA1/N-WASH-GBV/INGO/7687,9/11/2019 9:50:05 AM,Host Communities,2748,3761,2448,2370,11327,10762,29233,8604,9629,58228
23,Afghanistan,2018,AFG-18/3481/SA1/N-WASH-GBV/INGO/7687,9/11/2019 9:50:05 AM,Internally Displaced People,752,1950,974,1091,4767,0,0,0,0,0
23,Afghanistan,2018,AFG-18/3481/SA1/N-WASH-GBV/INGO/7687,9/11/2019 9:50:05 AM,Other,3542,12905,4395,4810,25652,0,0,0,0,0
23,Afghanistan,2018,AFG-18/3481/SA1/N-WASH-GBV/INGO/7687,9/11/2019 9:50:05 AM,Overall,7043,18916,7817,8271,42047,10762,29233,8604,9629,58228
23,Afghanistan,2018,AFG-18/3481/SA1/WASH/INGO/7701,11/7/2019 5:56:18 AM,Host Communities,6105,7471,14166,12126,39868,7474,7814,12624,11940,39852
23,Afghanistan,2018,AFG-18/3481/SA1/WASH/INGO/7701,11/7/2019 5:56:18 AM,Internally Displaced People,1919,2348,4452,3811,12530,2825,3289,2486,2497,11097
23,Afghanistan,2018,AFG-18/3481/SA1/WASH/INGO/7701,11/7/2019 5:56:18 AM,Overall,8024,9819,18618,15937,52398,10299,11103,15110,14437,50949
23,Afghanistan,2018,AFG-18/3481/SA1/WASH/INGO/7711,11/14/2019 11:22:57 AM,Other,22680,22680,34020,34020,113400,12185,12790,15588,16730,57293
23,Afghanistan,2018,AFG-18/3481/SA1/WASH/INGO/7711,11/14/2019 11:22:57 AM,Overall,22680,22680,34020,34020,113400,12185,12790,15588,16730,57293
23,Afghanistan,2018,AFG-18/3481/SA1/WASH-ESNFI/INGO/7682,1/23/2019 6:25:16 AM,Host Communities,1405,1481,875,785,4546,1789,1983,869,806,5447
23,Afghanistan,2018,AFG-18/3481/SA1/WASH-ESNFI/INGO/7682,1/23/2019 6:25:16 AM,Internally Displaced People,2584,2637,1707,1647,8575,2180,2533,1903,1765,8381
23,Afghanistan,2018,AFG-18/3481/SA1/WASH-ESNFI/INGO/7682,1/23/2019 6:25:16 AM,Other,0,0,0,0,0,83,92,40,37,252
23,Afghanistan,2018,AFG-18/3481/SA1/WASH-ESNFI/INGO/7682,1/23/2019 6:25:16 AM,Overall,3989,4118,2582,2432,13121,4052,4608,2812,2608,14080
23,Afghanistan,2018,AFG-18/3481/SA1/WASH-ESNFI/INGO/7713,10/3/2018 6:57:18 AM,Host Communities,426,428,597,614,2065,226,258,416,429,1329
23,Afghanistan,2018,AFG-18/3481/SA1/WASH-ESNFI/INGO/7713,10/3/2018 6:57:18 AM,Internally Displaced People,1863,1872,2610,2650,8995,2042,2321,3750,3863,11976
23,Afghanistan,2018,AFG-18/3481/SA1/WASH-ESNFI/INGO/7713,10/3/2018 6:57:18 AM,Overall,2289,2300,3207,3264,11060,2268,2579,4166,4292,13305
23,Afghanistan,2018,AFG-18/3481/SA1/WASH-ESNFI-CPiE/INGO/7694,10/24/2018 7:26:35 AM,Host Communities,1197,1171,2247,2268,6883,838,898,890,990,3616
23,Afghanistan,2018,AFG-18/3481/SA1/WASH-ESNFI-CPiE/INGO/7694,10/24/2018 7:26:35 AM,Internally Displaced People,1739,1700,3266,3295,10000,2011,2243,3283,3227,10764
23,Afghanistan,2018,AFG-18/3481/SA1/WASH-ESNFI-CPiE/INGO/7694,10/24/2018 7:26:35 AM,Other,118,115,221,223,677,0,0,0,0,0
23,Afghanistan,2018,AFG-18/3481/SA1/WASH-ESNFI-CPiE/INGO/7694,10/24/2018 7:26:35 AM,Overall,3054,2986,5734,5786,17560,2866,3170,4206,4256,14498
23,Afghanistan,2018,AFG-18/3481/SA1/WASH-ESNFI-CPiE/INGO/7694,10/24/2018 7:26:35 AM,Refugees,0,0,0,0,0,17,29,33,39,118
23,Afghanistan,2018,AFG-18/3481/SA1/WASH-GBV-CPiE/NGO/7700,1/31/2019 9:41:37 AM,Host Communities,2940,2235,3410,3175,11760,3532,2982,2463,1976,10953
23,Afghanistan,2018,AFG-18/3481/SA1/WASH-GBV-CPiE/NGO/7700,1/31/2019 9:41:37 AM,Internally Displaced People,2765,2101,3208,2986,11060,3112,3334,3022,2634,12102
23,Afghanistan,2018,AFG-18/3481/SA1/WASH-GBV-CPiE/NGO/7700,1/31/2019 9:41:37 AM,Overall,5705,4336,6618,6161,22820,6644,6316,5485,4610,23055
23,Afghanistan,2018,AFG-18/3481/SA2/APC/INGO/9760,12/26/2020 3:24:02 PM,Host Communities,585,550,140,140,1415,2898,2725,853,665,7141
23,Afghanistan,2018,AFG-18/3481/SA2/APC/INGO/9760,12/26/2020 3:24:02 PM,Internally Displaced People,1990,1875,460,460,4785,292,330,266,279,1167
23,Afghanistan,2018,AFG-18/3481/SA2/APC/INGO/9760,12/26/2020 3:24:02 PM,Overall,2575,2425,600,600,6200,3190,3055,1119,944,8308
23,Afghanistan,2018,AFG-18/3481/SA2/APC/NGO/9759,12/17/2019 11:26:54 AM,Host Communities,2244,2992,3162,2482,10880,3848,4505,4659,3023,16035
23,Afghanistan,2018,AFG-18/3481/SA2/APC/NGO/9759,12/17/2019 11:26:54 AM,Internally Displaced People,264,352,372,292,1280,757,1044,645,490,2936
23,Afghanistan,2018,AFG-18/3481/SA2/APC/NGO/9759,12/17/2019 11:26:54 AM,Other,132,176,186,146,640,152,65,162,93,472
23,Afghanistan,2018,AFG-18/3481/SA2/APC/NGO/9759,12/17/2019 11:26:54 AM,Overall,2640,3520,3720,2920,12800,4757,5614,5466,3606,19443
23,Afghanistan,2018,AFG-18/3481/SA2/FSAC/INGO/9723,10/1/2019 5:30:31 AM,Host Communities,3080,1320,13200,13200,30800,8782,10153,13742,13050,45727
23,Afghanistan,2018,AFG-18/3481/SA2/FSAC/INGO/9723,10/1/2019 5:30:31 AM,Internally Displaced People,770,330,3300,3300,7700,91,39,391,391,912
23,Afghanistan,2018,AFG-18/3481/SA2/FSAC/INGO/9723,10/1/2019 5:30:31 AM,Overall,3850,1650,16500,16500,38500,8873,10192,14133,13441,46639
23,Afghanistan,2018,AFG-18/3481/SA2/FSAC/INGO/9739,11/6/2019 5:03:31 PM,Host Communities,1391,1391,2784,2165,7731,1997,2091,5008,3619,12715
23,Afghanistan,2018,AFG-18/3481/SA2/FSAC/INGO/9739,11/6/2019 5:03:31 PM,Internally Displaced People,155,155,309,241,860,315,348,690,511,1864
23,Afghanistan,2018,AFG-18/3481/SA2/FSAC/INGO/9739,11/6/2019 5:03:31 PM,Overall,1546,1546,3093,2406,8591,2312,2439,5698,4130,14579
23,Afghanistan,2018,AFG-18/3481/SA2/FSAC/INGO/9744,9/11/2019 12:08:59 PM,Host Communities,11900,16450,14120,14230,56700,12803,13102,21831,21615,69351
23,Afghanistan,2018,AFG-18/3481/SA2/FSAC/INGO/9744,9/11/2019 12:08:59 PM,Overall,11900,16450,14120,14230,56700,12803,13102,21831,21615,69351
23,Afghanistan,2018,AFG-18/3481/SA2/FSAC/INGO/9751,11/29/2019 1:54:40 PM,Host Communities,1808,1808,2392,2392,8400,1562,1763,3288,3336,9949
23,Afghanistan,2018,AFG-18/3481/SA2/FSAC/INGO/9751,11/29/2019 1:54:40 PM,Overall,1808,1808,2392,2392,8400,1562,1763,3288,3336,9949
23,Afghanistan,2018,AFG-18/3481/SA2/FSAC-WASH/NGO/9713,9/18/2019 7:10:53 AM,Host Communities,16995,20637,12502,16315,66449,17627,21387,13214,17168,69396
23,Afghanistan,2018,AFG-18/3481/SA2/FSAC-WASH/NGO/9713,9/18/2019 7:10:53 AM,Internally Displaced People,4518,5485,3323,4337,17663,3886,4735,2611,3484,14716
23,Afghanistan,2018,AFG-18/3481/SA2/FSAC-WASH/NGO/9713,9/18/2019 7:10:53 AM,Overall,21513,26122,15825,20652,84112,21513,26122,15825,20652,84112
23,Afghanistan,2018,AFG-18/3481/SA2/N/INGO/9745,11/6/2019 4:47:37 AM,Host Communities,0,896,2149,2237,5282,0,725,989,1062,2776
23,Afghanistan,2018,AFG-18/3481/SA2/N/INGO/9745,11/6/2019 4:47:37 AM,Internally Displaced People,0,1778,2981,3102,7861,2,3803,5155,5198,14158
23,Afghanistan,2018,AFG-18/3481/SA2/N/INGO/9745,11/6/2019 4:47:37 AM,Overall,0,2674,5130,5339,13143,2,4528,6144,6260,16934
23,Afghanistan,2018,AFG-18/3481/SA2/N/INGO/9750,1/31/2020 1:12:50 PM,Host Communities,3447,3448,1186,1139,9220,21300,24142,8642,8892,62976
23,Afghanistan,2018,AFG-18/3481/SA2/N/INGO/9750,1/31/2020 1:12:50 PM,Overall,3447,3448,1186,1139,9220,21300,24142,8642,8892,62976
23,Afghanistan,2018,AFG-18/3481/SA2/N/NGO/9712,12/4/2019 5:51:37 AM,Host Communities,0,2800,4747,4825,12372,0,16211,6837,8006,31054
23,Afghanistan,2018,AFG-18/3481/SA2/N/NGO/9712,12/4/2019 5:51:37 AM,Internally Displaced People,0,800,1500,1508,3808,0,1730,825,1196,3751
23,Afghanistan,2018,AFG-18/3481/SA2/N/NGO/9712,12/4/2019 5:51:37 AM,Overall,0,3600,6247,6333,16180,0,17941,7662,9202,34805
23,Afghanistan,2018,AFG-18/3481/SA2/N/NGO/9743,11/17/2019 5:07:33 AM,Host Communities,0,22985,21403,25126,69514,28,35098,60547,58717,154390
23,Afghanistan,2018,AFG-18/3481/SA2/N/NGO/9743,11/17/2019 5:07:33 AM,Internally Displaced People,0,1187,1076,1263,3526,0,0,0,0,0
23,Afghanistan,2018,AFG-18/3481/SA2/N/NGO/9743,11/17/2019 5:07:33 AM,Other,53,113,0,0,166,0,0,0,0,0
23,Afghanistan,2018,AFG-18/3481/SA2/N/NGO/9743,11/17/2019 5:07:33 AM,Overall,53,24285,22480,26389,73207,28,35098,60547,58717,154390
23,Afghanistan,2018,AFG-18/3481/SA2/N/UN/9708,11/14/2019 5:36:32 AM,Host Communities,0,0,3817,4482,8299,0,0,5128,5987,11115
23,Afghanistan,2018,AFG-18/3481/SA2/N/UN/9708,11/14/2019 5:36:32 AM,Internally Displaced People,0,0,447,525,972,0,0,333,424,757
23,Afghanistan,2018,AFG-18/3481/SA2/N/UN/9708,11/14/2019 5:36:32 AM,Overall,0,0,4472,5249,9721,0,0,5461,6411,11872
23,Afghanistan,2018,AFG-18/3481/SA2/N-APC/INGO/9716,11/7/2019 7:37:57 AM,Internally Displaced People,1407,2217,2054,2138,7816,1234,5482,6209,8662,21587
23,Afghanistan,2018,AFG-18/3481/SA2/N-APC/INGO/9716,11/7/2019 7:37:57 AM,Other,5303,8354,8168,8502,30327,6175,11364,19955,20755,58249
23,Afghanistan,2018,AFG-18/3481/SA2/N-APC/INGO/9716,11/7/2019 7:37:57 AM,Overall,6710,10571,10222,10640,38143,7409,16846,26164,29417,79836
23,Afghanistan,2018,AFG-18/3481/SA2/N-FSAC-WASH/INGO/9731,11/8/2019 10:20:28 AM,Host Communities,7485,15189,13322,12781,48777,3532,3928,4356,4382,16198
23,Afghanistan,2018,AFG-18/3481/SA2/N-FSAC-WASH/INGO/9731,11/8/2019 10:20:28 AM,Internally Displaced People,394,800,701,672,2567,0,0,0,0,0
23,Afghanistan,2018,AFG-18/3481/SA2/N-FSAC-WASH/INGO/9731,11/8/2019 10:20:28 AM,Overall,7879,15989,14023,13453,51344,3532,3928,4356,4382,16198
23,Afghanistan,2018,AFG-18/3481/SA2/N-WASH-APC/INGO/9711,9/18/2019 8:33:41 AM,Host Communities,11619,13756,9271,6870,41516,8009,18840,10167,7919,44935
23,Afghanistan,2018,AFG-18/3481/SA2/N-WASH-APC/INGO/9711,9/18/2019 8:33:41 AM,Internally Displaced People,1579,1701,1150,815,5245,10,18,179,156,363
23,Afghanistan,2018,AFG-18/3481/SA2/N-WASH-APC/INGO/9711,9/18/2019 8:33:41 AM,Other,45,55,0,0,100,0,0,0,0,0
23,Afghanistan,2018,AFG-18/3481/SA2/N-WASH-APC/INGO/9711,9/18/2019 8:33:41 AM,Overall,13243,15512,10421,7685,46861,8019,18858,10346,8075,45298
23,Afghanistan,2018,AFG-18/3481/SA2/WASH/INGO/9703,12/10/2019 9:48:39 AM,Host Communities,1800,1900,3801,2840,10341,4308,3642,4096,4512,16558
23,Afghanistan,2018,AFG-18/3481/SA2/WASH/INGO/9703,12/10/2019 9:48:39 AM,Internally Displaced People,2020,1920,2120,2700,8760,657,611,656,734,2658
23,Afghanistan,2018,AFG-18/3481/SA2/WASH/INGO/9703,12/10/2019 9:48:39 AM,Overall,3820,3820,5921,5540,19101,4965,4253,4752,5246,19216
23,Afghanistan,2018,AFG-18/3481/SA2/WASH/INGO/9746,11/7/2019 11:24:22 AM,Host Communities,5646,5425,1897,1912,14880,5676,5457,1910,1837,14880
23,Afghanistan,2018,AFG-18/3481/SA2/WASH/INGO/9746,11/7/2019 11:24:22 AM,Internally Displaced People,5967,5733,1974,1806,15480,5807,5803,1937,1933,15480
23,Afghanistan,2018,AFG-18/3481/SA2/WASH/INGO/9746,11/7/2019 11:24:22 AM,Overall,11613,11158,3871,3718,30360,11483,11260,3847,3770,30360
23,Afghanistan,2018,AFG-18/3481/SA2/WASH/NGO/9756,1/21/2020 11:25:43 AM,Host Communities,5911,5939,8280,8423,28553,5911,5939,8280,8423,28553
23,Afghanistan,2018,AFG-18/3481/SA2/WASH/NGO/9756,1/21/2020 11:25:43 AM,Overall,5911,5939,8280,8423,28553,5911,5939,8280,8423,28553
23,Afghanistan,2018,AFG-18/3481/SA2/WASH-APC/INGO/9714,1/31/2020 1:23:53 PM,Host Communities,25897,26957,17644,18547,89045,23286,37844,15522,15142,91794
23,Afghanistan,2018,AFG-18/3481/SA2/WASH-APC/INGO/9714,1/31/2020 1:23:53 PM,Overall,25897,26957,17644,18547,89045,23286,37844,15522,15142,91794
23,Afghanistan,2018,AFG-18/3481/SA2/WASH-APC/INGO/9736,12/10/2019 8:18:55 AM,Host Communities,8994,19655,7796,10935,47380,6952,14141,8240,10004,39337
23,Afghanistan,2018,AFG-18/3481/SA2/WASH-APC/INGO/9736,12/10/2019 8:18:55 AM,Internally Displaced People,784,971,895,991,3641,805,4570,436,1671,7482
23,Afghanistan,2018,AFG-18/3481/SA2/WASH-APC/INGO/9736,12/10/2019 8:18:55 AM,Overall,9778,20626,8691,11926,51021,7757,18711,8676,11675,46819
23,Afghanistan,2018,AFG-18/3481/SA2/WASH-APC/NGO/9732,11/1/2019 1:07:48 PM,Host Communities,5228,5224,5222,5230,20904,4376,4274,4331,4373,17354
23,Afghanistan,2018,AFG-18/3481/SA2/WASH-APC/NGO/9732,11/1/2019 1:07:48 PM,Internally Displaced People,7842,7836,7833,7845,31356,10209,9980,10114,10203,40506
23,Afghanistan,2018,AFG-18/3481/SA2/WASH-APC/NGO/9732,11/1/2019 1:07:48 PM,Overall,13070,13060,13055,13075,52260,14585,14254,14445,14576,57860
23,Afghanistan,2018,AFG-18/3481/SA2/WASH-APC/NGO/9763,11/5/2019 12:35:26 PM,Host Communities,7000,5320,8120,7560,28000,8445,5725,8024,5884,28078
23,Afghanistan,2018,AFG-18/3481/SA2/WASH-APC/NGO/9763,11/5/2019 12:35:26 PM,Internally Displaced People,875,665,1015,945,3500,875,665,1015,965,3520
23,Afghanistan,2018,AFG-18/3481/SA2/WASH-APC/NGO/9763,11/5/2019 12:35:26 PM,Overall,7875,5985,9135,8505,31500,9320,6390,9039,6849,31598
23,Afghanistan,2019,AFG-19/3481/RA1/ESNFI/INGO/11914,11/6/2019 6:07:12 AM,Internally Displaced People,6317,9206,13860,12617,42000,8049,6337,9573,10448,34407
23,Afghanistan,2019,AFG-19/3481/RA1/ESNFI/INGO/11914,11/6/2019 6:07:12 AM,Overall,6317,9206,13860,12617,42000,8049,6337,9573,10448,34407
23,Afghanistan,2019,AFG-19/3481/RA1/ESNFI/INGO/11919,11/5/2019 8:44:56 AM,Internally Displaced People,2219,3089,4679,4085,14072,2215,3089,4685,4088,14077
23,Afghanistan,2019,AFG-19/3481/RA1/ESNFI/INGO/11919,11/5/2019 8:44:56 AM,Overall,2219,3089,4679,4085,14072,2215,3089,4685,4088,14077
23,Afghanistan,2019,AFG-19/3481/RA1/ESNFI/INGO/11921,11/5/2019 12:03:24 PM,Internally Displaced People,7460,7853,12957,10993,39263,4028,4484,5454,4982,18948
23,Afghanistan,2019,AFG-19/3481/RA1/ESNFI/INGO/11921,11/5/2019 12:03:24 PM,Overall,7460,7853,12957,10993,39263,4028,4484,5454,4982,18948
23,Afghanistan,2019,AFG-19/3481/RA1/H/INGO/11893,1/23/2020 4:27:43 AM,Other,11558,1879,7834,3729,25000,19608,3188,13290,6326,42412
23,Afghanistan,2019,AFG-19/3481/RA1/H/INGO/11893,1/23/2020 4:27:43 AM,Overall,11558,1879,7834,3729,25000,19608,3188,13290,6326,42412
23,Afghanistan,2019,AFG-19/3481/RA2/CCS/UN/12434,1/24/2020 10:25:30 AM,Other,2882,318,0,0,3200,1730,190,0,0,1920
23,Afghanistan,2019,AFG-19/3481/RA2/CCS/UN/12434,1/24/2020 10:25:30 AM,Overall,2882,318,0,0,3200,1730,190,0,0,1920
23,Afghanistan,2019,AFG-19/3481/RA3/ESNFI/INGO/14213,12/28/2020 7:21:14 AM,Host Communities,644,644,966,966,3220,504,750,1102,1179,3535
23,Afghanistan,2019,AFG-19/3481/RA3/ESNFI/INGO/14213,12/28/2020 7:21:14 AM,Internally Displaced People,1932,1932,2898,2898,9660,2405,3086,4512,4849,14852
23,Afghanistan,2019,AFG-19/3481/RA3/ESNFI/INGO/14213,12/28/2020 7:21:14 AM,Overall,3220,3220,4830,4830,16100,3182,4272,6393,6882,20729
23,Afghanistan,2019,AFG-19/3481/RA3/ESNFI/INGO/14213,12/28/2020 7:21:14 AM,Returnees,644,644,966,966,3220,273,436,779,854,2342
23,Afghanistan,2019,AFG-19/3481/RA3/ESNFI/INGO/14216,12/28/2020 8:29:05 AM,Internally Displaced People,9211,9460,8639,8390,35700,15113,15712,3240,3165,37230
23,Afghanistan,2019,AFG-19/3481/RA3/ESNFI/INGO/14216,12/28/2020 8:29:05 AM,Overall,9211,9460,8639,8390,35700,15113,15712,3240,3165,37230
23,Afghanistan,2019,AFG-19/3481/RA3/ESNFI/INGO/14222,9/13/2020 8:37:51 AM,Internally Displaced People,2365,2462,483,724,6034,1821,1909,561,585,4876
23,Afghanistan,2019,AFG-19/3481/RA3/ESNFI/INGO/14222,9/13/2020 8:37:51 AM,Overall,2365,2462,483,724,6034,1821,1909,561,585,4876
23,Afghanistan,2019,AFG-19/3481/RA3/ESNFI/INGO/14223,12/23/2020 11:20:56 AM,Internally Displaced People,2940,2940,1260,1260,8400,2940,2940,1260,1260,8400
23,Afghanistan,2019,AFG-19/3481/RA3/ESNFI/INGO/14223,12/23/2020 11:20:56 AM,Overall,4410,4410,1890,1890,12600,4410,4410,1890,1890,12600
23,Afghanistan,2019,AFG-19/3481/RA3/ESNFI/INGO/14223,12/23/2020 11:20:56 AM,Returnees,1470,1470,630,630,4200,1470,1470,630,630,4200
23,Afghanistan,2019,AFG-19/3481/RA3/ESNFI/INGO/14228,1/4/2021 7:20:17 AM,Internally Displaced People,2709,3291,4903,4540,15443,4296,5735,7449,6502,23982
23,Afghanistan,2019,AFG-19/3481/RA3/ESNFI/INGO/14228,1/4/2021 7:20:17 AM,Overall,2709,3291,4903,4540,15443,4296,5735,7449,6502,23982
23,Afghanistan,2019,AFG-19/3481/RA3/ESNFI/INGO/14302,1/17/2021 5:14:45 AM,Host Communities,1478,1546,1814,1882,6720,1189,1625,2745,2960,8519
23,Afghanistan,2019,AFG-19/3481/RA3/ESNFI/INGO/14302,1/17/2021 5:14:45 AM,Internally Displaced People,634,662,778,806,2880,72,93,135,149,449
23,Afghanistan,2019,AFG-19/3481/RA3/ESNFI/INGO/14302,1/17/2021 5:14:45 AM,Overall,2112,2208,2592,2688,9600,1261,1718,2880,3109,8968
23,Afghanistan,2019,AFG-19/3481/RA3/ESNFI/INGO/14315,12/13/2020 7:33:19 AM,Host Communities,1248,1157,990,910,4305,509,845,1560,1486,4400
23,Afghanistan,2019,AFG-19/3481/RA3/ESNFI/INGO/14315,12/13/2020 7:33:19 AM,Internally Displaced People,1166,1090,924,838,4018,485,706,1270,1238,3699
23,Afghanistan,2019,AFG-19/3481/RA3/ESNFI/INGO/14315,12/13/2020 7:33:19 AM,Overall,2436,2268,1932,1764,8400,1066,1603,2919,2794,8382
23,Afghanistan,2019,AFG-19/3481/RA3/ESNFI/INGO/14315,12/13/2020 7:33:19 AM,Returnees,22,21,18,16,77,72,52,89,70,283
23,Afghanistan,2019,AFG-19/3481/RA3/ESNFI/INGO/14319,12/23/2020 10:47:19 AM,Host Communities,172,165,257,247,841,166,204,404,460,1234
23,Afghanistan,2019,AFG-19/3481/RA3/ESNFI/INGO/14319,12/23/2020 10:47:19 AM,Internally Displaced People,2636,2530,3951,3798,12915,1848,2194,4181,4347,12570
23,Afghanistan,2019,AFG-19/3481/RA3/ESNFI/INGO/14319,12/23/2020 10:47:19 AM,Other,373,354,557,535,1819,197,314,567,698,1776
23,Afghanistan,2019,AFG-19/3481/RA3/ESNFI/INGO/14319,12/23/2020 10:47:19 AM,Overall,3181,3049,4765,4580,15575,2211,2712,5152,5505,15580
23,Afghanistan,2019,AFG-19/3481/RA3/ESNFI/INGO/14321,12/17/2020 4:37:47 AM,Internally Displaced People,2100,2168,2896,3336,10500,1888,1827,3474,3643,10832
23,Afghanistan,2019,AFG-19/3481/RA3/ESNFI/INGO/14321,12/17/2020 4:37:47 AM,Overall,2100,2168,2896,3336,10500,1888,1827,3474,3643,10832
23,Afghanistan,2019,AFG-19/3481/RA3/ESNFI/INGO/14341,12/21/2020 8:51:18 AM,Host Communities,218,275,463,438,1394,246,179,446,440,1311
23,Afghanistan,2019,AFG-19/3481/RA3/ESNFI/INGO/14341,12/21/2020 8:51:18 AM,Internally Displaced People,5587,7052,11871,11196,35706,4618,4751,9464,8878,27711
23,Afghanistan,2019,AFG-19/3481/RA3/ESNFI/INGO/14341,12/21/2020 8:51:18 AM,Overall,5805,7327,12334,11634,37100,4864,4930,9910,9318,29022
23,Afghanistan,2019,AFG-19/3481/RA3/ESNFI/INGO/14348,8/3/2020 6:07:41 PM,Host Communities,454,454,1059,1059,3026,0,0,0,0,0
23,Afghanistan,2019,AFG-19/3481/RA3/ESNFI/INGO/14348,8/3/2020 6:07:41 PM,Internally Displaced People,454,454,1059,1059,3026,710,761,995,988,3454
23,Afghanistan,2019,AFG-19/3481/RA3/ESNFI/INGO/14348,8/3/2020 6:07:41 PM,Overall,908,908,2118,2118,6052,710,761,995,988,3454
23,Afghanistan,2019,AFG-19/3481/RA3/ESNFI/INGO/14356,12/27/2020 3:37:32 PM,Internally Displaced People,3144,4385,6651,5805,19985,2122,2729,4824,4053,13728
23,Afghanistan,2019,AFG-19/3481/RA3/ESNFI/INGO/14356,12/27/2020 3:37:32 PM,Overall,3144,4385,6651,5805,19985,2122,2729,4824,4053,13728
23,Afghanistan,2019,AFG-19/3481/RA3/ESNFI/INGO/14373,12/17/2020 5:26:58 AM,Host Communities,1176,1176,1764,1764,5880,1318,1461,2110,2000,6889
23,Afghanistan,2019,AFG-19/3481/RA3/ESNFI/INGO/14373,12/17/2020 5:26:58 AM,Internally Displaced People,221,221,331,331,1104,205,231,354,369,1159
23,Afghanistan,2019,AFG-19/3481/RA3/ESNFI/INGO/14373,12/17/2020 5:26:58 AM,Overall,1471,1471,2205,2205,7352,1605,1766,2593,2499,8463
23,Afghanistan,2019,AFG-19/3481/RA3/ESNFI/INGO/14373,12/17/2020 5:26:58 AM,Returnees,74,74,110,110,368,82,74,129,130,415
23,Afghanistan,2019,AFG-19/3481/RA3/ESNFI/NGO/14204,1/6/2021 8:45:15 AM,Internally Displaced People,1899,2009,1500,1592,7000,1672,1780,1324,1406,6182
23,Afghanistan,2019,AFG-19/3481/RA3/ESNFI/NGO/14204,1/6/2021 8:45:15 AM,Overall,1899,2009,1500,1592,7000,1672,1780,1324,1406,6182
23,Afghanistan,2019,AFG-19/3481/RA3/ESNFI/NGO/14304,12/28/2020 7:01:50 AM,Host Communities,415,419,582,593,2009,415,419,582,593,2009
23,Afghanistan,2019,AFG-19/3481/RA3/ESNFI/NGO/14304,12/28/2020 7:01:50 AM,Internally Displaced People,347,348,485,493,1673,347,348,485,493,1673
23,Afghanistan,2019,AFG-19/3481/RA3/ESNFI/NGO/14304,12/28/2020 7:01:50 AM,Overall,762,767,1067,1086,3682,762,767,1067,1086,3682
23,Afghanistan,2019,AFG-19/3481/RA3/ESNFI/UN/14358,11/5/2021 7:05:29 AM,Internally Displaced People,3931,3901,5635,5346,18813,11010,10250,8732,7972,37964
23,Afghanistan,2019,AFG-19/3481/RA3/ESNFI/UN/14358,11/5/2021 7:05:29 AM,Overall,6779,6725,9716,9218,32438,11405,10618,9045,8258,39326
23,Afghanistan,2019,AFG-19/3481/RA3/ESNFI/UN/14358,11/5/2021 7:05:29 AM,Returnees,2848,2824,4081,3872,13625,395,368,313,286,1362
23,Afghanistan,2019,AFG-19/3481/RA3/ESNFI/UN/14362,11/23/2021 9:31:19 AM,Internally Displaced People,11475,11485,17421,17369,57750,4262,4489,4859,7327,20937
23,Afghanistan,2019,AFG-19/3481/RA3/ESNFI/UN/14362,11/23/2021 9:31:19 AM,Overall,11475,11485,17421,17369,57750,4262,4489,4859,7327,20937
23,Afghanistan,2019,AFG-19/3481/RA3/FSAC/INGO/14265,12/28/2020 5:12:59 AM,Host Communities,41810,38931,33155,30278,144174,47275,45613,70221,66225,229334
23,Afghanistan,2019,AFG-19/3481/RA3/FSAC/INGO/14265,12/28/2020 5:12:59 AM,Internally Displaced People,10923,10175,8665,7914,37677,596,662,1198,1367,3823
23,Afghanistan,2019,AFG-19/3481/RA3/FSAC/INGO/14265,12/28/2020 5:12:59 AM,Other,1744,1625,1386,1262,6017,33,33,48,42,156
23,Afghanistan,2019,AFG-19/3481/RA3/FSAC/INGO/14265,12/28/2020 5:12:59 AM,Overall,56821,52917,45063,41149,195950,47962,46360,71559,67712,233593
23,Afghanistan,2019,AFG-19/3481/RA3/FSAC/INGO/14265,12/28/2020 5:12:59 AM,Returnees,2344,2186,1857,1695,8082,58,52,92,78,280
23,Afghanistan,2019,AFG-19/3481/RA3/FSAC/INGO/14359,12/31/2020 4:09:41 PM,Host Communities,7102,2368,0,0,9470,13476,16,0,0,13492
23,Afghanistan,2019,AFG-19/3481/RA3/FSAC/INGO/14359,12/31/2020 4:09:41 PM,Internally Displaced People,930,280,0,0,1210,4,0,0,0,4
23,Afghanistan,2019,AFG-19/3481/RA3/FSAC/INGO/14359,12/31/2020 4:09:41 PM,Overall,10152,3348,0,0,13500,13484,16,0,0,13500
23,Afghanistan,2019,AFG-19/3481/RA3/FSAC/INGO/14359,12/31/2020 4:09:41 PM,Returnees,2120,700,0,0,2820,4,0,0,0,4
23,Afghanistan,2019,AFG-19/3481/RA3/FSAC/INGO/14367,12/27/2020 7:04:36 AM,Other,35875,33005,35301,39317,143498,31619,31854,47878,44159,155510
23,Afghanistan,2019,AFG-19/3481/RA3/FSAC/INGO/14367,12/27/2020 7:04:36 AM,Overall,35875,33005,35301,39317,143498,31619,31854,47878,44159,155510
23,Afghanistan,2019,AFG-19/3481/RA3/FSAC/INGO/14393,12/7/2020 8:14:41 AM,Host Communities,14052,14625,16496,17169,62342,12801,9963,18480,18065,59309
23,Afghanistan,2019,AFG-19/3481/RA3/FSAC/INGO/14393,12/7/2020 8:14:41 AM,Internally Displaced People,3272,3407,3841,3998,14518,37,33,70,71,211
23,Afghanistan,2019,AFG-19/3481/RA3/FSAC/INGO/14393,12/7/2020 8:14:41 AM,Overall,19249,20035,22597,23519,85400,12867,10019,18595,18182,59663
23,Afghanistan,2019,AFG-19/3481/RA3/FSAC/INGO/14393,12/7/2020 8:14:41 AM,Returnees,1925,2003,2260,2352,8540,29,23,45,46,143
23,Afghanistan,2019,AFG-19/3481/RA3/FSAC/UN/14366,4/21/2022 7:34:30 AM,Other,148396,136189,209215,207549,701349,181390,181994,255241,245082,863707
23,Afghanistan,2019,AFG-19/3481/RA3/FSAC/UN/14366,4/21/2022 7:34:30 AM,Overall,148396,136189,209215,207549,701349,181390,181994,255241,245082,863707
23,Afghanistan,2019,AFG-19/3481/RA3/H/UN/14224,12/28/2020 5:02:29 AM,Host Communities,8700,5800,2900,1950,19350,8700,5800,2900,1950,19350
23,Afghanistan,2019,AFG-19/3481/RA3/H/UN/14224,12/28/2020 5:02:29 AM,Internally Displaced People,8700,5800,2900,1950,19350,8700,5800,2900,1950,19350
23,Afghanistan,2019,AFG-19/3481/RA3/H/UN/14224,12/28/2020 5:02:29 AM,Overall,17400,11600,5800,3900,38700,17400,11600,5800,3900,38700
23,Afghanistan,2019,AFG-19/3481/RA3/N/UN/14357,12/23/2020 9:52:47 AM,Host Communities,0,0,11098,13564,24662,0,0,11140,13647,24787
23,Afghanistan,2019,AFG-19/3481/RA3/N/UN/14357,12/23/2020 9:52:47 AM,Internally Displaced People,0,0,402,491,893,0,0,353,415,768
23,Afghanistan,2019,AFG-19/3481/RA3/N/UN/14357,12/23/2020 9:52:47 AM,Overall,0,0,11500,14055,25555,0,0,11493,14062,25555
23,Afghanistan,2019,AFG-19/3481/RA3/N/UN/14361,12/17/2020 5:34:31 AM,Host Communities,0,22054,10163,9764,41981,0,20462,9069,10647,40178
23,Afghanistan,2019,AFG-19/3481/RA3/N/UN/14361,12/17/2020 5:34:31 AM,Internally Displaced People,0,3546,1337,1236,6119,0,2478,1106,1298,4882
23,Afghanistan,2019,AFG-19/3481/RA3/N/UN/14361,12/17/2020 5:34:31 AM,Overall,0,25600,11500,11000,48100,0,22940,10175,11945,45060
23,Afghanistan,2019,AFG-19/3481/RA3/WASH/INGO/14312,12/26/2020 5:31:34 PM,Internally Displaced People,25725,26775,26145,26355,105000,13477,18460,32162,27440,91539
23,Afghanistan,2019,AFG-19/3481/RA3/WASH/INGO/14312,12/26/2020 5:31:34 PM,Overall,42875,44625,43575,43925,175000,30467,32658,43880,38598,145603
23,Afghanistan,2019,AFG-19/3481/RA3/WASH/INGO/14312,12/26/2020 5:31:34 PM,Returnees,17150,17850,17430,17570,70000,16990,14198,11718,11158,54064
23,Afghanistan,2019,AFG-19/3481/RA3/WASH/INGO/14316,12/23/2020 3:49:18 AM,Host Communities,18988,20037,32691,33739,105455,20041,21806,34375,37562,113784
23,Afghanistan,2019,AFG-19/3481/RA3/WASH/INGO/14316,12/23/2020 3:49:18 AM,Overall,18988,20037,32691,33739,105455,20041,21806,34375,37562,113784
23,Afghanistan,2019,AFG-19/3481/RA3/WASH/NGO/14253,12/20/2020 6:30:08 AM,Host Communities,4250,4781,8499,9030,26560,3410,3870,5373,6000,18653
23,Afghanistan,2019,AFG-19/3481/RA3/WASH/NGO/14253,12/20/2020 6:30:08 AM,Internally Displaced People,4563,5134,9126,9697,28520,2826,3540,7364,6180,19910
23,Afghanistan,2019,AFG-19/3481/RA3/WASH/NGO/14253,12/20/2020 6:30:08 AM,Overall,12200,13726,24399,25925,76250,8841,10664,18217,18770,56492
23,Afghanistan,2019,AFG-19/3481/RA3/WASH/NGO/14253,12/20/2020 6:30:08 AM,Returnees,3387,3811,6774,7198,21170,2605,3254,5480,6590,17929
23,Afghanistan,2019,AFG-19/3481/RA4/APC/INGO/14849,4/4/2021 11:37:33 AM,Host Communities,1500,1500,1500,1500,6000,781,1067,571,570,2989
23,Afghanistan,2019,AFG-19/3481/RA4/APC/INGO/14849,4/4/2021 11:37:33 AM,Internally Displaced People,3500,3500,3500,3500,14000,8678,9006,5183,5192,28059
23,Afghanistan,2019,AFG-19/3481/RA4/APC/INGO/14849,4/4/2021 11:37:33 AM,Overall,5000,5000,5000,5000,20000,9459,10073,5754,5762,31048
23,Afghanistan,2019,AFG-19/3481/RA4/APC/INGO/14854,10/7/2021 9:25:06 AM,Host Communities,2258,3149,4779,4169,14355,6080,5940,2469,3152,17641
23,Afghanistan,2019,AFG-19/3481/RA4/APC/INGO/14854,10/7/2021 9:25:06 AM,Internally Displaced People,3737,5211,7902,6895,23745,1171,1123,292,212,2798
23,Afghanistan,2019,AFG-19/3481/RA4/APC/INGO/14854,10/7/2021 9:25:06 AM,Overall,7445,10384,15749,13742,47320,7682,7807,3208,4228,22925
23,Afghanistan,2019,AFG-19/3481/RA4/APC/INGO/14854,10/7/2021 9:25:06 AM,Returnees,1450,2024,3068,2678,9220,431,744,447,864,2486
23,Afghanistan,2019,AFG-19/3481/RA4/APC/INGO/14862,5/12/2021 6:57:08 AM,Host Communities,20738,20024,33724,32287,106773,10808,12364,43892,30300,97364
23,Afghanistan,2019,AFG-19/3481/RA4/APC/INGO/14862,5/12/2021 6:57:08 AM,Overall,20738,20024,33724,32287,106773,10808,12364,43892,30300,97364
23,Afghanistan,2019,AFG-19/3481/RA4/APC/NGO/14847,12/14/2020 6:33:48 AM,Host Communities,12890,16950,3000,3000,35840,9220,12470,2951,2258,26899
23,Afghanistan,2019,AFG-19/3481/RA4/APC/NGO/14847,12/14/2020 6:33:48 AM,Internally Displaced People,7000,8000,12000,14000,41000,5412,6184,9321,10410,31327
23,Afghanistan,2019,AFG-19/3481/RA4/APC/NGO/14847,12/14/2020 6:33:48 AM,Other,110,50,0,0,160,90,38,0,0,128
23,Afghanistan,2019,AFG-19/3481/RA4/APC/NGO/14847,12/14/2020 6:33:48 AM,Overall,20000,25000,15000,17000,77000,14722,18692,12272,12668,58354
23,Afghanistan,2019,AFG-19/3481/RA4/APC/UN/14851,6/21/2021 11:02:31 AM,Host Communities,4492,720,318,73,5603,4028,1007,336,84,5455
23,Afghanistan,2019,AFG-19/3481/RA4/APC/UN/14851,6/21/2021 11:02:31 AM,Internally Displaced People,2616,560,57,22,3255,4049,1267,89,36,5441
23,Afghanistan,2019,AFG-19/3481/RA4/APC/UN/14851,6/21/2021 11:02:31 AM,Other,107,4,2,0,113,119,8,2,0,129
23,Afghanistan,2019,AFG-19/3481/RA4/APC/UN/14851,6/21/2021 11:02:31 AM,Overall,8077,1400,422,101,10000,9486,2452,531,128,12597
23,Afghanistan,2019,AFG-19/3481/RA4/APC/UN/14851,6/21/2021 11:02:31 AM,Refugees,4,1,0,0,5,7,0,0,0,7
23,Afghanistan,2019,AFG-19/3481/RA4/APC/UN/14851,6/21/2021 11:02:31 AM,Returnees,858,115,45,6,1024,1283,170,104,8,1565
23,Afghanistan,2019,AFG-19/3481/RA4/FSAC/UN/14864,11/23/2021 9:22:00 AM,Other,65,10,0,0,75,40,7,0,0,47
23,Afghanistan,2019,AFG-19/3481/RA4/FSAC/UN/14864,11/23/2021 9:22:00 AM,Overall,65,10,0,0,75,40,7,0,0,47
23,Afghanistan,2019,AFG-19/3481/RA4/GBV/INGO/14846,4/6/2021 4:34:58 AM,Internally Displaced People,6000,18000,1500,4500,30000,7880,35542,2476,8733,54631
23,Afghanistan,2019,AFG-19/3481/RA4/GBV/INGO/14846,4/6/2021 4:34:58 AM,Overall,6000,18000,1500,4500,30000,7880,35542,2476,8733,54631
23,Afghanistan,2019,AFG-19/3481/RA4/GBV/NGO/14848,10/20/2021 8:13:59 AM,Host Communities,6450,5528,1844,1532,15354,6450,5528,1844,1532,15354
23,Afghanistan,2019,AFG-19/3481/RA4/GBV/NGO/14848,10/20/2021 8:13:59 AM,Internally Displaced People,6451,5529,1844,1536,15360,6451,5529,1844,1536,15360
23,Afghanistan,2019,AFG-19/3481/RA4/GBV/NGO/14848,10/20/2021 8:13:59 AM,Overall,12901,11057,3688,3068,30714,12901,11057,3688,3068,30714
23,Afghanistan,2019,AFG-19/3481/RA4/N/UN/14855,12/13/2020 10:39:07 AM,Host Communities,0,0,8766,10713,19479,0,0,8767,10715,19482
23,Afghanistan,2019,AFG-19/3481/RA4/N/UN/14855,12/13/2020 10:39:07 AM,Internally Displaced People,0,0,300,366,666,0,0,301,367,668
23,Afghanistan,2019,AFG-19/3481/RA4/N/UN/14855,12/13/2020 10:39:07 AM,Overall,0,0,9066,11079,20145,0,0,9068,11082,20150
23,Afghanistan,2019,AFG-19/3481/RA4/N/UN/14863,12/30/2020 9:06:55 AM,Host Communities,0,8931,13796,13255,35982,0,8494,12391,13973,34858
23,Afghanistan,2019,AFG-19/3481/RA4/N/UN/14863,12/30/2020 9:06:55 AM,Internally Displaced People,0,1789,2071,1990,5850,0,1701,1860,2097,5658
23,Afghanistan,2019,AFG-19/3481/RA4/N/UN/14863,12/30/2020 9:06:55 AM,Overall,0,10720,15867,15245,41832,0,10195,14251,16070,40516
23,Afghanistan,2019,AFG-19/3481/SA1/APC/UN/13334,8/9/2020 3:39:16 PM,Host Communities,1615,281,237,117,2250,1908,246,179,43,2376
23,Afghanistan,2019,AFG-19/3481/SA1/APC/UN/13334,8/9/2020 3:39:16 PM,Internally Displaced People,1024,160,38,17,1239,1689,424,52,11,2176
23,Afghanistan,2019,AFG-19/3481/SA1/APC/UN/13334,8/9/2020 3:39:16 PM,Other,38,0,0,0,38,42,2,0,0,44
23,Afghanistan,2019,AFG-19/3481/SA1/APC/UN/13334,8/9/2020 3:39:16 PM,Overall,3075,479,306,140,4000,3991,705,254,54,5004
23,Afghanistan,2019,AFG-19/3481/SA1/APC/UN/13334,8/9/2020 3:39:16 PM,Refugees,38,0,0,0,38,1,0,0,0,1
23,Afghanistan,2019,AFG-19/3481/SA1/APC/UN/13334,8/9/2020 3:39:16 PM,Returnees,360,38,31,6,435,351,33,23,0,407
23,Afghanistan,2019,AFG-19/3481/SA1/CPiE/NGO/13314,2/7/2021 6:52:37 AM,Host Communities,195,185,207,189,776,210,190,210,176,786
23,Afghanistan,2019,AFG-19/3481/SA1/CPiE/NGO/13314,2/7/2021 6:52:37 AM,Internally Displaced People,1170,1110,1242,1134,4656,1230,1150,1260,1146,4786
23,Afghanistan,2019,AFG-19/3481/SA1/CPiE/NGO/13314,2/7/2021 6:52:37 AM,Overall,1950,1850,2070,1890,7760,2045,1860,2150,1837,7892
23,Afghanistan,2019,AFG-19/3481/SA1/CPiE/NGO/13314,2/7/2021 6:52:37 AM,Returnees,585,555,621,567,2328,605,520,680,515,2320
23,Afghanistan,2019,AFG-19/3481/SA1/EIE/INGO/13329,12/17/2020 5:45:32 AM,Host Communities,340,338,1477,2215,4370,300,200,2822,1048,4370
23,Afghanistan,2019,AFG-19/3481/SA1/EIE/INGO/13329,12/17/2020 5:45:32 AM,Internally Displaced People,102,78,443,665,1288,120,60,695,235,1110
23,Afghanistan,2019,AFG-19/3481/SA1/EIE/INGO/13329,12/17/2020 5:45:32 AM,Overall,442,416,1920,2880,5658,420,260,3517,1283,5480
23,Afghanistan,2019,AFG-19/3481/SA1/EIE/INGO/13338,2/1/2021 6:56:27 AM,Host Communities,40,60,1000,1500,2600,32,68,0,162,262
23,Afghanistan,2019,AFG-19/3481/SA1/EIE/INGO/13338,2/1/2021 6:56:27 AM,Internally Displaced People,0,0,500,500,1000,0,0,1573,1765,3338
23,Afghanistan,2019,AFG-19/3481/SA1/EIE/INGO/13338,2/1/2021 6:56:27 AM,Overall,40,60,1500,2000,3600,32,68,1573,1927,3600
23,Afghanistan,2019,AFG-19/3481/SA1/EIE-APC-WASH/NGO/13303,1/3/2021 6:08:51 PM,Other,0,0,3827,4678,8505,0,0,3827,4678,8505
23,Afghanistan,2019,AFG-19/3481/SA1/EIE-APC-WASH/NGO/13303,1/3/2021 6:08:51 PM,Overall,0,0,3827,4678,8505,0,0,3827,4678,8505
23,Afghanistan,2019,AFG-19/3481/SA1/EIE-CPiE/INGO/13302,12/24/2020 6:50:30 AM,Internally Displaced People,1941,1730,5143,5580,14394,1503,502,5141,5347,12493
23,Afghanistan,2019,AFG-19/3481/SA1/EIE-CPiE/INGO/13302,12/24/2020 6:50:30 AM,Overall,1941,1730,5143,5580,14394,1503,502,5141,5347,12493
23,Afghanistan,2019,AFG-19/3481/SA1/EIE-CPiE/INGO/13342,1/25/2021 10:19:20 AM,Host Communities,35,55,900,1300,2290,80,10,1353,858,2301
23,Afghanistan,2019,AFG-19/3481/SA1/EIE-CPiE/INGO/13342,1/25/2021 10:19:20 AM,Internally Displaced People,0,300,500,800,1600,0,300,635,654,1589
23,Afghanistan,2019,AFG-19/3481/SA1/EIE-CPiE/INGO/13342,1/25/2021 10:19:20 AM,Overall,35,355,1400,2100,3890,80,310,1988,1512,3890
23,Afghanistan,2019,AFG-19/3481/SA1/EIE-WASH/INGO/13304,12/30/2020 10:12:53 PM,Host Communities,313,175,4749,3166,8403,5808,1432,9158,7315,23713
23,Afghanistan,2019,AFG-19/3481/SA1/EIE-WASH/INGO/13304,12/30/2020 10:12:53 PM,Internally Displaced People,169,121,3635,3473,7398,3873,945,7167,4365,16350
23,Afghanistan,2019,AFG-19/3481/SA1/EIE-WASH/INGO/13304,12/30/2020 10:12:53 PM,Overall,482,296,8384,6639,15801,9681,2377,16325,11680,40063
23,Afghanistan,2019,AFG-19/3481/SA1/ESNFI/INGO/13310,12/28/2020 8:42:05 AM,Host Communities,562,539,842,808,2751,345,400,795,996,2536
23,Afghanistan,2019,AFG-19/3481/SA1/ESNFI/INGO/13310,12/28/2020 8:42:05 AM,Internally Displaced People,4891,4705,7339,7054,23989,3330,3925,7751,8108,23114
23,Afghanistan,2019,AFG-19/3481/SA1/ESNFI/INGO/13310,12/28/2020 8:42:05 AM,Other,245,231,364,348,1188,155,169,433,532,1289
23,Afghanistan,2019,AFG-19/3481/SA1/ESNFI/INGO/13310,12/28/2020 8:42:05 AM,Overall,5698,5475,8545,8210,27928,3830,4494,8979,9636,26939
23,Afghanistan,2019,AFG-19/3481/SA1/ESNFI/INGO/13311,12/28/2020 2:28:22 PM,Host Communities,368,537,810,735,2450,1385,1013,2639,2517,7554
23,Afghanistan,2019,AFG-19/3481/SA1/ESNFI/INGO/13311,12/28/2020 2:28:22 PM,Internally Displaced People,3315,4834,7286,6615,22050,3041,2208,5578,5200,16027
23,Afghanistan,2019,AFG-19/3481/SA1/ESNFI/INGO/13311,12/28/2020 2:28:22 PM,Overall,3683,5371,8096,7350,24500,4426,3221,8217,7717,23581
23,Afghanistan,2019,AFG-19/3481/SA1/ESNFI/INGO/13312,1/24/2021 9:07:52 AM,Host Communities,394,482,613,701,2190,151,175,233,294,853
23,Afghanistan,2019,AFG-19/3481/SA1/ESNFI/INGO/13312,1/24/2021 9:07:52 AM,Internally Displaced People,3118,3811,4850,5543,17322,4884,5261,6653,7592,24390
23,Afghanistan,2019,AFG-19/3481/SA1/ESNFI/INGO/13312,1/24/2021 9:07:52 AM,Overall,3949,4829,6143,7022,21943,5184,5610,7156,8182,26132
23,Afghanistan,2019,AFG-19/3481/SA1/ESNFI/INGO/13312,1/24/2021 9:07:52 AM,Returnees,437,536,680,778,2431,149,174,270,296,889
23,Afghanistan,2019,AFG-19/3481/SA1/ESNFI/INGO/13313,12/6/2020 5:42:04 PM,Internally Displaced People,1391,1430,682,725,4228,884,969,1401,1400,4654
23,Afghanistan,2019,AFG-19/3481/SA1/ESNFI/INGO/13313,12/6/2020 5:42:04 PM,Overall,1391,1430,682,725,4228,884,969,1401,1400,4654
23,Afghanistan,2019,AFG-19/3481/SA1/ESNFI/INGO/13317,12/28/2020 2:36:52 PM,Internally Displaced People,980,980,420,420,2800,980,980,420,420,2800
23,Afghanistan,2019,AFG-19/3481/SA1/ESNFI/INGO/13317,12/28/2020 2:36:52 PM,Overall,2695,2695,1155,1155,7700,2695,2695,1155,1155,7700
23,Afghanistan,2019,AFG-19/3481/SA1/ESNFI/INGO/13317,12/28/2020 2:36:52 PM,Returnees,1715,1715,735,735,4900,1715,1715,735,735,4900
23,Afghanistan,2019,AFG-19/3481/SA1/ESNFI/INGO/13331,12/31/2020 2:58:41 PM,Internally Displaced People,3747,3822,9524,9907,27000,3824,4217,6847,7139,22027
23,Afghanistan,2019,AFG-19/3481/SA1/ESNFI/INGO/13331,12/31/2020 2:58:41 PM,Overall,3747,3822,9524,9907,27000,3824,4217,6847,7139,22027
23,Afghanistan,2019,AFG-19/3481/SA1/ESNFI/INGO/13344,12/31/2020 8:09:34 AM,Internally Displaced People,2111,2462,3635,3517,11725,1521,1761,3756,3707,10745
23,Afghanistan,2019,AFG-19/3481/SA1/ESNFI/INGO/13344,12/31/2020 8:09:34 AM,Overall,2111,2462,3635,3517,11725,1521,1761,3756,3707,10745
23,Afghanistan,2019,AFG-19/3481/SA1/FSAC/INGO/13301,11/25/2020 8:42:34 AM,Host Communities,7596,7596,10342,10342,35876,8432,8976,12942,12902,43252
23,Afghanistan,2019,AFG-19/3481/SA1/FSAC/INGO/13301,11/25/2020 8:42:34 AM,Overall,7596,7596,10342,10342,35876,8432,8976,12942,12902,43252
23,Afghanistan,2019,AFG-19/3481/SA1/FSAC/INGO/13327,12/22/2020 10:58:57 AM,Other,4542,4314,6533,5329,20718,6687,6943,7381,6761,27772
23,Afghanistan,2019,AFG-19/3481/SA1/FSAC/INGO/13327,12/22/2020 10:58:57 AM,Overall,4542,4314,6533,5329,20718,6687,6943,7381,6761,27772
23,Afghanistan,2019,AFG-19/3481/SA1/FSAC/INGO/13328,12/26/2020 6:26:14 PM,Host Communities,3068,507,0,0,3575,3377,946,0,0,4323
23,Afghanistan,2019,AFG-19/3481/SA1/FSAC/INGO/13328,12/26/2020 6:26:14 PM,Other,1952,823,0,0,2775,1663,364,0,0,2027
23,Afghanistan,2019,AFG-19/3481/SA1/FSAC/INGO/13328,12/26/2020 6:26:14 PM,Overall,5020,1330,0,0,6350,5040,1310,0,0,6350
23,Afghanistan,2019,AFG-19/3481/SA1/FSAC/NGO/13307,12/23/2020 3:46:45 AM,Other,5043,5067,7064,7186,24360,5043,5067,7064,7186,24360
23,Afghanistan,2019,AFG-19/3481/SA1/FSAC/NGO/13307,12/23/2020 3:46:45 AM,Overall,5043,5067,7064,7186,24360,5043,5067,7064,7186,24360
23,Afghanistan,2019,AFG-19/3481/SA1/FSAC/UN/13323,6/6/2021 11:08:29 AM,Other,23829,23742,35425,36004,119000,28456,28196,41315,37987,135954
23,Afghanistan,2019,AFG-19/3481/SA1/FSAC/UN/13323,6/6/2021 11:08:29 AM,Overall,23829,23742,35425,36004,119000,28456,28196,41315,37987,135954
23,Afghanistan,2019,AFG-19/3481/SA1/FSAC-GBV-ESNFI/INGO/13306,2/10/2021 8:27:07 AM,Internally Displaced People,4010,8104,4588,6439,23141,5918,11302,7710,9614,34544
23,Afghanistan,2019,AFG-19/3481/SA1/FSAC-GBV-ESNFI/INGO/13306,2/10/2021 8:27:07 AM,Other,2215,4340,2534,3500,12589,2244,4996,3363,4276,14879
23,Afghanistan,2019,AFG-19/3481/SA1/FSAC-GBV-ESNFI/INGO/13306,2/10/2021 8:27:07 AM,Overall,6225,12444,7122,9939,35730,8162,16298,11073,13890,49423
23,Afghanistan,2019,AFG-19/3481/SA1/GBV-CPiE-APC/INGO/13305,1/31/2021 6:10:35 AM,Host Communities,1650,6624,14087,13786,36147,1616,4070,11702,11258,28646
23,Afghanistan,2019,AFG-19/3481/SA1/GBV-CPiE-APC/INGO/13305,1/31/2021 6:10:35 AM,Overall,2698,9905,18095,17649,48347,2088,5853,13318,12797,34056
23,Afghanistan,2019,AFG-19/3481/SA1/GBV-CPiE-APC/INGO/13305,1/31/2021 6:10:35 AM,Returnees,1048,3281,4008,3863,12200,472,1783,1616,1539,5410
23,Afghanistan,2019,AFG-19/3481/SA1/N/UN/13340,12/31/2020 5:35:30 AM,Host Communities,0,0,13496,16495,29991,0,0,16734,20452,37186
23,Afghanistan,2019,AFG-19/3481/SA1/N/UN/13340,12/31/2020 5:35:30 AM,Internally Displaced People,0,0,259,316,575,0,0,342,417,759
23,Afghanistan,2019,AFG-19/3481/SA1/N/UN/13340,12/31/2020 5:35:30 AM,Overall,0,0,13755,16811,30566,0,0,17076,20869,37945
23,Afghanistan,2020,AFG-20/3481/RA1/H/UN/15062,5/12/2021 6:04:34 AM,Host Communities,130000,110000,30000,30000,300000,89000,71000,20400,14900,195300
23,Afghanistan,2020,AFG-20/3481/RA1/H/UN/15062,5/12/2021 6:04:34 AM,Overall,200000,160000,45000,45000,450000,134500,106500,33000,24600,298600
23,Afghanistan,2020,AFG-20/3481/RA1/H/UN/15062,5/12/2021 6:04:34 AM,Returnees,70000,50000,15000,15000,150000,45500,35500,12600,9700,103300
23,Afghanistan,2020,AFG-20/3481/RA2/CCS/UN/15748,12/23/2020 5:56:18 PM,Other,1810,490,0,0,2300,2096,538,0,0,2634
23,Afghanistan,2020,AFG-20/3481/RA2/CCS/UN/15748,12/23/2020 5:56:18 PM,Overall,1810,490,0,0,2300,2096,538,0,0,2634
23,Afghanistan,2020,AFG-20/3481/RA2/H/INGO/15739,11/26/2020 5:47:29 PM,Host Communities,727,727,1090,1090,3634,296,1325,1119,1725,4465
23,Afghanistan,2020,AFG-20/3481/RA2/H/INGO/15739,11/26/2020 5:47:29 PM,Internally Displaced People,13805,13805,20708,20708,69026,10940,17917,21038,22549,72444
23,Afghanistan,2020,AFG-20/3481/RA2/H/INGO/15739,11/26/2020 5:47:29 PM,Overall,14532,14532,21798,21798,72660,11236,19242,22157,24274,76909
23,Afghanistan,2020,AFG-20/3481/RA2/WASH/INGO/15741,9/25/2023 4:42:08 AM,Host Communities,18500,17340,16360,14630,66830,26675,17096,31946,16369,92086
23,Afghanistan,2020,AFG-20/3481/RA2/WASH/INGO/15741,9/25/2023 4:42:08 AM,Internally Displaced People,2515,2445,2247,2200,9407,6763,5280,6399,5594,24036
23,Afghanistan,2020,AFG-20/3481/RA2/WASH/INGO/15741,9/25/2023 4:42:08 AM,Overall,22485,21104,19707,17779,81075,39418,26957,42310,25718,134403
23,Afghanistan,2020,AFG-20/3481/RA2/WASH/INGO/15741,9/25/2023 4:42:08 AM,Returnees,1470,1319,1100,949,4838,5980,4581,3965,3755,18281
23,Afghanistan,2020,AFG-20/3481/RA2/WASH/INGO/15743,1/14/2021 5:34:25 AM,Host Communities,13850,14416,20775,21624,70665,17286,19481,27653,28409,92829
23,Afghanistan,2020,AFG-20/3481/RA2/WASH/INGO/15743,1/14/2021 5:34:25 AM,Internally Displaced People,1832,1906,2747,2860,9345,4123,4418,4558,4454,17553
23,Afghanistan,2020,AFG-20/3481/RA2/WASH/INGO/15743,1/14/2021 5:34:25 AM,Overall,15682,16322,23522,24484,80010,21409,23899,32211,32863,110382
23,Afghanistan,2020,AFG-20/3481/RA2/WASH/INGO/15744,7/25/2021 5:57:54 AM,Host Communities,34170,34170,45042,41934,155316,22959,25587,36413,39078,124037
23,Afghanistan,2020,AFG-20/3481/RA2/WASH/INGO/15744,7/25/2021 5:57:54 AM,Internally Displaced People,6834,6834,9008,8387,31063,7881,9337,14145,14305,45668
23,Afghanistan,2020,AFG-20/3481/RA2/WASH/INGO/15744,7/25/2021 5:57:54 AM,Overall,45560,45560,60056,55912,207088,32430,36792,53742,56627,179591
23,Afghanistan,2020,AFG-20/3481/RA2/WASH/INGO/15744,7/25/2021 5:57:54 AM,Returnees,4556,4556,6006,5591,20709,1590,1868,3184,3244,9886
23,Afghanistan,2020,AFG-20/3481/RA2/WASH/INGO/15750,5/12/2021 6:34:12 AM,Host Communities,12264,12727,10413,10876,46280,22047,24154,7039,6778,60018
23,Afghanistan,2020,AFG-20/3481/RA2/WASH/INGO/15750,5/12/2021 6:34:12 AM,Internally Displaced People,1116,1162,951,991,4220,977,1076,733,705,3491
23,Afghanistan,2020,AFG-20/3481/RA2/WASH/INGO/15750,5/12/2021 6:34:12 AM,Overall,13380,13889,11364,11867,50500,23024,25230,7772,7483,63509
23,Afghanistan,2020,AFG-20/3481/RA2/WASH/UN/15747,1/24/2021 6:29:56 AM,Internally Displaced People,5009,5009,6602,6150,22770,3850,3850,5075,4725,17500
23,Afghanistan,2020,AFG-20/3481/RA2/WASH/UN/15747,1/24/2021 6:29:56 AM,Other,5918,5918,7800,7264,26900,11374,11374,14993,13959,51700
23,Afghanistan,2020,AFG-20/3481/RA2/WASH/UN/15747,1/24/2021 6:29:56 AM,Overall,16939,16939,22329,20793,77000,16984,16984,22388,20844,77200
23,Afghanistan,2020,AFG-20/3481/RA2/WASH/UN/15747,1/24/2021 6:29:56 AM,Returnees,6012,6012,7927,7379,27330,1760,1760,2320,2160,8000
23,Afghanistan,2020,AFG-20/3481/RA3/APC/INGO/16062,6/21/2021 11:35:28 AM,Host Communities,3108,3592,745,801,8246,3403,1834,30,9,5276
23,Afghanistan,2020,AFG-20/3481/RA3/APC/INGO/16062,6/21/2021 11:35:28 AM,Internally Displaced People,11820,13651,2834,3047,31352,12809,5416,118,61,18404
23,Afghanistan,2020,AFG-20/3481/RA3/APC/INGO/16062,6/21/2021 11:35:28 AM,Overall,20735,23947,4970,5348,55000,22378,9791,204,100,32473
23,Afghanistan,2020,AFG-20/3481/RA3/APC/INGO/16062,6/21/2021 11:35:28 AM,Returnees,5807,6704,1391,1500,15402,6166,2541,56,30,8793
23,Afghanistan,2020,AFG-20/3481/RA3/APC/INGO/16068,12/27/2020 2:35:12 PM,Host Communities,6750,6500,1988,1975,17213,12478,12015,3673,3650,31816
23,Afghanistan,2020,AFG-20/3481/RA3/APC/INGO/16068,12/27/2020 2:35:12 PM,Internally Displaced People,12150,11700,3577,3555,30982,11865,11426,3495,3472,30258
23,Afghanistan,2020,AFG-20/3481/RA3/APC/INGO/16068,12/27/2020 2:35:12 PM,Overall,27000,26000,7950,7900,68850,33621,32376,9901,9836,85734
23,Afghanistan,2020,AFG-20/3481/RA3/APC/INGO/16068,12/27/2020 2:35:12 PM,Returnees,8100,7800,2385,2370,20655,9278,8935,2733,2714,23660
23,Afghanistan,2020,AFG-20/3481/RA3/APC/INGO/16073,5/6/2021 7:56:31 AM,Host Communities,9320,9293,10417,9968,38998,14219,14881,8989,6337,44426
23,Afghanistan,2020,AFG-20/3481/RA3/APC/INGO/16073,5/6/2021 7:56:31 AM,Internally Displaced People,1036,1032,1158,1107,4333,1600,1619,938,598,4755
23,Afghanistan,2020,AFG-20/3481/RA3/APC/INGO/16073,5/6/2021 7:56:31 AM,Overall,10356,10325,11575,11075,43331,15819,16500,9927,6935,49181
23,Afghanistan,2020,AFG-20/3481/RA3/CCS/UN/16109,11/7/2022 6:09:23 AM,Host Communities,7450,70,0,0,7520,6765,95,0,0,6860
23,Afghanistan,2020,AFG-20/3481/RA3/CCS/UN/16109,11/7/2022 6:09:23 AM,Internally Displaced People,413,8,0,0,421,1184,1,0,0,1185
23,Afghanistan,2020,AFG-20/3481/RA3/CCS/UN/16109,11/7/2022 6:09:23 AM,Overall,27776,1386,3900,1300,34362,104131,5210,8818,3080,121239
23,Afghanistan,2020,AFG-20/3481/RA3/CCS/UN/16109,11/7/2022 6:09:23 AM,Returnees,19913,1308,3900,1300,26421,96182,5114,8818,3080,113194
23,Afghanistan,2020,AFG-20/3481/RA3/CPiE/INGO/16083,12/23/2020 4:33:40 AM,Host Communities,0,0,1700,1700,3400,1562,1575,10962,12221,26320
23,Afghanistan,2020,AFG-20/3481/RA3/CPiE/INGO/16083,12/23/2020 4:33:40 AM,Internally Displaced People,1000,1000,10000,10000,22000,1725,2067,16655,17422,37869
23,Afghanistan,2020,AFG-20/3481/RA3/CPiE/INGO/16083,12/23/2020 4:33:40 AM,Overall,2000,2000,20700,20700,45400,4532,5065,36140,38650,84387
23,Afghanistan,2020,AFG-20/3481/RA3/CPiE/INGO/16083,12/23/2020 4:33:40 AM,Returnees,1000,1000,9000,9000,20000,1245,1423,8523,9007,20198
23,Afghanistan,2020,AFG-20/3481/RA3/CPiE/NGO/16075,5/5/2021 6:04:49 AM,Host Communities,8750,8750,1162,1162,19824,5808,7952,1140,857,15757
23,Afghanistan,2020,AFG-20/3481/RA3/CPiE/NGO/16075,5/5/2021 6:04:49 AM,Internally Displaced People,4375,4375,581,582,9913,4511,7144,891,729,13275
23,Afghanistan,2020,AFG-20/3481/RA3/CPiE/NGO/16075,5/5/2021 6:04:49 AM,Overall,17500,17500,2524,2526,40050,14617,20151,3141,2175,40084
23,Afghanistan,2020,AFG-20/3481/RA3/CPiE/NGO/16075,5/5/2021 6:04:49 AM,Returnees,4375,4375,781,782,10313,4298,5055,1110,589,11052
23,Afghanistan,2020,AFG-20/3481/RA3/CPiE-GBV-APC/INGO/16076,4/25/2021 6:34:45 AM,Other,5111,10620,8186,13483,37400,3204,6833,2676,3753,16466
23,Afghanistan,2020,AFG-20/3481/RA3/CPiE-GBV-APC/INGO/16076,4/25/2021 6:34:45 AM,Overall,5111,10620,8186,13483,37400,3204,6833,2676,3753,16466
23,Afghanistan,2020,AFG-20/3481/RA3/FSAC/INGO/16065,11/10/2022 6:09:53 AM,Host Communities,847,1052,969,1072,3940,429,450,614,624,2117
23,Afghanistan,2020,AFG-20/3481/RA3/FSAC/INGO/16065,11/10/2022 6:09:53 AM,Internally Displaced People,7626,9470,8720,9644,35460,6442,7717,14216,14528,42903
23,Afghanistan,2020,AFG-20/3481/RA3/FSAC/INGO/16065,11/10/2022 6:09:53 AM,Overall,8473,10522,9689,10716,39400,6871,8167,14830,15152,45020
23,Afghanistan,2020,AFG-20/3481/RA3/FSAC/INGO/16072,12/30/2020 9:24:54 AM,Host Communities,620,640,1040,1040,3340,12,13,33,34,92
23,Afghanistan,2020,AFG-20/3481/RA3/FSAC/INGO/16072,12/30/2020 9:24:54 AM,Internally Displaced People,2480,2560,4160,4160,13360,2324,2607,6603,6537,18071
23,Afghanistan,2020,AFG-20/3481/RA3/FSAC/INGO/16072,12/30/2020 9:24:54 AM,Overall,3100,3200,5200,5200,16700,2336,2620,6636,6571,18163
23,Afghanistan,2020,AFG-20/3481/RA3/FSAC/INGO/16077,2/21/2021 4:53:30 AM,Internally Displaced People,10780,10395,8855,8470,38500,6724,8273,11467,12246,38710
23,Afghanistan,2020,AFG-20/3481/RA3/FSAC/INGO/16077,2/21/2021 4:53:30 AM,Overall,10780,10395,8855,8470,38500,6724,8273,11467,12246,38710
23,Afghanistan,2020,AFG-20/3481/RA3/FSAC/INGO/16122,4/4/2021 10:08:21 AM,Internally Displaced People,8291,8963,14204,15036,46494,8712,9469,17144,18180,53505
23,Afghanistan,2020,AFG-20/3481/RA3/FSAC/INGO/16122,4/4/2021 10:08:21 AM,Overall,8291,8963,14204,15036,46494,8712,9469,17144,18180,53505
23,Afghanistan,2020,AFG-20/3481/RA3/FSAC/UN/16086,9/15/2021 9:47:15 AM,Host Communities,16662,15617,22284,21905,76468,15495,15831,18863,17179,67368
23,Afghanistan,2020,AFG-20/3481/RA3/FSAC/UN/16086,9/15/2021 9:47:15 AM,Internally Displaced People,9075,8506,12137,11932,41650,11270,11515,13720,12495,49000
23,Afghanistan,2020,AFG-20/3481/RA3/FSAC/UN/16086,9/15/2021 9:47:15 AM,Overall,27339,25624,36563,35942,125468,26765,27346,32583,29674,116368
23,Afghanistan,2020,AFG-20/3481/RA3/FSAC/UN/16086,9/15/2021 9:47:15 AM,Returnees,1602,1501,2142,2105,7350,0,0,0,0,0
23,Afghanistan,2020,AFG-20/3481/RA3/GBV/INGO/16070,9/28/2022 11:55:16 AM,Host Communities,3660,5662,1220,1622,12164,8283,14529,1900,3947,28659
23,Afghanistan,2020,AFG-20/3481/RA3/GBV/INGO/16070,9/28/2022 11:55:16 AM,Internally Displaced People,6595,10197,2200,2924,21916,830,4028,370,433,5661
23,Afghanistan,2020,AFG-20/3481/RA3/GBV/INGO/16070,9/28/2022 11:55:16 AM,Overall,10400,16084,3470,4606,34560,9256,18772,2296,4426,34750
23,Afghanistan,2020,AFG-20/3481/RA3/GBV/INGO/16070,9/28/2022 11:55:16 AM,Returnees,145,225,50,60,480,143,215,26,46,430
23,Afghanistan,2020,AFG-20/3481/RA3/GBV/NGO/16084,12/29/2020 9:38:11 AM,Host Communities,1186,2965,1184,594,5929,1100,2966,954,819,5839
23,Afghanistan,2020,AFG-20/3481/RA3/GBV/NGO/16084,12/29/2020 9:38:11 AM,Internally Displaced People,540,1347,538,270,2695,400,1347,538,500,2785
23,Afghanistan,2020,AFG-20/3481/RA3/GBV/NGO/16084,12/29/2020 9:38:11 AM,Overall,2156,5392,2152,1080,10780,1930,5393,1922,1535,10780
23,Afghanistan,2020,AFG-20/3481/RA3/GBV/NGO/16084,12/29/2020 9:38:11 AM,Returnees,430,1080,430,216,2156,430,1080,430,216,2156
23,Afghanistan,2020,AFG-20/3481/RA3/GBV/NGO/16105,12/30/2020 5:50:38 AM,Host Communities,4860,5717,5983,6242,22802,4860,5717,5983,6242,22802
23,Afghanistan,2020,AFG-20/3481/RA3/GBV/NGO/16105,12/30/2020 5:50:38 AM,Internally Displaced People,6480,7616,7978,8322,30396,6480,7616,7978,8322,30396
23,Afghanistan,2020,AFG-20/3481/RA3/GBV/NGO/16105,12/30/2020 5:50:38 AM,Overall,16200,19050,19944,20806,76000,16200,19050,19944,20806,76000
23,Afghanistan,2020,AFG-20/3481/RA3/GBV/NGO/16105,12/30/2020 5:50:38 AM,Returnees,4860,5717,5983,6242,22802,4860,5717,5983,6242,22802
23,Afghanistan,2020,AFG-20/3481/RA3/GBV-CPiE/INGO/16102,3/24/2021 6:34:58 AM,Host Communities,5450,6950,8895,9335,30630,6350,7768,9870,10120,34108
23,Afghanistan,2020,AFG-20/3481/RA3/GBV-CPiE/INGO/16102,3/24/2021 6:34:58 AM,Internally Displaced People,4590,5310,6955,7725,24580,6123,6230,7459,9160,28972
23,Afghanistan,2020,AFG-20/3481/RA3/GBV-CPiE/INGO/16102,3/24/2021 6:34:58 AM,Overall,12530,15560,19750,21160,69000,15964,18539,22307,24651,81461
23,Afghanistan,2020,AFG-20/3481/RA3/GBV-CPiE/INGO/16102,3/24/2021 6:34:58 AM,Returnees,2490,3300,3900,4100,13790,3491,4541,4978,5371,18381
23,Afghanistan,2020,AFG-20/3481/RA3/H/INGO/16056,2/3/2021 9:41:15 AM,Host Communities,23603,22530,31113,30040,107286,97579,38328,18484,16017,170408
23,Afghanistan,2020,AFG-20/3481/RA3/H/INGO/16056,2/3/2021 9:41:15 AM,Internally Displaced People,13640,13020,17980,17360,62000,69842,28083,12303,11003,121231
23,Afghanistan,2020,AFG-20/3481/RA3/H/INGO/16056,2/3/2021 9:41:15 AM,Other,1177,408,9,9,1603,1050,281,1,1,1333
23,Afghanistan,2020,AFG-20/3481/RA3/H/INGO/16056,2/3/2021 9:41:15 AM,Overall,42820,40158,54902,53009,190889,205490,82521,36186,32359,356556
23,Afghanistan,2020,AFG-20/3481/RA3/H/INGO/16056,2/3/2021 9:41:15 AM,Refugees,4400,4200,5800,5600,20000,37019,15829,5398,5338,63584
23,Afghanistan,2020,AFG-20/3481/RA3/H/INGO/16063,4/25/2021 5:32:08 AM,Host Communities,26743,25664,10965,10531,73903,30671,53978,22437,28378,135464
23,Afghanistan,2020,AFG-20/3481/RA3/H/INGO/16063,4/25/2021 5:32:08 AM,Overall,26743,25664,10965,10531,73903,30671,53978,22437,28378,135464
23,Afghanistan,2020,AFG-20/3481/RA3/H/INGO/16074,3/31/2021 7:13:57 AM,Host Communities,50970,50970,33980,33980,169900,156056,205857,76246,124840,562999
23,Afghanistan,2020,AFG-20/3481/RA3/H/INGO/16074,3/31/2021 7:13:57 AM,Internally Displaced People,4350,4350,2900,2900,14500,4568,3958,2735,2421,13682
23,Afghanistan,2020,AFG-20/3481/RA3/H/INGO/16074,3/31/2021 7:13:57 AM,Other,235,161,0,0,396,422,343,0,0,765
23,Afghanistan,2020,AFG-20/3481/RA3/H/INGO/16074,3/31/2021 7:13:57 AM,Overall,57235,57161,38000,38000,190396,161046,210158,78981,127261,577446
23,Afghanistan,2020,AFG-20/3481/RA3/H/INGO/16074,3/31/2021 7:13:57 AM,Returnees,1680,1680,1120,1120,5600,0,0,0,0,0
23,Afghanistan,2020,AFG-20/3481/RA3/H/INGO/16085,3/31/2021 7:03:37 AM,Host Communities,8054,9999,3601,3546,25200,7503,29800,4813,5278,47394
23,Afghanistan,2020,AFG-20/3481/RA3/H/INGO/16085,3/31/2021 7:03:37 AM,Internally Displaced People,12082,14999,5401,5318,37800,1084,4450,815,779,7128
23,Afghanistan,2020,AFG-20/3481/RA3/H/INGO/16085,3/31/2021 7:03:37 AM,Overall,20136,24998,9002,8864,63000,8587,34250,5628,6057,54522
23,Afghanistan,2020,AFG-20/3481/RA3/H/INGO/16098,3/23/2021 4:10:43 PM,Host Communities,7206,8407,4083,4324,24020,8959,10453,5077,5376,29865
23,Afghanistan,2020,AFG-20/3481/RA3/H/INGO/16098,3/23/2021 4:10:43 PM,Internally Displaced People,7204,8404,4082,4322,24012,8957,10449,5075,5374,29855
23,Afghanistan,2020,AFG-20/3481/RA3/H/INGO/16098,3/23/2021 4:10:43 PM,Overall,18000,21000,10200,10800,60000,22380,26110,12682,13428,74600
23,Afghanistan,2020,AFG-20/3481/RA3/H/INGO/16098,3/23/2021 4:10:43 PM,Returnees,3590,4189,2035,2154,11968,4464,5208,2530,2678,14880
23,Afghanistan,2020,AFG-20/3481/RA3/H/UN/16067,3/23/2021 3:19:25 PM,Host Communities,20000,5000,7000,2000,34000,37276,9319,13047,3728,63370
23,Afghanistan,2020,AFG-20/3481/RA3/H/UN/16067,3/23/2021 3:19:25 PM,Internally Displaced People,9000,2000,4500,1250,16750,16774,3728,8387,2316,31205
23,Afghanistan,2020,AFG-20/3481/RA3/H/UN/16067,3/23/2021 3:19:25 PM,Overall,40000,10000,15000,5000,70000,74552,18638,27957,9319,130466
23,Afghanistan,2020,AFG-20/3481/RA3/H/UN/16067,3/23/2021 3:19:25 PM,Refugees,1000,500,500,250,2250,1864,932,932,479,4207
23,Afghanistan,2020,AFG-20/3481/RA3/H/UN/16067,3/23/2021 3:19:25 PM,Returnees,10000,2500,3000,1500,17000,18638,4659,5591,2796,31684
23,Afghanistan,2020,AFG-20/3481/RA3/H-N/NGO/16057,3/31/2021 7:20:35 AM,Host Communities,78624,85041,30183,30668,224516,166241,161787,61553,63698,453279
23,Afghanistan,2020,AFG-20/3481/RA3/H-N/NGO/16057,3/31/2021 7:20:35 AM,Other,1262,1247,0,0,2509,1315,1280,0,0,2595
23,Afghanistan,2020,AFG-20/3481/RA3/H-N/NGO/16057,3/31/2021 7:20:35 AM,Overall,79886,86288,30183,30668,227025,167556,163067,61553,63698,455874
23,Afghanistan,2020,AFG-20/3481/RA3/H-N/UN/16082,3/29/2021 9:42:54 AM,Host Communities,15044,10044,2250,2162,29500,399000,255000,14000,13000,681000
23,Afghanistan,2020,AFG-20/3481/RA3/H-N/UN/16082,3/29/2021 9:42:54 AM,Overall,15044,10044,2250,2162,29500,399000,255000,14000,13000,681000
23,Afghanistan,2020,AFG-20/3481/RA3/N/INGO/16064,4/25/2021 6:25:55 AM,Host Communities,5184,7776,7474,8366,28800,4648,20793,6276,6579,38296
23,Afghanistan,2020,AFG-20/3481/RA3/N/INGO/16064,4/25/2021 6:25:55 AM,Internally Displaced People,1296,1944,1868,2092,7200,0,0,0,0,0
23,Afghanistan,2020,AFG-20/3481/RA3/N/INGO/16064,4/25/2021 6:25:55 AM,Overall,6480,9720,9342,10458,36000,4648,20793,6276,6579,38296
23,Afghanistan,2020,AFG-20/3481/RA3/N/INGO/16097,4/6/2021 5:43:05 AM,Host Communities,6466,6734,9704,10096,33000,6905,30241,11054,16298,64498
23,Afghanistan,2020,AFG-20/3481/RA3/N/INGO/16097,4/6/2021 5:43:05 AM,Internally Displaced People,1766,1834,2644,2756,9000,2651,5559,3956,4253,16419
23,Afghanistan,2020,AFG-20/3481/RA3/N/INGO/16097,4/6/2021 5:43:05 AM,Overall,8232,8568,12348,12852,42000,9556,35800,15010,20551,80917
23,Afghanistan,2020,AFG-20/3481/RA3/N/UN/16118,6/21/2021 6:36:44 AM,Host Communities,0,6812,14813,14232,35857,0,7207,15163,15511,37881
23,Afghanistan,2020,AFG-20/3481/RA3/N/UN/16118,6/21/2021 6:36:44 AM,Overall,0,6812,14813,14232,35857,0,7207,15163,15511,37881
23,Afghanistan,2020,AFG-20/3481/RA3/N/UN/16123,1/28/2021 8:15:31 AM,Host Communities,0,0,9385,11471,20856,0,0,10283,12568,22851
23,Afghanistan,2020,AFG-20/3481/RA3/N/UN/16123,1/28/2021 8:15:31 AM,Overall,0,0,9385,11471,20856,0,0,10283,12568,22851
23,Afghanistan,2020,AFG-20/3481/RA5/APC/INGO/17222,10/21/2021 11:26:07 AM,Host Communities,1889,1883,1340,1343,6455,3077,7161,4348,3339,17925
23,Afghanistan,2020,AFG-20/3481/RA5/APC/INGO/17222,10/21/2021 11:26:07 AM,Internally Displaced People,257,256,182,183,878,773,2433,1589,1183,5978
23,Afghanistan,2020,AFG-20/3481/RA5/APC/INGO/17222,10/21/2021 11:26:07 AM,Overall,2146,2139,1522,1526,7333,3850,9594,5937,4522,23903
23,Afghanistan,2020,AFG-20/3481/RA5/APC/INGO/17255,8/8/2021 10:13:11 AM,Host Communities,835,841,569,573,2818,933,895,518,442,2788
23,Afghanistan,2020,AFG-20/3481/RA5/APC/INGO/17255,8/8/2021 10:13:11 AM,Internally Displaced People,1026,1033,693,699,3451,942,986,750,830,3508
23,Afghanistan,2020,AFG-20/3481/RA5/APC/INGO/17255,8/8/2021 10:13:11 AM,Overall,1885,1892,1274,1285,6336,1885,1892,1274,1285,6336
23,Afghanistan,2020,AFG-20/3481/RA5/APC/INGO/17255,8/8/2021 10:13:11 AM,Returnees,24,18,12,13,67,10,11,6,13,40
23,Afghanistan,2020,AFG-20/3481/RA5/APC/UN/17241,11/22/2021 3:11:55 PM,Host Communities,394,392,566,538,1890,1076,1366,1844,1780,6066
23,Afghanistan,2020,AFG-20/3481/RA5/APC/UN/17241,11/22/2021 3:11:55 PM,Internally Displaced People,767,762,1100,1043,3672,86,107,156,120,469
23,Afghanistan,2020,AFG-20/3481/RA5/APC/UN/17241,11/22/2021 3:11:55 PM,Overall,2048,2033,2936,2783,9800,2078,2359,3662,3560,11659
23,Afghanistan,2020,AFG-20/3481/RA5/APC/UN/17241,11/22/2021 3:11:55 PM,Refugees,234,232,336,317,1119,0,0,0,0,0
23,Afghanistan,2020,AFG-20/3481/RA5/APC/UN/17241,11/22/2021 3:11:55 PM,Returnees,653,647,934,885,3119,916,886,1662,1660,5124
23,Afghanistan,2020,AFG-20/3481/RA5/CPiE/INGO/17228,9/19/2021 8:43:39 AM,Host Communities,213,211,686,680,1790,1014,585,1340,1608,4547
23,Afghanistan,2020,AFG-20/3481/RA5/CPiE/INGO/17228,9/19/2021 8:43:39 AM,Internally Displaced People,1917,1899,6174,6126,16116,2494,2494,7035,4615,16638
23,Afghanistan,2020,AFG-20/3481/RA5/CPiE/INGO/17228,9/19/2021 8:43:39 AM,Overall,2130,2110,6860,6806,17906,3508,3079,8375,6223,21185
23,Afghanistan,2020,AFG-20/3481/RA5/CPiE-GBV/INGO/17232,9/15/2021 10:41:21 AM,Host Communities,2100,2520,2713,3133,10466,2200,2444,2574,3107,10325
23,Afghanistan,2020,AFG-20/3481/RA5/CPiE-GBV/INGO/17232,9/15/2021 10:41:21 AM,Internally Displaced People,600,720,775,895,2990,673,1031,974,1050,3728
23,Afghanistan,2020,AFG-20/3481/RA5/CPiE-GBV/INGO/17232,9/15/2021 10:41:21 AM,Overall,3000,3600,3875,4475,14950,3224,3811,3984,4579,15598
23,Afghanistan,2020,AFG-20/3481/RA5/CPiE-GBV/INGO/17232,9/15/2021 10:41:21 AM,Returnees,300,360,387,447,1494,351,336,436,422,1545
23,Afghanistan,2020,AFG-20/3481/RA5/EIE/INGO/17218,10/26/2021 6:36:35 AM,Host Communities,730,587,22936,18451,42704,937,269,25831,16220,43257
23,Afghanistan,2020,AFG-20/3481/RA5/EIE/INGO/17218,10/26/2021 6:36:35 AM,Internally Displaced People,2,3,62,56,123,1,5,92,91,189
23,Afghanistan,2020,AFG-20/3481/RA5/EIE/INGO/17218,10/26/2021 6:36:35 AM,Overall,738,595,23192,18649,43174,938,280,26024,16403,43645
23,Afghanistan,2020,AFG-20/3481/RA5/EIE/INGO/17218,10/26/2021 6:36:35 AM,Returnees,6,5,194,142,347,0,6,101,92,199
23,Afghanistan,2020,AFG-20/3481/RA5/EIE/INGO/17237,9/15/2021 10:49:41 AM,Host Communities,2137,1397,40953,34363,78850,2540,857,44723,30730,78850
23,Afghanistan,2020,AFG-20/3481/RA5/EIE/INGO/17237,9/15/2021 10:49:41 AM,Internally Displaced People,238,155,4550,3818,8761,238,155,4550,3818,8761
23,Afghanistan,2020,AFG-20/3481/RA5/EIE/INGO/17237,9/15/2021 10:49:41 AM,Overall,2375,1552,45503,38181,87611,2778,1012,49273,34548,87611
23,Afghanistan,2020,AFG-20/3481/RA5/EIE/NGO/17250,4/28/2022 9:22:09 AM,Host Communities,240,780,7927,11890,20837,3600,3060,29600,3640,39900
23,Afghanistan,2020,AFG-20/3481/RA5/EIE/NGO/17250,4/28/2022 9:22:09 AM,Internally Displaced People,40,76,4756,7134,12006,30,18,60,92,200
23,Afghanistan,2020,AFG-20/3481/RA5/EIE/NGO/17250,4/28/2022 9:22:09 AM,Overall,290,876,15854,23780,40800,3770,3200,29900,3930,40800
23,Afghanistan,2020,AFG-20/3481/RA5/EIE/NGO/17250,4/28/2022 9:22:09 AM,Refugees,0,0,793,1189,1982,80,90,140,90,400
23,Afghanistan,2020,AFG-20/3481/RA5/EIE/NGO/17250,4/28/2022 9:22:09 AM,Returnees,10,20,2378,3567,5975,60,32,100,108,300
23,Afghanistan,2020,AFG-20/3481/RA5/ESNFI/INGO/17211,5/24/2021 1:06:47 PM,Host Communities,1600,1650,2400,2500,8150,1267,1368,1859,2017,6511
23,Afghanistan,2020,AFG-20/3481/RA5/ESNFI/INGO/17211,5/24/2021 1:06:47 PM,Internally Displaced People,90,70,50,40,250,44,53,67,81,245
23,Afghanistan,2020,AFG-20/3481/RA5/ESNFI/INGO/17211,5/24/2021 1:06:47 PM,Overall,1690,1720,2450,2540,8400,1311,1421,1926,2098,6756
23,Afghanistan,2020,AFG-20/3481/RA5/ESNFI/INGO/17212,8/11/2021 9:48:37 AM,Host Communities,189,277,416,378,1260,234,295,571,525,1625
23,Afghanistan,2020,AFG-20/3481/RA5/ESNFI/INGO/17212,8/11/2021 9:48:37 AM,Internally Displaced People,719,1053,1580,1436,4788,1040,1276,2180,2117,6613
23,Afghanistan,2020,AFG-20/3481/RA5/ESNFI/INGO/17212,8/11/2021 9:48:37 AM,Overall,1261,1847,2772,2520,8400,1441,1787,3152,3043,9423
23,Afghanistan,2020,AFG-20/3481/RA5/ESNFI/INGO/17212,8/11/2021 9:48:37 AM,Returnees,353,517,776,706,2352,167,216,401,401,1185
23,Afghanistan,2020,AFG-20/3481/RA5/ESNFI/INGO/17213,5/19/2021 3:29:22 AM,Host Communities,233,250,297,277,1057,25,42,63,62,192
23,Afghanistan,2020,AFG-20/3481/RA5/ESNFI/INGO/17213,5/19/2021 3:29:22 AM,Internally Displaced People,1750,1900,2250,2151,8051,1598,1709,3005,2976,9288
23,Afghanistan,2020,AFG-20/3481/RA5/ESNFI/INGO/17213,5/19/2021 3:29:22 AM,Overall,2233,2519,2970,2778,10500,1778,1911,3430,3389,10508
23,Afghanistan,2020,AFG-20/3481/RA5/ESNFI/INGO/17213,5/19/2021 3:29:22 AM,Returnees,250,369,423,350,1392,155,160,362,351,1028
23,Afghanistan,2020,AFG-20/3481/RA5/ESNFI/INGO/17220,5/11/2021 6:24:40 AM,Host Communities,4284,4284,7854,7378,23800,4284,4284,7854,7378,23800
23,Afghanistan,2020,AFG-20/3481/RA5/ESNFI/INGO/17220,5/11/2021 6:24:40 AM,Overall,4284,4284,7854,7378,23800,4284,4284,7854,7378,23800
23,Afghanistan,2020,AFG-20/3481/RA5/ESNFI/INGO/17223,6/6/2021 6:25:25 AM,Host Communities,858,892,858,892,3500,993,1002,496,470,2961
23,Afghanistan,2020,AFG-20/3481/RA5/ESNFI/INGO/17223,6/6/2021 6:25:25 AM,Internally Displaced People,1372,1428,1372,1428,5600,1590,1602,795,750,4737
23,Afghanistan,2020,AFG-20/3481/RA5/ESNFI/INGO/17223,6/6/2021 6:25:25 AM,Overall,2230,2320,2230,2320,9100,2583,2604,1291,1220,7698
23,Afghanistan,2020,AFG-20/3481/RA5/ESNFI/INGO/17231,9/15/2021 10:07:47 AM,Host Communities,1064,1064,1792,1680,5600,1186,1579,1890,1851,6506
23,Afghanistan,2020,AFG-20/3481/RA5/ESNFI/INGO/17231,9/15/2021 10:07:47 AM,Internally Displaced People,200,200,336,315,1051,158,211,256,245,870
23,Afghanistan,2020,AFG-20/3481/RA5/ESNFI/INGO/17231,9/15/2021 10:07:47 AM,Overall,1330,1330,2240,2100,7000,1355,1808,2156,2115,7434
23,Afghanistan,2020,AFG-20/3481/RA5/ESNFI/INGO/17231,9/15/2021 10:07:47 AM,Returnees,66,66,112,105,349,11,18,10,19,58
23,Afghanistan,2020,AFG-20/3481/RA5/ESNFI/INGO/17257,10/28/2021 7:31:24 AM,Host Communities,1600,1536,0,0,3136,1931,1903,0,0,3834
23,Afghanistan,2020,AFG-20/3481/RA5/ESNFI/INGO/17257,10/28/2021 7:31:24 AM,Overall,1600,1536,0,0,3136,1931,1903,0,0,3834
23,Afghanistan,2020,AFG-20/3481/RA5/ESNFI/INGO/17264,8/9/2021 7:45:25 AM,Host Communities,57,80,121,105,363,145,99,195,163,602
23,Afghanistan,2020,AFG-20/3481/RA5/ESNFI/INGO/17264,8/9/2021 7:45:25 AM,Internally Displaced People,513,716,1086,948,3263,887,602,1183,1024,3696
23,Afghanistan,2020,AFG-20/3481/RA5/ESNFI/INGO/17264,8/9/2021 7:45:25 AM,Overall,570,796,1207,1053,3626,1032,701,1378,1187,4298
23,Afghanistan,2020,AFG-20/3481/RA5/ESNFI/INGO/17289,8/9/2021 7:42:39 AM,Host Communities,187,195,229,238,849,159,233,466,414,1272
23,Afghanistan,2020,AFG-20/3481/RA5/ESNFI/INGO/17289,8/9/2021 7:42:39 AM,Internally Displaced People,559,586,687,712,2544,428,379,700,711,2218
23,Afghanistan,2020,AFG-20/3481/RA5/ESNFI/INGO/17289,8/9/2021 7:42:39 AM,Overall,933,976,1145,1188,4242,688,734,1376,1308,4106
23,Afghanistan,2020,AFG-20/3481/RA5/ESNFI/INGO/17289,8/9/2021 7:42:39 AM,Returnees,187,195,229,238,849,101,122,210,183,616
23,Afghanistan,2020,AFG-20/3481/RA5/ESNFI/NGO/17229,5/11/2021 6:22:14 AM,Host Communities,365,443,520,598,1926,365,443,520,598,1926
23,Afghanistan,2020,AFG-20/3481/RA5/ESNFI/NGO/17229,5/11/2021 6:22:14 AM,Internally Displaced People,458,554,650,747,2409,458,554,650,747,2409
23,Afghanistan,2020,AFG-20/3481/RA5/ESNFI/NGO/17229,5/11/2021 6:22:14 AM,Overall,1143,1385,1624,1868,6020,1143,1385,1624,1868,6020
23,Afghanistan,2020,AFG-20/3481/RA5/ESNFI/NGO/17229,5/11/2021 6:22:14 AM,Returnees,320,388,454,523,1685,320,388,454,523,1685
23,Afghanistan,2020,AFG-20/3481/RA5/ESNFI-FSAC/INGO/17208,5/11/2021 6:28:42 AM,Host Communities,1088,1472,1984,1856,6400,947,1297,1591,1573,5408
23,Afghanistan,2020,AFG-20/3481/RA5/ESNFI-FSAC/INGO/17208,5/11/2021 6:28:42 AM,Internally Displaced People,318,431,580,543,1872,220,295,371,490,1376
23,Afghanistan,2020,AFG-20/3481/RA5/ESNFI-FSAC/INGO/17208,5/11/2021 6:28:42 AM,Overall,1441,1951,2629,2459,8480,1205,1640,2027,2136,7008
23,Afghanistan,2020,AFG-20/3481/RA5/ESNFI-FSAC/INGO/17208,5/11/2021 6:28:42 AM,Returnees,35,48,65,60,208,38,48,65,73,224
23,Afghanistan,2020,AFG-20/3481/RA5/ESNFI-FSAC/INGO/17217,9/15/2021 10:16:30 AM,Host Communities,1457,1752,2207,2493,7909,1900,2031,3189,2974,10094
23,Afghanistan,2020,AFG-20/3481/RA5/ESNFI-FSAC/INGO/17217,9/15/2021 10:16:30 AM,Overall,1457,1752,2207,2493,7909,1900,2031,3189,2974,10094
23,Afghanistan,2020,AFG-20/3481/RA5/FSAC/INGO/17210,9/15/2021 10:18:48 AM,Host Communities,3301,3301,6052,5685,18339,2178,3717,7858,8871,22624
23,Afghanistan,2020,AFG-20/3481/RA5/FSAC/INGO/17210,9/15/2021 10:18:48 AM,Overall,3301,3301,6052,5685,18339,2178,3717,7858,8871,22624
23,Afghanistan,2020,AFG-20/3481/RA5/FSAC/INGO/17234,7/16/2023 9:24:18 AM,Other,3225,4005,3690,4080,15000,3363,3547,4829,4914,16653
23,Afghanistan,2020,AFG-20/3481/RA5/FSAC/INGO/17234,7/16/2023 9:24:18 AM,Overall,3225,4005,3690,4080,15000,3363,3547,4829,4914,16653
23,Afghanistan,2020,AFG-20/3481/RA5/FSAC/NGO/17252,9/29/2021 9:14:57 AM,Host Communities,4100,5400,5000,5500,20000,4200,5749,4657,5394,20000
23,Afghanistan,2020,AFG-20/3481/RA5/FSAC/NGO/17252,9/29/2021 9:14:57 AM,Overall,4100,5400,5000,5500,20000,4200,5749,4657,5394,20000
23,Afghanistan,2020,AFG-20/3481/RA5/GBV/INGO/17246,12/28/2022 8:51:08 AM,Host Communities,3392,9188,1004,2628,16212,2230,4262,1184,1684,9360
23,Afghanistan,2020,AFG-20/3481/RA5/GBV/INGO/17246,12/28/2022 8:51:08 AM,Internally Displaced People,4388,12120,1340,3500,21348,448,1093,232,511,2284
23,Afghanistan,2020,AFG-20/3481/RA5/GBV/INGO/17246,12/28/2022 8:51:08 AM,Overall,7936,21740,2392,6252,38320,2684,5362,1424,2205,11675
23,Afghanistan,2020,AFG-20/3481/RA5/GBV/INGO/17246,12/28/2022 8:51:08 AM,Returnees,156,432,48,124,760,6,7,8,10,31
23,Afghanistan,2020,AFG-20/3481/RA5/H/INGO/17207,5/5/2022 8:50:50 AM,Host Communities,1281,1475,505,621,3882,610,862,681,771,2924
23,Afghanistan,2020,AFG-20/3481/RA5/H/INGO/17207,5/5/2022 8:50:50 AM,Other,182,110,0,0,292,127,143,0,0,270
23,Afghanistan,2020,AFG-20/3481/RA5/H/INGO/17207,5/5/2022 8:50:50 AM,Overall,12722,14550,4940,6080,38292,10352,14304,10973,11836,47465
23,Afghanistan,2020,AFG-20/3481/RA5/H/INGO/17207,5/5/2022 8:50:50 AM,Refugees,11259,12965,4435,5459,34118,9615,13299,10292,11065,44271
23,Afghanistan,2020,AFG-20/3481/RA5/H/INGO/17215,9/15/2021 9:57:19 AM,Host Communities,10661,10208,2656,2552,26077,6303,26609,4693,8890,46495
23,Afghanistan,2020,AFG-20/3481/RA5/H/INGO/17215,9/15/2021 9:57:19 AM,Internally Displaced People,15990,15311,3984,3828,39113,2894,12366,1908,3320,20488
23,Afghanistan,2020,AFG-20/3481/RA5/H/INGO/17215,9/15/2021 9:57:19 AM,Overall,26651,25519,6640,6380,65190,9197,38975,6601,12210,66983
23,Afghanistan,2020,AFG-20/3481/RA5/H/INGO/17219,4/19/2022 8:30:41 AM,Host Communities,5000,10892,7000,10000,32892,18901,25555,6134,7590,58180
23,Afghanistan,2020,AFG-20/3481/RA5/H/INGO/17219,4/19/2022 8:30:41 AM,Internally Displaced People,10004,21000,18129,25867,75000,23837,46785,7102,8406,86130
23,Afghanistan,2020,AFG-20/3481/RA5/H/INGO/17219,4/19/2022 8:30:41 AM,Overall,15004,31892,25129,35867,107892,42738,72340,13236,15996,144310
23,Afghanistan,2020,AFG-20/3481/RA5/H/INGO/17239,4/19/2022 9:37:23 AM,Host Communities,24580,22987,29234,27863,104664,225023,152219,116254,102288,595784
23,Afghanistan,2020,AFG-20/3481/RA5/H/INGO/17239,4/19/2022 9:37:23 AM,Internally Displaced People,2171,2487,2005,2070,8733,3276,2755,2823,2325,11179
23,Afghanistan,2020,AFG-20/3481/RA5/H/INGO/17239,4/19/2022 9:37:23 AM,Overall,26751,25474,31239,29933,113397,228299,154974,119077,104613,606963
23,Afghanistan,2020,AFG-20/3481/RA5/H/INGO/17256,4/19/2022 9:58:37 AM,Host Communities,4835,7515,1845,2202,16397,9913,23603,3991,4202,41709
23,Afghanistan,2020,AFG-20/3481/RA5/H/INGO/17256,4/19/2022 9:58:37 AM,Internally Displaced People,2245,3465,963,1121,7794,1420,3455,251,267,5393
23,Afghanistan,2020,AFG-20/3481/RA5/H/INGO/17256,4/19/2022 9:58:37 AM,Overall,7555,11565,2975,3520,25615,11370,27305,4247,4475,47397
23,Afghanistan,2020,AFG-20/3481/RA5/H/INGO/17256,4/19/2022 9:58:37 AM,Returnees,475,585,167,197,1424,37,247,5,6,295
23,Afghanistan,2020,AFG-20/3481/RA5/H/NGO/17227,4/19/2022 10:25:45 AM,Host Communities,7649,7543,2896,2456,20544,7903,9681,2781,3675,24040
23,Afghanistan,2020,AFG-20/3481/RA5/H/NGO/17227,4/19/2022 10:25:45 AM,Other,28,24,0,0,52,43,27,0,0,70
23,Afghanistan,2020,AFG-20/3481/RA5/H/NGO/17227,4/19/2022 10:25:45 AM,Overall,7677,7567,2896,2456,20596,7946,9708,2781,3675,24110
23,Afghanistan,2020,AFG-20/3481/RA5/H-APC/INGO/17230,4/27/2022 10:44:45 AM,Host Communities,19244,18406,10143,9155,56948,48369,43511,27636,22417,141933
23,Afghanistan,2020,AFG-20/3481/RA5/H-APC/INGO/17230,4/27/2022 10:44:45 AM,Internally Displaced People,22923,22082,12421,11583,69009,19385,14746,9684,7456,51271
23,Afghanistan,2020,AFG-20/3481/RA5/H-APC/INGO/17230,4/27/2022 10:44:45 AM,Other,6266,1041,2402,731,10440,17534,7053,12400,5507,42494
23,Afghanistan,2020,AFG-20/3481/RA5/H-APC/INGO/17230,4/27/2022 10:44:45 AM,Overall,48433,41529,24966,21469,136397,85288,65310,49720,35380,235698
23,Afghanistan,2020,AFG-20/3481/RA5/WASH/INGO/17209,11/11/2021 7:05:24 AM,Host Communities,41544,66211,11684,10386,129825,50300,80164,14146,12574,157184
23,Afghanistan,2020,AFG-20/3481/RA5/WASH/INGO/17209,11/11/2021 7:05:24 AM,Internally Displaced People,2216,3532,623,555,6926,2647,4220,744,662,8273
23,Afghanistan,2020,AFG-20/3481/RA5/WASH/INGO/17209,11/11/2021 7:05:24 AM,Overall,43760,69743,12307,10941,136751,52947,84384,14890,13236,165457
23,Afghanistan,2020,AFG-20/3481/RA5/WASH/INGO/17214,7/31/2021 6:36:53 PM,Host Communities,638,678,1317,1357,3990,1367,1510,863,898,4638
23,Afghanistan,2020,AFG-20/3481/RA5/WASH/INGO/17214,7/31/2021 6:36:53 PM,Internally Displaced People,3405,3618,7022,7235,21280,6351,6320,3695,3885,20251
23,Afghanistan,2020,AFG-20/3481/RA5/WASH/INGO/17214,7/31/2021 6:36:53 PM,Overall,4256,4522,8778,9044,26600,8904,9046,5276,5536,28762
23,Afghanistan,2020,AFG-20/3481/RA5/WASH/INGO/17214,7/31/2021 6:36:53 PM,Returnees,213,226,439,452,1330,1186,1216,718,753,3873
23,Afghanistan,2020,AFG-20/3481/RA5/WASH/INGO/17216,7/5/2021 7:37:50 AM,Host Communities,21892,18891,22140,22126,85049,23628,20071,23401,22909,90009
23,Afghanistan,2020,AFG-20/3481/RA5/WASH/INGO/17216,7/5/2021 7:37:50 AM,Overall,23509,20106,23011,22739,89365,26821,22077,26112,25461,100471
23,Afghanistan,2020,AFG-20/3481/RA5/WASH/INGO/17216,7/5/2021 7:37:50 AM,Returnees,1617,1215,871,613,4316,3193,2006,2711,2552,10462
23,Afghanistan,2020,AFG-20/3481/RA5/WASH/INGO/17247,4/19/2022 11:36:08 AM,Host Communities,16709,16709,21266,21266,75950,20917,21394,16189,16566,75066
23,Afghanistan,2020,AFG-20/3481/RA5/WASH/INGO/17247,4/19/2022 11:36:08 AM,Internally Displaced People,3580,3581,4557,4557,16275,25009,24072,26971,25349,101401
23,Afghanistan,2020,AFG-20/3481/RA5/WASH/INGO/17247,4/19/2022 11:36:08 AM,Overall,23869,23871,30380,30380,108500,50673,50007,48194,46550,195424
23,Afghanistan,2020,AFG-20/3481/RA5/WASH/INGO/17247,4/19/2022 11:36:08 AM,Returnees,3580,3581,4557,4557,16275,4747,4541,5034,4635,18957
23,Afghanistan,2020,AFG-20/3481/RA6/APC/INGO/17753,8/11/2021 7:11:12 AM,Host Communities,337,995,274,504,2110,554,948,35,18,1555
23,Afghanistan,2020,AFG-20/3481/RA6/APC/INGO/17753,8/11/2021 7:11:12 AM,Internally Displaced People,1278,3742,1041,1920,7981,5108,7843,116,138,13205
23,Afghanistan,2020,AFG-20/3481/RA6/APC/INGO/17753,8/11/2021 7:11:12 AM,Overall,2244,6579,1826,3351,14000,5718,9065,151,156,15090
23,Afghanistan,2020,AFG-20/3481/RA6/APC/INGO/17753,8/11/2021 7:11:12 AM,Returnees,629,1842,511,927,3909,56,274,0,0,330
23,Afghanistan,2020,AFG-20/3481/RA6/CPiE/INGO/17701,11/10/2021 7:33:14 AM,Other,1250,1250,1250,1250,5000,37,37,418,116,608
23,Afghanistan,2020,AFG-20/3481/RA6/CPiE/INGO/17701,11/10/2021 7:33:14 AM,Overall,1250,1250,1250,1250,5000,37,37,418,116,608
23,Afghanistan,2020,AFG-20/3481/RA6/CPiE/INGO/17703,10/20/2021 12:17:16 PM,Host Communities,38,912,2350,2375,5675,337,1422,2545,2723,7027
23,Afghanistan,2020,AFG-20/3481/RA6/CPiE/INGO/17703,10/20/2021 12:17:16 PM,Internally Displaced People,40,900,2250,2445,5635,346,1177,2239,2779,6541
23,Afghanistan,2020,AFG-20/3481/RA6/CPiE/INGO/17703,10/20/2021 12:17:16 PM,Overall,110,2612,6400,6820,15942,964,3555,5790,6307,16616
23,Afghanistan,2020,AFG-20/3481/RA6/CPiE/INGO/17703,10/20/2021 12:17:16 PM,Returnees,32,800,1800,2000,4632,281,956,1006,805,3048
23,Afghanistan,2020,AFG-20/3481/RA6/ESNFI/INGO/17702,6/7/2021 5:04:01 AM,Host Communities,605,739,942,1077,3363,986,1205,1532,1752,5475
23,Afghanistan,2020,AFG-20/3481/RA6/ESNFI/INGO/17702,6/7/2021 5:04:01 AM,Internally Displaced People,83,102,130,148,463,194,237,302,346,1079
23,Afghanistan,2020,AFG-20/3481/RA6/ESNFI/INGO/17702,6/7/2021 5:04:01 AM,Overall,1207,1476,1880,2150,6713,1209,1478,1879,2149,6715
23,Afghanistan,2020,AFG-20/3481/RA6/ESNFI/INGO/17702,6/7/2021 5:04:01 AM,Returnees,519,635,808,925,2887,29,36,45,51,161
23,Afghanistan,2020,AFG-20/3481/RA6/ESNFI/INGO/17706,8/8/2021 10:38:51 AM,Host Communities,1432,1432,2148,2149,7161,974,1218,2313,2133,6638
23,Afghanistan,2020,AFG-20/3481/RA6/ESNFI/INGO/17706,8/8/2021 10:38:51 AM,Internally Displaced People,1715,1715,2572,2573,8575,1567,1991,3471,3213,10242
23,Afghanistan,2020,AFG-20/3481/RA6/ESNFI/INGO/17706,8/8/2021 10:38:51 AM,Overall,3147,3147,4720,4722,15736,2541,3209,5784,5346,16880
23,Afghanistan,2020,AFG-20/3481/RA6/ESNFI/INGO/17707,4/21/2022 10:25:39 AM,Host Communities,3223,3223,5909,5551,17906,3223,3223,5909,5551,17906
23,Afghanistan,2020,AFG-20/3481/RA6/ESNFI/INGO/17707,4/21/2022 10:25:39 AM,Internally Displaced People,743,743,1363,1281,4130,743,743,1363,1281,4130
23,Afghanistan,2020,AFG-20/3481/RA6/ESNFI/INGO/17707,4/21/2022 10:25:39 AM,Overall,3966,3966,7272,6832,22036,3966,3966,7272,6832,22036
23,Afghanistan,2020,AFG-20/3481/RA6/ESNFI/INGO/17708,7/5/2021 6:20:00 AM,Internally Displaced People,3841,4307,4449,4563,17160,3750,3706,5578,5914,18948
23,Afghanistan,2020,AFG-20/3481/RA6/ESNFI/INGO/17708,7/5/2021 6:20:00 AM,Overall,3841,4307,4449,4563,17160,3750,3706,5578,5914,18948
23,Afghanistan,2020,AFG-20/3481/RA6/ESNFI/INGO/17711,7/31/2021 6:31:07 PM,Host Communities,2245,2090,1781,1626,7742,1581,2278,3782,4395,12036
23,Afghanistan,2020,AFG-20/3481/RA6/ESNFI/INGO/17711,7/31/2021 6:31:07 PM,Internally Displaced People,1112,1036,882,806,3836,521,594,1157,1242,3514
23,Afghanistan,2020,AFG-20/3481/RA6/ESNFI/INGO/17711,7/31/2021 6:31:07 PM,Overall,4618,4299,3663,3345,15925,2522,3344,5764,6495,18125
23,Afghanistan,2020,AFG-20/3481/RA6/ESNFI/INGO/17711,7/31/2021 6:31:07 PM,Returnees,1261,1173,1000,913,4347,420,472,825,858,2575
23,Afghanistan,2020,AFG-20/3481/RA6/ESNFI/INGO/17720,10/20/2021 7:33:49 AM,Host Communities,3684,3498,3684,3498,14364,5502,6058,1446,1487,14493
23,Afghanistan,2020,AFG-20/3481/RA6/ESNFI/INGO/17720,10/20/2021 7:33:49 AM,Internally Displaced People,135,128,135,127,525,125,136,48,59,368
23,Afghanistan,2020,AFG-20/3481/RA6/ESNFI/INGO/17720,10/20/2021 7:33:49 AM,Overall,3819,3626,3819,3625,14889,5627,6194,1494,1546,14861
23,Afghanistan,2020,AFG-20/3481/RA6/ESNFI/INGO/17777,8/11/2021 7:12:59 AM,Host Communities,74,67,109,100,350,317,405,631,620,1973
23,Afghanistan,2020,AFG-20/3481/RA6/ESNFI/INGO/17777,8/11/2021 7:12:59 AM,Internally Displaced People,4977,4535,7411,6877,23800,1647,3557,6184,5211,16599
23,Afghanistan,2020,AFG-20/3481/RA6/ESNFI/INGO/17777,8/11/2021 7:12:59 AM,Overall,5125,4669,7629,7077,24500,1982,3983,6856,5873,18694
23,Afghanistan,2020,AFG-20/3481/RA6/ESNFI/INGO/17777,8/11/2021 7:12:59 AM,Returnees,74,67,109,100,350,18,21,41,42,122
23,Afghanistan,2020,AFG-20/3481/RA6/ESNFI/NGO/17700,5/11/2021 6:04:46 AM,Host Communities,454,548,643,739,2384,356,481,1129,1147,3113
23,Afghanistan,2020,AFG-20/3481/RA6/ESNFI/NGO/17700,5/11/2021 6:04:46 AM,Internally Displaced People,483,584,687,788,2542,434,481,1127,1160,3202
23,Afghanistan,2020,AFG-20/3481/RA6/ESNFI/NGO/17700,5/11/2021 6:04:46 AM,Overall,1511,1827,2145,2462,7945,1329,1529,3514,3492,9864
23,Afghanistan,2020,AFG-20/3481/RA6/ESNFI/NGO/17700,5/11/2021 6:04:46 AM,Refugees,152,183,215,245,795,130,141,284,263,818
23,Afghanistan,2020,AFG-20/3481/RA6/ESNFI/NGO/17700,5/11/2021 6:04:46 AM,Returnees,422,512,600,690,2224,409,426,974,922,2731
23,Afghanistan,2020,AFG-20/3481/RA6/ESNFI-FSAC/NGO/17743,7/5/2021 9:49:32 AM,Host Communities,97,92,152,149,490,107,155,283,298,843
23,Afghanistan,2020,AFG-20/3481/RA6/ESNFI-FSAC/NGO/17743,7/5/2021 9:49:32 AM,Internally Displaced People,750,742,1132,1051,3675,620,760,1389,1214,3983
23,Afghanistan,2020,AFG-20/3481/RA6/ESNFI-FSAC/NGO/17743,7/5/2021 9:49:32 AM,Overall,1012,991,1492,1405,4900,831,1052,1793,1656,5332
23,Afghanistan,2020,AFG-20/3481/RA6/ESNFI-FSAC/NGO/17743,7/5/2021 9:49:32 AM,Returnees,165,157,208,205,735,104,137,121,144,506
23,Afghanistan,2020,AFG-20/3481/RA6/FSAC/INGO/17741,7/5/2021 10:21:32 AM,Host Communities,1430,1470,2250,2350,7500,1179,1672,2302,2548,7701
23,Afghanistan,2020,AFG-20/3481/RA6/FSAC/INGO/17741,7/5/2021 10:21:32 AM,Overall,1430,1470,2250,2350,7500,1179,1672,2302,2548,7701
23,Afghanistan,2020,AFG-20/3481/RA6/FSAC/INGO/17745,11/23/2021 9:15:06 AM,Other,4502,4125,2257,2220,13104,3079,2115,5330,4855,15379
23,Afghanistan,2020,AFG-20/3481/RA6/FSAC/INGO/17745,11/23/2021 9:15:06 AM,Overall,4502,4125,2257,2220,13104,3079,2115,5330,4855,15379
23,Afghanistan,2020,AFG-20/3481/RA6/FSAC/INGO/17771,9/28/2021 10:18:19 AM,Host Communities,4463,4237,4463,4237,17400,6574,7079,1630,1725,17008
23,Afghanistan,2020,AFG-20/3481/RA6/FSAC/INGO/17771,9/28/2021 10:18:19 AM,Overall,4463,4237,4463,4237,17400,6574,7079,1630,1725,17008
23,Afghanistan,2020,AFG-20/3481/RA6/FSAC/INGO/17781,9/22/2022 11:45:10 AM,Host Communities,6800,6630,1530,2040,17000,3993,3836,998,959,9786
23,Afghanistan,2020,AFG-20/3481/RA6/FSAC/INGO/17781,9/22/2022 11:45:10 AM,Overall,6800,6630,1530,2040,17000,3993,3836,998,959,9786
23,Afghanistan,2020,AFG-20/3481/RA6/FSAC/INGO/17796,10/7/2021 10:47:40 AM,Host Communities,1602,1538,1879,1806,6825,1733,1664,2033,1954,7384
23,Afghanistan,2020,AFG-20/3481/RA6/FSAC/INGO/17796,10/7/2021 10:47:40 AM,Internally Displaced People,18,17,20,20,75,19,18,22,22,81
23,Afghanistan,2020,AFG-20/3481/RA6/FSAC/INGO/17796,10/7/2021 10:47:40 AM,Other,16,17,20,20,73,17,18,22,22,79
23,Afghanistan,2020,AFG-20/3481/RA6/FSAC/INGO/17796,10/7/2021 10:47:40 AM,Overall,1760,1690,2065,1985,7500,1903,1828,2235,2148,8114
23,Afghanistan,2020,AFG-20/3481/RA6/FSAC/INGO/17796,10/7/2021 10:47:40 AM,Returnees,124,118,146,139,527,134,128,158,150,570
23,Afghanistan,2020,AFG-20/3481/RA6/FSAC/NGO/17808,9/28/2021 10:09:17 AM,Host Communities,2687,3356,3059,3398,12500,1784,2619,4269,4246,12918
23,Afghanistan,2020,AFG-20/3481/RA6/FSAC/NGO/17808,9/28/2021 10:09:17 AM,Overall,2687,3356,3059,3398,12500,1784,2619,4269,4246,12918
23,Afghanistan,2020,AFG-20/3481/RA6/N/INGO/17747,11/22/2021 3:01:50 PM,Host Communities,13200,13208,19801,19809,66018,8101,17247,6976,7379,39703
23,Afghanistan,2020,AFG-20/3481/RA6/N/INGO/17747,11/22/2021 3:01:50 PM,Overall,13200,13208,19801,19809,66018,8101,17247,6976,7379,39703
23,Afghanistan,2020,AFG-20/3481/RA6/N/INGO/17806,9/22/2022 7:01:07 AM,Host Communities,1068,5131,1721,2380,10300,0,4374,5454,4179,14007
23,Afghanistan,2020,AFG-20/3481/RA6/N/INGO/17806,9/22/2022 7:01:07 AM,Overall,1068,5131,1721,2380,10300,0,4374,5454,4179,14007
23,Afghanistan,2020,AFG-20/3481/RA6/N/UN/17791,10/7/2021 6:12:49 AM,Host Communities,0,0,1682,2056,3738,0,0,2025,2476,4501
23,Afghanistan,2020,AFG-20/3481/RA6/N/UN/17791,10/7/2021 6:12:49 AM,Overall,0,0,1682,2056,3738,0,0,2025,2476,4501
23,Afghanistan,2020,AFG-20/3481/RA6/N/UN/17809,9/20/2021 9:27:48 AM,Host Communities,0,1500,2397,2303,6200,0,1069,2424,2793,6286
23,Afghanistan,2020,AFG-20/3481/RA6/N/UN/17809,9/20/2021 9:27:48 AM,Overall,0,1500,2397,2303,6200,0,1069,2424,2793,6286
23,Afghanistan,2020,AFG-20/3481/SA1/APC/INGO/15065,9/16/2021 6:41:36 AM,Host Communities,1404,1560,78,78,3120,2257,1719,81,81,4138
23,Afghanistan,2020,AFG-20/3481/SA1/APC/INGO/15065,9/16/2021 6:41:36 AM,Internally Displaced People,5616,6240,312,312,12480,9160,7443,463,510,17576
23,Afghanistan,2020,AFG-20/3481/SA1/APC/INGO/15065,9/16/2021 6:41:36 AM,Overall,7020,7800,390,390,15600,11417,9162,544,591,21714
23,Afghanistan,2020,AFG-20/3481/SA1/APC/INGO/15079,9/16/2021 9:20:33 AM,Host Communities,2458,3472,1220,1220,8370,4941,5058,3364,2847,16210
23,Afghanistan,2020,AFG-20/3481/SA1/APC/INGO/15079,9/16/2021 9:20:33 AM,Internally Displaced People,4568,6680,2348,2348,15944,9182,9732,6475,5478,30867
23,Afghanistan,2020,AFG-20/3481/SA1/APC/INGO/15079,9/16/2021 9:20:33 AM,Overall,11496,16682,5841,5841,39860,23109,24304,16110,13629,77152
23,Afghanistan,2020,AFG-20/3481/SA1/APC/INGO/15079,9/16/2021 9:20:33 AM,Returnees,4470,6530,2273,2273,15546,8986,9514,6271,5304,30075
23,Afghanistan,2020,AFG-20/3481/SA1/APC/INGO/15137,9/16/2021 2:45:28 PM,Other,3010,3596,16359,11542,34507,3172,3734,23367,16550,46823
23,Afghanistan,2020,AFG-20/3481/SA1/APC/INGO/15137,9/16/2021 2:45:28 PM,Overall,3010,3596,16359,11542,34507,3172,3734,23367,16550,46823
23,Afghanistan,2020,AFG-20/3481/SA1/ESNFI/INGO/15064,5/5/2021 2:58:35 AM,Host Communities,328,302,491,454,1575,372,400,673,643,2088
23,Afghanistan,2020,AFG-20/3481/SA1/ESNFI/INGO/15064,5/5/2021 2:58:35 AM,Internally Displaced People,36,34,55,50,175,5,7,17,17,46
23,Afghanistan,2020,AFG-20/3481/SA1/ESNFI/INGO/15064,5/5/2021 2:58:35 AM,Overall,364,336,546,504,1750,377,407,690,660,2134
23,Afghanistan,2020,AFG-20/3481/SA1/ESNFI/INGO/15066,5/12/2021 12:15:00 PM,Host Communities,574,575,1050,990,3189,556,650,1413,1306,3925
23,Afghanistan,2020,AFG-20/3481/SA1/ESNFI/INGO/15066,5/12/2021 12:15:00 PM,Internally Displaced People,120,120,180,181,601,96,113,263,228,700
23,Afghanistan,2020,AFG-20/3481/SA1/ESNFI/INGO/15066,5/12/2021 12:15:00 PM,Overall,734,735,1290,1231,3990,655,766,1681,1539,4641
23,Afghanistan,2020,AFG-20/3481/SA1/ESNFI/INGO/15066,5/12/2021 12:15:00 PM,Returnees,40,40,60,60,200,3,3,5,5,16
23,Afghanistan,2020,AFG-20/3481/SA1/ESNFI/INGO/15073,7/5/2021 10:51:08 AM,Internally Displaced People,414,505,643,736,2298,521,652,655,783,2611
23,Afghanistan,2020,AFG-20/3481/SA1/ESNFI/INGO/15073,7/5/2021 10:51:08 AM,Overall,470,574,731,836,2611,521,652,655,783,2611
23,Afghanistan,2020,AFG-20/3481/SA1/ESNFI/INGO/15073,7/5/2021 10:51:08 AM,Returnees,56,69,88,100,313,0,0,0,0,0
23,Afghanistan,2020,AFG-20/3481/SA1/ESNFI-APC/NGO/15081,9/30/2021 9:27:12 AM,Host Communities,88,109,127,144,468,88,109,127,144,468
23,Afghanistan,2020,AFG-20/3481/SA1/ESNFI-APC/NGO/15081,9/30/2021 9:27:12 AM,Internally Displaced People,87,107,122,141,457,87,107,122,141,457
23,Afghanistan,2020,AFG-20/3481/SA1/ESNFI-APC/NGO/15081,9/30/2021 9:27:12 AM,Overall,197,245,283,325,1050,197,245,283,325,1050
23,Afghanistan,2020,AFG-20/3481/SA1/ESNFI-APC/NGO/15081,9/30/2021 9:27:12 AM,Returnees,22,29,34,40,125,22,29,34,40,125
23,Afghanistan,2020,AFG-20/3481/SA1/ESNFI-APC-WASH/INGO/15070,6/24/2021 4:37:37 AM,Host Communities,274,290,442,478,1484,135,151,270,262,818
23,Afghanistan,2020,AFG-20/3481/SA1/ESNFI-APC-WASH/INGO/15070,6/24/2021 4:37:37 AM,Internally Displaced People,411,435,698,717,2261,510,600,1220,1077,3407
23,Afghanistan,2020,AFG-20/3481/SA1/ESNFI-APC-WASH/INGO/15070,6/24/2021 4:37:37 AM,Overall,685,725,1140,1195,3745,645,751,1490,1339,4225
23,Afghanistan,2020,AFG-20/3481/SA1/FSAC/INGO/15067,12/30/2020 8:01:55 AM,Host Communities,3101,3101,4652,4652,15506,4734,4946,9381,8775,27836
23,Afghanistan,2020,AFG-20/3481/SA1/FSAC/INGO/15067,12/30/2020 8:01:55 AM,Internally Displaced People,1550,1550,2326,2326,7752,812,835,1429,1361,4437
23,Afghanistan,2020,AFG-20/3481/SA1/FSAC/INGO/15067,12/30/2020 8:01:55 AM,Overall,6201,6201,9304,9304,31010,5549,5784,10813,10140,32286
23,Afghanistan,2020,AFG-20/3481/SA1/FSAC/INGO/15067,12/30/2020 8:01:55 AM,Returnees,1550,1550,2326,2326,7752,3,3,3,4,13
23,Afghanistan,2020,AFG-20/3481/SA1/FSAC/INGO/15083,12/28/2022 8:17:35 AM,Host Communities,9126,9126,12098,12098,42448,12473,12473,16534,16535,58015
23,Afghanistan,2020,AFG-20/3481/SA1/FSAC/INGO/15083,12/28/2022 8:17:35 AM,Internally Displaced People,185,185,245,246,861,384,384,508,509,1785
23,Afghanistan,2020,AFG-20/3481/SA1/FSAC/INGO/15083,12/28/2022 8:17:35 AM,Overall,9311,9311,12343,12344,43309,12857,12857,17042,17044,59800
23,Afghanistan,2020,AFG-20/3481/SA1/FSAC/INGO/15359,4/11/2021 7:27:30 AM,Host Communities,6261,6261,8299,8299,29120,6261,6261,8299,8299,29120
23,Afghanistan,2020,AFG-20/3481/SA1/FSAC/INGO/15359,4/11/2021 7:27:30 AM,Internally Displaced People,1565,1565,2075,2075,7280,728,875,821,927,3351
23,Afghanistan,2020,AFG-20/3481/SA1/FSAC/INGO/15359,4/11/2021 7:27:30 AM,Overall,7826,7826,10374,10374,36400,6989,7136,9120,9226,32471
23,Afghanistan,2020,AFG-20/3481/SA1/GBV-CPiE/NGO/15132,10/1/2021 6:31:01 AM,Host Communities,2740,4274,3344,3522,13880,2740,4274,3344,3522,13880
23,Afghanistan,2020,AFG-20/3481/SA1/GBV-CPiE/NGO/15132,10/1/2021 6:31:01 AM,Internally Displaced People,4110,6411,5016,5283,20820,4110,6411,5016,5283,20820
23,Afghanistan,2020,AFG-20/3481/SA1/GBV-CPiE/NGO/15132,10/1/2021 6:31:01 AM,Overall,6850,10685,8360,8805,34700,6850,10685,8360,8805,34700
23,Afghanistan,2020,AFG-20/3481/SA1/H/INGO/15084,10/1/2021 6:44:53 AM,Host Communities,5435,3502,7130,5619,21686,13620,7279,5697,5430,32026
23,Afghanistan,2020,AFG-20/3481/SA1/H/INGO/15084,10/1/2021 6:44:53 AM,Other,5,0,50,100,155,5,0,50,100,155
23,Afghanistan,2020,AFG-20/3481/SA1/H/INGO/15084,10/1/2021 6:44:53 AM,Overall,5440,3502,7180,5719,21841,13625,7279,5747,5530,32181
23,Afghanistan,2020,AFG-20/3481/SA1/H/INGO/15104,11/23/2021 9:18:34 AM,Host Communities,126,1378,24,24,1552,264,1294,58,67,1683
23,Afghanistan,2020,AFG-20/3481/SA1/H/INGO/15104,11/23/2021 9:18:34 AM,Internally Displaced People,189,2067,36,36,2328,396,1942,86,101,2525
23,Afghanistan,2020,AFG-20/3481/SA1/H/INGO/15104,11/23/2021 9:18:34 AM,Overall,315,3445,60,60,3880,660,3236,144,168,4208
23,Afghanistan,2020,AFG-20/3481/SA1/H/INGO/15160,5/19/2021 7:07:03 AM,Host Communities,5600,5600,8400,8400,28000,6953,12757,3560,3731,27001
23,Afghanistan,2020,AFG-20/3481/SA1/H/INGO/15160,5/19/2021 7:07:03 AM,Internally Displaced People,1200,1200,1800,1800,6000,565,640,820,750,2775
23,Afghanistan,2020,AFG-20/3481/SA1/H/INGO/15160,5/19/2021 7:07:03 AM,Overall,6800,6800,10200,10200,34000,7518,13397,4380,4481,29776
23,Afghanistan,2020,AFG-20/3481/SA1/H/NGO/15113,9/17/2021 10:11:03 AM,Host Communities,26214,25203,20816,19039,91272,24520,49119,25825,23170,122634
23,Afghanistan,2020,AFG-20/3481/SA1/H/NGO/15113,9/17/2021 10:11:03 AM,Other,67,67,0,0,134,84,58,0,0,142
23,Afghanistan,2020,AFG-20/3481/SA1/H/NGO/15113,9/17/2021 10:11:03 AM,Overall,26281,25270,20816,19039,91406,24604,49177,25825,23170,122776
23,Afghanistan,2020,AFG-20/3481/SA1/H/NGO/15252,9/17/2021 10:26:39 AM,Host Communities,6206,6502,8570,8275,29553,25353,34979,11803,12362,84497
23,Afghanistan,2020,AFG-20/3481/SA1/H/NGO/15252,9/17/2021 10:26:39 AM,Internally Displaced People,1161,1216,1603,1548,5528,5079,6488,2523,2693,16783
23,Afghanistan,2020,AFG-20/3481/SA1/H/NGO/15252,9/17/2021 10:26:39 AM,Other,46,8,0,0,54,46,8,0,0,54
23,Afghanistan,2020,AFG-20/3481/SA1/H/NGO/15252,9/17/2021 10:26:39 AM,Overall,7413,7726,10173,9823,35135,30478,41475,14326,15055,101334
23,Afghanistan,2020,AFG-20/3481/SA1/H-APC-GBV/INGO/15056,10/1/2021 6:58:42 AM,Host Communities,7404,15064,3341,2353,28162,23753,28624,11804,11594,75775
23,Afghanistan,2020,AFG-20/3481/SA1/H-APC-GBV/INGO/15056,10/1/2021 6:58:42 AM,Internally Displaced People,3620,7501,1876,2602,15599,7068,16334,5090,6844,35336
23,Afghanistan,2020,AFG-20/3481/SA1/H-APC-GBV/INGO/15056,10/1/2021 6:58:42 AM,Overall,11821,23741,5616,5578,46756,32284,46600,17628,19489,116001
23,Afghanistan,2020,AFG-20/3481/SA1/H-APC-GBV/INGO/15056,10/1/2021 6:58:42 AM,Returnees,797,1176,399,623,2995,1463,1642,734,1051,4890
23,Afghanistan,2020,AFG-20/3481/SA1/HLP/INGO/15162,9/17/2021 10:54:23 AM,Host Communities,924,924,27,27,1902,778,1573,61,75,2487
23,Afghanistan,2020,AFG-20/3481/SA1/HLP/INGO/15162,9/17/2021 10:54:23 AM,Internally Displaced People,4619,4619,136,136,9510,6434,9189,511,497,16631
23,Afghanistan,2020,AFG-20/3481/SA1/HLP/INGO/15162,9/17/2021 10:54:23 AM,Overall,9233,9233,272,272,19010,7624,11266,667,682,20239
23,Afghanistan,2020,AFG-20/3481/SA1/HLP/INGO/15162,9/17/2021 10:54:23 AM,Returnees,3690,3690,109,109,7598,412,504,95,110,1121
23,Afghanistan,2020,AFG-20/3481/SA1/HLP/UN/15360,7/24/2023 1:18:56 PM,Internally Displaced People,12600,14000,22400,21000,70000,19464,21628,34602,32441,108135
23,Afghanistan,2020,AFG-20/3481/SA1/HLP/UN/15360,7/24/2023 1:18:56 PM,Overall,12600,14000,22400,21000,70000,19464,21628,34602,32441,108135
23,Afghanistan,2020,AFG-20/3481/SA1/H-N/INGO/15100,10/20/2021 10:51:49 AM,Host Communities,7297,7660,9212,8849,33018,0,0,0,0,0
23,Afghanistan,2020,AFG-20/3481/SA1/H-N/INGO/15100,10/20/2021 10:51:49 AM,Internally Displaced People,659,692,832,799,2982,0,0,0,0,0
23,Afghanistan,2020,AFG-20/3481/SA1/H-N/INGO/15100,10/20/2021 10:51:49 AM,Overall,7956,8352,10044,9648,36000,0,0,0,0,0
23,Afghanistan,2020,AFG-20/3481/SA1/H-N/UN/15336,9/15/2021 11:05:48 AM,Host Communities,16130,18432,14179,11816,60557,18669,21333,16411,13675,70088
23,Afghanistan,2020,AFG-20/3481/SA1/H-N/UN/15336,9/15/2021 11:05:48 AM,Internally Displaced People,1792,2048,1575,1313,6728,2074,2370,1823,1520,7787
23,Afghanistan,2020,AFG-20/3481/SA1/H-N/UN/15336,9/15/2021 11:05:48 AM,Overall,17922,20480,15754,13129,67285,20743,23703,18234,15195,77875
23,Afghanistan,2020,AFG-20/3481/SA1/H-N-GBV/INGO/15090,11/17/2021 8:52:24 AM,Host Communities,14443,19531,25939,26085,85998,31131,66512,46636,57807,202086
23,Afghanistan,2020,AFG-20/3481/SA1/H-N-GBV/INGO/15090,11/17/2021 8:52:24 AM,Overall,14443,19531,25939,26085,85998,31131,66512,46636,57807,202086
23,Afghanistan,2020,AFG-20/3481/SA1/H-WASH-GBV/INGO/15093,11/17/2021 8:49:17 AM,Host Communities,23878,24084,11073,11222,70257,19250,39921,14913,14063,88147
23,Afghanistan,2020,AFG-20/3481/SA1/H-WASH-GBV/INGO/15093,11/17/2021 8:49:17 AM,Internally Displaced People,2800,2826,1301,1319,8246,3683,5031,2982,3217,14913
23,Afghanistan,2020,AFG-20/3481/SA1/H-WASH-GBV/INGO/15093,11/17/2021 8:49:17 AM,Overall,28070,28314,13009,13123,82516,24136,45843,18803,18227,107009
23,Afghanistan,2020,AFG-20/3481/SA1/H-WASH-GBV/INGO/15093,11/17/2021 8:49:17 AM,Returnees,1392,1404,635,582,4013,1203,891,908,947,3949
23,Afghanistan,2020,AFG-20/3481/SA1/N/UN/15089,10/20/2021 11:00:41 AM,Host Communities,0,6834,6403,6152,19389,0,7136,7030,8054,22220
23,Afghanistan,2020,AFG-20/3481/SA1/N/UN/15089,10/20/2021 11:00:41 AM,Overall,0,6834,6403,6152,19389,0,7136,7030,8054,22220
23,Afghanistan,2020,AFG-20/3481/SA1/N/UN/15091,10/20/2021 11:11:39 AM,Host Communities,0,0,6933,8138,15071,0,0,7543,9220,16763
23,Afghanistan,2020,AFG-20/3481/SA1/N/UN/15091,10/20/2021 11:11:39 AM,Overall,0,0,6933,8138,15071,0,0,7543,9220,16763
23,Afghanistan,2020,AFG-20/3481/SA1/N-H/INGO/15071,11/23/2021 9:17:58 AM,Host Communities,59,4482,6726,6732,17999,87,4392,4887,4684,14050
23,Afghanistan,2020,AFG-20/3481/SA1/N-H/INGO/15071,11/23/2021 9:17:58 AM,Overall,59,4482,6726,6732,17999,87,4392,4887,4684,14050
23,Afghanistan,2020,AFG-20/3481/SA1/WASH/INGO/15080,9/22/2022 7:48:52 AM,Host Communities,4778,4967,4106,4203,18054,4876,11618,4255,4846,25595
23,Afghanistan,2020,AFG-20/3481/SA1/WASH/INGO/15080,9/22/2022 7:48:52 AM,Overall,4778,4967,4106,4203,18054,4876,11618,4255,4846,25595
23,Afghanistan,2020,AFG-20/3481/SA1/WASH/INGO/15082,9/28/2022 12:03:49 PM,Host Communities,1062,995,3627,3163,8847,1211,1217,2640,2445,7513
23,Afghanistan,2020,AFG-20/3481/SA1/WASH/INGO/15082,9/28/2022 12:03:49 PM,Internally Displaced People,1097,1028,3749,3269,9143,1078,1046,3310,2899,8333
23,Afghanistan,2020,AFG-20/3481/SA1/WASH/INGO/15082,9/28/2022 12:03:49 PM,Overall,2184,2047,7462,6507,18200,2320,2295,6033,5417,16065
23,Afghanistan,2020,AFG-20/3481/SA1/WASH/INGO/15082,9/28/2022 12:03:49 PM,Returnees,25,24,86,75,210,31,32,83,73,219
23,Afghanistan,2020,AFG-20/3481/SA1/WASH/INGO/15102,5/28/2021 8:08:59 AM,Host Communities,2251,2355,2764,2866,10236,2848,2441,2429,2447,10165
23,Afghanistan,2020,AFG-20/3481/SA1/WASH/INGO/15102,5/28/2021 8:08:59 AM,Internally Displaced People,3062,3201,3755,3896,13914,3385,3319,3795,3989,14488
23,Afghanistan,2020,AFG-20/3481/SA1/WASH/INGO/15102,5/28/2021 8:08:59 AM,Overall,5313,5556,6519,6762,24150,6233,5760,6224,6436,24653
23,Afghanistan,2020,AFG-20/3481/SA1/WASH/INGO/15106,9/20/2021 6:40:39 AM,Host Communities,6616,7312,10795,10098,34821,6878,7595,11213,10475,36161
23,Afghanistan,2020,AFG-20/3481/SA1/WASH/INGO/15106,9/20/2021 6:40:39 AM,Internally Displaced People,2692,2976,4392,4109,14169,3551,3927,5809,5421,18708
23,Afghanistan,2020,AFG-20/3481/SA1/WASH/INGO/15106,9/20/2021 6:40:39 AM,Overall,10045,11103,16390,15333,52871,11163,12337,18232,17005,58737
23,Afghanistan,2020,AFG-20/3481/SA1/WASH/INGO/15106,9/20/2021 6:40:39 AM,Returnees,737,815,1203,1126,3881,734,815,1210,1109,3868
23,Afghanistan,2020,AFG-20/3481/SA1/WASH/INGO/15344,1/5/2021 6:10:16 PM,Host Communities,2192,2293,2696,2755,9936,3855,4844,3202,3233,15134
23,Afghanistan,2020,AFG-20/3481/SA1/WASH/INGO/15344,1/5/2021 6:10:16 PM,Overall,2192,2293,2696,2755,9936,3855,4844,3202,3233,15134
23,Afghanistan,2021,AFG-21/3481/RA1/CCS/UN/18084,10/26/2021 9:37:43 AM,Other,6232,468,0,0,6700,5765,1330,0,0,7095
23,Afghanistan,2021,AFG-21/3481/RA1/CCS/UN/18084,10/26/2021 9:37:43 AM,Overall,6232,468,0,0,6700,5765,1330,0,0,7095
23,Afghanistan,2021,AFG-21/3481/RA2/APC/INGO/18685,12/5/2022 12:51:51 PM,Host Communities,92,92,315,315,814,840,898,450,450,2638
23,Afghanistan,2021,AFG-21/3481/RA2/APC/INGO/18685,12/5/2022 12:51:51 PM,Internally Displaced People,832,832,2835,2835,7334,1961,1163,1050,1050,5224
23,Afghanistan,2021,AFG-21/3481/RA2/APC/INGO/18685,12/5/2022 12:51:51 PM,Overall,924,924,3150,3150,8148,2801,2061,1500,1500,7862
23,Afghanistan,2021,AFG-21/3481/RA2/APC/INGO/18697,4/26/2022 12:14:55 PM,Host Communities,5442,5426,1800,1796,14464,8161,6701,4851,4509,24222
23,Afghanistan,2021,AFG-21/3481/RA2/APC/INGO/18697,4/26/2022 12:14:55 PM,Internally Displaced People,5442,5426,1801,1797,14466,7310,2503,3906,1745,15464
23,Afghanistan,2021,AFG-21/3481/RA2/APC/INGO/18697,4/26/2022 12:14:55 PM,Overall,13605,13565,4501,4491,36162,18305,10055,10676,6876,45912
23,Afghanistan,2021,AFG-21/3481/RA2/APC/INGO/18697,4/26/2022 12:14:55 PM,Returnees,2721,2713,900,898,7232,2834,851,1919,622,6226
23,Afghanistan,2021,AFG-21/3481/RA2/APC/INGO/18698,5/16/2022 12:12:34 PM,Host Communities,422,422,89,89,1022,10,43,0,0,53
23,Afghanistan,2021,AFG-21/3481/RA2/APC/INGO/18698,5/16/2022 12:12:34 PM,Internally Displaced People,23831,24954,966,1191,50942,2411,3421,116,115,6063
23,Afghanistan,2021,AFG-21/3481/RA2/APC/INGO/18698,5/16/2022 12:12:34 PM,Overall,25502,26625,1313,1538,54978,2735,3719,117,115,6686
23,Afghanistan,2021,AFG-21/3481/RA2/APC/INGO/18698,5/16/2022 12:12:34 PM,Returnees,1249,1249,258,258,3014,314,255,1,0,570
23,Afghanistan,2021,AFG-21/3481/RA2/APC/INGO/18703,4/24/2022 4:34:16 AM,Other,3690,3545,2522,2423,12180,0,0,0,0,0
23,Afghanistan,2021,AFG-21/3481/RA2/APC/INGO/18703,4/24/2022 4:34:16 AM,Overall,3690,3545,2522,2423,12180,0,0,0,0,0
23,Afghanistan,2021,AFG-21/3481/RA2/APC/INGO/18745,4/19/2022 12:33:51 PM,Other,2570,2171,10041,6373,21155,5536,5106,14954,10540,36136
23,Afghanistan,2021,AFG-21/3481/RA2/APC/INGO/18745,4/19/2022 12:33:51 PM,Overall,2570,2171,10041,6373,21155,5536,5106,14954,10540,36136
23,Afghanistan,2021,AFG-21/3481/RA2/APC/INGO/18761,5/2/2022 11:42:10 AM,Host Communities,2496,2168,2509,2509,9682,2673,2311,2729,2498,10211
23,Afghanistan,2021,AFG-21/3481/RA2/APC/INGO/18761,5/2/2022 11:42:10 AM,Internally Displaced People,7488,6503,7525,7525,29041,8020,6932,8186,7495,30633
23,Afghanistan,2021,AFG-21/3481/RA2/APC/INGO/18761,5/2/2022 11:42:10 AM,Overall,9984,8671,10034,10034,38723,10693,9243,10915,9993,40844
23,Afghanistan,2021,AFG-21/3481/RA2/APC/INGO/18771,5/17/2022 5:42:06 AM,Host Communities,702,702,78,78,1560,6889,2959,208,44,10100
23,Afghanistan,2021,AFG-21/3481/RA2/APC/INGO/18771,5/17/2022 5:42:06 AM,Internally Displaced People,5619,5619,624,625,12487,1950,4106,101,36,6193
23,Afghanistan,2021,AFG-21/3481/RA2/APC/INGO/18771,5/17/2022 5:42:06 AM,Overall,7023,7041,780,781,15625,8916,7244,310,87,16557
23,Afghanistan,2021,AFG-21/3481/RA2/APC/INGO/18771,5/17/2022 5:42:06 AM,Returnees,702,720,78,78,1578,77,179,1,7,264
23,Afghanistan,2021,AFG-21/3481/RA2/APC/UN/18692,12/16/2022 11:28:41 AM,Host Communities,3948,980,161,35,5124,4774,1434,196,100,6504
23,Afghanistan,2021,AFG-21/3481/RA2/APC/UN/18692,12/16/2022 11:28:41 AM,Internally Displaced People,1981,763,42,14,2800,3500,1415,55,34,5004
23,Afghanistan,2021,AFG-21/3481/RA2/APC/UN/18692,12/16/2022 11:28:41 AM,Other,28,0,0,0,28,41,5,0,0,46
23,Afghanistan,2021,AFG-21/3481/RA2/APC/UN/18692,12/16/2022 11:28:41 AM,Overall,6860,1883,329,49,9121,9837,3060,365,155,13417
23,Afghanistan,2021,AFG-21/3481/RA2/APC/UN/18692,12/16/2022 11:28:41 AM,Returnees,903,140,126,0,1169,1522,206,114,21,1863
23,Afghanistan,2021,AFG-21/3481/RA2/APC/UN/18707,11/9/2022 1:04:38 PM,Internally Displaced People,2032,1930,2356,2182,8500,0,0,0,0,0
23,Afghanistan,2021,AFG-21/3481/RA2/APC/UN/18707,11/9/2022 1:04:38 PM,Overall,2032,1930,2356,2182,8500,0,0,0,0,0
23,Afghanistan,2021,AFG-21/3481/RA2/APC/UN/18715,3/6/2023 6:06:52 AM,Host Communities,1035,993,1902,1890,5820,1035,993,1902,1890,5820
23,Afghanistan,2021,AFG-21/3481/RA2/APC/UN/18715,3/6/2023 6:06:52 AM,Internally Displaced People,1293,1312,2610,2464,7679,1293,1312,2610,2464,7679
23,Afghanistan,2021,AFG-21/3481/RA2/APC/UN/18715,3/6/2023 6:06:52 AM,Overall,3150,3205,6274,6028,18657,3150,3205,6274,6028,18657
23,Afghanistan,2021,AFG-21/3481/RA2/APC/UN/18715,3/6/2023 6:06:52 AM,Returnees,822,900,1762,1674,5158,822,900,1762,1674,5158
23,Afghanistan,2021,AFG-21/3481/RA2/APC/UN/18734,12/8/2022 6:46:51 AM,Internally Displaced People,133343,128113,33336,32028,326820,18965,79018,13667,19755,131405
23,Afghanistan,2021,AFG-21/3481/RA2/APC/UN/18734,12/8/2022 6:46:51 AM,Overall,133343,128113,33336,32028,326820,18965,79018,13667,19755,131405
23,Afghanistan,2021,AFG-21/3481/RA2/EIE/INGO/18732,5/15/2022 9:15:43 AM,Host Communities,173,75,623,416,1287,173,75,623,416,1287
23,Afghanistan,2021,AFG-21/3481/RA2/EIE/INGO/18732,5/15/2022 9:15:43 AM,Internally Displaced People,167,69,619,412,1267,167,69,619,412,1267
23,Afghanistan,2021,AFG-21/3481/RA2/EIE/INGO/18732,5/15/2022 9:15:43 AM,Overall,568,242,2070,1380,4260,568,242,2070,1380,4260
23,Afghanistan,2021,AFG-21/3481/RA2/EIE/INGO/18732,5/15/2022 9:15:43 AM,Returnees,228,98,828,552,1706,228,98,828,552,1706
23,Afghanistan,2021,AFG-21/3481/RA2/ESNFI/INGO/18684,5/3/2022 4:33:08 AM,Host Communities,1008,1008,1512,1512,5040,663,637,1117,1152,3569
23,Afghanistan,2021,AFG-21/3481/RA2/ESNFI/INGO/18684,5/3/2022 4:33:08 AM,Internally Displaced People,392,392,588,588,1960,816,877,1278,1345,4316
23,Afghanistan,2021,AFG-21/3481/RA2/ESNFI/INGO/18684,5/3/2022 4:33:08 AM,Overall,1400,1400,2100,2100,7000,1479,1514,2395,2497,7885
23,Afghanistan,2021,AFG-21/3481/RA2/ESNFI/INGO/18691,4/20/2022 11:14:52 AM,Internally Displaced People,1937,2305,4848,4543,13633,1937,2305,4848,4543,13633
23,Afghanistan,2021,AFG-21/3481/RA2/ESNFI/INGO/18691,4/20/2022 11:14:52 AM,Overall,1937,2305,4848,4543,13633,1937,2305,4848,4543,13633
23,Afghanistan,2021,AFG-21/3481/RA2/ESNFI/INGO/18701,5/15/2022 7:32:51 AM,Host Communities,2268,2268,4158,3906,12600,2268,2268,4158,3906,12600
23,Afghanistan,2021,AFG-21/3481/RA2/ESNFI/INGO/18701,5/15/2022 7:32:51 AM,Internally Displaced People,1779,1779,3262,3064,9884,1779,1779,3262,3064,9884
23,Afghanistan,2021,AFG-21/3481/RA2/ESNFI/INGO/18701,5/15/2022 7:32:51 AM,Overall,4047,4047,7420,6970,22484,4047,4047,7420,6970,22484
23,Afghanistan,2021,AFG-21/3481/RA2/ESNFI/INGO/18733,4/21/2022 12:34:10 PM,Host Communities,875,828,671,612,2986,312,551,759,939,2561
23,Afghanistan,2021,AFG-21/3481/RA2/ESNFI/INGO/18733,4/21/2022 12:34:10 PM,Internally Displaced People,1210,1125,981,894,4210,723,1356,2152,2422,6653
23,Afghanistan,2021,AFG-21/3481/RA2/ESNFI/INGO/18733,4/21/2022 12:34:10 PM,Overall,2337,2174,1849,1690,8050,1035,1907,2911,3361,9214
23,Afghanistan,2021,AFG-21/3481/RA2/ESNFI/INGO/18733,4/21/2022 12:34:10 PM,Refugees,252,221,197,184,854,0,0,0,0,0
23,Afghanistan,2021,AFG-21/3481/RA2/ESNFI/INGO/18736,12/26/2022 6:31:12 AM,Host Communities,2186,2672,3401,3886,12145,2278,2784,3544,4050,12656
23,Afghanistan,2021,AFG-21/3481/RA2/ESNFI/INGO/18736,12/26/2022 6:31:12 AM,Internally Displaced People,1354,1656,2107,2408,7525,834,1019,1298,1483,4634
23,Afghanistan,2021,AFG-21/3481/RA2/ESNFI/INGO/18736,12/26/2022 6:31:12 AM,Overall,3540,4328,5508,6294,19670,3112,3803,4842,5533,17290
23,Afghanistan,2021,AFG-21/3481/RA2/ESNFI/INGO/18766,5/12/2022 11:24:18 AM,Host Communities,119,147,217,217,700,171,198,302,291,962
23,Afghanistan,2021,AFG-21/3481/RA2/ESNFI/INGO/18766,5/12/2022 11:24:18 AM,Internally Displaced People,1601,1976,2919,2919,9415,2635,2700,3116,2953,11404
23,Afghanistan,2021,AFG-21/3481/RA2/ESNFI/INGO/18766,5/12/2022 11:24:18 AM,Overall,1720,2123,3136,3136,10115,2806,2898,3418,3244,12366
23,Afghanistan,2021,AFG-21/3481/RA2/ESNFI/NGO/18704,4/20/2022 7:40:58 AM,Host Communities,4468,5411,6350,7291,23520,4468,5411,6350,7291,23520
23,Afghanistan,2021,AFG-21/3481/RA2/ESNFI/NGO/18704,4/20/2022 7:40:58 AM,Internally Displaced People,1277,1546,1815,2083,6721,1277,1546,1815,2083,6721
23,Afghanistan,2021,AFG-21/3481/RA2/ESNFI/NGO/18704,4/20/2022 7:40:58 AM,Overall,6383,7729,9073,10415,33600,6383,7729,9073,10415,33600
23,Afghanistan,2021,AFG-21/3481/RA2/ESNFI/NGO/18704,4/20/2022 7:40:58 AM,Returnees,638,772,908,1041,3359,638,772,908,1041,3359
23,Afghanistan,2021,AFG-21/3481/RA2/ESNFI/NGO/18741,12/26/2022 6:45:09 AM,Internally Displaced People,1202,1440,2582,2196,7420,1791,2097,2672,2684,9244
23,Afghanistan,2021,AFG-21/3481/RA2/ESNFI/NGO/18741,12/26/2022 6:45:09 AM,Other,1948,2015,3639,3528,11130,1793,1809,2141,2043,7786
23,Afghanistan,2021,AFG-21/3481/RA2/ESNFI/NGO/18741,12/26/2022 6:45:09 AM,Overall,3150,3455,6221,5724,18550,3584,3906,4813,4727,17030
23,Afghanistan,2021,AFG-21/3481/RA2/ESNFI/UN/18714,7/6/2023 6:36:53 AM,Internally Displaced People,3036,2827,2409,2200,10472,3036,2827,2409,2200,10472
23,Afghanistan,2021,AFG-21/3481/RA2/ESNFI/UN/18714,7/6/2023 6:36:53 AM,Overall,3795,3534,3011,2750,13090,3795,3534,3011,2750,13090
23,Afghanistan,2021,AFG-21/3481/RA2/ESNFI/UN/18714,7/6/2023 6:36:53 AM,Returnees,759,707,602,550,2618,759,707,602,550,2618
23,Afghanistan,2021,AFG-21/3481/RA2/FSAC/INGO/18683,4/24/2022 6:27:25 AM,Host Communities,3818,4309,5183,5090,18400,4057,4556,5594,5727,19934
23,Afghanistan,2021,AFG-21/3481/RA2/FSAC/INGO/18683,4/24/2022 6:27:25 AM,Overall,3818,4309,5183,5090,18400,4057,4556,5594,5727,19934
23,Afghanistan,2021,AFG-21/3481/RA2/FSAC/INGO/18735,5/21/2022 12:26:58 PM,Host Communities,3655,4468,5686,6498,20307,3680,4498,6544,5725,20447
23,Afghanistan,2021,AFG-21/3481/RA2/FSAC/INGO/18735,5/21/2022 12:26:58 PM,Overall,3655,4468,5686,6498,20307,3680,4498,6544,5725,20447
23,Afghanistan,2021,AFG-21/3481/RA2/FSAC/NGO/18774,7/6/2023 6:10:10 AM,Host Communities,1985,2494,2245,2511,9235,241,328,541,448,1558
23,Afghanistan,2021,AFG-21/3481/RA2/FSAC/NGO/18774,7/6/2023 6:10:10 AM,Overall,1985,2494,2245,2511,9235,241,328,541,448,1558
23,Afghanistan,2021,AFG-21/3481/RA2/FSAC/UN/18699,4/21/2022 7:17:19 AM,Host Communities,13247,13535,16126,14686,57594,13247,13535,16126,14686,57594
23,Afghanistan,2021,AFG-21/3481/RA2/FSAC/UN/18699,4/21/2022 7:17:19 AM,Overall,13247,13535,16126,14686,57594,13247,13535,16126,14686,57594
23,Afghanistan,2021,AFG-21/3481/RA2/H/INGO/18687,5/8/2022 4:06:50 AM,Host Communities,17456,18525,4091,4697,44769,16360,17645,3912,4415,42332
23,Afghanistan,2021,AFG-21/3481/RA2/H/INGO/18687,5/8/2022 4:06:50 AM,Internally Displaced People,4014,4214,933,1070,10231,3631,4184,1640,1403,10858
23,Afghanistan,2021,AFG-21/3481/RA2/H/INGO/18687,5/8/2022 4:06:50 AM,Overall,21470,22739,5024,5767,55000,19991,21829,5552,5818,53190
23,Afghanistan,2021,AFG-21/3481/RA2/H/INGO/18743,5/12/2022 6:55:38 AM,Host Communities,976,868,1320,1320,4484,2057,1331,944,954,5286
23,Afghanistan,2021,AFG-21/3481/RA2/H/INGO/18743,5/12/2022 6:55:38 AM,Internally Displaced People,3904,3472,5280,5280,17936,4464,3687,3557,3025,14733
23,Afghanistan,2021,AFG-21/3481/RA2/H/INGO/18743,5/12/2022 6:55:38 AM,Overall,4880,4340,6600,6600,22420,6521,5018,4501,3979,20019
23,Afghanistan,2021,AFG-21/3481/RA2/H/NGO/18696,4/20/2022 9:46:43 AM,Host Communities,17525,18241,14020,18062,67848,13897,29322,11795,12768,67782
23,Afghanistan,2021,AFG-21/3481/RA2/H/NGO/18696,4/20/2022 9:46:43 AM,Internally Displaced People,4381,5016,3855,4013,17265,6056,11469,4881,5435,27841
23,Afghanistan,2021,AFG-21/3481/RA2/H/NGO/18696,4/20/2022 9:46:43 AM,Overall,21906,23257,17875,22075,85113,19953,40791,16676,18203,95623
23,Afghanistan,2021,AFG-21/3481/RA2/H/UN/18686,4/21/2022 6:49:07 AM,Host Communities,28350,25650,6750,6750,67500,26647,37771,9444,10495,84357
23,Afghanistan,2021,AFG-21/3481/RA2/H/UN/18686,4/21/2022 6:49:07 AM,Internally Displaced People,37200,34800,9000,9000,90000,50194,71147,17778,19769,158888
23,Afghanistan,2021,AFG-21/3481/RA2/H/UN/18686,4/21/2022 6:49:07 AM,Overall,93900,86100,22500,22500,225000,96899,137349,34330,38164,306742
23,Afghanistan,2021,AFG-21/3481/RA2/H/UN/18686,4/21/2022 6:49:07 AM,Refugees,9450,8550,2250,2250,22500,0,0,0,0,0
23,Afghanistan,2021,AFG-21/3481/RA2/H/UN/18686,4/21/2022 6:49:07 AM,Returnees,18900,17100,4500,4500,45000,20058,28431,7108,7900,63497
23,Afghanistan,2021,AFG-21/3481/RA2/H-N/INGO/18694,4/26/2022 6:05:52 AM,Other,13143,40590,40967,43555,138255,17548,78516,44638,61937,202639
23,Afghanistan,2021,AFG-21/3481/RA2/H-N/INGO/18694,4/26/2022 6:05:52 AM,Overall,13143,40590,40967,43555,138255,17548,78516,44638,61937,202639
23,Afghanistan,2021,AFG-21/3481/RA2/N/INGO/18688,4/21/2022 5:14:38 AM,Other,9470,19091,18385,17711,64657,21681,31671,17144,17638,88134
23,Afghanistan,2021,AFG-21/3481/RA2/N/INGO/18688,4/21/2022 5:14:38 AM,Overall,9470,19091,18385,17711,64657,21681,31671,17144,17638,88134
23,Afghanistan,2021,AFG-21/3481/RA2/N/INGO/18700,5/29/2022 6:37:49 AM,Host Communities,681,7671,1191,1206,10749,1005,7863,4095,3759,16722
23,Afghanistan,2021,AFG-21/3481/RA2/N/INGO/18700,5/29/2022 6:37:49 AM,Internally Displaced People,144,1618,265,268,2295,0,0,0,0,0
23,Afghanistan,2021,AFG-21/3481/RA2/N/INGO/18700,5/29/2022 6:37:49 AM,Overall,825,9289,1456,1474,13044,1005,7863,4095,3759,16722
23,Afghanistan,2021,AFG-21/3481/RA2/N/INGO/18702,5/8/2022 4:30:33 AM,Host Communities,5700,6300,8700,9300,30000,1236,4000,1450,1345,8031
23,Afghanistan,2021,AFG-21/3481/RA2/N/INGO/18702,5/8/2022 4:30:33 AM,Internally Displaced People,1900,2100,2900,3100,10000,530,329,320,253,1432
23,Afghanistan,2021,AFG-21/3481/RA2/N/INGO/18702,5/8/2022 4:30:33 AM,Overall,7600,8400,11600,12400,40000,1766,4329,1770,1598,9463
23,Afghanistan,2021,AFG-21/3481/RA2/WASH/INGO/18690,5/15/2022 5:00:31 AM,Host Communities,7375,7480,10000,9669,34524,9113,9341,14783,14532,47769
23,Afghanistan,2021,AFG-21/3481/RA2/WASH/INGO/18690,5/15/2022 5:00:31 AM,Internally Displaced People,3280,3314,4629,4500,15723,2753,2752,4451,4515,14471
23,Afghanistan,2021,AFG-21/3481/RA2/WASH/INGO/18690,5/15/2022 5:00:31 AM,Overall,12387,12529,16914,16293,58123,12089,12325,19588,19420,63422
23,Afghanistan,2021,AFG-21/3481/RA2/WASH/INGO/18690,5/15/2022 5:00:31 AM,Returnees,1732,1735,2285,2124,7876,223,232,354,373,1182
23,Afghanistan,2021,AFG-21/3481/RA2/WASH/INGO/18722,5/22/2022 5:02:52 AM,Host Communities,4000,4000,6000,6000,20000,0,0,0,0,0
23,Afghanistan,2021,AFG-21/3481/RA2/WASH/INGO/18722,5/22/2022 5:02:52 AM,Overall,4000,4000,6000,6000,20000,0,0,0,0,0
23,Afghanistan,2021,AFG-21/3481/RA2/WASH/INGO/18772,5/2/2022 10:21:18 AM,Host Communities,9503,8883,7539,6900,32825,11415,11142,7812,7484,37853
23,Afghanistan,2021,AFG-21/3481/RA2/WASH/INGO/18772,5/2/2022 10:21:18 AM,Internally Displaced People,4153,3843,3302,2987,14285,4986,4867,3412,3268,16533
23,Afghanistan,2021,AFG-21/3481/RA2/WASH/INGO/18772,5/2/2022 10:21:18 AM,Overall,13656,12726,10841,9887,47110,16401,16009,11224,10752,54386
23,Afghanistan,2021,AFG-21/3481/RA2/WASH/NGO/18730,4/20/2022 9:12:18 AM,Host Communities,1612,1612,1893,1893,7010,1614,1610,1889,1897,7010
23,Afghanistan,2021,AFG-21/3481/RA2/WASH/NGO/18730,4/20/2022 9:12:18 AM,Internally Displaced People,440,444,520,520,1924,435,449,520,520,1924
23,Afghanistan,2021,AFG-21/3481/RA2/WASH/NGO/18730,4/20/2022 9:12:18 AM,Overall,2157,2165,2539,2539,9400,2159,2163,2534,2544,9400
23,Afghanistan,2021,AFG-21/3481/RA2/WASH/NGO/18730,4/20/2022 9:12:18 AM,Returnees,105,109,126,126,466,110,104,125,127,466
23,Afghanistan,2021,AFG-21/3481/RA3/APC/INGO/20010,6/29/2023 8:41:34 AM,Other,35156,37367,51423,47974,171920,89888,90824,122138,112825,415675
23,Afghanistan,2021,AFG-21/3481/RA3/APC/INGO/20010,6/29/2023 8:41:34 AM,Overall,35156,37367,51423,47974,171920,89888,90824,122138,112825,415675
23,Afghanistan,2021,AFG-21/3481/RA3/APC/INGO/20043,2/6/2023 9:20:44 AM,Host Communities,1134,1134,10434,9300,22002,2393,2010,10642,9003,24048
23,Afghanistan,2021,AFG-21/3481/RA3/APC/INGO/20043,2/6/2023 9:20:44 AM,Other,0,0,500,500,1000,39,183,940,885,2047
23,Afghanistan,2021,AFG-21/3481/RA3/APC/INGO/20043,2/6/2023 9:20:44 AM,Overall,1134,1134,10934,9800,23002,2432,2193,11582,9888,26095
23,Afghanistan,2021,AFG-21/3481/RA3/APC/INGO/20083,7/17/2023 1:28:52 PM,Host Communities,4800,10630,0,0,15430,4899,7601,0,0,12500
23,Afghanistan,2021,AFG-21/3481/RA3/APC/INGO/20083,7/17/2023 1:28:52 PM,Internally Displaced People,1218,2800,0,0,4018,4820,7569,0,0,12389
23,Afghanistan,2021,AFG-21/3481/RA3/APC/INGO/20083,7/17/2023 1:28:52 PM,Overall,6018,13430,0,0,19448,9719,15170,0,0,24889
23,Afghanistan,2021,AFG-21/3481/RA3/APC/INGO/20136,12/4/2022 9:37:21 AM,Host Communities,126,99,83,7,315,241,255,141,7,644
23,Afghanistan,2021,AFG-21/3481/RA3/APC/INGO/20136,12/4/2022 9:37:21 AM,Internally Displaced People,342,353,30,27,752,243,226,21,0,490
23,Afghanistan,2021,AFG-21/3481/RA3/APC/INGO/20136,12/4/2022 9:37:21 AM,Overall,508,491,118,39,1156,487,482,162,7,1138
23,Afghanistan,2021,AFG-21/3481/RA3/APC/INGO/20136,12/4/2022 9:37:21 AM,Returnees,40,39,5,5,89,3,1,0,0,4
23,Afghanistan,2021,AFG-21/3481/RA3/APC/INGO/20178,11/13/2022 12:53:44 PM,Host Communities,1572,1572,1072,1072,5288,2106,1742,1285,1211,6344
23,Afghanistan,2021,AFG-21/3481/RA3/APC/INGO/20178,11/13/2022 12:53:44 PM,Internally Displaced People,3668,3668,2502,2502,12340,4234,3668,2733,2744,13379
23,Afghanistan,2021,AFG-21/3481/RA3/APC/INGO/20178,11/13/2022 12:53:44 PM,Overall,5240,5240,3574,3574,17628,6340,5410,4018,3955,19723
23,Afghanistan,2021,AFG-21/3481/RA3/APC/INGO/20265,7/20/2023 10:15:34 AM,Host Communities,4265,4265,1670,1670,11870,6511,4732,4429,3774,19446
23,Afghanistan,2021,AFG-21/3481/RA3/APC/INGO/20265,7/20/2023 10:15:34 AM,Internally Displaced People,4265,4265,1670,1670,11870,3292,3171,2508,2435,11406
23,Afghanistan,2021,AFG-21/3481/RA3/APC/INGO/20265,7/20/2023 10:15:34 AM,Overall,10656,10656,4180,4180,29672,11596,9228,8127,7031,35982
23,Afghanistan,2021,AFG-21/3481/RA3/APC/INGO/20265,7/20/2023 10:15:34 AM,Returnees,2126,2126,840,840,5932,1793,1325,1190,822,5130
23,Afghanistan,2021,AFG-21/3481/RA3/APC/INGO/20335,12/26/2022 9:32:46 AM,Host Communities,2695,2623,1976,1978,9272,1956,1897,2937,2743,9533
23,Afghanistan,2021,AFG-21/3481/RA3/APC/INGO/20335,12/26/2022 9:32:46 AM,Internally Displaced People,727,695,633,633,2688,992,767,1486,1109,4354
23,Afghanistan,2021,AFG-21/3481/RA3/APC/INGO/20335,12/26/2022 9:32:46 AM,Overall,3422,3318,2609,2611,11960,2948,2664,4423,3852,13887
23,Afghanistan,2021,AFG-21/3481/RA3/APC/NGO/20065,12/26/2022 7:57:08 AM,Host Communities,300,400,440,320,1460,300,400,440,320,1460
23,Afghanistan,2021,AFG-21/3481/RA3/APC/NGO/20065,12/26/2022 7:57:08 AM,Internally Displaced People,600,500,4200,4130,9430,600,500,4200,4130,9430
23,Afghanistan,2021,AFG-21/3481/RA3/APC/NGO/20065,12/26/2022 7:57:08 AM,Overall,900,900,5700,5180,12680,900,900,5700,5180,12680
23,Afghanistan,2021,AFG-21/3481/RA3/APC/NGO/20065,12/26/2022 7:57:08 AM,Refugees,0,0,40,30,70,0,0,40,30,70
23,Afghanistan,2021,AFG-21/3481/RA3/APC/NGO/20065,12/26/2022 7:57:08 AM,Returnees,0,0,1020,700,1720,0,0,1020,700,1720
23,Afghanistan,2021,AFG-21/3481/RA3/APC/NGO/20240,12/21/2022 4:40:50 AM,Host Communities,295,205,205,205,910,390,321,262,242,1215
23,Afghanistan,2021,AFG-21/3481/RA3/APC/NGO/20240,12/21/2022 4:40:50 AM,Internally Displaced People,295,230,230,230,985,385,275,261,262,1183
23,Afghanistan,2021,AFG-21/3481/RA3/APC/NGO/20240,12/21/2022 4:40:50 AM,Other,205,105,105,105,520,15,13,2,6,36
23,Afghanistan,2021,AFG-21/3481/RA3/APC/NGO/20240,12/21/2022 4:40:50 AM,Overall,1090,770,770,770,3400,1095,877,780,745,3497
23,Afghanistan,2021,AFG-21/3481/RA3/APC/NGO/20240,12/21/2022 4:40:50 AM,Returnees,295,230,230,230,985,305,268,255,235,1063
23,Afghanistan,2021,AFG-21/3481/RA3/APC/UN/20116,9/22/2023 10:22:36 AM,Other,80,20,0,0,100,59,10,0,0,69
23,Afghanistan,2021,AFG-21/3481/RA3/APC/UN/20116,9/22/2023 10:22:36 AM,Overall,80,20,0,0,100,59,10,0,0,69
23,Afghanistan,2021,AFG-21/3481/RA3/APC/UN/20166,9/22/2023 7:07:44 AM,Host Communities,5800,5400,4600,4200,20000,16559,18991,19113,21084,75747
23,Afghanistan,2021,AFG-21/3481/RA3/APC/UN/20166,9/22/2023 7:07:44 AM,Internally Displaced People,11600,10800,9200,8400,40000,45675,48033,55595,62352,211655
23,Afghanistan,2021,AFG-21/3481/RA3/APC/UN/20166,9/22/2023 7:07:44 AM,Overall,29000,27000,23000,21000,100000,68001,73876,83834,93134,318845
23,Afghanistan,2021,AFG-21/3481/RA3/APC/UN/20166,9/22/2023 7:07:44 AM,Returnees,11600,10800,9200,8400,40000,5767,6852,9126,9698,31443
23,Afghanistan,2021,AFG-21/3481/RA3/APC/UN/20490,10/3/2023 3:54:10 AM,Host Communities,4363,4027,13088,12082,33560,17368,15440,25156,18401,76365
23,Afghanistan,2021,AFG-21/3481/RA3/APC/UN/20490,10/3/2023 3:54:10 AM,Internally Displaced People,1091,1007,3272,3020,8390,291,259,2210,2167,4927
23,Afghanistan,2021,AFG-21/3481/RA3/APC/UN/20490,10/3/2023 3:54:10 AM,Overall,5454,5034,16360,15102,41950,17659,15699,27366,20568,81292
23,Afghanistan,2021,AFG-21/3481/RA3/EIE/INGO/20066,7/20/2023 12:42:48 PM,Internally Displaced People,110,110,4100,4100,8420,163,77,4093,4417,8750
23,Afghanistan,2021,AFG-21/3481/RA3/EIE/INGO/20066,7/20/2023 12:42:48 PM,Overall,110,110,4100,4100,8420,163,77,4093,4417,8750
23,Afghanistan,2021,AFG-21/3481/RA3/EIE/INGO/20128,7/12/2023 1:38:07 PM,Other,30,50,1187,1213,2480,30,50,1122,1418,2620
23,Afghanistan,2021,AFG-21/3481/RA3/EIE/INGO/20128,7/12/2023 1:38:07 PM,Overall,30,50,1187,1213,2480,30,50,1122,1418,2620
23,Afghanistan,2021,AFG-21/3481/RA3/EIE/INGO/20132,2/6/2023 9:15:55 AM,Host Communities,518,51,983,982,2534,559,60,991,992,2602
23,Afghanistan,2021,AFG-21/3481/RA3/EIE/INGO/20132,2/6/2023 9:15:55 AM,Internally Displaced People,1208,1208,2293,2293,7002,1290,1150,2301,2301,7042
23,Afghanistan,2021,AFG-21/3481/RA3/EIE/INGO/20132,2/6/2023 9:15:55 AM,Overall,1726,1259,3276,3275,9536,1849,1210,3292,3293,9644
23,Afghanistan,2021,AFG-21/3481/RA3/EIE/INGO/20153,2/6/2023 9:25:19 AM,Host Communities,160,96,1080,1080,2416,131,125,1940,2258,4454
23,Afghanistan,2021,AFG-21/3481/RA3/EIE/INGO/20153,2/6/2023 9:25:19 AM,Internally Displaced People,0,0,2520,2520,5040,0,0,1456,1546,3002
23,Afghanistan,2021,AFG-21/3481/RA3/EIE/INGO/20153,2/6/2023 9:25:19 AM,Overall,160,96,3600,3600,7456,131,125,3396,3804,7456
23,Afghanistan,2021,AFG-21/3481/RA3/ESNFI/INGO/20036,11/13/2022 6:20:28 AM,Host Communities,922,922,1382,1382,4608,1125,1163,1462,1577,5327
23,Afghanistan,2021,AFG-21/3481/RA3/ESNFI/INGO/20036,11/13/2022 6:20:28 AM,Internally Displaced People,115,115,173,173,576,145,169,177,188,679
23,Afghanistan,2021,AFG-21/3481/RA3/ESNFI/INGO/20036,11/13/2022 6:20:28 AM,Overall,1152,1152,1728,1728,5760,1312,1375,1680,1821,6188
23,Afghanistan,2021,AFG-21/3481/RA3/ESNFI/INGO/20036,11/13/2022 6:20:28 AM,Returnees,115,115,173,173,576,42,43,41,56,182
23,Afghanistan,2021,AFG-21/3481/RA3/ESNFI/INGO/20072,5/26/2022 7:19:06 AM,Host Communities,2858,2858,1905,1905,9526,130,146,240,219,735
23,Afghanistan,2021,AFG-21/3481/RA3/ESNFI/INGO/20072,5/26/2022 7:19:06 AM,Internally Displaced People,317,317,212,212,1058,1376,1579,2670,2614,8239
23,Afghanistan,2021,AFG-21/3481/RA3/ESNFI/INGO/20072,5/26/2022 7:19:06 AM,Overall,3175,3175,2117,2117,10584,1506,1725,2910,2833,8974
23,Afghanistan,2021,AFG-21/3481/RA3/ESNFI/INGO/20121,12/6/2022 8:45:21 AM,Host Communities,765,732,796,766,3059,769,958,1592,1515,4834
23,Afghanistan,2021,AFG-21/3481/RA3/ESNFI/INGO/20121,12/6/2022 8:45:21 AM,Internally Displaced People,389,374,389,374,1526,67,81,140,127,415
23,Afghanistan,2021,AFG-21/3481/RA3/ESNFI/INGO/20121,12/6/2022 8:45:21 AM,Overall,1154,1106,1185,1140,4585,836,1039,1732,1642,5249
23,Afghanistan,2021,AFG-21/3481/RA3/ESNFI/INGO/20122,1/2/2023 10:09:39 AM,Host Communities,1078,1078,1617,1617,5390,2438,2649,2752,2828,10667
23,Afghanistan,2021,AFG-21/3481/RA3/ESNFI/INGO/20122,1/2/2023 10:09:39 AM,Other,462,462,693,693,2310,660,722,762,795,2939
23,Afghanistan,2021,AFG-21/3481/RA3/ESNFI/INGO/20122,1/2/2023 10:09:39 AM,Overall,1540,1540,2310,2310,7700,3098,3371,3514,3623,13606
23,Afghanistan,2021,AFG-21/3481/RA3/ESNFI/INGO/20133,7/2/2023 11:11:44 AM,Host Communities,673,831,1227,1227,3958,2246,2647,4738,4881,14512
23,Afghanistan,2021,AFG-21/3481/RA3/ESNFI/INGO/20133,7/2/2023 11:11:44 AM,Internally Displaced People,3139,3878,5725,5725,18467,1857,2227,4084,4206,12374
23,Afghanistan,2021,AFG-21/3481/RA3/ESNFI/INGO/20133,7/2/2023 11:11:44 AM,Overall,4485,5540,8179,8179,26383,4491,5341,9676,9967,29475
23,Afghanistan,2021,AFG-21/3481/RA3/ESNFI/INGO/20133,7/2/2023 11:11:44 AM,Returnees,673,831,1227,1227,3958,388,467,854,880,2589
23,Afghanistan,2021,AFG-21/3481/RA3/ESNFI/NGO/20107,11/13/2022 11:28:01 AM,Internally Displaced People,759,810,1518,1974,5061,1082,1322,1640,1912,5956
23,Afghanistan,2021,AFG-21/3481/RA3/ESNFI/NGO/20107,11/13/2022 11:28:01 AM,Other,380,405,759,986,2530,373,393,665,748,2179
23,Afghanistan,2021,AFG-21/3481/RA3/ESNFI/NGO/20107,11/13/2022 11:28:01 AM,Overall,1266,1350,2530,3289,8435,1621,1883,2613,3033,9150
23,Afghanistan,2021,AFG-21/3481/RA3/ESNFI/NGO/20107,11/13/2022 11:28:01 AM,Returnees,127,135,253,329,844,166,168,308,373,1015
23,Afghanistan,2021,AFG-21/3481/RA3/ESNFI/NGO/20115,11/10/2022 7:30:43 AM,Internally Displaced People,3729,4515,5300,6084,19628,3729,4515,5300,6084,19628
23,Afghanistan,2021,AFG-21/3481/RA3/ESNFI/NGO/20115,11/10/2022 7:30:43 AM,Overall,3729,4515,5300,6084,19628,3729,4515,5300,6084,19628
23,Afghanistan,2021,AFG-21/3481/RA3/ESNFI/NGO/20151,9/29/2023 7:09:23 AM,Internally Displaced People,2113,2067,2618,2389,9187,1684,2265,2987,3392,10328
23,Afghanistan,2021,AFG-21/3481/RA3/ESNFI/NGO/20151,9/29/2023 7:09:23 AM,Other,704,690,873,796,3063,202,222,214,292,930
23,Afghanistan,2021,AFG-21/3481/RA3/ESNFI/NGO/20151,9/29/2023 7:09:23 AM,Overall,2817,2757,3491,3185,12250,1886,2487,3201,3684,11258
23,Afghanistan,2021,AFG-21/3481/RA3/ESNFI/UN/20049,12/16/2022 8:28:17 AM,Internally Displaced People,3220,3220,4830,4830,16100,2517,2898,5063,5168,15646
23,Afghanistan,2021,AFG-21/3481/RA3/ESNFI/UN/20049,12/16/2022 8:28:17 AM,Overall,3220,3220,4830,4830,16100,2517,2898,5063,5168,15646
23,Afghanistan,2021,AFG-21/3481/RA3/FSAC/INGO/20024,11/30/2022 6:07:19 AM,Host Communities,3771,3771,7542,11316,26400,5806,5766,9044,8303,28919
23,Afghanistan,2021,AFG-21/3481/RA3/FSAC/INGO/20024,11/30/2022 6:07:19 AM,Overall,3771,3771,7542,11316,26400,5806,5766,9044,8303,28919
23,Afghanistan,2021,AFG-21/3481/RA3/FSAC/INGO/20045,9/28/2022 9:56:28 AM,Internally Displaced People,2457,2363,2362,2268,9450,1655,2051,2907,2818,9431
23,Afghanistan,2021,AFG-21/3481/RA3/FSAC/INGO/20045,9/28/2022 9:56:28 AM,Overall,2457,2363,2362,2268,9450,1655,2051,2907,2818,9431
23,Afghanistan,2021,AFG-21/3481/RA3/FSAC/NGO/20007,12/16/2022 7:16:48 AM,Host Communities,1500,500,500,500,3000,3000,0,0,0,3000
23,Afghanistan,2021,AFG-21/3481/RA3/FSAC/NGO/20007,12/16/2022 7:16:48 AM,Overall,1500,500,500,500,3000,3000,0,0,0,3000
23,Afghanistan,2021,AFG-21/3481/RA3/FSAC/NGO/20027,11/27/2022 5:40:35 AM,Host Communities,780,780,1520,1540,4620,786,828,1661,1605,4880
23,Afghanistan,2021,AFG-21/3481/RA3/FSAC/NGO/20027,11/27/2022 5:40:35 AM,Internally Displaced People,740,760,1540,1551,4591,818,886,1565,1575,4844
23,Afghanistan,2021,AFG-21/3481/RA3/FSAC/NGO/20027,11/27/2022 5:40:35 AM,Overall,1520,1540,3060,3091,9211,1604,1714,3226,3180,9724
23,Afghanistan,2021,AFG-21/3481/RA3/FSAC/NGO/20030,1/5/2023 9:42:59 AM,Host Communities,5171,6260,7349,8437,27217,5171,6260,7349,8437,27217
23,Afghanistan,2021,AFG-21/3481/RA3/FSAC/NGO/20030,1/5/2023 9:42:59 AM,Internally Displaced People,1500,1816,2132,2447,7895,1500,1816,2132,2447,7895
23,Afghanistan,2021,AFG-21/3481/RA3/FSAC/NGO/20030,1/5/2023 9:42:59 AM,Overall,6671,8076,9481,10884,35112,6671,8076,9481,10884,35112
23,Afghanistan,2021,AFG-21/3481/RA3/FSAC/NGO/20046,12/18/2022 7:03:29 AM,Host Communities,1209,1322,1610,1610,5751,1110,1220,1470,1500,5300
23,Afghanistan,2021,AFG-21/3481/RA3/FSAC/NGO/20046,12/18/2022 7:03:29 AM,Internally Displaced People,301,331,403,403,1438,277,330,441,485,1533
23,Afghanistan,2021,AFG-21/3481/RA3/FSAC/NGO/20046,12/18/2022 7:03:29 AM,Overall,1510,1653,2013,2013,7189,1387,1550,1911,1985,6833
23,Afghanistan,2021,AFG-21/3481/RA3/FSAC/NGO/20112,7/15/2023 9:50:47 AM,Host Communities,871,1088,971,1088,4018,2450,1400,1078,700,5628
23,Afghanistan,2021,AFG-21/3481/RA3/FSAC/NGO/20112,7/15/2023 9:50:47 AM,Internally Displaced People,951,1202,1088,1218,4459,1190,524,959,175,2848
23,Afghanistan,2021,AFG-21/3481/RA3/FSAC/NGO/20112,7/15/2023 9:50:47 AM,Other,8813,11079,9962,11157,41011,10596,10028,19203,17447,57274
23,Afghanistan,2021,AFG-21/3481/RA3/FSAC/NGO/20112,7/15/2023 9:50:47 AM,Overall,10635,13369,12021,13463,49488,14236,11952,21240,18322,65750
23,Afghanistan,2021,AFG-21/3481/RA3/FSAC/UN/20034,11/13/2022 6:16:25 AM,Host Communities,6856,7005,8346,7600,29807,7237,7394,8347,8487,31465
23,Afghanistan,2021,AFG-21/3481/RA3/FSAC/UN/20034,11/13/2022 6:16:25 AM,Overall,6856,7005,8346,7600,29807,7237,7394,8347,8487,31465
23,Afghanistan,2021,AFG-21/3481/RA3/H/INGO/20018,12/5/2022 12:58:06 PM,Host Communities,11197,9200,2605,2790,25792,9090,7202,6697,4056,27045
23,Afghanistan,2021,AFG-21/3481/RA3/H/INGO/20018,12/5/2022 12:58:06 PM,Internally Displaced People,8907,11875,2797,3131,26710,8530,20456,6595,6571,42152
23,Afghanistan,2021,AFG-21/3481/RA3/H/INGO/20018,12/5/2022 12:58:06 PM,Overall,21073,22380,5883,6496,55832,19001,29040,14641,11769,74451
23,Afghanistan,2021,AFG-21/3481/RA3/H/INGO/20018,12/5/2022 12:58:06 PM,Returnees,969,1305,481,575,3330,1381,1382,1349,1142,5254
23,Afghanistan,2021,AFG-21/3481/RA3/H/INGO/20031,12/16/2022 12:53:58 PM,Host Communities,20552,19307,8976,8964,57799,30596,27794,11094,10554,80038
23,Afghanistan,2021,AFG-21/3481/RA3/H/INGO/20031,12/16/2022 12:53:58 PM,Internally Displaced People,60,50,55,57,222,173,100,638,422,1333
23,Afghanistan,2021,AFG-21/3481/RA3/H/INGO/20031,12/16/2022 12:53:58 PM,Overall,20612,19357,9031,9021,58021,30769,27894,11732,10976,81371
23,Afghanistan,2021,AFG-21/3481/RA3/H/INGO/20042,11/9/2022 12:49:53 PM,Host Communities,6305,16813,8406,10508,42032,11128,18993,7868,8640,46629
23,Afghanistan,2021,AFG-21/3481/RA3/H/INGO/20042,11/9/2022 12:49:53 PM,Internally Displaced People,1940,5172,2587,3233,12932,2563,6702,2418,2656,14339
23,Afghanistan,2021,AFG-21/3481/RA3/H/INGO/20042,11/9/2022 12:49:53 PM,Overall,9700,25865,12933,16166,64664,15586,30721,12101,13287,71695
23,Afghanistan,2021,AFG-21/3481/RA3/H/INGO/20042,11/9/2022 12:49:53 PM,Returnees,1455,3880,1940,2425,9700,1895,5026,1815,1991,10727
23,Afghanistan,2021,AFG-21/3481/RA3/H/INGO/20073,11/10/2022 6:14:35 AM,Host Communities,12767,15843,17253,15926,61789,11188,14070,17355,21027,63640
23,Afghanistan,2021,AFG-21/3481/RA3/H/INGO/20073,11/10/2022 6:14:35 AM,Internally Displaced People,672,833,908,838,3251,589,741,913,1107,3350
23,Afghanistan,2021,AFG-21/3481/RA3/H/INGO/20073,11/10/2022 6:14:35 AM,Overall,13439,16676,18161,16764,65040,11777,14811,18268,22134,66990
23,Afghanistan,2021,AFG-21/3481/RA3/H/NGO/20009,12/10/2022 5:09:56 PM,Host Communities,23439,31715,9227,6172,70553,29460,33271,20141,18321,101193
23,Afghanistan,2021,AFG-21/3481/RA3/H/NGO/20009,12/10/2022 5:09:56 PM,Other,60,44,0,0,104,58,46,0,0,104
23,Afghanistan,2021,AFG-21/3481/RA3/H/NGO/20009,12/10/2022 5:09:56 PM,Overall,23499,31759,9227,6172,70657,29518,33317,20141,18321,101297
23,Afghanistan,2021,AFG-21/3481/RA3/H/NGO/20035,12/5/2022 1:02:19 PM,Host Communities,12085,12086,2761,2865,29797,13678,9834,3438,3227,30177
23,Afghanistan,2021,AFG-21/3481/RA3/H/NGO/20035,12/5/2022 1:02:19 PM,Internally Displaced People,2018,2129,708,730,5585,2911,1712,331,514,5468
23,Afghanistan,2021,AFG-21/3481/RA3/H/NGO/20035,12/5/2022 1:02:19 PM,Overall,14103,14215,3469,3595,35382,16589,11546,3769,3741,35645
23,Afghanistan,2021,AFG-21/3481/RA3/H/UN/20003,2/7/2023 12:56:07 PM,Internally Displaced People,2300,28000,1400,2800,34500,2200,29300,1475,3050,36025
23,Afghanistan,2021,AFG-21/3481/RA3/H/UN/20003,2/7/2023 12:56:07 PM,Overall,2300,28000,1400,2800,34500,2200,29300,1475,3050,36025
23,Afghanistan,2021,AFG-21/3481/RA3/H/UN/20021,2/8/2023 10:18:21 AM,Host Communities,52031,72778,41328,41328,207465,31598,41055,30774,28833,132260
23,Afghanistan,2021,AFG-21/3481/RA3/H/UN/20021,2/8/2023 10:18:21 AM,Internally Displaced People,13088,18323,10470,10470,52351,6797,8455,6366,5678,27296
23,Afghanistan,2021,AFG-21/3481/RA3/H/UN/20021,2/8/2023 10:18:21 AM,Overall,66428,92933,52845,52844,265050,38400,49517,37144,34515,159576
23,Afghanistan,2021,AFG-21/3481/RA3/H/UN/20021,2/8/2023 10:18:21 AM,Returnees,1309,1832,1047,1046,5234,5,7,4,4,20
23,Afghanistan,2021,AFG-21/3481/RA3/H-N/NGO/20005,12/26/2022 11:34:01 AM,Host Communities,13747,19711,4629,4351,42438,14382,20135,4024,4486,43027
23,Afghanistan,2021,AFG-21/3481/RA3/H-N/NGO/20005,12/26/2022 11:34:01 AM,Internally Displaced People,2481,4601,5057,5002,17141,5061,16031,4777,4844,30713
23,Afghanistan,2021,AFG-21/3481/RA3/H-N/NGO/20005,12/26/2022 11:34:01 AM,Other,26,19,0,0,45,52,37,0,0,89
23,Afghanistan,2021,AFG-21/3481/RA3/H-N/NGO/20005,12/26/2022 11:34:01 AM,Overall,16254,24331,9686,9353,59624,19495,36203,8801,9330,73829
23,Afghanistan,2021,AFG-21/3481/RA3/N/NGO/20028,9/29/2022 11:32:05 AM,Host Communities,565,540,303,321,1729,577,6030,2535,2320,11462
23,Afghanistan,2021,AFG-21/3481/RA3/N/NGO/20028,9/29/2022 11:32:05 AM,Internally Displaced People,1755,1686,1755,1754,6950,150,1575,631,534,2890
23,Afghanistan,2021,AFG-21/3481/RA3/N/NGO/20028,9/29/2022 11:32:05 AM,Overall,2440,2312,2173,2195,9120,787,8548,3466,3203,16004
23,Afghanistan,2021,AFG-21/3481/RA3/N/NGO/20028,9/29/2022 11:32:05 AM,Returnees,120,86,115,120,441,60,943,300,349,1652
23,Afghanistan,2021,AFG-21/3481/RA3/N/UN/20025,12/16/2022 10:57:03 AM,Host Communities,0,0,1676,1610,3286,0,0,3404,3271,6675
23,Afghanistan,2021,AFG-21/3481/RA3/N/UN/20025,12/16/2022 10:57:03 AM,Internally Displaced People,0,0,186,179,365,0,0,175,190,365
23,Afghanistan,2021,AFG-21/3481/RA3/N/UN/20025,12/16/2022 10:57:03 AM,Overall,0,0,1862,1789,3651,0,0,3579,3461,7040
23,Afghanistan,2021,AFG-21/3481/RA3/N/UN/20048,12/21/2022 4:42:54 AM,Host Communities,0,4060,4336,4166,12562,0,21314,16784,16126,54224
23,Afghanistan,2021,AFG-21/3481/RA3/N/UN/20048,12/21/2022 4:42:54 AM,Internally Displaced People,0,839,857,824,2520,0,5329,4196,4032,13557
23,Afghanistan,2021,AFG-21/3481/RA3/N/UN/20048,12/21/2022 4:42:54 AM,Overall,0,4899,5193,4990,15082,0,26643,20980,20158,67781
23,Afghanistan,2021,AFG-21/3481/RA3/N/UN/20095,12/5/2022 1:14:06 PM,Host Communities,0,0,2789,3409,6198,0,0,3081,3766,6847
23,Afghanistan,2021,AFG-21/3481/RA3/N/UN/20095,12/5/2022 1:14:06 PM,Internally Displaced People,0,0,147,179,326,0,0,162,198,360
23,Afghanistan,2021,AFG-21/3481/RA3/N/UN/20095,12/5/2022 1:14:06 PM,Overall,0,0,2936,3588,6524,0,0,3243,3964,7207
23,Afghanistan,2021,AFG-21/3481/RA3/N-H/INGO/20017,9/29/2022 10:52:35 AM,Other,7230,35671,23701,22819,89421,13845,60529,30120,38524,143018
23,Afghanistan,2021,AFG-21/3481/RA3/N-H/INGO/20017,9/29/2022 10:52:35 AM,Overall,7230,35671,23701,22819,89421,13845,60529,30120,38524,143018
23,Afghanistan,2021,AFG-21/3481/RA3/WASH/INGO/20026,1/2/2023 10:13:30 AM,Host Communities,7947,7945,10475,9754,36121,10712,11060,16691,17406,55869
23,Afghanistan,2021,AFG-21/3481/RA3/WASH/INGO/20026,1/2/2023 10:13:30 AM,Internally Displaced People,3311,3311,4365,4062,15049,4508,4645,6039,6154,21346
23,Afghanistan,2021,AFG-21/3481/RA3/WASH/INGO/20026,1/2/2023 10:13:30 AM,Overall,13245,13242,17459,16254,60200,16208,16725,24033,24816,81782
23,Afghanistan,2021,AFG-21/3481/RA3/WASH/INGO/20026,1/2/2023 10:13:30 AM,Returnees,1987,1986,2619,2438,9030,988,1020,1303,1256,4567
23,Afghanistan,2021,AFG-21/3481/RA3/WASH/INGO/20037,12/21/2022 6:51:48 AM,Host Communities,4565,4773,5810,5602,20750,2835,2930,5372,5049,16186
23,Afghanistan,2021,AFG-21/3481/RA3/WASH/INGO/20037,12/21/2022 6:51:48 AM,Internally Displaced People,3080,3220,3920,3780,14000,6059,6341,11362,11234,34996
23,Afghanistan,2021,AFG-21/3481/RA3/WASH/INGO/20037,12/21/2022 6:51:48 AM,Overall,8250,8626,10500,10124,37500,9271,9598,17567,17149,53585
23,Afghanistan,2021,AFG-21/3481/RA3/WASH/INGO/20037,12/21/2022 6:51:48 AM,Returnees,605,633,770,742,2750,377,327,833,866,2403
23,Afghanistan,2021,AFG-21/3481/RA3/WASH/INGO/20041,12/8/2022 7:31:32 AM,Host Communities,3310,3426,2283,2398,11417,1605,1737,4068,4651,12061
23,Afghanistan,2021,AFG-21/3481/RA3/WASH/INGO/20041,12/8/2022 7:31:32 AM,Internally Displaced People,271,274,185,194,924,275,309,611,623,1818
23,Afghanistan,2021,AFG-21/3481/RA3/WASH/INGO/20041,12/8/2022 7:31:32 AM,Overall,4156,4269,2856,2999,14280,1955,2129,4760,5406,14250
23,Afghanistan,2021,AFG-21/3481/RA3/WASH/INGO/20041,12/8/2022 7:31:32 AM,Refugees,88,90,60,63,301,40,48,49,80,217
23,Afghanistan,2021,AFG-21/3481/RA3/WASH/INGO/20041,12/8/2022 7:31:32 AM,Returnees,487,479,328,344,1638,35,35,32,52,154
23,Afghanistan,2021,AFG-21/3481/RA3/WASH/INGO/20068,12/13/2022 4:56:22 PM,Host Communities,4617,5387,12825,13082,35911,38143,40303,39211,44271,161928
23,Afghanistan,2021,AFG-21/3481/RA3/WASH/INGO/20068,12/13/2022 4:56:22 PM,Internally Displaced People,1979,2309,5496,5606,15390,5325,5219,6350,6543,23437
23,Afghanistan,2021,AFG-21/3481/RA3/WASH/INGO/20068,12/13/2022 4:56:22 PM,Overall,6596,7696,18321,18688,51301,43468,45522,45561,50814,185365
23,Afghanistan,2021,AFG-21/3481/RA3/WASH/INGO/20075,6/12/2023 3:54:26 PM,Host Communities,7318,7617,7530,7598,30063,8536,5598,6630,6386,27150
23,Afghanistan,2021,AFG-21/3481/RA3/WASH/INGO/20075,6/12/2023 3:54:26 PM,Overall,7318,7617,7530,7598,30063,8536,5598,6630,6386,27150
23,Afghanistan,2021,AFG-21/3481/RA3/WASH/INGO/20104,2/7/2023 1:06:02 PM,Host Communities,3276,3440,5078,4586,16380,2011,2085,2620,2711,9427
23,Afghanistan,2021,AFG-21/3481/RA3/WASH/INGO/20104,2/7/2023 1:06:02 PM,Overall,3276,3440,5078,4586,16380,2011,2085,2620,2711,9427
23,Afghanistan,2021,AFG-21/3481/RA3/WASH/INGO/20269,9/25/2023 4:51:03 AM,Host Communities,5997,6330,10994,9995,33316,6036,6370,11066,10060,33532
23,Afghanistan,2021,AFG-21/3481/RA3/WASH/INGO/20269,9/25/2023 4:51:03 AM,Internally Displaced People,316,333,579,526,1754,317,335,582,530,1764
23,Afghanistan,2021,AFG-21/3481/RA3/WASH/INGO/20269,9/25/2023 4:51:03 AM,Overall,6313,6663,11573,10521,35070,6353,6705,11648,10590,35296
23,Afghanistan,2021,AFG-21/3481/RA3/WASH/NGO/20029,12/5/2022 6:35:16 AM,Host Communities,3684,4461,5236,6010,19391,3684,4461,5236,6010,19391
23,Afghanistan,2021,AFG-21/3481/RA3/WASH/NGO/20029,12/5/2022 6:35:16 AM,Internally Displaced People,1052,1273,1496,1718,5539,1052,1273,1496,1718,5539
23,Afghanistan,2021,AFG-21/3481/RA3/WASH/NGO/20029,12/5/2022 6:35:16 AM,Overall,5261,6371,7481,8587,27700,5261,6371,7481,8587,27700
23,Afghanistan,2021,AFG-21/3481/RA3/WASH/NGO/20029,12/5/2022 6:35:16 AM,Returnees,525,637,749,859,2770,525,637,749,859,2770
23,Afghanistan,2021,AFG-21/3481/RA3/WASH/NGO/20118,11/10/2022 7:12:52 AM,Host Communities,577,615,1154,1500,3846,577,615,1509,1862,4563
23,Afghanistan,2021,AFG-21/3481/RA3/WASH/NGO/20118,11/10/2022 7:12:52 AM,Internally Displaced People,865,923,1731,2250,5769,796,845,1722,2038,5401
23,Afghanistan,2021,AFG-21/3481/RA3/WASH/NGO/20118,11/10/2022 7:12:52 AM,Overall,1442,1538,2885,3750,9615,1373,1460,3231,3900,9964
23,Afghanistan,2021,AFG-21/3481/RA3/WASH/NGO/20221,12/5/2022 9:45:07 AM,Host Communities,2000,2200,3000,3300,10500,3176,3375,5868,6229,18648
23,Afghanistan,2021,AFG-21/3481/RA3/WASH/NGO/20221,12/5/2022 9:45:07 AM,Internally Displaced People,1000,1050,1500,1700,5250,1173,1285,1566,1868,5892
23,Afghanistan,2021,AFG-21/3481/RA3/WASH/NGO/20221,12/5/2022 9:45:07 AM,Overall,3000,3250,4500,5000,15750,4349,4660,7434,8097,24540
23,Afghanistan,2021,AFG-21/3481/RA3/WASH/NGO/20415,11/14/2022 5:21:35 AM,Host Communities,4610,4610,3074,3074,15368,4581,4584,3112,3054,15331
23,Afghanistan,2021,AFG-21/3481/RA3/WASH/NGO/20415,11/14/2022 5:21:35 AM,Internally Displaced People,864,864,577,576,2881,903,845,614,548,2910
23,Afghanistan,2021,AFG-21/3481/RA3/WASH/NGO/20415,11/14/2022 5:21:35 AM,Overall,5762,5762,3844,3842,19210,5775,5699,3947,3787,19208
23,Afghanistan,2021,AFG-21/3481/RA3/WASH/NGO/20415,11/14/2022 5:21:35 AM,Returnees,288,288,193,192,961,291,270,221,185,967
23,Afghanistan,2021,AFG-21/3481/SA1/APC/INGO/21129,7/19/2023 8:23:20 AM,Host Communities,3749,1956,7466,5577,18748,2534,865,7975,5834,17208
23,Afghanistan,2021,AFG-21/3481/SA1/APC/INGO/21129,7/19/2023 8:23:20 AM,Overall,3749,1956,7466,5577,18748,2534,865,7975,5834,17208
23,Afghanistan,2021,AFG-21/3481/SA1/APC/INGO/21201,12/21/2022 4:32:44 AM,Other,5685,9312,13911,11278,40186,7069,7562,23983,21248,59862
23,Afghanistan,2021,AFG-21/3481/SA1/APC/INGO/21201,12/21/2022 4:32:44 AM,Overall,5685,9312,13911,11278,40186,7069,7562,23983,21248,59862
23,Afghanistan,2021,AFG-21/3481/SA1/APC/INGO/21214,9/21/2023 8:46:44 AM,Host Communities,1993,1950,215,217,4375,2220,2509,4231,4101,13061
23,Afghanistan,2021,AFG-21/3481/SA1/APC/INGO/21214,9/21/2023 8:46:44 AM,Internally Displaced People,11504,11494,734,754,24486,10572,9936,4165,4342,29015
23,Afghanistan,2021,AFG-21/3481/SA1/APC/INGO/21214,9/21/2023 8:46:44 AM,Overall,15766,15674,1308,1331,34079,17623,15127,13128,13171,59049
23,Afghanistan,2021,AFG-21/3481/SA1/APC/INGO/21214,9/21/2023 8:46:44 AM,Returnees,2269,2230,359,360,5218,4831,2682,4732,4728,16973
23,Afghanistan,2021,AFG-21/3481/SA1/APC/INGO/21341,12/5/2022 7:34:52 AM,Host Communities,2981,2981,3037,3037,12036,4625,4342,3620,3378,15965
23,Afghanistan,2021,AFG-21/3481/SA1/APC/INGO/21341,12/5/2022 7:34:52 AM,Internally Displaced People,4471,4471,4555,4555,18052,4990,4980,4333,4230,18533
23,Afghanistan,2021,AFG-21/3481/SA1/APC/INGO/21341,12/5/2022 7:34:52 AM,Overall,7452,7452,7592,7592,30088,9615,9322,7953,7608,34498
23,Afghanistan,2021,AFG-21/3481/SA1/APC/INGO/21346,7/20/2023 8:34:34 AM,Host Communities,8292,8292,3807,3807,24198,12199,10170,7122,6724,36215
23,Afghanistan,2021,AFG-21/3481/SA1/APC/INGO/21346,7/20/2023 8:34:34 AM,Internally Displaced People,5528,5528,2538,2538,16132,4733,3286,2546,2323,12888
23,Afghanistan,2021,AFG-21/3481/SA1/APC/INGO/21346,7/20/2023 8:34:34 AM,Overall,13820,13820,6345,6345,40330,16932,13456,9668,9047,49103
23,Afghanistan,2021,AFG-21/3481/SA1/APC/INGO/21354,2/5/2023 12:23:18 PM,Host Communities,2016,2016,900,900,5832,3010,2660,1053,906,7629
23,Afghanistan,2021,AFG-21/3481/SA1/APC/INGO/21354,2/5/2023 12:23:18 PM,Internally Displaced People,1344,1344,600,600,3888,1344,1344,478,432,3598
23,Afghanistan,2021,AFG-21/3481/SA1/APC/INGO/21354,2/5/2023 12:23:18 PM,Overall,3360,3360,1500,1500,9720,4354,4004,1531,1338,11227
23,Afghanistan,2021,AFG-21/3481/SA1/APC/NGO/21348,12/21/2022 4:32:16 AM,Host Communities,4750,4500,8000,7750,25000,3203,2697,10822,8278,25000
23,Afghanistan,2021,AFG-21/3481/SA1/APC/NGO/21348,12/21/2022 4:32:16 AM,Overall,4750,4500,8000,7750,25000,3203,2697,10822,8278,25000
23,Afghanistan,2021,AFG-21/3481/SA1/APC/NGO/21376,12/5/2022 9:41:45 AM,Host Communities,1820,1690,5340,5550,14400,72,73,8444,8698,17287
23,Afghanistan,2021,AFG-21/3481/SA1/APC/NGO/21376,12/5/2022 9:41:45 AM,Internally Displaced People,560,520,2520,2400,6000,29,29,3348,3448,6854
23,Afghanistan,2021,AFG-21/3481/SA1/APC/NGO/21376,12/5/2022 9:41:45 AM,Overall,2800,2600,10000,10000,25400,125,126,14557,14995,29803
23,Afghanistan,2021,AFG-21/3481/SA1/APC/NGO/21376,12/5/2022 9:41:45 AM,Returnees,420,390,2140,2050,5000,24,24,2765,2849,5662
23,Afghanistan,2021,AFG-21/3481/SA1/APC/NGO/21383,12/3/2022 5:40:09 PM,Host Communities,1638,1512,546,504,4200,2761,2607,1188,1037,7593
23,Afghanistan,2021,AFG-21/3481/SA1/APC/NGO/21383,12/3/2022 5:40:09 PM,Internally Displaced People,7800,7200,2600,2400,20000,12108,11430,5213,4550,33301
23,Afghanistan,2021,AFG-21/3481/SA1/APC/NGO/21383,12/3/2022 5:40:09 PM,Overall,15600,14400,5200,4800,40000,21241,20053,9144,7982,58420
23,Afghanistan,2021,AFG-21/3481/SA1/APC/NGO/21383,12/3/2022 5:40:09 PM,Returnees,6162,5688,2054,1896,15800,6372,6016,2743,2395,17526
23,Afghanistan,2021,AFG-21/3481/SA1/APC/UN/20554,7/17/2023 7:12:24 AM,Internally Displaced People,310,341,481,419,1551,151,225,425,396,1197
23,Afghanistan,2021,AFG-21/3481/SA1/APC/UN/20554,7/17/2023 7:12:24 AM,Overall,3102,3413,4809,4188,15512,1896,2212,3325,3248,10681
23,Afghanistan,2021,AFG-21/3481/SA1/APC/UN/20554,7/17/2023 7:12:24 AM,Returnees,2792,3072,4328,3769,13961,1745,1987,2900,2852,9484
23,Afghanistan,2021,AFG-21/3481/SA1/APC/UN/21259,12/5/2022 7:40:01 AM,Host Communities,2000,12500,1500,5000,21000,0,11839,0,2961,14800
23,Afghanistan,2021,AFG-21/3481/SA1/APC/UN/21259,12/5/2022 7:40:01 AM,Internally Displaced People,2500,12500,2500,5000,22500,0,365,0,91,456
23,Afghanistan,2021,AFG-21/3481/SA1/APC/UN/21259,12/5/2022 7:40:01 AM,Overall,4500,25000,4000,10000,43500,0,12204,0,3052,15256
23,Afghanistan,2021,AFG-21/3481/SA1/APC/UN/21323,1/5/2023 6:11:43 AM,Host Communities,5035,1103,185,45,6368,7799,3614,391,116,11920
23,Afghanistan,2021,AFG-21/3481/SA1/APC/UN/21323,1/5/2023 6:11:43 AM,Internally Displaced People,2218,722,24,20,2984,2629,1440,32,29,4130
23,Afghanistan,2021,AFG-21/3481/SA1/APC/UN/21323,1/5/2023 6:11:43 AM,Other,90,21,0,0,111,327,71,0,0,398
23,Afghanistan,2021,AFG-21/3481/SA1/APC/UN/21323,1/5/2023 6:11:43 AM,Overall,8048,1975,243,67,10333,12548,5536,474,158,18716
23,Afghanistan,2021,AFG-21/3481/SA1/APC/UN/21323,1/5/2023 6:11:43 AM,Returnees,705,129,34,2,870,1793,411,51,13,2268
23,Afghanistan,2021,AFG-21/3481/SA1/APC/UN/21343,10/8/2023 11:15:56 AM,Host Communities,8216,7584,22752,24648,63200,11133,14064,41169,32956,99322
23,Afghanistan,2021,AFG-21/3481/SA1/APC/UN/21343,10/8/2023 11:15:56 AM,Internally Displaced People,2054,1896,5688,6162,15800,432,890,4172,4326,9820
23,Afghanistan,2021,AFG-21/3481/SA1/APC/UN/21343,10/8/2023 11:15:56 AM,Overall,10270,9480,28440,30810,79000,11565,14954,45341,37282,109142
23,Afghanistan,2021,AFG-21/3481/SA1/EIE/INGO/21033,9/30/2023 6:36:37 AM,Host Communities,100,155,630,946,1831,343,132,1464,1328,3267
23,Afghanistan,2021,AFG-21/3481/SA1/EIE/INGO/21033,9/30/2023 6:36:37 AM,Internally Displaced People,245,370,1470,2204,4289,201,199,1177,1265,2842
23,Afghanistan,2021,AFG-21/3481/SA1/EIE/INGO/21033,9/30/2023 6:36:37 AM,Overall,345,525,2100,3150,6120,544,331,2641,2593,6109
23,Afghanistan,2021,AFG-21/3481/SA1/EIE/INGO/21040,10/1/2023 4:18:17 AM,Internally Displaced People,645,230,2695,2730,6300,2586,291,2102,3323,8302
23,Afghanistan,2021,AFG-21/3481/SA1/EIE/INGO/21040,10/1/2023 4:18:17 AM,Overall,645,230,2695,2730,6300,2586,291,2102,3323,8302
23,Afghanistan,2021,AFG-21/3481/SA1/EIE/INGO/21046,10/4/2023 7:29:22 AM,Host Communities,364,186,928,1392,2870,264,203,1043,1138,2648
23,Afghanistan,2021,AFG-21/3481/SA1/EIE/INGO/21046,10/4/2023 7:29:22 AM,Internally Displaced People,360,90,1160,1740,3350,325,272,988,2240,3825
23,Afghanistan,2021,AFG-21/3481/SA1/EIE/INGO/21046,10/4/2023 7:29:22 AM,Overall,796,294,2320,3480,6890,625,509,2225,3697,7056
23,Afghanistan,2021,AFG-21/3481/SA1/EIE/INGO/21046,10/4/2023 7:29:22 AM,Returnees,72,18,232,348,670,36,34,194,319,583
23,Afghanistan,2021,AFG-21/3481/SA1/EIE/INGO/21047,7/12/2023 1:43:07 PM,Host Communities,924,924,840,840,3528,528,919,1009,1099,3555
23,Afghanistan,2021,AFG-21/3481/SA1/EIE/INGO/21047,7/12/2023 1:43:07 PM,Internally Displaced People,616,616,560,560,2352,138,307,336,367,1148
23,Afghanistan,2021,AFG-21/3481/SA1/EIE/INGO/21047,7/12/2023 1:43:07 PM,Overall,1540,1540,1400,1400,5880,666,1226,1345,1466,4703
23,Afghanistan,2021,AFG-21/3481/SA1/EIE/INGO/21067,7/18/2023 8:07:38 AM,Internally Displaced People,595,397,4340,4340,9672,789,195,3122,5558,9664
23,Afghanistan,2021,AFG-21/3481/SA1/EIE/INGO/21067,7/18/2023 8:07:38 AM,Overall,595,397,4340,4340,9672,789,195,3122,5558,9664
23,Afghanistan,2021,AFG-21/3481/SA1/EIE/INGO/21197,10/2/2023 9:35:06 AM,Host Communities,88,86,1701,1701,3576,382,155,8453,4025,13015
23,Afghanistan,2021,AFG-21/3481/SA1/EIE/INGO/21197,10/2/2023 9:35:06 AM,Internally Displaced People,173,173,3404,3404,7154,188,99,2576,1371,4234
23,Afghanistan,2021,AFG-21/3481/SA1/EIE/INGO/21197,10/2/2023 9:35:06 AM,Overall,434,432,8509,8509,17884,616,262,11469,5588,17935
23,Afghanistan,2021,AFG-21/3481/SA1/EIE/INGO/21197,10/2/2023 9:35:06 AM,Returnees,173,173,3404,3404,7154,46,8,440,192,686
23,Afghanistan,2021,AFG-21/3481/SA1/EIE/INGO/21374,9/24/2023 10:02:07 AM,Host Communities,2051,2051,3619,3619,11340,2060,2070,3912,3692,11734
23,Afghanistan,2021,AFG-21/3481/SA1/EIE/INGO/21374,9/24/2023 10:02:07 AM,Internally Displaced People,733,733,1293,1293,4052,730,750,1295,1310,4085
23,Afghanistan,2021,AFG-21/3481/SA1/EIE/INGO/21374,9/24/2023 10:02:07 AM,Overall,2931,2931,5171,5171,16204,2930,2970,5467,5272,16639
23,Afghanistan,2021,AFG-21/3481/SA1/EIE/INGO/21374,9/24/2023 10:02:07 AM,Returnees,147,147,259,259,812,140,150,260,270,820
23,Afghanistan,2021,AFG-21/3481/SA1/EIE/NGO/21068,9/23/2023 10:45:48 AM,Host Communities,0,0,1081,1081,2162,0,0,1433,755,2188
23,Afghanistan,2021,AFG-21/3481/SA1/EIE/NGO/21068,9/23/2023 10:45:48 AM,Internally Displaced People,0,0,920,920,1840,0,0,1227,727,1954
23,Afghanistan,2021,AFG-21/3481/SA1/EIE/NGO/21068,9/23/2023 10:45:48 AM,Overall,0,0,2300,2300,4600,0,0,3059,1686,4745
23,Afghanistan,2021,AFG-21/3481/SA1/EIE/NGO/21068,9/23/2023 10:45:48 AM,Returnees,0,0,299,299,598,0,0,399,204,603
23,Afghanistan,2021,AFG-21/3481/SA1/EIE/NGO/21340,9/5/2023 5:09:19 AM,Host Communities,80,52,2050,2050,4232,108,37,3352,3456,6953
23,Afghanistan,2021,AFG-21/3481/SA1/EIE/NGO/21340,9/5/2023 5:09:19 AM,Internally Displaced People,80,52,2050,2050,4232,11,4,705,791,1511
23,Afghanistan,2021,AFG-21/3481/SA1/EIE/NGO/21340,9/5/2023 5:09:19 AM,Overall,160,104,4100,4100,8464,119,41,4057,4247,8464
23,Afghanistan,2021,AFG-21/3481/SA1/ESNFI/INGO/20587,11/9/2022 12:57:51 PM,Host Communities,1482,1420,1667,1606,6175,1660,1794,2222,2106,7782
23,Afghanistan,2021,AFG-21/3481/SA1/ESNFI/INGO/20587,11/9/2022 12:57:51 PM,Other,371,356,417,402,1546,26,29,32,37,124
23,Afghanistan,2021,AFG-21/3481/SA1/ESNFI/INGO/20587,11/9/2022 12:57:51 PM,Overall,1853,1776,2084,2008,7721,1686,1823,2254,2143,7906
23,Afghanistan,2021,AFG-21/3481/SA1/ESNFI/INGO/20589,12/15/2022 11:31:57 AM,Host Communities,1687,1621,794,763,4865,1266,1695,2063,2256,7280
23,Afghanistan,2021,AFG-21/3481/SA1/ESNFI/INGO/20589,12/15/2022 11:31:57 AM,Internally Displaced People,607,583,286,274,1750,89,132,160,174,555
23,Afghanistan,2021,AFG-21/3481/SA1/ESNFI/INGO/20589,12/15/2022 11:31:57 AM,Overall,2294,2204,1080,1037,6615,1355,1827,2223,2430,7835
23,Afghanistan,2021,AFG-21/3481/SA1/ESNFI/INGO/20619,12/3/2022 5:45:44 PM,Host Communities,3192,2704,2128,2128,10152,4157,4044,1432,1528,11161
23,Afghanistan,2021,AFG-21/3481/SA1/ESNFI/INGO/20619,12/3/2022 5:45:44 PM,Other,0,488,0,0,488,0,488,0,0,488
23,Afghanistan,2021,AFG-21/3481/SA1/ESNFI/INGO/20619,12/3/2022 5:45:44 PM,Overall,3192,3192,2128,2128,10640,4157,4532,1432,1528,11649
23,Afghanistan,2021,AFG-21/3481/SA1/ESNFI/INGO/20646,11/9/2022 12:34:51 PM,Host Communities,1376,1296,2608,2856,8136,1336,1594,2383,2487,7800
23,Afghanistan,2021,AFG-21/3481/SA1/ESNFI/INGO/20646,11/9/2022 12:34:51 PM,Internally Displaced People,473,445,897,982,2797,572,682,1020,1065,3339
23,Afghanistan,2021,AFG-21/3481/SA1/ESNFI/INGO/20646,11/9/2022 12:34:51 PM,Other,0,489,0,0,489,0,200,0,0,200
23,Afghanistan,2021,AFG-21/3481/SA1/ESNFI/INGO/20646,11/9/2022 12:34:51 PM,Overall,1849,2230,3505,3838,11422,1908,2476,3403,3552,11339
23,Afghanistan,2021,AFG-21/3481/SA1/ESNFI/INGO/20652,12/3/2022 5:32:13 PM,Host Communities,1355,1355,1795,1795,6300,1091,2078,3129,3695,9993
23,Afghanistan,2021,AFG-21/3481/SA1/ESNFI/INGO/20652,12/3/2022 5:32:13 PM,Internally Displaced People,1084,1084,1436,1436,5040,746,1114,1857,2029,5746
23,Afghanistan,2021,AFG-21/3481/SA1/ESNFI/INGO/20652,12/3/2022 5:32:13 PM,Overall,2710,2710,3590,3590,12600,1908,3314,5195,5922,16339
23,Afghanistan,2021,AFG-21/3481/SA1/ESNFI/INGO/20652,12/3/2022 5:32:13 PM,Returnees,271,271,359,359,1260,71,122,209,198,600
23,Afghanistan,2021,AFG-21/3481/SA1/ESNFI/INGO/20658,12/29/2022 6:46:46 AM,Host Communities,1590,1590,2386,2386,7952,1723,2082,2696,2912,9413
23,Afghanistan,2021,AFG-21/3481/SA1/ESNFI/INGO/20658,12/29/2022 6:46:46 AM,Internally Displaced People,199,199,298,298,994,219,241,316,393,1169
23,Afghanistan,2021,AFG-21/3481/SA1/ESNFI/INGO/20658,12/29/2022 6:46:46 AM,Overall,1988,1988,2982,2982,9940,2135,2564,3336,3674,11709
23,Afghanistan,2021,AFG-21/3481/SA1/ESNFI/INGO/20658,12/29/2022 6:46:46 AM,Returnees,199,199,298,298,994,193,241,324,369,1127
23,Afghanistan,2021,AFG-21/3481/SA1/ESNFI/INGO/20671,10/5/2022 6:54:14 AM,Host Communities,910,910,1669,1567,5056,455,455,835,784,2529
23,Afghanistan,2021,AFG-21/3481/SA1/ESNFI/INGO/20671,10/5/2022 6:54:14 AM,Internally Displaced People,715,715,1311,1233,3974,357,357,655,617,1986
23,Afghanistan,2021,AFG-21/3481/SA1/ESNFI/INGO/20671,10/5/2022 6:54:14 AM,Overall,1625,1625,2980,2800,9030,812,812,1490,1401,4515
23,Afghanistan,2021,AFG-21/3481/SA1/ESNFI/INGO/20753,11/9/2022 1:08:03 PM,Host Communities,3087,2940,735,588,7350,3086,2940,735,589,7350
23,Afghanistan,2021,AFG-21/3481/SA1/ESNFI/INGO/20753,11/9/2022 1:08:03 PM,Internally Displaced People,4263,4060,1015,812,10150,4264,4060,1015,811,10150
23,Afghanistan,2021,AFG-21/3481/SA1/ESNFI/INGO/20753,11/9/2022 1:08:03 PM,Overall,7350,7000,1750,1400,17500,7350,7000,1750,1400,17500
23,Afghanistan,2021,AFG-21/3481/SA1/ESNFI/INGO/21389,2/6/2023 9:38:56 AM,Internally Displaced People,1887,2011,1699,1893,7490,1690,1851,3473,3507,10521
23,Afghanistan,2021,AFG-21/3481/SA1/ESNFI/INGO/21389,2/6/2023 9:38:56 AM,Overall,1887,2011,1699,1893,7490,1690,1851,3473,3507,10521
23,Afghanistan,2021,AFG-21/3481/SA1/ESNFI/INGO/21403,7/7/2023 6:31:31 PM,Host Communities,192,236,348,348,1124,815,943,1771,1882,5411
23,Afghanistan,2021,AFG-21/3481/SA1/ESNFI/INGO/21403,7/7/2023 6:31:31 PM,Internally Displaced People,828,1022,1509,1509,4868,500,544,958,947,2949
23,Afghanistan,2021,AFG-21/3481/SA1/ESNFI/INGO/21403,7/7/2023 6:31:31 PM,Overall,1275,1573,2321,2321,7490,1383,1563,2903,2997,8846
23,Afghanistan,2021,AFG-21/3481/SA1/ESNFI/INGO/21403,7/7/2023 6:31:31 PM,Returnees,255,315,464,464,1498,68,76,174,168,486
23,Afghanistan,2021,AFG-21/3481/SA1/ESNFI/NGO/20635,11/9/2022 12:53:10 PM,Host Communities,1344,2688,1344,1344,6720,1352,2682,1347,1346,6727
23,Afghanistan,2021,AFG-21/3481/SA1/ESNFI/NGO/20635,11/9/2022 12:53:10 PM,Internally Displaced People,252,505,251,252,1260,247,504,253,249,1253
23,Afghanistan,2021,AFG-21/3481/SA1/ESNFI/NGO/20635,11/9/2022 12:53:10 PM,Overall,1680,3361,1679,1680,8400,1685,3351,1689,1675,8400
23,Afghanistan,2021,AFG-21/3481/SA1/ESNFI/NGO/20635,11/9/2022 12:53:10 PM,Returnees,84,168,84,84,420,86,165,89,80,420
23,Afghanistan,2021,AFG-21/3481/SA1/ESNFI/NGO/20641,11/27/2022 7:27:23 AM,Host Communities,280,263,525,681,1749,467,653,929,833,2882
23,Afghanistan,2021,AFG-21/3481/SA1/ESNFI/NGO/20641,11/27/2022 7:27:23 AM,Internally Displaced People,394,420,788,1024,2626,216,256,678,654,1804
23,Afghanistan,2021,AFG-21/3481/SA1/ESNFI/NGO/20641,11/27/2022 7:27:23 AM,Overall,674,683,1313,1705,4375,683,909,1607,1487,4686
23,Afghanistan,2021,AFG-21/3481/SA1/ESNFI/NGO/20656,11/9/2022 12:44:29 PM,Host Communities,660,700,1135,1180,3675,760,895,1612,1556,4823
23,Afghanistan,2021,AFG-21/3481/SA1/ESNFI/NGO/20656,11/9/2022 12:44:29 PM,Internally Displaced People,660,700,1135,1180,3675,686,712,1184,1179,3761
23,Afghanistan,2021,AFG-21/3481/SA1/ESNFI/NGO/20656,11/9/2022 12:44:29 PM,Overall,1320,1400,2270,2360,7350,1446,1607,2796,2735,8584
23,Afghanistan,2021,AFG-21/3481/SA1/ESNFI/NGO/20707,12/16/2022 12:36:22 PM,Host Communities,280,280,420,420,1400,280,280,420,420,1400
23,Afghanistan,2021,AFG-21/3481/SA1/ESNFI/NGO/20707,12/16/2022 12:36:22 PM,Internally Displaced People,844,844,1266,1267,4221,844,844,1266,1267,4221
23,Afghanistan,2021,AFG-21/3481/SA1/ESNFI/NGO/20707,12/16/2022 12:36:22 PM,Other,528,528,792,791,2639,528,528,792,791,2639
23,Afghanistan,2021,AFG-21/3481/SA1/ESNFI/NGO/20707,12/16/2022 12:36:22 PM,Overall,1652,1652,2478,2478,8260,1652,1652,2478,2478,8260
23,Afghanistan,2021,AFG-21/3481/SA1/ESNFI/UN/20672,12/16/2022 9:35:47 AM,Host Communities,1260,1260,1862,1862,6244,2121,2430,4020,4103,12674
23,Afghanistan,2021,AFG-21/3481/SA1/ESNFI/UN/20672,12/16/2022 9:35:47 AM,Internally Displaced People,4691,4690,6100,6100,21581,3510,3012,4707,4435,15664
23,Afghanistan,2021,AFG-21/3481/SA1/ESNFI/UN/20672,12/16/2022 9:35:47 AM,Overall,5951,5950,7962,7962,27825,5631,5442,8727,8538,28338
23,Afghanistan,2021,AFG-21/3481/SA1/FSAC/INGO/20547,12/16/2022 11:10:38 AM,Host Communities,3132,3778,5937,6501,19348,4098,4665,6345,6527,21635
23,Afghanistan,2021,AFG-21/3481/SA1/FSAC/INGO/20547,12/16/2022 11:10:38 AM,Overall,3132,3778,5937,6501,19348,4098,4665,6345,6527,21635
23,Afghanistan,2021,AFG-21/3481/SA1/FSAC/INGO/20618,2/6/2023 10:03:19 AM,Host Communities,6084,7044,8515,8688,30331,8121,8186,9977,9788,36072
23,Afghanistan,2021,AFG-21/3481/SA1/FSAC/INGO/20618,2/6/2023 10:03:19 AM,Overall,6084,7044,8515,8688,30331,8121,8186,9977,9788,36072
23,Afghanistan,2021,AFG-21/3481/SA1/FSAC/INGO/20693,11/10/2022 6:18:35 AM,Host Communities,3207,3982,3667,4054,14910,1601,1688,12259,12393,27941
23,Afghanistan,2021,AFG-21/3481/SA1/FSAC/INGO/20693,11/10/2022 6:18:35 AM,Overall,3207,3982,3667,4054,14910,1601,1688,12259,12393,27941
23,Afghanistan,2021,AFG-21/3481/SA1/FSAC/INGO/20724,12/26/2022 10:51:29 AM,Host Communities,3492,4267,5431,6207,19397,5089,6107,7634,6617,25447
23,Afghanistan,2021,AFG-21/3481/SA1/FSAC/INGO/20724,12/26/2022 10:51:29 AM,Overall,3492,4267,5431,6207,19397,5089,6107,7634,6617,25447
23,Afghanistan,2021,AFG-21/3481/SA1/FSAC/INGO/20760,12/21/2022 4:25:38 AM,Host Communities,6011,5596,4767,4353,20727,2714,4851,6404,6863,20832
23,Afghanistan,2021,AFG-21/3481/SA1/FSAC/INGO/20760,12/21/2022 4:25:38 AM,Overall,6011,5596,4767,4353,20727,2714,4851,6404,6863,20832
23,Afghanistan,2021,AFG-21/3481/SA1/FSAC/INGO/20763,11/10/2022 9:53:26 AM,Host Communities,3746,4166,5922,5689,19523,3746,4166,5922,5689,19523
23,Afghanistan,2021,AFG-21/3481/SA1/FSAC/INGO/20763,11/10/2022 9:53:26 AM,Other,413,396,465,447,1721,413,396,465,447,1721
23,Afghanistan,2021,AFG-21/3481/SA1/FSAC/INGO/20763,11/10/2022 9:53:26 AM,Overall,4159,4562,6387,6136,21244,4159,4562,6387,6136,21244
23,Afghanistan,2021,AFG-21/3481/SA1/FSAC/INGO/20782,11/29/2022 7:48:25 AM,Host Communities,2802,2803,3695,3440,12740,4726,5107,6530,6521,22884
23,Afghanistan,2021,AFG-21/3481/SA1/FSAC/INGO/20782,11/29/2022 7:48:25 AM,Internally Displaced People,863,862,1137,1058,3920,1114,1223,1588,1617,5542
23,Afghanistan,2021,AFG-21/3481/SA1/FSAC/INGO/20782,11/29/2022 7:48:25 AM,Overall,4312,4313,5684,5291,19600,5879,6373,8189,8195,28636
23,Afghanistan,2021,AFG-21/3481/SA1/FSAC/INGO/20782,11/29/2022 7:48:25 AM,Returnees,647,648,852,793,2940,39,43,71,57,210
23,Afghanistan,2021,AFG-21/3481/SA1/FSAC/INGO/20791,12/5/2022 12:54:48 PM,Host Communities,4590,4590,6085,6085,21350,6264,6474,9219,8832,30789
23,Afghanistan,2021,AFG-21/3481/SA1/FSAC/INGO/20791,12/5/2022 12:54:48 PM,Overall,4590,4590,6085,6085,21350,6264,6474,9219,8832,30789
23,Afghanistan,2021,AFG-21/3481/SA1/FSAC/INGO/20801,12/3/2022 5:43:22 PM,Host Communities,5355,5355,3570,3570,17850,8557,9281,2484,2674,22996
23,Afghanistan,2021,AFG-21/3481/SA1/FSAC/INGO/20801,12/3/2022 5:43:22 PM,Overall,5355,5355,3570,3570,17850,8557,9281,2484,2674,22996
23,Afghanistan,2021,AFG-21/3481/SA1/FSAC/INGO/20815,12/5/2022 7:00:56 AM,Host Communities,2962,3332,2838,3209,12341,3059,3523,5451,5375,17408
23,Afghanistan,2021,AFG-21/3481/SA1/FSAC/INGO/20815,12/5/2022 7:00:56 AM,Overall,2962,3332,2838,3209,12341,3059,3523,5451,5375,17408
23,Afghanistan,2021,AFG-21/3481/SA1/FSAC/INGO/20844,12/5/2022 6:42:23 AM,Host Communities,2747,2747,4120,4120,13734,4109,4081,4913,5044,18147
23,Afghanistan,2021,AFG-21/3481/SA1/FSAC/INGO/20844,12/5/2022 6:42:23 AM,Internally Displaced People,305,305,458,458,1526,471,487,588,605,2151
23,Afghanistan,2021,AFG-21/3481/SA1/FSAC/INGO/20844,12/5/2022 6:42:23 AM,Overall,3052,3052,4578,4578,15260,4580,4568,5501,5649,20298
23,Afghanistan,2021,AFG-21/3481/SA1/FSAC/INGO/20886,12/12/2022 6:53:36 AM,Host Communities,3489,2069,6977,4139,16674,3489,2069,6977,4139,16674
23,Afghanistan,2021,AFG-21/3481/SA1/FSAC/INGO/20886,12/12/2022 6:53:36 AM,Internally Displaced People,367,215,735,429,1746,367,215,735,429,1746
23,Afghanistan,2021,AFG-21/3481/SA1/FSAC/INGO/20886,12/12/2022 6:53:36 AM,Overall,3856,2284,7712,4568,18420,3856,2284,7712,4568,18420
23,Afghanistan,2021,AFG-21/3481/SA1/FSAC/INGO/20889,11/27/2022 7:44:36 AM,Host Communities,10731,10220,2400,2199,25550,10731,10220,2400,2199,25550
23,Afghanistan,2021,AFG-21/3481/SA1/FSAC/INGO/20889,11/27/2022 7:44:36 AM,Overall,10731,10220,2400,2199,25550,10731,10220,2400,2199,25550
23,Afghanistan,2021,AFG-21/3481/SA1/FSAC/INGO/20912,7/15/2023 10:58:03 AM,Host Communities,3775,3964,5591,5591,18921,4442,4457,5422,5292,19613
23,Afghanistan,2021,AFG-21/3481/SA1/FSAC/INGO/20912,7/15/2023 10:58:03 AM,Overall,3775,3964,5591,5591,18921,4442,4457,5422,5292,19613
23,Afghanistan,2021,AFG-21/3481/SA1/FSAC/INGO/20990,2/6/2023 12:25:23 PM,Host Communities,3145,3555,5890,5852,18442,3145,3555,5890,5852,18442
23,Afghanistan,2021,AFG-21/3481/SA1/FSAC/INGO/20990,2/6/2023 12:25:23 PM,Overall,3145,3555,5890,5852,18442,3145,3555,5890,5852,18442
23,Afghanistan,2021,AFG-21/3481/SA1/FSAC/INGO/20999,12/16/2022 10:44:28 AM,Host Communities,2857,2857,17143,17143,40000,3586,3528,17148,17136,41398
23,Afghanistan,2021,AFG-21/3481/SA1/FSAC/INGO/20999,12/16/2022 10:44:28 AM,Overall,2857,2857,17143,17143,40000,3586,3528,17148,17136,41398
23,Afghanistan,2021,AFG-21/3481/SA1/FSAC/INGO/21020,12/26/2022 10:56:12 AM,Other,3812,3664,5055,4857,17388,3812,3664,5055,4857,17388
23,Afghanistan,2021,AFG-21/3481/SA1/FSAC/INGO/21020,12/26/2022 10:56:12 AM,Overall,3812,3664,5055,4857,17388,3812,3664,5055,4857,17388
23,Afghanistan,2021,AFG-21/3481/SA1/FSAC/INGO/21397,12/16/2022 12:02:43 PM,Host Communities,2959,3656,5400,5400,17415,3367,4070,7346,7782,22565
23,Afghanistan,2021,AFG-21/3481/SA1/FSAC/INGO/21397,12/16/2022 12:02:43 PM,Internally Displaced People,523,645,953,953,3074,468,608,1037,1200,3313
23,Afghanistan,2021,AFG-21/3481/SA1/FSAC/INGO/21397,12/16/2022 12:02:43 PM,Overall,3482,4301,6353,6353,20489,3835,4678,8383,8982,25878
23,Afghanistan,2021,AFG-21/3481/SA1/FSAC/INGO/21398,12/16/2022 12:43:11 PM,Other,5076,6123,9625,10536,31360,16756,17207,23399,25715,83077
23,Afghanistan,2021,AFG-21/3481/SA1/FSAC/INGO/21398,12/16/2022 12:43:11 PM,Overall,5076,6123,9625,10536,31360,16756,17207,23399,25715,83077
23,Afghanistan,2021,AFG-21/3481/SA1/FSAC/INGO/21400,9/25/2023 4:20:39 AM,Host Communities,5083,5458,4285,4176,19002,4502,5053,6780,6985,23320
23,Afghanistan,2021,AFG-21/3481/SA1/FSAC/INGO/21400,9/25/2023 4:20:39 AM,Internally Displaced People,267,287,225,219,998,41,63,86,106,296
23,Afghanistan,2021,AFG-21/3481/SA1/FSAC/INGO/21400,9/25/2023 4:20:39 AM,Overall,5350,5745,4510,4395,20000,4543,5116,6866,7091,23616
23,Afghanistan,2021,AFG-21/3481/SA1/FSAC/INGO/21418,1/3/2023 1:27:46 PM,Host Communities,2898,4042,6131,5352,18423,2729,4254,8021,8329,23333
23,Afghanistan,2021,AFG-21/3481/SA1/FSAC/INGO/21418,1/3/2023 1:27:46 PM,Overall,2898,4042,6131,5352,18423,2729,4254,8021,8329,23333
23,Afghanistan,2021,AFG-21/3481/SA1/FSAC/NGO/20612,12/20/2022 6:14:57 AM,Host Communities,1358,1358,2037,2037,6790,1528,1528,2292,2291,7639
23,Afghanistan,2021,AFG-21/3481/SA1/FSAC/NGO/20612,12/20/2022 6:14:57 AM,Overall,1358,1358,2037,2037,6790,1528,1528,2292,2291,7639
23,Afghanistan,2021,AFG-21/3481/SA1/FSAC/NGO/20746,2/7/2023 5:04:16 AM,Host Communities,2721,2721,2721,2722,10885,2821,2821,2821,2822,11285
23,Afghanistan,2021,AFG-21/3481/SA1/FSAC/NGO/20746,2/7/2023 5:04:16 AM,Overall,2721,2721,2721,2722,10885,2821,2821,2821,2822,11285
23,Afghanistan,2021,AFG-21/3481/SA1/FSAC/NGO/20748,12/7/2022 6:41:31 AM,Host Communities,3202,3202,3203,3203,12810,3655,3583,3584,3584,14406
23,Afghanistan,2021,AFG-21/3481/SA1/FSAC/NGO/20748,12/7/2022 6:41:31 AM,Overall,3202,3202,3203,3203,12810,3655,3583,3584,3584,14406
23,Afghanistan,2021,AFG-21/3481/SA1/FSAC/NGO/20761,11/27/2022 8:33:24 AM,Host Communities,1287,1483,2472,2654,7896,1287,1483,2472,2654,7896
23,Afghanistan,2021,AFG-21/3481/SA1/FSAC/NGO/20761,11/27/2022 8:33:24 AM,Internally Displaced People,1175,1186,2354,2680,7395,1175,1186,2354,2680,7395
23,Afghanistan,2021,AFG-21/3481/SA1/FSAC/NGO/20761,11/27/2022 8:33:24 AM,Overall,2462,2669,4826,5334,15291,2462,2669,4826,5334,15291
23,Afghanistan,2021,AFG-21/3481/SA1/FSAC/NGO/20810,12/28/2022 8:55:14 AM,Host Communities,1579,2211,1264,1263,6317,1775,2489,1427,1415,7106
23,Afghanistan,2021,AFG-21/3481/SA1/FSAC/NGO/20810,12/28/2022 8:55:14 AM,Internally Displaced People,526,737,422,421,2106,596,822,481,470,2369
23,Afghanistan,2021,AFG-21/3481/SA1/FSAC/NGO/20810,12/28/2022 8:55:14 AM,Overall,2631,3685,2107,2105,10528,2963,4136,2393,2352,11844
23,Afghanistan,2021,AFG-21/3481/SA1/FSAC/NGO/20810,12/28/2022 8:55:14 AM,Returnees,526,737,421,421,2105,592,825,485,467,2369
23,Afghanistan,2021,AFG-21/3481/SA1/FSAC/NGO/20817,11/27/2022 8:46:49 AM,Host Communities,1642,2070,1570,1858,7140,1634,2332,2844,2756,9566
23,Afghanistan,2021,AFG-21/3481/SA1/FSAC/NGO/20817,11/27/2022 8:46:49 AM,Overall,1642,2070,1570,1858,7140,1634,2332,2844,2756,9566
23,Afghanistan,2021,AFG-21/3481/SA1/FSAC/NGO/20855,1/4/2023 3:41:38 PM,Host Communities,2016,2191,5075,5221,14503,3844,4483,7522,8886,24735
23,Afghanistan,2021,AFG-21/3481/SA1/FSAC/NGO/20855,1/4/2023 3:41:38 PM,Overall,2016,2191,5075,5221,14503,3844,4483,7522,8886,24735
23,Afghanistan,2021,AFG-21/3481/SA1/FSAC/NGO/20963,12/7/2022 6:36:35 AM,Host Communities,1659,1816,2211,2211,7897,1866,2043,2487,2487,8883
23,Afghanistan,2021,AFG-21/3481/SA1/FSAC/NGO/20963,12/7/2022 6:36:35 AM,Overall,1659,1816,2211,2211,7897,1866,2043,2487,2487,8883
23,Afghanistan,2021,AFG-21/3481/SA1/FSAC/NGO/20967,7/7/2023 6:58:32 PM,Host Communities,2262,2488,2611,2912,10273,1922,2594,4993,5193,14702
23,Afghanistan,2021,AFG-21/3481/SA1/FSAC/NGO/20967,7/7/2023 6:58:32 PM,Internally Displaced People,610,783,681,811,2885,90,102,212,220,624
23,Afghanistan,2021,AFG-21/3481/SA1/FSAC/NGO/20967,7/7/2023 6:58:32 PM,Overall,2872,3271,3292,3723,13158,2012,2696,5205,5413,15326
23,Afghanistan,2021,AFG-21/3481/SA1/FSAC/NGO/21159,12/3/2022 5:54:54 PM,Host Communities,4200,4200,6300,6300,21000,4200,4200,6300,6300,21000
23,Afghanistan,2021,AFG-21/3481/SA1/FSAC/NGO/21159,12/3/2022 5:54:54 PM,Overall,4200,4200,6300,6300,21000,4200,4200,6300,6300,21000
23,Afghanistan,2021,AFG-21/3481/SA1/FSAC/NGO/21219,1/3/2023 6:48:39 AM,Host Communities,3232,3912,4593,5273,17010,3232,3912,4593,5273,17010
23,Afghanistan,2021,AFG-21/3481/SA1/FSAC/NGO/21219,1/3/2023 6:48:39 AM,Overall,3232,3912,4593,5273,17010,3232,3912,4593,5273,17010
23,Afghanistan,2021,AFG-21/3481/SA1/FSAC/NGO/21229,12/28/2022 10:58:54 AM,Host Communities,1760,1760,2314,2174,8008,2000,2150,2800,3500,10450
23,Afghanistan,2021,AFG-21/3481/SA1/FSAC/NGO/21229,12/28/2022 10:58:54 AM,Overall,1760,1760,2314,2174,8008,2000,2150,2800,3500,10450
23,Afghanistan,2021,AFG-21/3481/SA1/FSAC/NGO/21387,12/28/2022 5:19:43 AM,Host Communities,2818,2817,3430,3185,12250,1499,2693,3496,4341,12029
23,Afghanistan,2021,AFG-21/3481/SA1/FSAC/NGO/21387,12/28/2022 5:19:43 AM,Overall,2818,2817,3430,3185,12250,1499,2693,3496,4341,12029
23,Afghanistan,2021,AFG-21/3481/SA1/FSAC/NGO/21399,12/28/2022 7:36:48 AM,Host Communities,2407,3026,2718,3049,11200,5708,5803,2417,2237,16165
23,Afghanistan,2021,AFG-21/3481/SA1/FSAC/NGO/21399,12/28/2022 7:36:48 AM,Overall,2407,3026,2718,3049,11200,5708,5803,2417,2237,16165
23,Afghanistan,2021,AFG-21/3481/SA1/FSAC/NGO/21404,2/6/2023 12:33:13 PM,Host Communities,1890,1890,2835,2835,9450,1907,1875,2842,2826,9450
23,Afghanistan,2021,AFG-21/3481/SA1/FSAC/NGO/21404,2/6/2023 12:33:13 PM,Overall,1890,1890,2835,2835,9450,1907,1875,2842,2826,9450
23,Afghanistan,2021,AFG-21/3481/SA1/FSAC/NGO/21408,12/16/2022 10:22:51 AM,Host Communities,2503,2903,2202,2602,10210,3041,3211,3198,4084,13534
23,Afghanistan,2021,AFG-21/3481/SA1/FSAC/NGO/21408,12/16/2022 10:22:51 AM,Overall,2503,2903,2202,2602,10210,3041,3211,3198,4084,13534
23,Afghanistan,2021,AFG-21/3481/SA1/FSAC/NGO/21574,12/19/2022 7:11:56 AM,Host Communities,3055,2085,2753,2085,9978,3055,2085,2753,2085,9978
23,Afghanistan,2021,AFG-21/3481/SA1/FSAC/NGO/21574,12/19/2022 7:11:56 AM,Overall,3055,2085,2753,2085,9978,3055,2085,2753,2085,9978
23,Afghanistan,2021,AFG-21/3481/SA1/FSAC/NGO/21580,2/7/2023 12:13:53 PM,Host Communities,2923,2923,2922,2922,11690,3810,3814,3811,3817,15252
23,Afghanistan,2021,AFG-21/3481/SA1/FSAC/NGO/21580,2/7/2023 12:13:53 PM,Overall,2923,2923,2922,2922,11690,3810,3814,3811,3817,15252
23,Afghanistan,2021,AFG-21/3481/SA1/FSAC/UN/20790,9/23/2023 10:38:07 AM,Host Communities,71941,73505,87580,79760,312786,71921,73485,87557,79739,312702
23,Afghanistan,2021,AFG-21/3481/SA1/FSAC/UN/20790,9/23/2023 10:38:07 AM,Overall,71941,73505,87580,79760,312786,71921,73485,87557,79739,312702
23,Afghanistan,2021,AFG-21/3481/SA1/H/INGO/20670,6/27/2023 12:03:47 PM,Host Communities,17480,19320,26680,28520,92000,18540,16061,24069,22780,81450
23,Afghanistan,2021,AFG-21/3481/SA1/H/INGO/20670,6/27/2023 12:03:47 PM,Internally Displaced People,1672,1848,2552,2728,8800,1120,1335,1771,1699,5925
23,Afghanistan,2021,AFG-21/3481/SA1/H/INGO/20670,6/27/2023 12:03:47 PM,Overall,19152,21168,29232,31248,100800,19660,17396,25840,24479,87375
23,Afghanistan,2021,AFG-21/3481/SA1/H/INGO/20703,1/2/2023 10:45:01 AM,Host Communities,16828,24837,4202,6214,52081,11917,40644,5943,5773,64277
23,Afghanistan,2021,AFG-21/3481/SA1/H/INGO/20703,1/2/2023 10:45:01 AM,Overall,16828,24837,4202,6214,52081,11917,40644,5943,5773,64277
23,Afghanistan,2021,AFG-21/3481/SA1/H/INGO/21384,1/1/2023 10:39:03 AM,Other,5760,1152,3456,1152,11520,10112,3822,7043,2670,23647
23,Afghanistan,2021,AFG-21/3481/SA1/H/INGO/21384,1/1/2023 10:39:03 AM,Overall,5760,1152,3456,1152,11520,10112,3822,7043,2670,23647
23,Afghanistan,2021,AFG-21/3481/SA1/H/NGO/20654,12/16/2022 10:04:16 AM,Host Communities,10766,2458,6776,1970,21970,11326,9553,5140,3041,29060
23,Afghanistan,2021,AFG-21/3481/SA1/H/NGO/20654,12/16/2022 10:04:16 AM,Other,50,50,0,0,100,65,50,0,0,115
23,Afghanistan,2021,AFG-21/3481/SA1/H/NGO/20654,12/16/2022 10:04:16 AM,Overall,10816,2508,6776,1970,22070,11391,9603,5140,3041,29175
23,Afghanistan,2021,AFG-21/3481/SA1/H/NGO/20676,12/8/2022 7:06:38 AM,Host Communities,108835,80402,31573,24245,245055,70349,129508,63887,67013,330757
23,Afghanistan,2021,AFG-21/3481/SA1/H/NGO/20676,12/8/2022 7:06:38 AM,Other,173,167,0,0,340,168,165,0,0,333
23,Afghanistan,2021,AFG-21/3481/SA1/H/NGO/20676,12/8/2022 7:06:38 AM,Overall,109008,80569,31573,24245,245395,70517,129673,63887,67013,331090
23,Afghanistan,2021,AFG-21/3481/SA1/H/NGO/20896,11/13/2022 11:10:20 AM,Host Communities,5671,11189,4967,5887,27714,6418,19509,7251,6395,39573
23,Afghanistan,2021,AFG-21/3481/SA1/H/NGO/20896,11/13/2022 11:10:20 AM,Internally Displaced People,1386,2469,1832,1730,7417,220,275,137,141,773
23,Afghanistan,2021,AFG-21/3481/SA1/H/NGO/20896,11/13/2022 11:10:20 AM,Overall,7057,13658,6799,7617,35131,6638,19784,7388,6536,40346
23,Afghanistan,2021,AFG-21/3481/SA1/H/NGO/21039,1/2/2023 10:52:53 AM,Host Communities,20061,20879,9013,9381,59334,20412,32080,14708,14685,81885
23,Afghanistan,2021,AFG-21/3481/SA1/H/NGO/21039,1/2/2023 10:52:53 AM,Internally Displaced People,6913,7195,3106,3233,20447,5388,12513,5172,5307,28380
23,Afghanistan,2021,AFG-21/3481/SA1/H/NGO/21039,1/2/2023 10:52:53 AM,Other,51,39,0,0,90,51,39,0,0,90
23,Afghanistan,2021,AFG-21/3481/SA1/H/NGO/21039,1/2/2023 10:52:53 AM,Overall,27025,28113,12119,12614,79871,25851,44632,19880,19992,110355
23,Afghanistan,2021,AFG-21/3481/SA1/H/NGO/21041,12/5/2022 7:10:16 AM,Host Communities,18291,15895,6749,6285,47220,83368,102722,31953,32752,250795
23,Afghanistan,2021,AFG-21/3481/SA1/H/NGO/21041,12/5/2022 7:10:16 AM,Overall,18291,15895,6749,6285,47220,83368,102722,31953,32752,250795
23,Afghanistan,2021,AFG-21/3481/SA1/H/NGO/21380,12/16/2022 12:24:11 PM,Host Communities,17492,12521,4065,3629,37707,37881,35833,4345,5065,83124
23,Afghanistan,2021,AFG-21/3481/SA1/H/NGO/21380,12/16/2022 12:24:11 PM,Overall,17492,12521,4065,3629,37707,37881,35833,4345,5065,83124
23,Afghanistan,2021,AFG-21/3481/SA1/H/UN/21386,2/6/2023 12:18:34 PM,Host Communities,116600,112030,83930,80640,393200,207232,187069,89953,89010,573264
23,Afghanistan,2021,AFG-21/3481/SA1/H/UN/21386,2/6/2023 12:18:34 PM,Internally Displaced People,11660,11200,8300,8060,39220,0,0,0,0,0
23,Afghanistan,2021,AFG-21/3481/SA1/H/UN/21386,2/6/2023 12:18:34 PM,Overall,134660,129951,96830,93130,454571,207232,187069,89953,89010,573264
23,Afghanistan,2021,AFG-21/3481/SA1/H/UN/21386,2/6/2023 12:18:34 PM,Returnees,6400,6721,4600,4430,22151,0,0,0,0,0
23,Afghanistan,2021,AFG-21/3481/SA1/H-N/INGO/20653,12/10/2022 4:01:34 PM,Other,10639,10032,21390,20552,62613,13020,28703,21717,22383,85823
23,Afghanistan,2021,AFG-21/3481/SA1/H-N/INGO/20653,12/10/2022 4:01:34 PM,Overall,10639,10032,21390,20552,62613,13020,28703,21717,22383,85823
23,Afghanistan,2021,AFG-21/3481/SA1/H-N/UN/20853,12/5/2022 7:31:02 AM,Host Communities,5036093,6714791,2518099,2518097,16787080,5036093,6714791,2518099,2518097,16787080
23,Afghanistan,2021,AFG-21/3481/SA1/H-N/UN/20853,12/5/2022 7:31:02 AM,Internally Displaced People,102778,137037,51392,51392,342599,102778,137037,51392,51392,342599
23,Afghanistan,2021,AFG-21/3481/SA1/H-N/UN/20853,12/5/2022 7:31:02 AM,Overall,5138871,6851828,2569491,2569489,17129679,5138871,6851828,2569491,2569489,17129679
23,Afghanistan,2021,AFG-21/3481/SA1/H-N-APC/INGO/20851,7/19/2023 2:05:15 PM,Host Communities,9364,28094,4682,4682,46822,5669,17053,10982,13989,47693
23,Afghanistan,2021,AFG-21/3481/SA1/H-N-APC/INGO/20851,7/19/2023 2:05:15 PM,Internally Displaced People,1041,3122,520,520,5203,1315,1233,2161,2488,7197
23,Afghanistan,2021,AFG-21/3481/SA1/H-N-APC/INGO/20851,7/19/2023 2:05:15 PM,Overall,10405,31216,5202,5202,52025,6984,18286,13143,16477,54890
23,Afghanistan,2021,AFG-21/3481/SA1/H-WASH/NGO/20651,11/10/2022 7:22:24 AM,Host Communities,6486,6192,8550,8256,29484,10740,13822,7460,7547,39569
23,Afghanistan,2021,AFG-21/3481/SA1/H-WASH/NGO/20651,11/10/2022 7:22:24 AM,Internally Displaced People,1236,1179,1629,1572,5616,1240,1429,771,827,4267
23,Afghanistan,2021,AFG-21/3481/SA1/H-WASH/NGO/20651,11/10/2022 7:22:24 AM,Other,63,20,0,0,83,63,20,0,0,83
23,Afghanistan,2021,AFG-21/3481/SA1/H-WASH/NGO/20651,11/10/2022 7:22:24 AM,Overall,7785,7391,10179,9828,35183,12043,15271,8231,8374,43919
23,Afghanistan,2021,AFG-21/3481/SA1/N/INGO/20673,12/26/2022 11:32:41 AM,Host Communities,11400,12600,17400,18600,60000,10532,24634,7746,7226,50138
23,Afghanistan,2021,AFG-21/3481/SA1/N/INGO/20673,12/26/2022 11:32:41 AM,Internally Displaced People,703,777,1073,1147,3700,552,1296,408,532,2788
23,Afghanistan,2021,AFG-21/3481/SA1/N/INGO/20673,12/26/2022 11:32:41 AM,Overall,12103,13377,18473,19747,63700,11084,25930,8154,7758,52926
23,Afghanistan,2021,AFG-21/3481/SA1/N/INGO/21021,1/4/2023 3:44:37 PM,Host Communities,242,48,0,0,290,326,62,0,0,388
23,Afghanistan,2021,AFG-21/3481/SA1/N/INGO/21021,1/4/2023 3:44:37 PM,Overall,242,48,0,0,290,326,62,0,0,388
23,Afghanistan,2021,AFG-21/3481/SA1/N/INGO/21377,9/22/2023 11:59:25 AM,Host Communities,367,7450,6576,7062,21455,0,0,0,0,0
23,Afghanistan,2021,AFG-21/3481/SA1/N/INGO/21377,9/22/2023 11:59:25 AM,Overall,367,7450,6576,7062,21455,0,0,0,0,0
23,Afghanistan,2021,AFG-21/3481/SA1/N/NGO/20991,7/9/2023 9:05:58 PM,Host Communities,12584,13098,5654,5885,37221,18082,31064,14483,18481,82110
23,Afghanistan,2021,AFG-21/3481/SA1/N/NGO/20991,7/9/2023 9:05:58 PM,Internally Displaced People,2224,2315,999,1040,6578,1398,3738,1213,1302,7651
23,Afghanistan,2021,AFG-21/3481/SA1/N/NGO/20991,7/9/2023 9:05:58 PM,Other,38,40,0,0,78,40,24,0,0,64
23,Afghanistan,2021,AFG-21/3481/SA1/N/NGO/20991,7/9/2023 9:05:58 PM,Overall,14846,15453,6653,6925,43877,19520,34826,15696,19783,89825
23,Afghanistan,2021,AFG-21/3481/SA1/N/NGO/21010,12/26/2022 10:59:11 AM,Host Communities,830,7910,738,802,10280,882,5851,3695,3540,13968
23,Afghanistan,2021,AFG-21/3481/SA1/N/NGO/21010,12/26/2022 10:59:11 AM,Overall,830,7910,738,802,10280,882,5851,3695,3540,13968
23,Afghanistan,2021,AFG-21/3481/SA1/N/NGO/21019,2/8/2023 9:58:38 AM,Host Communities,53129,53759,11586,11245,129719,23358,50347,10196,9789,93690
23,Afghanistan,2021,AFG-21/3481/SA1/N/NGO/21019,2/8/2023 9:58:38 AM,Overall,53129,53759,11586,11245,129719,23358,50347,10196,9789,93690
23,Afghanistan,2021,AFG-21/3481/SA1/N/NGO/21109,12/6/2022 8:05:10 AM,Host Communities,0,5763,2247,2535,10545,5842,11571,3194,3188,23795
23,Afghanistan,2021,AFG-21/3481/SA1/N/NGO/21109,12/6/2022 8:05:10 AM,Internally Displaced People,0,2376,841,875,4092,24,42,45,31,142
23,Afghanistan,2021,AFG-21/3481/SA1/N/NGO/21109,12/6/2022 8:05:10 AM,Overall,0,8139,3088,3410,14637,5866,11613,3239,3219,23937
23,Afghanistan,2021,AFG-21/3481/SA1/N/UN/21042,12/5/2022 7:01:58 AM,Host Communities,0,0,12634,15442,28076,0,0,13504,16506,30010
23,Afghanistan,2021,AFG-21/3481/SA1/N/UN/21042,12/5/2022 7:01:58 AM,Overall,0,0,12634,15442,28076,0,0,13504,16506,30010
23,Afghanistan,2021,AFG-21/3481/SA1/N-H/INGO/20965,12/7/2022 6:29:20 AM,Other,7894,31330,31874,30678,101776,20079,52766,35909,35854,144608
23,Afghanistan,2021,AFG-21/3481/SA1/N-H/INGO/20965,12/7/2022 6:29:20 AM,Overall,7894,31330,31874,30678,101776,20079,52766,35909,35854,144608
23,Afghanistan,2021,AFG-21/3481/SA1/N-H/NGO/20935,12/16/2022 12:08:56 PM,Host Communities,14689,42118,18335,17786,92928,17027,99228,25829,25999,168083
23,Afghanistan,2021,AFG-21/3481/SA1/N-H/NGO/20935,12/16/2022 12:08:56 PM,Other,40,50,0,0,90,40,50,0,0,90
23,Afghanistan,2021,AFG-21/3481/SA1/N-H/NGO/20935,12/16/2022 12:08:56 PM,Overall,14729,42168,18335,17786,93018,17067,99278,25829,25999,168173
23,Afghanistan,2021,AFG-21/3481/SA1/WASH/INGO/20701,7/9/2023 9:26:39 PM,Host Communities,3526,3670,3628,3666,14490,4040,3852,4528,4643,17063
23,Afghanistan,2021,AFG-21/3481/SA1/WASH/INGO/20701,7/9/2023 9:26:39 PM,Overall,3526,3670,3628,3666,14490,4040,3852,4528,4643,17063
23,Afghanistan,2021,AFG-21/3481/SA1/WASH/INGO/20876,1/2/2023 10:16:03 AM,Host Communities,12905,13351,17446,17084,60786,11817,13021,23064,23646,71548
23,Afghanistan,2021,AFG-21/3481/SA1/WASH/INGO/20876,1/2/2023 10:16:03 AM,Internally Displaced People,3650,3691,4821,4630,16792,1451,1573,2187,2435,7646
23,Afghanistan,2021,AFG-21/3481/SA1/WASH/INGO/20876,1/2/2023 10:16:03 AM,Overall,17536,18095,23636,23150,82417,13852,15335,26047,27099,82333
23,Afghanistan,2021,AFG-21/3481/SA1/WASH/INGO/20876,1/2/2023 10:16:03 AM,Returnees,981,1053,1369,1436,4839,584,741,796,1018,3139
23,Afghanistan,2021,AFG-21/3481/SA1/WASH/INGO/20883,11/30/2022 8:39:44 AM,Host Communities,10842,10842,14292,13306,49282,8573,9944,12204,12897,43618
23,Afghanistan,2021,AFG-21/3481/SA1/WASH/INGO/20883,11/30/2022 8:39:44 AM,Internally Displaced People,8131,8131,10718,9979,36959,4098,4484,4987,5253,18822
23,Afghanistan,2021,AFG-21/3481/SA1/WASH/INGO/20883,11/30/2022 8:39:44 AM,Overall,27104,27104,35728,33264,123200,13491,15375,17876,18884,65626
23,Afghanistan,2021,AFG-21/3481/SA1/WASH/INGO/20883,11/30/2022 8:39:44 AM,Returnees,8131,8131,10718,9979,36959,820,947,685,734,3186
23,Afghanistan,2021,AFG-21/3481/SA1/WASH/INGO/20894,7/6/2023 8:03:59 AM,Host Communities,2625,2657,4124,4077,13483,2627,2658,4124,4077,13486
23,Afghanistan,2021,AFG-21/3481/SA1/WASH/INGO/20894,7/6/2023 8:03:59 AM,Internally Displaced People,1024,1169,1813,1708,5714,1022,1168,1813,1708,5711
23,Afghanistan,2021,AFG-21/3481/SA1/WASH/INGO/20894,7/6/2023 8:03:59 AM,Overall,3649,3826,5937,5785,19197,3649,3826,5937,5785,19197
23,Afghanistan,2021,AFG-21/3481/SA1/WASH/INGO/20901,2/6/2023 10:28:52 AM,Host Communities,2570,2570,4712,4428,14280,3145,3267,6067,6825,19304
23,Afghanistan,2021,AFG-21/3481/SA1/WASH/INGO/20901,2/6/2023 10:28:52 AM,Internally Displaced People,1714,1714,3142,2950,9520,869,891,1600,1732,5092
23,Afghanistan,2021,AFG-21/3481/SA1/WASH/INGO/20901,2/6/2023 10:28:52 AM,Overall,4284,4284,7854,7378,23800,4014,4158,7667,8557,24396
23,Afghanistan,2021,AFG-21/3481/SA1/WASH/INGO/21000,7/18/2023 8:14:13 AM,Host Communities,10143,10143,12348,11466,44100,15164,16119,28704,30033,90020
23,Afghanistan,2021,AFG-21/3481/SA1/WASH/INGO/21000,7/18/2023 8:14:13 AM,Internally Displaced People,4347,4347,5292,4914,18900,5425,5096,10034,9904,30459
23,Afghanistan,2021,AFG-21/3481/SA1/WASH/INGO/21000,7/18/2023 8:14:13 AM,Overall,14490,14490,17640,16380,63000,20589,21215,38738,39937,120479
23,Afghanistan,2021,AFG-21/3481/SA1/WASH/INGO/21358,12/10/2022 5:51:53 PM,Host Communities,7923,7923,10444,9724,36014,7457,8058,15820,15085,46420
23,Afghanistan,2021,AFG-21/3481/SA1/WASH/INGO/21358,12/10/2022 5:51:53 PM,Internally Displaced People,2830,2830,3730,3473,12863,1074,1164,2484,2272,6994
23,Afghanistan,2021,AFG-21/3481/SA1/WASH/INGO/21358,12/10/2022 5:51:53 PM,Overall,11319,11319,14920,13892,51450,8706,9418,18620,17672,54416
23,Afghanistan,2021,AFG-21/3481/SA1/WASH/INGO/21358,12/10/2022 5:51:53 PM,Returnees,566,566,746,695,2573,175,196,316,315,1002
23,Afghanistan,2021,AFG-21/3481/SA1/WASH/INGO/21385,5/16/2023 1:10:40 PM,Host Communities,4220,4344,1448,1808,11820,6243,6426,2142,2676,17487
23,Afghanistan,2021,AFG-21/3481/SA1/WASH/INGO/21385,5/16/2023 1:10:40 PM,Internally Displaced People,2389,2557,4428,4626,14000,4998,5145,1716,2141,14000
23,Afghanistan,2021,AFG-21/3481/SA1/WASH/INGO/21385,5/16/2023 1:10:40 PM,Overall,6609,6901,5876,6434,25820,11241,11571,3858,4817,31487
23,Afghanistan,2021,AFG-21/3481/SA1/WASH/NGO/20681,12/7/2022 6:45:49 AM,Host Communities,9900,9900,6600,6600,33000,9904,9906,6647,6604,33061
23,Afghanistan,2021,AFG-21/3481/SA1/WASH/NGO/20681,12/7/2022 6:45:49 AM,Overall,9900,9900,6600,6600,33000,9904,9906,6647,6604,33061
23,Afghanistan,2021,AFG-21/3481/SA1/WASH/NGO/20683,11/29/2022 7:09:59 AM,Host Communities,1050,1100,2050,2100,6300,1480,1725,2702,2980,8887
23,Afghanistan,2021,AFG-21/3481/SA1/WASH/NGO/20683,11/29/2022 7:09:59 AM,Internally Displaced People,1050,1100,2050,2100,6300,759,871,1530,1686,4846
23,Afghanistan,2021,AFG-21/3481/SA1/WASH/NGO/20683,11/29/2022 7:09:59 AM,Overall,2100,2200,4100,4200,12600,2239,2596,4232,4666,13733
23,Afghanistan,2021,AFG-21/3481/SA1/WASH/NGO/20723,1/4/2023 12:07:39 PM,Host Communities,8000,5875,9368,11268,34511,8053,5954,9473,11399,34879
23,Afghanistan,2021,AFG-21/3481/SA1/WASH/NGO/20723,1/4/2023 12:07:39 PM,Internally Displaced People,3337,18000,18000,17000,56337,3423,18129,18172,17214,56938
23,Afghanistan,2021,AFG-21/3481/SA1/WASH/NGO/20723,1/4/2023 12:07:39 PM,Overall,11357,23927,27398,28308,90990,11499,24140,27684,28666,91989
23,Afghanistan,2021,AFG-21/3481/SA1/WASH/NGO/20723,1/4/2023 12:07:39 PM,Returnees,20,52,30,40,142,23,57,39,53,172
23,Afghanistan,2021,AFG-21/3481/SA1/WASH/NGO/20973,2/7/2023 10:22:34 AM,Host Communities,15036,15036,10024,10024,50120,14740,14625,10460,10315,50140
23,Afghanistan,2021,AFG-21/3481/SA1/WASH/NGO/20973,2/7/2023 10:22:34 AM,Internally Displaced People,2819,2819,1880,1880,9398,2750,2775,2025,2030,9580
23,Afghanistan,2021,AFG-21/3481/SA1/WASH/NGO/20973,2/7/2023 10:22:34 AM,Overall,18795,18795,12529,12531,62650,18360,18295,13080,12915,62650
23,Afghanistan,2021,AFG-21/3481/SA1/WASH/NGO/20973,2/7/2023 10:22:34 AM,Returnees,940,940,625,627,3132,870,895,595,570,2930
23,Afghanistan,2021,AFG-21/3481/SA1/WASH/NGO/21008,2/7/2023 10:28:46 AM,Host Communities,2422,2422,3633,3633,12110,2422,2422,3633,3633,12110
23,Afghanistan,2021,AFG-21/3481/SA1/WASH/NGO/21008,2/7/2023 10:28:46 AM,Internally Displaced People,1428,1428,2142,2142,7140,1428,1428,2142,2142,7140
23,Afghanistan,2021,AFG-21/3481/SA1/WASH/NGO/21008,2/7/2023 10:28:46 AM,Other,2128,2128,3192,3192,10640,2128,2128,3192,3192,10640
23,Afghanistan,2021,AFG-21/3481/SA1/WASH/NGO/21008,2/7/2023 10:28:46 AM,Overall,6650,6650,9975,9975,33250,6650,6650,9975,9975,33250
23,Afghanistan,2021,AFG-21/3481/SA1/WASH/NGO/21008,2/7/2023 10:28:46 AM,Returnees,672,672,1008,1008,3360,672,672,1008,1008,3360
23,Afghanistan,2021,AFG-21/3481/SA1/WASH/NGO/21049,12/26/2022 11:15:42 AM,Host Communities,3000,2400,1800,1800,9000,3003,2403,1845,1803,9054
23,Afghanistan,2021,AFG-21/3481/SA1/WASH/NGO/21049,12/26/2022 11:15:42 AM,Internally Displaced People,2000,1600,1200,1200,6000,2004,1602,1230,1215,6051
23,Afghanistan,2021,AFG-21/3481/SA1/WASH/NGO/21049,12/26/2022 11:15:42 AM,Overall,5000,4000,3000,3000,15000,5007,4005,3075,3018,15105
23,Afghanistan,2021,AFG-21/3481/SA1/WASH/NGO/21156,9/23/2023 7:47:26 AM,Host Communities,6502,8807,2936,2728,20973,5434,7359,2452,2280,17525
23,Afghanistan,2021,AFG-21/3481/SA1/WASH/NGO/21156,9/23/2023 7:47:26 AM,Overall,6502,8807,2936,2728,20973,5434,7359,2452,2280,17525
23,Afghanistan,2021,AFG-21/3481/SA1/WASH/NGO/21337,12/5/2022 7:21:12 AM,Host Communities,8475,8475,5650,5650,28250,8662,8661,5770,5782,28875
23,Afghanistan,2021,AFG-21/3481/SA1/WASH/NGO/21337,12/5/2022 7:21:12 AM,Overall,8475,8475,5650,5650,28250,8662,8661,5770,5782,28875
23,Afghanistan,2021,AFG-21/3481/SA1/WASH/NGO/21349,12/28/2022 5:12:20 AM,Host Communities,7613,7612,5075,5074,25374,3695,3903,9733,9213,26544
23,Afghanistan,2021,AFG-21/3481/SA1/WASH/NGO/21349,12/28/2022 5:12:20 AM,Overall,7613,7612,5075,5074,25374,3695,3903,9733,9213,26544
23,Afghanistan,2021,AFG-21/3481/SA1/WASH/UN/20625,9/23/2023 9:44:10 AM,Host Communities,462191,462191,609252,567234,2100868,450676,450696,595149,554079,2050600
23,Afghanistan,2021,AFG-21/3481/SA1/WASH/UN/20625,9/23/2023 9:44:10 AM,Internally Displaced People,85800,85800,113100,105300,390000,11544,11524,14141,13191,50400
23,Afghanistan,2021,AFG-21/3481/SA1/WASH/UN/20625,9/23/2023 9:44:10 AM,Overall,611791,611791,806452,750834,2780868,462220,462220,609290,567270,2101000
23,Afghanistan,2021,AFG-21/3481/SA1/WASH/UN/20625,9/23/2023 9:44:10 AM,Returnees,63800,63800,84100,78300,290000,0,0,0,0,0
23,Afghanistan,2021,AFG-21/3481/SA1/WASH/UN/20695,7/16/2023 9:04:59 AM,Internally Displaced People,10350,10350,15525,15525,51750,17885,21614,15057,17233,71789
23,Afghanistan,2021,AFG-21/3481/SA1/WASH/UN/20695,7/16/2023 9:04:59 AM,Overall,10350,10350,15525,15525,51750,17885,21614,15057,17233,71789
23,Afghanistan,2021,AFG-21/3481/SA1/WASH/UN/20918,12/5/2022 6:53:18 AM,Other,17102,16996,25461,25461,85020,17102,16996,25461,25461,85020
23,Afghanistan,2021,AFG-21/3481/SA1/WASH/UN/20918,12/5/2022 6:53:18 AM,Overall,17102,16996,25461,25461,85020,17102,16996,25461,25461,85020
23,Afghanistan,2022,AFG-22/3481/RA1/APC/INGO/21623,2/6/2023 1:04:02 PM,Host Communities,2918,2840,7723,6538,20019,3179,2474,8380,5360,19393
23,Afghanistan,2022,AFG-22/3481/RA1/APC/INGO/21623,2/6/2023 1:04:02 PM,Overall,2918,2840,7723,6538,20019,3179,2474,8380,5360,19393
23,Afghanistan,2022,AFG-22/3481/RA1/APC/INGO/21689,7/20/2023 8:12:29 AM,Host Communities,0,986,0,658,1644,0,2516,0,629,3145
23,Afghanistan,2022,AFG-22/3481/RA1/APC/INGO/21689,7/20/2023 8:12:29 AM,Internally Displaced People,0,1480,0,986,2466,0,773,0,193,966
23,Afghanistan,2022,AFG-22/3481/RA1/APC/INGO/21689,7/20/2023 8:12:29 AM,Overall,0,2466,0,1644,4110,0,3289,0,822,4111
23,Afghanistan,2022,AFG-22/3481/RA1/APC/INGO/21705,7/18/2023 1:30:03 PM,Host Communities,0,547,0,364,911,0,0,0,0,0
23,Afghanistan,2022,AFG-22/3481/RA1/APC/INGO/21705,7/18/2023 1:30:03 PM,Internally Displaced People,0,820,0,547,1367,0,0,0,0,0
23,Afghanistan,2022,AFG-22/3481/RA1/APC/INGO/21705,7/18/2023 1:30:03 PM,Overall,0,1367,0,911,2278,0,0,0,0,0
23,Afghanistan,2022,AFG-22/3481/RA1/APC/INGO/21710,2/6/2023 10:37:58 AM,Host Communities,1717,1338,6971,6229,16255,4059,5986,7641,7349,25035
23,Afghanistan,2022,AFG-22/3481/RA1/APC/INGO/21710,2/6/2023 10:37:58 AM,Overall,1717,1338,6971,6229,16255,4059,5986,7641,7349,25035
23,Afghanistan,2022,AFG-22/3481/RA1/APC/NGO/21646,10/11/2023 5:51:09 AM,Host Communities,56959,60310,107217,110567,335053,68127,72135,128240,132247,400749
23,Afghanistan,2022,AFG-22/3481/RA1/APC/NGO/21646,10/11/2023 5:51:09 AM,Internally Displaced People,1700,1800,3200,3300,10000,1906,2018,3587,3700,11211
23,Afghanistan,2022,AFG-22/3481/RA1/APC/NGO/21646,10/11/2023 5:51:09 AM,Other,4500,750,5250,4500,15000,3522,1418,8840,6394,20174
23,Afghanistan,2022,AFG-22/3481/RA1/APC/NGO/21646,10/11/2023 5:51:09 AM,Overall,66559,66460,122067,124967,380053,77194,79424,147516,149405,453539
23,Afghanistan,2022,AFG-22/3481/RA1/APC/NGO/21646,10/11/2023 5:51:09 AM,Returnees,3400,3600,6400,6600,20000,3639,3853,6849,7064,21405
23,Afghanistan,2022,AFG-22/3481/RA1/APC/NGO/21665,7/10/2023 6:40:02 PM,Host Communities,4990,4727,8404,8142,26263,5411,4875,8276,7731,26293
23,Afghanistan,2022,AFG-22/3481/RA1/APC/NGO/21665,7/10/2023 6:40:02 PM,Overall,4990,4727,8404,8142,26263,5411,4875,8276,7731,26293
23,Afghanistan,2022,AFG-22/3481/RA1/APC/NGO/21686,9/24/2023 5:20:32 AM,Host Communities,5250,5250,11750,11750,34000,4800,5189,20808,19650,50447
23,Afghanistan,2022,AFG-22/3481/RA1/APC/NGO/21686,9/24/2023 5:20:32 AM,Internally Displaced People,1750,1750,7900,7900,19300,1884,2087,5173,5358,14502
23,Afghanistan,2022,AFG-22/3481/RA1/APC/NGO/21686,9/24/2023 5:20:32 AM,Overall,9000,9000,26050,25950,70000,7343,8093,27611,26958,70005
23,Afghanistan,2022,AFG-22/3481/RA1/APC/NGO/21686,9/24/2023 5:20:32 AM,Refugees,750,750,1500,1500,4500,0,0,0,0,0
23,Afghanistan,2022,AFG-22/3481/RA1/APC/NGO/21686,9/24/2023 5:20:32 AM,Returnees,1250,1250,4900,4800,12200,659,817,1630,1950,5056
23,Afghanistan,2022,AFG-22/3481/RA1/APC/NGO/21743,10/2/2023 9:48:28 AM,Host Communities,1050,840,2200,1750,5840,2267,2385,3702,1773,10127
23,Afghanistan,2022,AFG-22/3481/RA1/APC/NGO/21743,10/2/2023 9:48:28 AM,Internally Displaced People,1200,800,11400,6450,19850,4849,2622,8277,5366,21114
23,Afghanistan,2022,AFG-22/3481/RA1/APC/NGO/21743,10/2/2023 9:48:28 AM,Overall,2360,1690,13950,8500,26500,7275,5070,12329,7472,32146
23,Afghanistan,2022,AFG-22/3481/RA1/APC/NGO/21743,10/2/2023 9:48:28 AM,Refugees,10,0,50,50,110,10,0,50,50,110
23,Afghanistan,2022,AFG-22/3481/RA1/APC/NGO/21743,10/2/2023 9:48:28 AM,Returnees,100,50,300,250,700,149,63,300,283,795
23,Afghanistan,2022,AFG-22/3481/RA1/APC/UN/21678,2/6/2023 10:44:41 AM,Host Communities,25000,23000,16700,15000,79700,33162,30918,24121,22979,111180
23,Afghanistan,2022,AFG-22/3481/RA1/APC/UN/21678,2/6/2023 10:44:41 AM,Internally Displaced People,6970,5780,4200,3800,20750,4647,4221,4180,3312,16360
23,Afghanistan,2022,AFG-22/3481/RA1/APC/UN/21678,2/6/2023 10:44:41 AM,Overall,31970,28780,20900,18800,100450,37809,35139,28301,26291,127540
23,Afghanistan,2022,AFG-22/3481/RA1/ESNFI/INGO/21624,7/17/2023 7:23:11 AM,Other,453,506,749,764,2472,453,504,748,764,2469
23,Afghanistan,2022,AFG-22/3481/RA1/ESNFI/INGO/21624,7/17/2023 7:23:11 AM,Overall,453,506,749,764,2472,453,504,748,764,2469
23,Afghanistan,2022,AFG-22/3481/RA1/ESNFI/INGO/21709,5/20/2023 6:58:46 AM,Host Communities,274,274,502,471,1521,437,547,868,911,2763
23,Afghanistan,2022,AFG-22/3481/RA1/ESNFI/INGO/21709,5/20/2023 6:58:46 AM,Internally Displaced People,538,538,987,927,2990,380,507,919,942,2748
23,Afghanistan,2022,AFG-22/3481/RA1/ESNFI/INGO/21709,5/20/2023 6:58:46 AM,Overall,912,912,1673,1571,5068,826,1065,1814,1882,5587
23,Afghanistan,2022,AFG-22/3481/RA1/ESNFI/INGO/21709,5/20/2023 6:58:46 AM,Returnees,100,100,184,173,557,9,11,27,29,76
23,Afghanistan,2022,AFG-22/3481/RA1/ESNFI/NGO/21610,9/21/2023 7:08:28 AM,Host Communities,546,660,777,894,2877,550,668,789,910,2917
23,Afghanistan,2022,AFG-22/3481/RA1/ESNFI/NGO/21610,9/21/2023 7:08:28 AM,Overall,546,660,777,894,2877,550,668,789,910,2917
23,Afghanistan,2022,AFG-22/3481/RA1/ESNFI/NGO/21672,9/23/2023 9:37:07 AM,Host Communities,822,996,1170,1345,4333,830,999,1190,1355,4374
23,Afghanistan,2022,AFG-22/3481/RA1/ESNFI/NGO/21672,9/23/2023 9:37:07 AM,Overall,822,996,1170,1345,4333,830,999,1190,1355,4374
23,Afghanistan,2022,AFG-22/3481/RA1/FSAC/INGO/21602,9/25/2023 5:31:51 AM,Host Communities,3486,3341,3922,3776,14525,2790,3236,5866,6164,18056
23,Afghanistan,2022,AFG-22/3481/RA1/FSAC/INGO/21602,9/25/2023 5:31:51 AM,Overall,3486,3341,3922,3776,14525,2790,3236,5866,6164,18056
23,Afghanistan,2022,AFG-22/3481/RA1/FSAC/INGO/21675,7/20/2023 1:10:19 PM,Host Communities,3034,2913,3155,3034,12136,2519,2517,3346,3775,12157
23,Afghanistan,2022,AFG-22/3481/RA1/FSAC/INGO/21675,7/20/2023 1:10:19 PM,Overall,3034,2913,3155,3034,12136,2519,2517,3346,3775,12157
23,Afghanistan,2022,AFG-22/3481/RA1/FSAC/INGO/21692,7/15/2023 9:13:44 AM,Host Communities,2012,2948,2282,2430,9672,2360,2670,4264,3878,13172
23,Afghanistan,2022,AFG-22/3481/RA1/FSAC/INGO/21692,7/15/2023 9:13:44 AM,Internally Displaced People,280,267,254,269,1070,0,0,0,0,0
23,Afghanistan,2022,AFG-22/3481/RA1/FSAC/INGO/21692,7/15/2023 9:13:44 AM,Overall,2292,3215,2536,2699,10742,2360,2670,4264,3878,13172
23,Afghanistan,2022,AFG-22/3481/RA1/FSAC/INGO/21702,9/22/2023 8:10:02 AM,Host Communities,2404,2404,2718,2927,10453,1777,2075,2970,3179,10001
23,Afghanistan,2022,AFG-22/3481/RA1/FSAC/INGO/21702,9/22/2023 8:10:02 AM,Overall,2404,2404,2718,2927,10453,1777,2075,2970,3179,10001
23,Afghanistan,2022,AFG-22/3481/RA1/FSAC/NGO/21606,7/15/2023 11:23:00 AM,Host Communities,1602,2035,1772,2031,7440,972,1547,2744,3080,8343
23,Afghanistan,2022,AFG-22/3481/RA1/FSAC/NGO/21606,7/15/2023 11:23:00 AM,Overall,1602,2035,1772,2031,7440,972,1547,2744,3080,8343
23,Afghanistan,2022,AFG-22/3481/RA1/FSAC/NGO/21632,3/5/2023 11:46:12 AM,Host Communities,880,1020,1460,1530,4890,761,1044,1720,1979,5504
23,Afghanistan,2022,AFG-22/3481/RA1/FSAC/NGO/21632,3/5/2023 11:46:12 AM,Internally Displaced People,285,440,850,920,2495,442,579,970,1217,3208
23,Afghanistan,2022,AFG-22/3481/RA1/FSAC/NGO/21632,3/5/2023 11:46:12 AM,Overall,1165,1460,2310,2450,7385,1203,1623,2690,3196,8712
23,Afghanistan,2022,AFG-22/3481/RA1/FSAC/NGO/21640,9/22/2023 9:51:05 AM,Host Communities,10290,10290,6860,6860,34300,10290,10290,6860,6860,34300
23,Afghanistan,2022,AFG-22/3481/RA1/FSAC/NGO/21640,9/22/2023 9:51:05 AM,Overall,10290,10290,6860,6860,34300,10290,10290,6860,6860,34300
23,Afghanistan,2022,AFG-22/3481/RA1/FSAC/UN/21761,9/24/2023 9:48:08 AM,Host Communities,50195,51287,61107,55650,218239,105921,108224,128948,117434,460527
23,Afghanistan,2022,AFG-22/3481/RA1/FSAC/UN/21761,9/24/2023 9:48:08 AM,Overall,50195,51287,61107,55650,218239,105921,108224,128948,117434,460527
23,Afghanistan,2022,AFG-22/3481/RA1/H/INGO/21599,9/23/2023 10:36:04 AM,Host Communities,8670,20230,9633,9633,48166,12553,15157,9956,26162,63828
23,Afghanistan,2022,AFG-22/3481/RA1/H/INGO/21599,9/23/2023 10:36:04 AM,Internally Displaced People,133,309,147,147,736,343,339,213,501,1396
23,Afghanistan,2022,AFG-22/3481/RA1/H/INGO/21599,9/23/2023 10:36:04 AM,Overall,8821,20580,9800,9800,49001,12896,15496,10169,26663,65224
23,Afghanistan,2022,AFG-22/3481/RA1/H/INGO/21599,9/23/2023 10:36:04 AM,Returnees,18,41,20,20,99,0,0,0,0,0
23,Afghanistan,2022,AFG-22/3481/RA1/H/INGO/21600,7/2/2023 7:04:47 PM,Host Communities,31567,47350,7892,11838,98647,41712,46541,19221,18822,126296
23,Afghanistan,2022,AFG-22/3481/RA1/H/INGO/21600,7/2/2023 7:04:47 PM,Overall,31567,47350,7892,11838,98647,41712,46541,19221,18822,126296
23,Afghanistan,2022,AFG-22/3481/RA1/H/NGO/21596,2/7/2023 10:38:27 AM,Host Communities,3768,3509,0,0,7277,3802,6524,1103,540,11969
23,Afghanistan,2022,AFG-22/3481/RA1/H/NGO/21596,2/7/2023 10:38:27 AM,Other,46,8,0,0,54,42,9,0,0,51
23,Afghanistan,2022,AFG-22/3481/RA1/H/NGO/21596,2/7/2023 10:38:27 AM,Overall,3814,3517,0,0,7331,3844,6533,1103,540,12020
23,Afghanistan,2022,AFG-22/3481/RA1/H/NGO/21631,9/21/2023 8:42:41 AM,Host Communities,16583,20729,3317,4146,44775,10142,32245,8878,10738,62003
23,Afghanistan,2022,AFG-22/3481/RA1/H/NGO/21631,9/21/2023 8:42:41 AM,Overall,16583,20729,3317,4146,44775,10142,32245,8878,10738,62003
23,Afghanistan,2022,AFG-22/3481/RA1/H/NGO/21708,2/7/2023 10:50:26 AM,Host Communities,2428,2731,581,553,6293,1939,4946,238,568,7691
23,Afghanistan,2022,AFG-22/3481/RA1/H/NGO/21708,2/7/2023 10:50:26 AM,Internally Displaced People,611,860,288,280,2039,283,253,0,0,536
23,Afghanistan,2022,AFG-22/3481/RA1/H/NGO/21708,2/7/2023 10:50:26 AM,Overall,3039,3591,869,833,8332,2222,5199,238,568,8227
23,Afghanistan,2022,AFG-22/3481/RA1/H/NGO/21747,7/17/2023 9:10:04 AM,Host Communities,2500,2700,150,150,5500,601,1188,80,2159,4028
23,Afghanistan,2022,AFG-22/3481/RA1/H/NGO/21747,7/17/2023 9:10:04 AM,Internally Displaced People,500,500,50,50,1100,658,1522,97,344,2621
23,Afghanistan,2022,AFG-22/3481/RA1/H/NGO/21747,7/17/2023 9:10:04 AM,Overall,3000,3200,200,200,6600,1259,2710,177,2503,6649
23,Afghanistan,2022,AFG-22/3481/RA1/N-H/INGO/21645,7/13/2023 10:10:58 AM,Other,17340,34680,32368,31212,115600,22971,47925,20672,23076,114644
23,Afghanistan,2022,AFG-22/3481/RA1/N-H/INGO/21645,7/13/2023 10:10:58 AM,Overall,17340,34680,32368,31212,115600,22971,47925,20672,23076,114644
23,Afghanistan,2022,AFG-22/3481/RA1/N-H/NGO/21597,9/27/2023 9:10:40 AM,Host Communities,14116,40434,13358,13459,81367,18138,86111,29122,31981,165352
23,Afghanistan,2022,AFG-22/3481/RA1/N-H/NGO/21597,9/27/2023 9:10:40 AM,Other,35,40,0,0,75,35,42,0,0,77
23,Afghanistan,2022,AFG-22/3481/RA1/N-H/NGO/21597,9/27/2023 9:10:40 AM,Overall,14151,40474,13358,13459,81442,18173,86153,29122,31981,165429
23,Afghanistan,2022,AFG-22/3481/RA2/CCS/UN/23031,9/24/2023 6:45:40 AM,Other,210,90,0,0,300,374,80,0,0,454
23,Afghanistan,2022,AFG-22/3481/RA2/CCS/UN/23031,9/24/2023 6:45:40 AM,Overall,210,90,0,0,300,374,80,0,0,454
23,Afghanistan,2022,AFG-22/3481/RA2/CCS/UN/23154,2/6/2023 11:45:25 AM,Other,150,50,0,0,200,224,48,0,0,272
23,Afghanistan,2022,AFG-22/3481/RA2/CCS/UN/23154,2/6/2023 11:45:25 AM,Overall,150,50,0,0,200,224,48,0,0,272
23,Afghanistan,2022,AFG-22/3481/RA2/CCS/UN/23180,7/19/2023 12:59:16 PM,Host Communities,6918,7068,7670,8421,30077,0,0,0,0,0
23,Afghanistan,2022,AFG-22/3481/RA2/CCS/UN/23180,7/19/2023 12:59:16 PM,Other,350,150,0,0,500,345,138,0,0,483
23,Afghanistan,2022,AFG-22/3481/RA2/CCS/UN/23180,7/19/2023 12:59:16 PM,Overall,7268,7218,7670,8421,30577,345,138,0,0,483
23,Afghanistan,2022,AFG-22/3481/RA2/H/INGO/22977,9/23/2023 10:07:05 AM,Host Communities,1748,1758,498,498,4502,1598,1807,1048,706,5159
23,Afghanistan,2022,AFG-22/3481/RA2/H/INGO/22977,9/23/2023 10:07:05 AM,Internally Displaced People,92,92,27,27,238,90,0,21,0,111
23,Afghanistan,2022,AFG-22/3481/RA2/H/INGO/22977,9/23/2023 10:07:05 AM,Overall,1840,1850,525,525,4740,1688,1807,1069,706,5270
23,Afghanistan,2022,AFG-22/3481/RA2/H/UN/23109,9/11/2023 8:50:07 AM,Host Communities,40927,33485,22037,18031,114480,52418,32301,24441,20291,129451
23,Afghanistan,2022,AFG-22/3481/RA2/H/UN/23109,9/11/2023 8:50:07 AM,Internally Displaced People,18704,15304,10072,8240,52320,23960,14764,11172,9275,59171
23,Afghanistan,2022,AFG-22/3481/RA2/H/UN/23109,9/11/2023 8:50:07 AM,Overall,59631,48789,32109,26271,166800,76378,47065,35613,29566,188622
23,Afghanistan,2022,AFG-22/3481/RA3/APC/INGO/23971,9/30/2023 6:17:08 AM,Host Communities,11241,22482,749,2998,37470,0,0,0,0,0
23,Afghanistan,2022,AFG-22/3481/RA3/APC/INGO/23971,9/30/2023 6:17:08 AM,Internally Displaced People,433,866,29,115,1443,0,0,0,0,0
23,Afghanistan,2022,AFG-22/3481/RA3/APC/INGO/23971,9/30/2023 6:17:08 AM,Overall,11674,23348,778,3113,38913,0,0,0,0,0
23,Afghanistan,2022,AFG-22/3481/RA3/APC/INGO/23997,9/29/2023 10:52:48 AM,Host Communities,4136,8274,276,1103,13789,0,0,0,0,0
23,Afghanistan,2022,AFG-22/3481/RA3/APC/INGO/23997,9/29/2023 10:52:48 AM,Internally Displaced People,26,53,2,7,88,0,0,0,0,0
23,Afghanistan,2022,AFG-22/3481/RA3/APC/INGO/23997,9/29/2023 10:52:48 AM,Overall,4162,8327,278,1110,13877,0,0,0,0,0
23,Afghanistan,2022,AFG-22/3481/RA3/APC/INGO/24012,9/29/2023 10:55:32 AM,Host Communities,9027,18053,601,2407,30088,0,0,0,0,0
23,Afghanistan,2022,AFG-22/3481/RA3/APC/INGO/24012,9/29/2023 10:55:32 AM,Internally Displaced People,266,531,18,71,886,0,0,0,0,0
23,Afghanistan,2022,AFG-22/3481/RA3/APC/INGO/24012,9/29/2023 10:55:32 AM,Overall,9293,18584,619,2478,30974,0,0,0,0,0
23,Afghanistan,2022,AFG-22/3481/RA3/ESNFI/INGO/23583,9/30/2023 5:33:38 AM,Host Communities,1685,2109,3185,3475,10454,1668,2085,3141,3420,10314
23,Afghanistan,2022,AFG-22/3481/RA3/ESNFI/INGO/23583,9/30/2023 5:33:38 AM,Internally Displaced People,241,258,430,497,1426,241,258,430,497,1426
23,Afghanistan,2022,AFG-22/3481/RA3/ESNFI/INGO/23583,9/30/2023 5:33:38 AM,Overall,2174,2673,4085,4445,13377,1912,2345,3574,3923,11754
23,Afghanistan,2022,AFG-22/3481/RA3/ESNFI/INGO/23583,9/30/2023 5:33:38 AM,Returnees,248,306,470,473,1497,3,2,3,6,14
23,Afghanistan,2022,AFG-22/3481/RA3/ESNFI/INGO/23610,9/24/2023 10:19:04 AM,Host Communities,1672,1606,785,755,4818,1403,1638,2716,2623,8380
23,Afghanistan,2022,AFG-22/3481/RA3/ESNFI/INGO/23610,9/24/2023 10:19:04 AM,Internally Displaced People,1169,1124,550,529,3372,89,96,152,156,493
23,Afghanistan,2022,AFG-22/3481/RA3/ESNFI/INGO/23610,9/24/2023 10:19:04 AM,Overall,2841,2730,1335,1284,8190,1492,1734,2868,2779,8873
23,Afghanistan,2022,AFG-22/3481/RA3/ESNFI/INGO/23613,9/22/2023 10:19:21 AM,Host Communities,4069,3875,969,775,9688,4069,3875,969,775,9688
23,Afghanistan,2022,AFG-22/3481/RA3/ESNFI/INGO/23613,9/22/2023 10:19:21 AM,Overall,4069,3875,969,775,9688,4069,3875,969,775,9688
23,Afghanistan,2022,AFG-22/3481/RA3/ESNFI/INGO/23628,7/7/2023 12:51:49 PM,Host Communities,1000,950,1050,1000,4000,2194,2173,4552,4206,13125
23,Afghanistan,2022,AFG-22/3481/RA3/ESNFI/INGO/23628,7/7/2023 12:51:49 PM,Internally Displaced People,1226,1187,1265,1226,4904,0,0,0,0,0
23,Afghanistan,2022,AFG-22/3481/RA3/ESNFI/INGO/23628,7/7/2023 12:51:49 PM,Overall,2226,2137,2315,2226,8904,2194,2173,4552,4206,13125
23,Afghanistan,2022,AFG-22/3481/RA3/ESNFI/INGO/23643,10/2/2023 11:26:11 AM,Host Communities,1718,1719,2278,2279,7994,1693,2159,2571,2658,9081
23,Afghanistan,2022,AFG-22/3481/RA3/ESNFI/INGO/23643,10/2/2023 11:26:11 AM,Overall,1718,1719,2278,2279,7994,1693,2159,2571,2658,9081
23,Afghanistan,2022,AFG-22/3481/RA3/ESNFI/INGO/23679,9/27/2023 9:13:09 AM,Host Communities,2284,2190,2570,2476,9520,3485,3404,5312,5122,17323
23,Afghanistan,2022,AFG-22/3481/RA3/ESNFI/INGO/23679,9/27/2023 9:13:09 AM,Overall,2284,2190,2570,2476,9520,3485,3404,5312,5122,17323
23,Afghanistan,2022,AFG-22/3481/RA3/ESNFI/INGO/23686,10/2/2023 11:18:56 AM,Host Communities,850,851,1127,1127,3955,885,967,1041,1067,3960
23,Afghanistan,2022,AFG-22/3481/RA3/ESNFI/INGO/23686,10/2/2023 11:18:56 AM,Overall,850,851,1127,1127,3955,885,967,1041,1067,3960
23,Afghanistan,2022,AFG-22/3481/RA3/ESNFI/INGO/23687,9/23/2023 9:34:24 AM,Host Communities,3436,3436,2291,2290,11453,4661,4810,2425,2330,14226
23,Afghanistan,2022,AFG-22/3481/RA3/ESNFI/INGO/23687,9/23/2023 9:34:24 AM,Overall,3436,3436,2291,2290,11453,4661,4810,2425,2330,14226
23,Afghanistan,2022,AFG-22/3481/RA3/ESNFI/INGO/23706,9/21/2023 10:51:32 AM,Host Communities,1643,2132,3918,4356,12049,1627,2112,3874,4325,11938
23,Afghanistan,2022,AFG-22/3481/RA3/ESNFI/INGO/23706,9/21/2023 10:51:32 AM,Internally Displaced People,141,183,332,317,973,141,183,332,317,973
23,Afghanistan,2022,AFG-22/3481/RA3/ESNFI/INGO/23706,9/21/2023 10:51:32 AM,Overall,1785,2316,4252,4674,13027,1769,2296,4208,4643,12916
23,Afghanistan,2022,AFG-22/3481/RA3/ESNFI/INGO/23706,9/21/2023 10:51:32 AM,Returnees,1,1,2,1,5,1,1,2,1,5
23,Afghanistan,2022,AFG-22/3481/RA3/ESNFI/INGO/23716,9/30/2023 6:50:41 AM,Host Communities,1966,2070,3550,3572,11158,2041,2157,3838,3695,11731
23,Afghanistan,2022,AFG-22/3481/RA3/ESNFI/INGO/23716,9/30/2023 6:50:41 AM,Overall,1966,2070,3550,3572,11158,2041,2157,3838,3695,11731
23,Afghanistan,2022,AFG-22/3481/RA3/ESNFI/INGO/23727,7/30/2023 11:07:11 AM,Host Communities,860,1204,1950,1718,5732,860,1204,1950,1718,5732
23,Afghanistan,2022,AFG-22/3481/RA3/ESNFI/INGO/23727,7/30/2023 11:07:11 AM,Internally Displaced People,369,516,836,737,2458,369,516,836,737,2458
23,Afghanistan,2022,AFG-22/3481/RA3/ESNFI/INGO/23727,7/30/2023 11:07:11 AM,Overall,1229,1720,2786,2455,8190,1229,1720,2786,2455,8190
23,Afghanistan,2022,AFG-22/3481/RA3/ESNFI/INGO/23729,9/24/2023 6:42:58 AM,Host Communities,3442,3442,2295,2295,11474,2531,2823,4385,4215,13954
23,Afghanistan,2022,AFG-22/3481/RA3/ESNFI/INGO/23729,9/24/2023 6:42:58 AM,Overall,3442,3442,2295,2295,11474,2531,2823,4385,4215,13954
23,Afghanistan,2022,AFG-22/3481/RA3/ESNFI/NGO/23603,9/12/2023 5:35:31 AM,Host Communities,2211,2211,1474,1474,7370,2225,2204,1480,1461,7370
23,Afghanistan,2022,AFG-22/3481/RA3/ESNFI/NGO/23603,9/12/2023 5:35:31 AM,Internally Displaced People,246,246,164,164,820,241,249,158,172,820
23,Afghanistan,2022,AFG-22/3481/RA3/ESNFI/NGO/23603,9/12/2023 5:35:31 AM,Overall,2457,2457,1638,1638,8190,2466,2453,1638,1633,8190
23,Afghanistan,2022,AFG-22/3481/RA3/ESNFI/NGO/23652,10/11/2023 6:08:49 AM,Host Communities,546,546,819,819,2730,546,546,819,819,2730
23,Afghanistan,2022,AFG-22/3481/RA3/ESNFI/NGO/23652,10/11/2023 6:08:49 AM,Internally Displaced People,546,546,819,819,2730,546,546,819,819,2730
23,Afghanistan,2022,AFG-22/3481/RA3/ESNFI/NGO/23652,10/11/2023 6:08:49 AM,Other,546,546,819,819,2730,546,546,819,819,2730
23,Afghanistan,2022,AFG-22/3481/RA3/ESNFI/NGO/23652,10/11/2023 6:08:49 AM,Overall,1638,1638,2457,2457,8190,1638,1638,2457,2457,8190
23,Afghanistan,2022,AFG-22/3481/RA3/ESNFI/NGO/23661,9/23/2023 7:59:48 AM,Host Communities,1561,1561,2341,2342,7805,1341,1718,2804,2759,8622
23,Afghanistan,2022,AFG-22/3481/RA3/ESNFI/NGO/23661,9/23/2023 7:59:48 AM,Other,280,280,420,421,1401,234,294,490,458,1476
23,Afghanistan,2022,AFG-22/3481/RA3/ESNFI/NGO/23661,9/23/2023 7:59:48 AM,Overall,1841,1841,2761,2763,9206,1575,2012,3294,3217,10098
23,Afghanistan,2022,AFG-22/3481/RA3/ESNFI/NGO/23664,9/12/2023 4:48:43 AM,Host Communities,2386,2386,1590,1590,7952,2396,2373,1607,1576,7952
23,Afghanistan,2022,AFG-22/3481/RA3/ESNFI/NGO/23664,9/12/2023 4:48:43 AM,Overall,2386,2386,1590,1590,7952,2396,2373,1607,1576,7952
23,Afghanistan,2022,AFG-22/3481/RA3/ESNFI/NGO/23666,10/11/2023 6:12:04 AM,Host Communities,546,546,819,819,2730,544,615,810,868,2837
23,Afghanistan,2022,AFG-22/3481/RA3/ESNFI/NGO/23666,10/11/2023 6:12:04 AM,Internally Displaced People,546,546,819,819,2730,544,615,810,868,2837
23,Afghanistan,2022,AFG-22/3481/RA3/ESNFI/NGO/23666,10/11/2023 6:12:04 AM,Other,546,546,819,819,2730,544,615,810,868,2837
23,Afghanistan,2022,AFG-22/3481/RA3/ESNFI/NGO/23666,10/11/2023 6:12:04 AM,Overall,1638,1638,2457,2457,8190,1632,1845,2430,2604,8511
23,Afghanistan,2022,AFG-22/3481/RA3/ESNFI/NGO/23675,9/29/2023 6:54:10 AM,Host Communities,1753,2211,1677,1982,7623,1272,1314,2417,2348,7351
23,Afghanistan,2022,AFG-22/3481/RA3/ESNFI/NGO/23675,9/29/2023 6:54:10 AM,Overall,1753,2211,1677,1982,7623,1272,1314,2417,2348,7351
23,Afghanistan,2022,AFG-22/3481/RA3/ESNFI/NGO/23688,7/6/2023 7:07:38 AM,Host Communities,884,1115,845,999,3843,670,774,1199,1229,3872
23,Afghanistan,2022,AFG-22/3481/RA3/ESNFI/NGO/23688,7/6/2023 7:07:38 AM,Overall,884,1115,845,999,3843,670,774,1199,1229,3872
23,Afghanistan,2022,AFG-22/3481/RA3/ESNFI/NGO/23740,10/11/2023 9:37:55 AM,Host Communities,1485,1505,2526,2674,8190,1522,1543,2660,2700,8425
23,Afghanistan,2022,AFG-22/3481/RA3/ESNFI/NGO/23740,10/11/2023 9:37:55 AM,Overall,1485,1505,2526,2674,8190,1522,1543,2660,2700,8425
23,Afghanistan,2022,AFG-22/3481/RA3/ESNFI/UN/24303,7/17/2023 4:54:19 AM,Host Communities,1501,1501,1314,1314,5630,1134,1310,2414,1851,6709
23,Afghanistan,2022,AFG-22/3481/RA3/ESNFI/UN/24303,7/17/2023 4:54:19 AM,Internally Displaced People,4119,4127,6187,6187,20620,2991,3169,6624,6661,19445
23,Afghanistan,2022,AFG-22/3481/RA3/ESNFI/UN/24303,7/17/2023 4:54:19 AM,Overall,5620,5628,7501,7501,26250,4125,4479,9038,8512,26154
23,Afghanistan,2022,AFG-22/3481/RA3/FSAC/INGO/23591,10/2/2023 11:32:54 AM,Host Communities,1546,1913,2822,2822,9103,1314,1975,2494,2984,8767
23,Afghanistan,2022,AFG-22/3481/RA3/FSAC/INGO/23591,10/2/2023 11:32:54 AM,Internally Displaced People,272,339,498,498,1607,267,331,516,588,1702
23,Afghanistan,2022,AFG-22/3481/RA3/FSAC/INGO/23591,10/2/2023 11:32:54 AM,Overall,1818,2252,3320,3320,10710,1581,2306,3010,3572,10469
23,Afghanistan,2022,AFG-22/3481/RA3/FSAC/INGO/23612,10/3/2023 11:39:02 AM,Host Communities,1792,1792,2376,2377,8337,1130,1781,2714,3010,8635
23,Afghanistan,2022,AFG-22/3481/RA3/FSAC/INGO/23612,10/3/2023 11:39:02 AM,Overall,1792,1792,2376,2377,8337,1130,1781,2714,3010,8635
23,Afghanistan,2022,AFG-22/3481/RA3/FSAC/INGO/23756,10/2/2023 9:36:41 AM,Host Communities,1809,2035,1735,1960,7539,1561,1910,3654,3459,10584
23,Afghanistan,2022,AFG-22/3481/RA3/FSAC/INGO/23756,10/2/2023 9:36:41 AM,Overall,1809,2035,1735,1960,7539,1561,1910,3654,3459,10584
23,Afghanistan,2022,AFG-22/3481/RA3/FSAC/NGO/23606,9/29/2023 7:28:34 AM,Host Communities,1527,1943,1690,1940,7100,1430,1644,2950,2953,8977
23,Afghanistan,2022,AFG-22/3481/RA3/FSAC/NGO/23606,9/29/2023 7:28:34 AM,Overall,1527,1943,1690,1940,7100,1430,1644,2950,2953,8977
23,Afghanistan,2022,AFG-22/3481/RA3/FSAC/NGO/23641,9/23/2023 10:11:27 AM,Host Communities,1814,1663,2117,1966,7560,1403,1810,3083,2928,9224
23,Afghanistan,2022,AFG-22/3481/RA3/FSAC/NGO/23641,9/23/2023 10:11:27 AM,Overall,1814,1663,2117,1966,7560,1403,1810,3083,2928,9224
23,Afghanistan,2022,AFG-22/3481/RA3/FSAC/NGO/23665,10/11/2023 6:28:31 AM,Host Communities,1368,2064,1662,2046,7140,1331,1349,2594,3371,8645
23,Afghanistan,2022,AFG-22/3481/RA3/FSAC/NGO/23665,10/11/2023 6:28:31 AM,Overall,1368,2064,1662,2046,7140,1331,1349,2594,3371,8645
23,Afghanistan,2022,AFG-22/3481/RA3/FSAC/NGO/23698,10/4/2023 7:34:22 AM,Host Communities,1254,1568,2430,2588,7840,1386,1753,2460,2754,8353
23,Afghanistan,2022,AFG-22/3481/RA3/FSAC/NGO/23698,10/4/2023 7:34:22 AM,Overall,1254,1568,2430,2588,7840,1386,1753,2460,2754,8353
23,Afghanistan,2022,AFG-22/3481/RA3/H/INGO/23623,10/12/2023 5:22:15 AM,Host Communities,19976,27888,10386,12134,70384,21972,26518,10955,11174,70619
23,Afghanistan,2022,AFG-22/3481/RA3/H/INGO/23623,10/12/2023 5:22:15 AM,Overall,19976,27888,10386,12134,70384,21972,26518,10955,11174,70619
23,Afghanistan,2022,AFG-22/3481/RA3/H/NGO/23636,9/27/2023 9:08:12 AM,Host Communities,9135,8483,7830,7178,32626,28035,32116,10012,9199,79362
23,Afghanistan,2022,AFG-22/3481/RA3/H/NGO/23636,9/27/2023 9:08:12 AM,Other,20,20,0,0,40,20,20,0,0,40
23,Afghanistan,2022,AFG-22/3481/RA3/H/NGO/23636,9/27/2023 9:08:12 AM,Overall,9155,8503,7830,7178,32666,28055,32136,10012,9199,79402
23,Afghanistan,2022,AFG-22/3481/RA3/H/NGO/24327,9/30/2023 6:20:56 AM,Host Communities,29574,30780,13287,13829,87470,15735,22574,7045,6900,52254
23,Afghanistan,2022,AFG-22/3481/RA3/H/NGO/24327,9/30/2023 6:20:56 AM,Other,47,39,0,0,86,47,39,0,0,86
23,Afghanistan,2022,AFG-22/3481/RA3/H/NGO/24327,9/30/2023 6:20:56 AM,Overall,29621,30819,13287,13829,87556,15782,22613,7045,6900,52340
23,Afghanistan,2022,AFG-22/3481/RA3/N/INGO/23581,8/6/2023 5:48:31 AM,Host Communities,56,850,950,770,2626,151,1011,1365,1493,4020
23,Afghanistan,2022,AFG-22/3481/RA3/N/INGO/23581,8/6/2023 5:48:31 AM,Internally Displaced People,0,513,401,708,1622,0,520,402,750,1672
23,Afghanistan,2022,AFG-22/3481/RA3/N/INGO/23581,8/6/2023 5:48:31 AM,Overall,56,1363,1351,1478,4248,151,1531,1767,2243,5692
23,Afghanistan,2022,AFG-22/3481/RA3/N/NGO/23609,9/21/2023 12:00:02 PM,Host Communities,0,5910,4045,4045,14000,0,6603,4149,4367,15119
23,Afghanistan,2022,AFG-22/3481/RA3/N/NGO/23609,9/21/2023 12:00:02 PM,Overall,0,5910,4045,4045,14000,0,6603,4149,4367,15119
23,Afghanistan,2022,AFG-22/3481/RA3/N/UN/23630,10/6/2023 7:34:32 AM,Host Communities,0,0,9592,10206,19798,0,0,8700,10640,19340
23,Afghanistan,2022,AFG-22/3481/RA3/N/UN/23630,10/6/2023 7:34:32 AM,Overall,0,0,9592,10206,19798,0,0,8700,10640,19340
23,Afghanistan,2022,AFG-22/3481/RA3/WASH/INGO/23580,9/22/2023 9:19:52 AM,Host Communities,2737,3451,2618,3094,11900,2350,3519,2980,3354,12203
23,Afghanistan,2022,AFG-22/3481/RA3/WASH/INGO/23580,9/22/2023 9:19:52 AM,Internally Displaced People,684,863,654,774,2975,670,810,638,740,2858
23,Afghanistan,2022,AFG-22/3481/RA3/WASH/INGO/23580,9/22/2023 9:19:52 AM,Overall,3421,4314,3272,3868,14875,3020,4329,3618,4094,15061
23,Afghanistan,2022,AFG-22/3481/RA3/WASH/NGO/23651,9/27/2023 9:17:06 AM,Host Communities,5200,5200,2500,2500,15400,5623,5400,2715,2385,16123
23,Afghanistan,2022,AFG-22/3481/RA3/WASH/NGO/23651,9/27/2023 9:17:06 AM,Internally Displaced People,1000,1000,500,500,3000,824,795,440,479,2538
23,Afghanistan,2022,AFG-22/3481/RA3/WASH/NGO/23651,9/27/2023 9:17:06 AM,Overall,6700,6700,3300,3300,20000,6925,6564,3411,3100,20000
23,Afghanistan,2022,AFG-22/3481/RA3/WASH/NGO/23651,9/27/2023 9:17:06 AM,Returnees,500,500,300,300,1600,478,369,256,236,1339
23,Afghanistan,2022,AFG-22/3481/RA3/WASH/NGO/23678,10/6/2023 9:07:26 AM,Host Communities,5507,8306,6690,8237,28740,8880,8665,7931,8706,34182
23,Afghanistan,2022,AFG-22/3481/RA3/WASH/NGO/23678,10/6/2023 9:07:26 AM,Overall,5507,8306,6690,8237,28740,8880,8665,7931,8706,34182
23,Afghanistan,2022,AFG-22/3481/SA1/APC/INGO/22242,9/23/2023 10:01:47 AM,Host Communities,2139,2444,2649,2954,10186,2664,2760,3684,3924,13032
23,Afghanistan,2022,AFG-22/3481/SA1/APC/INGO/22242,9/23/2023 10:01:47 AM,Internally Displaced People,44,51,54,60,209,54,58,100,122,334
23,Afghanistan,2022,AFG-22/3481/SA1/APC/INGO/22242,9/23/2023 10:01:47 AM,Overall,2205,2520,2730,3045,10500,2725,2828,3809,4071,13433
23,Afghanistan,2022,AFG-22/3481/SA1/APC/INGO/22242,9/23/2023 10:01:47 AM,Returnees,22,25,27,31,105,7,10,25,25,67
23,Afghanistan,2022,AFG-22/3481/SA1/APC/INGO/22261,10/1/2023 4:36:02 AM,Host Communities,2720,2240,2816,3648,11424,3519,902,4499,2933,11853
23,Afghanistan,2022,AFG-22/3481/SA1/APC/INGO/22261,10/1/2023 4:36:02 AM,Overall,2720,2240,2816,3648,11424,3519,902,4499,2933,11853
23,Afghanistan,2022,AFG-22/3481/SA1/APC/INGO/22935,2/6/2023 11:38:13 AM,Host Communities,308,308,924,616,2156,1423,1366,1983,1761,6533
23,Afghanistan,2022,AFG-22/3481/SA1/APC/INGO/22935,2/6/2023 11:38:13 AM,Overall,308,308,924,616,2156,1423,1366,1983,1761,6533
23,Afghanistan,2022,AFG-22/3481/SA1/APC/NGO/22068,10/6/2023 7:32:48 AM,Host Communities,2960,1480,5920,4440,14800,2330,2020,5844,4606,14800
23,Afghanistan,2022,AFG-22/3481/SA1/APC/NGO/22068,10/6/2023 7:32:48 AM,Internally Displaced People,70,35,140,105,350,50,70,130,100,350
23,Afghanistan,2022,AFG-22/3481/SA1/APC/NGO/22068,10/6/2023 7:32:48 AM,Overall,3030,1515,6060,4545,15150,2380,2090,5974,4706,15150
23,Afghanistan,2022,AFG-22/3481/SA1/APC/NGO/22611,12/28/2022 5:23:03 AM,Host Communities,3802,3802,7591,7590,22785,5299,5286,9840,9490,29915
23,Afghanistan,2022,AFG-22/3481/SA1/APC/NGO/22611,12/28/2022 5:23:03 AM,Internally Displaced People,3802,3802,7590,7591,22785,3006,3000,5583,5385,16974
23,Afghanistan,2022,AFG-22/3481/SA1/APC/NGO/22611,12/28/2022 5:23:03 AM,Overall,7604,7604,15181,15181,45570,8305,8286,15423,14875,46889
23,Afghanistan,2022,AFG-22/3481/SA1/APC/NGO/22963,2/7/2023 11:06:31 AM,Host Communities,1278,2992,1325,3105,8700,4038,4779,3988,5072,17877
23,Afghanistan,2022,AFG-22/3481/SA1/APC/NGO/22963,2/7/2023 11:06:31 AM,Internally Displaced People,1278,2992,1325,3105,8700,1571,1858,1550,1973,6952
23,Afghanistan,2022,AFG-22/3481/SA1/APC/NGO/22963,2/7/2023 11:06:31 AM,Overall,2556,5984,2650,6210,17400,5609,6637,5538,7045,24829
23,Afghanistan,2022,AFG-22/3481/SA1/APC/UN/23050,9/23/2023 6:53:57 AM,Other,2032,1659,1120,1286,6097,7456,2687,2222,1116,13481
23,Afghanistan,2022,AFG-22/3481/SA1/APC/UN/23050,9/23/2023 6:53:57 AM,Overall,2032,1659,1120,1286,6097,7456,2687,2222,1116,13481
23,Afghanistan,2022,AFG-22/3481/SA1/EIE/INGO/22474,10/6/2023 9:11:01 AM,Host Communities,1271,1271,2243,2243,7028,1385,1202,1780,2401,6768
23,Afghanistan,2022,AFG-22/3481/SA1/EIE/INGO/22474,10/6/2023 9:11:01 AM,Internally Displaced People,456,456,801,801,2514,485,460,698,985,2628
23,Afghanistan,2022,AFG-22/3481/SA1/EIE/INGO/22474,10/6/2023 9:11:01 AM,Overall,1818,1818,3204,3204,10044,1962,1756,2640,3560,9918
23,Afghanistan,2022,AFG-22/3481/SA1/EIE/INGO/22474,10/6/2023 9:11:01 AM,Returnees,91,91,160,160,502,92,94,162,174,522
23,Afghanistan,2022,AFG-22/3481/SA1/ESNFI/INGO/21949,7/16/2023 11:34:48 AM,Host Communities,574,574,1053,991,3192,574,574,1053,991,3192
23,Afghanistan,2022,AFG-22/3481/SA1/ESNFI/INGO/21949,7/16/2023 11:34:48 AM,Overall,574,574,1053,991,3192,574,574,1053,991,3192
23,Afghanistan,2022,AFG-22/3481/SA1/ESNFI/INGO/21989,9/27/2023 9:21:12 AM,Host Communities,1189,1358,1472,1640,5659,1811,1988,2189,2187,8175
23,Afghanistan,2022,AFG-22/3481/SA1/ESNFI/INGO/21989,9/27/2023 9:21:12 AM,Internally Displaced People,24,28,30,34,116,101,129,299,316,845
23,Afghanistan,2022,AFG-22/3481/SA1/ESNFI/INGO/21989,9/27/2023 9:21:12 AM,Overall,1222,1396,1513,1686,5817,1936,2150,2531,2520,9137
23,Afghanistan,2022,AFG-22/3481/SA1/ESNFI/INGO/21989,9/27/2023 9:21:12 AM,Returnees,9,10,11,12,42,24,33,43,17,117
23,Afghanistan,2022,AFG-22/3481/SA1/ESNFI/INGO/22118,10/4/2023 7:31:26 AM,Host Communities,70,71,94,94,329,83,96,183,204,566
23,Afghanistan,2022,AFG-22/3481/SA1/ESNFI/INGO/22118,10/4/2023 7:31:26 AM,Internally Displaced People,502,503,666,667,2338,740,787,1240,1239,4006
23,Afghanistan,2022,AFG-22/3481/SA1/ESNFI/INGO/22118,10/4/2023 7:31:26 AM,Overall,1074,1077,1426,1428,5005,1482,1515,2387,2498,7882
23,Afghanistan,2022,AFG-22/3481/SA1/ESNFI/INGO/22118,10/4/2023 7:31:26 AM,Returnees,502,503,666,667,2338,659,632,964,1055,3310
23,Afghanistan,2022,AFG-22/3481/SA1/ESNFI/INGO/22139,7/17/2023 6:37:16 AM,Host Communities,2528,2529,1686,1686,8429,2009,2289,3054,2903,10255
23,Afghanistan,2022,AFG-22/3481/SA1/ESNFI/INGO/22139,7/17/2023 6:37:16 AM,Overall,3160,3161,2107,2107,10535,2010,2291,3058,2904,10263
23,Afghanistan,2022,AFG-22/3481/SA1/ESNFI/INGO/22139,7/17/2023 6:37:16 AM,Returnees,632,632,421,421,2106,1,2,4,1,8
23,Afghanistan,2022,AFG-22/3481/SA1/ESNFI/INGO/22621,10/2/2023 11:23:00 AM,Host Communities,675,676,896,896,3143,473,518,814,753,2558
23,Afghanistan,2022,AFG-22/3481/SA1/ESNFI/INGO/22621,10/2/2023 11:23:00 AM,Overall,675,676,896,896,3143,473,518,814,753,2558
23,Afghanistan,2022,AFG-22/3481/SA1/ESNFI/INGO/22635,9/25/2023 6:23:40 AM,Host Communities,285,285,522,490,1582,427,487,726,754,2394
23,Afghanistan,2022,AFG-22/3481/SA1/ESNFI/INGO/22635,9/25/2023 6:23:40 AM,Overall,285,285,522,490,1582,427,487,726,754,2394
23,Afghanistan,2022,AFG-22/3481/SA1/ESNFI/INGO/22653,9/25/2023 6:21:43 AM,Host Communities,263,263,483,454,1463,625,653,1285,1154,3717
23,Afghanistan,2022,AFG-22/3481/SA1/ESNFI/INGO/22653,9/25/2023 6:21:43 AM,Overall,263,263,483,454,1463,625,653,1285,1154,3717
23,Afghanistan,2022,AFG-22/3481/SA1/ESNFI/NGO/21957,7/17/2023 5:51:07 AM,Internally Displaced People,850,890,1620,1645,5005,863,892,1887,1989,5631
23,Afghanistan,2022,AFG-22/3481/SA1/ESNFI/NGO/21957,7/17/2023 5:51:07 AM,Overall,850,890,1620,1645,5005,863,892,1887,1989,5631
23,Afghanistan,2022,AFG-22/3481/SA1/ESNFI/NGO/21999,7/15/2023 9:28:45 AM,Internally Displaced People,372,403,558,603,1936,296,382,1067,1195,2940
23,Afghanistan,2022,AFG-22/3481/SA1/ESNFI/NGO/21999,7/15/2023 9:28:45 AM,Other,248,268,372,403,1291,147,194,530,587,1458
23,Afghanistan,2022,AFG-22/3481/SA1/ESNFI/NGO/21999,7/15/2023 9:28:45 AM,Overall,620,671,930,1006,3227,443,576,1597,1782,4398
23,Afghanistan,2022,AFG-22/3481/SA1/ESNFI/NGO/22014,9/24/2023 10:13:45 AM,Host Communities,1340,1620,1907,2190,7057,1350,1626,1927,2199,7102
23,Afghanistan,2022,AFG-22/3481/SA1/ESNFI/NGO/22014,9/24/2023 10:13:45 AM,Overall,1340,1620,1907,2190,7057,1350,1626,1927,2199,7102
23,Afghanistan,2022,AFG-22/3481/SA1/ESNFI/NGO/22132,7/29/2023 2:39:17 PM,Host Communities,756,756,1134,1134,3780,732,762,1151,1142,3787
23,Afghanistan,2022,AFG-22/3481/SA1/ESNFI/NGO/22132,7/29/2023 2:39:17 PM,Internally Displaced People,95,95,141,141,472,88,85,151,142,466
23,Afghanistan,2022,AFG-22/3481/SA1/ESNFI/NGO/22132,7/29/2023 2:39:17 PM,Overall,946,946,1417,1416,4725,912,944,1447,1423,4726
23,Afghanistan,2022,AFG-22/3481/SA1/ESNFI/NGO/22132,7/29/2023 2:39:17 PM,Returnees,95,95,142,141,473,92,97,145,139,473
23,Afghanistan,2022,AFG-22/3481/SA1/ESNFI/NGO/22143,10/6/2023 7:44:25 AM,Host Communities,185,186,475,484,1330,555,604,1031,3276,5466
23,Afghanistan,2022,AFG-22/3481/SA1/ESNFI/NGO/22143,10/6/2023 7:44:25 AM,Internally Displaced People,262,263,675,676,1876,0,0,0,0,0
23,Afghanistan,2022,AFG-22/3481/SA1/ESNFI/NGO/22143,10/6/2023 7:44:25 AM,Overall,628,631,1615,1627,4501,555,604,1031,3276,5466
23,Afghanistan,2022,AFG-22/3481/SA1/ESNFI/NGO/22143,10/6/2023 7:44:25 AM,Returnees,181,182,465,467,1295,0,0,0,0,0
23,Afghanistan,2022,AFG-22/3481/SA1/ESNFI/NGO/22150,7/26/2023 1:24:25 PM,Host Communities,259,259,388,389,1295,817,817,1226,1226,4086
23,Afghanistan,2022,AFG-22/3481/SA1/ESNFI/NGO/22150,7/26/2023 1:24:25 PM,Internally Displaced People,410,410,615,616,2051,67,66,99,99,331
23,Afghanistan,2022,AFG-22/3481/SA1/ESNFI/NGO/22150,7/26/2023 1:24:25 PM,Overall,669,669,1003,1005,3346,884,883,1325,1325,4417
23,Afghanistan,2022,AFG-22/3481/SA1/ESNFI/NGO/22619,10/10/2023 7:30:26 AM,Host Communities,371,371,557,556,1855,375,368,559,553,1855
23,Afghanistan,2022,AFG-22/3481/SA1/ESNFI/NGO/22619,10/10/2023 7:30:26 AM,Overall,371,371,557,556,1855,375,368,559,553,1855
23,Afghanistan,2022,AFG-22/3481/SA1/ESNFI/NGO/22654,9/24/2023 6:47:44 AM,Host Communities,582,704,827,949,3062,590,711,834,952,3087
23,Afghanistan,2022,AFG-22/3481/SA1/ESNFI/NGO/22654,9/24/2023 6:47:44 AM,Overall,582,704,827,949,3062,590,711,834,952,3087
23,Afghanistan,2022,AFG-22/3481/SA1/ESNFI/NGO/23148,9/29/2023 10:58:48 AM,Host Communities,170,170,430,430,1200,194,206,387,420,1207
23,Afghanistan,2022,AFG-22/3481/SA1/ESNFI/NGO/23148,9/29/2023 10:58:48 AM,Internally Displaced People,60,60,100,100,320,65,79,120,122,386
23,Afghanistan,2022,AFG-22/3481/SA1/ESNFI/NGO/23148,9/29/2023 10:58:48 AM,Overall,230,230,530,530,1520,259,285,507,542,1593
23,Afghanistan,2022,AFG-22/3481/SA1/ESNFI/UN/22595,10/6/2023 7:42:31 AM,Other,652,652,979,979,3262,505,521,660,601,2287
23,Afghanistan,2022,AFG-22/3481/SA1/ESNFI/UN/22595,10/6/2023 7:42:31 AM,Overall,652,652,979,979,3262,505,521,660,601,2287
23,Afghanistan,2022,AFG-22/3481/SA1/FSAC/INGO/21971,9/21/2023 10:35:39 AM,Host Communities,2063,1981,2421,2327,8792,1434,1964,2952,2924,9274
23,Afghanistan,2022,AFG-22/3481/SA1/FSAC/INGO/21971,9/21/2023 10:35:39 AM,Overall,2063,1981,2421,2327,8792,1434,1964,2952,2924,9274
23,Afghanistan,2022,AFG-22/3481/SA1/FSAC/INGO/22048,10/1/2023 7:28:15 AM,Host Communities,1654,1890,2048,2282,7874,1480,1652,2461,2445,8038
23,Afghanistan,2022,AFG-22/3481/SA1/FSAC/INGO/22048,10/1/2023 7:28:15 AM,Overall,1654,1890,2048,2282,7874,1480,1652,2461,2445,8038
23,Afghanistan,2022,AFG-22/3481/SA1/FSAC/INGO/22110,10/1/2023 4:45:07 AM,Host Communities,2020,1917,2290,2188,8415,1285,1526,2741,2766,8318
23,Afghanistan,2022,AFG-22/3481/SA1/FSAC/INGO/22110,10/1/2023 4:45:07 AM,Internally Displaced People,865,821,981,937,3604,549,626,1031,1018,3224
23,Afghanistan,2022,AFG-22/3481/SA1/FSAC/INGO/22110,10/1/2023 4:45:07 AM,Overall,2885,2738,3271,3125,12019,1834,2152,3772,3784,11542
23,Afghanistan,2022,AFG-22/3481/SA1/FSAC/INGO/22162,9/24/2023 10:09:47 AM,Host Communities,2348,2916,2687,2971,10922,3466,3500,2451,1505,10922
23,Afghanistan,2022,AFG-22/3481/SA1/FSAC/INGO/22162,9/24/2023 10:09:47 AM,Overall,2348,2916,2687,2971,10922,3466,3500,2451,1505,10922
23,Afghanistan,2022,AFG-22/3481/SA1/FSAC/INGO/22193,7/17/2023 8:27:14 AM,Host Communities,2859,2860,1907,1908,9534,1823,2881,4041,3556,12301
23,Afghanistan,2022,AFG-22/3481/SA1/FSAC/INGO/22193,7/17/2023 8:27:14 AM,Overall,2859,2860,1907,1908,9534,1823,2881,4041,3556,12301
23,Afghanistan,2022,AFG-22/3481/SA1/FSAC/INGO/22203,10/2/2023 11:24:26 AM,Host Communities,2188,2188,2901,2901,10178,3016,2245,3149,3329,11739
23,Afghanistan,2022,AFG-22/3481/SA1/FSAC/INGO/22203,10/2/2023 11:24:26 AM,Overall,2188,2188,2901,2901,10178,3016,2245,3149,3329,11739
23,Afghanistan,2022,AFG-22/3481/SA1/FSAC/INGO/22280,9/24/2023 10:03:51 AM,Host Communities,1457,1638,1396,1578,6069,1226,1572,2508,2818,8124
23,Afghanistan,2022,AFG-22/3481/SA1/FSAC/INGO/22280,9/24/2023 10:03:51 AM,Overall,1457,1638,1396,1578,6069,1226,1572,2508,2818,8124
23,Afghanistan,2022,AFG-22/3481/SA1/FSAC/NGO/21965,10/2/2023 9:42:46 AM,Host Communities,1824,2240,1414,1804,7282,1074,1510,2303,2500,7387
23,Afghanistan,2022,AFG-22/3481/SA1/FSAC/NGO/21965,10/2/2023 9:42:46 AM,Overall,1824,2240,1414,1804,7282,1074,1510,2303,2500,7387
23,Afghanistan,2022,AFG-22/3481/SA1/FSAC/NGO/21966,7/15/2023 2:19:17 PM,Host Communities,1024,1303,1133,1300,4760,869,996,1538,1506,4909
23,Afghanistan,2022,AFG-22/3481/SA1/FSAC/NGO/21966,7/15/2023 2:19:17 PM,Overall,1024,1303,1133,1300,4760,869,996,1538,1506,4909
23,Afghanistan,2022,AFG-22/3481/SA1/FSAC/NGO/22165,9/22/2023 8:40:38 AM,Host Communities,1490,1635,2288,2987,8400,891,1254,3771,5004,10920
23,Afghanistan,2022,AFG-22/3481/SA1/FSAC/NGO/22165,9/22/2023 8:40:38 AM,Overall,1490,1635,2288,2987,8400,891,1254,3771,5004,10920
23,Afghanistan,2022,AFG-22/3481/SA1/FSAC/NGO/22182,9/24/2023 7:00:39 AM,Host Communities,1370,1657,1950,2241,7218,1372,1660,1965,2249,7246
23,Afghanistan,2022,AFG-22/3481/SA1/FSAC/NGO/22182,9/24/2023 7:00:39 AM,Overall,1370,1657,1950,2241,7218,1372,1660,1965,2249,7246
23,Afghanistan,2022,AFG-22/3481/SA1/FSAC/NGO/22217,9/25/2023 5:26:03 AM,Host Communities,394,419,788,1023,2624,483,497,931,1575,3486
23,Afghanistan,2022,AFG-22/3481/SA1/FSAC/NGO/22217,9/25/2023 5:26:03 AM,Internally Displaced People,590,629,1181,1535,3935,706,735,1215,1604,4260
23,Afghanistan,2022,AFG-22/3481/SA1/FSAC/NGO/22217,9/25/2023 5:26:03 AM,Overall,984,1048,1969,2558,6559,1189,1232,2146,3179,7746
23,Afghanistan,2022,AFG-22/3481/SA1/FSAC/NGO/22245,9/3/2023 6:29:56 AM,Host Communities,2266,3173,1813,1813,9065,2278,3162,1815,1810,9065
23,Afghanistan,2022,AFG-22/3481/SA1/FSAC/NGO/22245,9/3/2023 6:29:56 AM,Overall,2266,3173,1813,1813,9065,2278,3162,1815,1810,9065
23,Afghanistan,2022,AFG-22/3481/SA1/FSAC/NGO/22255,9/24/2023 5:14:00 AM,Host Communities,1903,1905,2306,2195,8309,1258,1512,2475,2697,7942
23,Afghanistan,2022,AFG-22/3481/SA1/FSAC/NGO/22255,9/24/2023 5:14:00 AM,Overall,1903,1905,2306,2195,8309,1258,1512,2475,2697,7942
23,Afghanistan,2022,AFG-22/3481/SA1/FSAC/NGO/22270,9/23/2023 10:09:21 AM,Host Communities,1578,1578,1921,1784,6861,837,1005,2526,2813,7181
23,Afghanistan,2022,AFG-22/3481/SA1/FSAC/NGO/22270,9/23/2023 10:09:21 AM,Overall,1578,1578,1921,1784,6861,837,1005,2526,2813,7181
23,Afghanistan,2022,AFG-22/3481/SA1/N/NGO/22097,7/29/2023 3:14:05 PM,Host Communities,0,5750,5615,5615,16980,773,13744,6177,5053,25747
23,Afghanistan,2022,AFG-22/3481/SA1/N/NGO/22097,7/29/2023 3:14:05 PM,Overall,0,5750,5615,5615,16980,773,13744,6177,5053,25747
23,Afghanistan,2022,AFG-22/3481/SA1/N/UN/21994,10/8/2023 11:14:14 AM,Host Communities,0,0,3517,4298,7815,0,0,3341,4512,7853
23,Afghanistan,2022,AFG-22/3481/SA1/N/UN/21994,10/8/2023 11:14:14 AM,Overall,0,0,3517,4298,7815,0,0,3341,4512,7853
23,Afghanistan,2022,AFG-22/3481/SA1/N/UN/22222,10/15/2023 9:48:16 AM,Host Communities,0,0,1838,1922,3760,0,0,5802,5573,11375
23,Afghanistan,2022,AFG-22/3481/SA1/N/UN/22222,10/15/2023 9:48:16 AM,Internally Displaced People,0,0,129,134,263,0,0,403,387,790
23,Afghanistan,2022,AFG-22/3481/SA1/N/UN/22222,10/15/2023 9:48:16 AM,Overall,0,0,1967,2056,4023,0,0,6205,5960,12165
23,Afghanistan,2022,AFG-22/3481/SA1/WASH/INGO/22196,9/22/2023 10:35:38 AM,Host Communities,1848,2326,1764,2085,8023,1860,2336,1750,2050,7996
23,Afghanistan,2022,AFG-22/3481/SA1/WASH/INGO/22196,9/22/2023 10:35:38 AM,Internally Displaced People,4305,5428,4118,4866,18717,4204,5459,4216,4939,18818
23,Afghanistan,2022,AFG-22/3481/SA1/WASH/INGO/22196,9/22/2023 10:35:38 AM,Overall,6153,7754,5882,6951,26740,6064,7795,5966,6989,26814
23,Afghanistan,2022,AFG-22/3481/SA1/WASH/INGO/22489,10/1/2023 4:23:47 AM,Host Communities,2528,2528,1686,1686,8428,2528,2528,2241,2340,9637
23,Afghanistan,2022,AFG-22/3481/SA1/WASH/INGO/22489,10/1/2023 4:23:47 AM,Overall,3160,3160,2107,2108,10535,3160,3160,2662,2762,11744
23,Afghanistan,2022,AFG-22/3481/SA1/WASH/INGO/22489,10/1/2023 4:23:47 AM,Returnees,632,632,421,422,2107,632,632,421,422,2107
23,Afghanistan,2022,AFG-22/3481/SA1/WASH/NGO/22333,10/6/2023 7:51:10 AM,Host Communities,1703,2569,2069,2547,8888,2704,2798,2288,2548,10338
23,Afghanistan,2022,AFG-22/3481/SA1/WASH/NGO/22333,10/6/2023 7:51:10 AM,Internally Displaced People,730,1101,887,1092,3810,1159,1242,1021,1092,4514
23,Afghanistan,2022,AFG-22/3481/SA1/WASH/NGO/22333,10/6/2023 7:51:10 AM,Overall,2433,3670,2956,3639,12698,3863,4040,3309,3640,14852
23,Afghanistan,2022,AFG-22/3481/SA1/WASH/NGO/22562,10/11/2023 9:32:09 AM,Host Communities,9853,9853,6569,6569,32844,9852,9782,6611,6455,32700
23,Afghanistan,2022,AFG-22/3481/SA1/WASH/NGO/22562,10/11/2023 9:32:09 AM,Internally Displaced People,1159,1159,773,773,3864,1174,1143,812,791,3920
23,Afghanistan,2022,AFG-22/3481/SA1/WASH/NGO/22562,10/11/2023 9:32:09 AM,Overall,11592,11592,7728,7728,38640,11649,11518,7821,7652,38640
23,Afghanistan,2022,AFG-22/3481/SA1/WASH/NGO/22562,10/11/2023 9:32:09 AM,Returnees,580,580,386,386,1932,623,593,398,406,2020
85,Burkina Faso,2022,BFA-22/BF_CBPF_RHPF/RA/FS-GBV/NGO/24238,9/15/2023 9:16:57 AM,Host Communities,129,134,186,209,658,121,131,299,286,837
85,Burkina Faso,2022,BFA-22/BF_CBPF_RHPF/RA/FS-GBV/NGO/24238,9/15/2023 9:16:57 AM,Internally Displaced People,420,437,604,681,2142,398,467,922,882,2669
85,Burkina Faso,2022,BFA-22/BF_CBPF_RHPF/RA/FS-GBV/NGO/24238,9/15/2023 9:16:57 AM,Overall,549,571,790,890,2800,519,598,1221,1168,3506
85,Burkina Faso,2022,BFA-22/BF_CBPF_RHPF/RA/GBV/INGO/24280,10/18/2023 4:36:59 PM,Host Communities,74,307,251,338,970,1311,4303,4422,6395,16431
85,Burkina Faso,2022,BFA-22/BF_CBPF_RHPF/RA/GBV/INGO/24280,10/18/2023 4:36:59 PM,Internally Displaced People,294,1223,997,1348,3862,993,8790,2216,4992,16991
85,Burkina Faso,2022,BFA-22/BF_CBPF_RHPF/RA/GBV/INGO/24280,10/18/2023 4:36:59 PM,Overall,368,1530,1248,1686,4832,2304,13093,6638,11387,33422
85,Burkina Faso,2022,BFA-22/BF_CBPF_RHPF/RA/H-NUT-W-FS/INGO/24300,9/15/2023 11:00:31 AM,Host Communities,4673,5042,52715,57345,119775,2033,8526,79306,80666,170531
85,Burkina Faso,2022,BFA-22/BF_CBPF_RHPF/RA/H-NUT-W-FS/INGO/24300,9/15/2023 11:00:31 AM,Internally Displaced People,17187,18680,33863,36676,106406,3422,14762,21008,22583,61775
85,Burkina Faso,2022,BFA-22/BF_CBPF_RHPF/RA/H-NUT-W-FS/INGO/24300,9/15/2023 11:00:31 AM,Overall,21860,23722,86578,94021,226181,5455,23288,100314,103249,232306
85,Burkina Faso,2022,BFA-22/BF_CBPF_RHPF/RA/NUT-FS-H-W/INGO/24217,9/20/2023 2:50:35 PM,Host Communities,1040,2421,3724,4184,11369,1515,4559,5491,6223,17788
85,Burkina Faso,2022,BFA-22/BF_CBPF_RHPF/RA/NUT-FS-H-W/INGO/24217,9/20/2023 2:50:35 PM,Internally Displaced People,1557,3632,5587,6277,17053,1419,2981,5678,7600,17678
85,Burkina Faso,2022,BFA-22/BF_CBPF_RHPF/RA/NUT-FS-H-W/INGO/24217,9/20/2023 2:50:35 PM,Overall,2597,6053,9311,10461,28422,2934,7540,11169,13823,35466
85,Burkina Faso,2022,BFA-22/BF_CBPF_RHPF/RA/NUT-W/INGO/24284,10/16/2023 9:48:05 AM,Host Communities,564,846,636,954,3000,78,734,3811,2664,7287
85,Burkina Faso,2022,BFA-22/BF_CBPF_RHPF/RA/NUT-W/INGO/24284,10/16/2023 9:48:05 AM,Internally Displaced People,1316,1974,1484,2226,7000,355,317,1828,3451,5951
85,Burkina Faso,2022,BFA-22/BF_CBPF_RHPF/RA/NUT-W/INGO/24284,10/16/2023 9:48:05 AM,Overall,1880,2820,2120,3180,10000,433,1051,5639,6115,13238
85,Burkina Faso,2022,BFA-22/BF_CBPF_RHPF/RA/NUT-W-H/INGO/24230,10/16/2023 9:40:41 AM,Host Communities,624,14707,3486,3652,22469,892,16195,2815,3499,23401
85,Burkina Faso,2022,BFA-22/BF_CBPF_RHPF/RA/NUT-W-H/INGO/24230,10/16/2023 9:40:41 AM,Internally Displaced People,67,1204,313,325,1909,294,1526,577,476,2873
85,Burkina Faso,2022,BFA-22/BF_CBPF_RHPF/RA/NUT-W-H/INGO/24230,10/16/2023 9:40:41 AM,Overall,691,15911,3799,3977,24378,1186,17721,3392,3975,26274
85,Burkina Faso,2022,BFA-22/BF_CBPF_RHPF/RA/S-W-FS-GBV-CP/INGO/24235,9/18/2023 9:53:45 AM,Host Communities,415,597,805,779,2596,200,365,785,986,2336
85,Burkina Faso,2022,BFA-22/BF_CBPF_RHPF/RA/S-W-FS-GBV-CP/INGO/24235,9/18/2023 9:53:45 AM,Internally Displaced People,1661,2388,3219,3115,10383,1774,11113,4778,6515,24180
85,Burkina Faso,2022,BFA-22/BF_CBPF_RHPF/RA/S-W-FS-GBV-CP/INGO/24235,9/18/2023 9:53:45 AM,Overall,2076,2985,4024,3894,12979,1974,11478,5563,7501,26516
85,Burkina Faso,2022,BFA-22/BF_CBPF_RHPF/RA/W/INGO/24292,9/20/2023 2:52:51 PM,Host Communities,1350,2250,2430,2970,9000,591,1605,863,1090,4149
85,Burkina Faso,2022,BFA-22/BF_CBPF_RHPF/RA/W/INGO/24292,9/20/2023 2:52:51 PM,Internally Displaced People,900,1500,1620,1980,6000,1802,4486,2217,3963,12468
85,Burkina Faso,2022,BFA-22/BF_CBPF_RHPF/RA/W/INGO/24292,9/20/2023 2:52:51 PM,Overall,2250,3750,4050,4950,15000,2393,6091,3080,5053,16617
85,Burkina Faso,2022,BFA-22/BF_CBPF_RHPF/RA/W-NUT-H/NGO/24245,9/18/2023 12:50:43 PM,Host Communities,1306,1414,1877,2034,6631,1398,1527,1905,2098,6928
85,Burkina Faso,2022,BFA-22/BF_CBPF_RHPF/RA/W-NUT-H/NGO/24245,9/18/2023 12:50:43 PM,Internally Displaced People,1668,2189,2922,3164,9943,1741,3007,3104,3273,11125
85,Burkina Faso,2022,BFA-22/BF_CBPF_RHPF/RA/W-NUT-H/NGO/24245,9/18/2023 12:50:43 PM,Overall,2974,3603,4799,5198,16574,3139,4534,5009,5371,18053
85,Burkina Faso,2022,BFA-22/BF_CBPF_RHPF/SA/CP/NGO/21780,8/24/2023 10:25:38 AM,Host Communities,7500,10000,7500,7500,32500,7832,11357,6618,8416,34223
85,Burkina Faso,2022,BFA-22/BF_CBPF_RHPF/SA/CP/NGO/21780,8/24/2023 10:25:38 AM,Internally Displaced People,7000,8000,6500,6000,27500,7052,8143,5831,7093,28119
85,Burkina Faso,2022,BFA-22/BF_CBPF_RHPF/SA/CP/NGO/21780,8/24/2023 10:25:38 AM,Overall,14500,18000,14000,13500,60000,14884,19500,12449,15509,62342
85,Burkina Faso,2022,BFA-22/BF_CBPF_RHPF/SA/CP-GBV/INGO/21839,9/12/2023 10:43:20 AM,Host Communities,410,565,1405,1719,4099,2449,4042,5797,6658,18946
85,Burkina Faso,2022,BFA-22/BF_CBPF_RHPF/SA/CP-GBV/INGO/21839,9/12/2023 10:43:20 AM,Internally Displaced People,2775,3805,4428,5390,16398,3166,5205,6660,8104,23135
85,Burkina Faso,2022,BFA-22/BF_CBPF_RHPF/SA/CP-GBV/INGO/21839,9/12/2023 10:43:20 AM,Overall,3185,4370,5833,7109,20497,5615,9247,12457,14762,42081
85,Burkina Faso,2022,BFA-22/BF_CBPF_RHPF/SA/CP-W-S/INGO/21658,9/22/2023 8:54:58 AM,Host Communities,398,614,649,1012,2673,292,410,476,922,2100
85,Burkina Faso,2022,BFA-22/BF_CBPF_RHPF/SA/CP-W-S/INGO/21658,9/22/2023 8:54:58 AM,Internally Displaced People,4584,7060,7473,11620,30737,2603,3246,5539,6720,18108
85,Burkina Faso,2022,BFA-22/BF_CBPF_RHPF/SA/CP-W-S/INGO/21658,9/22/2023 8:54:58 AM,Overall,4982,7674,8122,12632,33410,2895,3656,6015,7642,20208
85,Burkina Faso,2022,BFA-22/BF_CBPF_RHPF/SA/E-W/INGO/21776,8/21/2023 10:07:42 AM,Host Communities,98,118,1505,2097,3818,249,281,4877,5099,10506
85,Burkina Faso,2022,BFA-22/BF_CBPF_RHPF/SA/E-W/INGO/21776,8/21/2023 10:07:42 AM,Internally Displaced People,70,101,1982,2634,4787,210,215,3632,3785,7842
85,Burkina Faso,2022,BFA-22/BF_CBPF_RHPF/SA/E-W/INGO/21776,8/21/2023 10:07:42 AM,Overall,168,219,3487,4731,8605,459,496,8509,8884,18348
85,Burkina Faso,2022,BFA-22/BF_CBPF_RHPF/SA/FS/NGO/21766,4/3/2023 6:29:35 PM,Host Communities,129,134,186,209,658,123,184,189,185,681
85,Burkina Faso,2022,BFA-22/BF_CBPF_RHPF/SA/FS/NGO/21766,4/3/2023 6:29:35 PM,Internally Displaced People,420,437,604,681,2142,477,593,734,797,2601
85,Burkina Faso,2022,BFA-22/BF_CBPF_RHPF/SA/FS/NGO/21766,4/3/2023 6:29:35 PM,Overall,549,571,790,890,2800,600,777,923,982,3282
85,Burkina Faso,2022,BFA-22/BF_CBPF_RHPF/SA/FS-GBV/INGO/21822,8/24/2023 10:21:11 AM,Host Communities,1456,2094,2821,2730,9101,2550,7362,1480,2812,14204
85,Burkina Faso,2022,BFA-22/BF_CBPF_RHPF/SA/FS-GBV/INGO/21822,8/24/2023 10:21:11 AM,Internally Displaced People,3397,4884,6583,6370,21234,3539,7067,2890,4101,17597
85,Burkina Faso,2022,BFA-22/BF_CBPF_RHPF/SA/FS-GBV/INGO/21822,8/24/2023 10:21:11 AM,Overall,4853,6978,9404,9100,30335,6089,14429,4370,6913,31801
85,Burkina Faso,2022,BFA-22/BF_CBPF_RHPF/SA/FS-S-NUT/INGO/21711,4/3/2023 5:44:50 PM,Host Communities,295,320,333,361,1309,363,470,643,671,2147
85,Burkina Faso,2022,BFA-22/BF_CBPF_RHPF/SA/FS-S-NUT/INGO/21711,4/3/2023 5:44:50 PM,Internally Displaced People,889,963,1003,1086,3941,692,1027,1422,1457,4598
85,Burkina Faso,2022,BFA-22/BF_CBPF_RHPF/SA/FS-S-NUT/INGO/21711,4/3/2023 5:44:50 PM,Overall,1184,1283,1336,1447,5250,1055,1497,2065,2128,6745
85,Burkina Faso,2022,BFA-22/BF_CBPF_RHPF/SA/FS-W/INGO/21745,4/3/2023 5:48:25 PM,Host Communities,963,1406,1896,1835,6100,958,1378,1858,1798,5992
85,Burkina Faso,2022,BFA-22/BF_CBPF_RHPF/SA/FS-W/INGO/21745,4/3/2023 5:48:25 PM,Internally Displaced People,1444,2110,2844,2752,9150,2238,3216,4334,4194,13982
85,Burkina Faso,2022,BFA-22/BF_CBPF_RHPF/SA/FS-W/INGO/21745,4/3/2023 5:48:25 PM,Overall,2407,3516,4740,4587,15250,3196,4594,6192,5992,19974
85,Burkina Faso,2022,BFA-22/BF_CBPF_RHPF/SA/GBV-CP/INGO/21690,10/16/2023 9:50:39 AM,Host Communities,3191,5207,3604,5222,17224,8356,19005,6204,7936,41501
85,Burkina Faso,2022,BFA-22/BF_CBPF_RHPF/SA/GBV-CP/INGO/21690,10/16/2023 9:50:39 AM,Internally Displaced People,7447,12151,1545,2238,23381,929,2112,853,1162,5056
85,Burkina Faso,2022,BFA-22/BF_CBPF_RHPF/SA/GBV-CP/INGO/21690,10/16/2023 9:50:39 AM,Overall,10638,17358,5149,7460,40605,9285,21117,7057,9098,46557
85,Burkina Faso,2022,BFA-22/BF_CBPF_RHPF/SA/GBV-CP/INGO/21778,9/12/2023 10:51:38 AM,Host Communities,1000,3000,1000,1500,6500,1620,4917,4346,4581,15464
85,Burkina Faso,2022,BFA-22/BF_CBPF_RHPF/SA/GBV-CP/INGO/21778,9/12/2023 10:51:38 AM,Internally Displaced People,2382,10011,4479,11403,28275,2976,19661,13029,18314,53980
85,Burkina Faso,2022,BFA-22/BF_CBPF_RHPF/SA/GBV-CP/INGO/21778,9/12/2023 10:51:38 AM,Overall,3382,13011,5479,12903,34775,4596,24578,17375,22895,69444
85,Burkina Faso,2022,BFA-22/BF_CBPF_RHPF/SA/GBV-E/INGO/21727,9/12/2023 10:54:40 AM,Host Communities,2114,3427,12460,11320,29321,2395,3882,14117,12825,33219
85,Burkina Faso,2022,BFA-22/BF_CBPF_RHPF/SA/GBV-E/INGO/21727,9/12/2023 10:54:40 AM,Internally Displaced People,3078,13647,11583,13999,42307,3487,15462,13123,15860,47932
85,Burkina Faso,2022,BFA-22/BF_CBPF_RHPF/SA/GBV-E/INGO/21727,9/12/2023 10:54:40 AM,Other,167,248,0,0,415,189,280,0,0,469
85,Burkina Faso,2022,BFA-22/BF_CBPF_RHPF/SA/GBV-E/INGO/21727,9/12/2023 10:54:40 AM,Overall,5359,17322,24043,25319,72043,6071,19624,27240,28685,81620
85,Burkina Faso,2022,BFA-22/BF_CBPF_RHPF/SA/NUT-W/INGO/21749,10/19/2023 9:32:45 AM,Host Communities,362,6781,589,631,8363,302,6302,819,4682,12105
85,Burkina Faso,2022,BFA-22/BF_CBPF_RHPF/SA/NUT-W/INGO/21749,10/19/2023 9:32:45 AM,Internally Displaced People,241,4521,393,420,5575,202,4201,546,3122,8071
85,Burkina Faso,2022,BFA-22/BF_CBPF_RHPF/SA/NUT-W/INGO/21749,10/19/2023 9:32:45 AM,Overall,603,11302,982,1051,13938,504,10503,1365,7804,20176
85,Burkina Faso,2022,BFA-22/BF_CBPF_RHPF/SA/P/NGO/21850,10/17/2023 11:58:23 AM,Host Communities,1500,1500,1000,1000,5000,860,4131,289,1359,6639
85,Burkina Faso,2022,BFA-22/BF_CBPF_RHPF/SA/P/NGO/21850,10/17/2023 11:58:23 AM,Internally Displaced People,3500,3500,3000,3000,13000,2009,9641,675,3173,15498
85,Burkina Faso,2022,BFA-22/BF_CBPF_RHPF/SA/P/NGO/21850,10/17/2023 11:58:23 AM,Overall,5000,5000,4000,4000,18000,2869,13772,964,4532,22137
85,Burkina Faso,2022,BFA-22/BF_CBPF_RHPF/SA/P-NUT/INGO/21795,7/28/2023 11:52:29 AM,Host Communities,1253,1543,2062,2236,7094,1028,1667,2133,2910,7738
85,Burkina Faso,2022,BFA-22/BF_CBPF_RHPF/SA/P-NUT/INGO/21795,7/28/2023 11:52:29 AM,Internally Displaced People,3597,2925,4797,5201,16520,2421,3826,4697,6238,17182
85,Burkina Faso,2022,BFA-22/BF_CBPF_RHPF/SA/P-NUT/INGO/21795,7/28/2023 11:52:29 AM,Overall,4850,4468,6859,7437,23614,3449,5493,6830,9148,24920
85,Burkina Faso,2022,BFA-22/BF_CBPF_RHPF/SA/P-NUT-FS/INGO/21847,9/19/2023 11:44:53 AM,Host Communities,278,258,7411,8032,15979,2319,7234,9395,9986,28934
85,Burkina Faso,2022,BFA-22/BF_CBPF_RHPF/SA/P-NUT-FS/INGO/21847,9/19/2023 11:44:53 AM,Internally Displaced People,199,191,29652,32114,62156,3209,3549,20757,31004,58519
85,Burkina Faso,2022,BFA-22/BF_CBPF_RHPF/SA/P-NUT-FS/INGO/21847,9/19/2023 11:44:53 AM,Overall,477,449,37063,40146,78135,5528,10783,30152,40990,87453
85,Burkina Faso,2022,BFA-22/BF_CBPF_RHPF/SA/S-FS-P/INGO/21775,7/28/2023 12:22:01 PM,Host Communities,823,788,343,379,2333,225,459,272,243,1199
85,Burkina Faso,2022,BFA-22/BF_CBPF_RHPF/SA/S-FS-P/INGO/21775,7/28/2023 12:22:01 PM,Internally Displaced People,3817,4080,3382,3806,15085,2968,6541,5804,5682,20995
85,Burkina Faso,2022,BFA-22/BF_CBPF_RHPF/SA/S-FS-P/INGO/21775,7/28/2023 12:22:01 PM,Overall,4640,4868,3725,4185,17418,3193,7000,6076,5925,22194
85,Burkina Faso,2022,BFA-22/BF_CBPF_RHPF/SA/S-W-FS/INGO/21860,10/19/2023 11:02:37 AM,Internally Displaced People,6864,7348,11393,12195,37800,4393,8400,13359,15019,41171
85,Burkina Faso,2022,BFA-22/BF_CBPF_RHPF/SA/S-W-FS/INGO/21860,10/19/2023 11:02:37 AM,Overall,6864,7348,11393,12195,37800,4393,8400,13359,15019,41171
85,Burkina Faso,2022,BFA-22/BF_CBPF_RHPF/SA/S-W-FS-LTB/INGO/21765,8/18/2023 10:57:09 AM,Host Communities,754,564,517,543,2378,264,34,0,0,298
85,Burkina Faso,2022,BFA-22/BF_CBPF_RHPF/SA/S-W-FS-LTB/INGO/21765,8/18/2023 10:57:09 AM,Internally Displaced People,3056,2935,2675,3481,12147,1191,1306,1890,1986,6373
85,Burkina Faso,2022,BFA-22/BF_CBPF_RHPF/SA/S-W-FS-LTB/INGO/21765,8/18/2023 10:57:09 AM,Overall,3810,3499,3192,4024,14525,1455,1340,1890,1986,6671
85,Burkina Faso,2022,BFA-22/BF_CBPF_RHPF/SA/W-FS/INGO/21824,8/28/2023 9:44:26 AM,Host Communities,1194,1371,1767,1631,5963,2392,4217,979,1121,8709
85,Burkina Faso,2022,BFA-22/BF_CBPF_RHPF/SA/W-FS/INGO/21824,8/28/2023 9:44:26 AM,Internally Displaced People,1673,2045,2900,2677,9295,4511,9065,1847,2431,17854
85,Burkina Faso,2022,BFA-22/BF_CBPF_RHPF/SA/W-FS/INGO/21824,8/28/2023 9:44:26 AM,Overall,2867,3416,4667,4308,15258,6903,13282,2826,3552,26563
85,Burkina Faso,2022,BFA-22/BF_CBPF_RHPF/SA/W-GBV/INGO/21674,9/19/2023 3:54:42 PM,Host Communities,639,1097,1236,1602,4574,4317,6691,3953,5169,20130
85,Burkina Faso,2022,BFA-22/BF_CBPF_RHPF/SA/W-GBV/INGO/21674,9/19/2023 3:54:42 PM,Internally Displaced People,1017,1729,1944,2521,7211,6840,12861,7504,9746,36951
85,Burkina Faso,2022,BFA-22/BF_CBPF_RHPF/SA/W-GBV/INGO/21674,9/19/2023 3:54:42 PM,Other,184,314,353,456,1307,57,98,110,142,407
85,Burkina Faso,2022,BFA-22/BF_CBPF_RHPF/SA/W-GBV/INGO/21674,9/19/2023 3:54:42 PM,Overall,1840,3140,3533,4579,13092,11214,19650,11567,15057,57488
85,Burkina Faso,2022,BFA-22/BF_CBPF_RHPF/SA/W-NUT/INGO/21753,8/28/2023 10:16:58 AM,Host Communities,22000,31404,26748,29986,110138,1013,14870,1518,1626,19027
85,Burkina Faso,2022,BFA-22/BF_CBPF_RHPF/SA/W-NUT/INGO/21753,8/28/2023 10:16:58 AM,Internally Displaced People,692,2905,1598,1598,6793,47473,54332,269,273,102347
85,Burkina Faso,2022,BFA-22/BF_CBPF_RHPF/SA/W-NUT/INGO/21753,8/28/2023 10:16:58 AM,Overall,22692,34309,28346,31584,116931,48486,69202,1787,1899,121374
85,Burkina Faso,2022,BFA-22/BF_CBPF_RHPF/SA/W-NUT/INGO/21773,10/18/2023 12:35:35 PM,Host Communities,940,1021,1411,1532,4904,285,470,1898,2047,4700
85,Burkina Faso,2022,BFA-22/BF_CBPF_RHPF/SA/W-NUT/INGO/21773,10/18/2023 12:35:35 PM,Internally Displaced People,1275,1427,1776,2144,6622,269,508,2941,3088,6806
85,Burkina Faso,2022,BFA-22/BF_CBPF_RHPF/SA/W-NUT/INGO/21773,10/18/2023 12:35:35 PM,Overall,2215,2448,3187,3676,11526,554,978,4839,5135,11506
85,Burkina Faso,2022,BFA-22/BF_CBPF_RHPF/SA/W-NUT/NGO/21852,9/12/2023 10:45:01 AM,Host Communities,2304,2816,4041,4379,13540,2463,4242,2808,4027,13540
85,Burkina Faso,2022,BFA-22/BF_CBPF_RHPF/SA/W-NUT/NGO/21852,9/12/2023 10:45:01 AM,Internally Displaced People,4896,5984,7959,8621,27460,5619,7577,6282,7982,27460
85,Burkina Faso,2022,BFA-22/BF_CBPF_RHPF/SA/W-NUT/NGO/21852,9/12/2023 10:45:01 AM,Overall,7200,8800,12000,13000,41000,8082,11819,9090,12009,41000
18,CAR,2020,CAR-20/HCF10/RA1/LOG/UN/15110,6/5/2020 8:43:58 AM,Other,0,0,0,8,8,0,0,0,6,6
18,CAR,2020,CAR-20/HCF10/RA1/LOG/UN/15110,6/5/2020 8:43:58 AM,Overall,0,0,0,8,8,0,0,0,6,6
18,CAR,2020,CAR-20/HCF10/RA1/NFI-CCCM/INGO/15109,11/3/2020 10:26:19 AM,Host Communities,3000,3000,0,0,6000,635,387,0,0,1022
18,CAR,2020,CAR-20/HCF10/RA1/NFI-CCCM/INGO/15109,11/3/2020 10:26:19 AM,Internally Displaced People,9000,9000,0,0,18000,5544,5578,0,0,11122
18,CAR,2020,CAR-20/HCF10/RA1/NFI-CCCM/INGO/15109,11/3/2020 10:26:19 AM,Overall,12000,12000,0,0,24000,6179,5965,0,0,12144
18,CAR,2020,CAR-20/HCF10/RA2/CCCM-NFI/INGO/15816,2/11/2021 11:07:18 AM,Internally Displaced People,13297,16776,25698,26254,82025,10572,11803,21252,20986,64613
18,CAR,2020,CAR-20/HCF10/RA2/CCCM-NFI/INGO/15816,2/11/2021 11:07:18 AM,Overall,13297,16776,25698,26254,82025,10572,11803,21252,20986,64613
18,CAR,2020,CAR-20/HCF10/RA2/CCCM-NFI/UN/15944,4/2/2021 8:06:48 AM,Host Communities,1250,2000,750,1000,5000,1600,2200,900,1300,6000
18,CAR,2020,CAR-20/HCF10/RA2/CCCM-NFI/UN/15944,4/2/2021 8:06:48 AM,Internally Displaced People,5000,8000,3000,4000,20000,5500,8500,3200,4000,21200
18,CAR,2020,CAR-20/HCF10/RA2/CCCM-NFI/UN/15944,4/2/2021 8:06:48 AM,Overall,6250,10000,3750,5000,25000,7100,10700,4100,5300,27200
18,CAR,2020,CAR-20/HCF10/RA2/FSEC/INGO/15782,12/15/2020 11:00:55 AM,Host Communities,571,577,341,379,1868,571,577,341,379,1868
18,CAR,2020,CAR-20/HCF10/RA2/FSEC/INGO/15782,12/15/2020 11:00:55 AM,Internally Displaced People,1247,1247,785,787,4066,1247,1247,785,787,4066
18,CAR,2020,CAR-20/HCF10/RA2/FSEC/INGO/15782,12/15/2020 11:00:55 AM,Overall,3065,3071,1911,1953,10000,3065,3071,1911,1953,10000
18,CAR,2020,CAR-20/HCF10/RA2/FSEC/INGO/15782,12/15/2020 11:00:55 AM,Returnees,1247,1247,785,787,4066,1247,1247,785,787,4066
18,CAR,2020,CAR-20/HCF10/RA2/FSEC/NGO/15786,1/11/2021 12:45:13 PM,Host Communities,140,270,0,0,410,137,273,0,0,410
18,CAR,2020,CAR-20/HCF10/RA2/FSEC/NGO/15786,1/11/2021 12:45:13 PM,Internally Displaced People,220,240,0,0,460,207,253,0,0,460
18,CAR,2020,CAR-20/HCF10/RA2/FSEC/NGO/15786,1/11/2021 12:45:13 PM,Overall,650,850,0,0,1500,589,911,0,0,1500
18,CAR,2020,CAR-20/HCF10/RA2/FSEC/NGO/15786,1/11/2021 12:45:13 PM,Refugees,40,80,0,0,120,37,83,0,0,120
18,CAR,2020,CAR-20/HCF10/RA2/FSEC/NGO/15786,1/11/2021 12:45:13 PM,Returnees,250,260,0,0,510,208,302,0,0,510
18,CAR,2020,CAR-20/HCF10/RA2/HLT/INGO/15923,3/12/2021 10:50:40 AM,Host Communities,79461,82704,72617,75581,310363,69161,71983,74925,77982,294051
18,CAR,2020,CAR-20/HCF10/RA2/HLT/INGO/15923,3/12/2021 10:50:40 AM,Internally Displaced People,2121,2207,1938,2017,8283,1843,1917,1997,2077,7834
18,CAR,2020,CAR-20/HCF10/RA2/HLT/INGO/15923,3/12/2021 10:50:40 AM,Other,1106,1151,1010,1052,4319,963,1005,1045,1087,4100
18,CAR,2020,CAR-20/HCF10/RA2/HLT/INGO/15923,3/12/2021 10:50:40 AM,Overall,82688,86062,75565,78650,322965,71967,74905,77967,81146,305985
18,CAR,2020,CAR-20/HCF10/RA2/HLT-NUT/INGO/15802,4/2/2021 8:39:35 AM,Other,58958,73294,10248,10299,152799,58931,96517,16112,14489,186049
18,CAR,2020,CAR-20/HCF10/RA2/HLT-NUT/INGO/15802,4/2/2021 8:39:35 AM,Overall,58958,73294,10248,10299,152799,58931,96517,16112,14489,186049
18,CAR,2020,CAR-20/HCF10/RA2/HLT-NUT/INGO/15834,1/12/2021 10:52:33 AM,Host Communities,6636,7043,5461,5342,24482,3645,6350,4122,4451,18568
18,CAR,2020,CAR-20/HCF10/RA2/HLT-NUT/INGO/15834,1/12/2021 10:52:33 AM,Internally Displaced People,1301,867,201,187,2556,1822,2715,2062,2226,8825
18,CAR,2020,CAR-20/HCF10/RA2/HLT-NUT/INGO/15834,1/12/2021 10:52:33 AM,Other,133,46,0,0,179,124,185,140,152,601
18,CAR,2020,CAR-20/HCF10/RA2/HLT-NUT/INGO/15834,1/12/2021 10:52:33 AM,Overall,9525,9577,6415,6227,31744,6708,10914,7587,8194,33403
18,CAR,2020,CAR-20/HCF10/RA2/HLT-NUT/INGO/15834,1/12/2021 10:52:33 AM,Returnees,1455,1621,753,698,4527,1117,1664,1263,1365,5409
18,CAR,2020,CAR-20/HCF10/RA2/HLT-NUT/INGO/15941,3/5/2021 8:09:23 AM,Host Communities,440,440,441,440,1761,773,774,774,774,3095
18,CAR,2020,CAR-20/HCF10/RA2/HLT-NUT/INGO/15941,3/5/2021 8:09:23 AM,Internally Displaced People,1284,1284,1284,1285,5137,602,602,601,602,2407
18,CAR,2020,CAR-20/HCF10/RA2/HLT-NUT/INGO/15941,3/5/2021 8:09:23 AM,Other,293,293,294,294,1174,137,137,138,138,550
18,CAR,2020,CAR-20/HCF10/RA2/HLT-NUT/INGO/15941,3/5/2021 8:09:23 AM,Overall,3668,3668,3671,3671,14678,1718,1719,1719,1721,6877
18,CAR,2020,CAR-20/HCF10/RA2/HLT-NUT/INGO/15941,3/5/2021 8:09:23 AM,Returnees,1651,1651,1652,1652,6606,206,206,206,207,825
18,CAR,2020,CAR-20/HCF10/RA2/HLT-NUT-WaSH/INGO/15807,2/18/2021 8:35:00 AM,Host Communities,37190,41863,8215,8554,95822,37190,41863,8215,8554,95822
18,CAR,2020,CAR-20/HCF10/RA2/HLT-NUT-WaSH/INGO/15807,2/18/2021 8:35:00 AM,Internally Displaced People,8397,9459,1856,1933,21645,8397,9459,1856,1933,21645
18,CAR,2020,CAR-20/HCF10/RA2/HLT-NUT-WaSH/INGO/15807,2/18/2021 8:35:00 AM,Overall,45587,51322,10071,10487,117467,45587,51322,10071,10487,117467
18,CAR,2020,CAR-20/HCF10/RA2/HLT-NUT-WaSH/INGO/15825,12/28/2020 9:35:59 AM,Host Communities,11904,12894,4241,4596,33635,6567,7966,2503,2811,19847
18,CAR,2020,CAR-20/HCF10/RA2/HLT-NUT-WaSH/INGO/15825,12/28/2020 9:35:59 AM,Internally Displaced People,4589,4973,1327,1437,12326,2003,2115,751,849,5718
18,CAR,2020,CAR-20/HCF10/RA2/HLT-NUT-WaSH/INGO/15825,12/28/2020 9:35:59 AM,Overall,16493,17867,5568,6033,45961,8570,10081,3254,3660,25565
18,CAR,2020,CAR-20/HCF10/RA2/HLT-NUT-WaSH/NGO/15812,2/23/2021 10:47:50 AM,Host Communities,2460,15970,7653,10858,36941,1490,17020,9453,10842,38805
18,CAR,2020,CAR-20/HCF10/RA2/HLT-NUT-WaSH/NGO/15812,2/23/2021 10:47:50 AM,Internally Displaced People,405,700,150,200,1455,1003,820,420,340,2583
18,CAR,2020,CAR-20/HCF10/RA2/HLT-NUT-WaSH/NGO/15812,2/23/2021 10:47:50 AM,Overall,2865,16670,7803,11058,38396,2493,17840,9873,11182,41388
18,CAR,2020,CAR-20/HCF10/RA2/HLT-WaSH/INGO/15893,1/18/2021 9:23:19 AM,Other,50,0,0,0,50,76,0,0,0,76
18,CAR,2020,CAR-20/HCF10/RA2/HLT-WaSH/INGO/15893,1/18/2021 9:23:19 AM,Overall,50,0,0,0,50,76,0,0,0,76
18,CAR,2020,CAR-20/HCF10/RA2/LOG/INGO/15910,2/22/2021 11:07:47 AM,Other,0,14,0,0,14,0,20,0,0,20
18,CAR,2020,CAR-20/HCF10/RA2/LOG/INGO/15910,2/22/2021 11:07:47 AM,Overall,0,14,0,0,14,0,20,0,0,20
18,CAR,2020,CAR-20/HCF10/RA2/LOG/UN/15794,11/30/2020 3:47:36 PM,Other,0,0,0,20,20,0,0,0,20,20
18,CAR,2020,CAR-20/HCF10/RA2/LOG/UN/15794,11/30/2020 3:47:36 PM,Overall,0,0,0,20,20,0,0,0,20,20
18,CAR,2020,CAR-20/HCF10/RA2/LOG-FSEC-NFI/INGO/15776,2/5/2021 9:45:54 AM,Host Communities,531,588,483,504,2106,1423,1482,0,0,2905
18,CAR,2020,CAR-20/HCF10/RA2/LOG-FSEC-NFI/INGO/15776,2/5/2021 9:45:54 AM,Internally Displaced People,750,840,690,720,3000,1225,1275,0,0,2500
18,CAR,2020,CAR-20/HCF10/RA2/LOG-FSEC-NFI/INGO/15776,2/5/2021 9:45:54 AM,Overall,1806,2016,1656,1728,7206,2940,3060,0,0,6000
18,CAR,2020,CAR-20/HCF10/RA2/LOG-FSEC-NFI/INGO/15776,2/5/2021 9:45:54 AM,Returnees,525,588,483,504,2100,292,303,0,0,595
18,CAR,2020,CAR-20/HCF10/RA2/NFI-CCCM-PROT/INGO/15832,5/31/2021 3:49:23 PM,Host Communities,17,18,3636,4172,7843,43,42,1934,2196,4215
18,CAR,2020,CAR-20/HCF10/RA2/NFI-CCCM-PROT/INGO/15832,5/31/2021 3:49:23 PM,Internally Displaced People,2230,2497,2541,2765,10033,2786,3365,9037,8779,23967
18,CAR,2020,CAR-20/HCF10/RA2/NFI-CCCM-PROT/INGO/15832,5/31/2021 3:49:23 PM,Overall,2247,2515,6177,6937,17876,2829,3407,10971,10975,28182
18,CAR,2020,CAR-20/HCF10/RA2/NUT/INGO/15820,8/16/2021 9:36:51 AM,Host Communities,4611,5723,1576,2671,14581,7011,7973,1576,2671,19231
18,CAR,2020,CAR-20/HCF10/RA2/NUT/INGO/15820,8/16/2021 9:36:51 AM,Internally Displaced People,2070,2999,1397,1679,8145,2070,2999,1397,1679,8145
18,CAR,2020,CAR-20/HCF10/RA2/NUT/INGO/15820,8/16/2021 9:36:51 AM,Overall,6681,8722,2973,4350,22726,9081,10972,2973,4350,27376
18,CAR,2020,CAR-20/HCF10/RA2/NUT-WaSH-HLT/INGO/15804,12/16/2020 10:06:46 AM,Host Communities,15831,17141,3216,3628,39816,13333,13628,3753,4858,35572
18,CAR,2020,CAR-20/HCF10/RA2/NUT-WaSH-HLT/INGO/15804,12/16/2020 10:06:46 AM,Internally Displaced People,2443,2643,494,557,6137,2537,2912,653,678,6780
18,CAR,2020,CAR-20/HCF10/RA2/NUT-WaSH-HLT/INGO/15804,12/16/2020 10:06:46 AM,Overall,18274,19784,3710,4185,45953,15870,16540,4406,5536,42352
18,CAR,2020,CAR-20/HCF10/RA2/PROT/INGO/15801,1/25/2021 8:20:58 AM,Other,152,203,455,465,1275,84,121,628,444,1277
18,CAR,2020,CAR-20/HCF10/RA2/PROT/INGO/15801,1/25/2021 8:20:58 AM,Overall,152,203,455,465,1275,84,121,628,444,1277
18,CAR,2020,CAR-20/HCF10/RA2/PROT/INGO/15819,2/24/2021 9:10:28 AM,Host Communities,1912,1915,609,615,5051,1664,1352,475,565,4056
18,CAR,2020,CAR-20/HCF10/RA2/PROT/INGO/15819,2/24/2021 9:10:28 AM,Internally Displaced People,1912,1915,609,615,5051,1872,1521,535,637,4565
18,CAR,2020,CAR-20/HCF10/RA2/PROT/INGO/15819,2/24/2021 9:10:28 AM,Overall,6373,6383,2030,2050,16836,4160,3380,1189,1415,10144
18,CAR,2020,CAR-20/HCF10/RA2/PROT/INGO/15819,2/24/2021 9:10:28 AM,Returnees,2549,2553,812,820,6734,624,507,179,213,1523
18,CAR,2020,CAR-20/HCF10/RA2/PROT/NGO/15833,1/7/2021 9:00:15 AM,Host Communities,1900,2100,4700,3300,12000,1620,2132,4639,3670,12061
18,CAR,2020,CAR-20/HCF10/RA2/PROT/NGO/15833,1/7/2021 9:00:15 AM,Overall,1900,2100,4700,3300,12000,1620,2132,4639,3670,12061
18,CAR,2020,CAR-20/HCF10/RA2/PROT-HLT/INGO/15790,2/2/2021 8:52:38 AM,Host Communities,1735,2065,2603,3097,9500,2996,3781,6732,2475,15984
18,CAR,2020,CAR-20/HCF10/RA2/PROT-HLT/INGO/15790,2/2/2021 8:52:38 AM,Internally Displaced People,450,550,675,825,2500,824,1191,616,769,3400
18,CAR,2020,CAR-20/HCF10/RA2/PROT-HLT/INGO/15790,2/2/2021 8:52:38 AM,Overall,2750,3250,4125,4875,15000,3967,5163,7487,3524,20141
18,CAR,2020,CAR-20/HCF10/RA2/PROT-HLT/INGO/15790,2/2/2021 8:52:38 AM,Returnees,565,635,847,953,3000,147,191,139,280,757
18,CAR,2020,CAR-20/HCF10/RA2/WaSH/INGO/15783,12/9/2020 9:21:35 AM,Host Communities,2261,2918,3526,3475,12180,563,541,275,273,1652
18,CAR,2020,CAR-20/HCF10/RA2/WaSH/INGO/15783,12/9/2020 9:21:35 AM,Internally Displaced People,4235,5464,6602,6507,22808,4029,5089,6149,5938,21205
18,CAR,2020,CAR-20/HCF10/RA2/WaSH/INGO/15783,12/9/2020 9:21:35 AM,Overall,6496,8382,10128,9982,34988,4592,5630,6424,6211,22857
18,CAR,2020,CAR-20/HCF10/RA2/WaSH/INGO/15805,1/8/2021 11:58:17 AM,Internally Displaced People,2231,2726,3346,4089,12392,2251,2746,3366,4109,12472
18,CAR,2020,CAR-20/HCF10/RA2/WaSH/INGO/15805,1/8/2021 11:58:17 AM,Overall,2231,2726,3346,4089,12392,2251,2746,3366,4109,12472
18,CAR,2020,CAR-20/HCF10/RA2/WaSH/INGO/15843,4/2/2021 12:03:51 PM,Host Communities,18650,18650,12191,12200,61691,13800,15470,15066,15580,59916
18,CAR,2020,CAR-20/HCF10/RA2/WaSH/INGO/15843,4/2/2021 12:03:51 PM,Internally Displaced People,4200,4200,2800,2800,14000,3890,4535,4335,5270,18030
18,CAR,2020,CAR-20/HCF10/RA2/WaSH/INGO/15843,4/2/2021 12:03:51 PM,Overall,26210,26210,17231,17240,86891,20950,24565,23991,26050,95556
18,CAR,2020,CAR-20/HCF10/RA2/WaSH/INGO/15843,4/2/2021 12:03:51 PM,Returnees,3360,3360,2240,2240,11200,3260,4560,4590,5200,17610
18,CAR,2020,CAR-20/HCF10/RA2/WaSH/INGO/15927,1/7/2021 3:20:45 PM,Host Communities,934,893,1178,1056,4061,1639,1567,2066,1853,7125
18,CAR,2020,CAR-20/HCF10/RA2/WaSH/INGO/15927,1/7/2021 3:20:45 PM,Internally Displaced People,6091,5826,7680,6885,26482,4454,4260,5615,5035,19364
18,CAR,2020,CAR-20/HCF10/RA2/WaSH/INGO/15927,1/7/2021 3:20:45 PM,Overall,9521,9106,12004,10762,41393,8589,8214,10827,9709,37339
18,CAR,2020,CAR-20/HCF10/RA2/WaSH/INGO/15927,1/7/2021 3:20:45 PM,Returnees,2496,2387,3146,2821,10850,2496,2387,3146,2821,10850
18,CAR,2020,CAR-20/HCF10/RA2/WaSH/NGO/15898,1/18/2021 9:47:49 AM,Host Communities,3500,5000,1500,2000,12000,2000,5000,1150,2005,10155
18,CAR,2020,CAR-20/HCF10/RA2/WaSH/NGO/15898,1/18/2021 9:47:49 AM,Internally Displaced People,12000,20000,6000,10000,48000,9000,26000,8000,12010,55010
18,CAR,2020,CAR-20/HCF10/RA2/WaSH/NGO/15898,1/18/2021 9:47:49 AM,Overall,15500,25000,7500,12000,60000,11000,31000,9150,14015,65165
18,CAR,2020,CAR-20/HCF10/RA2/WaSH-HLT/INGO/15824,1/22/2021 8:41:24 AM,Host Communities,1250,1355,262,283,3150,1240,1351,262,283,3136
18,CAR,2020,CAR-20/HCF10/RA2/WaSH-HLT/INGO/15824,1/22/2021 8:41:24 AM,Internally Displaced People,179,193,37,41,450,181,196,48,54,479
18,CAR,2020,CAR-20/HCF10/RA2/WaSH-HLT/INGO/15824,1/22/2021 8:41:24 AM,Overall,1429,1548,299,324,3600,1421,1547,310,337,3615
18,CAR,2020,CAR-20/HCF10/RA2/WaSH-HLT/INGO/15836,11/13/2020 11:31:48 AM,Host Communities,5611,6079,1174,1272,14136,49670,48946,38117,36150,172883
18,CAR,2020,CAR-20/HCF10/RA2/WaSH-HLT/INGO/15836,11/13/2020 11:31:48 AM,Internally Displaced People,842,911,176,191,2120,8765,8638,6726,6380,30509
18,CAR,2020,CAR-20/HCF10/RA2/WaSH-HLT/INGO/15836,11/13/2020 11:31:48 AM,Overall,6453,6990,1350,1463,16256,58435,57584,44843,42530,203392
18,CAR,2020,CAR-20/HCF10/RA2/WaSH-HLT-NUT/INGO/15818,2/11/2021 1:49:29 PM,Host Communities,1106,1160,226,236,2728,1106,1160,226,236,2728
18,CAR,2020,CAR-20/HCF10/RA2/WaSH-HLT-NUT/INGO/15818,2/11/2021 1:49:29 PM,Internally Displaced People,4799,4995,980,1024,11798,4799,4995,980,1024,11798
18,CAR,2020,CAR-20/HCF10/RA2/WaSH-HLT-NUT/INGO/15818,2/11/2021 1:49:29 PM,Other,691,720,141,148,1700,691,720,141,148,1700
18,CAR,2020,CAR-20/HCF10/RA2/WaSH-HLT-NUT/INGO/15818,2/11/2021 1:49:29 PM,Overall,10056,10484,2057,2147,24744,10056,10484,2057,2147,24744
18,CAR,2020,CAR-20/HCF10/RA2/WaSH-HLT-NUT/INGO/15818,2/11/2021 1:49:29 PM,Returnees,3460,3609,710,739,8518,3460,3609,710,739,8518
18,CAR,2020,CAR-20/HCF10/RA2/WaSH-NFI-PROT/NGO/15928,5/19/2021 8:24:09 AM,Host Communities,345,402,742,811,2300,338,400,687,759,2184
18,CAR,2020,CAR-20/HCF10/RA2/WaSH-NFI-PROT/NGO/15928,5/19/2021 8:24:09 AM,Internally Displaced People,5357,6197,11491,12509,35554,4420,5983,11806,21550,43759
18,CAR,2020,CAR-20/HCF10/RA2/WaSH-NFI-PROT/NGO/15928,5/19/2021 8:24:09 AM,Overall,5852,6774,12555,13673,38854,4920,6542,12812,22599,46873
18,CAR,2020,CAR-20/HCF10/RA2/WaSH-NFI-PROT/NGO/15928,5/19/2021 8:24:09 AM,Returnees,150,175,322,353,1000,162,159,319,290,930
18,CAR,2020,CAR-20/HCF10/RA2/WaSH-PROT/INGO/15800,5/11/2021 3:15:51 PM,Host Communities,923,961,1415,1382,4681,1739,1757,692,1095,5283
18,CAR,2020,CAR-20/HCF10/RA2/WaSH-PROT/INGO/15800,5/11/2021 3:15:51 PM,Internally Displaced People,1824,1904,2775,2737,9240,1373,1600,447,638,4058
18,CAR,2020,CAR-20/HCF10/RA2/WaSH-PROT/INGO/15800,5/11/2021 3:15:51 PM,Overall,3433,3581,5237,5149,17400,5170,6215,2908,3873,18166
18,CAR,2020,CAR-20/HCF10/RA2/WaSH-PROT/INGO/15800,5/11/2021 3:15:51 PM,Returnees,686,716,1047,1030,3479,2058,2858,1769,2140,8825
18,CAR,2020,CAR-20/HCF10/RA2/WaSH-PROT/INGO/15806,2/24/2021 8:57:07 AM,Internally Displaced People,27815,30134,18544,20090,96583,27837,30156,18566,20112,96671
18,CAR,2020,CAR-20/HCF10/RA2/WaSH-PROT/INGO/15806,2/24/2021 8:57:07 AM,Overall,28557,30937,19038,20626,99158,28601,30981,19082,20670,99334
18,CAR,2020,CAR-20/HCF10/RA2/WaSH-PROT/INGO/15806,2/24/2021 8:57:07 AM,Returnees,742,803,494,536,2575,764,825,516,558,2663
18,CAR,2020,CAR-20/HCF10/RA3/CCCM-NFI/INGO/16759,3/24/2021 2:31:59 PM,Internally Displaced People,10583,12178,18928,19409,61098,9074,10249,15108,15347,49778
18,CAR,2020,CAR-20/HCF10/RA3/CCCM-NFI/INGO/16759,3/24/2021 2:31:59 PM,Overall,10583,12178,18928,19409,61098,9074,10249,15108,15347,49778
18,CAR,2020,CAR-20/HCF10/RA3/COORD/INGO/16688,3/1/2021 7:35:16 AM,Other,50,0,0,0,50,76,0,0,0,76
18,CAR,2020,CAR-20/HCF10/RA3/COORD/INGO/16688,3/1/2021 7:35:16 AM,Overall,50,0,0,0,50,76,0,0,0,76
18,CAR,2020,CAR-20/HCF10/RA3/COORD/INGO/16721,7/26/2021 1:35:22 PM,Other,120,0,0,0,120,120,0,0,0,120
18,CAR,2020,CAR-20/HCF10/RA3/COORD/INGO/16721,7/26/2021 1:35:22 PM,Overall,120,0,0,0,120,120,0,0,0,120
18,CAR,2020,CAR-20/HCF10/RA3/COORD/INGO/16753,8/16/2021 9:18:01 AM,Other,135,90,0,0,225,98,74,0,0,172
18,CAR,2020,CAR-20/HCF10/RA3/COORD/INGO/16753,8/16/2021 9:18:01 AM,Overall,135,90,0,0,225,98,74,0,0,172
18,CAR,2020,CAR-20/HCF10/RA3/COORD/INGO/16758,5/4/2021 1:31:46 PM,Other,4,4,4,4,16,4,4,4,4,16
18,CAR,2020,CAR-20/HCF10/RA3/COORD/INGO/16758,5/4/2021 1:31:46 PM,Overall,4,4,4,4,16,4,4,4,4,16
18,CAR,2020,CAR-20/HCF10/RA3/COORD/INGO/16761,3/10/2021 10:42:03 AM,Host Communities,70,0,0,0,70,131,0,0,0,131
18,CAR,2020,CAR-20/HCF10/RA3/COORD/INGO/16761,3/10/2021 10:42:03 AM,Overall,70,0,0,0,70,131,0,0,0,131
18,CAR,2020,CAR-20/HCF10/RA3/EDU/INGO/16740,4/2/2021 7:46:50 AM,Internally Displaced People,0,0,1233,1306,2539,0,0,1233,1306,2539
18,CAR,2020,CAR-20/HCF10/RA3/EDU/INGO/16740,4/2/2021 7:46:50 AM,Other,6,7,0,0,13,6,7,0,0,13
18,CAR,2020,CAR-20/HCF10/RA3/EDU/INGO/16740,4/2/2021 7:46:50 AM,Overall,6,7,1233,1306,2552,6,7,1233,1306,2552
18,CAR,2020,CAR-20/HCF10/RA3/FSEC/INGO/16686,12/15/2020 11:25:13 AM,Host Communities,2340,2360,1541,1554,7795,3761,3793,2476,2496,12526
18,CAR,2020,CAR-20/HCF10/RA3/FSEC/INGO/16686,12/15/2020 11:25:13 AM,Overall,2340,2360,1541,1554,7795,3761,3793,2476,2496,12526
18,CAR,2020,CAR-20/HCF10/RA3/FSEC/INGO/16741,2/1/2021 1:53:25 PM,Internally Displaced People,764,1530,1530,2294,6118,1461,1913,2833,2994,9201
18,CAR,2020,CAR-20/HCF10/RA3/FSEC/INGO/16741,2/1/2021 1:53:25 PM,Overall,764,1530,1530,2294,6118,1461,1913,2833,2994,9201
18,CAR,2020,CAR-20/HCF10/RA3/FSEC/NGO/16712,4/14/2021 12:39:40 PM,Host Communities,501,504,500,505,2010,501,504,500,505,2010
18,CAR,2020,CAR-20/HCF10/RA3/FSEC/NGO/16712,4/14/2021 12:39:40 PM,Internally Displaced People,420,450,441,589,1900,420,450,441,589,1900
18,CAR,2020,CAR-20/HCF10/RA3/FSEC/NGO/16712,4/14/2021 12:39:40 PM,Other,550,587,601,612,2350,550,587,601,612,2350
18,CAR,2020,CAR-20/HCF10/RA3/FSEC/NGO/16712,4/14/2021 12:39:40 PM,Overall,1761,1851,1855,2033,7500,1761,1851,1855,2033,7500
18,CAR,2020,CAR-20/HCF10/RA3/FSEC/NGO/16712,4/14/2021 12:39:40 PM,Returnees,290,310,313,327,1240,290,310,313,327,1240
18,CAR,2020,CAR-20/HCF10/RA3/FSEC/UN/16714,4/6/2021 8:10:05 AM,Host Communities,3645,3793,5467,5690,18595,4331,4507,6496,6761,22095
18,CAR,2020,CAR-20/HCF10/RA3/FSEC/UN/16714,4/6/2021 8:10:05 AM,Internally Displaced People,1041,1084,1562,1626,5313,1237,1288,1856,1932,6313
18,CAR,2020,CAR-20/HCF10/RA3/FSEC/UN/16714,4/6/2021 8:10:05 AM,Overall,5207,5419,7810,8129,26565,6285,6541,9427,9812,32065
18,CAR,2020,CAR-20/HCF10/RA3/FSEC/UN/16714,4/6/2021 8:10:05 AM,Returnees,521,542,781,813,2657,717,746,1075,1119,3657
18,CAR,2020,CAR-20/HCF10/RA3/LOG/UN/16681,2/23/2021 2:25:44 PM,Other,50,50,50,23,173,50,50,50,23,173
18,CAR,2020,CAR-20/HCF10/RA3/LOG/UN/16681,2/23/2021 2:25:44 PM,Overall,50,50,50,23,173,50,50,50,23,173
18,CAR,2020,CAR-20/HCF10/RA3/NFI/UN/16693,3/25/2021 9:30:51 AM,Host Communities,500,500,500,500,2000,600,610,650,650,2510
18,CAR,2020,CAR-20/HCF10/RA3/NFI/UN/16693,3/25/2021 9:30:51 AM,Internally Displaced People,5000,5000,3000,3000,16000,5400,5500,3100,3200,17200
18,CAR,2020,CAR-20/HCF10/RA3/NFI/UN/16693,3/25/2021 9:30:51 AM,Overall,5500,5500,3500,3500,18000,6000,6110,3750,3850,19710
18,CAR,2020,CAR-20/HCF10/RA3/NFI/UN/16749,12/3/2021 9:29:18 AM,Internally Displaced People,9554,11156,16215,16803,53728,3253,3974,5080,4832,17139
18,CAR,2020,CAR-20/HCF10/RA3/NFI/UN/16749,12/3/2021 9:29:18 AM,Overall,9554,11156,16215,16803,53728,3253,3974,5080,4832,17139
18,CAR,2020,CAR-20/HCF10/RA3/NFI-CCCM-PROT/INGO/16699,7/8/2021 1:20:43 PM,Host Communities,2275,2548,2093,2184,9100,705,757,1817,1704,4983
18,CAR,2020,CAR-20/HCF10/RA3/NFI-CCCM-PROT/INGO/16699,7/8/2021 1:20:43 PM,Internally Displaced People,5906,6614,5433,5669,23622,4532,5188,5501,5430,20651
18,CAR,2020,CAR-20/HCF10/RA3/NFI-CCCM-PROT/INGO/16699,7/8/2021 1:20:43 PM,Overall,8181,9162,7526,7853,32722,5237,5945,7318,7134,25634
18,CAR,2020,CAR-20/HCF10/RA3/NFI-FSEC/INGO/16744,4/6/2021 2:30:34 PM,Host Communities,1438,1438,1437,1437,5750,2493,3842,0,0,6335
18,CAR,2020,CAR-20/HCF10/RA3/NFI-FSEC/INGO/16744,4/6/2021 2:30:34 PM,Internally Displaced People,1438,1438,1437,1437,5750,1540,2195,0,0,3735
18,CAR,2020,CAR-20/HCF10/RA3/NFI-FSEC/INGO/16744,4/6/2021 2:30:34 PM,Overall,4314,4314,4311,4311,17250,5695,11800,0,0,17495
18,CAR,2020,CAR-20/HCF10/RA3/NFI-FSEC/INGO/16744,4/6/2021 2:30:34 PM,Returnees,1438,1438,1437,1437,5750,1662,5763,0,0,7425
18,CAR,2020,CAR-20/HCF10/RA3/NFI-WaSH/INGO/16733,6/3/2021 9:54:28 AM,Host Communities,312,325,300,313,1250,312,325,300,313,1250
18,CAR,2020,CAR-20/HCF10/RA3/NFI-WaSH/INGO/16733,6/3/2021 9:54:28 AM,Internally Displaced People,468,488,450,469,1875,343,895,213,292,1743
18,CAR,2020,CAR-20/HCF10/RA3/NFI-WaSH/INGO/16733,6/3/2021 9:54:28 AM,Overall,780,813,750,782,3125,655,1220,513,605,2993
18,CAR,2020,CAR-20/HCF10/RA3/NUT/INGO/16697,3/31/2021 10:07:27 AM,Host Communities,26597,28812,5448,6143,67000,25345,28637,7276,7853,69111
18,CAR,2020,CAR-20/HCF10/RA3/NUT/INGO/16697,3/31/2021 10:07:27 AM,Overall,26597,28812,5448,6143,67000,25345,28637,7276,7853,69111
18,CAR,2020,CAR-20/HCF10/RA3/NUT/INGO/16703,3/26/2021 11:39:09 AM,Host Communities,7996,8663,1673,1812,20144,4412,4893,845,1002,11152
18,CAR,2020,CAR-20/HCF10/RA3/NUT/INGO/16703,3/26/2021 11:39:09 AM,Internally Displaced People,5128,5556,1073,1162,12919,2533,2766,683,715,6697
18,CAR,2020,CAR-20/HCF10/RA3/NUT/INGO/16703,3/26/2021 11:39:09 AM,Overall,13124,14219,2746,2974,33063,6945,7659,1528,1717,17849
18,CAR,2020,CAR-20/HCF10/RA3/NUT/INGO/16734,8/9/2021 9:06:53 AM,Host Communities,7581,8256,1668,1808,19313,7581,8256,1668,1808,19313
18,CAR,2020,CAR-20/HCF10/RA3/NUT/INGO/16734,8/9/2021 9:06:53 AM,Internally Displaced People,1379,1569,311,336,3595,1379,1569,311,336,3595
18,CAR,2020,CAR-20/HCF10/RA3/NUT/INGO/16734,8/9/2021 9:06:53 AM,Overall,8960,9825,1979,2144,22908,8960,9825,1979,2144,22908
18,CAR,2020,CAR-20/HCF10/RA3/NUT/UN/16728,3/3/2021 10:28:24 AM,Host Communities,0,0,1489,1612,3101,0,0,1433,1553,2986
18,CAR,2020,CAR-20/HCF10/RA3/NUT/UN/16728,3/3/2021 10:28:24 AM,Internally Displaced People,0,0,496,538,1034,0,0,478,518,996
18,CAR,2020,CAR-20/HCF10/RA3/NUT/UN/16728,3/3/2021 10:28:24 AM,Overall,0,0,1985,2150,4135,0,0,1911,2071,3982
18,CAR,2020,CAR-20/HCF10/RA3/PROT/INGO/16685,5/19/2021 2:41:46 PM,Host Communities,6237,2426,2498,1252,12413,20390,42606,9187,16962,89145
18,CAR,2020,CAR-20/HCF10/RA3/PROT/INGO/16685,5/19/2021 2:41:46 PM,Internally Displaced People,3119,1213,1249,626,6207,10196,21304,4594,8482,44576
18,CAR,2020,CAR-20/HCF10/RA3/PROT/INGO/16685,5/19/2021 2:41:46 PM,Overall,10396,4043,4163,2088,20690,34325,71722,15466,28554,150067
18,CAR,2020,CAR-20/HCF10/RA3/PROT/INGO/16685,5/19/2021 2:41:46 PM,Returnees,1040,404,416,210,2070,3739,7812,1685,3110,16346
18,CAR,2020,CAR-20/HCF10/RA3/PROT/NGO/16725,5/17/2021 8:58:27 AM,Host Communities,140,220,2642,3002,6004,141,228,2978,3221,6568
18,CAR,2020,CAR-20/HCF10/RA3/PROT/NGO/16725,5/17/2021 8:58:27 AM,Internally Displaced People,89,123,427,687,1326,70,125,555,660,1410
18,CAR,2020,CAR-20/HCF10/RA3/PROT/NGO/16725,5/17/2021 8:58:27 AM,Overall,357,567,3427,3938,8289,341,578,3895,4139,8953
18,CAR,2020,CAR-20/HCF10/RA3/PROT/NGO/16725,5/17/2021 8:58:27 AM,Returnees,128,224,358,249,959,130,225,362,258,975
18,CAR,2020,CAR-20/HCF10/RA3/PROT-WaSH-EDU/INGO/16711,7/13/2021 10:25:18 AM,Host Communities,19145,19926,12764,13284,65119,19188,20001,12799,13291,65279
18,CAR,2020,CAR-20/HCF10/RA3/PROT-WaSH-EDU/INGO/16711,7/13/2021 10:25:18 AM,Internally Displaced People,20118,20938,13412,13958,68426,20596,21021,14851,14242,70710
18,CAR,2020,CAR-20/HCF10/RA3/PROT-WaSH-EDU/INGO/16711,7/13/2021 10:25:18 AM,Overall,39263,40864,26176,27242,133545,39784,41022,27650,27533,135989
18,CAR,2020,CAR-20/HCF10/RA3/WaSH/INGO/16689,6/30/2021 8:15:43 AM,Internally Displaced People,3816,4921,6008,5920,20665,3824,4932,6021,5932,20709
18,CAR,2020,CAR-20/HCF10/RA3/WaSH/INGO/16689,6/30/2021 8:15:43 AM,Overall,3816,4921,6008,5920,20665,3824,4932,6021,5932,20709
18,CAR,2020,CAR-20/HCF10/RA3/WaSH/INGO/16731,4/12/2021 9:13:25 AM,Internally Displaced People,1334,1388,3020,2584,8326,2204,2294,2588,2693,9779
18,CAR,2020,CAR-20/HCF10/RA3/WaSH/INGO/16731,4/12/2021 9:13:25 AM,Overall,1334,1388,3020,2584,8326,2204,2294,2588,2693,9779
18,CAR,2020,CAR-20/HCF10/RA3/WaSH/NGO/16707,4/2/2021 12:19:41 PM,Host Communities,500,500,200,270,1470,300,550,100,120,1070
18,CAR,2020,CAR-20/HCF10/RA3/WaSH/NGO/16707,4/2/2021 12:19:41 PM,Internally Displaced People,7300,20350,8950,11930,48530,5680,22650,8800,11889,49019
18,CAR,2020,CAR-20/HCF10/RA3/WaSH/NGO/16707,4/2/2021 12:19:41 PM,Overall,7800,20850,9150,12200,50000,5980,23200,8900,12009,50089
18,CAR,2020,CAR-20/HCF10/RA3/WaSH-FSEC/INGO/16684,5/14/2021 9:39:04 AM,Host Communities,200,200,50,50,500,200,200,50,50,500
18,CAR,2020,CAR-20/HCF10/RA3/WaSH-FSEC/INGO/16684,5/14/2021 9:39:04 AM,Internally Displaced People,8779,9421,15950,15308,49458,8779,9421,17683,18149,54032
18,CAR,2020,CAR-20/HCF10/RA3/WaSH-FSEC/INGO/16684,5/14/2021 9:39:04 AM,Overall,9698,10356,17541,16863,54458,10024,10826,19506,20106,60462
18,CAR,2020,CAR-20/HCF10/RA3/WaSH-FSEC/INGO/16684,5/14/2021 9:39:04 AM,Returnees,719,735,1541,1505,4500,1045,1205,1773,1907,5930
18,CAR,2020,CAR-20/HCF10/RA3/WaSH-NFI/INGO/16720,6/3/2021 9:33:47 AM,Internally Displaced People,2303,2818,3528,4242,12891,2409,2909,3644,4356,13318
18,CAR,2020,CAR-20/HCF10/RA3/WaSH-NFI/INGO/16720,6/3/2021 9:33:47 AM,Overall,2303,2818,3528,4242,12891,2409,2909,3644,4356,13318
18,CAR,2020,CAR-20/HCF10/RA3/WaSH-NFI-PROT/NGO/16757,4/28/2021 1:32:44 PM,Internally Displaced People,4226,4889,9067,9871,28053,3861,4435,10095,10042,28433
18,CAR,2020,CAR-20/HCF10/RA3/WaSH-NFI-PROT/NGO/16757,4/28/2021 1:32:44 PM,Overall,4226,4889,9067,9871,28053,3861,4435,10095,10042,28433
18,CAR,2020,CAR-20/HCF10/RA4/ETC/UN/17206,6/3/2021 10:11:05 AM,Internally Displaced People,500,1000,0,0,1500,0,0,0,0,0
18,CAR,2020,CAR-20/HCF10/RA4/ETC/UN/17206,6/3/2021 10:11:05 AM,Other,500,200,0,0,700,548,141,0,0,689
18,CAR,2020,CAR-20/HCF10/RA4/ETC/UN/17206,6/3/2021 10:11:05 AM,Overall,1000,1200,0,0,2200,548,141,0,0,689
18,CAR,2020,CAR-20/HCF10/SA1/CCCM-NFI/INGO/17699,9/3/2021 11:12:31 AM,Internally Displaced People,2364,2329,1220,1179,7092,10066,9748,13959,13824,47597
18,CAR,2020,CAR-20/HCF10/SA1/CCCM-NFI/INGO/17699,9/3/2021 11:12:31 AM,Overall,2364,2329,1220,1179,7092,10066,9748,13959,13824,47597
18,CAR,2020,CAR-20/HCF10/SA1/COORD/INGO/17696,9/6/2021 3:15:42 PM,Other,80,0,0,0,80,78,0,0,0,78
18,CAR,2020,CAR-20/HCF10/SA1/COORD/INGO/17696,9/6/2021 3:15:42 PM,Overall,80,0,0,0,80,78,0,0,0,78
18,CAR,2020,CAR-20/HCF10/SA1/COORD/UN/17728,8/26/2021 1:26:04 PM,Host Communities,171,178,0,0,349,114,174,0,0,288
18,CAR,2020,CAR-20/HCF10/SA1/COORD/UN/17728,8/26/2021 1:26:04 PM,Internally Displaced People,397,413,0,0,810,195,362,0,0,557
18,CAR,2020,CAR-20/HCF10/SA1/COORD/UN/17728,8/26/2021 1:26:04 PM,Overall,747,778,0,0,1525,567,899,0,0,1466
18,CAR,2020,CAR-20/HCF10/SA1/COORD/UN/17728,8/26/2021 1:26:04 PM,Returnees,179,187,0,0,366,258,363,0,0,621
18,CAR,2020,CAR-20/HCF10/SA1/EDU-PROT/INGO/17726,11/24/2021 10:48:04 AM,Host Communities,6688,6962,4459,4641,22750,4876,6592,5054,6044,22566
18,CAR,2020,CAR-20/HCF10/SA1/EDU-PROT/INGO/17726,11/24/2021 10:48:04 AM,Internally Displaced People,5410,5790,2940,3060,17200,5567,5410,3002,3123,17102
18,CAR,2020,CAR-20/HCF10/SA1/EDU-PROT/INGO/17726,11/24/2021 10:48:04 AM,Overall,12980,13670,7987,8313,42950,11149,12835,8565,9648,42197
18,CAR,2020,CAR-20/HCF10/SA1/EDU-PROT/INGO/17726,11/24/2021 10:48:04 AM,Returnees,882,918,588,612,3000,706,833,509,481,2529
18,CAR,2020,CAR-20/HCF10/SA1/EDU-WaSH/INGO/17727,1/23/2023 2:10:55 PM,Host Communities,2512,2822,1582,1036,7952,5037,1873,1530,936,9376
18,CAR,2020,CAR-20/HCF10/SA1/EDU-WaSH/INGO/17727,1/23/2023 2:10:55 PM,Internally Displaced People,4475,5272,6532,6012,22291,4710,5173,7606,6847,24336
18,CAR,2020,CAR-20/HCF10/SA1/EDU-WaSH/INGO/17727,1/23/2023 2:10:55 PM,Other,624,704,128,144,1600,641,692,149,137,1619
18,CAR,2020,CAR-20/HCF10/SA1/EDU-WaSH/INGO/17727,1/23/2023 2:10:55 PM,Overall,16359,18656,11104,9668,55787,15360,11640,10988,9410,47398
18,CAR,2020,CAR-20/HCF10/SA1/EDU-WaSH/INGO/17727,1/23/2023 2:10:55 PM,Returnees,8748,9858,2862,2476,23944,4972,3902,1703,1490,12067
18,CAR,2020,CAR-20/HCF10/SA1/FSEC/INGO/17714,9/6/2021 3:42:06 PM,Host Communities,410,445,789,710,2354,89,95,141,136,461
18,CAR,2020,CAR-20/HCF10/SA1/FSEC/INGO/17714,9/6/2021 3:42:06 PM,Internally Displaced People,64,69,124,111,368,77,91,173,138,479
18,CAR,2020,CAR-20/HCF10/SA1/FSEC/INGO/17714,9/6/2021 3:42:06 PM,Overall,760,823,1462,1315,4360,1016,1221,1986,1810,6033
18,CAR,2020,CAR-20/HCF10/SA1/FSEC/INGO/17714,9/6/2021 3:42:06 PM,Returnees,286,309,549,494,1638,850,1035,1672,1536,5093
18,CAR,2020,CAR-20/HCF10/SA1/FSEC/INGO/17716,10/25/2021 2:55:33 PM,Host Communities,1874,1951,1801,1874,7500,1721,1839,2008,1933,7501
18,CAR,2020,CAR-20/HCF10/SA1/FSEC/INGO/17716,10/25/2021 2:55:33 PM,Internally Displaced People,1250,1300,1200,1250,5000,1147,1226,1339,1288,5000
18,CAR,2020,CAR-20/HCF10/SA1/FSEC/INGO/17716,10/25/2021 2:55:33 PM,Overall,3124,3251,3001,3124,12500,2868,3065,3347,3221,12501
18,CAR,2020,CAR-20/HCF10/SA1/FSEC/UN/17723,10/22/2021 8:01:49 AM,Host Communities,3523,3666,5284,5500,17973,3523,3666,5284,5500,17973
18,CAR,2020,CAR-20/HCF10/SA1/FSEC/UN/17723,10/22/2021 8:01:49 AM,Internally Displaced People,1006,1048,1510,1571,5135,1006,1048,1510,1571,5135
18,CAR,2020,CAR-20/HCF10/SA1/FSEC/UN/17723,10/22/2021 8:01:49 AM,Overall,5032,5238,7549,7856,25675,5032,5238,7549,7856,25675
18,CAR,2020,CAR-20/HCF10/SA1/FSEC/UN/17723,10/22/2021 8:01:49 AM,Returnees,503,524,755,785,2567,503,524,755,785,2567
18,CAR,2020,CAR-20/HCF10/SA1/FSEC-NFI-PROT/INGO/17737,11/24/2021 11:31:53 AM,Internally Displaced People,920,1200,838,1620,4578,2352,2979,0,0,5331
18,CAR,2020,CAR-20/HCF10/SA1/FSEC-NFI-PROT/INGO/17737,11/24/2021 11:31:53 AM,Overall,920,1200,838,1620,4578,2352,2979,0,0,5331
18,CAR,2020,CAR-20/HCF10/SA1/LOG/INGO/17715,11/15/2021 2:29:44 PM,Other,15,0,0,0,15,15,10,0,0,25
18,CAR,2020,CAR-20/HCF10/SA1/LOG/INGO/17715,11/15/2021 2:29:44 PM,Overall,15,0,0,0,15,15,10,0,0,25
18,CAR,2020,CAR-20/HCF10/SA1/LOG/UN/17673,8/2/2021 10:29:33 AM,Other,0,0,0,25,25,0,0,0,41,41
18,CAR,2020,CAR-20/HCF10/SA1/LOG/UN/17673,8/2/2021 10:29:33 AM,Overall,0,0,0,25,25,0,0,0,41,41
18,CAR,2020,CAR-20/HCF10/SA1/NFI-CCCM-EDU/INGO/17817,6/24/2022 10:55:36 AM,Host Communities,35,5,1720,1189,2949,1636,1910,809,768,5123
18,CAR,2020,CAR-20/HCF10/SA1/NFI-CCCM-EDU/INGO/17817,6/24/2022 10:55:36 AM,Internally Displaced People,4282,5067,8363,7757,25469,3415,3868,6111,6076,19470
18,CAR,2020,CAR-20/HCF10/SA1/NFI-CCCM-EDU/INGO/17817,6/24/2022 10:55:36 AM,Overall,4317,5072,10083,8946,28418,5051,5778,6920,6844,24593
18,CAR,2020,CAR-20/HCF10/SA1/NUT-HLT/INGO/17693,12/14/2021 3:29:28 PM,Host Communities,3958,6896,4477,4834,20165,3840,6758,4388,4640,19626
18,CAR,2020,CAR-20/HCF10/SA1/NUT-HLT/INGO/17693,12/14/2021 3:29:28 PM,Internally Displaced People,1979,2948,2239,2417,9583,1840,2800,2128,2368,9136
18,CAR,2020,CAR-20/HCF10/SA1/NUT-HLT/INGO/17693,12/14/2021 3:29:28 PM,Other,135,201,152,165,653,128,180,144,156,608
18,CAR,2020,CAR-20/HCF10/SA1/NUT-HLT/INGO/17693,12/14/2021 3:29:28 PM,Overall,7285,11852,8240,8898,36275,6900,11436,7978,8572,34886
18,CAR,2020,CAR-20/HCF10/SA1/NUT-HLT/INGO/17693,12/14/2021 3:29:28 PM,Returnees,1213,1807,1372,1482,5874,1092,1698,1318,1408,5516
18,CAR,2020,CAR-20/HCF10/SA1/NUT-HLT/NGO/17675,1/30/2022 6:02:20 AM,Host Communities,3000,6000,7000,8000,24000,3602,5685,5685,6725,21697
18,CAR,2020,CAR-20/HCF10/SA1/NUT-HLT/NGO/17675,1/30/2022 6:02:20 AM,Internally Displaced People,72,30,12,88,202,275,380,182,291,1128
18,CAR,2020,CAR-20/HCF10/SA1/NUT-HLT/NGO/17675,1/30/2022 6:02:20 AM,Overall,3662,6620,7512,8488,26282,4277,6419,6257,7418,24371
18,CAR,2020,CAR-20/HCF10/SA1/NUT-HLT/NGO/17675,1/30/2022 6:02:20 AM,Returnees,590,590,500,400,2080,400,354,390,402,1546
18,CAR,2020,CAR-20/HCF10/SA1/PROT/INGO/17725,11/24/2021 11:35:16 AM,Host Communities,535,695,4825,5005,11060,935,1270,1070,1386,4661
18,CAR,2020,CAR-20/HCF10/SA1/PROT/INGO/17725,11/24/2021 11:35:16 AM,Internally Displaced People,16000,16000,14200,14300,60500,16919,21145,17452,22891,78407
18,CAR,2020,CAR-20/HCF10/SA1/PROT/INGO/17725,11/24/2021 11:35:16 AM,Overall,16535,16695,19025,19305,71560,17854,22415,18522,24277,83068
18,CAR,2020,CAR-20/HCF10/SA1/PROT/NGO/17679,9/14/2021 9:45:45 AM,Host Communities,5000,5003,8737,8260,27000,3100,2955,4976,5877,16908
18,CAR,2020,CAR-20/HCF10/SA1/PROT/NGO/17679,9/14/2021 9:45:45 AM,Overall,5000,5003,8737,8260,27000,3100,2955,4976,5877,16908
18,CAR,2020,CAR-20/HCF10/SA1/WaSH/INGO/17681,11/16/2021 3:01:07 PM,Host Communities,2125,2511,3452,4902,12990,4220,4420,2736,3024,14400
18,CAR,2020,CAR-20/HCF10/SA1/WaSH/INGO/17681,11/16/2021 3:01:07 PM,Internally Displaced People,7114,7406,10313,10257,35090,6624,6825,9784,8163,31396
18,CAR,2020,CAR-20/HCF10/SA1/WaSH/INGO/17681,11/16/2021 3:01:07 PM,Overall,9756,10698,14577,16051,51082,13226,13875,14910,13143,55154
18,CAR,2020,CAR-20/HCF10/SA1/WaSH/INGO/17681,11/16/2021 3:01:07 PM,Returnees,517,781,812,892,3002,2382,2630,2390,1956,9358
18,CAR,2021,CAR-21/HCF10/RA1/HLT-PROT/UN/19981,11/21/2022 10:02:48 AM,Host Communities,3860,9320,2800,4450,20430,121,8323,11,1872,10327
18,CAR,2021,CAR-21/HCF10/RA1/HLT-PROT/UN/19981,11/21/2022 10:02:48 AM,Internally Displaced People,2670,6300,2300,3300,14570,1,508,0,379,888
18,CAR,2021,CAR-21/HCF10/RA1/HLT-PROT/UN/19981,11/21/2022 10:02:48 AM,Overall,6530,15620,5100,7750,35000,122,8831,11,2251,11215
18,CAR,2021,CAR-21/HCF10/RA1/PROT/INGO/19980,11/16/2022 3:15:07 PM,Host Communities,3591,4408,1202,1498,10699,3103,4265,1067,1260,9695
18,CAR,2021,CAR-21/HCF10/RA1/PROT/INGO/19980,11/16/2022 3:15:07 PM,Internally Displaced People,8379,10285,2804,3494,24962,7466,9502,2489,3167,22624
18,CAR,2021,CAR-21/HCF10/RA1/PROT/INGO/19980,11/16/2022 3:15:07 PM,Overall,11970,14693,4006,4992,35661,10569,13767,3556,4427,32319
18,CAR,2021,CAR-21/HCF10/RA1/PROT/INGO/19989,9/12/2022 7:52:45 AM,Host Communities,250,1200,150,400,2000,519,1049,124,294,1986
18,CAR,2021,CAR-21/HCF10/RA1/PROT/INGO/19989,9/12/2022 7:52:45 AM,Internally Displaced People,1500,7200,900,2400,12000,3115,6543,672,1732,12062
18,CAR,2021,CAR-21/HCF10/RA1/PROT/INGO/19989,9/12/2022 7:52:45 AM,Overall,2500,12000,1500,4000,20000,5192,10740,1042,2902,19876
18,CAR,2021,CAR-21/HCF10/RA1/PROT/INGO/19989,9/12/2022 7:52:45 AM,Returnees,750,3600,450,1200,6000,1558,3148,246,876,5828
18,CAR,2021,CAR-21/HCF10/RA1/PROT/INGO/19999,11/14/2022 12:21:48 PM,Internally Displaced People,4590,4884,6362,6741,22577,11363,18657,12672,22027,64719
18,CAR,2021,CAR-21/HCF10/RA1/PROT/INGO/19999,11/14/2022 12:21:48 PM,Overall,4590,4884,6362,6741,22577,11363,18657,12672,22027,64719
18,CAR,2021,CAR-21/HCF10/RA1/PROT/INGO/20002,7/5/2022 2:30:47 PM,Host Communities,3150,3270,2200,2390,11010,1515,3110,535,831,5991
18,CAR,2021,CAR-21/HCF10/RA1/PROT/INGO/20002,7/5/2022 2:30:47 PM,Internally Displaced People,2015,2735,1680,1980,8410,1010,2073,357,554,3994
18,CAR,2021,CAR-21/HCF10/RA1/PROT/INGO/20002,7/5/2022 2:30:47 PM,Overall,5165,6005,3880,4370,19420,2525,5183,892,1385,9985
18,CAR,2021,CAR-21/HCF10/RA1/PROT/INGO/20006,10/14/2022 7:31:23 AM,Host Communities,5750,7950,2475,4550,20725,6899,9538,2969,5459,24865
18,CAR,2021,CAR-21/HCF10/RA1/PROT/INGO/20006,10/14/2022 7:31:23 AM,Internally Displaced People,4500,5500,525,1275,11800,5399,6599,630,1530,14158
18,CAR,2021,CAR-21/HCF10/RA1/PROT/INGO/20006,10/14/2022 7:31:23 AM,Overall,10800,14050,3450,6350,34650,12958,16857,4139,7618,41572
18,CAR,2021,CAR-21/HCF10/RA1/PROT/INGO/20006,10/14/2022 7:31:23 AM,Returnees,550,600,450,525,2125,660,720,540,629,2549
18,CAR,2021,CAR-21/HCF10/RA1/PROT/UN/19993,1/3/2023 12:19:51 PM,Host Communities,2000,1000,2000,1000,6000,1818,907,1817,1000,5542
18,CAR,2021,CAR-21/HCF10/RA1/PROT/UN/19993,1/3/2023 12:19:51 PM,Internally Displaced People,4000,3000,4000,3000,14000,2158,1805,2047,1545,7555
18,CAR,2021,CAR-21/HCF10/RA1/PROT/UN/19993,1/3/2023 12:19:51 PM,Overall,6000,4000,6000,4000,20000,3976,2712,3864,2545,13097
18,CAR,2021,CAR-21/HCF10/RA1/PROT-HLT/INGO/19990,6/30/2022 11:31:22 AM,Internally Displaced People,14411,15737,6202,6718,43068,14188,15211,5632,6379,41410
18,CAR,2021,CAR-21/HCF10/RA1/PROT-HLT/INGO/19990,6/30/2022 11:31:22 AM,Overall,14411,15737,6202,6718,43068,14188,15211,5632,6379,41410
18,CAR,2021,CAR-21/HCF10/RA1/PROT-WaSH-FSEC/INGO/19984,11/30/2022 10:04:52 AM,Host Communities,1348,1464,1133,1255,5200,148,490,139,1175,1952
18,CAR,2021,CAR-21/HCF10/RA1/PROT-WaSH-FSEC/INGO/19984,11/30/2022 10:04:52 AM,Internally Displaced People,8687,9433,7299,8087,33506,9316,10115,7826,8674,35931
18,CAR,2021,CAR-21/HCF10/RA1/PROT-WaSH-FSEC/INGO/19984,11/30/2022 10:04:52 AM,Overall,10709,11629,8998,9970,41306,12758,15308,11237,11980,51283
18,CAR,2021,CAR-21/HCF10/RA1/PROT-WaSH-FSEC/INGO/19984,11/30/2022 10:04:52 AM,Returnees,674,732,566,628,2600,3294,4703,3272,2131,13400
18,CAR,2021,CAR-21/HCF10/RA2/COORD/INGO/20952,2/15/2023 6:24:46 AM,Host Communities,204,218,270,294,986,258,333,428,381,1400
18,CAR,2021,CAR-21/HCF10/RA2/COORD/INGO/20952,2/15/2023 6:24:46 AM,Internally Displaced People,68,70,90,96,324,17,25,23,20,85
18,CAR,2021,CAR-21/HCF10/RA2/COORD/INGO/20952,2/15/2023 6:24:46 AM,Overall,272,288,360,390,1310,275,358,451,401,1485
18,CAR,2021,CAR-21/HCF10/RA2/ETC/UN/20925,3/15/2023 3:15:30 PM,Host Communities,395034,471671,360475,372950,1600130,257305,275534,211171,227957,971967
18,CAR,2021,CAR-21/HCF10/RA2/ETC/UN/20925,3/15/2023 3:15:30 PM,Internally Displaced People,30711,36668,28024,28982,124385,12637,12095,9545,9789,44066
18,CAR,2021,CAR-21/HCF10/RA2/ETC/UN/20925,3/15/2023 3:15:30 PM,Other,40885,52764,40079,41448,175176,23332,128340,7939,6947,166558
18,CAR,2021,CAR-21/HCF10/RA2/ETC/UN/20925,3/15/2023 3:15:30 PM,Overall,466630,561103,428578,443380,1899691,293274,415969,228655,244693,1182591
18,CAR,2021,CAR-21/HCF10/RA2/HLT/INGO/20771,9/9/2022 1:54:16 PM,Host Communities,7576,9260,11364,13889,42089,7597,9281,11388,13899,42165
18,CAR,2021,CAR-21/HCF10/RA2/HLT/INGO/20771,9/9/2022 1:54:16 PM,Internally Displaced People,659,805,988,1209,3661,669,811,991,1231,3702
18,CAR,2021,CAR-21/HCF10/RA2/HLT/INGO/20771,9/9/2022 1:54:16 PM,Overall,8235,10065,12352,15098,45750,8266,10092,12379,15130,45867
18,CAR,2021,CAR-21/HCF10/RA2/HLT/INGO/20874,12/14/2022 10:55:54 AM,Host Communities,3203,3709,4560,4839,16311,2819,3264,3876,4451,14410
18,CAR,2021,CAR-21/HCF10/RA2/HLT/INGO/20874,12/14/2022 10:55:54 AM,Internally Displaced People,957,922,981,903,3763,862,822,864,832,3380
18,CAR,2021,CAR-21/HCF10/RA2/HLT/INGO/20874,12/14/2022 10:55:54 AM,Overall,4469,5084,5991,6213,21757,3951,4484,5162,5697,19294
18,CAR,2021,CAR-21/HCF10/RA2/HLT/INGO/20874,12/14/2022 10:55:54 AM,Returnees,309,453,450,471,1683,270,398,422,414,1504
18,CAR,2021,CAR-21/HCF10/RA2/HLT/INGO/20898,3/22/2023 10:01:42 AM,Host Communities,4806,7676,2358,2853,17693,6112,8821,3242,3399,21574
18,CAR,2021,CAR-21/HCF10/RA2/HLT/INGO/20898,3/22/2023 10:01:42 AM,Internally Displaced People,1373,2193,674,815,5055,1564,2201,731,999,5495
18,CAR,2021,CAR-21/HCF10/RA2/HLT/INGO/20898,3/22/2023 10:01:42 AM,Overall,6866,10966,3369,4075,25276,8474,12281,4375,5056,30186
18,CAR,2021,CAR-21/HCF10/RA2/HLT/INGO/20898,3/22/2023 10:01:42 AM,Returnees,687,1097,337,407,2528,798,1259,402,658,3117
18,CAR,2021,CAR-21/HCF10/RA2/HLT/INGO/20913,2/22/2023 11:12:44 AM,Host Communities,4823,7975,7414,7731,27943,3311,8284,5757,5709,23061
18,CAR,2021,CAR-21/HCF10/RA2/HLT/INGO/20913,2/22/2023 11:12:44 AM,Internally Displaced People,63,94,74,78,309,385,827,515,530,2257
18,CAR,2021,CAR-21/HCF10/RA2/HLT/INGO/20913,2/22/2023 11:12:44 AM,Overall,4886,8069,7488,7809,28252,3696,9111,6272,6239,25318
18,CAR,2021,CAR-21/HCF10/RA2/HLT/INGO/20944,3/7/2023 3:24:34 PM,Host Communities,2964,3192,2622,2622,11400,2745,3229,4682,5490,16146
18,CAR,2021,CAR-21/HCF10/RA2/HLT/INGO/20944,3/7/2023 3:24:34 PM,Internally Displaced People,741,798,655,656,2850,183,215,312,366,1076
18,CAR,2021,CAR-21/HCF10/RA2/HLT/INGO/20944,3/7/2023 3:24:34 PM,Overall,3900,4200,3449,3451,15000,3050,3588,5202,6100,17940
18,CAR,2021,CAR-21/HCF10/RA2/HLT/INGO/20944,3/7/2023 3:24:34 PM,Returnees,195,210,172,173,750,122,144,208,244,718
18,CAR,2021,CAR-21/HCF10/RA2/HLT/INGO/20956,1/9/2023 9:05:22 AM,Other,5,70,5,70,150,0,430,0,1,431
18,CAR,2021,CAR-21/HCF10/RA2/HLT/INGO/20956,1/9/2023 9:05:22 AM,Overall,5,70,5,70,150,0,430,0,1,431
18,CAR,2021,CAR-21/HCF10/RA2/HLT/INGO/20958,1/4/2023 3:02:36 PM,Host Communities,2518,23365,8241,10827,44951,12537,21396,15221,16412,65566
18,CAR,2021,CAR-21/HCF10/RA2/HLT/INGO/20958,1/4/2023 3:02:36 PM,Internally Displaced People,236,2149,762,993,4140,1197,2117,1715,1770,6799
18,CAR,2021,CAR-21/HCF10/RA2/HLT/INGO/20958,1/4/2023 3:02:36 PM,Overall,2866,26374,9328,12204,50772,14201,24311,17504,18794,74810
18,CAR,2021,CAR-21/HCF10/RA2/HLT/INGO/20958,1/4/2023 3:02:36 PM,Returnees,112,860,325,384,1681,467,798,568,612,2445
18,CAR,2021,CAR-21/HCF10/RA2/HLT-NUT/INGO/20840,12/23/2022 10:34:15 AM,Host Communities,41597,43295,8732,9089,102713,42874,44624,9000,9367,105865
18,CAR,2021,CAR-21/HCF10/RA2/HLT-NUT/INGO/20840,12/23/2022 10:34:15 AM,Internally Displaced People,6838,7117,1435,1494,16884,158,244,367,486,1255
18,CAR,2021,CAR-21/HCF10/RA2/HLT-NUT/INGO/20840,12/23/2022 10:34:15 AM,Overall,48435,50412,10167,10583,119597,43032,44868,9367,9853,107120
18,CAR,2021,CAR-21/HCF10/RA2/NFI/INGO/20767,12/20/2022 8:18:03 AM,Host Communities,468,483,381,396,1728,468,483,381,396,1728
18,CAR,2021,CAR-21/HCF10/RA2/NFI/INGO/20767,12/20/2022 8:18:03 AM,Internally Displaced People,777,807,633,663,2880,777,807,633,663,2880
18,CAR,2021,CAR-21/HCF10/RA2/NFI/INGO/20767,12/20/2022 8:18:03 AM,Overall,1296,1344,1056,1104,4800,1296,1344,1056,1104,4800
18,CAR,2021,CAR-21/HCF10/RA2/NFI/INGO/20767,12/20/2022 8:18:03 AM,Returnees,51,54,42,45,192,51,54,42,45,192
18,CAR,2021,CAR-21/HCF10/RA2/NFI-CCCM-COORD/UN/20778,1/23/2023 8:02:08 AM,Host Communities,463,682,354,416,1915,46,68,35,42,191
18,CAR,2021,CAR-21/HCF10/RA2/NFI-CCCM-COORD/UN/20778,1/23/2023 8:02:08 AM,Internally Displaced People,8351,12276,6372,7488,34487,4434,5612,4743,5005,19794
18,CAR,2021,CAR-21/HCF10/RA2/NFI-CCCM-COORD/UN/20778,1/23/2023 8:02:08 AM,Overall,9277,13640,7080,8320,38317,4619,5884,4884,5193,20580
18,CAR,2021,CAR-21/HCF10/RA2/NFI-CCCM-COORD/UN/20778,1/23/2023 8:02:08 AM,Returnees,463,682,354,416,1915,139,204,106,146,595
18,CAR,2021,CAR-21/HCF10/RA2/WaSH/INGO/20773,2/22/2023 10:48:03 AM,Internally Displaced People,4187,4358,2792,2905,14242,4187,4358,2792,2905,14242
18,CAR,2021,CAR-21/HCF10/RA2/WaSH/INGO/20773,2/22/2023 10:48:03 AM,Overall,4187,4358,2792,2905,14242,4187,4358,2792,2905,14242
18,CAR,2021,CAR-21/HCF10/RA2/WaSH/INGO/20781,11/22/2022 7:24:50 AM,Host Communities,2885,3262,3011,3387,12545,148,490,139,1175,1952
18,CAR,2021,CAR-21/HCF10/RA2/WaSH/INGO/20781,11/22/2022 7:24:50 AM,Internally Displaced People,4428,5723,9057,8951,28159,3606,4661,7376,7292,22935
18,CAR,2021,CAR-21/HCF10/RA2/WaSH/INGO/20781,11/22/2022 7:24:50 AM,Overall,8675,10192,14198,14225,47290,5355,6509,9050,9647,30561
18,CAR,2021,CAR-21/HCF10/RA2/WaSH/INGO/20781,11/22/2022 7:24:50 AM,Returnees,1362,1207,2130,1887,6586,1601,1358,1535,1180,5674
18,CAR,2021,CAR-21/HCF10/RA2/WaSH/INGO/20949,1/3/2023 9:13:32 AM,Internally Displaced People,2000,3200,3400,3900,12500,1959,2127,2401,2516,9003
18,CAR,2021,CAR-21/HCF10/RA2/WaSH/INGO/20949,1/3/2023 9:13:32 AM,Overall,2000,3200,3400,3900,12500,1959,2127,2401,2516,9003
18,CAR,2021,CAR-21/HCF10/SA1/CCCM-FSEC-NFI/INGO/19000,9/29/2022 2:33:41 PM,Host Communities,1967,2705,1090,1619,7381,291,246,45,45,627
18,CAR,2021,CAR-21/HCF10/SA1/CCCM-FSEC-NFI/INGO/19000,9/29/2022 2:33:41 PM,Internally Displaced People,2951,5328,5797,4279,18355,3065,3911,6146,6041,19163
18,CAR,2021,CAR-21/HCF10/SA1/CCCM-FSEC-NFI/INGO/19000,9/29/2022 2:33:41 PM,Overall,4918,8033,6887,5898,25736,3356,4157,6191,6086,19790
18,CAR,2021,CAR-21/HCF10/SA1/CCCM-NFI/INGO/18897,4/14/2022 12:35:05 PM,Host Communities,1543,1632,2776,2762,8713,1125,1215,2100,2154,6594
18,CAR,2021,CAR-21/HCF10/SA1/CCCM-NFI/INGO/18897,4/14/2022 12:35:05 PM,Internally Displaced People,12688,13583,22767,22719,71757,11209,11508,20443,19984,63144
18,CAR,2021,CAR-21/HCF10/SA1/CCCM-NFI/INGO/18897,4/14/2022 12:35:05 PM,Overall,14231,15215,25543,25481,80470,12334,12723,22543,22138,69738
18,CAR,2021,CAR-21/HCF10/SA1/CCCM-WaSH/INGO/19099,9/17/2022 8:49:46 AM,Host Communities,1280,1386,2560,2774,8000,1355,1442,2714,2885,8396
18,CAR,2021,CAR-21/HCF10/SA1/CCCM-WaSH/INGO/19099,9/17/2022 8:49:46 AM,Internally Displaced People,2423,2576,4847,5154,15000,1681,1787,3813,3574,10855
18,CAR,2021,CAR-21/HCF10/SA1/CCCM-WaSH/INGO/19099,9/17/2022 8:49:46 AM,Overall,3703,3962,7407,7928,23000,3036,3229,6527,6459,19251
18,CAR,2021,CAR-21/HCF10/SA1/COORD/INGO/18916,9/30/2022 7:30:03 AM,Other,75,45,0,0,120,75,45,0,0,120
18,CAR,2021,CAR-21/HCF10/SA1/COORD/INGO/18916,9/30/2022 7:30:03 AM,Overall,75,45,0,0,120,75,45,0,0,120
18,CAR,2021,CAR-21/HCF10/SA1/COORD/INGO/18935,6/22/2022 2:22:41 PM,Other,75,0,0,0,75,84,0,0,0,84
18,CAR,2021,CAR-21/HCF10/SA1/COORD/INGO/18935,6/22/2022 2:22:41 PM,Overall,75,0,0,0,75,84,0,0,0,84
18,CAR,2021,CAR-21/HCF10/SA1/COORD-FSEC-WaSH/INGO/18954,9/9/2022 1:05:42 PM,Host Communities,1100,1300,1200,1400,5000,1006,1113,1463,1529,5111
18,CAR,2021,CAR-21/HCF10/SA1/COORD-FSEC-WaSH/INGO/18954,9/9/2022 1:05:42 PM,Other,135,90,0,0,225,24,11,0,0,35
18,CAR,2021,CAR-21/HCF10/SA1/COORD-FSEC-WaSH/INGO/18954,9/9/2022 1:05:42 PM,Overall,1635,1840,1500,1750,6725,1731,1843,2179,2318,8071
18,CAR,2021,CAR-21/HCF10/SA1/COORD-FSEC-WaSH/INGO/18954,9/9/2022 1:05:42 PM,Returnees,400,450,300,350,1500,701,719,716,789,2925
18,CAR,2021,CAR-21/HCF10/SA1/COORD-WaSH-NUT-HLT/INGO/18857,12/9/2022 8:05:15 AM,Host Communities,78,2500,3777,3959,10314,1946,2162,1679,1754,7541
18,CAR,2021,CAR-21/HCF10/SA1/COORD-WaSH-NUT-HLT/INGO/18857,12/9/2022 8:05:15 AM,Internally Displaced People,10,312,472,495,1289,2587,2699,2924,3037,11247
18,CAR,2021,CAR-21/HCF10/SA1/COORD-WaSH-NUT-HLT/INGO/18857,12/9/2022 8:05:15 AM,Overall,98,3124,4721,4949,12892,5111,5506,5092,5302,21011
18,CAR,2021,CAR-21/HCF10/SA1/COORD-WaSH-NUT-HLT/INGO/18857,12/9/2022 8:05:15 AM,Returnees,10,312,472,495,1289,578,645,489,511,2223
18,CAR,2021,CAR-21/HCF10/SA1/EDU/INGO/18855,10/20/2022 1:23:36 PM,Host Communities,1182,1166,2284,2109,6741,1023,1166,2284,2109,6582
18,CAR,2021,CAR-21/HCF10/SA1/EDU/INGO/18855,10/20/2022 1:23:36 PM,Internally Displaced People,433,256,550,539,1778,134,153,400,341,1028
18,CAR,2021,CAR-21/HCF10/SA1/EDU/INGO/18855,10/20/2022 1:23:36 PM,Overall,1676,1491,2970,2774,8911,1218,1388,2820,2576,8002
18,CAR,2021,CAR-21/HCF10/SA1/EDU/INGO/18855,10/20/2022 1:23:36 PM,Returnees,61,69,136,126,392,61,69,136,126,392
18,CAR,2021,CAR-21/HCF10/SA1/EDU/INGO/18881,3/14/2022 1:56:35 PM,Host Communities,299,430,390,510,1629,314,429,429,541,1713
18,CAR,2021,CAR-21/HCF10/SA1/EDU/INGO/18881,3/14/2022 1:56:35 PM,Internally Displaced People,977,1485,1014,1563,5039,974,1372,1080,1655,5081
18,CAR,2021,CAR-21/HCF10/SA1/EDU/INGO/18881,3/14/2022 1:56:35 PM,Overall,1302,1954,1448,2171,6875,1314,1838,1553,2302,7007
18,CAR,2021,CAR-21/HCF10/SA1/EDU/INGO/18881,3/14/2022 1:56:35 PM,Returnees,26,39,44,98,207,26,37,44,106,213
18,CAR,2021,CAR-21/HCF10/SA1/EDU/INGO/18886,7/28/2022 10:57:10 AM,Host Communities,0,0,6520,9003,15523,110,29,6352,9173,15664
18,CAR,2021,CAR-21/HCF10/SA1/EDU/INGO/18886,7/28/2022 10:57:10 AM,Internally Displaced People,0,0,1351,1866,3217,0,0,1379,1863,3242
18,CAR,2021,CAR-21/HCF10/SA1/EDU/INGO/18886,7/28/2022 10:57:10 AM,Overall,0,0,7871,10869,18740,110,29,7731,11036,18906
18,CAR,2021,CAR-21/HCF10/SA1/FSEC/INGO/18913,11/16/2022 3:19:40 PM,Host Communities,1020,1148,126,255,2549,742,1231,132,273,2378
18,CAR,2021,CAR-21/HCF10/SA1/FSEC/INGO/18913,11/16/2022 3:19:40 PM,Internally Displaced People,3332,3749,417,833,8331,3231,4321,421,1243,9216
18,CAR,2021,CAR-21/HCF10/SA1/FSEC/INGO/18913,11/16/2022 3:19:40 PM,Overall,6800,7651,849,1700,17000,6105,7884,784,2258,17031
18,CAR,2021,CAR-21/HCF10/SA1/FSEC/INGO/18913,11/16/2022 3:19:40 PM,Returnees,2448,2754,306,612,6120,2132,2332,231,742,5437
18,CAR,2021,CAR-21/HCF10/SA1/FSEC/INGO/18948,6/24/2022 8:14:25 AM,Host Communities,658,714,1267,1140,3779,863,1414,1963,2257,6497
18,CAR,2021,CAR-21/HCF10/SA1/FSEC/INGO/18948,6/24/2022 8:14:25 AM,Internally Displaced People,102,110,200,179,591,0,0,0,0,0
18,CAR,2021,CAR-21/HCF10/SA1/FSEC/INGO/18948,6/24/2022 8:14:25 AM,Overall,1219,1320,2348,2113,7000,863,1414,1963,2257,6497
18,CAR,2021,CAR-21/HCF10/SA1/FSEC/INGO/18948,6/24/2022 8:14:25 AM,Returnees,459,496,881,794,2630,0,0,0,0,0
18,CAR,2021,CAR-21/HCF10/SA1/HLT/INGO/18880,6/17/2022 7:28:05 AM,Host Communities,24420,45354,59657,45004,174435,24420,45354,59658,45004,174436
18,CAR,2021,CAR-21/HCF10/SA1/HLT/INGO/18880,6/17/2022 7:28:05 AM,Internally Displaced People,2713,5040,6630,4999,19382,2713,5040,6630,4999,19382
18,CAR,2021,CAR-21/HCF10/SA1/HLT/INGO/18880,6/17/2022 7:28:05 AM,Overall,27133,50394,66287,50003,193817,27133,50394,66288,50003,193818
18,CAR,2021,CAR-21/HCF10/SA1/HLT/INGO/18923,7/5/2022 2:10:35 PM,Host Communities,9048,9426,8691,9053,36218,33251,35204,4657,4918,78030
18,CAR,2021,CAR-21/HCF10/SA1/HLT/INGO/18923,7/5/2022 2:10:35 PM,Internally Displaced People,5474,5701,5254,5478,21907,26758,28076,2345,2470,59649
18,CAR,2021,CAR-21/HCF10/SA1/HLT/INGO/18923,7/5/2022 2:10:35 PM,Overall,14522,15127,13945,14531,58125,60009,63280,7002,7388,137679
18,CAR,2021,CAR-21/HCF10/SA1/HLT/INGO/19034,3/10/2022 1:44:53 PM,Host Communities,6036,8088,6461,5340,25925,5011,7023,7045,4065,23144
18,CAR,2021,CAR-21/HCF10/SA1/HLT/INGO/19034,3/10/2022 1:44:53 PM,Internally Displaced People,4385,5867,1201,1187,12640,3894,6002,1072,1301,12269
18,CAR,2021,CAR-21/HCF10/SA1/HLT/INGO/19034,3/10/2022 1:44:53 PM,Overall,10421,13955,7662,6527,38565,8905,13025,8117,5366,35413
18,CAR,2021,CAR-21/HCF10/SA1/HLT-COORD/INGO/18927,9/9/2022 1:52:21 PM,Host Communities,11029,14620,2757,3655,32061,13252,15171,6002,8896,43321
18,CAR,2021,CAR-21/HCF10/SA1/HLT-COORD/INGO/18927,9/9/2022 1:52:21 PM,Internally Displaced People,2757,3655,689,914,8015,2941,3755,756,1004,8456
18,CAR,2021,CAR-21/HCF10/SA1/HLT-COORD/INGO/18927,9/9/2022 1:52:21 PM,Overall,13786,18275,3446,4569,40076,16193,18926,6758,9900,51777
18,CAR,2021,CAR-21/HCF10/SA1/HLT-NUT/INGO/18876,6/24/2022 11:08:05 AM,Host Communities,7797,14655,13747,14084,50283,15000,28000,5598,7310,55908
18,CAR,2021,CAR-21/HCF10/SA1/HLT-NUT/INGO/18876,6/24/2022 11:08:05 AM,Internally Displaced People,939,1766,1659,1697,6061,5500,11110,1912,1981,20503
18,CAR,2021,CAR-21/HCF10/SA1/HLT-NUT/INGO/18876,6/24/2022 11:08:05 AM,Overall,11728,22057,20708,21210,75703,23510,46094,9242,11339,90185
18,CAR,2021,CAR-21/HCF10/SA1/HLT-NUT/INGO/18876,6/24/2022 11:08:05 AM,Refugees,1210,2281,2144,2194,7829,1200,3004,508,1130,5842
18,CAR,2021,CAR-21/HCF10/SA1/HLT-NUT/INGO/18876,6/24/2022 11:08:05 AM,Returnees,1782,3355,3158,3235,11530,1810,3980,1224,918,7932
18,CAR,2021,CAR-21/HCF10/SA1/HLT-NUT/INGO/18991,6/30/2022 10:39:34 AM,Host Communities,1901,2059,1826,1978,7764,2722,5005,1729,2531,11987
18,CAR,2021,CAR-21/HCF10/SA1/HLT-NUT/INGO/18991,6/30/2022 10:39:34 AM,Internally Displaced People,2138,2316,2054,2226,8734,3312,5026,2960,3676,14974
18,CAR,2021,CAR-21/HCF10/SA1/HLT-NUT/INGO/18991,6/30/2022 10:39:34 AM,Overall,4752,5147,4565,4946,19410,7083,11121,5350,6949,30503
18,CAR,2021,CAR-21/HCF10/SA1/HLT-NUT/INGO/18991,6/30/2022 10:39:34 AM,Returnees,713,772,685,742,2912,1049,1090,661,742,3542
18,CAR,2021,CAR-21/HCF10/SA1/HLT-NUT/NGO/18875,3/24/2022 10:46:49 AM,Host Communities,2047,7216,5912,6211,21386,2301,7396,6202,6494,22393
18,CAR,2021,CAR-21/HCF10/SA1/HLT-NUT/NGO/18875,3/24/2022 10:46:49 AM,Internally Displaced People,853,3007,2464,2588,8912,793,3350,2198,2641,8982
18,CAR,2021,CAR-21/HCF10/SA1/HLT-NUT/NGO/18875,3/24/2022 10:46:49 AM,Overall,3412,12027,9854,10352,35645,3681,12344,9901,10550,36476
18,CAR,2021,CAR-21/HCF10/SA1/HLT-NUT/NGO/18875,3/24/2022 10:46:49 AM,Returnees,512,1804,1478,1553,5347,587,1598,1501,1415,5101
18,CAR,2021,CAR-21/HCF10/SA1/LOG/INGO/18854,2/25/2022 9:57:55 AM,Other,23,0,0,0,23,27,0,0,0,27
18,CAR,2021,CAR-21/HCF10/SA1/LOG/INGO/18854,2/25/2022 9:57:55 AM,Overall,23,0,0,0,23,27,0,0,0,27
18,CAR,2021,CAR-21/HCF10/SA1/LOG-ETC/UN/18867,6/14/2022 11:24:45 AM,Other,0,0,0,25,25,0,0,0,21,21
18,CAR,2021,CAR-21/HCF10/SA1/LOG-ETC/UN/18867,6/14/2022 11:24:45 AM,Overall,0,0,0,25,25,0,0,0,21,21
18,CAR,2021,CAR-21/HCF10/SA1/NUT-HLT/INGO/18869,2/25/2022 9:11:55 AM,Host Communities,32359,35337,8031,8700,84427,36791,44409,9278,9391,99869
18,CAR,2021,CAR-21/HCF10/SA1/NUT-HLT/INGO/18869,2/25/2022 9:11:55 AM,Overall,32359,35337,8031,8700,84427,36791,44409,9278,9391,99869
18,CAR,2021,CAR-21/HCF10/SA1/PROT/INGO/18856,11/16/2022 2:53:04 PM,Host Communities,1871,1045,1339,1137,5392,4078,2214,2913,1137,10342
18,CAR,2021,CAR-21/HCF10/SA1/PROT/INGO/18856,11/16/2022 2:53:04 PM,Internally Displaced People,2155,1975,2663,2488,9281,4616,4214,5820,5418,20068
18,CAR,2021,CAR-21/HCF10/SA1/PROT/INGO/18856,11/16/2022 2:53:04 PM,Overall,4227,3062,4044,3640,14973,9127,6519,8824,6586,31056
18,CAR,2021,CAR-21/HCF10/SA1/PROT/INGO/18856,11/16/2022 2:53:04 PM,Returnees,201,42,42,15,300,433,91,91,31,646
18,CAR,2021,CAR-21/HCF10/SA1/PROT/INGO/18864,4/22/2022 1:34:23 PM,Host Communities,1650,2100,1250,1250,6250,1710,2195,1320,1290,6515
18,CAR,2021,CAR-21/HCF10/SA1/PROT/INGO/18864,4/22/2022 1:34:23 PM,Internally Displaced People,550,700,417,417,2084,568,715,431,425,2139
18,CAR,2021,CAR-21/HCF10/SA1/PROT/INGO/18864,4/22/2022 1:34:23 PM,Overall,3300,4200,2500,2500,12500,3399,4332,2590,2557,12878
18,CAR,2021,CAR-21/HCF10/SA1/PROT/INGO/18864,4/22/2022 1:34:23 PM,Returnees,1100,1400,833,833,4166,1121,1422,839,842,4224
18,CAR,2021,CAR-21/HCF10/SA1/PROT/NGO/18874,2/18/2022 4:31:46 PM,Host Communities,420,310,2198,2520,5448,218,311,2219,2198,4946
18,CAR,2021,CAR-21/HCF10/SA1/PROT/NGO/18874,2/18/2022 4:31:46 PM,Internally Displaced People,196,152,1104,1100,2552,121,111,1034,918,2184
18,CAR,2021,CAR-21/HCF10/SA1/PROT/NGO/18874,2/18/2022 4:31:46 PM,Overall,616,462,3302,3620,8000,339,422,3253,3116,7130
18,CAR,2021,CAR-21/HCF10/SA1/WaSH/INGO/18885,3/1/2022 2:59:09 PM,Host Communities,8258,10093,12387,15139,45877,8271,11009,12390,15139,46809
18,CAR,2021,CAR-21/HCF10/SA1/WaSH/INGO/18885,3/1/2022 2:59:09 PM,Internally Displaced People,515,630,773,945,2863,515,630,773,945,2863
18,CAR,2021,CAR-21/HCF10/SA1/WaSH/INGO/18885,3/1/2022 2:59:09 PM,Overall,8773,10723,13160,16084,48740,8786,11639,13163,16084,49672
18,CAR,2021,CAR-21/HCF10/SA1/WaSH/INGO/18895,6/3/2022 3:10:20 PM,Internally Displaced People,1098,1099,1242,1337,4776,1178,1179,1767,1768,5892
18,CAR,2021,CAR-21/HCF10/SA1/WaSH/INGO/18895,6/3/2022 3:10:20 PM,Overall,1098,1099,1242,1337,4776,1178,1179,1767,1768,5892
18,CAR,2021,CAR-21/HCF10/SA1/WaSH/INGO/18928,5/25/2022 10:35:30 AM,Internally Displaced People,8797,9903,1943,2024,22667,5941,6919,4658,4849,22367
18,CAR,2021,CAR-21/HCF10/SA1/WaSH/INGO/18928,5/25/2022 10:35:30 AM,Overall,8797,9903,1943,2024,22667,5941,6919,4658,4849,22367
18,CAR,2021,CAR-21/HCF10/SA1/WaSH/NGO/19072,7/25/2022 12:52:57 PM,Host Communities,2000,6000,2000,2000,12000,2230,3996,1724,2805,10755
18,CAR,2021,CAR-21/HCF10/SA1/WaSH/NGO/19072,7/25/2022 12:52:57 PM,Overall,7700,14000,4500,3800,30000,6320,9057,6723,6905,29005
18,CAR,2021,CAR-21/HCF10/SA1/WaSH/NGO/19072,7/25/2022 12:52:57 PM,Returnees,5700,8000,2500,1800,18000,4090,5061,4999,4100,18250
18,CAR,2021,CAR-21/HCF10/SA1/WaSH-PROT/INGO/18952,3/10/2022 2:43:00 PM,Host Communities,161,216,54,108,539,157,269,54,108,588
18,CAR,2021,CAR-21/HCF10/SA1/WaSH-PROT/INGO/18952,3/10/2022 2:43:00 PM,Internally Displaced People,7331,6481,12221,12121,38154,7307,6712,12631,12529,39179
18,CAR,2021,CAR-21/HCF10/SA1/WaSH-PROT/INGO/18952,3/10/2022 2:43:00 PM,Overall,7858,7185,12396,12473,39912,7855,7478,12798,12865,40996
18,CAR,2021,CAR-21/HCF10/SA1/WaSH-PROT/INGO/18952,3/10/2022 2:43:00 PM,Returnees,366,488,121,244,1219,391,497,113,228,1229
18,CAR,2022,CAR-22/HCF10/RA1/LOG/UN/21204,12/22/2022 1:51:05 PM,Other,0,208,0,0,208,0,183,0,0,183
18,CAR,2022,CAR-22/HCF10/RA1/LOG/UN/21204,12/22/2022 1:51:05 PM,Overall,0,208,0,0,208,0,183,0,0,183
18,CAR,2022,CAR-22/HCF10/RA2/HLT/INGO/22078,6/13/2023 8:57:48 AM,Host Communities,2611,2829,2509,2718,10667,3833,4153,3683,3989,15658
18,CAR,2022,CAR-22/HCF10/RA2/HLT/INGO/22078,6/13/2023 8:57:48 AM,Internally Displaced People,2749,2978,2641,2861,11229,4035,4371,3877,4202,16485
18,CAR,2022,CAR-22/HCF10/RA2/HLT/INGO/22078,6/13/2023 8:57:48 AM,Overall,6872,7445,6603,7153,28073,10087,10928,9692,10501,41208
18,CAR,2022,CAR-22/HCF10/RA2/HLT/INGO/22078,6/13/2023 8:57:48 AM,Returnees,1512,1638,1453,1574,6177,2219,2404,2132,2310,9065
18,CAR,2022,CAR-22/HCF10/RA3/COORD/INGO/23064,7/6/2023 9:29:06 AM,Other,75,45,0,0,120,60,25,0,0,85
18,CAR,2022,CAR-22/HCF10/RA3/COORD/INGO/23064,7/6/2023 9:29:06 AM,Overall,75,45,0,0,120,60,25,0,0,85
18,CAR,2022,CAR-22/HCF10/RA3/COORD/INGO/23065,2/27/2023 7:31:00 AM,Other,188,0,0,0,188,188,0,0,0,188
18,CAR,2022,CAR-22/HCF10/RA3/COORD/INGO/23065,2/27/2023 7:31:00 AM,Overall,188,0,0,0,188,188,0,0,0,188
18,CAR,2022,CAR-22/HCF10/RA3/COORD/INGO/23066,3/2/2023 1:19:34 PM,Other,105,105,0,0,210,110,70,0,0,180
18,CAR,2022,CAR-22/HCF10/RA3/COORD/INGO/23066,3/2/2023 1:19:34 PM,Overall,105,105,0,0,210,110,70,0,0,180
18,CAR,2022,CAR-22/HCF10/RA3/COORD/INGO/23068,3/6/2023 10:05:09 AM,Other,125,0,0,0,125,125,0,0,0,125
18,CAR,2022,CAR-22/HCF10/RA3/COORD/INGO/23068,3/6/2023 10:05:09 AM,Overall,125,0,0,0,125,125,0,0,0,125
18,CAR,2022,CAR-22/HCF10/RA4 /PROT-EDU/INGO/24227,10/13/2023 11:53:57 AM,Host Communities,2402,4536,2496,4556,13990,3255,4574,5204,3676,16709
18,CAR,2022,CAR-22/HCF10/RA4 /PROT-EDU/INGO/24227,10/13/2023 11:53:57 AM,Internally Displaced People,16,79,25,23,143,17,88,32,27,164
18,CAR,2022,CAR-22/HCF10/RA4 /PROT-EDU/INGO/24227,10/13/2023 11:53:57 AM,Overall,3029,5519,2710,4826,16084,3974,5629,5442,4014,19059
18,CAR,2022,CAR-22/HCF10/RA4 /PROT-EDU/INGO/24227,10/13/2023 11:53:57 AM,Returnees,611,904,189,247,1951,702,967,206,311,2186
18,CAR,2022,CAR-22/HCF10/RA4 /WaSH/INGO/24248,9/26/2023 10:35:47 AM,Internally Displaced People,2257,2630,1770,1843,8500,2352,2950,1886,1945,9133
18,CAR,2022,CAR-22/HCF10/RA4 /WaSH/INGO/24248,9/26/2023 10:35:47 AM,Overall,2257,2630,1770,1843,8500,2352,2950,1886,1945,9133
18,CAR,2022,CAR-22/HCF10/SA1/COORD/INGO/21448,6/13/2023 10:49:48 AM,Other,188,0,0,0,188,188,0,0,0,188
18,CAR,2022,CAR-22/HCF10/SA1/COORD/INGO/21448,6/13/2023 10:49:48 AM,Overall,188,0,0,0,188,188,0,0,0,188
18,CAR,2022,CAR-22/HCF10/SA1/FSEC/INGO/21409,8/11/2023 9:14:46 AM,Host Communities,1795,1999,4585,3591,11970,2149,2472,3603,3803,12027
18,CAR,2022,CAR-22/HCF10/SA1/FSEC/INGO/21409,8/11/2023 9:14:46 AM,Internally Displaced People,1354,1508,3459,2709,9030,1486,1604,2091,1990,7171
18,CAR,2022,CAR-22/HCF10/SA1/FSEC/INGO/21409,8/11/2023 9:14:46 AM,Overall,3149,3507,8044,6300,21000,3635,4076,5694,5793,19198
18,CAR,2022,CAR-22/HCF10/SA1/FSEC/INGO/21411,8/11/2023 8:57:14 AM,Host Communities,1457,1501,1164,1141,5263,72,75,58,57,262
18,CAR,2022,CAR-22/HCF10/SA1/FSEC/INGO/21411,8/11/2023 8:57:14 AM,Internally Displaced People,5100,5255,4072,3995,18422,666,686,532,521,2405
18,CAR,2022,CAR-22/HCF10/SA1/FSEC/INGO/21411,8/11/2023 8:57:14 AM,Overall,6921,7131,5527,5421,25000,4805,4953,3838,3764,17360
18,CAR,2022,CAR-22/HCF10/SA1/FSEC/INGO/21411,8/11/2023 8:57:14 AM,Returnees,364,375,291,285,1315,4067,4192,3248,3186,14693
18,CAR,2022,CAR-22/HCF10/SA1/FSEC/INGO/21495,5/25/2023 2:48:05 PM,Host Communities,1503,1533,1497,1717,6250,3267,4387,2852,3608,14114
18,CAR,2022,CAR-22/HCF10/SA1/FSEC/INGO/21495,5/25/2023 2:48:05 PM,Internally Displaced People,4508,4598,4491,5153,18750,2313,3639,1940,3011,10903
18,CAR,2022,CAR-22/HCF10/SA1/FSEC/INGO/21495,5/25/2023 2:48:05 PM,Overall,6011,6131,5988,6870,25000,5580,8026,4792,6619,25017
18,CAR,2022,CAR-22/HCF10/SA1/FSEC/INGO/21499,3/22/2023 2:20:03 PM,Host Communities,765,887,612,796,3060,1153,1190,1079,1152,4574
18,CAR,2022,CAR-22/HCF10/SA1/FSEC/INGO/21499,3/22/2023 2:20:03 PM,Internally Displaced People,1275,1479,1020,1326,5100,1560,1667,1458,1563,6248
18,CAR,2022,CAR-22/HCF10/SA1/FSEC/INGO/21499,3/22/2023 2:20:03 PM,Overall,2550,2958,2040,2652,10200,3388,3514,3166,3389,13457
18,CAR,2022,CAR-22/HCF10/SA1/FSEC/INGO/21499,3/22/2023 2:20:03 PM,Returnees,510,592,408,530,2040,675,657,629,674,2635
18,CAR,2022,CAR-22/HCF10/SA1/FSEC/NGO/21416,5/4/2023 1:16:20 PM,Host Communities,650,550,350,325,1875,310,539,403,319,1571
18,CAR,2022,CAR-22/HCF10/SA1/FSEC/NGO/21416,5/4/2023 1:16:20 PM,Internally Displaced People,2500,2100,1550,1350,7500,2310,1319,1415,1790,6834
18,CAR,2022,CAR-22/HCF10/SA1/FSEC/NGO/21416,5/4/2023 1:16:20 PM,Overall,4400,3650,2350,2100,12500,3730,2697,2616,3019,12062
18,CAR,2022,CAR-22/HCF10/SA1/FSEC/NGO/21416,5/4/2023 1:16:20 PM,Returnees,1250,1000,450,425,3125,1110,839,798,910,3657
18,CAR,2022,CAR-22/HCF10/SA1/HLT/INGO/21504,3/31/2023 10:40:58 AM,Host Communities,1660,2857,1018,1064,6599,1380,2836,381,391,4988
18,CAR,2022,CAR-22/HCF10/SA1/HLT/INGO/21504,3/31/2023 10:40:58 AM,Internally Displaced People,1112,1134,1070,1117,4433,714,1590,143,151,2598
18,CAR,2022,CAR-22/HCF10/SA1/HLT/INGO/21504,3/31/2023 10:40:58 AM,Overall,2772,3991,2088,2181,11032,2094,4426,524,542,7586
18,CAR,2022,CAR-22/HCF10/SA1/LOG/UN/21482,12/15/2022 10:50:34 AM,Other,0,0,0,20,20,0,0,0,17,17
18,CAR,2022,CAR-22/HCF10/SA1/LOG/UN/21482,12/15/2022 10:50:34 AM,Overall,0,0,0,20,20,0,0,0,17,17
18,CAR,2022,CAR-22/HCF10/SA1/NFI-CCCM/INGO/21432,12/2/2022 8:31:28 PM,Host Communities,85,103,127,155,470,87,106,130,152,475
18,CAR,2022,CAR-22/HCF10/SA1/NFI-CCCM/INGO/21432,12/2/2022 8:31:28 PM,Internally Displaced People,626,765,938,1146,3475,634,770,936,1151,3491
18,CAR,2022,CAR-22/HCF10/SA1/NFI-CCCM/INGO/21432,12/2/2022 8:31:28 PM,Overall,1071,1308,1605,1961,5945,1084,1319,1612,1970,5985
18,CAR,2022,CAR-22/HCF10/SA1/NFI-CCCM/INGO/21432,12/2/2022 8:31:28 PM,Returnees,360,440,540,660,2000,363,443,546,667,2019
18,CAR,2022,CAR-22/HCF10/SA1/PROT/INGO/21520,2/15/2023 6:21:46 AM,Host Communities,505,505,675,675,2360,777,511,903,939,3130
18,CAR,2022,CAR-22/HCF10/SA1/PROT/INGO/21520,2/15/2023 6:21:46 AM,Internally Displaced People,170,170,225,225,790,75,89,98,80,342
18,CAR,2022,CAR-22/HCF10/SA1/PROT/INGO/21520,2/15/2023 6:21:46 AM,Overall,675,675,900,900,3150,852,600,1001,1019,3472
18,CAR,2022,CAR-22/HCF10/SA1/WaSH/INGO/21410,6/2/2023 1:07:21 PM,Host Communities,1360,1415,1110,1155,5040,1462,1862,2631,2507,8462
18,CAR,2022,CAR-22/HCF10/SA1/WaSH/INGO/21410,6/2/2023 1:07:21 PM,Internally Displaced People,2270,2350,1850,1930,8400,374,422,651,654,2101
18,CAR,2022,CAR-22/HCF10/SA1/WaSH/INGO/21410,6/2/2023 1:07:21 PM,Overall,3780,3925,3080,3215,14000,4036,5232,7949,8046,25263
18,CAR,2022,CAR-22/HCF10/SA1/WaSH/INGO/21410,6/2/2023 1:07:21 PM,Returnees,150,160,120,130,560,2200,2948,4667,4885,14700
18,CAR,2022,CAR-22/HCF10/SA1/WaSH/INGO/21435,6/29/2023 7:08:34 AM,Host Communities,200,200,200,200,800,131,200,319,238,888
18,CAR,2022,CAR-22/HCF10/SA1/WaSH/INGO/21435,6/29/2023 7:08:34 AM,Internally Displaced People,542,1119,816,1483,3960,648,1119,1570,1483,4820
18,CAR,2022,CAR-22/HCF10/SA1/WaSH/INGO/21435,6/29/2023 7:08:34 AM,Overall,1367,1944,1641,2308,7260,1107,1599,2687,2315,7708
18,CAR,2022,CAR-22/HCF10/SA1/WaSH/INGO/21435,6/29/2023 7:08:34 AM,Returnees,625,625,625,625,2500,328,280,798,594,2000
18,CAR,2022,CAR-22/HCF10/SA1/WaSH/INGO/21506,3/23/2023 10:31:50 AM,Internally Displaced People,6068,7067,4757,4953,22845,5829,6790,4571,4759,21949
18,CAR,2022,CAR-22/HCF10/SA1/WaSH/INGO/21506,3/23/2023 10:31:50 AM,Overall,6068,7067,4757,4953,22845,5829,6790,4571,4759,21949
18,CAR,2022,CAR-22/HCF10/SA1/WaSH/INGO/21523,12/19/2022 1:24:43 PM,Host Communities,2797,3244,2237,2908,11186,2495,2894,1996,2594,9979
18,CAR,2022,CAR-22/HCF10/SA1/WaSH/INGO/21523,12/19/2022 1:24:43 PM,Internally Displaced People,6639,7701,5311,6905,26556,6791,7877,5433,7062,27163
18,CAR,2022,CAR-22/HCF10/SA1/WaSH/INGO/21523,12/19/2022 1:24:43 PM,Overall,11083,12855,8865,11525,44328,11802,13689,9441,12272,47204
18,CAR,2022,CAR-22/HCF10/SA1/WaSH/INGO/21523,12/19/2022 1:24:43 PM,Returnees,1647,1910,1317,1712,6586,2516,2918,2012,2616,10062
18,CAR,2022,CAR-22/HCF10/SA1/WaSH-CCCM/INGO/21412,6/13/2023 9:42:09 AM,Host Communities,4,4,0,0,8,4,0,0,0,4
18,CAR,2022,CAR-22/HCF10/SA1/WaSH-CCCM/INGO/21412,6/13/2023 9:42:09 AM,Internally Displaced People,2915,3842,4853,4934,16544,2113,2144,6163,5384,15804
18,CAR,2022,CAR-22/HCF10/SA1/WaSH-CCCM/INGO/21412,6/13/2023 9:42:09 AM,Overall,2919,3846,4853,4934,16552,2117,2144,6163,5384,15808
18,CAR,2022,CAR-22/HCF10/SA2/HLT-NUT-WaSH-PROT/INGO/23187,9/6/2023 10:10:55 AM,Host Communities,16355,12338,3084,4089,35866,16355,12338,3084,4089,35866
18,CAR,2022,CAR-22/HCF10/SA2/HLT-NUT-WaSH-PROT/INGO/23187,9/6/2023 10:10:55 AM,Internally Displaced People,3817,2880,720,954,8371,3817,2880,720,954,8371
18,CAR,2022,CAR-22/HCF10/SA2/HLT-NUT-WaSH-PROT/INGO/23187,9/6/2023 10:10:55 AM,Overall,20172,15218,3804,5043,44237,20172,15218,3804,5043,44237
18,CAR,2022,CAR-22/HCF10/SA2/LOG/UN/23178,7/6/2023 3:14:24 PM,Other,0,0,0,20,20,0,0,0,55,55
18,CAR,2022,CAR-22/HCF10/SA2/LOG/UN/23178,7/6/2023 3:14:24 PM,Overall,0,0,0,20,20,0,0,0,55,55
18,CAR,2022,CAR-22/HCF10/SA2/NFI-CCCM-WaSH/INGO/23177,8/30/2023 7:44:21 AM,Host Communities,1439,1759,2159,2639,7996,1466,1792,2199,2687,8144
18,CAR,2022,CAR-22/HCF10/SA2/NFI-CCCM-WaSH/INGO/23177,8/30/2023 7:44:21 AM,Internally Displaced People,1365,1669,2048,2503,7585,1372,1677,2058,2515,7622
18,CAR,2022,CAR-22/HCF10/SA2/NFI-CCCM-WaSH/INGO/23177,8/30/2023 7:44:21 AM,Overall,2804,3428,4207,5142,15581,2838,3469,4257,5202,15766
18,CAR,2022,CAR-22/HCF10/SA2/PROT/INGO/23282,9/6/2023 10:42:53 AM,Host Communities,2300,2550,1007,1055,6912,2400,3000,850,1250,7500
18,CAR,2022,CAR-22/HCF10/SA2/PROT/INGO/23282,9/6/2023 10:42:53 AM,Internally Displaced People,2900,3475,1053,1325,8753,2822,5000,1400,1800,11022
18,CAR,2022,CAR-22/HCF10/SA2/PROT/INGO/23282,9/6/2023 10:42:53 AM,Overall,5795,7020,2860,3475,19150,8862,15008,3971,5361,33202
18,CAR,2022,CAR-22/HCF10/SA2/PROT/INGO/23282,9/6/2023 10:42:53 AM,Returnees,595,995,800,1095,3485,3640,7008,1721,2311,14680
17,CAR (UNDP),2014,CAR-14/HCF10/R/EDU/INGO/1104,10/26/2017 10:13:49 AM,Host Communities,6200,5600,3800,3200,18800,10850,6266,5566,3581,26263
17,CAR (UNDP),2014,CAR-14/HCF10/R/EDU/INGO/1104,10/26/2017 10:13:49 AM,Internally Displaced People,1550,1400,950,750,4650,2140,1950,1431,1044,6565
17,CAR (UNDP),2014,CAR-14/HCF10/R/EDU/INGO/1104,10/26/2017 10:13:49 AM,Overall,7750,7000,4570,3950,23270,12990,8216,6997,4625,32828
17,CAR (UNDP),2014,CAR-14/HCF10/R/EDU/NGO/1103,7/8/2016 11:51:50 AM,Host Communities,379,74,15179,8481,24113,380,74,15178,8481,24113
17,CAR (UNDP),2014,CAR-14/HCF10/R/EDU/NGO/1103,7/8/2016 11:51:50 AM,Internally Displaced People,74,13,2821,1519,4427,78,35,2910,1681,4704
17,CAR (UNDP),2014,CAR-14/HCF10/R/EDU/NGO/1103,7/8/2016 11:51:50 AM,Overall,453,87,18000,10000,28540,453,87,18000,10277,28817
17,CAR (UNDP),2014,CAR-14/HCF10/SPA2/HLT/UN/1100,8/2/2017 3:07:17 PM,Overall,65921,68612,46534,48433,229500,40072,43412,29210,28642,141336
17,CAR (UNDP),2014,CAR-14/HCF10/SPA2/NFI-WaSH/INGO/1101,5/12/2016 9:47:46 AM,Other,0,0,0,0,0,4276,5665,5302,5333,20576
17,CAR (UNDP),2014,CAR-14/HCF10/SPA2/NFI-WaSH/INGO/1101,5/12/2016 9:47:46 AM,Overall,5057,7693,6125,6125,25000,4276,5665,5302,5333,20576
17,CAR (UNDP),2014,CAR-14/HCF10/SPA2/NUT-PROT/INGO/1105,8/4/2016 11:36:22 AM,Overall,6154,24280,7200,10800,48434,6154,24280,7200,10800,48434
17,CAR (UNDP),2014,CAR-14/HCF10/SPA2/PROT/INGO/1096,11/22/2016 3:12:04 PM,Host Communities,7350,7650,0,0,15000,0,0,0,0,0
17,CAR (UNDP),2014,CAR-14/HCF10/SPA2/PROT/INGO/1096,11/22/2016 3:12:04 PM,Overall,4000,5000,2880,3120,15000,0,0,0,0,0
17,CAR (UNDP),2014,CAR-14/HCF10/SPA2/PROT/INGO/1098,11/10/2016 2:36:57 PM,Overall,7810,10750,1050,1450,21060,7966,11489,2852,3343,25650
17,CAR (UNDP),2014,CAR-14/HCF10/SPA3/CCCM/INGO/1090,11/22/2016 3:11:00 PM,Internally Displaced People,28238,29376,0,0,57614,0,0,0,0,0
17,CAR (UNDP),2014,CAR-14/HCF10/SPA3/CCCM/INGO/1090,11/22/2016 3:11:00 PM,Overall,28238,29376,0,0,57614,0,0,0,0,0
17,CAR (UNDP),2014,CAR-14/HCF10/SPA3/FSEC/INGO/1086,7/25/2016 9:21:35 AM,Host Communities,2165,2474,742,804,6185,2165,2474,742,804,6185
17,CAR (UNDP),2014,CAR-14/HCF10/SPA3/FSEC/INGO/1086,7/25/2016 9:21:35 AM,Internally Displaced People,747,854,256,278,2135,747,854,256,278,2135
17,CAR (UNDP),2014,CAR-14/HCF10/SPA3/FSEC/INGO/1086,7/25/2016 9:21:35 AM,Overall,2912,3320,998,1090,8320,2912,3320,998,1090,8320
17,CAR (UNDP),2014,CAR-14/HCF10/SPA3/NUT/INGO/1088,9/23/2016 10:02:17 AM,Host Communities,25503,30098,20345,21175,97121,11772,9147,3848,3640,28407
17,CAR (UNDP),2014,CAR-14/HCF10/SPA3/NUT/INGO/1088,9/23/2016 10:02:17 AM,Overall,25503,30098,20345,21175,97121,11772,9147,3848,3640,28407
17,CAR (UNDP),2014,CAR-14/HCF10/SPA3/PROT-EDU/INGO/1093,9/23/2016 9:05:36 AM,Overall,1546,1674,3302,3438,9960,3826,2728,17467,12716,36737
17,CAR (UNDP),2014,CAR-14/HCF10/SPA3/WaSH-PROT/INGO/1092,9/22/2017 9:32:51 AM,Internally Displaced People,107,364,140,160,771,107,364,140,160,771
17,CAR (UNDP),2014,CAR-14/HCF10/SPA3/WaSH-PROT/INGO/1092,9/22/2017 9:32:51 AM,Overall,2833,5328,1137,1202,10500,2833,5328,1137,1202,10500
17,CAR (UNDP),2014,CAR-14/R/EDU/INGO/1058,7/25/2016 10:00:45 AM,Overall,32,11,4687,5608,10338,0,0,0,0,0
17,CAR (UNDP),2014,CAR-14/R/NFI/INGO/1070,4/19/2016 7:12:42 AM,Host Communities,192,192,0,0,384,192,192,0,0,384
17,CAR (UNDP),2014,CAR-14/R/NFI/INGO/1070,4/19/2016 7:12:42 AM,Internally Displaced People,226,246,134,146,752,226,246,134,146,752
17,CAR (UNDP),2014,CAR-14/R/NFI/INGO/1070,4/19/2016 7:12:42 AM,Overall,418,438,134,146,1136,418,438,134,146,1136
17,CAR (UNDP),2014,CAR-14/R/NFI/INGO/1074,4/18/2016 1:39:15 PM,Host Communities,2205,2295,0,0,4500,0,0,0,0,0
17,CAR (UNDP),2014,CAR-14/R/NFI/INGO/1074,4/18/2016 1:39:15 PM,Internally Displaced People,2205,2295,0,0,4500,9689,10757,0,0,20446
17,CAR (UNDP),2014,CAR-14/R/NFI/INGO/1074,4/18/2016 1:39:15 PM,Other,5,5,0,0,10,4,6,0,0,10
17,CAR (UNDP),2014,CAR-14/R/NFI/INGO/1074,4/18/2016 1:39:15 PM,Overall,4415,4595,0,0,9010,5898,7876,3795,2877,20446
17,CAR (UNDP),2014,CAR-14/R/WaSH/INGO/1085,9/9/2016 1:49:42 PM,Internally Displaced People,5072,6723,1242,1580,14617,0,0,0,0,0
17,CAR (UNDP),2014,CAR-14/R/WaSH/INGO/1085,9/9/2016 1:49:42 PM,Overall,5072,6723,1242,1580,14617,0,0,0,0,0
17,CAR (UNDP),2014,CAR-14/SPA2/FSEC-HLT/NGO/1083,8/2/2017 3:10:29 PM,Host Communities,4600,8600,7000,5200,25400,5724,10194,9097,6491,31506
17,CAR (UNDP),2014,CAR-14/SPA2/FSEC-HLT/NGO/1083,8/2/2017 3:10:29 PM,Other,400,800,700,500,2400,1028,931,1203,957,4119
17,CAR (UNDP),2014,CAR-14/SPA2/FSEC-HLT/NGO/1083,8/2/2017 3:10:29 PM,Overall,7000,8600,7000,5200,27800,6349,11125,10300,7448,35222
17,CAR (UNDP),2014,CAR-14/SPA2/NUT/INGO/1080,9/23/2016 10:40:27 AM,Overall,47927,70910,9888,9628,138353,50935,53015,10805,11245,126000
17,CAR (UNDP),2014,CAR-14/SPA2/PROT-NFI-FSEC-WaSH/INGO/1082,7/11/2016 7:29:08 AM,Overall,11729,11700,13469,13469,50367,8508,8775,11375,11305,39963
17,CAR (UNDP),2014,CAR-14/SPA3/COORD/UN/1067,8/2/2017 2:58:10 PM,Other,60,0,0,0,60,60,0,0,0,60
17,CAR (UNDP),2014,CAR-14/SPA3/COORD/UN/1067,8/2/2017 2:58:10 PM,Overall,60,0,0,0,60,60,0,0,0,60
17,CAR (UNDP),2014,CAR-14/SPA3/EDU/NGO/1056,8/4/2016 10:51:00 AM,Overall,1113,1449,2051,1712,6325,1113,1449,2051,1712,6325
17,CAR (UNDP),2014,CAR-14/SPA3/EDU/NGO/1076,10/11/2017 8:07:54 AM,Host Communities,100,60,20,20,200,100,60,30,35,225
17,CAR (UNDP),2014,CAR-14/SPA3/EDU/NGO/1076,10/11/2017 8:07:54 AM,Internally Displaced People,100,60,20,20,200,100,60,20,20,200
17,CAR (UNDP),2014,CAR-14/SPA3/EDU/NGO/1076,10/11/2017 8:07:54 AM,Overall,200,120,40,40,400,107,285,30,35,457
17,CAR (UNDP),2014,CAR-14/SPA3/EDU/UN/1060,1/3/2017 3:43:00 PM,Overall,322,153,15000,15000,30475,263,106,15924,15547,31840
17,CAR (UNDP),2014,CAR-14/SPA3/FSEC/INGO/1068,7/4/2016 2:34:55 PM,Overall,3801,3893,2523,2853,13070,21936,12264,0,0,34200
17,CAR (UNDP),2014,CAR-14/SPA3/HLT/INGO/1048,8/4/2016 11:31:35 AM,Host Communities,0,0,0,0,0,3983,13275,12819,12295,42372
17,CAR (UNDP),2014,CAR-14/SPA3/HLT/INGO/1048,8/4/2016 11:31:35 AM,Overall,26,4700,6732,7293,18751,3983,13275,12819,12295,42372
17,CAR (UNDP),2014,CAR-14/SPA3/HLT/NGO/1050,3/10/2016 4:30:01 PM,Overall,47452,55096,34133,35526,172207,23083,29497,16987,17056,86623
17,CAR (UNDP),2014,CAR-14/SPA3/HLT/NGO/1057,8/2/2017 2:57:27 PM,Host Communities,18210,27315,22762,22762,91049,18210,27315,22762,22762,91049
17,CAR (UNDP),2014,CAR-14/SPA3/HLT/NGO/1057,8/2/2017 2:57:27 PM,Internally Displaced People,12140,18210,15175,15175,60700,12140,18210,15175,15175,60700
17,CAR (UNDP),2014,CAR-14/SPA3/HLT/NGO/1057,8/2/2017 2:57:27 PM,Overall,30350,45524,37937,37937,151748,30350,45524,37937,37937,151748
17,CAR (UNDP),2014,CAR-14/SPA3/HLT-PROT/NGO/1081,10/13/2018 12:45:32 PM,Host Communities,300,3000,1900,2700,7900,1014,3975,3601,3251,11841
17,CAR (UNDP),2014,CAR-14/SPA3/HLT-PROT/NGO/1081,10/13/2018 12:45:32 PM,Internally Displaced People,437,3144,3388,4000,10969,1307,4019,6241,5792,17359
17,CAR (UNDP),2014,CAR-14/SPA3/HLT-PROT/NGO/1081,10/13/2018 12:45:32 PM,Other,100,1000,1100,1300,3500,117,1205,1308,1403,4033
17,CAR (UNDP),2014,CAR-14/SPA3/HLT-PROT/NGO/1081,10/13/2018 12:45:32 PM,Overall,837,7144,6388,8000,22369,2438,9199,11150,10446,33233
17,CAR (UNDP),2014,CAR-14/SPA3/NUT/INGO/1051,7/4/2016 2:32:41 PM,Host Communities,295,301,6550,6711,13857,16,1085,5607,5992,12700
17,CAR (UNDP),2014,CAR-14/SPA3/NUT/INGO/1051,7/4/2016 2:32:41 PM,Internally Displaced People,15,15,345,353,728,0,0,0,0,0
17,CAR (UNDP),2014,CAR-14/SPA3/NUT/INGO/1051,7/4/2016 2:32:41 PM,Overall,310,316,6895,7064,14585,16,1085,5607,5992,12700
17,CAR (UNDP),2014,CAR-14/SPA3/NUT/UN/1052,7/1/2016 10:34:06 AM,Overall,0,0,2080,1920,4000,0,0,2248,2076,4324
17,CAR (UNDP),2014,CAR-14/SPA3/PROT/NGO/1053,4/12/2016 4:00:31 PM,Internally Displaced People,200,0,0,0,200,20000,0,0,0,20000
17,CAR (UNDP),2014,CAR-14/SPA3/PROT/NGO/1053,4/12/2016 4:00:31 PM,Other,44,0,0,0,44,78,0,0,0,78
17,CAR (UNDP),2014,CAR-14/SPA3/PROT/NGO/1053,4/12/2016 4:00:31 PM,Overall,6160,5491,6014,7030,24695,16085,24128,8535,12803,61551
17,CAR (UNDP),2014,CAR-14/SPA3/PROT/NGO/1053,4/12/2016 4:00:31 PM,Refugees,24,0,0,0,24,0,0,0,0,0
17,CAR (UNDP),2014,CAR-14/SPA3/PROT/NGO/1054,10/27/2016 7:58:57 AM,Overall,800,860,1180,1800,4640,1102,1627,2301,2248,7278
17,CAR (UNDP),2014,CAR-14/SPA3/PROT/NGO/1055,3/10/2016 1:44:36 PM,Overall,14000,22700,41650,43350,121700,62083,66299,43506,53174,225062
17,CAR (UNDP),2014,CAR-14/SPA3/WaSH/INGO/1059,11/19/2018 11:17:24 AM,Overall,15312,45932,14122,14698,90064,22948,23885,21183,22048,90064
17,CAR (UNDP),2014,CAR-14/SPA3/WaSH/INGO/1061,4/21/2016 7:50:16 AM,Host Communities,9735,10194,9793,10132,39854,10982,11500,11048,11430,44960
17,CAR (UNDP),2014,CAR-14/SPA3/WaSH/INGO/1061,4/21/2016 7:50:16 AM,Internally Displaced People,512,537,515,533,2097,132,138,133,137,540
17,CAR (UNDP),2014,CAR-14/SPA3/WaSH/INGO/1061,4/21/2016 7:50:16 AM,Overall,10247,10730,10308,10665,41950,11593,11840,11008,11060,45501
17,CAR (UNDP),2015,CAR-15/HCF10/9/EDU/INGO/1354,12/19/2016 8:24:41 AM,Host Communities,3377,3377,338,375,7467,3468,3141,1622,1348,9579
17,CAR (UNDP),2015,CAR-15/HCF10/9/EDU/INGO/1354,12/19/2016 8:24:41 AM,Internally Displaced People,1126,1126,112,125,2489,51,67,197,163,478
17,CAR (UNDP),2015,CAR-15/HCF10/9/EDU/INGO/1354,12/19/2016 8:24:41 AM,Overall,4503,4503,450,500,9956,3641,3298,1703,1415,10057
17,CAR (UNDP),2015,CAR-15/HCF10/9/EDU/UN/1301,3/1/2017 3:33:14 PM,Host Communities,29,19,400,500,948,57,32,930,998,2017
17,CAR (UNDP),2015,CAR-15/HCF10/9/EDU/UN/1301,3/1/2017 3:33:14 PM,Internally Displaced People,58,38,3700,4700,8496,85,75,5224,4570,9954
17,CAR (UNDP),2015,CAR-15/HCF10/9/EDU/UN/1301,3/1/2017 3:33:14 PM,Other,0,0,350,350,700,0,0,389,353,742
17,CAR (UNDP),2015,CAR-15/HCF10/9/EDU/UN/1301,3/1/2017 3:33:14 PM,Overall,87,57,4450,5550,10144,132,117,6547,5917,12713
17,CAR (UNDP),2015,CAR-15/HCF10/9/ER/INGO/1291,8/25/2016 11:47:09 AM,Host Communities,2593,2699,0,0,5292,2593,2699,0,0,5292
17,CAR (UNDP),2015,CAR-15/HCF10/9/ER/INGO/1291,8/25/2016 11:47:09 AM,Internally Displaced People,1111,1157,0,0,2268,1111,1157,0,0,2268
17,CAR (UNDP),2015,CAR-15/HCF10/9/ER/INGO/1291,8/25/2016 11:47:09 AM,Overall,3704,3856,0,0,7560,3704,3856,0,0,7560
17,CAR (UNDP),2015,CAR-15/HCF10/9/ER/INGO/1320,12/20/2016 3:18:22 PM,Host Communities,325,755,720,880,2680,2263,3395,0,0,5658
17,CAR (UNDP),2015,CAR-15/HCF10/9/ER/INGO/1320,12/20/2016 3:18:22 PM,Internally Displaced People,365,700,560,500,2125,1851,2778,0,0,4629
17,CAR (UNDP),2015,CAR-15/HCF10/9/ER/INGO/1320,12/20/2016 3:18:22 PM,Overall,690,1455,1280,1380,4805,4115,6172,0,0,10287
17,CAR (UNDP),2015,CAR-15/HCF10/9/ER/INGO/1339,1/21/2019 9:20:47 AM,Host Communities,155,202,300,225,882,155,202,300,225,882
17,CAR (UNDP),2015,CAR-15/HCF10/9/ER/INGO/1339,1/21/2019 9:20:47 AM,Internally Displaced People,10699,20380,10225,11341,52645,10699,20380,10225,11341,52645
17,CAR (UNDP),2015,CAR-15/HCF10/9/ER/INGO/1339,1/21/2019 9:20:47 AM,Other,3388,4029,3326,6952,17695,3388,4029,3326,6952,17695
17,CAR (UNDP),2015,CAR-15/HCF10/9/ER/INGO/1339,1/21/2019 9:20:47 AM,Overall,12350,24942,14400,15117,66809,12350,24942,14400,15117,66809
17,CAR (UNDP),2015,CAR-15/HCF10/9/ER/NGO/1258,2/20/2017 2:30:27 PM,Host Communities,3701,4009,3715,4025,15450,3701,4009,3715,4025,15450
17,CAR (UNDP),2015,CAR-15/HCF10/9/ER/NGO/1258,2/20/2017 2:30:27 PM,Internally Displaced People,45,45,58,62,210,45,45,45,45,180
17,CAR (UNDP),2015,CAR-15/HCF10/9/ER/NGO/1258,2/20/2017 2:30:27 PM,Overall,3746,4054,3777,4083,15660,3746,4054,3777,4083,15660
17,CAR (UNDP),2015,CAR-15/HCF10/9/FSEC/INGO/1287,12/28/2016 3:46:27 PM,Host Communities,960,1455,307,592,3314,1268,1902,0,0,3170
17,CAR (UNDP),2015,CAR-15/HCF10/9/FSEC/INGO/1287,12/28/2016 3:46:27 PM,Internally Displaced People,570,970,173,453,2166,718,1396,0,0,2114
17,CAR (UNDP),2015,CAR-15/HCF10/9/FSEC/INGO/1287,12/28/2016 3:46:27 PM,Overall,1530,2425,480,1045,5480,1479,2325,423,1057,5284
17,CAR (UNDP),2015,CAR-15/HCF10/9/FSEC/INGO/1293,9/25/2017 9:50:10 AM,Other,0,0,0,0,0,15148,11364,10,0,26522
17,CAR (UNDP),2015,CAR-15/HCF10/9/FSEC/INGO/1293,9/25/2017 9:50:10 AM,Overall,2189,2181,3086,2544,10000,7574,5682,5,0,13261
17,CAR (UNDP),2015,CAR-15/HCF10/9/FSEC/INGO/1304,12/9/2016 3:16:23 PM,Host Communities,200,710,875,1085,2870,300,366,1165,2568,4399
17,CAR (UNDP),2015,CAR-15/HCF10/9/FSEC/INGO/1304,12/9/2016 3:16:23 PM,Internally Displaced People,50,440,375,465,1330,0,0,0,0,0
17,CAR (UNDP),2015,CAR-15/HCF10/9/FSEC/INGO/1304,12/9/2016 3:16:23 PM,Overall,250,1150,1250,1550,4200,300,366,1165,2568,4399
17,CAR (UNDP),2015,CAR-15/HCF10/9/FSEC/INGO/1357,8/2/2017 3:52:31 PM,Host Communities,1765,1837,1837,1911,7350,2733,2622,2841,2733,10929
17,CAR (UNDP),2015,CAR-15/HCF10/9/FSEC/INGO/1357,8/2/2017 3:52:31 PM,Internally Displaced People,705,735,735,765,2940,1093,1049,1137,1083,4362
17,CAR (UNDP),2015,CAR-15/HCF10/9/FSEC/INGO/1357,8/2/2017 3:52:31 PM,Other,1059,1102,1102,1147,4410,1639,1574,1705,1639,6557
17,CAR (UNDP),2015,CAR-15/HCF10/9/FSEC/INGO/1357,8/2/2017 3:52:31 PM,Overall,3529,3674,3674,3823,14700,5465,5246,5682,5465,21858
17,CAR (UNDP),2015,CAR-15/HCF10/9/FSEC/NGO/1222,9/2/2019 10:11:18 AM,Host Communities,364,396,380,444,1584,759,825,792,924,3300
17,CAR (UNDP),2015,CAR-15/HCF10/9/FSEC/NGO/1222,9/2/2019 10:11:18 AM,Internally Displaced People,188,204,195,229,816,391,425,408,476,1700
17,CAR (UNDP),2015,CAR-15/HCF10/9/FSEC/NGO/1222,9/2/2019 10:11:18 AM,Overall,552,600,576,672,2400,1150,1250,1200,1400,5000
17,CAR (UNDP),2015,CAR-15/HCF10/9/HLT/INGO/1243,1/3/2017 8:58:21 AM,Host Communities,6766,13053,6990,8252,35061,6236,12587,6653,7857,33333
17,CAR (UNDP),2015,CAR-15/HCF10/9/HLT/INGO/1243,1/3/2017 8:58:21 AM,Internally Displaced People,1234,2310,2400,2800,8744,1123,2266,2195,2671,8255
17,CAR (UNDP),2015,CAR-15/HCF10/9/HLT/INGO/1243,1/3/2017 8:58:21 AM,Overall,8000,15363,9290,11052,43705,8711,13352,9394,10131,41588
17,CAR (UNDP),2015,CAR-15/HCF10/9/HLT/INGO/1266,10/29/2018 2:56:10 PM,Other,0,0,22872,0,22872,5021,5652,6306,6528,23507
17,CAR (UNDP),2015,CAR-15/HCF10/9/HLT/INGO/1266,10/29/2018 2:56:10 PM,Overall,4905,6914,5163,5927,22909,5820,7015,5598,8313,26746
17,CAR (UNDP),2015,CAR-15/HCF10/9/HLT/UN/1335,1/23/2019 1:40:35 PM,Host Communities,1973,2861,5945,6440,17219,2466,3579,7430,7890,21365
17,CAR (UNDP),2015,CAR-15/HCF10/9/HLT/UN/1335,1/23/2019 1:40:35 PM,Internally Displaced People,492,718,1486,1610,4306,0,0,0,0,0
17,CAR (UNDP),2015,CAR-15/HCF10/9/HLT/UN/1335,1/23/2019 1:40:35 PM,Overall,2465,3579,7431,8050,21525,2465,3579,7431,8050,21525
17,CAR (UNDP),2015,CAR-15/HCF10/9/HLT-PROT/INGO/1260,2/1/2017 11:20:04 AM,Host Communities,9914,11180,2692,3036,26822,2869,7214,10063,10123,30269
17,CAR (UNDP),2015,CAR-15/HCF10/9/HLT-PROT/INGO/1260,2/1/2017 11:20:04 AM,Other,2025,2283,424,478,5210,1747,4434,3470,3453,13104
17,CAR (UNDP),2015,CAR-15/HCF10/9/HLT-PROT/INGO/1260,2/1/2017 11:20:04 AM,Overall,11939,13463,3116,3514,32032,4616,11648,13533,13576,43373
17,CAR (UNDP),2015,CAR-15/HCF10/9/LOG/INGO/1277,9/27/2016 10:32:26 AM,Host Communities,17850,17150,0,0,35000,24480,23520,0,0,48000
17,CAR (UNDP),2015,CAR-15/HCF10/9/LOG/INGO/1277,9/27/2016 10:32:26 AM,Overall,17850,17150,0,0,35000,24480,23520,0,0,48000
17,CAR (UNDP),2015,CAR-15/HCF10/9/NFI/INGO/1332,10/8/2018 9:09:52 AM,Host Communities,2316,3260,4158,4158,13892,1136,2497,10544,13416,27593
17,CAR (UNDP),2015,CAR-15/HCF10/9/NFI/INGO/1332,10/8/2018 9:09:52 AM,Internally Displaced People,965,1358,1732,1732,5787,42,23,48,94,207
17,CAR (UNDP),2015,CAR-15/HCF10/9/NFI/INGO/1332,10/8/2018 9:09:52 AM,Other,579,814,1040,1040,3473,104,48,84,98,334
17,CAR (UNDP),2015,CAR-15/HCF10/9/NFI/INGO/1332,10/8/2018 9:09:52 AM,Overall,3860,5434,6930,6930,23154,1282,2568,10676,13608,28134
17,CAR (UNDP),2015,CAR-15/HCF10/9/NFI/INGO/1361,2/1/2017 2:49:50 PM,Internally Displaced People,1000,1000,1500,1500,5000,1303,1642,1925,3392,8262
17,CAR (UNDP),2015,CAR-15/HCF10/9/NFI/INGO/1361,2/1/2017 2:49:50 PM,Overall,1000,1000,1500,1500,5000,1303,1642,1925,3392,8262
17,CAR (UNDP),2015,CAR-15/HCF10/9/NFI/UN/1273,2/22/2019 11:47:54 AM,Internally Displaced People,8624,17504,785,1174,28087,8500,17600,800,1150,28050
17,CAR (UNDP),2015,CAR-15/HCF10/9/NFI/UN/1273,2/22/2019 11:47:54 AM,Overall,8624,17504,785,1174,28087,8500,17600,800,1150,28050
17,CAR (UNDP),2015,CAR-15/HCF10/9/NUT/INGO/1246,9/9/2016 3:02:08 PM,Host Communities,0,1605,165,207,1977,24,1600,3057,3400,8081
17,CAR (UNDP),2015,CAR-15/HCF10/9/NUT/INGO/1246,9/9/2016 3:02:08 PM,Internally Displaced People,0,65,235,109,409,0,70,300,71,441
17,CAR (UNDP),2015,CAR-15/HCF10/9/NUT/INGO/1246,9/9/2016 3:02:08 PM,Overall,0,1670,400,316,2386,24,1670,3357,3471,8522
17,CAR (UNDP),2015,CAR-15/HCF10/9/NUT/INGO/1261,10/27/2016 8:08:15 AM,Host Communities,206,8417,1212,1308,11143,0,0,1695,1824,3519
17,CAR (UNDP),2015,CAR-15/HCF10/9/NUT/INGO/1261,10/27/2016 8:08:15 AM,Internally Displaced People,97,110,23,5,235,0,0,0,0,0
17,CAR (UNDP),2015,CAR-15/HCF10/9/NUT/INGO/1261,10/27/2016 8:08:15 AM,Overall,303,8527,1235,1313,11378,0,0,1695,1824,3519
17,CAR (UNDP),2015,CAR-15/HCF10/9/NUT/INGO/1276,10/4/2016 4:03:01 PM,Host Communities,0,148,1546,1659,3353,0,17,1274,1659,2950
17,CAR (UNDP),2015,CAR-15/HCF10/9/NUT/INGO/1276,10/4/2016 4:03:01 PM,Overall,0,148,1546,1659,3353,0,17,1274,1659,2950
17,CAR (UNDP),2015,CAR-15/HCF10/9/NUT/INGO/1281,8/4/2016 3:38:29 PM,Host Communities,0,6069,6272,6272,18613,0,0,0,0,0
17,CAR (UNDP),2015,CAR-15/HCF10/9/NUT/INGO/1281,8/4/2016 3:38:29 PM,Overall,0,6069,6272,6272,18613,0,6069,6272,6272,18613
17,CAR (UNDP),2015,CAR-15/HCF10/9/NUT/INGO/1288,9/9/2016 1:59:09 PM,Host Communities,323,489,7527,7526,15865,307,775,10705,11116,22903
17,CAR (UNDP),2015,CAR-15/HCF10/9/NUT/INGO/1288,9/9/2016 1:59:09 PM,Internally Displaced People,17,26,396,396,835,16,41,563,585,1205
17,CAR (UNDP),2015,CAR-15/HCF10/9/NUT/INGO/1288,9/9/2016 1:59:09 PM,Overall,340,515,7923,7922,16700,323,816,11268,11701,24108
17,CAR (UNDP),2015,CAR-15/HCF10/9/NUT/UN/1238,1/23/2017 4:51:24 PM,Host Communities,0,0,3867,4189,8056,0,0,3630,3933,7563
17,CAR (UNDP),2015,CAR-15/HCF10/9/NUT/UN/1238,1/23/2017 4:51:24 PM,Overall,0,0,3867,4189,8056,0,0,3630,3933,7563
17,CAR (UNDP),2015,CAR-15/HCF10/9/PROT/INGO/1280,2/1/2019 8:20:31 AM,Host Communities,2655,2760,2970,2790,11175,9161,6716,9068,8671,33616
17,CAR (UNDP),2015,CAR-15/HCF10/9/PROT/INGO/1280,2/1/2019 8:20:31 AM,Internally Displaced People,1106,1150,1238,1163,4657,192,191,107,77,567
17,CAR (UNDP),2015,CAR-15/HCF10/9/PROT/INGO/1280,2/1/2019 8:20:31 AM,Other,664,690,743,698,2795,0,0,0,0,0
17,CAR (UNDP),2015,CAR-15/HCF10/9/PROT/INGO/1280,2/1/2019 8:20:31 AM,Overall,4425,4600,4650,4950,18625,9353,6907,9175,8748,34183
17,CAR (UNDP),2015,CAR-15/HCF10/9/PROT/INGO/1321,12/9/2016 4:09:03 PM,Host Communities,1051,1096,1462,1537,5146,365,609,228,312,1514
17,CAR (UNDP),2015,CAR-15/HCF10/9/PROT/INGO/1321,12/9/2016 4:09:03 PM,Internally Displaced People,349,364,488,513,1714,182,169,17,88,456
17,CAR (UNDP),2015,CAR-15/HCF10/9/PROT/INGO/1321,12/9/2016 4:09:03 PM,Overall,1400,1460,1950,2050,6860,547,778,245,400,1970
17,CAR (UNDP),2015,CAR-15/HCF10/9/PROT/UN/1338,12/4/2018 7:40:00 AM,Host Communities,0,0,0,0,0,20,263,314,236,833
17,CAR (UNDP),2015,CAR-15/HCF10/9/PROT/UN/1338,12/4/2018 7:40:00 AM,Internally Displaced People,7,292,162,78,539,17,294,95,123,529
17,CAR (UNDP),2015,CAR-15/HCF10/9/PROT/UN/1338,12/4/2018 7:40:00 AM,Other,3,98,108,52,261,0,0,0,0,0
17,CAR (UNDP),2015,CAR-15/HCF10/9/PROT/UN/1338,12/4/2018 7:40:00 AM,Overall,10,390,270,130,800,18,557,409,359,1343
17,CAR (UNDP),2015,CAR-15/HCF10/9/WaSH/INGO/1267,7/8/2016 3:50:09 PM,Internally Displaced People,186,103,125,109,523,158,116,140,128,542
17,CAR (UNDP),2015,CAR-15/HCF10/9/WaSH/INGO/1267,7/8/2016 3:50:09 PM,Overall,186,103,125,109,523,0,0,0,0,0
17,CAR (UNDP),2015,CAR-15/HCF10/9/WaSH/INGO/1303,12/28/2016 10:36:38 AM,Host Communities,5523,5600,5760,5679,22562,6993,7091,7293,7190,28567
17,CAR (UNDP),2015,CAR-15/HCF10/9/WaSH/INGO/1303,12/28/2016 10:36:38 AM,Other,2367,2400,2469,2434,9670,2997,3039,3126,3082,12244
17,CAR (UNDP),2015,CAR-15/HCF10/9/WaSH/INGO/1303,12/28/2016 10:36:38 AM,Overall,7890,8000,8229,8113,32232,9991,10129,10419,10272,40811
17,CAR (UNDP),2015,CAR-15/HCF10/9/WaSH/INGO/1316,9/27/2016 9:02:30 AM,Internally Displaced People,15395,14791,0,0,30186,8167,8398,8618,8848,34031
17,CAR (UNDP),2015,CAR-15/HCF10/9/WaSH/INGO/1316,9/27/2016 9:02:30 AM,Overall,15395,14791,0,0,30186,8167,8398,8618,8848,34031
17,CAR (UNDP),2015,CAR-15/HCF10/9/WaSH/INGO/1322,7/8/2016 10:40:28 AM,Internally Displaced People,134,69,25,25,253,692,356,123,135,1306
17,CAR (UNDP),2015,CAR-15/HCF10/9/WaSH/INGO/1322,7/8/2016 10:40:28 AM,Overall,1825,1825,1825,1825,7300,1722,1652,2315,2362,8051
17,CAR (UNDP),2015,CAR-15/HCF10/9/WaSH/INGO/1330,1/23/2017 4:47:02 PM,Host Communities,11045,11495,11495,11965,46000,11045,11495,11495,11965,46000
17,CAR (UNDP),2015,CAR-15/HCF10/9/WaSH/INGO/1330,1/23/2017 4:47:02 PM,Other,888,925,925,962,3700,0,0,0,0,0
17,CAR (UNDP),2015,CAR-15/HCF10/9/WaSH/INGO/1330,1/23/2017 4:47:02 PM,Overall,11933,12420,12420,12927,49700,11045,11495,11495,11965,46000
17,CAR (UNDP),2015,CAR-15/HCF10/R/CCCM/INGO/1125,5/9/2016 2:22:26 PM,Internally Displaced People,9671,9282,403,807,20163,4747,4747,5802,5802,21098
17,CAR (UNDP),2015,CAR-15/HCF10/R/CCCM/INGO/1125,5/9/2016 2:22:26 PM,Overall,9671,9282,403,807,20163,4747,4747,5802,5802,21098
17,CAR (UNDP),2015,CAR-15/HCF10/R/CCCM/INGO/1368,9/23/2016 11:35:20 AM,Internally Displaced People,4500,4500,5500,5500,20000,6079,6849,7647,7487,28062
17,CAR (UNDP),2015,CAR-15/HCF10/R/CCCM/INGO/1368,9/23/2016 11:35:20 AM,Overall,4500,4500,5500,5500,20000,6079,6849,7647,7487,28062
17,CAR (UNDP),2015,CAR-15/HCF10/R/CCCM/NGO/1211,8/2/2017 3:42:10 PM,Internally Displaced People,2006,4011,1003,3008,10028,2485,4969,1243,3726,12423
17,CAR (UNDP),2015,CAR-15/HCF10/R/CCCM/NGO/1211,8/2/2017 3:42:10 PM,Overall,2006,4011,1003,3008,10028,2485,4969,1243,3726,12423
17,CAR (UNDP),2015,CAR-15/HCF10/R/CCCM/NGO/1212,8/2/2017 3:45:00 PM,Internally Displaced People,2684,5374,1343,4031,13432,1565,1612,2752,2397,8326
17,CAR (UNDP),2015,CAR-15/HCF10/R/CCCM/NGO/1212,8/2/2017 3:45:00 PM,Overall,2684,5374,1343,4031,13432,1565,1612,2752,2397,8326
17,CAR (UNDP),2015,CAR-15/HCF10/R/CCCM/UN/1210,5/5/2016 8:54:19 AM,Internally Displaced People,4036,4201,5121,5005,18363,4036,4201,5121,5005,18363
17,CAR (UNDP),2015,CAR-15/HCF10/R/CCCM/UN/1210,5/5/2016 8:54:19 AM,Overall,4036,4201,5121,5005,18363,4036,4201,5121,5005,18363
17,CAR (UNDP),2015,CAR-15/HCF10/R/FSEC/UN/1220,1/23/2017 4:52:56 PM,Host Communities,3240,2160,1800,1800,9000,5400,3600,3000,3000,15000
17,CAR (UNDP),2015,CAR-15/HCF10/R/FSEC/UN/1220,1/23/2017 4:52:56 PM,Overall,3240,2160,1800,1800,9000,5400,3600,3000,3000,15000
17,CAR (UNDP),2015,CAR-15/HCF10/R/NFI/UN/1215,1/23/2017 2:36:36 PM,Host Communities,8621,8974,8282,8622,34499,3545,3686,3402,3545,14178
17,CAR (UNDP),2015,CAR-15/HCF10/R/NFI/UN/1215,1/23/2017 2:36:36 PM,Internally Displaced People,18680,19443,17947,18680,74750,5564,5787,5341,5564,22256
17,CAR (UNDP),2015,CAR-15/HCF10/R/NFI/UN/1215,1/23/2017 2:36:36 PM,Other,1437,1496,1381,1437,5751,11805,12277,11331,11805,47218
17,CAR (UNDP),2015,CAR-15/HCF10/R/NFI/UN/1215,1/23/2017 2:36:36 PM,Overall,28738,29912,27611,28739,115000,20913,21750,20076,20913,83652
17,CAR (UNDP),2015,CAR-15/HCF10/R/NUT-HLT/INGO/1208,5/3/2016 1:55:25 PM,Internally Displaced People,0,62,57,37,156,0,0,23,27,50
17,CAR (UNDP),2015,CAR-15/HCF10/R/NUT-HLT/INGO/1208,5/3/2016 1:55:25 PM,Other,0,705,554,625,1884,0,137,957,1039,2133
17,CAR (UNDP),2015,CAR-15/HCF10/R/NUT-HLT/INGO/1208,5/3/2016 1:55:25 PM,Overall,0,767,611,662,2040,0,137,934,1012,2083
17,CAR (UNDP),2015,CAR-15/HCF10/SA1/EDU/INGO/1132,12/22/2016 4:19:23 PM,Overall,49,16,3824,2326,6215,54,6,4003,2450,6513
17,CAR (UNDP),2015,CAR-15/HCF10/SA1/EDU/INGO/1152,1/25/2017 4:34:55 PM,Overall,72,34,2093,2437,4636,130,78,2584,2216,5008
17,CAR (UNDP),2015,CAR-15/HCF10/SA1/EDU/NGO/1171,2/27/2023 5:24:40 PM,Host Communities,53,23,4339,2333,6748,30,15,1600,1500,3145
17,CAR (UNDP),2015,CAR-15/HCF10/SA1/EDU/NGO/1171,2/27/2023 5:24:40 PM,Internally Displaced People,9,7,456,288,760,29,13,3009,1013,4064
17,CAR (UNDP),2015,CAR-15/HCF10/SA1/EDU/NGO/1171,2/27/2023 5:24:40 PM,Overall,61,31,4795,2622,7509,59,28,4609,2513,7209
17,CAR (UNDP),2015,CAR-15/HCF10/SA1/ER/INGO/1166,9/1/2016 2:09:05 PM,Host Communities,3400,3500,2500,2800,12200,1700,1750,1250,1400,6100
17,CAR (UNDP),2015,CAR-15/HCF10/SA1/ER/INGO/1166,9/1/2016 2:09:05 PM,Internally Displaced People,1000,1500,1000,1200,4700,500,750,500,600,2350
17,CAR (UNDP),2015,CAR-15/HCF10/SA1/ER/INGO/1166,9/1/2016 2:09:05 PM,Overall,4400,5000,3500,4000,16900,2200,2500,1750,2000,8450
17,CAR (UNDP),2015,CAR-15/HCF10/SA1/ER/INGO/1176,10/16/2018 8:10:10 AM,Overall,30,90,0,0,120,84,78,0,0,162
17,CAR (UNDP),2015,CAR-15/HCF10/SA1/ER/INGO/1177,11/1/2018 11:30:04 AM,Overall,48,47,30,20,145,84,45,30,20,179
17,CAR (UNDP),2015,CAR-15/HCF10/SA1/FSEC/INGO/1126,12/2/2016 1:26:32 PM,Host Communities,6902,10948,2618,3332,23800,11570,12230,0,0,23800
17,CAR (UNDP),2015,CAR-15/HCF10/SA1/FSEC/INGO/1126,12/2/2016 1:26:32 PM,Internally Displaced People,990,2385,529,596,4500,2540,1960,0,0,4500
17,CAR (UNDP),2015,CAR-15/HCF10/SA1/FSEC/INGO/1126,12/2/2016 1:26:32 PM,Overall,7641,13584,3113,3962,28300,14110,14190,0,0,28300
17,CAR (UNDP),2015,CAR-15/HCF10/SA1/FSEC/NGO/1112,10/4/2016 9:36:19 AM,Host Communities,1825,1775,75,100,3775,1732,1671,78,97,3578
17,CAR (UNDP),2015,CAR-15/HCF10/SA1/FSEC/NGO/1112,10/4/2016 9:36:19 AM,Internally Displaced People,500,625,50,50,1225,713,609,52,48,1422
17,CAR (UNDP),2015,CAR-15/HCF10/SA1/FSEC/NGO/1112,10/4/2016 9:36:19 AM,Overall,2325,2400,125,150,5000,2445,2280,130,145,5000
17,CAR (UNDP),2015,CAR-15/HCF10/SA1/FSEC-ER/NGO/1143,8/31/2016 4:12:55 PM,Host Communities,60,60,180,200,500,60,60,180,200,500
17,CAR (UNDP),2015,CAR-15/HCF10/SA1/FSEC-ER/NGO/1143,8/31/2016 4:12:55 PM,Internally Displaced People,30,30,120,180,360,30,30,120,180,360
17,CAR (UNDP),2015,CAR-15/HCF10/SA1/FSEC-ER/NGO/1143,8/31/2016 4:12:55 PM,Other,7885,7885,8925,9045,33740,7885,7885,8925,9045,33740
17,CAR (UNDP),2015,CAR-15/HCF10/SA1/FSEC-ER/NGO/1143,8/31/2016 4:12:55 PM,Overall,7975,7975,9225,9425,34600,8300,8500,9480,9725,36005
17,CAR (UNDP),2015,CAR-15/HCF10/SA1/HLT/INGO/1150,10/4/2016 4:01:46 PM,Internally Displaced People,0,0,4500,3500,8000,0,0,8420,3609,12029
17,CAR (UNDP),2015,CAR-15/HCF10/SA1/HLT/INGO/1150,10/4/2016 4:01:46 PM,Overall,95,50,23600,18600,42345,163,210,29683,12721,42777
17,CAR (UNDP),2015,CAR-15/HCF10/SA1/HLT/INGO/1189,10/29/2018 2:42:53 PM,Overall,10945,11392,8257,8594,39188,1031,1409,3879,3460,9779
17,CAR (UNDP),2015,CAR-15/HCF10/SA1/HLT-NUT-PROT/INGO/1163,5/5/2016 10:23:52 AM,Host Communities,5689,5921,0,0,11610,3575,4645,0,0,8220
17,CAR (UNDP),2015,CAR-15/HCF10/SA1/HLT-NUT-PROT/INGO/1163,5/5/2016 10:23:52 AM,Overall,5689,5921,0,0,11610,3575,4645,0,0,8220
17,CAR (UNDP),2015,CAR-15/HCF10/SA1/HLT-PROT/INGO/1131,2/23/2016 10:10:04 AM,Overall,7785,15565,10895,10895,45140,13625,20494,22625,19403,76147
17,CAR (UNDP),2015,CAR-15/HCF10/SA1/NFI/INGO/1173,8/2/2017 3:29:03 PM,Internally Displaced People,4125,4125,4125,4125,16500,1303,1729,2735,2849,8616
17,CAR (UNDP),2015,CAR-15/HCF10/SA1/NFI/INGO/1173,8/2/2017 3:29:03 PM,Overall,4125,4125,4125,4125,16500,1303,1729,2735,2849,8616
17,CAR (UNDP),2015,CAR-15/HCF10/SA1/NUT/INGO/1141,12/5/2017 10:51:27 AM,Host Communities,0,2720,4940,7410,15070,0,1469,2118,3807,7394
17,CAR (UNDP),2015,CAR-15/HCF10/SA1/NUT/INGO/1141,12/5/2017 10:51:27 AM,Overall,0,2720,4940,7410,15070,0,1469,2118,3807,7394
17,CAR (UNDP),2015,CAR-15/HCF10/SA1/PROT/INGO/1120,1/21/2019 11:57:11 AM,Host Communities,173,2082,173,1041,3469,0,0,0,0,0
17,CAR (UNDP),2015,CAR-15/HCF10/SA1/PROT/INGO/1120,1/21/2019 11:57:11 AM,Internally Displaced People,173,2082,173,1041,3469,0,0,0,0,0
17,CAR (UNDP),2015,CAR-15/HCF10/SA1/PROT/INGO/1120,1/21/2019 11:57:11 AM,Overall,347,4164,347,2082,6940,347,4164,347,2082,6940
17,CAR (UNDP),2015,CAR-15/HCF10/SA1/PROT/INGO/1161,5/10/2016 8:40:35 AM,Internally Displaced People,810,1002,480,558,2850,1234,1526,865,765,4390
17,CAR (UNDP),2015,CAR-15/HCF10/SA1/PROT/INGO/1161,5/10/2016 8:40:35 AM,Overall,4495,4495,2765,2775,14530,4567,4519,3326,3187,15599
17,CAR (UNDP),2015,CAR-15/HCF10/SA1/PROT/UN/1201,11/29/2018 2:35:23 PM,Host Communities,80,70,6500,6500,13150,99,29,6124,4818,11070
17,CAR (UNDP),2015,CAR-15/HCF10/SA1/PROT/UN/1201,11/29/2018 2:35:23 PM,Overall,80,70,6500,6500,13150,99,29,6124,4818,11070
17,CAR (UNDP),2015,CAR-15/HCF10/SA1/PROT-ER/INGO/1129,10/4/2017 8:10:59 AM,Host Communities,120,260,700,1100,2180,50,100,600,1000,1750
17,CAR (UNDP),2015,CAR-15/HCF10/SA1/PROT-ER/INGO/1129,10/4/2017 8:10:59 AM,Internally Displaced People,120,260,350,550,1280,78,150,800,900,1928
17,CAR (UNDP),2015,CAR-15/HCF10/SA1/PROT-ER/INGO/1129,10/4/2017 8:10:59 AM,Other,60,130,300,500,990,20,0,75,100,195
17,CAR (UNDP),2015,CAR-15/HCF10/SA1/PROT-ER/INGO/1129,10/4/2017 8:10:59 AM,Overall,300,650,1350,2150,4450,148,250,1883,2122,4403
17,CAR (UNDP),2015,CAR-15/HCF10/SA1/WaSH/INGO/1128,5/10/2016 8:49:33 AM,Host Communities,3000,3000,4500,4500,15000,3000,3000,4500,4500,15000
17,CAR (UNDP),2015,CAR-15/HCF10/SA1/WaSH/INGO/1128,5/10/2016 8:49:33 AM,Internally Displaced People,8000,8000,12000,12000,40000,13313,13313,19970,19970,66566
17,CAR (UNDP),2015,CAR-15/HCF10/SA1/WaSH/INGO/1128,5/10/2016 8:49:33 AM,Overall,11000,11000,16500,16500,55000,16313,16313,24470,24470,81566
17,CAR (UNDP),2016,CAR-16/HCF10/10/CCCM/INGO/1422,9/27/2017 4:16:24 PM,Internally Displaced People,6079,6849,7647,7487,28062,6539,7950,6955,6857,28301
17,CAR (UNDP),2016,CAR-16/HCF10/10/CCCM/INGO/1422,9/27/2017 4:16:24 PM,Overall,6079,6849,7647,7487,28062,0,0,0,0,0
17,CAR (UNDP),2016,CAR-16/HCF10/10/EDU/INGO/1395,9/19/2017 1:34:19 PM,Overall,320,113,6200,4125,10758,321,23,6214,4186,10744
17,CAR (UNDP),2016,CAR-16/HCF10/10/EDU/NGO/1388,10/29/2018 3:33:53 PM,Host Communities,867,1050,1950,2320,6187,750,978,1865,2001,5594
17,CAR (UNDP),2016,CAR-16/HCF10/10/EDU/NGO/1388,10/29/2018 3:33:53 PM,Internally Displaced People,987,1250,2250,2750,7237,805,976,1999,2001,5781
17,CAR (UNDP),2016,CAR-16/HCF10/10/EDU/NGO/1388,10/29/2018 3:33:53 PM,Other,995,1260,2265,2767,7287,1345,1546,5450,5970,14311
17,CAR (UNDP),2016,CAR-16/HCF10/10/EDU/NGO/1388,10/29/2018 3:33:53 PM,Overall,2849,3560,6465,7837,20711,2900,3500,5450,5970,17820
17,CAR (UNDP),2016,CAR-16/HCF10/10/FSEC/INGO/1426,9/15/2017 8:04:30 AM,Host Communities,533,532,530,521,2116,480,700,500,620,2300
17,CAR (UNDP),2016,CAR-16/HCF10/10/FSEC/INGO/1426,9/15/2017 8:04:30 AM,Internally Displaced People,584,586,588,596,2354,526,520,320,512,1878
17,CAR (UNDP),2016,CAR-16/HCF10/10/FSEC/INGO/1426,9/15/2017 8:04:30 AM,Other,560,560,580,580,2280,194,343,254,268,1059
17,CAR (UNDP),2016,CAR-16/HCF10/10/FSEC/INGO/1426,9/15/2017 8:04:30 AM,Overall,1677,1678,1698,1697,6750,1200,1563,1074,1400,5237
17,CAR (UNDP),2016,CAR-16/HCF10/10/FSEC/INGO/1443,11/2/2017 8:08:54 AM,Host Communities,151,185,80,94,510,87,107,46,55,295
17,CAR (UNDP),2016,CAR-16/HCF10/10/FSEC/INGO/1443,11/2/2017 8:08:54 AM,Internally Displaced People,1370,1670,737,900,4677,792,966,426,521,2705
17,CAR (UNDP),2016,CAR-16/HCF10/10/FSEC/INGO/1443,11/2/2017 8:08:54 AM,Overall,1521,1855,817,994,5187,879,1073,473,575,3000
17,CAR (UNDP),2016,CAR-16/HCF10/10/FSEC/NGO/1390,4/11/2018 11:12:07 AM,Host Communities,729,891,1094,1336,4050,729,891,1094,1336,4050
17,CAR (UNDP),2016,CAR-16/HCF10/10/FSEC/NGO/1390,4/11/2018 11:12:07 AM,Internally Displaced People,171,209,256,314,950,171,209,256,314,950
17,CAR (UNDP),2016,CAR-16/HCF10/10/FSEC/NGO/1390,4/11/2018 11:12:07 AM,Overall,900,1100,1350,1650,5000,900,1100,1350,1650,5000
17,CAR (UNDP),2016,CAR-16/HCF10/10/FSEC/NGO/1418,10/31/2017 3:58:50 PM,Host Communities,455,495,475,555,1980,455,470,475,530,1930
17,CAR (UNDP),2016,CAR-16/HCF10/10/FSEC/NGO/1418,10/31/2017 3:58:50 PM,Internally Displaced People,683,742,713,832,2970,683,767,713,857,3020
17,CAR (UNDP),2016,CAR-16/HCF10/10/FSEC/NGO/1418,10/31/2017 3:58:50 PM,Overall,1138,1238,1188,1386,4950,1138,1238,1188,1386,4950
17,CAR (UNDP),2016,CAR-16/HCF10/10/FSEC/UN/1431,10/12/2017 12:51:01 PM,Host Communities,600,1250,0,0,1850,503,932,99,109,1643
17,CAR (UNDP),2016,CAR-16/HCF10/10/FSEC/UN/1431,10/12/2017 12:51:01 PM,Internally Displaced People,400,850,0,0,1250,543,603,197,237,1580
17,CAR (UNDP),2016,CAR-16/HCF10/10/FSEC/UN/1431,10/12/2017 12:51:01 PM,Overall,1000,2100,0,0,3100,1335,1865,0,0,3200
17,CAR (UNDP),2016,CAR-16/HCF10/10/HLT/INGO/1406,9/14/2017 9:51:59 AM,Internally Displaced People,0,0,11200,7500,18700,0,0,10146,8998,19144
17,CAR (UNDP),2016,CAR-16/HCF10/10/HLT/INGO/1406,9/14/2017 9:51:59 AM,Overall,168,143,28410,18940,47661,257,204,25622,48805,74888
17,CAR (UNDP),2016,CAR-16/HCF10/10/HLT/INGO/1424,4/21/2017 3:29:54 PM,Host Communities,19441,20967,19923,20003,80334,16481,17824,16914,18982,70201
17,CAR (UNDP),2016,CAR-16/HCF10/10/HLT/INGO/1424,4/21/2017 3:29:54 PM,Internally Displaced People,2462,2614,2503,2513,10092,5422,5757,5512,5534,22225
17,CAR (UNDP),2016,CAR-16/HCF10/10/HLT/INGO/1424,4/21/2017 3:29:54 PM,Overall,21903,23581,22426,22516,90426,21903,23581,22426,22516,90426
17,CAR (UNDP),2016,CAR-16/HCF10/10/HLT/INGO/1432,9/20/2017 10:19:10 AM,Host Communities,10367,10790,0,0,21157,2238,2943,0,0,5181
17,CAR (UNDP),2016,CAR-16/HCF10/10/HLT/INGO/1432,9/20/2017 10:19:10 AM,Internally Displaced People,682,711,0,0,1393,1884,2055,0,0,3939
17,CAR (UNDP),2016,CAR-16/HCF10/10/HLT/INGO/1432,9/20/2017 10:19:10 AM,Overall,11049,11501,0,0,22550,4122,4998,0,0,9120
17,CAR (UNDP),2016,CAR-16/HCF10/10/HLT/INGO/1446,9/14/2017 9:38:27 AM,Host Communities,83,5069,6214,6467,17833,53,3453,1824,1898,7228
17,CAR (UNDP),2016,CAR-16/HCF10/10/HLT/INGO/1446,9/14/2017 9:38:27 AM,Overall,83,5169,6214,6467,17933,78,685,2691,5241,8695
17,CAR (UNDP),2016,CAR-16/HCF10/10/HLT/NGO/1497,1/22/2019 3:00:21 PM,Host Communities,0,0,0,0,0,124,250,130,200,704
17,CAR (UNDP),2016,CAR-16/HCF10/10/HLT/NGO/1497,1/22/2019 3:00:21 PM,Internally Displaced People,954,1215,659,772,3600,649,871,384,400,2304
17,CAR (UNDP),2016,CAR-16/HCF10/10/HLT/NGO/1497,1/22/2019 3:00:21 PM,Overall,954,1215,659,772,3600,879,932,584,613,3008
17,CAR (UNDP),2016,CAR-16/HCF10/10/HLT-PROT/UN/1455,2/7/2019 1:08:35 PM,Host Communities,17374,12252,12263,11080,52969,2724,24530,11469,15785,54508
17,CAR (UNDP),2016,CAR-16/HCF10/10/HLT-PROT/UN/1455,2/7/2019 1:08:35 PM,Internally Displaced People,11060,9337,4908,5357,30662,1257,11321,4305,8273,25156
17,CAR (UNDP),2016,CAR-16/HCF10/10/HLT-PROT/UN/1455,2/7/2019 1:08:35 PM,Overall,28514,21649,17231,16477,83871,4189,42868,16578,25346,88981
17,CAR (UNDP),2016,CAR-16/HCF10/10/HLT-PROT/UN/1455,2/7/2019 1:08:35 PM,Refugees,80,60,60,40,240,208,1885,804,1288,4185
17,CAR (UNDP),2016,CAR-16/HCF10/10/NFI/INGO/1437,10/13/2018 1:06:32 PM,Host Communities,882,1298,1575,1575,5330,4153,3468,3412,3826,14859
17,CAR (UNDP),2016,CAR-16/HCF10/10/NFI/INGO/1437,10/13/2018 1:06:32 PM,Internally Displaced People,882,1298,1575,1575,5330,669,697,695,725,2786
17,CAR (UNDP),2016,CAR-16/HCF10/10/NFI/INGO/1437,10/13/2018 1:06:32 PM,Other,1175,1731,2100,2100,7106,628,810,733,763,2934
17,CAR (UNDP),2016,CAR-16/HCF10/10/NFI/INGO/1437,10/13/2018 1:06:32 PM,Overall,2939,4327,5250,5250,17766,4781,4975,4840,5314,19910
17,CAR (UNDP),2016,CAR-16/HCF10/10/NFI/INGO/1469,12/7/2017 9:00:10 AM,Overall,0,0,0,25,25,0,0,0,25,25
17,CAR (UNDP),2016,CAR-16/HCF10/10/NFI/INGO/1476,2/13/2018 2:36:17 PM,Host Communities,240,240,288,432,1200,280,315,285,320,1200
17,CAR (UNDP),2016,CAR-16/HCF10/10/NFI/INGO/1476,2/13/2018 2:36:17 PM,Internally Displaced People,149,119,140,125,533,50,47,44,26,167
17,CAR (UNDP),2016,CAR-16/HCF10/10/NFI/INGO/1476,2/13/2018 2:36:17 PM,Other,132,64,0,0,196,157,40,0,0,197
17,CAR (UNDP),2016,CAR-16/HCF10/10/NFI/INGO/1476,2/13/2018 2:36:17 PM,Overall,389,359,557,428,1733,487,402,329,346,1564
17,CAR (UNDP),2016,CAR-16/HCF10/10/NFI/NGO/1481,2/23/2018 10:37:32 AM,Internally Displaced People,4368,4396,5406,5517,19687,4546,4543,5754,5518,20361
17,CAR (UNDP),2016,CAR-16/HCF10/10/NFI/NGO/1481,2/23/2018 10:37:32 AM,Overall,4368,4396,5406,5517,19687,4546,4543,5754,5518,20361
17,CAR (UNDP),2016,CAR-16/HCF10/10/NUT/INGO/1393,9/14/2017 9:28:36 AM,Host Communities,3500,11500,969,930,16899,3560,5810,243,290,9903
17,CAR (UNDP),2016,CAR-16/HCF10/10/NUT/INGO/1393,9/14/2017 9:28:36 AM,Overall,3500,11500,969,930,16899,3560,5810,243,290,9903
17,CAR (UNDP),2016,CAR-16/HCF10/10/NUT-HLT/INGO/1492,12/28/2016 10:45:03 AM,Host Communities,123,665,1379,1435,3602,95,22,383,360,860
17,CAR (UNDP),2016,CAR-16/HCF10/10/NUT-HLT/INGO/1492,12/28/2016 10:45:03 AM,Internally Displaced People,6,35,73,76,190,5,5,20,19,49
17,CAR (UNDP),2016,CAR-16/HCF10/10/NUT-HLT/INGO/1492,12/28/2016 10:45:03 AM,Overall,129,700,1452,1511,3792,100,27,403,379,909
17,CAR (UNDP),2016,CAR-16/HCF10/10/PROT/INGO/1410,9/6/2017 10:58:58 AM,Overall,30936,20624,38670,38670,128900,13066,13692,26252,23381,76391
17,CAR (UNDP),2016,CAR-16/HCF10/10/PROT/INGO/1415,10/12/2017 10:58:03 AM,Host Communities,3913,4240,4076,4077,16306,5200,6120,3802,4156,19278
17,CAR (UNDP),2016,CAR-16/HCF10/10/PROT/INGO/1415,10/12/2017 10:58:03 AM,Internally Displaced People,2113,2289,2201,2202,8805,2363,2620,2600,3541,11124
17,CAR (UNDP),2016,CAR-16/HCF10/10/PROT/INGO/1415,10/12/2017 10:58:03 AM,Other,1800,1950,1875,1877,7502,360,1110,1250,868,3588
17,CAR (UNDP),2016,CAR-16/HCF10/10/PROT/INGO/1415,10/12/2017 10:58:03 AM,Overall,7826,8479,8152,8156,32613,7923,9850,7652,8565,33990
17,CAR (UNDP),2016,CAR-16/HCF10/10/PROT/INGO/1451,10/19/2017 1:26:22 PM,Host Communities,302,302,4599,5211,10414,300,300,4599,5211,10410
17,CAR (UNDP),2016,CAR-16/HCF10/10/PROT/INGO/1451,10/19/2017 1:26:22 PM,Internally Displaced People,75,75,511,579,1240,70,50,401,389,910
17,CAR (UNDP),2016,CAR-16/HCF10/10/PROT/INGO/1451,10/19/2017 1:26:22 PM,Overall,377,377,5110,5790,11654,370,350,5000,5600,11320
17,CAR (UNDP),2016,CAR-16/HCF10/10/PROT/INGO/1501,9/14/2017 8:55:41 AM,Internally Displaced People,79792,83781,115698,119688,398959,85346,89535,123569,127830,426280
17,CAR (UNDP),2016,CAR-16/HCF10/10/PROT/INGO/1501,9/14/2017 8:55:41 AM,Other,40237,42248,58343,60355,201183,43014,45125,62287,64426,214852
17,CAR (UNDP),2016,CAR-16/HCF10/10/PROT/INGO/1501,9/14/2017 8:55:41 AM,Overall,120029,126029,174041,180043,600142,128360,134660,185856,192256,641132
17,CAR (UNDP),2016,CAR-16/HCF10/10/PROT/NGO/1374,1/22/2019 4:03:00 PM,Host Communities,1400,2300,2200,2800,8700,1300,2400,2000,2600,8300
17,CAR (UNDP),2016,CAR-16/HCF10/10/PROT/NGO/1374,1/22/2019 4:03:00 PM,Internally Displaced People,2200,1350,2800,1300,7650,2300,1250,2600,1200,7350
17,CAR (UNDP),2016,CAR-16/HCF10/10/PROT/NGO/1374,1/22/2019 4:03:00 PM,Overall,4000,5200,5600,4400,19200,3800,5400,5700,4300,19200
17,CAR (UNDP),2016,CAR-16/HCF10/10/PROT/NGO/1374,1/22/2019 4:03:00 PM,Refugees,400,1550,600,300,2850,400,1550,1000,600,3550
17,CAR (UNDP),2016,CAR-16/HCF10/10/PROT/NGO/1391,11/30/2017 3:37:14 PM,Host Communities,3670,4060,3940,4032,15702,5000,6000,5500,6000,22500
17,CAR (UNDP),2016,CAR-16/HCF10/10/PROT/NGO/1391,11/30/2017 3:37:14 PM,Internally Displaced People,30,40,60,68,198,700,800,300,1200,3000
17,CAR (UNDP),2016,CAR-16/HCF10/10/PROT/NGO/1391,11/30/2017 3:37:14 PM,Overall,3700,4100,4000,4100,15900,6000,7500,7000,5000,25500
17,CAR (UNDP),2016,CAR-16/HCF10/10/WaSH/INGO/1416,9/6/2017 10:33:38 AM,Host Communities,3539,3741,3159,3561,14000,1809,1912,2756,2902,9379
17,CAR (UNDP),2016,CAR-16/HCF10/10/WaSH/INGO/1416,9/6/2017 10:33:38 AM,Internally Displaced People,1517,1603,1353,1527,6000,539,569,821,864,2793
17,CAR (UNDP),2016,CAR-16/HCF10/10/WaSH/INGO/1416,9/6/2017 10:33:38 AM,Overall,5056,5344,4512,5088,20000,2385,2482,3577,3728,12172
17,CAR (UNDP),2016,CAR-16/HCF10/10/WaSH/INGO/1474,9/13/2017 11:47:07 AM,Host Communities,1276,1328,1296,1350,5250,1503,2254,2254,3380,9391
17,CAR (UNDP),2016,CAR-16/HCF10/10/WaSH/INGO/1474,9/13/2017 11:47:07 AM,Internally Displaced People,550,483,515,485,2033,81,48,15,23,167
17,CAR (UNDP),2016,CAR-16/HCF10/10/WaSH/INGO/1474,9/13/2017 11:47:07 AM,Other,182,190,185,193,750,821,1239,399,599,3058
17,CAR (UNDP),2016,CAR-16/HCF10/10/WaSH/INGO/1474,9/13/2017 11:47:07 AM,Overall,2008,2046,1996,2079,8129,2405,3541,2668,4002,12616
17,CAR (UNDP),2016,CAR-16/HCF10/10/WaSH/INGO/1482,10/3/2017 2:02:26 PM,Other,0,40,0,0,40,39,3,0,0,42
17,CAR (UNDP),2016,CAR-16/HCF10/10/WaSH/INGO/1482,10/3/2017 2:02:26 PM,Overall,0,40,0,0,40,0,0,0,0,0
17,CAR (UNDP),2016,CAR-16/HCF10/10/WaSH/INGO/1494,8/2/2017 3:59:08 PM,Host Communities,2880,3000,3000,3120,12000,2815,2933,2933,3050,11731
17,CAR (UNDP),2016,CAR-16/HCF10/10/WaSH/INGO/1494,8/2/2017 3:59:08 PM,Internally Displaced People,720,750,750,780,3000,20904,21775,21775,22646,87100
17,CAR (UNDP),2016,CAR-16/HCF10/10/WaSH/INGO/1494,8/2/2017 3:59:08 PM,Overall,3600,3750,3750,3900,15000,23719,24707,24707,25696,98829
17,CAR (UNDP),2016,CAR-16/HCF10/10/WaSH/NGO/1384,2/27/2023 5:38:47 PM,Host Communities,2411,2828,857,1537,7633,2411,2828,857,1537,7633
17,CAR (UNDP),2016,CAR-16/HCF10/10/WaSH/NGO/1384,2/27/2023 5:38:47 PM,Internally Displaced People,1270,1448,491,752,3961,1270,1448,491,752,3961
17,CAR (UNDP),2016,CAR-16/HCF10/10/WaSH/NGO/1384,2/27/2023 5:38:47 PM,Overall,3681,4276,1348,2289,11594,3681,4276,1348,2289,11594
17,CAR (UNDP),2016,CAR-16/HCF10/10/WaSH/UN/1387,9/20/2017 10:08:44 AM,Host Communities,4620,4760,2240,2380,14000,7161,7378,3472,3689,21700
17,CAR (UNDP),2016,CAR-16/HCF10/10/WaSH/UN/1387,9/20/2017 10:08:44 AM,Other,1980,2040,960,1020,6000,3069,3162,1488,1581,9300
17,CAR (UNDP),2016,CAR-16/HCF10/10/WaSH/UN/1387,9/20/2017 10:08:44 AM,Overall,5500,5600,2600,2800,16500,10425,10525,4825,5225,31000
17,CAR (UNDP),2016,CAR-16/HCF10/10/WaSH-NUT-HLT/INGO/1483,8/10/2017 8:51:05 AM,Host Communities,2068,2600,2341,2491,9500,1836,2139,1658,1729,7362
17,CAR (UNDP),2016,CAR-16/HCF10/10/WaSH-NUT-HLT/INGO/1483,8/10/2017 8:51:05 AM,Internally Displaced People,109,137,123,131,500,95,114,85,93,387
17,CAR (UNDP),2016,CAR-16/HCF10/10/WaSH-NUT-HLT/INGO/1483,8/10/2017 8:51:05 AM,Overall,2177,2737,2464,2622,10000,1934,2252,1743,1820,7749
17,CAR (UNDP),2016,CAR-16/HCF10/12/CCCM/NGO/4006,2/27/2018 3:44:42 PM,Internally Displaced People,5931,6424,10009,8438,30802,5931,6424,10009,8438,30802
17,CAR (UNDP),2016,CAR-16/HCF10/12/CCCM/NGO/4006,2/27/2018 3:44:42 PM,Other,70,30,0,0,100,70,30,0,0,100
17,CAR (UNDP),2016,CAR-16/HCF10/12/CCCM/NGO/4006,2/27/2018 3:44:42 PM,Overall,6001,6454,10009,8438,30902,5931,6424,10009,8438,30802
17,CAR (UNDP),2016,CAR-16/HCF10/12/CCCM/NGO/4018,2/27/2018 1:59:30 PM,Internally Displaced People,1981,2292,4111,3960,12344,1981,2292,4111,3960,12344
17,CAR (UNDP),2016,CAR-16/HCF10/12/CCCM/NGO/4018,2/27/2018 1:59:30 PM,Overall,1981,2292,4111,3960,12344,4516,4502,5589,5481,20088
17,CAR (UNDP),2016,CAR-16/HCF10/12/EDU/INGO/3908,3/5/2018 10:44:37 AM,Host Communities,52,4,1449,774,2279,33,3,289,155,480
17,CAR (UNDP),2016,CAR-16/HCF10/12/EDU/INGO/3908,3/5/2018 10:44:37 AM,Internally Displaced People,10,0,289,155,454,33,3,1152,1760,2948
17,CAR (UNDP),2016,CAR-16/HCF10/12/EDU/INGO/3908,3/5/2018 10:44:37 AM,Overall,62,4,1738,929,2733,50,2,1760,1152,2964
17,CAR (UNDP),2016,CAR-16/HCF10/12/EDU/INGO/4092,2/28/2018 5:15:38 PM,Host Communities,31,14,1125,1125,2295,1635,1303,5231,3853,12022
17,CAR (UNDP),2016,CAR-16/HCF10/12/EDU/INGO/4092,2/28/2018 5:15:38 PM,Internally Displaced People,31,14,1125,1125,2295,0,0,0,0,0
17,CAR (UNDP),2016,CAR-16/HCF10/12/EDU/INGO/4092,2/28/2018 5:15:38 PM,Overall,62,28,2250,2250,4590,1635,1303,5231,3853,12022
17,CAR (UNDP),2016,CAR-16/HCF10/12/EDU-PROT/INGO/4068,2/22/2018 9:01:51 AM,Host Communities,161,77,3817,2639,6694,163,78,3185,3535,6961
17,CAR (UNDP),2016,CAR-16/HCF10/12/EDU-PROT/INGO/4068,2/22/2018 9:01:51 AM,Internally Displaced People,18,8,954,660,1640,18,2,796,884,1700
17,CAR (UNDP),2016,CAR-16/HCF10/12/EDU-PROT/INGO/4068,2/22/2018 9:01:51 AM,Overall,179,85,4771,3299,8334,181,80,3981,4419,8661
17,CAR (UNDP),2016,CAR-16/HCF10/12/ER-PROT/INGO/4067,9/20/2018 4:16:23 PM,Host Communities,1419,1479,1479,1537,5914,1348,1663,2013,1685,6709
17,CAR (UNDP),2016,CAR-16/HCF10/12/ER-PROT/INGO/4067,9/20/2018 4:16:23 PM,Internally Displaced People,3311,3449,3449,3588,13797,2696,3325,4027,3371,13419
17,CAR (UNDP),2016,CAR-16/HCF10/12/ER-PROT/INGO/4067,9/20/2018 4:16:23 PM,Other,0,0,0,0,0,450,554,671,562,2237
17,CAR (UNDP),2016,CAR-16/HCF10/12/ER-PROT/INGO/4067,9/20/2018 4:16:23 PM,Overall,4730,4928,4928,5125,19711,4494,5542,6711,5618,22365
17,CAR (UNDP),2016,CAR-16/HCF10/12/ER-PROT-WaSH/INGO/4033,3/14/2018 3:56:53 PM,Host Communities,3360,3360,5040,5040,16800,8535,8535,12803,12803,42676
17,CAR (UNDP),2016,CAR-16/HCF10/12/ER-PROT-WaSH/INGO/4033,3/14/2018 3:56:53 PM,Internally Displaced People,1344,1344,2016,2016,6720,3414,3414,5121,5121,17070
17,CAR (UNDP),2016,CAR-16/HCF10/12/ER-PROT-WaSH/INGO/4033,3/14/2018 3:56:53 PM,Other,2016,2016,3024,3024,10080,5121,5121,7682,7682,25606
17,CAR (UNDP),2016,CAR-16/HCF10/12/ER-PROT-WaSH/INGO/4033,3/14/2018 3:56:53 PM,Overall,6720,6720,10080,10080,33600,17291,17235,26786,24041,85353
17,CAR (UNDP),2016,CAR-16/HCF10/12/FSEC/NGO/3964,9/25/2019 3:46:02 PM,Host Communities,370,436,403,471,1680,370,894,403,471,2138
17,CAR (UNDP),2016,CAR-16/HCF10/12/FSEC/NGO/3964,9/25/2019 3:46:02 PM,Internally Displaced People,756,894,826,962,3438,756,894,826,962,3438
17,CAR (UNDP),2016,CAR-16/HCF10/12/FSEC/NGO/3964,9/25/2019 3:46:02 PM,Other,634,750,691,807,2882,634,750,691,807,2882
17,CAR (UNDP),2016,CAR-16/HCF10/12/FSEC/NGO/3964,9/25/2019 3:46:02 PM,Overall,1760,2080,1920,2240,8000,1760,2080,1920,2240,8000
17,CAR (UNDP),2016,CAR-16/HCF10/12/FSEC/UN/4106,2/26/2018 11:40:22 AM,Host Communities,150,250,250,350,1000,829,920,1370,1505,4624
17,CAR (UNDP),2016,CAR-16/HCF10/12/FSEC/UN/4106,2/26/2018 11:40:22 AM,Internally Displaced People,600,1000,1000,1400,4000,1958,2121,2936,3181,10196
17,CAR (UNDP),2016,CAR-16/HCF10/12/FSEC/UN/4106,2/26/2018 11:40:22 AM,Other,600,1000,1000,1400,4000,600,1000,1000,1400,4000
17,CAR (UNDP),2016,CAR-16/HCF10/12/FSEC/UN/4106,2/26/2018 11:40:22 AM,Overall,1350,2250,2250,3150,9000,3805,4123,4708,6184,18820
17,CAR (UNDP),2016,CAR-16/HCF10/12/FSEC-PROT/INGO/4062,4/27/2018 2:12:39 PM,Host Communities,910,1050,1060,390,3410,782,1086,7000,4205,13073
17,CAR (UNDP),2016,CAR-16/HCF10/12/FSEC-PROT/INGO/4062,4/27/2018 2:12:39 PM,Internally Displaced People,1200,2200,1200,5200,9800,1589,1983,459,535,4566
17,CAR (UNDP),2016,CAR-16/HCF10/12/FSEC-PROT/INGO/4062,4/27/2018 2:12:39 PM,Overall,1810,2950,1960,5290,12010,1907,2344,7940,5448,17639
17,CAR (UNDP),2016,CAR-16/HCF10/12/HLT/INGO/3918,3/1/2018 2:18:13 PM,Overall,7273,10940,4058,5389,27660,6666,10024,27,210,16927
17,CAR (UNDP),2016,CAR-16/HCF10/12/HLT/INGO/4005,10/3/2018 9:26:09 AM,Other,20424,4849,1765,1177,28215,24739,5874,2138,1425,34176
17,CAR (UNDP),2016,CAR-16/HCF10/12/HLT/INGO/4005,10/3/2018 9:26:09 AM,Overall,20424,4849,1765,1177,28215,24739,5874,2138,1425,34176
17,CAR (UNDP),2016,CAR-16/HCF10/12/HLT/INGO/4097,11/27/2017 4:09:44 PM,Host Communities,855,1118,1644,2105,5722,1212,1678,1053,869,4812
17,CAR (UNDP),2016,CAR-16/HCF10/12/HLT/INGO/4097,11/27/2017 4:09:44 PM,Other,293,382,562,719,1956,698,926,466,617,2707
17,CAR (UNDP),2016,CAR-16/HCF10/12/HLT/INGO/4097,11/27/2017 4:09:44 PM,Overall,1148,1500,2206,2824,7678,1910,2604,1519,1486,7519
17,CAR (UNDP),2016,CAR-16/HCF10/12/HLT-NUT/INGO/4108,2/15/2018 11:21:49 AM,Host Communities,12443,13905,10269,10659,47276,10263,10123,10176,10537,41099
17,CAR (UNDP),2016,CAR-16/HCF10/12/HLT-NUT/INGO/4108,2/15/2018 11:21:49 AM,Internally Displaced People,2445,2545,2378,2474,9842,2053,2025,2036,2108,8222
17,CAR (UNDP),2016,CAR-16/HCF10/12/HLT-NUT/INGO/4108,2/15/2018 11:21:49 AM,Overall,14888,16450,12647,13133,57118,12316,12148,12212,12645,49321
17,CAR (UNDP),2016,CAR-16/HCF10/12/LOG/INGO/4016,2/26/2018 8:41:54 AM,Overall,5341,5432,5297,5297,21367,1008,465,386,183,2042
17,CAR (UNDP),2016,CAR-16/HCF10/12/NUT/INGO/4099,12/12/2017 2:56:38 PM,Host Communities,83,5835,6954,7238,20110,81,5771,7053,6986,19891
17,CAR (UNDP),2016,CAR-16/HCF10/12/NUT/INGO/4099,12/12/2017 2:56:38 PM,Overall,83,5835,6954,7238,20110,81,5771,7053,6986,19891
17,CAR (UNDP),2016,CAR-16/HCF10/12/NUT-HLT/INGO/3994,11/27/2017 4:21:17 PM,Host Communities,1877,1953,3812,3970,11612,3399,4547,2177,1995,12118
17,CAR (UNDP),2016,CAR-16/HCF10/12/NUT-HLT/INGO/3994,11/27/2017 4:21:17 PM,Overall,1877,1953,3812,3970,11612,3399,4547,2177,1995,12118
17,CAR (UNDP),2016,CAR-16/HCF10/12/NUT-HLT/INGO/4032,2/13/2018 1:55:13 PM,Host Communities,0,2876,2810,3044,8730,4927,5338,2393,2593,15251
17,CAR (UNDP),2016,CAR-16/HCF10/12/NUT-HLT/INGO/4032,2/13/2018 1:55:13 PM,Internally Displaced People,0,148,145,157,450,1916,2076,931,1008,5931
17,CAR (UNDP),2016,CAR-16/HCF10/12/NUT-HLT/INGO/4032,2/13/2018 1:55:13 PM,Other,0,72,70,76,218,0,0,0,0,0
17,CAR (UNDP),2016,CAR-16/HCF10/12/NUT-HLT/INGO/4032,2/13/2018 1:55:13 PM,Overall,0,3096,3025,3277,9398,6843,7414,3324,3601,21182
17,CAR (UNDP),2016,CAR-16/HCF10/12/PROT/NGO/3910,10/2/2018 10:41:48 AM,Host Communities,2450,3140,2900,3300,11790,3327,3283,4223,4205,15038
17,CAR (UNDP),2016,CAR-16/HCF10/12/PROT/NGO/3910,10/2/2018 10:41:48 AM,Internally Displaced People,270,290,320,481,1361,270,290,320,481,1361
17,CAR (UNDP),2016,CAR-16/HCF10/12/PROT/NGO/3910,10/2/2018 10:41:48 AM,Other,2580,4460,1876,3319,12235,2580,4460,1876,3319,12235
17,CAR (UNDP),2016,CAR-16/HCF10/12/PROT/NGO/3910,10/2/2018 10:41:48 AM,Overall,5300,7900,5096,7100,25396,5700,14800,5200,4300,30000
17,CAR (UNDP),2016,CAR-16/HCF10/12/PROT/NGO/4013,3/15/2018 4:06:48 PM,Host Communities,1920,2900,4100,3600,12520,2000,3200,5100,4200,14500
17,CAR (UNDP),2016,CAR-16/HCF10/12/PROT/NGO/4013,3/15/2018 4:06:48 PM,Internally Displaced People,1480,1700,3600,2100,8880,700,3100,3300,1900,9000
17,CAR (UNDP),2016,CAR-16/HCF10/12/PROT/NGO/4013,3/15/2018 4:06:48 PM,Overall,3400,4600,7700,5700,21400,2800,6300,8400,6100,23600
17,CAR (UNDP),2016,CAR-16/HCF10/12/PROT-EDU/INGO/4057,2/22/2018 8:53:52 AM,Host Communities,742,998,1006,918,3664,1307,1406,1212,1445,5370
17,CAR (UNDP),2016,CAR-16/HCF10/12/PROT-EDU/INGO/4057,2/22/2018 8:53:52 AM,Internally Displaced People,340,295,528,756,1919,361,321,285,735,1702
17,CAR (UNDP),2016,CAR-16/HCF10/12/PROT-EDU/INGO/4057,2/22/2018 8:53:52 AM,Overall,1400,1800,1900,1900,7000,2133,2841,2001,2812,9787
17,CAR (UNDP),2016,CAR-16/HCF10/12/PROT-EDU/INGO/4057,2/22/2018 8:53:52 AM,Refugees,318,507,366,226,1417,465,1114,504,632,2715
17,CAR (UNDP),2016,CAR-16/HCF10/12/WaSH/INGO/4069,10/3/2018 9:33:00 AM,Host Communities,1342,1695,2213,2250,7500,2100,2106,1753,1376,7335
17,CAR (UNDP),2016,CAR-16/HCF10/12/WaSH/INGO/4069,10/3/2018 9:33:00 AM,Internally Displaced People,268,339,442,450,1499,420,421,351,275,1467
17,CAR (UNDP),2016,CAR-16/HCF10/12/WaSH/INGO/4069,10/3/2018 9:33:00 AM,Other,1075,1356,1770,1800,6001,1680,1685,1402,1100,5867
17,CAR (UNDP),2016,CAR-16/HCF10/12/WaSH/INGO/4069,10/3/2018 9:33:00 AM,Overall,2685,3390,4425,4500,15000,4199,4212,3505,2751,14667
17,CAR (UNDP),2016,CAR-16/HCF10/12/WaSH/INGO/4085,2/22/2018 8:45:22 AM,Internally Displaced People,7136,8717,9119,9496,34468,6964,8292,8622,9286,33164
17,CAR (UNDP),2016,CAR-16/HCF10/12/WaSH/INGO/4085,2/22/2018 8:45:22 AM,Overall,7136,8717,9119,9496,34468,6964,8292,8622,9286,33164
17,CAR (UNDP),2016,CAR-16/HCF10/12/WaSH/INGO/4093,10/3/2018 9:02:32 AM,Internally Displaced People,3138,3745,7791,6969,21643,7340,7639,7952,8276,31207
17,CAR (UNDP),2016,CAR-16/HCF10/12/WaSH/INGO/4093,10/3/2018 9:02:32 AM,Overall,3138,3745,7791,6969,21643,7340,7639,7952,8276,31207
17,CAR (UNDP),2016,CAR-16/HCF10/12/WaSH/INGO/4111,2/27/2018 3:21:45 PM,Host Communities,1525,1459,1923,1724,6631,900,1088,1534,1360,4882
17,CAR (UNDP),2016,CAR-16/HCF10/12/WaSH/INGO/4111,2/27/2018 3:21:45 PM,Internally Displaced People,12080,11554,15231,13655,52520,15702,16343,15702,16343,64090
17,CAR (UNDP),2016,CAR-16/HCF10/12/WaSH/INGO/4111,2/27/2018 3:21:45 PM,Overall,13605,13013,17154,15379,59151,16602,17431,17236,17703,68972
17,CAR (UNDP),2016,CAR-16/HCF10/R/ER/INGO/3612,10/15/2018 11:22:34 AM,Host Communities,37306,43795,74614,87590,243305,0,0,0,0,0
17,CAR (UNDP),2016,CAR-16/HCF10/R/ER/INGO/3612,10/15/2018 11:22:34 AM,Overall,37306,43795,74614,87590,243305,0,0,0,0,0
17,CAR (UNDP),2016,CAR-16/HCF10/R/FSEC/UN/4482,2/6/2019 4:51:55 PM,Host Communities,288,331,338,483,1440,378,434,444,634,1890
17,CAR (UNDP),2016,CAR-16/HCF10/R/FSEC/UN/4482,2/6/2019 4:51:55 PM,Internally Displaced People,2249,2529,3165,3467,11410,2248,2526,3182,3454,11410
17,CAR (UNDP),2016,CAR-16/HCF10/R/FSEC/UN/4482,2/6/2019 4:51:55 PM,Overall,2537,2860,3503,3950,12850,0,0,0,0,0
17,CAR (UNDP),2016,CAR-16/HCF10/R/HLT/UN/1505,1/22/2019 7:43:28 AM,Host Communities,375788,388857,375788,388857,1529290,300630,311086,300600,311086,1223402
17,CAR (UNDP),2016,CAR-16/HCF10/R/HLT/UN/1505,1/22/2019 7:43:28 AM,Internally Displaced People,53381,57829,53381,57829,222420,53381,57829,53381,57829,222420
17,CAR (UNDP),2016,CAR-16/HCF10/R/HLT/UN/1505,1/22/2019 7:43:28 AM,Overall,429169,446686,429169,446686,1751710,343335,357348,394080,400000,1494763
17,CAR (UNDP),2016,CAR-16/HCF10/R/HLT/UN/3608,1/22/2019 4:37:30 PM,Host Communities,10332,11193,25045,27090,73660,10332,11193,25045,27090,73660
17,CAR (UNDP),2016,CAR-16/HCF10/R/HLT/UN/3608,1/22/2019 4:37:30 PM,Internally Displaced People,6893,7467,16674,18105,49139,6893,7467,16674,18105,49139
17,CAR (UNDP),2016,CAR-16/HCF10/R/HLT/UN/3608,1/22/2019 4:37:30 PM,Overall,17225,18660,41719,45195,122799,17225,18660,41719,45195,122799
17,CAR (UNDP),2016,CAR-16/HCF10/R/LOG/INGO/1506,8/10/2017 8:21:24 AM,Overall,0,33,0,0,33,0,13,0,0,13
17,CAR (UNDP),2016,CAR-16/HCF10/R/LOG/INGO/3172,4/24/2017 4:04:52 PM,Other,16,0,0,0,16,14,0,0,0,14
17,CAR (UNDP),2016,CAR-16/HCF10/R/LOG/INGO/3172,4/24/2017 4:04:52 PM,Overall,16,0,0,0,16,14,0,0,0,14
17,CAR (UNDP),2016,CAR-16/HCF10/R/WaSH/INGO/1504,9/14/2017 8:49:02 AM,Host Communities,2401,2499,2499,2601,10000,2426,2308,2637,2501,9872
17,CAR (UNDP),2016,CAR-16/HCF10/R/WaSH/INGO/1504,9/14/2017 8:49:02 AM,Internally Displaced People,3100,3227,3226,3358,12911,1831,2017,2961,3102,9911
17,CAR (UNDP),2016,CAR-16/HCF10/R/WaSH/INGO/1504,9/14/2017 8:49:02 AM,Overall,5501,5726,5725,5959,22911,4257,4325,5598,5603,19783
17,CAR (UNDP),2016,CAR-16/HCF10/R/WaSH/INGO/3610,9/6/2017 10:49:31 AM,Host Communities,2448,2482,2553,2517,10000,2496,2904,2254,2346,10000
17,CAR (UNDP),2016,CAR-16/HCF10/R/WaSH/INGO/3610,9/6/2017 10:49:31 AM,Overall,2448,2482,2553,2517,10000,2745,3195,2478,2582,11000
17,CAR (UNDP),2016,CAR-16/HCF10/R/WaSH/UN/3609,9/12/2017 11:15:38 AM,Other,16500,17000,8000,8500,50000,45210,46580,21920,23290,137000
17,CAR (UNDP),2016,CAR-16/HCF10/R/WaSH/UN/3609,9/12/2017 11:15:38 AM,Overall,16500,17000,8000,8500,50000,45210,46580,21920,23290,137000
17,CAR (UNDP),2016,CAR-16/HCF10/R/WaSH/UN/3616,10/12/2017 12:42:33 PM,Other,9576,9966,7834,8155,35531,11136,11548,9073,9486,41243
17,CAR (UNDP),2016,CAR-16/HCF10/R/WaSH/UN/3616,10/12/2017 12:42:33 PM,Overall,9576,9966,7834,8155,35531,11136,11548,9073,9486,41243
17,CAR (UNDP),2017,CAR-17/HCF10/13/CCCM/NGO/7331,7/19/2018 1:45:22 PM,Internally Displaced People,2476,3458,5138,4734,15806,0,0,0,0,0
17,CAR (UNDP),2017,CAR-17/HCF10/13/CCCM/NGO/7331,7/19/2018 1:45:22 PM,Overall,2479,3458,5138,4734,15809,4023,5223,7192,6719,23157
17,CAR (UNDP),2017,CAR-17/HCF10/13/HLT/INGO/4640,3/13/2018 9:45:38 AM,Host Communities,1296,1250,1720,1934,6200,1322,2015,3325,2275,8937
17,CAR (UNDP),2017,CAR-17/HCF10/13/HLT/INGO/4640,3/13/2018 9:45:38 AM,Internally Displaced People,934,1410,1780,1876,6000,700,1050,1020,1067,3837
17,CAR (UNDP),2017,CAR-17/HCF10/13/HLT/INGO/4640,3/13/2018 9:45:38 AM,Overall,2230,2660,3500,3810,12200,2022,3065,4345,3342,12774
17,CAR (UNDP),2017,CAR-17/HCF10/13/HLT/INGO/6128,12/13/2017 3:30:47 PM,Overall,0,0,13475,11025,24500,0,0,14676,11531,26207
17,CAR (UNDP),2017,CAR-17/HCF10/13/LOG/INGO/4711,2/22/2018 6:01:49 PM,Other,0,33,0,0,33,0,31,0,0,31
17,CAR (UNDP),2017,CAR-17/HCF10/13/LOG/INGO/4711,2/22/2018 6:01:49 PM,Overall,0,33,0,0,33,0,31,0,0,31
17,CAR (UNDP),2017,CAR-17/HCF10/13/LOG/INGO/4713,5/24/2018 11:52:51 AM,Overall,440,458,423,440,1761,496,517,476,496,1985
17,CAR (UNDP),2017,CAR-17/HCF10/13/NFI/INGO/5549,9/13/2018 11:29:47 AM,Internally Displaced People,159,266,213,425,1063,159,263,211,422,1055
17,CAR (UNDP),2017,CAR-17/HCF10/13/NFI/INGO/5549,9/13/2018 11:29:47 AM,Overall,188,312,250,500,1250,159,263,211,422,1055
17,CAR (UNDP),2017,CAR-17/HCF10/13/NFI/INGO/5567,9/13/2018 11:24:12 AM,Internally Displaced People,391,437,433,389,1650,380,412,412,380,1584
17,CAR (UNDP),2017,CAR-17/HCF10/13/NFI/INGO/5567,9/13/2018 11:24:12 AM,Overall,391,437,433,389,1650,380,412,412,380,1584
17,CAR (UNDP),2017,CAR-17/HCF10/13/NFI/UN/4701,3/22/2018 10:06:32 AM,Host Communities,1619,1701,810,870,5000,782,831,392,440,2445
17,CAR (UNDP),2017,CAR-17/HCF10/13/NFI/UN/4701,3/22/2018 10:06:32 AM,Internally Displaced People,6473,6803,3243,3481,20000,16109,17116,8054,9061,50340
17,CAR (UNDP),2017,CAR-17/HCF10/13/NFI/UN/4701,3/22/2018 10:06:32 AM,Overall,8092,8504,4053,4351,25000,16891,17947,8446,9501,52785
17,CAR (UNDP),2017,CAR-17/HCF10/13/NFI-CCCM-PROT/UN/4710,2/27/2018 1:21:31 PM,Internally Displaced People,7400,8810,9516,9514,35240,18241,21618,26219,26343,92421
17,CAR (UNDP),2017,CAR-17/HCF10/13/NFI-CCCM-PROT/UN/4710,2/27/2018 1:21:31 PM,Overall,7400,8810,9516,9514,35240,18241,21618,26219,26343,92421
17,CAR (UNDP),2017,CAR-17/HCF10/13/WaSH/INGO/4712,2/28/2018 8:52:27 AM,Host Communities,943,1145,2425,2155,6668,6003,6831,13121,12612,38567
17,CAR (UNDP),2017,CAR-17/HCF10/13/WaSH/INGO/4712,2/28/2018 8:52:27 AM,Internally Displaced People,963,1169,2475,2200,6807,269,271,587,892,2019
17,CAR (UNDP),2017,CAR-17/HCF10/13/WaSH/INGO/4712,2/28/2018 8:52:27 AM,Overall,1906,2314,4900,4375,13495,6272,7102,13708,13504,40586
17,CAR (UNDP),2017,CAR-17/HCF10/13/WaSH/INGO/5365,6/13/2018 4:04:47 PM,Host Communities,8153,8486,7834,7527,32000,11014,9489,7426,8111,36040
17,CAR (UNDP),2017,CAR-17/HCF10/13/WaSH/INGO/5365,6/13/2018 4:04:47 PM,Overall,8153,8486,7834,7527,32000,11014,9489,7426,8111,36040
17,CAR (UNDP),2017,CAR-17/HCF10/13/WaSH/INGO/7332,9/20/2018 4:27:35 PM,Host Communities,1503,1437,1895,1698,6533,1392,1331,1755,1572,6050
17,CAR (UNDP),2017,CAR-17/HCF10/13/WaSH/INGO/7332,9/20/2018 4:27:35 PM,Internally Displaced People,14482,13853,18260,16371,62966,12377,11839,13991,15607,53814
17,CAR (UNDP),2017,CAR-17/HCF10/13/WaSH/INGO/7332,9/20/2018 4:27:35 PM,Overall,15985,15290,20155,18069,69499,13769,13170,15564,17361,59864
17,CAR (UNDP),2017,CAR-17/HCF10/13/WaSH/UN/6129,10/4/2017 8:36:31 AM,Host Communities,75240,77520,36480,38760,228000,75240,77520,36480,38760,228000
17,CAR (UNDP),2017,CAR-17/HCF10/13/WaSH/UN/6129,10/4/2017 8:36:31 AM,Other,3960,4080,1920,2040,12000,3960,4080,1920,2040,12000
17,CAR (UNDP),2017,CAR-17/HCF10/13/WaSH/UN/6129,10/4/2017 8:36:31 AM,Overall,79200,81600,38400,40800,240000,79200,81600,38400,40800,240000
17,CAR (UNDP),2017,CAR-17/HCF10/13/WaSH-PROT/UN/4694,2/22/2018 6:06:07 PM,Overall,7000,7400,4900,5000,24300,6100,6400,4775,4289,21564
17,CAR (UNDP),2017,CAR-17/HCF10/AS1/EDU/NGO/6195,11/5/2018 4:12:13 PM,Host Communities,416,979,1150,1082,3627,1216,2179,2874,2056,8325
17,CAR (UNDP),2017,CAR-17/HCF10/AS1/EDU/NGO/6195,11/5/2018 4:12:13 PM,Internally Displaced People,800,1200,1724,974,4698,1341,2449,3225,3437,10452
17,CAR (UNDP),2017,CAR-17/HCF10/AS1/EDU/NGO/6195,11/5/2018 4:12:13 PM,Overall,1216,2179,2874,2056,8325,1341,2449,3225,3437,10452
17,CAR (UNDP),2017,CAR-17/HCF10/AS1/EDU/UN/6115,10/9/2018 11:05:07 AM,Host Communities,35,23,920,1080,2058,0,0,0,0,0
17,CAR (UNDP),2017,CAR-17/HCF10/AS1/EDU/UN/6115,10/9/2018 11:05:07 AM,Internally Displaced People,105,70,3772,4428,8375,0,0,0,0,0
17,CAR (UNDP),2017,CAR-17/HCF10/AS1/EDU/UN/6115,10/9/2018 11:05:07 AM,Other,0,0,828,972,1800,0,0,0,0,0
17,CAR (UNDP),2017,CAR-17/HCF10/AS1/EDU/UN/6115,10/9/2018 11:05:07 AM,Overall,140,93,5520,6480,12233,311,83,8830,9761,18985
17,CAR (UNDP),2017,CAR-17/HCF10/AS1/EDU-PROT/INGO/5956,10/4/2018 8:49:41 AM,Host Communities,0,0,1091,1181,2272,463,607,785,882,2737
17,CAR (UNDP),2017,CAR-17/HCF10/AS1/EDU-PROT/INGO/5956,10/4/2018 8:49:41 AM,Internally Displaced People,1504,1583,1522,1632,6241,1547,1554,3921,3112,10134
17,CAR (UNDP),2017,CAR-17/HCF10/AS1/EDU-PROT/INGO/5956,10/4/2018 8:49:41 AM,Overall,1504,1583,2613,2813,8513,577,417,3801,3222,8017
17,CAR (UNDP),2017,CAR-17/HCF10/AS1/FSEC/INGO/6230,1/10/2019 11:43:46 AM,Other,70,0,0,0,70,70,0,0,0,70
17,CAR (UNDP),2017,CAR-17/HCF10/AS1/FSEC/INGO/6230,1/10/2019 11:43:46 AM,Overall,70,0,0,0,70,70,0,0,0,70
17,CAR (UNDP),2017,CAR-17/HCF10/AS1/FSEC/NGO/6160,10/13/2018 12:25:51 PM,Host Communities,1215,1485,810,990,4500,1215,1485,810,990,4500
17,CAR (UNDP),2017,CAR-17/HCF10/AS1/FSEC/NGO/6160,10/13/2018 12:25:51 PM,Internally Displaced People,405,495,270,330,1500,405,495,270,330,1500
17,CAR (UNDP),2017,CAR-17/HCF10/AS1/FSEC/NGO/6160,10/13/2018 12:25:51 PM,Overall,1620,1980,1080,1320,6000,1620,1980,1080,1320,6000
17,CAR (UNDP),2017,CAR-17/HCF10/AS1/FSEC-ER/INGO/6229,10/3/2018 8:55:48 AM,Host Communities,235,235,0,0,470,20,33,0,0,53
17,CAR (UNDP),2017,CAR-17/HCF10/AS1/FSEC-ER/INGO/6229,10/3/2018 8:55:48 AM,Internally Displaced People,350,350,0,0,700,76,113,0,0,189
17,CAR (UNDP),2017,CAR-17/HCF10/AS1/FSEC-ER/INGO/6229,10/3/2018 8:55:48 AM,Other,590,590,0,0,1180,960,1148,0,0,2108
17,CAR (UNDP),2017,CAR-17/HCF10/AS1/FSEC-ER/INGO/6229,10/3/2018 8:55:48 AM,Overall,1175,1175,0,0,2350,1031,1319,0,0,2350
17,CAR (UNDP),2017,CAR-17/HCF10/AS1/FSEC-PROT-ER/INGO/5970,10/3/2018 8:21:03 AM,Host Communities,552,575,575,598,2300,3349,3489,3489,3629,13956
17,CAR (UNDP),2017,CAR-17/HCF10/AS1/FSEC-PROT-ER/INGO/5970,10/3/2018 8:21:03 AM,Internally Displaced People,276,288,288,299,1151,0,0,0,0,0
17,CAR (UNDP),2017,CAR-17/HCF10/AS1/FSEC-PROT-ER/INGO/5970,10/3/2018 8:21:03 AM,Other,1932,2012,2012,2093,8049,0,0,0,0,0
17,CAR (UNDP),2017,CAR-17/HCF10/AS1/FSEC-PROT-ER/INGO/5970,10/3/2018 8:21:03 AM,Overall,2760,2875,2875,2990,11500,3349,3489,3489,3629,13956
17,CAR (UNDP),2017,CAR-17/HCF10/AS1/HLT/INGO/6007,10/4/2018 3:00:23 PM,Host Communities,8557,9271,1790,1940,21558,4126,4855,3651,3508,16140
17,CAR (UNDP),2017,CAR-17/HCF10/AS1/HLT/INGO/6007,10/4/2018 3:00:23 PM,Internally Displaced People,1721,1869,360,391,4341,1063,1486,1042,988,4579
17,CAR (UNDP),2017,CAR-17/HCF10/AS1/HLT/INGO/6007,10/4/2018 3:00:23 PM,Overall,10278,11140,2150,2331,25899,5189,6341,4693,4496,20719
17,CAR (UNDP),2017,CAR-17/HCF10/AS1/LOG/INGO/5955,7/19/2018 2:07:54 PM,Other,0,32,0,0,32,0,27,0,0,27
17,CAR (UNDP),2017,CAR-17/HCF10/AS1/LOG/INGO/5955,7/19/2018 2:07:54 PM,Overall,0,32,0,0,32,0,27,0,0,27
17,CAR (UNDP),2017,CAR-17/HCF10/AS1/LOG/INGO/6223,9/12/2018 2:06:57 PM,Overall,20,0,0,0,20,19,0,0,0,19
17,CAR (UNDP),2017,CAR-17/HCF10/AS1/LOG/UN/6150,10/17/2018 9:51:57 AM,Overall,1200,0,0,0,1200,513,0,0,0,513
17,CAR (UNDP),2017,CAR-17/HCF10/AS1/NFI/INGO/6210,10/19/2018 11:18:21 AM,Host Communities,56,95,67,67,285,257,300,280,310,1147
17,CAR (UNDP),2017,CAR-17/HCF10/AS1/NFI/INGO/6210,10/19/2018 11:18:21 AM,Internally Displaced People,508,852,603,603,2566,261,420,320,290,1291
17,CAR (UNDP),2017,CAR-17/HCF10/AS1/NFI/INGO/6210,10/19/2018 11:18:21 AM,Overall,564,947,670,670,2851,518,720,600,600,2438
17,CAR (UNDP),2017,CAR-17/HCF10/AS1/NFI/UN/6232,11/22/2018 7:48:37 AM,Host Communities,66,69,39,36,210,74,70,42,39,225
17,CAR (UNDP),2017,CAR-17/HCF10/AS1/NFI/UN/6232,11/22/2018 7:48:37 AM,Internally Displaced People,240,260,260,240,1000,235,264,248,242,989
17,CAR (UNDP),2017,CAR-17/HCF10/AS1/NFI/UN/6232,11/22/2018 7:48:37 AM,Other,84,91,91,84,350,96,82,89,90,357
17,CAR (UNDP),2017,CAR-17/HCF10/AS1/NFI/UN/6232,11/22/2018 7:48:37 AM,Overall,390,420,390,360,1560,405,416,379,371,1571
17,CAR (UNDP),2017,CAR-17/HCF10/AS1/NUT-HLT/INGO/6090,7/19/2018 12:45:58 PM,Host Communities,7332,8107,8052,8450,31941,7306,8078,8025,8442,31851
17,CAR (UNDP),2017,CAR-17/HCF10/AS1/NUT-HLT/INGO/6090,7/19/2018 12:45:58 PM,Internally Displaced People,506,560,556,584,2206,504,558,555,584,2201
17,CAR (UNDP),2017,CAR-17/HCF10/AS1/NUT-HLT/INGO/6090,7/19/2018 12:45:58 PM,Overall,7838,8667,8608,9034,34147,7810,8636,8580,9026,34052
17,CAR (UNDP),2017,CAR-17/HCF10/AS1/NUT-HLT/INGO/6202,7/19/2018 11:31:57 AM,Host Communities,6,54,1354,1526,2940,0,0,0,0,0
17,CAR (UNDP),2017,CAR-17/HCF10/AS1/NUT-HLT/INGO/6202,7/19/2018 11:31:57 AM,Overall,6,54,1354,1526,2940,66,18,1516,1618,3218
17,CAR (UNDP),2017,CAR-17/HCF10/AS1/NUT-HLT/INGO/6209,10/13/2018 11:31:21 AM,Other,95,0,0,0,95,0,0,0,0,0
17,CAR (UNDP),2017,CAR-17/HCF10/AS1/NUT-HLT/INGO/6209,10/13/2018 11:31:21 AM,Overall,95,0,0,0,95,95,0,0,0,95
17,CAR (UNDP),2017,CAR-17/HCF10/AS1/NUT-HLT/INGO/6226,9/20/2018 4:24:01 PM,Host Communities,2944,13814,6280,6536,29574,3688,7661,5978,6051,23378
17,CAR (UNDP),2017,CAR-17/HCF10/AS1/NUT-HLT/INGO/6226,9/20/2018 4:24:01 PM,Overall,2944,13814,6280,6536,29574,3688,7661,5978,6051,23378
17,CAR (UNDP),2017,CAR-17/HCF10/AS1/PROT/INGO/6213,10/3/2018 8:32:38 AM,Overall,135,90,0,0,225,136,65,0,0,201
17,CAR (UNDP),2017,CAR-17/HCF10/AS1/PROT/INGO/6236,7/19/2018 1:30:07 PM,Host Communities,2160,1805,1130,900,5995,0,0,0,0,0
17,CAR (UNDP),2017,CAR-17/HCF10/AS1/PROT/INGO/6236,7/19/2018 1:30:07 PM,Internally Displaced People,3800,3145,1980,1575,10500,0,0,0,0,0
17,CAR (UNDP),2017,CAR-17/HCF10/AS1/PROT/INGO/6236,7/19/2018 1:30:07 PM,Other,4300,3600,2300,1800,12000,0,0,0,0,0
17,CAR (UNDP),2017,CAR-17/HCF10/AS1/PROT/INGO/6236,7/19/2018 1:30:07 PM,Overall,10800,9000,5700,4500,30000,8269,1881,766,411,11327
17,CAR (UNDP),2017,CAR-17/HCF10/AS1/PROT/INGO/6236,7/19/2018 1:30:07 PM,Refugees,540,450,290,225,1505,0,0,0,0,0
17,CAR (UNDP),2017,CAR-17/HCF10/AS1/PROT-EDU/INGO/6064,7/19/2018 1:07:33 PM,Host Communities,21,50,1000,1510,2581,240,79,4904,3504,8727
17,CAR (UNDP),2017,CAR-17/HCF10/AS1/PROT-EDU/INGO/6064,7/19/2018 1:07:33 PM,Internally Displaced People,20,50,1500,2265,3835,0,0,471,349,820
17,CAR (UNDP),2017,CAR-17/HCF10/AS1/PROT-EDU/INGO/6064,7/19/2018 1:07:33 PM,Overall,41,100,2500,3775,6416,240,79,5375,3754,9448
17,CAR (UNDP),2017,CAR-17/HCF10/AS1/WaSH/INGO/6221,10/3/2018 8:47:20 AM,Other,2351,2447,3527,3675,12000,2477,2739,3781,4043,13040
17,CAR (UNDP),2017,CAR-17/HCF10/AS1/WaSH/INGO/6221,10/3/2018 8:47:20 AM,Overall,2351,2447,3527,3675,12000,2478,2738,3782,4042,13040
17,CAR (UNDP),2017,CAR-17/HCF10/AS1/WaSH/INGO/6227,11/23/2018 4:12:15 PM,Overall,27,27,0,0,54,37,14,0,0,51
17,CAR (UNDP),2017,CAR-17/HCF10/AS1/WaSH/NGO/6228,10/3/2018 9:14:30 AM,Host Communities,3000,5000,2000,2000,12000,3500,5700,2000,2400,13600
17,CAR (UNDP),2017,CAR-17/HCF10/AS1/WaSH/NGO/6228,10/3/2018 9:14:30 AM,Overall,4700,6700,3700,3900,19000,5300,7400,4000,4022,20722
17,CAR (UNDP),2017,CAR-17/HCF10/AS1/WaSH/UN/6212,7/19/2018 9:38:40 AM,Internally Displaced People,3300,3400,1600,1700,10000,5133,5289,2489,2644,15555
17,CAR (UNDP),2017,CAR-17/HCF10/AS1/WaSH/UN/6212,7/19/2018 9:38:40 AM,Overall,3300,3400,1600,1700,10000,5133,5289,2489,2644,15555
17,CAR (UNDP),2017,CAR-17/HCF10/AS1/WaSH-NFI/INGO/6237,10/15/2018 10:13:31 AM,Overall,2500,2600,2300,2600,10000,1676,1743,1542,1743,6704
17,CAR (UNDP),2017,CAR-17/HCF10/AS2/EDU/INGO/7385,2/15/2019 7:41:08 AM,Host Communities,140,70,4360,4640,9210,231,38,5839,7826,13934
17,CAR (UNDP),2017,CAR-17/HCF10/AS2/EDU/INGO/7385,2/15/2019 7:41:08 AM,Internally Displaced People,20,10,1000,1000,2030,0,0,1601,1033,2634
17,CAR (UNDP),2017,CAR-17/HCF10/AS2/EDU/INGO/7385,2/15/2019 7:41:08 AM,Other,10,20,2000,3000,5030,1,0,2,9,12
17,CAR (UNDP),2017,CAR-17/HCF10/AS2/EDU/INGO/7385,2/15/2019 7:41:08 AM,Overall,170,100,7360,8640,16270,232,38,7442,8868,16580
17,CAR (UNDP),2017,CAR-17/HCF10/AS2/EDU/UN/7393,2/6/2019 8:01:11 AM,Host Communities,11,11,350,200,572,0,0,0,0,0
17,CAR (UNDP),2017,CAR-17/HCF10/AS2/EDU/UN/7393,2/6/2019 8:01:11 AM,Internally Displaced People,11,11,1450,1000,2472,51,24,3730,3004,6809
17,CAR (UNDP),2017,CAR-17/HCF10/AS2/EDU/UN/7393,2/6/2019 8:01:11 AM,Overall,22,22,1800,1200,3044,51,24,3730,3004,6809
17,CAR (UNDP),2017,CAR-17/HCF10/AS2/EDU-PROT/INGO/7339,10/5/2018 3:09:27 PM,Host Communities,419,401,474,529,1823,415,584,1612,1466,4077
17,CAR (UNDP),2017,CAR-17/HCF10/AS2/EDU-PROT/INGO/7339,10/5/2018 3:09:27 PM,Internally Displaced People,149,143,169,188,649,261,221,948,1113,2543
17,CAR (UNDP),2017,CAR-17/HCF10/AS2/EDU-PROT/INGO/7339,10/5/2018 3:09:27 PM,Overall,638,610,722,804,2774,864,1034,2997,2864,7759
17,CAR (UNDP),2017,CAR-17/HCF10/AS2/EDU-PROT/INGO/7339,10/5/2018 3:09:27 PM,Refugees,70,66,79,87,302,188,229,437,285,1139
17,CAR (UNDP),2017,CAR-17/HCF10/AS2/ER/NGO/7379,11/16/2018 4:05:52 PM,Host Communities,44,48,52,56,200,117,128,114,140,499
17,CAR (UNDP),2017,CAR-17/HCF10/AS2/ER/NGO/7379,11/16/2018 4:05:52 PM,Other,66,72,78,84,300,41,59,54,63,217
17,CAR (UNDP),2017,CAR-17/HCF10/AS2/ER/NGO/7379,11/16/2018 4:05:52 PM,Overall,110,120,130,140,500,101,128,119,160,508
17,CAR (UNDP),2017,CAR-17/HCF10/AS2/FSEC-ER/NGO/7341,3/26/2019 8:58:21 AM,Host Communities,650,780,440,299,2169,650,780,440,299,2169
17,CAR (UNDP),2017,CAR-17/HCF10/AS2/FSEC-ER/NGO/7341,3/26/2019 8:58:21 AM,Internally Displaced People,240,220,145,286,891,240,220,145,286,891
17,CAR (UNDP),2017,CAR-17/HCF10/AS2/FSEC-ER/NGO/7341,3/26/2019 8:58:21 AM,Other,1460,1725,1545,1610,6340,1460,1725,1545,1610,6340
17,CAR (UNDP),2017,CAR-17/HCF10/AS2/FSEC-ER/NGO/7341,3/26/2019 8:58:21 AM,Overall,2350,2725,2130,2195,9400,2350,2725,2130,2195,9400
17,CAR (UNDP),2017,CAR-17/HCF10/AS2/FSEC-PROT/INGO/7369,4/25/2019 4:10:16 PM,Host Communities,711,3199,1067,2133,7110,2274,4222,1766,2687,10949
17,CAR (UNDP),2017,CAR-17/HCF10/AS2/FSEC-PROT/INGO/7369,4/25/2019 4:10:16 PM,Internally Displaced People,869,3912,1305,2607,8693,302,561,235,357,1455
17,CAR (UNDP),2017,CAR-17/HCF10/AS2/FSEC-PROT/INGO/7369,4/25/2019 4:10:16 PM,Other,0,0,0,0,0,976,1814,759,1155,4704
17,CAR (UNDP),2017,CAR-17/HCF10/AS2/FSEC-PROT/INGO/7369,4/25/2019 4:10:16 PM,Overall,1580,7111,2372,4740,15803,3552,6597,2760,4199,17108
17,CAR (UNDP),2017,CAR-17/HCF10/AS2/NFI/INGO/7378,2/1/2019 2:33:53 PM,Host Communities,0,0,0,0,0,240,330,495,450,1515
17,CAR (UNDP),2017,CAR-17/HCF10/AS2/NFI/INGO/7378,2/1/2019 2:33:53 PM,Other,372,393,360,375,1500,0,0,0,0,0
17,CAR (UNDP),2017,CAR-17/HCF10/AS2/NFI/INGO/7378,2/1/2019 2:33:53 PM,Overall,372,393,360,375,1500,240,330,495,450,1515
17,CAR (UNDP),2017,CAR-17/HCF10/AS2/NFI-FSEC-PROT/INGO/7391,12/26/2018 9:45:29 AM,Host Communities,390,520,782,911,2603,460,612,920,1072,3064
17,CAR (UNDP),2017,CAR-17/HCF10/AS2/NFI-FSEC-PROT/INGO/7391,12/26/2018 9:45:29 AM,Other,68,92,138,161,459,0,0,0,0,0
17,CAR (UNDP),2017,CAR-17/HCF10/AS2/NFI-FSEC-PROT/INGO/7391,12/26/2018 9:45:29 AM,Overall,460,612,920,1072,3064,460,612,920,1072,3064
17,CAR (UNDP),2017,CAR-17/HCF10/AS2/NFI-PROT-FSEC/INGO/7371,4/3/2019 8:29:06 AM,Host Communities,2550,2469,2500,2600,10119,1789,2123,33,42,3987
17,CAR (UNDP),2017,CAR-17/HCF10/AS2/NFI-PROT-FSEC/INGO/7371,4/3/2019 8:29:06 AM,Internally Displaced People,600,400,469,488,1957,1063,598,304,262,2227
17,CAR (UNDP),2017,CAR-17/HCF10/AS2/NFI-PROT-FSEC/INGO/7371,4/3/2019 8:29:06 AM,Other,130,136,136,143,545,469,412,67,59,1007
17,CAR (UNDP),2017,CAR-17/HCF10/AS2/NFI-PROT-FSEC/INGO/7371,4/3/2019 8:29:06 AM,Overall,3280,3005,3105,3231,12621,3321,3133,404,363,7221
17,CAR (UNDP),2017,CAR-17/HCF10/AS2/NUT-HLT/INGO/7354,11/12/2018 7:41:44 AM,Host Communities,981,1062,170,184,2397,771,855,499,693,2818
17,CAR (UNDP),2017,CAR-17/HCF10/AS2/NUT-HLT/INGO/7354,11/12/2018 7:41:44 AM,Internally Displaced People,4605,4991,797,862,11255,1374,3263,2604,3980,11221
17,CAR (UNDP),2017,CAR-17/HCF10/AS2/NUT-HLT/INGO/7354,11/12/2018 7:41:44 AM,Overall,5588,6054,967,1047,13656,2145,4118,3103,4673,14039
17,CAR (UNDP),2017,CAR-17/HCF10/AS2/NUT-HLT/INGO/7370,11/13/2018 2:12:45 PM,Host Communities,6085,9065,6884,7433,29467,4832,7545,5061,7433,24871
17,CAR (UNDP),2017,CAR-17/HCF10/AS2/NUT-HLT/INGO/7370,11/13/2018 2:12:45 PM,Overall,6085,9065,6884,7433,29467,4832,7545,5061,5837,23275
17,CAR (UNDP),2017,CAR-17/HCF10/AS2/NUT-HLT-WaSH/INGO/7394,12/10/2018 9:19:36 AM,Host Communities,4114,6497,3998,4162,18771,0,0,0,0,0
17,CAR (UNDP),2017,CAR-17/HCF10/AS2/NUT-HLT-WaSH/INGO/7394,12/10/2018 9:19:36 AM,Internally Displaced People,1641,2104,1595,1660,7000,0,0,0,0,0
17,CAR (UNDP),2017,CAR-17/HCF10/AS2/NUT-HLT-WaSH/INGO/7394,12/10/2018 9:19:36 AM,Overall,5755,8601,5593,5822,25771,4644,8601,4675,4865,22785
17,CAR (UNDP),2017,CAR-17/HCF10/AS2/PROT/INGO/7368,1/3/2019 2:30:56 PM,Host Communities,1270,1925,495,627,4317,1516,1539,843,862,4760
17,CAR (UNDP),2017,CAR-17/HCF10/AS2/PROT/INGO/7368,1/3/2019 2:30:56 PM,Internally Displaced People,3333,5054,1299,1647,11333,3978,4041,2214,2266,12499
17,CAR (UNDP),2017,CAR-17/HCF10/AS2/PROT/INGO/7368,1/3/2019 2:30:56 PM,Overall,4603,6979,1794,2274,15650,5494,5580,3057,3128,17259
17,CAR (UNDP),2017,CAR-17/HCF10/AS2/PROT/INGO/7380,12/26/2018 9:26:50 AM,Other,0,0,0,0,0,4211,3768,4073,3486,15538
17,CAR (UNDP),2017,CAR-17/HCF10/AS2/PROT/INGO/7380,12/26/2018 9:26:50 AM,Overall,2400,2400,2400,2400,9600,4211,3768,4073,3486,15538
17,CAR (UNDP),2017,CAR-17/HCF10/AS2/PROT-EDU/INGO/7396,3/25/2019 9:47:05 AM,Host Communities,589,596,1675,1675,4535,0,0,0,0,0
17,CAR (UNDP),2017,CAR-17/HCF10/AS2/PROT-EDU/INGO/7396,3/25/2019 9:47:05 AM,Internally Displaced People,480,480,1200,1200,3360,0,0,0,0,0
17,CAR (UNDP),2017,CAR-17/HCF10/AS2/PROT-EDU/INGO/7396,3/25/2019 9:47:05 AM,Overall,2080,2200,3270,3270,10820,2385,2330,3376,4387,12478
17,CAR (UNDP),2017,CAR-17/HCF10/AS2/WaSH/INGO/7347,2/15/2019 9:26:18 AM,Overall,5142,5743,5668,5092,21645,5124,5743,5668,5092,21627
17,CAR (UNDP),2017,CAR-17/HCF10/AS2/WaSH/INGO/7361,10/19/2018 7:28:17 AM,Host Communities,1200,1200,2100,2100,6600,4365,5970,3000,3750,17085
17,CAR (UNDP),2017,CAR-17/HCF10/AS2/WaSH/INGO/7361,10/19/2018 7:28:17 AM,Internally Displaced People,1000,1000,2400,2400,6800,2436,3925,2750,2655,11766
17,CAR (UNDP),2017,CAR-17/HCF10/AS2/WaSH/INGO/7361,10/19/2018 7:28:17 AM,Other,800,800,1500,1500,4600,1590,89,1005,1059,3743
17,CAR (UNDP),2017,CAR-17/HCF10/AS2/WaSH/INGO/7361,10/19/2018 7:28:17 AM,Overall,3000,3000,6000,6000,18000,8391,9984,6755,7464,32594
17,CAR (UNDP),2017,CAR-17/HCF10/RE17 HS/CCCM-PROT/UN/6607,2/22/2018 6:11:44 PM,Internally Displaced People,8010,9536,10294,10302,38142,7094,8519,14553,14437,44603
17,CAR (UNDP),2017,CAR-17/HCF10/RE17 HS/CCCM-PROT/UN/6607,2/22/2018 6:11:44 PM,Overall,8010,9536,10294,10302,38142,7094,8519,14553,14437,44603
17,CAR (UNDP),2017,CAR-17/HCF10/RE17 HS/LOG/UN/6736,11/9/2018 7:10:28 AM,Overall,40,0,0,0,40,13,0,0,0,13
17,CAR (UNDP),2017,CAR-17/HCF10/RE17 HS/NUT-HLT/INGO/6578,2/13/2018 9:58:03 AM,Host Communities,4974,5388,1041,1127,12530,3479,3768,727,788,8762
17,CAR (UNDP),2017,CAR-17/HCF10/RE17 HS/NUT-HLT/INGO/6578,2/13/2018 9:58:03 AM,Internally Displaced People,1038,1124,217,235,2614,524,458,1191,1374,3547
17,CAR (UNDP),2017,CAR-17/HCF10/RE17 HS/NUT-HLT/INGO/6578,2/13/2018 9:58:03 AM,Overall,6012,6512,1258,1362,15144,4003,4226,1918,2162,12309
17,CAR (UNDP),2017,CAR-17/HCF10/RE17 HS/NUT-HLT/INGO/6601,3/8/2018 3:37:10 PM,Host Communities,45,836,1479,1229,3589,74,549,115,141,879
17,CAR (UNDP),2017,CAR-17/HCF10/RE17 HS/NUT-HLT/INGO/6601,3/8/2018 3:37:10 PM,Internally Displaced People,13,326,964,1123,2426,321,8156,1954,1886,12317
17,CAR (UNDP),2017,CAR-17/HCF10/RE17 HS/NUT-HLT/INGO/6601,3/8/2018 3:37:10 PM,Overall,58,1162,2443,2352,6015,395,8705,2069,2027,13196
17,CAR (UNDP),2017,CAR-17/HCF10/RE17 HS/WaSH/INGO/6619,2/22/2018 5:58:04 PM,Host Communities,463,764,532,556,2315,582,653,610,745,2590
17,CAR (UNDP),2017,CAR-17/HCF10/RE17 HS/WaSH/INGO/6619,2/22/2018 5:58:04 PM,Internally Displaced People,4337,7156,4988,5204,21685,5400,7220,5430,5360,23410
17,CAR (UNDP),2017,CAR-17/HCF10/RE17 HS/WaSH/INGO/6619,2/22/2018 5:58:04 PM,Overall,4800,7920,5520,5760,24000,5982,7873,6040,6105,26000
17,CAR (UNDP),2017,CAR-17/HCF10/RE17 HS/WaSH/INGO/6621,10/9/2018 10:47:17 AM,Host Communities,1194,1244,1243,1294,4975,1921,2001,2001,2080,8003
17,CAR (UNDP),2017,CAR-17/HCF10/RE17 HS/WaSH/INGO/6621,10/9/2018 10:47:17 AM,Internally Displaced People,572,596,596,619,2383,2099,2187,2187,2274,8747
17,CAR (UNDP),2017,CAR-17/HCF10/RE17 HS/WaSH/INGO/6621,10/9/2018 10:47:17 AM,Overall,1800,1875,1875,1950,7500,4020,4188,4188,4354,16750
17,CAR (UNDP),2017,CAR-17/HCF10/RE17 HS/WaSH-PROT/INGO/6618,7/10/2018 11:37:10 AM,Host Communities,875,875,875,875,3500,0,0,0,0,0
17,CAR (UNDP),2017,CAR-17/HCF10/RE17 HS/WaSH-PROT/INGO/6618,7/10/2018 11:37:10 AM,Internally Displaced People,2917,4520,8129,8210,23776,0,0,0,0,0
17,CAR (UNDP),2017,CAR-17/HCF10/RE17 HS/WaSH-PROT/INGO/6618,7/10/2018 11:37:10 AM,Overall,3792,5395,9004,9085,27276,5082,14220,7327,12118,38747
17,CAR (UNDP),2018,CAR-18/HCF10/RA1/HLT/INGO/8019,10/2/2018 1:52:22 PM,Host Communities,12432,13939,5370,5819,37560,12537,13049,5120,5330,36036
17,CAR (UNDP),2018,CAR-18/HCF10/RA1/HLT/INGO/8019,10/2/2018 1:52:22 PM,Internally Displaced People,26178,25661,9887,10714,72440,26643,27731,10883,11327,76584
17,CAR (UNDP),2018,CAR-18/HCF10/RA1/HLT/INGO/8019,10/2/2018 1:52:22 PM,Overall,38610,39600,15257,16533,110000,39180,40780,16003,16657,112620
17,CAR (UNDP),2018,CAR-18/HCF10/RA1/HLT/UN/8018,12/28/2018 10:08:25 AM,Host Communities,2854,2970,16746,17430,40000,2854,2970,16746,17430,40000
17,CAR (UNDP),2018,CAR-18/HCF10/RA1/HLT/UN/8018,12/28/2018 10:08:25 AM,Internally Displaced People,4280,4455,25120,26145,60000,3980,4455,23411,24592,56438
17,CAR (UNDP),2018,CAR-18/HCF10/RA1/HLT/UN/8018,12/28/2018 10:08:25 AM,Overall,7134,7425,41866,43575,100000,6978,7112,40007,42341,96438
17,CAR (UNDP),2018,CAR-18/HCF10/RA1/LOG/INGO/8014,11/19/2018 8:03:42 AM,Other,0,20,0,0,20,0,9,0,0,9
17,CAR (UNDP),2018,CAR-18/HCF10/RA1/LOG/INGO/8014,11/19/2018 8:03:42 AM,Overall,0,20,0,0,20,0,9,0,0,9
17,CAR (UNDP),2018,CAR-18/HCF10/RA1/NFI/UN/8010,1/11/2019 1:55:36 PM,Internally Displaced People,300,450,300,450,1500,260,600,250,350,1460
17,CAR (UNDP),2018,CAR-18/HCF10/RA1/NFI/UN/8010,1/11/2019 1:55:36 PM,Overall,300,450,300,450,1500,260,600,250,350,1460
17,CAR (UNDP),2018,CAR-18/HCF10/RA1/NFI-PROT/INGO/8016,2/13/2019 3:39:28 PM,Host Communities,9780,15648,5868,7824,39120,14390,13283,5857,2878,36408
17,CAR (UNDP),2018,CAR-18/HCF10/RA1/NFI-PROT/INGO/8016,2/13/2019 3:39:28 PM,Internally Displaced People,14670,23472,8802,11736,58680,21584,19924,8786,4317,54611
17,CAR (UNDP),2018,CAR-18/HCF10/RA1/NFI-PROT/INGO/8016,2/13/2019 3:39:28 PM,Overall,24450,39120,14670,19560,97800,35974,33207,14643,7195,91019
17,CAR (UNDP),2018,CAR-18/HCF10/RA1/PROT/UN/8017,11/12/2018 11:16:05 AM,Host Communities,600,560,4000,3840,9000,600,560,4000,3840,9000
17,CAR (UNDP),2018,CAR-18/HCF10/RA1/PROT/UN/8017,11/12/2018 11:16:05 AM,Internally Displaced People,500,500,5400,5000,11400,500,500,5400,5000,11400
17,CAR (UNDP),2018,CAR-18/HCF10/RA1/PROT/UN/8017,11/12/2018 11:16:05 AM,Overall,1100,1060,9400,8840,20400,2432,1456,11439,7520,22847
17,CAR (UNDP),2018,CAR-18/HCF10/RA1/WaSH/INGO/8021,11/13/2018 7:30:07 AM,Host Communities,453,576,841,1065,2935,4777,4973,0,0,9750
17,CAR (UNDP),2018,CAR-18/HCF10/RA1/WaSH/INGO/8021,11/13/2018 7:30:07 AM,Internally Displaced People,7700,9800,14300,18200,50000,15435,16065,0,0,31500
17,CAR (UNDP),2018,CAR-18/HCF10/RA1/WaSH/INGO/8021,11/13/2018 7:30:07 AM,Overall,8153,10376,15141,19265,52935,20212,21038,0,0,41250
17,CAR (UNDP),2018,CAR-18/HCF10/SA1/CCCM/NGO/9149,7/3/2019 10:47:39 AM,Internally Displaced People,5900,7560,10553,9898,33911,12444,16084,20492,20008,69028
17,CAR (UNDP),2018,CAR-18/HCF10/SA1/CCCM/NGO/9149,7/3/2019 10:47:39 AM,Overall,5900,7560,10553,9898,33911,3111,4021,5123,5002,17257
17,CAR (UNDP),2018,CAR-18/HCF10/SA1/EDU/INGO/9172,5/15/2019 1:43:55 PM,Host Communities,902,1165,1812,1607,5486,0,0,1130,1338,2468
17,CAR (UNDP),2018,CAR-18/HCF10/SA1/EDU/INGO/9172,5/15/2019 1:43:55 PM,Internally Displaced People,1606,2251,2786,2635,9278,2612,3513,3627,3145,12897
17,CAR (UNDP),2018,CAR-18/HCF10/SA1/EDU/INGO/9172,5/15/2019 1:43:55 PM,Overall,2629,3563,5153,4619,15964,2598,3511,4603,4493,15205
17,CAR (UNDP),2018,CAR-18/HCF10/SA1/EDU/INGO/9172,5/15/2019 1:43:55 PM,Returnees,121,147,555,377,1200,0,0,391,329,720
17,CAR (UNDP),2018,CAR-18/HCF10/SA1/EDU/UN/9528,1/21/2019 8:11:24 AM,Internally Displaced People,40,10,1375,1125,2550,40,10,3902,1985,5937
17,CAR (UNDP),2018,CAR-18/HCF10/SA1/EDU/UN/9528,1/21/2019 8:11:24 AM,Overall,40,10,1375,1125,2550,40,10,3902,1985,5937
17,CAR (UNDP),2018,CAR-18/HCF10/SA1/EDU-PROT/UN/9008,1/23/2019 3:15:15 PM,Host Communities,1010,2607,4300,4300,12217,12743,9329,133,22,22227
17,CAR (UNDP),2018,CAR-18/HCF10/SA1/EDU-PROT/UN/9008,1/23/2019 3:15:15 PM,Internally Displaced People,3030,5420,8200,8200,24850,92,8,18098,19495,37693
17,CAR (UNDP),2018,CAR-18/HCF10/SA1/EDU-PROT/UN/9008,1/23/2019 3:15:15 PM,Overall,4040,8027,12500,12500,37067,12835,9337,18231,19517,59920
17,CAR (UNDP),2018,CAR-18/HCF10/SA1/ER-FSEC/INGO/9107,6/7/2019 2:33:33 PM,Host Communities,3570,3780,6720,6930,21000,1544,1944,4,8,3500
17,CAR (UNDP),2018,CAR-18/HCF10/SA1/ER-FSEC/INGO/9107,6/7/2019 2:33:33 PM,Internally Displaced People,5250,5460,5040,5250,21000,1177,2317,3,3,3500
17,CAR (UNDP),2018,CAR-18/HCF10/SA1/ER-FSEC/INGO/9107,6/7/2019 2:33:33 PM,Overall,8820,9240,11760,12180,42000,6953,7966,12653,12756,40328
17,CAR (UNDP),2018,CAR-18/HCF10/SA1/ER-WaSH/INGO/9163,5/14/2019 2:11:14 PM,Host Communities,1657,1918,3555,3870,11000,0,0,0,0,0
17,CAR (UNDP),2018,CAR-18/HCF10/SA1/ER-WaSH/INGO/9163,5/14/2019 2:11:14 PM,Internally Displaced People,2109,2441,4525,4925,14000,0,0,0,0,0
17,CAR (UNDP),2018,CAR-18/HCF10/SA1/ER-WaSH/INGO/9163,5/14/2019 2:11:14 PM,Overall,3766,4359,8080,8795,25000,1527,1765,3275,3562,10129
17,CAR (UNDP),2018,CAR-18/HCF10/SA1/FSEC/UN/9142,9/4/2019 8:07:31 AM,Host Communities,4410,4590,6590,6885,22475,4777,4912,7361,7458,24508
17,CAR (UNDP),2018,CAR-18/HCF10/SA1/FSEC/UN/9142,9/4/2019 8:07:31 AM,Internally Displaced People,1470,1530,2230,2295,7525,1593,1658,2454,2487,8192
17,CAR (UNDP),2018,CAR-18/HCF10/SA1/FSEC/UN/9142,9/4/2019 8:07:31 AM,Overall,5880,6120,8820,9180,30000,6370,6630,9555,9945,32500
17,CAR (UNDP),2018,CAR-18/HCF10/SA1/HLT/INGO/9044,4/1/2019 8:41:38 AM,Host Communities,461,316,464,414,1655,10710,11527,13609,13910,49756
17,CAR (UNDP),2018,CAR-18/HCF10/SA1/HLT/INGO/9044,4/1/2019 8:41:38 AM,Internally Displaced People,318,312,371,368,1369,4044,1323,3586,3299,12252
17,CAR (UNDP),2018,CAR-18/HCF10/SA1/HLT/INGO/9044,4/1/2019 8:41:38 AM,Overall,14746,12399,17207,17105,61457,14754,12850,17195,17209,62008
17,CAR (UNDP),2018,CAR-18/HCF10/SA1/HLT/UN/9123,2/13/2019 3:53:44 PM,Host Communities,8048,8375,2139,2227,20789,0,0,0,0,0
17,CAR (UNDP),2018,CAR-18/HCF10/SA1/HLT/UN/9123,2/13/2019 3:53:44 PM,Internally Displaced People,14017,14590,3726,3878,36211,0,0,0,0,0
17,CAR (UNDP),2018,CAR-18/HCF10/SA1/HLT/UN/9123,2/13/2019 3:53:44 PM,Overall,22065,22965,5865,6105,57000,18000,15000,4000,5000,42000
17,CAR (UNDP),2018,CAR-18/HCF10/SA1/HLT/UN/9183,8/6/2019 1:46:35 PM,Host Communities,16758,17442,10729,12071,57000,27000,27800,17200,18600,90600
17,CAR (UNDP),2018,CAR-18/HCF10/SA1/HLT/UN/9183,8/6/2019 1:46:35 PM,Internally Displaced People,29400,30600,18824,21176,100000,14000,15000,9100,11300,49400
17,CAR (UNDP),2018,CAR-18/HCF10/SA1/HLT/UN/9183,8/6/2019 1:46:35 PM,Other,0,0,0,0,0,6000,6200,3700,4100,20000
17,CAR (UNDP),2018,CAR-18/HCF10/SA1/HLT/UN/9183,8/6/2019 1:46:35 PM,Overall,46158,48042,29553,33247,157000,47000,49000,30000,34000,160000
17,CAR (UNDP),2018,CAR-18/HCF10/SA1/HLT-NUT/INGO/9550,9/3/2019 1:38:19 PM,Host Communities,95,0,0,0,95,95,0,0,0,95
17,CAR (UNDP),2018,CAR-18/HCF10/SA1/HLT-NUT/INGO/9550,9/3/2019 1:38:19 PM,Overall,95,0,0,0,95,95,0,0,0,95
17,CAR (UNDP),2018,CAR-18/HCF10/SA1/HLT-NUT/NGO/9144,3/11/2019 8:45:40 AM,Host Communities,0,150,1400,1500,3050,23,652,5037,5337,11049
17,CAR (UNDP),2018,CAR-18/HCF10/SA1/HLT-NUT/NGO/9144,3/11/2019 8:45:40 AM,Overall,11,350,4008,4097,8466,23,652,5037,5337,11049
17,CAR (UNDP),2018,CAR-18/HCF10/SA1/LOG/INGO/9000,2/5/2019 7:55:12 AM,Overall,0,23,0,0,23,0,33,0,0,33
17,CAR (UNDP),2018,CAR-18/HCF10/SA1/LOG/INGO/9170,4/3/2019 8:41:02 AM,Host Communities,81,9,0,0,90,203,73,0,0,276
17,CAR (UNDP),2018,CAR-18/HCF10/SA1/LOG/INGO/9170,4/3/2019 8:41:02 AM,Overall,81,9,0,0,90,203,73,0,0,276
17,CAR (UNDP),2018,CAR-18/HCF10/SA1/LOG/UN/9160,12/13/2018 9:54:34 AM,Overall,15,0,0,0,15,15,0,0,0,15
17,CAR (UNDP),2018,CAR-18/HCF10/SA1/NFI/UN/9082,3/25/2019 7:35:23 AM,Internally Displaced People,2325,2475,1425,1275,7500,722,1266,1562,1576,5126
17,CAR (UNDP),2018,CAR-18/HCF10/SA1/NFI/UN/9082,3/25/2019 7:35:23 AM,Overall,2325,2475,1425,1275,7500,722,1266,1562,1576,5126
17,CAR (UNDP),2018,CAR-18/HCF10/SA1/NFI/UN/9174,6/21/2019 1:33:19 PM,Host Communities,271,402,396,594,1663,365,284,156,299,1104
17,CAR (UNDP),2018,CAR-18/HCF10/SA1/NFI/UN/9174,6/21/2019 1:33:19 PM,Internally Displaced People,554,818,804,1206,3382,1263,925,614,1139,3941
17,CAR (UNDP),2018,CAR-18/HCF10/SA1/NFI/UN/9174,6/21/2019 1:33:19 PM,Overall,825,1220,1200,1800,5045,1628,1209,770,1438,5045
17,CAR (UNDP),2018,CAR-18/HCF10/SA1/NFI-ER/INGO/9177,9/3/2019 2:58:37 PM,Host Communities,588,882,1256,1474,4200,0,0,0,0,0
17,CAR (UNDP),2018,CAR-18/HCF10/SA1/NFI-ER/INGO/9177,9/3/2019 2:58:37 PM,Internally Displaced People,840,1260,1794,2106,6000,2484,2692,2535,2639,10350
17,CAR (UNDP),2018,CAR-18/HCF10/SA1/NFI-ER/INGO/9177,9/3/2019 2:58:37 PM,Overall,1428,2142,3050,3580,10200,2484,2692,2535,2639,10350
17,CAR (UNDP),2018,CAR-18/HCF10/SA1/NFI-PROT/INGO/9164,4/3/2019 9:47:31 AM,Host Communities,450,577,1055,1002,3084,379,436,432,896,2143
17,CAR (UNDP),2018,CAR-18/HCF10/SA1/NFI-PROT/INGO/9164,4/3/2019 9:47:31 AM,Internally Displaced People,5596,7169,13111,12458,38334,2510,5091,6636,8289,22526
17,CAR (UNDP),2018,CAR-18/HCF10/SA1/NFI-PROT/INGO/9164,4/3/2019 9:47:31 AM,Other,259,329,602,573,1763,0,0,0,0,0
17,CAR (UNDP),2018,CAR-18/HCF10/SA1/NFI-PROT/INGO/9164,4/3/2019 9:47:31 AM,Overall,6432,8240,15070,14320,44062,2713,4933,7401,9622,24669
17,CAR (UNDP),2018,CAR-18/HCF10/SA1/NFI-PROT/INGO/9164,4/3/2019 9:47:31 AM,Refugees,127,165,302,287,881,0,0,0,0,0
17,CAR (UNDP),2018,CAR-18/HCF10/SA1/NUT/INGO/9547,5/14/2019 10:49:26 AM,Internally Displaced People,63,89,604,682,1438,297,352,266,302,1217
17,CAR (UNDP),2018,CAR-18/HCF10/SA1/NUT/INGO/9547,5/14/2019 10:49:26 AM,Overall,63,89,604,682,1438,297,352,266,302,1217
17,CAR (UNDP),2018,CAR-18/HCF10/SA1/NUT/UN/9029,12/2/2021 3:42:13 PM,Host Communities,0,0,2773,3004,5777,0,0,5347,5862,11209
17,CAR (UNDP),2018,CAR-18/HCF10/SA1/NUT/UN/9029,12/2/2021 3:42:13 PM,Internally Displaced People,0,0,1188,1288,2476,0,0,0,0,0
17,CAR (UNDP),2018,CAR-18/HCF10/SA1/NUT/UN/9029,12/2/2021 3:42:13 PM,Overall,0,0,3961,4292,8253,0,0,5347,5862,11209
17,CAR (UNDP),2018,CAR-18/HCF10/SA1/NUT/UN/9106,1/14/2019 9:50:30 AM,Host Communities,0,0,2005,2172,4177,0,0,2047,2220,4267
17,CAR (UNDP),2018,CAR-18/HCF10/SA1/NUT/UN/9106,1/14/2019 9:50:30 AM,Internally Displaced People,0,0,669,724,1393,0,0,684,739,1423
17,CAR (UNDP),2018,CAR-18/HCF10/SA1/NUT/UN/9106,1/14/2019 9:50:30 AM,Overall,0,0,2674,2896,5570,0,0,2731,2959,5690
17,CAR (UNDP),2018,CAR-18/HCF10/SA1/NUT-HLT/INGO/9004,3/11/2019 1:51:21 PM,Host Communities,11966,12963,2503,2712,30144,12909,13985,2706,2919,32519
17,CAR (UNDP),2018,CAR-18/HCF10/SA1/NUT-HLT/INGO/9004,3/11/2019 1:51:21 PM,Internally Displaced People,5128,5556,1073,1162,12919,3663,3968,766,830,9227
17,CAR (UNDP),2018,CAR-18/HCF10/SA1/NUT-HLT/INGO/9004,3/11/2019 1:51:21 PM,Overall,17094,18519,3576,3874,43063,16572,17952,3467,3755,41746
17,CAR (UNDP),2018,CAR-18/HCF10/SA1/NUT-HLT/INGO/9075,3/11/2019 9:11:47 AM,Host Communities,7450,9420,6355,6885,30110,13620,16029,7301,7684,44634
17,CAR (UNDP),2018,CAR-18/HCF10/SA1/NUT-HLT/INGO/9075,3/11/2019 9:11:47 AM,Overall,15706,18364,8161,8842,51073,12854,16026,7301,7684,43865
17,CAR (UNDP),2018,CAR-18/HCF10/SA1/NUT-HLT/INGO/9077,4/23/2019 8:22:25 AM,Host Communities,1896,2137,396,447,4876,1869,2026,378,438,4711
17,CAR (UNDP),2018,CAR-18/HCF10/SA1/NUT-HLT/INGO/9077,4/23/2019 8:22:25 AM,Internally Displaced People,7581,8550,1586,1788,19505,7480,8104,1563,1696,18843
17,CAR (UNDP),2018,CAR-18/HCF10/SA1/NUT-HLT/INGO/9077,4/23/2019 8:22:25 AM,Overall,9477,10687,1982,2235,24381,0,0,0,0,0
17,CAR (UNDP),2018,CAR-18/HCF10/SA1/PROT/INGO/9155,4/2/2019 3:31:57 PM,Host Communities,8818,10813,5858,6695,32184,7322,8086,2181,2812,20401
17,CAR (UNDP),2018,CAR-18/HCF10/SA1/PROT/INGO/9155,4/2/2019 3:31:57 PM,Internally Displaced People,4890,5996,3247,3712,17845,8461,9344,2521,3249,23575
17,CAR (UNDP),2018,CAR-18/HCF10/SA1/PROT/INGO/9155,4/2/2019 3:31:57 PM,Overall,13708,16810,9105,10407,50030,15783,17430,4702,6061,43976
17,CAR (UNDP),2018,CAR-18/HCF10/SA1/PROT/INGO/9162,11/7/2018 3:53:32 PM,Host Communities,5341,3875,770,755,10741,7263,3672,1621,1648,14204
17,CAR (UNDP),2018,CAR-18/HCF10/SA1/PROT/INGO/9162,11/7/2018 3:53:32 PM,Internally Displaced People,1596,1157,230,225,3208,0,0,0,0,0
17,CAR (UNDP),2018,CAR-18/HCF10/SA1/PROT/INGO/9162,11/7/2018 3:53:32 PM,Overall,6937,5032,1000,980,13949,7263,3672,1621,1648,14204
17,CAR (UNDP),2018,CAR-18/HCF10/SA1/PROT/INGO/9548,8/7/2019 7:30:03 AM,Overall,135,90,0,0,225,65,24,0,0,89
17,CAR (UNDP),2018,CAR-18/HCF10/SA1/WaSH/INGO/9080,8/7/2019 6:56:32 AM,Host Communities,1026,915,1290,1303,4534,3429,3575,575,343,7922
17,CAR (UNDP),2018,CAR-18/HCF10/SA1/WaSH/INGO/9080,8/7/2019 6:56:32 AM,Internally Displaced People,928,1122,941,991,3982,2312,2378,384,228,5302
17,CAR (UNDP),2018,CAR-18/HCF10/SA1/WaSH/INGO/9080,8/7/2019 6:56:32 AM,Other,488,530,477,489,1984,0,0,0,0,0
17,CAR (UNDP),2018,CAR-18/HCF10/SA1/WaSH/INGO/9080,8/7/2019 6:56:32 AM,Overall,2442,2567,2708,2783,10500,5641,6053,959,571,13224
17,CAR (UNDP),2018,CAR-18/HCF10/SA1/WaSH/INGO/9119,2/20/2019 9:44:43 AM,Host Communities,523,546,592,614,2275,0,0,0,0,0
17,CAR (UNDP),2018,CAR-18/HCF10/SA1/WaSH/INGO/9119,2/20/2019 9:44:43 AM,Internally Displaced People,8125,8927,14848,14473,46373,5340,6360,21655,21966,55321
17,CAR (UNDP),2018,CAR-18/HCF10/SA1/WaSH/INGO/9119,2/20/2019 9:44:43 AM,Other,101,106,115,119,441,0,0,0,0,0
17,CAR (UNDP),2018,CAR-18/HCF10/SA1/WaSH/INGO/9119,2/20/2019 9:44:43 AM,Overall,8749,9579,15555,15206,49089,5340,6360,21655,21966,55321
17,CAR (UNDP),2018,CAR-18/HCF10/SA1/WaSH/INGO/9135,3/26/2019 9:47:26 AM,Host Communities,1919,2420,2003,2086,8428,1988,2506,2074,2160,8728
17,CAR (UNDP),2018,CAR-18/HCF10/SA1/WaSH/INGO/9135,3/26/2019 9:47:26 AM,Internally Displaced People,6900,8700,7200,7500,30300,6831,8614,7129,7426,30000
17,CAR (UNDP),2018,CAR-18/HCF10/SA1/WaSH/INGO/9135,3/26/2019 9:47:26 AM,Overall,8819,11120,9203,9586,38728,8819,11120,9203,9586,38728
17,CAR (UNDP),2018,CAR-18/HCF10/SA1/WaSH/INGO/9178,3/11/2019 8:39:32 AM,Internally Displaced People,6300,4950,5850,5400,22500,5580,5337,7035,6307,24259
17,CAR (UNDP),2018,CAR-18/HCF10/SA1/WaSH/INGO/9178,3/11/2019 8:39:32 AM,Overall,6300,4950,5850,5400,22500,5580,5537,7035,6307,24459
17,CAR (UNDP),2018,CAR-18/HCF10/SA1/WaSH/INGO/9215,3/13/2019 3:07:47 PM,Host Communities,4716,5110,1100,1192,12118,4140,4485,866,938,10429
17,CAR (UNDP),2018,CAR-18/HCF10/SA1/WaSH/INGO/9215,3/13/2019 3:07:47 PM,Internally Displaced People,699,757,275,298,2029,1878,2035,393,425,4731
17,CAR (UNDP),2018,CAR-18/HCF10/SA1/WaSH/INGO/9215,3/13/2019 3:07:47 PM,Other,397,430,83,90,1000,0,0,0,0,0
17,CAR (UNDP),2018,CAR-18/HCF10/SA1/WaSH/INGO/9215,3/13/2019 3:07:47 PM,Overall,5812,6297,1458,1580,15147,5815,6299,1460,1586,15160
17,CAR (UNDP),2018,CAR-18/HCF10/SA1/WaSH/NGO/9078,5/15/2019 1:01:52 PM,Host Communities,500,700,500,500,2200,450,800,840,910,3000
17,CAR (UNDP),2018,CAR-18/HCF10/SA1/WaSH/NGO/9078,5/15/2019 1:01:52 PM,Internally Displaced People,1000,3500,1500,2000,8000,1000,3500,1500,2000,8000
17,CAR (UNDP),2018,CAR-18/HCF10/SA1/WaSH/NGO/9078,5/15/2019 1:01:52 PM,Overall,1500,4200,2000,2500,10200,1450,4300,2340,2910,11000
17,CAR (UNDP),2018,CAR-18/HCF10/SA2/CCCM/NGO/10573,12/11/2019 8:50:32 AM,Internally Displaced People,3032,3467,4970,4756,16225,6932,4686,7200,7410,26228
17,CAR (UNDP),2018,CAR-18/HCF10/SA2/CCCM/NGO/10573,12/11/2019 8:50:32 AM,Overall,3032,3467,4970,4756,16225,6932,4686,7200,7410,26228
17,CAR (UNDP),2018,CAR-18/HCF10/SA2/EDU/INGO/10588,10/28/2019 10:29:06 AM,Host Communities,1445,615,1338,1077,4475,905,995,1639,1343,4882
17,CAR (UNDP),2018,CAR-18/HCF10/SA2/EDU/INGO/10588,10/28/2019 10:29:06 AM,Internally Displaced People,1765,750,1635,1318,5468,1085,1195,1638,1342,5260
17,CAR (UNDP),2018,CAR-18/HCF10/SA2/EDU/INGO/10588,10/28/2019 10:29:06 AM,Overall,3210,1365,2973,2395,9943,1990,2190,3277,2685,10142
17,CAR (UNDP),2018,CAR-18/HCF10/SA2/EDU/UN/10539,10/14/2019 7:59:26 AM,Host Communities,16,12,1142,1142,2312,0,0,0,0,0
17,CAR (UNDP),2018,CAR-18/HCF10/SA2/EDU/UN/10539,10/14/2019 7:59:26 AM,Internally Displaced People,19,12,858,858,1747,69,27,2654,2034,4784
17,CAR (UNDP),2018,CAR-18/HCF10/SA2/EDU/UN/10539,10/14/2019 7:59:26 AM,Overall,35,24,2000,2000,4059,69,27,2654,2034,4784
17,CAR (UNDP),2018,CAR-18/HCF10/SA2/EDU-NFI-WaSH-PROT/INGO/10538,10/14/2019 8:07:11 AM,Host Communities,360,274,2159,1512,4305,2794,2510,11738,11387,28429
17,CAR (UNDP),2018,CAR-18/HCF10/SA2/EDU-NFI-WaSH-PROT/INGO/10538,10/14/2019 8:07:11 AM,Internally Displaced People,1071,1351,570,386,3378,482,686,855,956,2979
17,CAR (UNDP),2018,CAR-18/HCF10/SA2/EDU-NFI-WaSH-PROT/INGO/10538,10/14/2019 8:07:11 AM,Other,595,725,920,981,3221,129,15,0,0,144
17,CAR (UNDP),2018,CAR-18/HCF10/SA2/EDU-NFI-WaSH-PROT/INGO/10538,10/14/2019 8:07:11 AM,Overall,2026,2350,3649,2879,10904,3467,3253,12609,12352,31681
17,CAR (UNDP),2018,CAR-18/HCF10/SA2/EDU-NFI-WaSH-PROT/INGO/10538,10/14/2019 8:07:11 AM,Refugees,0,0,0,0,0,62,42,16,9,129
17,CAR (UNDP),2018,CAR-18/HCF10/SA2/EDU-PROT-FSEC-CCCM/INGO/10528,9/6/2019 8:40:13 AM,Host Communities,664,643,1164,1120,3591,1835,2074,3017,3008,9934
17,CAR (UNDP),2018,CAR-18/HCF10/SA2/EDU-PROT-FSEC-CCCM/INGO/10528,9/6/2019 8:40:13 AM,Internally Displaced People,3523,3770,3678,3936,14907,3839,5193,9286,11147,29465
17,CAR (UNDP),2018,CAR-18/HCF10/SA2/EDU-PROT-FSEC-CCCM/INGO/10528,9/6/2019 8:40:13 AM,Overall,4187,4413,4842,5056,18498,5674,7267,12303,14155,39399
17,CAR (UNDP),2018,CAR-18/HCF10/SA2/ER/INGO/10600,8/21/2019 10:19:08 AM,Host Communities,1095,1358,1314,613,4380,1095,1358,1314,613,4380
17,CAR (UNDP),2018,CAR-18/HCF10/SA2/ER/INGO/10600,8/21/2019 10:19:08 AM,Internally Displaced People,1095,1358,1314,613,4380,1095,1358,1314,613,4380
17,CAR (UNDP),2018,CAR-18/HCF10/SA2/ER/INGO/10600,8/21/2019 10:19:08 AM,Other,3285,4073,3942,1840,13140,3285,4073,3942,1840,13140
17,CAR (UNDP),2018,CAR-18/HCF10/SA2/ER/INGO/10600,8/21/2019 10:19:08 AM,Overall,5475,6789,6570,3066,21900,5475,6789,6570,3066,21900
17,CAR (UNDP),2018,CAR-18/HCF10/SA2/ER/NGO/10537,10/14/2019 4:51:14 PM,Host Communities,680,788,682,672,2822,660,705,705,710,2780
17,CAR (UNDP),2018,CAR-18/HCF10/SA2/ER/NGO/10537,10/14/2019 4:51:14 PM,Internally Displaced People,630,590,606,653,2479,750,775,885,700,3110
17,CAR (UNDP),2018,CAR-18/HCF10/SA2/ER/NGO/10537,10/14/2019 4:51:14 PM,Other,710,662,731,721,2824,610,560,610,670,2450
17,CAR (UNDP),2018,CAR-18/HCF10/SA2/ER/NGO/10537,10/14/2019 4:51:14 PM,Overall,2020,2040,2019,2046,8125,2020,2040,2200,2080,8340
17,CAR (UNDP),2018,CAR-18/HCF10/SA2/ER/NGO/10582,1/13/2020 8:52:47 AM,Host Communities,360,365,0,0,725,540,699,0,0,1239
17,CAR (UNDP),2018,CAR-18/HCF10/SA2/ER/NGO/10582,1/13/2020 8:52:47 AM,Internally Displaced People,250,250,0,0,500,161,225,0,0,386
17,CAR (UNDP),2018,CAR-18/HCF10/SA2/ER/NGO/10582,1/13/2020 8:52:47 AM,Overall,610,615,0,0,1225,701,924,0,0,1625
17,CAR (UNDP),2018,CAR-18/HCF10/SA2/ETC/UN/10576,4/8/2020 8:43:29 AM,Other,0,0,0,0,0,3,1,0,0,4
17,CAR (UNDP),2018,CAR-18/HCF10/SA2/ETC/UN/10576,4/8/2020 8:43:29 AM,Overall,4,2,0,0,6,3,1,0,0,4
17,CAR (UNDP),2018,CAR-18/HCF10/SA2/FSEC/INGO/10564,9/5/2019 11:30:39 AM,Host Communities,905,905,1811,1811,5432,896,395,3480,3582,8353
17,CAR (UNDP),2018,CAR-18/HCF10/SA2/FSEC/INGO/10564,9/5/2019 11:30:39 AM,Internally Displaced People,1132,1132,2150,2376,6790,600,460,4480,5586,11126
17,CAR (UNDP),2018,CAR-18/HCF10/SA2/FSEC/INGO/10564,9/5/2019 11:30:39 AM,Other,2263,2263,4526,4526,13578,592,397,2480,1592,5061
17,CAR (UNDP),2018,CAR-18/HCF10/SA2/FSEC/INGO/10564,9/5/2019 11:30:39 AM,Overall,4300,4300,8487,8713,25800,2088,1252,10440,10760,24540
17,CAR (UNDP),2018,CAR-18/HCF10/SA2/FSEC/INGO/10602,7/12/2019 9:17:43 AM,Host Communities,694,917,595,544,2750,885,980,601,696,3162
17,CAR (UNDP),2018,CAR-18/HCF10/SA2/FSEC/INGO/10602,7/12/2019 9:17:43 AM,Internally Displaced People,1100,1000,800,800,3700,1080,1195,732,849,3856
17,CAR (UNDP),2018,CAR-18/HCF10/SA2/FSEC/INGO/10602,7/12/2019 9:17:43 AM,Other,900,1000,400,600,2900,681,754,462,535,2432
17,CAR (UNDP),2018,CAR-18/HCF10/SA2/FSEC/INGO/10602,7/12/2019 9:17:43 AM,Overall,2694,2917,1795,1944,9350,2646,2929,1795,2080,9450
17,CAR (UNDP),2018,CAR-18/HCF10/SA2/FSEC/INGO/10838,9/2/2019 8:55:28 AM,Other,40,0,0,0,40,41,0,0,0,41
17,CAR (UNDP),2018,CAR-18/HCF10/SA2/FSEC/INGO/10838,9/2/2019 8:55:28 AM,Overall,40,0,0,0,40,41,0,0,0,41
17,CAR (UNDP),2018,CAR-18/HCF10/SA2/FSEC/UN/10601,11/6/2019 4:04:06 PM,Host Communities,3430,3570,5145,5355,17500,1500,1570,2255,2350,7675
17,CAR (UNDP),2018,CAR-18/HCF10/SA2/FSEC/UN/10601,11/6/2019 4:04:06 PM,Internally Displaced People,980,1020,1470,1530,5000,430,445,640,670,2185
17,CAR (UNDP),2018,CAR-18/HCF10/SA2/FSEC/UN/10601,11/6/2019 4:04:06 PM,Other,490,510,735,765,2500,2965,3090,4450,4635,15140
17,CAR (UNDP),2018,CAR-18/HCF10/SA2/FSEC/UN/10601,11/6/2019 4:04:06 PM,Overall,4900,5100,7350,7650,25000,4895,5105,7345,7655,25000
17,CAR (UNDP),2018,CAR-18/HCF10/SA2/FSEC-EDU/INGO/10554,9/3/2019 2:35:17 PM,Overall,2448,2703,2652,2397,10200,5124,4836,0,0,9960
17,CAR (UNDP),2018,CAR-18/HCF10/SA2/FSEC-WaSH/INGO/10587,11/8/2019 11:11:08 AM,Overall,1331,1349,1388,1369,5437,1039,1239,1847,1865,5990
17,CAR (UNDP),2018,CAR-18/HCF10/SA2/HLT/INGO/10610,9/6/2019 10:26:18 AM,Host Communities,1664,1664,1401,1401,6130,3520,4778,2455,2676,13429
17,CAR (UNDP),2018,CAR-18/HCF10/SA2/HLT/INGO/10610,9/6/2019 10:26:18 AM,Internally Displaced People,223,223,187,187,820,0,0,0,0,0
17,CAR (UNDP),2018,CAR-18/HCF10/SA2/HLT/INGO/10610,9/6/2019 10:26:18 AM,Overall,1887,1887,1588,1588,6950,3520,4778,2455,2676,13429
17,CAR (UNDP),2018,CAR-18/HCF10/SA2/HLT/UN/10592,9/3/2019 1:47:09 PM,Host Communities,7128,7433,41859,43586,100006,9500,9500,54000,56000,129000
17,CAR (UNDP),2018,CAR-18/HCF10/SA2/HLT/UN/10592,9/3/2019 1:47:09 PM,Internally Displaced People,7126,7429,41852,43587,99994,5000,5500,29500,31000,71000
17,CAR (UNDP),2018,CAR-18/HCF10/SA2/HLT/UN/10592,9/3/2019 1:47:09 PM,Overall,14254,14862,83711,87173,200000,14500,15000,83500,87000,200000
17,CAR (UNDP),2018,CAR-18/HCF10/SA2/HLT/UN/10607,9/3/2019 1:23:41 PM,Host Communities,15446,16076,4106,4274,39902,12620,16692,3200,4110,36622
17,CAR (UNDP),2018,CAR-18/HCF10/SA2/HLT/UN/10607,9/3/2019 1:23:41 PM,Internally Displaced People,22065,22965,5865,6105,57000,19165,20158,3905,4870,48098
17,CAR (UNDP),2018,CAR-18/HCF10/SA2/HLT/UN/10607,9/3/2019 1:23:41 PM,Overall,37515,39041,9971,10379,96906,31785,36850,7105,8980,84720
17,CAR (UNDP),2018,CAR-18/HCF10/SA2/HLT-NUT/INGO/10563,12/4/2019 3:01:18 PM,Host Communities,1157,2483,4851,5078,13569,1060,2359,4852,6116,14387
17,CAR (UNDP),2018,CAR-18/HCF10/SA2/HLT-NUT/INGO/10563,12/4/2019 3:01:18 PM,Internally Displaced People,2011,1416,1810,2350,7587,1843,2295,1719,2233,8090
17,CAR (UNDP),2018,CAR-18/HCF10/SA2/HLT-NUT/INGO/10563,12/4/2019 3:01:18 PM,Overall,3168,4899,6661,8466,23194,2903,4654,6571,8349,22477
17,CAR (UNDP),2018,CAR-18/HCF10/SA2/LOG/INGO/10522,2/7/2020 3:10:33 PM,Overall,1,1,1,1,4,1,1,1,1,4
17,CAR (UNDP),2018,CAR-18/HCF10/SA2/LOG/INGO/10545,4/7/2020 9:27:52 AM,Other,50,23,0,0,73,7,31,0,0,38
17,CAR (UNDP),2018,CAR-18/HCF10/SA2/LOG/INGO/10545,4/7/2020 9:27:52 AM,Overall,50,23,0,0,73,7,31,0,0,38
17,CAR (UNDP),2018,CAR-18/HCF10/SA2/LOG/INGO/10596,9/10/2019 1:35:45 PM,Host Communities,0,0,0,0,0,20,20,20,8,68
17,CAR (UNDP),2018,CAR-18/HCF10/SA2/LOG/INGO/10596,9/10/2019 1:35:45 PM,Overall,20,20,20,8,68,20,20,20,8,68
17,CAR (UNDP),2018,CAR-18/HCF10/SA2/LOG/UN/10559,3/1/2019 2:36:15 PM,Overall,0,0,0,15,15,0,0,0,15,15
17,CAR (UNDP),2018,CAR-18/HCF10/SA2/NFI/UN/10590,12/4/2019 1:20:26 PM,Host Communities,384,416,624,576,2000,384,416,624,576,2000
17,CAR (UNDP),2018,CAR-18/HCF10/SA2/NFI/UN/10590,12/4/2019 1:20:26 PM,Internally Displaced People,1536,1664,2496,2304,8000,1536,1664,2496,2304,8000
17,CAR (UNDP),2018,CAR-18/HCF10/SA2/NFI/UN/10590,12/4/2019 1:20:26 PM,Overall,1920,2080,3120,2880,10000,1920,2080,3120,2880,10000
17,CAR (UNDP),2018,CAR-18/HCF10/SA2/NFI-CCCM-PROT/UN/10567,9/6/2019 2:52:03 PM,Internally Displaced People,15273,16362,21477,20388,73500,11991,12562,16560,15989,57102
17,CAR (UNDP),2018,CAR-18/HCF10/SA2/NFI-CCCM-PROT/UN/10567,9/6/2019 2:52:03 PM,Other,510,540,215,235,1500,0,0,0,0,0
17,CAR (UNDP),2018,CAR-18/HCF10/SA2/NFI-CCCM-PROT/UN/10567,9/6/2019 2:52:03 PM,Overall,15783,16902,21692,20623,75000,18491,19371,25535,24655,88052
17,CAR (UNDP),2018,CAR-18/HCF10/SA2/NUT/UN/10572,6/7/2019 9:53:03 AM,Host Communities,0,0,2320,2513,4833,0,0,2137,2314,4451
17,CAR (UNDP),2018,CAR-18/HCF10/SA2/NUT/UN/10572,6/7/2019 9:53:03 AM,Internally Displaced People,0,0,773,838,1611,0,0,714,772,1486
17,CAR (UNDP),2018,CAR-18/HCF10/SA2/NUT/UN/10572,6/7/2019 9:53:03 AM,Overall,0,0,3093,3351,6444,0,0,2853,3090,5943
17,CAR (UNDP),2018,CAR-18/HCF10/SA2/NUT/UN/10609,12/16/2021 2:00:07 PM,Internally Displaced People,0,0,4649,5036,9685,0,0,3640,4410,8050
17,CAR (UNDP),2018,CAR-18/HCF10/SA2/NUT/UN/10609,12/16/2021 2:00:07 PM,Overall,0,0,4649,5036,9685,0,0,3640,4410,8050
17,CAR (UNDP),2018,CAR-18/HCF10/SA2/NUT-HLT/INGO/10536,9/3/2019 9:52:12 AM,Host Communities,2914,3156,2798,3033,11901,1102,1309,1862,2217,6490
17,CAR (UNDP),2018,CAR-18/HCF10/SA2/NUT-HLT/INGO/10536,9/3/2019 9:52:12 AM,Internally Displaced People,609,660,586,634,2489,328,471,268,233,1300
17,CAR (UNDP),2018,CAR-18/HCF10/SA2/NUT-HLT/INGO/10536,9/3/2019 9:52:12 AM,Overall,3523,3816,3384,3667,14390,1430,1780,2130,2450,7790
17,CAR (UNDP),2018,CAR-18/HCF10/SA2/NUT-HLT/INGO/10565,10/29/2019 3:41:18 PM,Host Communities,22,3785,1280,1386,6473,9,1658,919,727,3313
17,CAR (UNDP),2018,CAR-18/HCF10/SA2/NUT-HLT/INGO/10565,10/29/2019 3:41:18 PM,Internally Displaced People,2,347,117,127,593,15,518,104,255,892
17,CAR (UNDP),2018,CAR-18/HCF10/SA2/NUT-HLT/INGO/10565,10/29/2019 3:41:18 PM,Overall,24,4132,1397,1513,7066,24,2176,1023,982,4205
17,CAR (UNDP),2018,CAR-18/HCF10/SA2/NUT-HLT/INGO/10579,8/6/2019 2:09:19 PM,Host Communities,11956,12952,2466,2671,30045,10474,11664,3637,3852,29627
17,CAR (UNDP),2018,CAR-18/HCF10/SA2/NUT-HLT/INGO/10579,8/6/2019 2:09:19 PM,Internally Displaced People,5510,5968,986,1068,13532,3322,4791,3771,3724,15608
17,CAR (UNDP),2018,CAR-18/HCF10/SA2/NUT-HLT/INGO/10579,8/6/2019 2:09:19 PM,Overall,17466,18920,3452,3739,43577,13796,16455,7408,7576,45235
17,CAR (UNDP),2018,CAR-18/HCF10/SA2/NUT-HLT/INGO/10583,8/22/2019 9:29:20 AM,Overall,18823,23785,6246,6501,55355,9589,11195,5423,5036,31243
17,CAR (UNDP),2018,CAR-18/HCF10/SA2/PROT/INGO/10561,9/6/2019 10:31:21 AM,Host Communities,0,0,0,0,0,4685,10211,5068,5973,25937
17,CAR (UNDP),2018,CAR-18/HCF10/SA2/PROT/INGO/10561,9/6/2019 10:31:21 AM,Internally Displaced People,10004,11599,40624,41729,103956,977,2805,1064,1255,6101
17,CAR (UNDP),2018,CAR-18/HCF10/SA2/PROT/INGO/10561,9/6/2019 10:31:21 AM,Overall,10772,12170,46009,46767,115718,5662,13016,6132,7228,32038
17,CAR (UNDP),2018,CAR-18/HCF10/SA2/PROT/INGO/10578,5/12/2020 8:45:38 AM,Host Communities,160,800,350,300,1610,9036,17395,6892,10368,43691
17,CAR (UNDP),2018,CAR-18/HCF10/SA2/PROT/INGO/10578,5/12/2020 8:45:38 AM,Internally Displaced People,500,1190,400,400,2490,375,522,257,431,1585
17,CAR (UNDP),2018,CAR-18/HCF10/SA2/PROT/INGO/10578,5/12/2020 8:45:38 AM,Overall,660,1990,750,700,4100,9411,17917,7149,10799,45276
17,CAR (UNDP),2018,CAR-18/HCF10/SA2/PROT/NGO/10568,12/3/2021 7:44:07 AM,Host Communities,2000,2100,2400,2600,9100,2014,1775,3285,2200,9274
17,CAR (UNDP),2018,CAR-18/HCF10/SA2/PROT/NGO/10568,12/3/2021 7:44:07 AM,Internally Displaced People,800,1200,1100,1100,4200,986,1606,1230,1150,4972
17,CAR (UNDP),2018,CAR-18/HCF10/SA2/PROT/NGO/10568,12/3/2021 7:44:07 AM,Other,400,1000,1100,1200,3700,0,0,0,0,0
17,CAR (UNDP),2018,CAR-18/HCF10/SA2/PROT/NGO/10568,12/3/2021 7:44:07 AM,Overall,3200,4300,4600,4900,17000,3300,4200,5100,4400,17000
17,CAR (UNDP),2018,CAR-18/HCF10/SA2/PROT/NGO/10568,12/3/2021 7:44:07 AM,Refugees,0,0,0,0,0,300,819,585,1050,2754
17,CAR (UNDP),2018,CAR-18/HCF10/SA2/PROT/UN/10603,9/3/2019 2:11:19 PM,Host Communities,2000,2080,1920,2000,8000,2001,2082,1920,2002,8005
17,CAR (UNDP),2018,CAR-18/HCF10/SA2/PROT/UN/10603,9/3/2019 2:11:19 PM,Internally Displaced People,7996,8322,7682,8000,32000,7995,8320,7682,7998,31995
17,CAR (UNDP),2018,CAR-18/HCF10/SA2/PROT/UN/10603,9/3/2019 2:11:19 PM,Overall,9996,10402,9602,10000,40000,9996,10402,9602,10000,40000
17,CAR (UNDP),2018,CAR-18/HCF10/SA2/PROT/UN/10606,9/12/2019 2:04:49 PM,Host Communities,1000,1000,7000,7000,16000,2376,2667,8212,10294,23549
17,CAR (UNDP),2018,CAR-18/HCF10/SA2/PROT/UN/10606,9/12/2019 2:04:49 PM,Internally Displaced People,4000,4000,8000,8000,24000,4360,4594,9251,10959,29164
17,CAR (UNDP),2018,CAR-18/HCF10/SA2/PROT/UN/10606,9/12/2019 2:04:49 PM,Overall,5000,5000,15000,15000,40000,6736,7261,17463,21253,52713
17,CAR (UNDP),2018,CAR-18/HCF10/SA2/WaSH/INGO/10525,9/4/2019 9:56:10 AM,Host Communities,0,0,0,0,0,429,461,419,444,1753
17,CAR (UNDP),2018,CAR-18/HCF10/SA2/WaSH/INGO/10525,9/4/2019 9:56:10 AM,Internally Displaced People,0,0,0,0,0,534,582,564,582,2262
17,CAR (UNDP),2018,CAR-18/HCF10/SA2/WaSH/INGO/10525,9/4/2019 9:56:10 AM,Overall,1680,1855,1820,1645,7000,963,1043,983,1026,4015
17,CAR (UNDP),2018,CAR-18/HCF10/SA2/WaSH/INGO/10527,6/18/2019 7:59:34 AM,Host Communities,397,613,718,306,2034,0,0,0,0,0
17,CAR (UNDP),2018,CAR-18/HCF10/SA2/WaSH/INGO/10527,6/18/2019 7:59:34 AM,Internally Displaced People,133,204,239,102,678,6058,6940,7535,8386,28919
17,CAR (UNDP),2018,CAR-18/HCF10/SA2/WaSH/INGO/10527,6/18/2019 7:59:34 AM,Other,2120,3268,3429,1632,10449,0,0,0,0,0
17,CAR (UNDP),2018,CAR-18/HCF10/SA2/WaSH/INGO/10527,6/18/2019 7:59:34 AM,Overall,2650,4085,4787,2040,13562,6058,6940,7535,8385,28918
17,CAR (UNDP),2018,CAR-18/HCF10/SA2/WaSH/INGO/10581,8/6/2019 3:19:10 PM,Host Communities,926,970,1191,1323,4410,1087,1477,676,813,4053
17,CAR (UNDP),2018,CAR-18/HCF10/SA2/WaSH/INGO/10581,8/6/2019 3:19:10 PM,Internally Displaced People,1588,1663,2041,2268,7560,1595,2511,1670,1526,7302
17,CAR (UNDP),2018,CAR-18/HCF10/SA2/WaSH/INGO/10581,8/6/2019 3:19:10 PM,Other,794,832,1020,1134,3780,925,1063,417,672,3077
17,CAR (UNDP),2018,CAR-18/HCF10/SA2/WaSH/INGO/10581,8/6/2019 3:19:10 PM,Overall,3308,3465,4252,4725,15750,3607,5051,2763,3011,14432
17,CAR (UNDP),2018,CAR-18/HCF10/SA2/WaSH/INGO/10589,12/30/2019 3:55:16 PM,Overall,1,1,1,1,4,1,1,1,1,4
17,CAR (UNDP),2018,CAR-18/HCF10/SA2/WaSH/NGO/10577,11/13/2019 7:46:26 AM,Host Communities,300,400,200,400,1300,500,905,200,376,1981
17,CAR (UNDP),2018,CAR-18/HCF10/SA2/WaSH/NGO/10577,11/13/2019 7:46:26 AM,Internally Displaced People,2000,4000,700,2000,8700,0,0,0,0,0
17,CAR (UNDP),2018,CAR-18/HCF10/SA2/WaSH/NGO/10577,11/13/2019 7:46:26 AM,Other,100,600,100,200,1000,1501,5100,1200,2124,9925
17,CAR (UNDP),2018,CAR-18/HCF10/SA2/WaSH/NGO/10577,11/13/2019 7:46:26 AM,Overall,2400,5000,1000,2600,11000,2001,6005,1400,2500,11906
17,CAR (UNDP),2018,CAR-18/HCF10/SA2/WaSH-PROT/INGO/10580,9/17/2019 7:47:39 AM,Host Communities,5760,6120,11520,12600,36000,5605,6402,10743,11128,33878
17,CAR (UNDP),2018,CAR-18/HCF10/SA2/WaSH-PROT/INGO/10580,9/17/2019 7:47:39 AM,Internally Displaced People,12063,12816,24125,26387,75391,12303,12824,24614,24008,73749
17,CAR (UNDP),2018,CAR-18/HCF10/SA2/WaSH-PROT/INGO/10580,9/17/2019 7:47:39 AM,Overall,17823,18936,35645,38987,111391,17908,19226,35357,35136,107627
17,CAR (UNDP),2019,CAR-19/HCF10/RA 2/HLT/O/13681,6/11/2020 8:03:13 AM,Host Communities,0,0,13708,14547,28255,0,0,13600,14251,27851
17,CAR (UNDP),2019,CAR-19/HCF10/RA 2/HLT/O/13681,6/11/2020 8:03:13 AM,Overall,0,0,13708,14547,28255,0,0,13600,14251,27851
17,CAR (UNDP),2019,CAR-19/HCF10/RA 2/HLT-NUT/INGO/13613,3/25/2020 9:14:58 AM,Other,2024,4026,11498,11512,29060,3657,6119,5869,6043,21688
17,CAR (UNDP),2019,CAR-19/HCF10/RA 2/HLT-NUT/INGO/13613,3/25/2020 9:14:58 AM,Overall,2024,4026,11498,11512,29060,3657,6119,5869,6043,21688
17,CAR (UNDP),2019,CAR-19/HCF10/RA 2/HLT-PROT/INGO/13708,6/28/2020 6:56:08 AM,Host Communities,1372,1428,343,357,3500,1616,6006,1175,1892,10689
17,CAR (UNDP),2019,CAR-19/HCF10/RA 2/HLT-PROT/INGO/13708,6/28/2020 6:56:08 AM,Internally Displaced People,2744,2856,686,714,7000,244,591,242,304,1381
17,CAR (UNDP),2019,CAR-19/HCF10/RA 2/HLT-PROT/INGO/13708,6/28/2020 6:56:08 AM,Overall,4116,4284,1029,1071,10500,1860,6597,1417,2196,12070
17,CAR (UNDP),2019,CAR-19/HCF10/RA 4/WaSH/UN/14896,7/6/2020 11:29:14 AM,Internally Displaced People,6600,6800,3200,3400,20000,3300,3400,1600,1700,10000
17,CAR (UNDP),2019,CAR-19/HCF10/RA 4/WaSH/UN/14896,7/6/2020 11:29:14 AM,Overall,6600,6800,3200,3400,20000,3300,3400,1600,1700,10000
17,CAR (UNDP),2019,CAR-19/HCF10/RA1/HLT/UN/11739,10/14/2019 4:11:52 PM,Host Communities,6174,6426,4116,4284,21000,6174,6426,4116,4284,21000
17,CAR (UNDP),2019,CAR-19/HCF10/RA1/HLT/UN/11739,10/14/2019 4:11:52 PM,Overall,7326,7674,4884,5116,25000,7326,7674,4884,5116,25000
17,CAR (UNDP),2019,CAR-19/HCF10/RA1/HLT/UN/11739,10/14/2019 4:11:52 PM,Returnees,1152,1248,768,832,4000,1152,1248,768,832,4000
17,CAR (UNDP),2019,CAR-19/HCF10/RA1/LOG/UN/11738,9/12/2019 1:33:59 PM,Other,160,0,0,0,160,160,0,0,0,160
17,CAR (UNDP),2019,CAR-19/HCF10/RA1/LOG/UN/11738,9/12/2019 1:33:59 PM,Overall,160,0,0,0,160,160,0,0,0,160
17,CAR (UNDP),2019,CAR-19/HCF10/RA1/WaSH/INGO/11740,6/7/2019 11:15:30 AM,Host Communities,786,817,885,922,3410,528,610,1132,1232,3502
17,CAR (UNDP),2019,CAR-19/HCF10/RA1/WaSH/INGO/11740,6/7/2019 11:15:30 AM,Overall,1152,1198,1298,1352,5000,774,894,1660,1806,5134
17,CAR (UNDP),2019,CAR-19/HCF10/RA1/WaSH/INGO/11740,6/7/2019 11:15:30 AM,Returnees,366,381,413,430,1590,246,284,528,574,1632
17,CAR (UNDP),2019,CAR-19/HCF10/RA3/LOG/UN/14144,3/17/2020 9:50:55 AM,Other,1,0,0,0,1,1,0,0,0,1
17,CAR (UNDP),2019,CAR-19/HCF10/RA3/LOG/UN/14144,3/17/2020 9:50:55 AM,Overall,1,0,0,0,1,1,0,0,0,1
17,CAR (UNDP),2019,CAR-19/HCF10/SA1/CCCM/NGO/12756,7/24/2020 9:30:37 AM,Internally Displaced People,3652,4712,6198,6197,20759,3652,4712,6198,6197,20759
17,CAR (UNDP),2019,CAR-19/HCF10/SA1/CCCM/NGO/12756,7/24/2020 9:30:37 AM,Overall,3652,4712,6198,6197,20759,3652,4712,6198,6197,20759
17,CAR (UNDP),2019,CAR-19/HCF10/SA1/CCCM-NFI-PROT/UN/12754,7/13/2020 11:08:57 AM,Host Communities,2842,2958,2842,2952,11594,3000,3200,2800,3100,12100
17,CAR (UNDP),2019,CAR-19/HCF10/SA1/CCCM-NFI-PROT/UN/12754,7/13/2020 11:08:57 AM,Internally Displaced People,26118,27184,26118,27184,106604,29000,35000,27000,33000,124000
17,CAR (UNDP),2019,CAR-19/HCF10/SA1/CCCM-NFI-PROT/UN/12754,7/13/2020 11:08:57 AM,Overall,28960,30142,28960,30136,118198,32000,38200,29800,36100,136100
17,CAR (UNDP),2019,CAR-19/HCF10/SA1/COORD/INGO/12735,3/24/2020 4:27:27 PM,Other,70,0,0,0,70,70,0,0,0,70
17,CAR (UNDP),2019,CAR-19/HCF10/SA1/COORD/INGO/12735,3/24/2020 4:27:27 PM,Overall,70,0,0,0,70,70,0,0,0,70
17,CAR (UNDP),2019,CAR-19/HCF10/SA1/COORD/UN/12691,7/9/2020 1:59:55 PM,Other,87,0,0,0,87,50,0,0,0,50
17,CAR (UNDP),2019,CAR-19/HCF10/SA1/COORD/UN/12691,7/9/2020 1:59:55 PM,Overall,87,0,0,0,87,50,0,0,0,50
17,CAR (UNDP),2019,CAR-19/HCF10/SA1/EDU/INGO/12629,2/25/2020 12:43:10 PM,Host Communities,22,16,2457,3335,5830,36,18,2457,3335,5846
17,CAR (UNDP),2019,CAR-19/HCF10/SA1/EDU/INGO/12629,2/25/2020 12:43:10 PM,Internally Displaced People,0,0,1336,1310,2646,0,0,1336,1310,2646
17,CAR (UNDP),2019,CAR-19/HCF10/SA1/EDU/INGO/12629,2/25/2020 12:43:10 PM,Overall,22,16,4009,4753,8800,36,18,4009,4753,8816
17,CAR (UNDP),2019,CAR-19/HCF10/SA1/EDU/INGO/12629,2/25/2020 12:43:10 PM,Returnees,0,0,216,108,324,0,0,216,108,324
17,CAR (UNDP),2019,CAR-19/HCF10/SA1/EDU/INGO/12666,6/24/2020 11:48:54 AM,Host Communities,1600,1067,1010,724,4401,2500,1000,2111,1150,6761
17,CAR (UNDP),2019,CAR-19/HCF10/SA1/EDU/INGO/12666,6/24/2020 11:48:54 AM,Internally Displaced People,1600,1067,1010,723,4400,0,0,0,0,0
17,CAR (UNDP),2019,CAR-19/HCF10/SA1/EDU/INGO/12666,6/24/2020 11:48:54 AM,Overall,4800,3200,3030,2170,13200,5000,2000,4223,2300,13523
17,CAR (UNDP),2019,CAR-19/HCF10/SA1/EDU/INGO/12666,6/24/2020 11:48:54 AM,Returnees,1600,1066,1010,723,4399,2500,1000,2112,1150,6762
17,CAR (UNDP),2019,CAR-19/HCF10/SA1/EDU/INGO/12693,4/6/2020 5:07:33 AM,Host Communities,4214,4385,882,917,10398,4174,4355,872,997,10398
17,CAR (UNDP),2019,CAR-19/HCF10/SA1/EDU/INGO/12693,4/6/2020 5:07:33 AM,Internally Displaced People,464,482,97,101,1144,464,482,97,101,1144
17,CAR (UNDP),2019,CAR-19/HCF10/SA1/EDU/INGO/12693,4/6/2020 5:07:33 AM,Overall,4678,4867,979,1018,11542,4638,4837,969,1098,11542
17,CAR (UNDP),2019,CAR-19/HCF10/SA1/EDU/NGO/12676,7/13/2020 7:55:09 AM,Host Communities,10,15,215,180,420,360,515,520,400,1795
17,CAR (UNDP),2019,CAR-19/HCF10/SA1/EDU/NGO/12676,7/13/2020 7:55:09 AM,Internally Displaced People,350,500,305,220,1375,350,500,305,220,1375
17,CAR (UNDP),2019,CAR-19/HCF10/SA1/EDU/NGO/12676,7/13/2020 7:55:09 AM,Overall,610,840,670,580,2700,960,1340,1159,800,4259
17,CAR (UNDP),2019,CAR-19/HCF10/SA1/EDU/NGO/12676,7/13/2020 7:55:09 AM,Returnees,250,325,150,180,905,250,325,334,180,1089
17,CAR (UNDP),2019,CAR-19/HCF10/SA1/EDU/NGO/12712,2/25/2020 1:00:38 PM,Host Communities,880,140,4535,2925,8480,2550,1984,2720,1385,8639
17,CAR (UNDP),2019,CAR-19/HCF10/SA1/EDU/NGO/12712,2/25/2020 1:00:38 PM,Internally Displaced People,222,178,975,525,1900,222,178,1455,835,2690
17,CAR (UNDP),2019,CAR-19/HCF10/SA1/EDU/NGO/12712,2/25/2020 1:00:38 PM,Overall,1102,318,5510,3450,10380,2772,2162,4175,2220,11329
17,CAR (UNDP),2019,CAR-19/HCF10/SA1/ER/NGO/12644,5/4/2020 11:46:45 AM,Host Communities,650,676,620,656,2602,425,450,370,270,1515
17,CAR (UNDP),2019,CAR-19/HCF10/SA1/ER/NGO/12644,5/4/2020 11:46:45 AM,Internally Displaced People,198,192,202,204,796,855,760,1155,660,3430
17,CAR (UNDP),2019,CAR-19/HCF10/SA1/ER/NGO/12644,5/4/2020 11:46:45 AM,Other,400,398,370,354,1522,400,420,370,800,1990
17,CAR (UNDP),2019,CAR-19/HCF10/SA1/ER/NGO/12644,5/4/2020 11:46:45 AM,Overall,1598,1676,1600,1626,6500,2360,2400,3020,2970,10750
17,CAR (UNDP),2019,CAR-19/HCF10/SA1/ER/NGO/12644,5/4/2020 11:46:45 AM,Returnees,350,410,408,412,1580,680,770,1125,1240,3815
17,CAR (UNDP),2019,CAR-19/HCF10/SA1/ER/NGO/12679,1/4/2021 11:37:03 AM,Host Communities,400,400,0,0,800,400,400,0,0,800
17,CAR (UNDP),2019,CAR-19/HCF10/SA1/ER/NGO/12679,1/4/2021 11:37:03 AM,Internally Displaced People,1000,1000,0,0,2000,1000,1000,0,0,2000
17,CAR (UNDP),2019,CAR-19/HCF10/SA1/ER/NGO/12679,1/4/2021 11:37:03 AM,Overall,1400,1400,0,0,2800,1400,1400,0,0,2800
17,CAR (UNDP),2019,CAR-19/HCF10/SA1/ER/NGO/12706,2/11/2020 1:41:25 PM,Host Communities,334,388,718,784,2224,0,0,832,1399,2231
17,CAR (UNDP),2019,CAR-19/HCF10/SA1/ER/NGO/12706,2/11/2020 1:41:25 PM,Overall,334,388,718,784,2224,0,0,832,1399,2231
17,CAR (UNDP),2019,CAR-19/HCF10/SA1/ER/NGO/12734,2/27/2020 2:41:42 PM,Host Communities,25,25,100,100,250,65,85,106,138,394
17,CAR (UNDP),2019,CAR-19/HCF10/SA1/ER/NGO/12734,2/27/2020 2:41:42 PM,Internally Displaced People,5,5,5,5,20,10,0,0,0,10
17,CAR (UNDP),2019,CAR-19/HCF10/SA1/ER/NGO/12734,2/27/2020 2:41:42 PM,Overall,40,40,110,110,300,77,89,106,140,412
17,CAR (UNDP),2019,CAR-19/HCF10/SA1/ER/NGO/12734,2/27/2020 2:41:42 PM,Returnees,10,10,5,5,30,2,4,0,2,8
17,CAR (UNDP),2019,CAR-19/HCF10/SA1/ER/NGO/12743,5/18/2020 2:59:36 PM,Host Communities,1000,1000,0,0,2000,900,1030,0,0,1930
17,CAR (UNDP),2019,CAR-19/HCF10/SA1/ER/NGO/12743,5/18/2020 2:59:36 PM,Other,20,180,0,0,200,0,100,0,0,100
17,CAR (UNDP),2019,CAR-19/HCF10/SA1/ER/NGO/12743,5/18/2020 2:59:36 PM,Overall,1820,2180,0,0,4000,1900,2135,0,0,4035
17,CAR (UNDP),2019,CAR-19/HCF10/SA1/ER/NGO/12743,5/18/2020 2:59:36 PM,Returnees,800,1000,0,0,1800,1000,1005,0,0,2005
17,CAR (UNDP),2019,CAR-19/HCF10/SA1/ETC/UN/12741,3/17/2020 8:48:10 AM,Host Communities,300,400,0,0,700,300,400,0,0,700
17,CAR (UNDP),2019,CAR-19/HCF10/SA1/ETC/UN/12741,3/17/2020 8:48:10 AM,Internally Displaced People,500,600,0,0,1100,500,600,0,0,1100
17,CAR (UNDP),2019,CAR-19/HCF10/SA1/ETC/UN/12741,3/17/2020 8:48:10 AM,Overall,800,1000,0,0,1800,800,1000,0,0,1800
17,CAR (UNDP),2019,CAR-19/HCF10/SA1/ETC/UN/12770,3/17/2020 8:51:15 AM,Other,40,15,0,0,55,40,15,0,0,55
17,CAR (UNDP),2019,CAR-19/HCF10/SA1/ETC/UN/12770,3/17/2020 8:51:15 AM,Overall,40,15,0,0,55,40,15,0,0,55
17,CAR (UNDP),2019,CAR-19/HCF10/SA1/FSEC/INGO/12617,5/29/2020 12:55:36 PM,Host Communities,139,155,151,139,584,250,250,250,250,1000
17,CAR (UNDP),2019,CAR-19/HCF10/SA1/FSEC/INGO/12617,5/29/2020 12:55:36 PM,Internally Displaced People,139,155,151,139,584,250,250,250,250,1000
17,CAR (UNDP),2019,CAR-19/HCF10/SA1/FSEC/INGO/12617,5/29/2020 12:55:36 PM,Overall,417,463,453,417,1750,750,750,750,750,3000
17,CAR (UNDP),2019,CAR-19/HCF10/SA1/FSEC/INGO/12617,5/29/2020 12:55:36 PM,Returnees,139,153,151,139,582,250,250,250,250,1000
17,CAR (UNDP),2019,CAR-19/HCF10/SA1/FSEC/INGO/12643,4/6/2020 10:39:06 AM,Host Communities,349,372,814,790,2325,412,575,911,981,2879
17,CAR (UNDP),2019,CAR-19/HCF10/SA1/FSEC/INGO/12643,4/6/2020 10:39:06 AM,Internally Displaced People,465,496,1085,1054,3100,117,145,206,220,688
17,CAR (UNDP),2019,CAR-19/HCF10/SA1/FSEC/INGO/12643,4/6/2020 10:39:06 AM,Overall,1163,1240,2713,2634,7750,1619,2173,3233,3414,10439
17,CAR (UNDP),2019,CAR-19/HCF10/SA1/FSEC/INGO/12643,4/6/2020 10:39:06 AM,Returnees,349,372,814,790,2325,1090,1453,2116,2213,6872
17,CAR (UNDP),2019,CAR-19/HCF10/SA1/FSEC/INGO/12645,1/20/2020 8:45:25 AM,Internally Displaced People,3656,4074,2574,2796,13100,779,2137,1493,1341,5750
17,CAR (UNDP),2019,CAR-19/HCF10/SA1/FSEC/INGO/12645,1/20/2020 8:45:25 AM,Overall,4420,5060,3150,3720,16350,2172,6095,3978,4105,16350
17,CAR (UNDP),2019,CAR-19/HCF10/SA1/FSEC/INGO/12645,1/20/2020 8:45:25 AM,Returnees,764,986,576,924,3250,1393,3958,2485,2764,10600
17,CAR (UNDP),2019,CAR-19/HCF10/SA1/FSEC/INGO/12657,7/16/2020 3:01:38 PM,Host Communities,2000,2000,1000,1000,6000,411,532,1706,1543,4192
17,CAR (UNDP),2019,CAR-19/HCF10/SA1/FSEC/INGO/12657,7/16/2020 3:01:38 PM,Internally Displaced People,2000,2000,1000,1000,6000,2811,3361,4313,4692,15177
17,CAR (UNDP),2019,CAR-19/HCF10/SA1/FSEC/INGO/12657,7/16/2020 3:01:38 PM,Overall,6000,6000,3000,3000,18000,3231,3906,6080,6317,19534
17,CAR (UNDP),2019,CAR-19/HCF10/SA1/FSEC/INGO/12657,7/16/2020 3:01:38 PM,Returnees,2000,2000,1000,1000,6000,9,13,61,82,165
17,CAR (UNDP),2019,CAR-19/HCF10/SA1/FSEC/INGO/12935,8/21/2020 10:05:33 AM,Host Communities,40,0,0,0,40,40,0,0,0,40
17,CAR (UNDP),2019,CAR-19/HCF10/SA1/FSEC/INGO/12935,8/21/2020 10:05:33 AM,Overall,40,0,0,0,40,40,0,0,0,40
17,CAR (UNDP),2019,CAR-19/HCF10/SA1/FSEC/UN/12728,8/9/2020 11:20:30 AM,Host Communities,5488,5712,8232,8568,28000,3842,3998,5762,5998,19600
17,CAR (UNDP),2019,CAR-19/HCF10/SA1/FSEC/UN/12728,8/9/2020 11:20:30 AM,Internally Displaced People,1568,1632,2352,2448,8000,1294,1346,1940,2020,6600
17,CAR (UNDP),2019,CAR-19/HCF10/SA1/FSEC/UN/12728,8/9/2020 11:20:30 AM,Overall,7840,8160,11760,12240,40000,5684,5915,8525,8875,28999
17,CAR (UNDP),2019,CAR-19/HCF10/SA1/FSEC/UN/12728,8/9/2020 11:20:30 AM,Returnees,784,816,1176,1224,4000,548,571,823,857,2799
17,CAR (UNDP),2019,CAR-19/HCF10/SA1/FSEC/UN/12758,3/27/2020 1:30:17 PM,Other,100,75,0,0,175,100,75,0,0,175
17,CAR (UNDP),2019,CAR-19/HCF10/SA1/FSEC/UN/12758,3/27/2020 1:30:17 PM,Overall,100,75,0,0,175,100,75,0,0,175
17,CAR (UNDP),2019,CAR-19/HCF10/SA1/HLT/INGO/12623,2/18/2020 3:04:48 PM,Host Communities,0,600,1247,1352,3199,2476,618,2216,3214,8524
17,CAR (UNDP),2019,CAR-19/HCF10/SA1/HLT/INGO/12623,2/18/2020 3:04:48 PM,Internally Displaced People,1942,2105,406,440,4893,2752,2134,1028,962,6876
17,CAR (UNDP),2019,CAR-19/HCF10/SA1/HLT/INGO/12623,2/18/2020 3:04:48 PM,Overall,1942,2705,1653,1792,8092,5228,2752,3244,4176,15400
17,CAR (UNDP),2019,CAR-19/HCF10/SA1/HLT/INGO/12685,4/10/2020 11:46:06 AM,Host Communities,2356,6976,4268,4427,18027,1885,5581,3414,3542,14422
17,CAR (UNDP),2019,CAR-19/HCF10/SA1/HLT/INGO/12685,4/10/2020 11:46:06 AM,Internally Displaced People,4567,4123,444,677,9811,3654,3298,1012,913,8877
17,CAR (UNDP),2019,CAR-19/HCF10/SA1/HLT/INGO/12685,4/10/2020 11:46:06 AM,Overall,6923,11099,4712,5104,27838,5539,8879,4426,4455,23299
17,CAR (UNDP),2019,CAR-19/HCF10/SA1/HLT/NGO/12737,6/11/2020 8:17:00 AM,Host Communities,1480,1850,1850,2220,7400,1480,1850,1850,2220,7400
17,CAR (UNDP),2019,CAR-19/HCF10/SA1/HLT/NGO/12737,6/11/2020 8:17:00 AM,Internally Displaced People,2200,2800,2800,3400,11200,2200,2800,2800,3400,11200
17,CAR (UNDP),2019,CAR-19/HCF10/SA1/HLT/NGO/12737,6/11/2020 8:17:00 AM,Overall,3960,5000,5000,6040,20000,3960,5000,5000,6040,20000
17,CAR (UNDP),2019,CAR-19/HCF10/SA1/HLT/NGO/12737,6/11/2020 8:17:00 AM,Returnees,280,350,350,420,1400,280,350,350,420,1400
17,CAR (UNDP),2019,CAR-19/HCF10/SA1/HLT/UN/12674,5/11/2020 10:53:48 AM,Host Communities,62842,65408,41895,43605,213750,62842,65408,41895,43605,213750
17,CAR (UNDP),2019,CAR-19/HCF10/SA1/HLT/UN/12674,5/11/2020 10:53:48 AM,Overall,83789,87211,55860,58140,285000,83789,87211,55860,58140,285000
17,CAR (UNDP),2019,CAR-19/HCF10/SA1/HLT/UN/12674,5/11/2020 10:53:48 AM,Returnees,20947,21803,13965,14535,71250,20947,21803,13965,14535,71250
17,CAR (UNDP),2019,CAR-19/HCF10/SA1/HLT/UN/12768,5/21/2020 1:46:41 PM,Host Communities,18500,24700,16600,18250,78050,18500,24700,16600,18250,78050
17,CAR (UNDP),2019,CAR-19/HCF10/SA1/HLT/UN/12768,5/21/2020 1:46:41 PM,Internally Displaced People,27500,35600,20300,25650,109050,27500,35600,20300,25650,109050
17,CAR (UNDP),2019,CAR-19/HCF10/SA1/HLT/UN/12768,5/21/2020 1:46:41 PM,Overall,46000,60300,36900,43900,187100,46000,60300,36900,43900,187100
17,CAR (UNDP),2019,CAR-19/HCF10/SA1/HLT-NUT/INGO/12672,2/27/2020 1:46:30 PM,Host Communities,5463,6057,851,1019,13390,5463,6057,851,1019,13390
17,CAR (UNDP),2019,CAR-19/HCF10/SA1/HLT-NUT/INGO/12672,2/27/2020 1:46:30 PM,Internally Displaced People,1205,1348,567,614,3734,1205,1348,567,614,3734
17,CAR (UNDP),2019,CAR-19/HCF10/SA1/HLT-NUT/INGO/12672,2/27/2020 1:46:30 PM,Overall,6668,7405,1418,1633,17124,6668,7405,1418,1633,17124
17,CAR (UNDP),2019,CAR-19/HCF10/SA1/HLT-NUT/INGO/12710,4/3/2020 11:05:13 AM,Host Communities,1896,1974,397,413,4680,1896,1974,397,413,4680
17,CAR (UNDP),2019,CAR-19/HCF10/SA1/HLT-NUT/INGO/12710,4/3/2020 11:05:13 AM,Internally Displaced People,6464,6727,1352,1407,15950,6464,6727,1352,1407,15950
17,CAR (UNDP),2019,CAR-19/HCF10/SA1/HLT-NUT/INGO/12710,4/3/2020 11:05:13 AM,Overall,8360,8701,1749,1820,20630,8360,8701,1749,1820,20630
17,CAR (UNDP),2019,CAR-19/HCF10/SA1/HLT-NUT/INGO/12930,9/29/2020 1:51:16 PM,Host Communities,47,53,0,0,100,47,53,0,0,100
17,CAR (UNDP),2019,CAR-19/HCF10/SA1/HLT-NUT/INGO/12930,9/29/2020 1:51:16 PM,Overall,47,53,0,0,100,47,53,0,0,100
17,CAR (UNDP),2019,CAR-19/HCF10/SA1/HLT-NUT/NGO/12684,12/23/2019 3:43:47 PM,Host Communities,1992,3236,6244,6247,17719,2011,3246,6254,6276,17787
17,CAR (UNDP),2019,CAR-19/HCF10/SA1/HLT-NUT/NGO/12684,12/23/2019 3:43:47 PM,Internally Displaced People,132,158,595,601,1486,172,192,612,621,1597
17,CAR (UNDP),2019,CAR-19/HCF10/SA1/HLT-NUT/NGO/12684,12/23/2019 3:43:47 PM,Overall,2413,4022,8621,8649,23705,2499,4082,8662,8749,23992
17,CAR (UNDP),2019,CAR-19/HCF10/SA1/HLT-NUT/NGO/12684,12/23/2019 3:43:47 PM,Returnees,289,628,1782,1801,4500,316,644,1796,1852,4608
17,CAR (UNDP),2019,CAR-19/HCF10/SA1/LOG/INGO/12620,5/8/2020 3:56:02 PM,Other,19,0,0,0,19,19,0,0,0,19
17,CAR (UNDP),2019,CAR-19/HCF10/SA1/LOG/INGO/12620,5/8/2020 3:56:02 PM,Overall,19,0,0,0,19,19,0,0,0,19
17,CAR (UNDP),2019,CAR-19/HCF10/SA1/LOG/INGO/12642,11/19/2019 9:34:30 AM,Other,24,0,0,0,24,14,0,0,0,14
17,CAR (UNDP),2019,CAR-19/HCF10/SA1/LOG/INGO/12642,11/19/2019 9:34:30 AM,Overall,24,0,0,0,24,14,0,0,0,14
17,CAR (UNDP),2019,CAR-19/HCF10/SA1/LOG/UN/12652,11/18/2019 3:39:21 PM,Other,0,0,0,20,20,0,0,0,19,19
17,CAR (UNDP),2019,CAR-19/HCF10/SA1/LOG/UN/12652,11/18/2019 3:39:21 PM,Overall,0,0,0,20,20,0,0,0,19,19
17,CAR (UNDP),2019,CAR-19/HCF10/SA1/NFI-CCCM/UN/12765,6/20/2020 10:07:35 AM,Host Communities,270,270,270,270,1080,350,350,350,350,1400
17,CAR (UNDP),2019,CAR-19/HCF10/SA1/NFI-CCCM/UN/12765,6/20/2020 10:07:35 AM,Internally Displaced People,1980,1980,1980,1980,7920,2500,2500,2500,2500,10000
17,CAR (UNDP),2019,CAR-19/HCF10/SA1/NFI-CCCM/UN/12765,6/20/2020 10:07:35 AM,Overall,2250,2250,2250,2250,9000,2850,2850,2850,2850,11400
17,CAR (UNDP),2019,CAR-19/HCF10/SA1/NFI-PROT-CCCM/UN/12733,5/8/2020 1:43:57 PM,Internally Displaced People,19509,22310,33607,32430,107856,24763,32864,53501,53837,164965
17,CAR (UNDP),2019,CAR-19/HCF10/SA1/NFI-PROT-CCCM/UN/12733,5/8/2020 1:43:57 PM,Overall,19509,22310,33607,32430,107856,24763,32864,53501,53837,164965
17,CAR (UNDP),2019,CAR-19/HCF10/SA1/NFI-WaSH/INGO/12625,5/19/2020 10:26:00 AM,Overall,4098,4150,4189,4198,16635,2456,2844,2138,2410,9848
17,CAR (UNDP),2019,CAR-19/HCF10/SA1/NFI-WaSH/INGO/12625,5/19/2020 10:26:00 AM,Returnees,4098,4150,4189,4198,16635,2456,2844,2138,2410,9848
17,CAR (UNDP),2019,CAR-19/HCF10/SA1/NUT/INGO/12624,2/11/2020 2:00:44 PM,Host Communities,0,0,182,196,378,0,0,202,206,408
17,CAR (UNDP),2019,CAR-19/HCF10/SA1/NUT/INGO/12624,2/11/2020 2:00:44 PM,Internally Displaced People,0,0,2290,2480,4770,0,0,2084,2271,4355
17,CAR (UNDP),2019,CAR-19/HCF10/SA1/NUT/INGO/12624,2/11/2020 2:00:44 PM,Overall,0,0,2472,2676,5148,0,0,2286,2477,4763
17,CAR (UNDP),2019,CAR-19/HCF10/SA1/NUT/INGO/12718,1/7/2020 1:48:56 PM,Host Communities,22521,24397,4712,5104,56734,22498,24470,5186,4780,56934
17,CAR (UNDP),2019,CAR-19/HCF10/SA1/NUT/INGO/12718,1/7/2020 1:48:56 PM,Internally Displaced People,5630,6100,1178,1276,14184,5580,6046,1330,1228,14184
17,CAR (UNDP),2019,CAR-19/HCF10/SA1/NUT/INGO/12718,1/7/2020 1:48:56 PM,Overall,28151,30497,5890,6380,70918,28078,30516,6516,6008,71118
17,CAR (UNDP),2019,CAR-19/HCF10/SA1/NUT/NGO/12669,12/16/2019 9:01:21 AM,Host Communities,33,33,2450,2350,4866,41,49,2459,2421,4970
17,CAR (UNDP),2019,CAR-19/HCF10/SA1/NUT/NGO/12669,12/16/2019 9:01:21 AM,Overall,33,33,2450,2350,4866,41,49,2459,2421,4970
17,CAR (UNDP),2019,CAR-19/HCF10/SA1/NUT/UN/12729,3/31/2020 7:47:15 AM,Host Communities,0,0,2194,2377,4571,0,0,2345,2540,4885
17,CAR (UNDP),2019,CAR-19/HCF10/SA1/NUT/UN/12729,3/31/2020 7:47:15 AM,Internally Displaced People,0,0,731,794,1525,0,0,782,847,1629
17,CAR (UNDP),2019,CAR-19/HCF10/SA1/NUT/UN/12729,3/31/2020 7:47:15 AM,Overall,0,0,2925,3171,6096,0,0,3127,3387,6514
17,CAR (UNDP),2019,CAR-19/HCF10/SA1/NUT/UN/12750,6/16/2020 11:06:33 PM,Host Communities,0,0,3485,3778,7263,0,0,5270,5878,11148
17,CAR (UNDP),2019,CAR-19/HCF10/SA1/NUT/UN/12750,6/16/2020 11:06:33 PM,Internally Displaced People,0,0,872,946,1818,0,0,1339,1476,2815
17,CAR (UNDP),2019,CAR-19/HCF10/SA1/NUT/UN/12750,6/16/2020 11:06:33 PM,Overall,0,0,4357,4724,9081,0,0,6609,7354,13963
17,CAR (UNDP),2019,CAR-19/HCF10/SA1/NUT-HLT/INGO/12671,5/21/2020 1:39:46 PM,Host Communities,3780,7530,5093,6349,22752,3374,6401,4621,5683,20079
17,CAR (UNDP),2019,CAR-19/HCF10/SA1/NUT-HLT/INGO/12671,5/21/2020 1:39:46 PM,Internally Displaced People,1063,1604,732,871,4270,964,1274,637,734,3609
17,CAR (UNDP),2019,CAR-19/HCF10/SA1/NUT-HLT/INGO/12671,5/21/2020 1:39:46 PM,Other,91,123,74,92,380,77,105,63,78,323
17,CAR (UNDP),2019,CAR-19/HCF10/SA1/NUT-HLT/INGO/12671,5/21/2020 1:39:46 PM,Overall,4934,9257,5899,7312,27402,4415,7780,5321,6495,24011
17,CAR (UNDP),2019,CAR-19/HCF10/SA1/NUT-HLT/INGO/12738,11/6/2019 3:55:48 PM,Host Communities,200,788,745,775,2508,487,2033,1676,1720,5916
17,CAR (UNDP),2019,CAR-19/HCF10/SA1/NUT-HLT/INGO/12738,11/6/2019 3:55:48 PM,Internally Displaced People,163,645,609,634,2051,398,1664,1371,1407,4840
17,CAR (UNDP),2019,CAR-19/HCF10/SA1/NUT-HLT/INGO/12738,11/6/2019 3:55:48 PM,Overall,363,1433,1354,1409,4559,885,3697,3047,3127,10756
17,CAR (UNDP),2019,CAR-19/HCF10/SA1/NUT-HLT-WaSH/INGO/12658,6/28/2020 6:26:43 AM,Host Communities,11904,12895,4241,4596,33636,4253,4712,1571,1989,12525
17,CAR (UNDP),2019,CAR-19/HCF10/SA1/NUT-HLT-WaSH/INGO/12658,6/28/2020 6:26:43 AM,Internally Displaced People,4590,4973,1327,1437,12327,2054,2137,354,398,4943
17,CAR (UNDP),2019,CAR-19/HCF10/SA1/NUT-HLT-WaSH/INGO/12658,6/28/2020 6:26:43 AM,Overall,16494,17868,5568,6033,45963,6307,6849,1925,2387,17468
17,CAR (UNDP),2019,CAR-19/HCF10/SA1/PROT/INGO/12622,5/11/2020 9:25:32 AM,Host Communities,1781,1899,837,942,5459,1977,3235,1292,1513,8017
17,CAR (UNDP),2019,CAR-19/HCF10/SA1/PROT/INGO/12622,5/11/2020 9:25:32 AM,Internally Displaced People,782,854,372,400,2408,0,0,2,1,3
17,CAR (UNDP),2019,CAR-19/HCF10/SA1/PROT/INGO/12622,5/11/2020 9:25:32 AM,Overall,2699,2913,1340,1507,8459,1982,3243,1332,1548,8105
17,CAR (UNDP),2019,CAR-19/HCF10/SA1/PROT/INGO/12622,5/11/2020 9:25:32 AM,Returnees,136,160,131,165,592,5,8,38,34,85
17,CAR (UNDP),2019,CAR-19/HCF10/SA1/PROT/INGO/12649,4/21/2020 8:53:15 AM,Host Communities,6773,3103,1115,1058,12049,11717,3184,1673,1154,17728
17,CAR (UNDP),2019,CAR-19/HCF10/SA1/PROT/INGO/12649,4/21/2020 8:53:15 AM,Internally Displaced People,1103,505,182,171,1961,835,339,105,113,1392
17,CAR (UNDP),2019,CAR-19/HCF10/SA1/PROT/INGO/12649,4/21/2020 8:53:15 AM,Overall,7876,3608,1297,1229,14010,12552,3523,1778,1267,19120
17,CAR (UNDP),2019,CAR-19/HCF10/SA1/PROT/INGO/12653,10/13/2020 10:23:02 AM,Other,135,90,0,0,225,139,47,0,0,186
17,CAR (UNDP),2019,CAR-19/HCF10/SA1/PROT/INGO/12653,10/13/2020 10:23:02 AM,Overall,135,90,0,0,225,139,47,0,0,186
17,CAR (UNDP),2019,CAR-19/HCF10/SA1/PROT/NGO/12632,1/7/2021 7:45:56 AM,Host Communities,500,800,1300,1400,4000,501,811,1320,1443,4075
17,CAR (UNDP),2019,CAR-19/HCF10/SA1/PROT/NGO/12632,1/7/2021 7:45:56 AM,Internally Displaced People,1000,700,1100,1300,4100,1017,704,1211,1354,4286
17,CAR (UNDP),2019,CAR-19/HCF10/SA1/PROT/NGO/12632,1/7/2021 7:45:56 AM,Overall,1700,1850,3450,3660,10660,1731,1879,3651,3795,11056
17,CAR (UNDP),2019,CAR-19/HCF10/SA1/PROT/NGO/12632,1/7/2021 7:45:56 AM,Returnees,200,350,1050,960,2560,213,364,1120,998,2695
17,CAR (UNDP),2019,CAR-19/HCF10/SA1/PROT-CCCM/INGO/12635,4/15/2020 12:39:25 PM,Host Communities,5545,7305,8643,9361,30854,4416,7011,8379,8730,28536
17,CAR (UNDP),2019,CAR-19/HCF10/SA1/PROT-CCCM/INGO/12635,4/15/2020 12:39:25 PM,Internally Displaced People,10816,14165,16574,18030,59585,9359,12221,14468,14457,50505
17,CAR (UNDP),2019,CAR-19/HCF10/SA1/PROT-CCCM/INGO/12635,4/15/2020 12:39:25 PM,Overall,16361,21470,25217,27391,90439,13775,19232,22847,23187,79041
17,CAR (UNDP),2019,CAR-19/HCF10/SA1/PROT-EDU/UN/12647,5/7/2020 9:50:40 AM,Host Communities,2000,1500,3900,3500,10900,2824,1506,7722,5920,17972
17,CAR (UNDP),2019,CAR-19/HCF10/SA1/PROT-EDU/UN/12647,5/7/2020 9:50:40 AM,Internally Displaced People,4000,2500,7600,7000,21100,2279,1274,14960,8669,27182
17,CAR (UNDP),2019,CAR-19/HCF10/SA1/PROT-EDU/UN/12647,5/7/2020 9:50:40 AM,Overall,6000,4000,11500,10500,32000,5103,2780,22682,14589,45154
17,CAR (UNDP),2019,CAR-19/HCF10/SA1/PROT-WaSH/INGO/12627,4/27/2020 8:58:49 AM,Host Communities,14811,18651,9874,11522,54858,13579,17718,15742,16418,63457
17,CAR (UNDP),2019,CAR-19/HCF10/SA1/PROT-WaSH/INGO/12627,4/27/2020 8:58:49 AM,Internally Displaced People,4628,5828,3085,3602,17143,3773,4964,3260,3516,15513
17,CAR (UNDP),2019,CAR-19/HCF10/SA1/PROT-WaSH/INGO/12627,4/27/2020 8:58:49 AM,Overall,23141,29143,15428,18003,85715,25438,31396,21924,23246,102004
17,CAR (UNDP),2019,CAR-19/HCF10/SA1/PROT-WaSH/INGO/12627,4/27/2020 8:58:49 AM,Returnees,3702,4664,2469,2879,13714,8086,8714,2922,3312,23034
17,CAR (UNDP),2019,CAR-19/HCF10/SA1/WaSH/INGO/12626,4/8/2020 8:06:26 AM,Overall,2260,2615,4848,5277,15000,2166,2599,4620,5054,14439
17,CAR (UNDP),2019,CAR-19/HCF10/SA1/WaSH/INGO/12626,4/8/2020 8:06:26 AM,Returnees,2260,2615,4848,5277,15000,2166,2599,4620,5054,14439
17,CAR (UNDP),2019,CAR-19/HCF10/SA1/WaSH/INGO/12631,7/22/2020 3:50:03 PM,Other,1443,1732,3079,3368,9622,1353,1624,2886,3157,9020
17,CAR (UNDP),2019,CAR-19/HCF10/SA1/WaSH/INGO/12631,7/22/2020 3:50:03 PM,Overall,1804,2164,3849,4210,12027,1804,2166,3848,4209,12027
17,CAR (UNDP),2019,CAR-19/HCF10/SA1/WaSH/INGO/12631,7/22/2020 3:50:03 PM,Returnees,361,432,770,842,2405,451,542,962,1052,3007
17,CAR (UNDP),2019,CAR-19/HCF10/SA1/WaSH/INGO/12638,3/31/2020 8:09:48 AM,Host Communities,4960,6062,7438,9093,27553,8398,8409,6713,5590,29110
17,CAR (UNDP),2019,CAR-19/HCF10/SA1/WaSH/INGO/12638,3/31/2020 8:09:48 AM,Internally Displaced People,4288,5241,6432,7861,23822,4181,5110,6271,7664,23226
17,CAR (UNDP),2019,CAR-19/HCF10/SA1/WaSH/INGO/12638,3/31/2020 8:09:48 AM,Overall,9248,11303,13870,16954,51375,12579,13519,12984,13254,52336
17,CAR (UNDP),2019,CAR-19/HCF10/SA1/WaSH/INGO/12708,4/10/2020 7:08:39 AM,Host Communities,898,859,1015,1132,3904,898,859,1015,1132,3904
17,CAR (UNDP),2019,CAR-19/HCF10/SA1/WaSH/INGO/12708,4/10/2020 7:08:39 AM,Internally Displaced People,5610,5366,6341,7073,24390,7505,7178,9462,8483,32628
17,CAR (UNDP),2019,CAR-19/HCF10/SA1/WaSH/INGO/12708,4/10/2020 7:08:39 AM,Overall,7442,6966,8064,9042,31514,9337,8778,11185,10452,39752
17,CAR (UNDP),2019,CAR-19/HCF10/SA1/WaSH/INGO/12708,4/10/2020 7:08:39 AM,Returnees,934,741,708,837,3220,934,741,708,837,3220
17,CAR (UNDP),2019,CAR-19/HCF10/SA1/WaSH/INGO/12739,12/24/2019 9:22:29 AM,Host Communities,1891,1970,401,418,4680,1891,1970,401,418,4680
17,CAR (UNDP),2019,CAR-19/HCF10/SA1/WaSH/INGO/12739,12/24/2019 9:22:29 AM,Internally Displaced People,6448,6711,1367,1424,15950,4453,4635,912,950,10950
17,CAR (UNDP),2019,CAR-19/HCF10/SA1/WaSH/INGO/12739,12/24/2019 9:22:29 AM,Overall,8339,8681,1768,1842,20630,6344,6605,1313,1368,15630
17,CAR (UNDP),2019,CAR-19/HCF10/SA1/WaSH/NGO/12678,5/28/2020 11:09:40 AM,Host Communities,200,2000,1000,1800,5000,305,1900,1200,1600,5005
17,CAR (UNDP),2019,CAR-19/HCF10/SA1/WaSH/NGO/12678,5/28/2020 11:09:40 AM,Overall,2100,7700,2300,4900,17000,2305,7590,2400,4608,16903
17,CAR (UNDP),2019,CAR-19/HCF10/SA1/WaSH/NGO/12678,5/28/2020 11:09:40 AM,Returnees,1900,5700,1300,3100,12000,2000,5690,1200,3008,11898
17,CAR (UNDP),2019,CAR-19/HCF10/SA1/WaSH-NFI/INGO/12668,5/19/2020 10:19:51 AM,Host Communities,2847,2847,3559,4532,13785,5184,7497,4270,6997,23948
17,CAR (UNDP),2019,CAR-19/HCF10/SA1/WaSH-NFI/INGO/12668,5/19/2020 10:19:51 AM,Internally Displaced People,1212,1212,1483,1985,5892,1171,1991,1338,2214,6714
17,CAR (UNDP),2019,CAR-19/HCF10/SA1/WaSH-NFI/INGO/12668,5/19/2020 10:19:51 AM,Overall,4771,4771,5932,7762,23236,8125,12588,7537,12517,40767
17,CAR (UNDP),2019,CAR-19/HCF10/SA1/WaSH-NFI/INGO/12668,5/19/2020 10:19:51 AM,Returnees,712,712,890,1245,3559,1770,3100,1929,3306,10105
17,CAR (UNDP),2019,CAR-19/HCF10/SA1/WaSH-PROT/INGO/12637,7/13/2020 7:46:07 AM,Host Communities,2368,2832,3422,3847,12469,2525,2911,3652,5102,14190
17,CAR (UNDP),2019,CAR-19/HCF10/SA1/WaSH-PROT/INGO/12637,7/13/2020 7:46:07 AM,Internally Displaced People,12885,14446,24696,25164,77191,15552,16440,25416,24693,82101
17,CAR (UNDP),2019,CAR-19/HCF10/SA1/WaSH-PROT/INGO/12637,7/13/2020 7:46:07 AM,Overall,15972,18013,29659,30516,94160,19311,21103,30962,32746,104122
17,CAR (UNDP),2019,CAR-19/HCF10/SA1/WaSH-PROT/INGO/12637,7/13/2020 7:46:07 AM,Returnees,719,735,1541,1505,4500,1234,1752,1894,2951,7831
17,CAR (UNDP),2019,CAR-19/HCF10/SA2/COORD/INGO/14186,11/12/2020 8:00:47 AM,Other,270,180,0,0,450,579,437,0,0,1016
17,CAR (UNDP),2019,CAR-19/HCF10/SA2/COORD/INGO/14186,11/12/2020 8:00:47 AM,Overall,270,180,0,0,450,579,437,0,0,1016
17,CAR (UNDP),2019,CAR-19/HCF10/SA2/COORD/INGO/14349,8/7/2020 12:30:32 PM,Other,70,0,0,0,70,70,0,0,0,70
17,CAR (UNDP),2019,CAR-19/HCF10/SA2/COORD/INGO/14349,8/7/2020 12:30:32 PM,Overall,70,0,0,0,70,70,0,0,0,70
17,CAR (UNDP),2019,CAR-19/HCF10/SA2/EDU/INGO/14199,11/13/2020 9:19:38 AM,Host Communities,110,25,1168,888,2191,24,10,89,67,190
17,CAR (UNDP),2019,CAR-19/HCF10/SA2/EDU/INGO/14199,11/13/2020 9:19:38 AM,Overall,215,50,2336,1776,4377,203,62,2158,1190,3613
17,CAR (UNDP),2019,CAR-19/HCF10/SA2/EDU/INGO/14199,11/13/2020 9:19:38 AM,Returnees,105,25,1168,888,2186,179,52,2069,1123,3423
17,CAR (UNDP),2019,CAR-19/HCF10/SA2/EDU/INGO/14205,10/12/2020 11:15:40 AM,Host Communities,10524,11401,2201,2385,26511,11008,11786,3248,3783,29825
17,CAR (UNDP),2019,CAR-19/HCF10/SA2/EDU/INGO/14205,10/12/2020 11:15:40 AM,Internally Displaced People,1301,1409,272,295,3277,1409,2098,379,396,4282
17,CAR (UNDP),2019,CAR-19/HCF10/SA2/EDU/INGO/14205,10/12/2020 11:15:40 AM,Overall,11825,12810,2473,2680,29788,12417,13884,3627,4179,34107
17,CAR (UNDP),2019,CAR-19/HCF10/SA2/EDU/INGO/14327,1/22/2021 11:40:25 AM,Internally Displaced People,4416,4784,0,0,9200,2027,2602,0,0,4629
17,CAR (UNDP),2019,CAR-19/HCF10/SA2/EDU/INGO/14327,1/22/2021 11:40:25 AM,Overall,4416,4784,0,0,9200,2027,2602,0,0,4629
17,CAR (UNDP),2019,CAR-19/HCF10/SA2/EDU/NGO/14249,1/12/2021 8:42:15 AM,Host Communities,12,6,500,300,818,27,10,574,376,987
17,CAR (UNDP),2019,CAR-19/HCF10/SA2/EDU/NGO/14249,1/12/2021 8:42:15 AM,Internally Displaced People,8,4,700,500,1212,10,4,1533,829,2376
17,CAR (UNDP),2019,CAR-19/HCF10/SA2/EDU/NGO/14249,1/12/2021 8:42:15 AM,Overall,20,10,1200,800,2030,37,14,2107,1205,3363
17,CAR (UNDP),2019,CAR-19/HCF10/SA2/FSEC/INGO/14230,9/17/2020 12:37:57 PM,Host Communities,1740,1860,1140,1260,6000,1813,1938,1187,1312,6250
17,CAR (UNDP),2019,CAR-19/HCF10/SA2/FSEC/INGO/14230,9/17/2020 12:37:57 PM,Internally Displaced People,560,620,380,440,2000,442,490,300,348,1580
17,CAR (UNDP),2019,CAR-19/HCF10/SA2/FSEC/INGO/14230,9/17/2020 12:37:57 PM,Overall,3605,3875,2375,2645,12500,3609,3876,2374,2641,12500
17,CAR (UNDP),2019,CAR-19/HCF10/SA2/FSEC/INGO/14230,9/17/2020 12:37:57 PM,Returnees,1305,1395,855,945,4500,1354,1448,887,981,4670
17,CAR (UNDP),2019,CAR-19/HCF10/SA2/FSEC/INGO/14256,8/12/2020 8:24:51 AM,Host Communities,1291,1291,1291,1291,5164,1291,1291,1291,1291,5164
17,CAR (UNDP),2019,CAR-19/HCF10/SA2/FSEC/INGO/14256,8/12/2020 8:24:51 AM,Internally Displaced People,1292,1292,1292,1292,5168,1292,1292,1292,1292,5168
17,CAR (UNDP),2019,CAR-19/HCF10/SA2/FSEC/INGO/14256,8/12/2020 8:24:51 AM,Overall,3875,3875,3875,3875,15500,3875,3875,3875,3875,15500
17,CAR (UNDP),2019,CAR-19/HCF10/SA2/FSEC/INGO/14256,8/12/2020 8:24:51 AM,Returnees,1292,1292,1292,1292,5168,1292,1292,1292,1292,5168
17,CAR (UNDP),2019,CAR-19/HCF10/SA2/FSEC/INGO/14278,8/17/2020 3:06:22 PM,Host Communities,1340,1260,0,0,2600,1340,1260,0,0,2600
17,CAR (UNDP),2019,CAR-19/HCF10/SA2/FSEC/INGO/14278,8/17/2020 3:06:22 PM,Internally Displaced People,1110,1090,0,0,2200,1110,1094,0,0,2204
17,CAR (UNDP),2019,CAR-19/HCF10/SA2/FSEC/INGO/14278,8/17/2020 3:06:22 PM,Overall,5990,5710,0,0,11700,6011,7678,0,0,13689
17,CAR (UNDP),2019,CAR-19/HCF10/SA2/FSEC/INGO/14278,8/17/2020 3:06:22 PM,Returnees,3540,3360,0,0,6900,3561,5324,0,0,8885
17,CAR (UNDP),2019,CAR-19/HCF10/SA2/FSEC/NGO/14218,12/28/2020 5:17:26 PM,Host Communities,375,350,0,0,725,378,353,0,0,731
17,CAR (UNDP),2019,CAR-19/HCF10/SA2/FSEC/NGO/14218,12/28/2020 5:17:26 PM,Internally Displaced People,40,39,0,0,79,43,44,0,0,87
17,CAR (UNDP),2019,CAR-19/HCF10/SA2/FSEC/NGO/14218,12/28/2020 5:17:26 PM,Overall,575,675,0,0,1250,585,693,0,0,1278
17,CAR (UNDP),2019,CAR-19/HCF10/SA2/FSEC/NGO/14218,12/28/2020 5:17:26 PM,Returnees,160,286,0,0,446,164,296,0,0,460
17,CAR (UNDP),2019,CAR-19/HCF10/SA2/FSEC/NGO/14277,6/22/2020 9:13:21 AM,Host Communities,900,1350,0,0,2250,897,1340,0,0,2237
17,CAR (UNDP),2019,CAR-19/HCF10/SA2/FSEC/NGO/14277,6/22/2020 9:13:21 AM,Internally Displaced People,250,375,0,0,625,250,375,0,0,625
17,CAR (UNDP),2019,CAR-19/HCF10/SA2/FSEC/NGO/14277,6/22/2020 9:13:21 AM,Overall,1500,2250,0,0,3750,1497,2240,0,0,3737
17,CAR (UNDP),2019,CAR-19/HCF10/SA2/FSEC/NGO/14277,6/22/2020 9:13:21 AM,Refugees,135,202,0,0,337,135,202,0,0,337
17,CAR (UNDP),2019,CAR-19/HCF10/SA2/FSEC/NGO/14277,6/22/2020 9:13:21 AM,Returnees,215,323,0,0,538,215,323,0,0,538
17,CAR (UNDP),2019,CAR-19/HCF10/SA2/FSEC/NGO/14291,8/10/2020 10:02:43 AM,Overall,2000,3000,1500,1500,8000,2000,3000,1500,1500,8000
17,CAR (UNDP),2019,CAR-19/HCF10/SA2/FSEC/NGO/14291,8/10/2020 10:02:43 AM,Returnees,2000,3000,1500,1500,8000,2000,3000,1500,1500,8000
17,CAR (UNDP),2019,CAR-19/HCF10/SA2/FSEC/UN/14274,9/29/2020 1:59:19 PM,Host Communities,6860,7140,10290,10710,35000,8026,8354,12039,12530,40949
17,CAR (UNDP),2019,CAR-19/HCF10/SA2/FSEC/UN/14274,9/29/2020 1:59:19 PM,Internally Displaced People,1960,2040,2940,3060,10000,2293,2387,3440,3580,11700
17,CAR (UNDP),2019,CAR-19/HCF10/SA2/FSEC/UN/14274,9/29/2020 1:59:19 PM,Overall,9800,10200,14700,15300,50000,11466,11934,17199,17901,58500
17,CAR (UNDP),2019,CAR-19/HCF10/SA2/FSEC/UN/14274,9/29/2020 1:59:19 PM,Returnees,980,1020,1470,1530,5000,1147,1193,1720,1791,5851
17,CAR (UNDP),2019,CAR-19/HCF10/SA2/HLT/UN/14287,2/1/2021 8:05:38 AM,Host Communities,700,2200,500,900,4300,700,2200,500,900,4300
17,CAR (UNDP),2019,CAR-19/HCF10/SA2/HLT/UN/14287,2/1/2021 8:05:38 AM,Internally Displaced People,2500,5100,900,1175,9675,2500,5100,900,1175,9675
17,CAR (UNDP),2019,CAR-19/HCF10/SA2/HLT/UN/14287,2/1/2021 8:05:38 AM,Overall,3200,7300,1400,2075,13975,3200,7300,1400,2075,13975
17,CAR (UNDP),2019,CAR-19/HCF10/SA2/HLT/UN/14344,6/28/2020 6:46:46 AM,Host Communities,6000,13000,16000,16000,51000,6000,13500,16200,16000,51700
17,CAR (UNDP),2019,CAR-19/HCF10/SA2/HLT/UN/14344,6/28/2020 6:46:46 AM,Internally Displaced People,2000,4000,9000,9000,24000,2000,4000,9000,9200,24200
17,CAR (UNDP),2019,CAR-19/HCF10/SA2/HLT/UN/14344,6/28/2020 6:46:46 AM,Overall,10000,20000,35000,35000,100000,10200,20700,35400,35400,101700
17,CAR (UNDP),2019,CAR-19/HCF10/SA2/HLT/UN/14344,6/28/2020 6:46:46 AM,Returnees,2000,3000,10000,10000,25000,2200,3200,10200,10200,25800
17,CAR (UNDP),2019,CAR-19/HCF10/SA2/HLT-NUT/INGO/14227,8/11/2020 8:22:42 AM,Host Communities,6136,10543,5461,5342,27482,5527,8823,8286,8863,31499
17,CAR (UNDP),2019,CAR-19/HCF10/SA2/HLT-NUT/INGO/14227,8/11/2020 8:22:42 AM,Internally Displaced People,2633,3201,732,824,7390,2371,2679,1111,1367,7528
17,CAR (UNDP),2019,CAR-19/HCF10/SA2/HLT-NUT/INGO/14227,8/11/2020 8:22:42 AM,Other,30,55,15,10,110,27,46,23,17,113
17,CAR (UNDP),2019,CAR-19/HCF10/SA2/HLT-NUT/INGO/14227,8/11/2020 8:22:42 AM,Overall,10366,16620,6961,6874,40821,9336,13909,10563,11405,45213
17,CAR (UNDP),2019,CAR-19/HCF10/SA2/HLT-NUT/INGO/14227,8/11/2020 8:22:42 AM,Returnees,1567,2821,753,698,5839,1411,2361,1143,1158,6073
17,CAR (UNDP),2019,CAR-19/HCF10/SA2/HLT-NUT/INGO/14258,8/2/2020 7:21:31 AM,Host Communities,338,338,338,338,1352,558,816,929,989,3292
17,CAR (UNDP),2019,CAR-19/HCF10/SA2/HLT-NUT/INGO/14258,8/2/2020 7:21:31 AM,Internally Displaced People,987,987,987,987,3948,454,341,543,1175,2513
17,CAR (UNDP),2019,CAR-19/HCF10/SA2/HLT-NUT/INGO/14258,8/2/2020 7:21:31 AM,Other,226,226,226,226,904,0,0,0,0,0
17,CAR (UNDP),2019,CAR-19/HCF10/SA2/HLT-NUT/INGO/14258,8/2/2020 7:21:31 AM,Overall,2821,2821,2822,2822,11286,1012,1157,1472,2164,5805
17,CAR (UNDP),2019,CAR-19/HCF10/SA2/HLT-NUT/INGO/14258,8/2/2020 7:21:31 AM,Returnees,1270,1270,1271,1271,5082,0,0,0,0,0
17,CAR (UNDP),2019,CAR-19/HCF10/SA2/HLT-NUT/NGO/14221,7/24/2020 2:05:44 PM,Host Communities,1789,6003,6085,6080,19957,1922,5885,6115,6213,20135
17,CAR (UNDP),2019,CAR-19/HCF10/SA2/HLT-NUT/NGO/14221,7/24/2020 2:05:44 PM,Internally Displaced People,444,1499,1544,1555,5042,469,1521,1434,1562,4986
17,CAR (UNDP),2019,CAR-19/HCF10/SA2/HLT-NUT/NGO/14221,7/24/2020 2:05:44 PM,Overall,2975,10001,10203,10228,33407,3122,9940,10191,10454,33707
17,CAR (UNDP),2019,CAR-19/HCF10/SA2/HLT-NUT/NGO/14221,7/24/2020 2:05:44 PM,Returnees,742,2499,2574,2593,8408,731,2534,2642,2679,8586
17,CAR (UNDP),2019,CAR-19/HCF10/SA2/HLT-NUT-PROT/INGO/14286,8/5/2020 8:43:09 AM,Host Communities,245,255,100,120,720,0,0,0,0,0
17,CAR (UNDP),2019,CAR-19/HCF10/SA2/HLT-NUT-PROT/INGO/14286,8/5/2020 8:43:09 AM,Internally Displaced People,3960,4122,2718,2829,13629,2984,3736,3764,3640,14124
17,CAR (UNDP),2019,CAR-19/HCF10/SA2/HLT-NUT-PROT/INGO/14286,8/5/2020 8:43:09 AM,Overall,4205,4377,2818,2949,14349,2984,3736,3764,3640,14124
17,CAR (UNDP),2019,CAR-19/HCF10/SA2/HLT-NUT-WaSH/INGO/14237,8/16/2020 11:18:41 AM,Host Communities,11904,12894,4241,4596,33635,5230,5761,2456,2974,16421
17,CAR (UNDP),2019,CAR-19/HCF10/SA2/HLT-NUT-WaSH/INGO/14237,8/16/2020 11:18:41 AM,Internally Displaced People,4589,4973,1327,1437,12326,1678,1231,679,714,4302
17,CAR (UNDP),2019,CAR-19/HCF10/SA2/HLT-NUT-WaSH/INGO/14237,8/16/2020 11:18:41 AM,Overall,16493,17867,5568,6033,45961,6908,6992,3135,3688,20723
17,CAR (UNDP),2019,CAR-19/HCF10/SA2/HLT-WaSH/INGO/14299,7/16/2020 2:51:30 PM,Host Communities,5866,6354,1227,1329,14776,5866,6354,1227,1329,14776
17,CAR (UNDP),2019,CAR-19/HCF10/SA2/HLT-WaSH/INGO/14299,7/16/2020 2:51:30 PM,Internally Displaced People,1722,1866,360,390,4338,1722,1866,360,390,4338
17,CAR (UNDP),2019,CAR-19/HCF10/SA2/HLT-WaSH/INGO/14299,7/16/2020 2:51:30 PM,Overall,7588,8220,1587,1719,19114,7588,8220,1587,1719,19114
17,CAR (UNDP),2019,CAR-19/HCF10/SA2/LOG/INGO/14194,11/11/2020 4:04:00 PM,Host Communities,920,395,0,0,1315,6403,5833,0,0,12236
17,CAR (UNDP),2019,CAR-19/HCF10/SA2/LOG/INGO/14194,11/11/2020 4:04:00 PM,Overall,920,395,0,0,1315,6403,5833,0,0,12236
17,CAR (UNDP),2019,CAR-19/HCF10/SA2/LOG/INGO/14346,1/7/2021 9:50:37 AM,Other,13,0,0,0,13,32,0,0,0,32
17,CAR (UNDP),2019,CAR-19/HCF10/SA2/LOG/INGO/14346,1/7/2021 9:50:37 AM,Overall,13,0,0,0,13,32,0,0,0,32
17,CAR (UNDP),2019,CAR-19/HCF10/SA2/LOG/UN/14184,5/19/2020 9:07:33 AM,Other,0,0,0,20,20,0,0,0,24,24
17,CAR (UNDP),2019,CAR-19/HCF10/SA2/LOG/UN/14184,5/19/2020 9:07:33 AM,Overall,0,0,0,20,20,0,0,0,24,24
17,CAR (UNDP),2019,CAR-19/HCF10/SA2/NFI/UN/14193,11/13/2020 3:24:18 PM,Host Communities,882,918,882,918,3600,950,1100,950,1500,4500
17,CAR (UNDP),2019,CAR-19/HCF10/SA2/NFI/UN/14193,11/13/2020 3:24:18 PM,Internally Displaced People,3528,3672,3528,14400,25128,4000,4000,3800,14900,26700
17,CAR (UNDP),2019,CAR-19/HCF10/SA2/NFI/UN/14193,11/13/2020 3:24:18 PM,Overall,4410,4590,4410,15318,28728,4950,5100,4750,16400,31200
17,CAR (UNDP),2019,CAR-19/HCF10/SA2/NFI-PROT-CCCM/UN/14197,12/3/2021 10:40:29 AM,Host Communities,500,500,1000,1000,3000,52,86,44,234,416
17,CAR (UNDP),2019,CAR-19/HCF10/SA2/NFI-PROT-CCCM/UN/14197,12/3/2021 10:40:29 AM,Internally Displaced People,1621,1801,4311,3679,11412,3370,3153,7150,5920,19593
17,CAR (UNDP),2019,CAR-19/HCF10/SA2/NFI-PROT-CCCM/UN/14197,12/3/2021 10:40:29 AM,Overall,2121,2301,5311,4679,14412,3422,3239,7194,6154,20009
17,CAR (UNDP),2019,CAR-19/HCF10/SA2/NUT/INGO/14235,7/9/2020 1:42:04 PM,Host Communities,15831,17141,3216,3628,39816,10256,16620,2861,3302,33039
17,CAR (UNDP),2019,CAR-19/HCF10/SA2/NUT/INGO/14235,7/9/2020 1:42:04 PM,Internally Displaced People,2443,2643,494,557,6137,3241,2945,512,682,7380
17,CAR (UNDP),2019,CAR-19/HCF10/SA2/NUT/INGO/14235,7/9/2020 1:42:04 PM,Overall,18274,19784,3710,4185,45953,13497,19565,3373,3984,40419
17,CAR (UNDP),2019,CAR-19/HCF10/SA2/NUT/NGO/14283,11/16/2020 8:06:39 AM,Host Communities,51,43,8160,8160,16414,95,59,5920,7210,13284
17,CAR (UNDP),2019,CAR-19/HCF10/SA2/NUT/NGO/14283,11/16/2020 8:06:39 AM,Overall,51,43,8160,8160,16414,95,59,5920,7210,13284
17,CAR (UNDP),2019,CAR-19/HCF10/SA2/NUT/UN/14325,6/28/2020 7:03:41 AM,Host Communities,0,0,1772,1920,3692,0,0,2335,2529,4864
17,CAR (UNDP),2019,CAR-19/HCF10/SA2/NUT/UN/14325,6/28/2020 7:03:41 AM,Internally Displaced People,0,0,591,640,1231,0,0,778,843,1621
17,CAR (UNDP),2019,CAR-19/HCF10/SA2/NUT/UN/14325,6/28/2020 7:03:41 AM,Overall,0,0,2363,2560,4923,0,0,3113,3372,6485
17,CAR (UNDP),2019,CAR-19/HCF10/SA2/NUT/UN/14333,10/21/2020 1:11:31 PM,Host Communities,0,0,2577,2785,5362,0,0,5347,5862,11209
17,CAR (UNDP),2019,CAR-19/HCF10/SA2/NUT/UN/14333,10/21/2020 1:11:31 PM,Internally Displaced People,0,0,641,691,1332,0,0,1337,1463,2800
17,CAR (UNDP),2019,CAR-19/HCF10/SA2/NUT/UN/14333,10/21/2020 1:11:31 PM,Overall,0,0,3218,3476,6694,0,0,6684,7325,14009
17,CAR (UNDP),2019,CAR-19/HCF10/SA2/NUT-WaSH/INGO/14207,7/9/2020 12:55:04 PM,Internally Displaced People,7373,7982,1543,1667,18565,7373,7982,1543,1667,18565
17,CAR (UNDP),2019,CAR-19/HCF10/SA2/NUT-WaSH/INGO/14207,7/9/2020 12:55:04 PM,Overall,8075,8737,1689,1825,20326,8075,8737,1689,1825,20326
17,CAR (UNDP),2019,CAR-19/HCF10/SA2/NUT-WaSH/INGO/14207,7/9/2020 12:55:04 PM,Returnees,702,755,146,158,1761,702,755,146,158,1761
17,CAR (UNDP),2019,CAR-19/HCF10/SA2/NUT-WaSH/INGO/14242,7/16/2020 2:43:50 PM,Host Communities,67519,73146,14124,15301,170090,67519,73146,14124,15301,170090
17,CAR (UNDP),2019,CAR-19/HCF10/SA2/NUT-WaSH/INGO/14242,7/16/2020 2:43:50 PM,Internally Displaced People,16200,17550,3389,3671,40810,16200,17550,3389,3671,40810
17,CAR (UNDP),2019,CAR-19/HCF10/SA2/NUT-WaSH/INGO/14242,7/16/2020 2:43:50 PM,Overall,83719,90696,17513,18972,210900,83719,90696,17513,18972,210900
17,CAR (UNDP),2019,CAR-19/HCF10/SA2/PROT/INGO/14187,10/13/2020 9:54:10 AM,Host Communities,7574,3464,1451,1155,13644,5874,3000,2125,1500,12499
17,CAR (UNDP),2019,CAR-19/HCF10/SA2/PROT/INGO/14187,10/13/2020 9:54:10 AM,Internally Displaced People,1033,472,198,158,1861,3916,2000,1416,1000,8332
17,CAR (UNDP),2019,CAR-19/HCF10/SA2/PROT/INGO/14187,10/13/2020 9:54:10 AM,Overall,8607,3936,1649,1313,15505,9790,5000,3541,2500,20831
17,CAR (UNDP),2019,CAR-19/HCF10/SA2/PROT/INGO/14255,9/8/2020 8:46:12 AM,Host Communities,1601,3201,1206,1992,8000,2222,2335,2139,2607,9303
17,CAR (UNDP),2019,CAR-19/HCF10/SA2/PROT/INGO/14255,9/8/2020 8:46:12 AM,Internally Displaced People,2099,4199,1569,2633,10500,1401,2882,659,995,5937
17,CAR (UNDP),2019,CAR-19/HCF10/SA2/PROT/INGO/14255,9/8/2020 8:46:12 AM,Overall,3700,7400,2775,4625,18500,3623,5217,2798,3602,15240
17,CAR (UNDP),2019,CAR-19/HCF10/SA2/PROT/INGO/14264,8/28/2020 12:42:15 PM,Host Communities,1000,1500,0,0,2500,1290,1670,1360,1406,5726
17,CAR (UNDP),2019,CAR-19/HCF10/SA2/PROT/INGO/14264,8/28/2020 12:42:15 PM,Internally Displaced People,94,69,1480,1420,3063,840,851,875,667,3233
17,CAR (UNDP),2019,CAR-19/HCF10/SA2/PROT/INGO/14264,8/28/2020 12:42:15 PM,Overall,1094,1569,1480,1420,5563,2130,2521,2235,2073,8959
17,CAR (UNDP),2019,CAR-19/HCF10/SA2/PROT/INGO/14338,8/5/2020 2:26:24 PM,Host Communities,1563,2065,2477,3236,9341,2538,3517,5689,5685,17429
17,CAR (UNDP),2019,CAR-19/HCF10/SA2/PROT/INGO/14338,8/5/2020 2:26:24 PM,Internally Displaced People,96,95,1796,2183,4170,28,50,172,153,403
17,CAR (UNDP),2019,CAR-19/HCF10/SA2/PROT/INGO/14338,8/5/2020 2:26:24 PM,Overall,1659,2160,4273,5419,13511,2566,3567,5861,5838,17832
17,CAR (UNDP),2019,CAR-19/HCF10/SA2/PROT/INGO/14399,11/16/2020 12:41:17 PM,Host Communities,1100,1400,1140,1410,5050,2540,4648,1216,1782,10186
17,CAR (UNDP),2019,CAR-19/HCF10/SA2/PROT/INGO/14399,11/16/2020 12:41:17 PM,Internally Displaced People,3000,3000,900,900,7800,484,964,214,376,2038
17,CAR (UNDP),2019,CAR-19/HCF10/SA2/PROT/INGO/14399,11/16/2020 12:41:17 PM,Overall,4100,4400,2040,2310,12850,3024,5612,1430,2158,12224
17,CAR (UNDP),2019,CAR-19/HCF10/SA2/PROT/NGO/14195,7/17/2020 7:57:23 AM,Host Communities,2200,1800,3200,2800,10000,1879,1376,5991,2912,12158
17,CAR (UNDP),2019,CAR-19/HCF10/SA2/PROT/NGO/14195,7/17/2020 7:57:23 AM,Overall,2200,1800,3200,2800,10000,1879,1376,5991,2912,12158
17,CAR (UNDP),2019,CAR-19/HCF10/SA2/PROT/NGO/14261,11/13/2020 1:36:22 PM,Host Communities,1758,1392,1307,1202,5659,1758,1572,107,203,3640
17,CAR (UNDP),2019,CAR-19/HCF10/SA2/PROT/NGO/14261,11/13/2020 1:36:22 PM,Internally Displaced People,627,230,710,547,2114,2679,2218,310,248,5455
17,CAR (UNDP),2019,CAR-19/HCF10/SA2/PROT/NGO/14261,11/13/2020 1:36:22 PM,Other,68,105,95,618,886,68,308,95,319,790
17,CAR (UNDP),2019,CAR-19/HCF10/SA2/PROT/NGO/14261,11/13/2020 1:36:22 PM,Overall,2951,2352,2432,2765,10500,5003,4913,632,958,11506
17,CAR (UNDP),2019,CAR-19/HCF10/SA2/PROT/NGO/14261,11/13/2020 1:36:22 PM,Returnees,498,625,320,398,1841,498,815,120,188,1621
17,CAR (UNDP),2019,CAR-19/HCF10/SA2/WaSH/INGO/14217,11/13/2020 1:40:07 PM,Host Communities,2071,2400,149,795,5415,1968,2280,142,755,5145
17,CAR (UNDP),2019,CAR-19/HCF10/SA2/WaSH/INGO/14217,11/13/2020 1:40:07 PM,Internally Displaced People,2047,2116,3699,3223,11085,1945,2010,3515,3062,10532
17,CAR (UNDP),2019,CAR-19/HCF10/SA2/WaSH/INGO/14217,11/13/2020 1:40:07 PM,Overall,4319,4584,3858,4105,16866,4104,4355,3667,3900,16026
17,CAR (UNDP),2019,CAR-19/HCF10/SA2/WaSH/INGO/14217,11/13/2020 1:40:07 PM,Returnees,201,68,10,87,366,191,65,10,83,349
17,CAR (UNDP),2019,CAR-19/HCF10/SA2/WaSH/INGO/14266,10/13/2020 9:39:46 AM,Overall,1190,1680,2310,1820,7000,1190,1680,2310,1820,7000
17,CAR (UNDP),2019,CAR-19/HCF10/SA2/WaSH/INGO/14266,10/13/2020 9:39:46 AM,Returnees,1190,1680,2310,1820,7000,1190,1680,2310,1820,7000
17,CAR (UNDP),2019,CAR-19/HCF10/SA2/WaSH/INGO/14272,1/7/2021 7:39:07 AM,Host Communities,8812,9920,1946,2027,22705,8622,10033,2315,3288,24258
17,CAR (UNDP),2019,CAR-19/HCF10/SA2/WaSH/INGO/14272,1/7/2021 7:39:07 AM,Internally Displaced People,12289,13834,2715,2827,31665,5672,6933,8508,10398,31511
17,CAR (UNDP),2019,CAR-19/HCF10/SA2/WaSH/INGO/14272,1/7/2021 7:39:07 AM,Overall,25846,29094,5709,5946,66595,18614,21593,12155,15339,67701
17,CAR (UNDP),2019,CAR-19/HCF10/SA2/WaSH/INGO/14272,1/7/2021 7:39:07 AM,Returnees,4745,5340,1048,1092,12225,4320,4627,1332,1653,11932
17,CAR (UNDP),2019,CAR-19/HCF10/SA2/WaSH/INGO/14311,7/22/2020 3:55:14 PM,Host Communities,4827,5024,990,1029,11870,4827,5024,990,1029,11870
17,CAR (UNDP),2019,CAR-19/HCF10/SA2/WaSH/INGO/14311,7/22/2020 3:55:14 PM,Internally Displaced People,4691,4883,961,1000,11535,4691,4883,961,1000,11535
17,CAR (UNDP),2019,CAR-19/HCF10/SA2/WaSH/INGO/14311,7/22/2020 3:55:14 PM,Other,3932,4092,806,838,9668,3932,4092,806,838,9668
17,CAR (UNDP),2019,CAR-19/HCF10/SA2/WaSH/INGO/14311,7/22/2020 3:55:14 PM,Overall,13891,14459,2848,2961,34159,13891,14459,2848,2961,34159
17,CAR (UNDP),2019,CAR-19/HCF10/SA2/WaSH/INGO/14311,7/22/2020 3:55:14 PM,Returnees,441,460,91,94,1086,441,460,91,94,1086
17,CAR (UNDP),2019,CAR-19/HCF10/SA2/WaSH/INGO/14360,10/12/2020 3:12:56 PM,Other,1,1,1,1,4,1,1,1,1,4
17,CAR (UNDP),2019,CAR-19/HCF10/SA2/WaSH/INGO/14360,10/12/2020 3:12:56 PM,Overall,1,1,1,1,4,1,1,1,1,4
17,CAR (UNDP),2019,CAR-19/HCF10/SA2/WaSH/NGO/14342,11/10/2020 2:19:18 PM,Internally Displaced People,15000,23000,11000,18000,67000,13410,24500,11002,19000,67912
17,CAR (UNDP),2019,CAR-19/HCF10/SA2/WaSH/NGO/14342,11/10/2020 2:19:18 PM,Overall,15000,23000,11000,18000,67000,13410,24500,11002,19000,67912
17,CAR (UNDP),2019,CAR-19/HCF10/SA2/WaSH/UN/14225,8/6/2020 11:55:21 AM,Host Communities,5500,5700,2700,2800,16700,22321,23078,12334,13090,70823
17,CAR (UNDP),2019,CAR-19/HCF10/SA2/WaSH/UN/14225,8/6/2020 11:55:21 AM,Internally Displaced People,11000,11300,5300,5700,33300,7966,8981,7951,9414,34312
17,CAR (UNDP),2019,CAR-19/HCF10/SA2/WaSH/UN/14225,8/6/2020 11:55:21 AM,Overall,16500,17000,8000,8500,50000,30287,32059,20285,22504,105135
17,CAR (UNDP),2019,CAR-19/HCF10/SA2/WaSH-EDU-NFI/INGO/14215,8/12/2020 9:20:13 AM,Host Communities,2000,2041,0,0,4041,2000,2041,994,1215,6250
17,CAR (UNDP),2019,CAR-19/HCF10/SA2/WaSH-EDU-NFI/INGO/14215,8/12/2020 9:20:13 AM,Internally Displaced People,2000,2041,0,0,4041,2000,2041,0,0,4041
17,CAR (UNDP),2019,CAR-19/HCF10/SA2/WaSH-EDU-NFI/INGO/14215,8/12/2020 9:20:13 AM,Other,1250,1250,0,0,2500,1250,1250,0,0,2500
17,CAR (UNDP),2019,CAR-19/HCF10/SA2/WaSH-EDU-NFI/INGO/14215,8/12/2020 9:20:13 AM,Overall,7250,7373,0,0,14623,7250,7372,994,1215,16831
17,CAR (UNDP),2019,CAR-19/HCF10/SA2/WaSH-EDU-NFI/INGO/14215,8/12/2020 9:20:13 AM,Returnees,2000,2041,0,0,4041,2000,2040,0,0,4040
17,CAR (UNDP),2019,CAR-19/HCF10/SA2/WaSH-NFI/NGO/14328,6/28/2020 6:36:28 AM,Host Communities,879,1019,1886,2056,5840,922,1021,1938,2110,5991
17,CAR (UNDP),2019,CAR-19/HCF10/SA2/WaSH-NFI/NGO/14328,6/28/2020 6:36:28 AM,Overall,1420,1648,3049,3323,9440,1483,1663,3127,3329,9602
17,CAR (UNDP),2019,CAR-19/HCF10/SA2/WaSH-NFI/NGO/14328,6/28/2020 6:36:28 AM,Returnees,541,629,1163,1267,3600,561,642,1189,1219,3611
52,Colombia,2015,COL-15/DDA-3418/DA/WASH/INGO/1742,9/14/2016 3:18:35 PM,Host Communities,324,358,144,164,990,216,232,261,235,944
52,Colombia,2015,COL-15/DDA-3418/DA/WASH/INGO/1742,9/14/2016 3:18:35 PM,Internally Displaced People,194,216,86,98,594,96,103,116,105,420
52,Colombia,2015,COL-15/DDA-3418/DA/WASH/INGO/1742,9/14/2016 3:18:35 PM,Other,130,144,57,65,396,168,180,203,183,734
52,Colombia,2015,COL-15/DDA-3418/DA/WASH/INGO/1742,9/14/2016 3:18:35 PM,Overall,718,648,287,327,1980,480,515,580,523,2098
52,Colombia,2015,COL-15/DDA-3418/DA/WASH-SAN-RT/INGO/1747,8/18/2016 4:28:53 PM,Other,904,673,363,383,2323,751,565,489,525,2330
52,Colombia,2015,COL-15/DDA-3418/DA/WASH-SAN-RT/INGO/1747,8/18/2016 4:28:53 PM,Overall,904,673,363,383,2323,751,565,489,525,2330
52,Colombia,2015,COL-15/DDA-3418/SA/AL/NGO/1743,9/14/2016 3:32:15 PM,Internally Displaced People,200,300,200,300,1000,169,180,131,90,570
52,Colombia,2015,COL-15/DDA-3418/SA/AL/NGO/1743,9/14/2016 3:32:15 PM,Overall,200,300,200,300,1000,169,180,131,90,570
52,Colombia,2015,COL-15/DDA-3418/SA/SAN/NGO/2091,11/7/2017 10:26:55 PM,Other,957,865,783,683,3288,868,895,761,773,3297
52,Colombia,2015,COL-15/DDA-3418/SA/SAN/NGO/2091,11/7/2017 10:26:55 PM,Overall,865,957,683,783,3288,868,895,761,773,3297
52,Colombia,2015,COL-15/DDA-3418/SA/SAN-WASH-Pr/INGO/2095,3/10/2017 2:53:06 PM,Host Communities,22,26,30,22,100,0,0,0,0,0
52,Colombia,2015,COL-15/DDA-3418/SA/SAN-WASH-Pr/INGO/2095,3/10/2017 2:53:06 PM,Internally Displaced People,110,132,151,107,500,113,147,182,176,618
52,Colombia,2015,COL-15/DDA-3418/SA/SAN-WASH-Pr/INGO/2095,3/10/2017 2:53:06 PM,Other,12,18,80,120,230,26,16,1229,1335,2606
52,Colombia,2015,COL-15/DDA-3418/SA/SAN-WASH-Pr/INGO/2095,3/10/2017 2:53:06 PM,Overall,144,176,261,249,830,139,163,1411,1511,3224
52,Colombia,2015,COL-15/DDA-3418/SA/WASH-SAN-Pr/INGO/2097,3/9/2017 4:12:20 PM,Internally Displaced People,92,112,126,90,420,92,112,126,90,420
52,Colombia,2015,COL-15/DDA-3418/SA/WASH-SAN-Pr/INGO/2097,3/9/2017 4:12:20 PM,Other,73,88,75,54,290,73,88,75,54,290
52,Colombia,2015,COL-15/DDA-3418/SA/WASH-SAN-Pr/INGO/2097,3/9/2017 4:12:20 PM,Overall,147,178,201,144,670,135,157,199,200,691
52,Colombia,2016,COL-16/DDA-3418/DA/SAN-AL-WASH/NGO/4367,9/5/2017 9:43:15 PM,Overall,504,374,393,411,1682,331,325,239,229,1124
52,Colombia,2016,COL-16/DDA-3418/DA/WASH-SA-SAN/NGO/3140,4/28/2017 6:27:54 PM,Internally Displaced People,196,244,202,184,826,209,233,191,211,844
52,Colombia,2016,COL-16/DDA-3418/DA/WASH-SA-SAN/NGO/3140,4/28/2017 6:27:54 PM,Overall,196,244,202,184,826,339,377,310,342,1368
52,Colombia,2016,COL-16/DDA-3418/SA/AL/INGO/2799,5/3/2017 2:17:21 PM,Internally Displaced People,50,51,64,81,246,50,40,79,86,255
52,Colombia,2016,COL-16/DDA-3418/SA/AL/INGO/2799,5/3/2017 2:17:21 PM,Overall,50,51,64,81,246,50,40,79,86,255
52,Colombia,2016,COL-16/DDA-3418/SA/E&E-Pr/INGO/3810,10/9/2017 2:31:58 PM,Other,88,152,200,360,800,203,230,282,290,1005
52,Colombia,2016,COL-16/DDA-3418/SA/E&E-Pr/INGO/3810,10/9/2017 2:31:58 PM,Overall,88,152,200,360,800,203,230,282,290,1005
52,Colombia,2016,COL-16/DDA-3418/SA/E&E-Pr/NGO/4029,2/5/2018 3:39:40 PM,Host Communities,220,280,145,121,766,400,384,200,234,1218
52,Colombia,2016,COL-16/DDA-3418/SA/E&E-Pr/NGO/4029,2/5/2018 3:39:40 PM,Internally Displaced People,50,22,10,10,92,73,100,91,100,364
52,Colombia,2016,COL-16/DDA-3418/SA/E&E-Pr/NGO/4029,2/5/2018 3:39:40 PM,Overall,270,302,155,131,858,473,484,291,334,1582
52,Colombia,2016,COL-16/DDA-3418/SA/E&E-WASH/INGO/4195,9/21/2017 1:44:48 PM,Other,75,151,95,100,421,121,247,246,248,862
52,Colombia,2016,COL-16/DDA-3418/SA/E&E-WASH/INGO/4195,9/21/2017 1:44:48 PM,Overall,75,151,95,100,421,121,247,246,248,862
52,Colombia,2016,COL-16/DDA-3418/SA/Pr-RT/INGO/3993,9/12/2017 3:01:52 PM,Internally Displaced People,255,322,231,280,1088,243,249,220,210,922
52,Colombia,2016,COL-16/DDA-3418/SA/Pr-RT/INGO/3993,9/12/2017 3:01:52 PM,Overall,255,322,231,280,1088,243,249,220,210,922
52,Colombia,2016,COL-16/DDA-3418/SA/Pr-WASH/INGO/2864,8/28/2017 2:08:13 PM,Host Communities,15,30,29,22,96,15,30,29,22,96
52,Colombia,2016,COL-16/DDA-3418/SA/Pr-WASH/INGO/2864,8/28/2017 2:08:13 PM,Internally Displaced People,485,630,411,378,1904,485,630,411,378,1904
52,Colombia,2016,COL-16/DDA-3418/SA/Pr-WASH/INGO/2864,8/28/2017 2:08:13 PM,Overall,500,660,440,400,2000,500,660,440,400,2000
52,Colombia,2016,COL-16/DDA-3418/SA/SAN-WASH/INGO/3900,2/28/2018 4:18:17 PM,Other,900,1250,178,172,2500,813,1037,1102,1089,4041
52,Colombia,2016,COL-16/DDA-3418/SA/SAN-WASH/INGO/3900,2/28/2018 4:18:17 PM,Overall,900,1250,178,172,2500,813,1037,1102,1089,4041
52,Colombia,2016,COL-16/DDA-3418/SA/WASH/INGO/2878,3/13/2017 1:52:36 PM,Other,109,127,114,87,437,182,130,102,110,524
52,Colombia,2016,COL-16/DDA-3418/SA/WASH/INGO/2878,3/13/2017 1:52:36 PM,Overall,109,127,114,87,437,182,130,102,110,524
52,Colombia,2016,COL-16/DDA-3418/SA/WASH-SA/NGO/2881,10/23/2017 10:19:16 PM,Other,528,571,610,602,2311,551,1028,975,985,3539
52,Colombia,2016,COL-16/DDA-3418/SA/WASH-SA/NGO/2881,10/23/2017 10:19:16 PM,Overall,528,571,610,602,2311,551,1028,975,985,3539
52,Colombia,2016,COL-16/DDA-3418/SA/WASH-SAN-Pr/NGO/4234,8/15/2017 9:23:33 PM,Other,100,100,100,100,400,0,0,0,0,0
52,Colombia,2016,COL-16/DDA-3418/SA/WASH-SAN-Pr/NGO/4234,8/15/2017 9:23:33 PM,Overall,100,100,100,100,400,100,100,100,100,400
52,Colombia,2017,COL-17/DDA-3418/DA/Pr/NGO/7657,8/27/2018 2:38:53 PM,Internally Displaced People,44,92,44,44,224,59,117,80,134,390
52,Colombia,2017,COL-17/DDA-3418/DA/Pr/NGO/7657,8/27/2018 2:38:53 PM,Overall,44,92,44,44,224,59,117,80,134,390
52,Colombia,2017,COL-17/DDA-3418/DA/Pr-E&E-AL/INGO/5777,3/5/2018 2:22:56 PM,Host Communities,60,70,510,590,1230,230,392,613,620,1855
52,Colombia,2017,COL-17/DDA-3418/DA/Pr-E&E-AL/INGO/5777,3/5/2018 2:22:56 PM,Internally Displaced People,100,120,765,885,1870,42,63,140,155,400
52,Colombia,2017,COL-17/DDA-3418/DA/Pr-E&E-AL/INGO/5777,3/5/2018 2:22:56 PM,Other,40,60,0,0,100,390,681,1128,886,3085
52,Colombia,2017,COL-17/DDA-3418/DA/Pr-E&E-AL/INGO/5777,3/5/2018 2:22:56 PM,Overall,200,250,1275,1475,3200,662,1136,1881,1661,5340
52,Colombia,2017,COL-17/DDA-3418/DA/SAN-SA-Pr/NGO/5853,4/27/2018 2:21:50 PM,Other,79,64,90,94,327,62,63,106,96,327
52,Colombia,2017,COL-17/DDA-3418/DA/SAN-SA-Pr/NGO/5853,4/27/2018 2:21:50 PM,Overall,79,64,90,94,327,62,63,106,96,327
52,Colombia,2017,COL-17/DDA-3418/DA/WASH-SA-RT/NGO/6398,5/26/2018 12:45:26 AM,Internally Displaced People,33,59,46,35,173,37,31,16,21,105
52,Colombia,2017,COL-17/DDA-3418/DA/WASH-SA-RT/NGO/6398,5/26/2018 12:45:26 AM,Other,535,364,535,393,1827,723,663,300,319,2005
52,Colombia,2017,COL-17/DDA-3418/DA/WASH-SA-RT/NGO/6398,5/26/2018 12:45:26 AM,Overall,568,423,581,428,2000,760,694,316,340,2110
52,Colombia,2017,COL-17/DDA-3418/SA /Pr-SA-WASH/NGO/7021,7/19/2018 8:02:31 PM,Host Communities,235,246,151,174,806,235,246,151,174,806
52,Colombia,2017,COL-17/DDA-3418/SA /Pr-SA-WASH/NGO/7021,7/19/2018 8:02:31 PM,Internally Displaced People,214,327,311,319,1171,214,327,311,319,1171
52,Colombia,2017,COL-17/DDA-3418/SA /Pr-SA-WASH/NGO/7021,7/19/2018 8:02:31 PM,Other,432,289,202,178,1101,432,289,202,178,1101
52,Colombia,2017,COL-17/DDA-3418/SA /Pr-SA-WASH/NGO/7021,7/19/2018 8:02:31 PM,Overall,881,862,664,671,3078,881,862,664,671,3078
52,Colombia,2017,COL-17/DDA-3418/SA /RT-WASH-SA/NGO/7033,7/18/2018 8:30:07 PM,Other,350,386,552,552,1840,495,517,669,682,2363
52,Colombia,2017,COL-17/DDA-3418/SA /RT-WASH-SA/NGO/7033,7/18/2018 8:30:07 PM,Overall,350,386,552,552,1840,350,386,552,552,1840
52,Colombia,2017,COL-17/DDA-3418/SA /SAN-WASH/INGO/7060,9/10/2018 9:53:47 PM,Overall,1020,1140,194,206,2560,582,1047,939,878,3446
52,Colombia,2017,COL-17/DDA-3418/SA /WASH-Pr-SA/INGO/7004,7/26/2018 4:13:49 PM,Internally Displaced People,604,580,339,327,1850,435,571,443,403,1852
52,Colombia,2017,COL-17/DDA-3418/SA /WASH-Pr-SA/INGO/7004,7/26/2018 4:13:49 PM,Overall,604,580,339,327,1850,435,571,443,403,1852
25,DRC,2020,DRC-20/HCG10/RA1/HLT/INGO/15859,4/21/2021 8:39:19 AM,Host Communities,11737,12213,0,0,23950,8348,10339,1150,1425,21262
25,DRC,2020,DRC-20/HCG10/RA1/HLT/INGO/15859,4/21/2021 8:39:19 AM,Overall,11737,12213,0,0,23950,8348,10339,1150,1425,21262
25,DRC,2020,DRC-20/HCG10/RA1/HLT/NGO/15860,5/11/2021 9:05:19 AM,Host Communities,116769,148541,142714,121534,529558,131084,142746,159996,125775,559601
25,DRC,2020,DRC-20/HCG10/RA1/HLT/NGO/15860,5/11/2021 9:05:19 AM,Overall,116769,148541,142714,121534,529558,131084,142746,159996,125775,559601
25,DRC,2020,DRC-20/HCG10/RA1/HLT/UN/15888,3/11/2021 8:40:37 AM,Other,861,933,795,861,3450,1152,1249,1067,1153,4621
25,DRC,2020,DRC-20/HCG10/RA1/HLT/UN/15888,3/11/2021 8:40:37 AM,Overall,861,933,795,861,3450,1152,1249,1067,1153,4621
25,DRC,2020,DRC-20/HCG10/RA1/HLT-PROT/INGO/15882,9/27/2021 5:46:36 AM,Host Communities,64167,66786,100362,104460,335775,207338,269290,110035,151630,738293
25,DRC,2020,DRC-20/HCG10/RA1/HLT-PROT/INGO/15882,9/27/2021 5:46:36 AM,Overall,64167,66786,100362,104460,335775,207338,269290,110035,151630,738293
25,DRC,2020,DRC-20/HCG10/RA1/HLT-PROT/UN/15886,9/16/2021 10:32:25 AM,Host Communities,9513,10305,14270,15459,49547,9856,10345,7134,8365,35700
25,DRC,2020,DRC-20/HCG10/RA1/HLT-PROT/UN/15886,9/16/2021 10:32:25 AM,Overall,9513,10305,14270,15459,49547,9856,10345,7134,8365,35700
25,DRC,2020,DRC-20/HCG10/RA1/HLT-PROT-WaSH/INGO/15873,3/19/2021 8:42:01 AM,Host Communities,780,780,0,0,1560,937,648,0,0,1585
25,DRC,2020,DRC-20/HCG10/RA1/HLT-PROT-WaSH/INGO/15873,3/19/2021 8:42:01 AM,Other,0,0,5000,3000,8000,0,0,6442,3793,10235
25,DRC,2020,DRC-20/HCG10/RA1/HLT-PROT-WaSH/INGO/15873,3/19/2021 8:42:01 AM,Overall,780,780,5000,3000,9560,937,648,6442,3793,11820
25,DRC,2020,DRC-20/HCG10/RA1/HLT-WaSH/NGO/15858,6/2/2021 10:55:19 AM,Host Communities,7382,9116,13460,13460,43418,7048,8959,5472,7278,28757
25,DRC,2020,DRC-20/HCG10/RA1/HLT-WaSH/NGO/15858,6/2/2021 10:55:19 AM,Internally Displaced People,4115,5084,7504,7504,24207,54,14,4970,4944,9982
25,DRC,2020,DRC-20/HCG10/RA1/HLT-WaSH/NGO/15858,6/2/2021 10:55:19 AM,Overall,12683,15666,23127,23127,74603,7102,8973,10442,12222,38739
25,DRC,2020,DRC-20/HCG10/RA1/HLT-WaSH/NGO/15858,6/2/2021 10:55:19 AM,Returnees,1186,1466,2163,2163,6978,0,0,0,0,0
25,DRC,2020,DRC-20/HCG10/RA1/HLT-WaSH/O/15866,7/21/2021 12:13:47 PM,Host Communities,11438,30502,14098,35136,91174,11438,30502,14098,35136,91174
25,DRC,2020,DRC-20/HCG10/RA1/HLT-WaSH/O/15866,7/21/2021 12:13:47 PM,Overall,11438,30502,14098,35136,91174,11438,30502,14098,35136,91174
25,DRC,2020,DRC-20/HCG10/RA1/HLT-WaSH-PROT/INGO/15856,5/7/2021 10:12:41 AM,Other,5522,6494,4866,4896,21778,28381,34450,933,716,64480
25,DRC,2020,DRC-20/HCG10/RA1/HLT-WaSH-PROT/INGO/15856,5/7/2021 10:12:41 AM,Overall,5522,6494,4866,4896,21778,28381,34450,933,716,64480
25,DRC,2020,DRC-20/HCG10/RA1/HLT-WaSH-PROT/INGO/15867,6/21/2021 8:30:23 AM,Host Communities,11212,18686,18686,26161,74745,21693,27119,13716,26120,88648
25,DRC,2020,DRC-20/HCG10/RA1/HLT-WaSH-PROT/INGO/15867,6/21/2021 8:30:23 AM,Overall,11212,18686,18686,26161,74745,21693,27119,13716,26120,88648
25,DRC,2020,DRC-20/HCG10/RA1/HLT-WaSH-PROT/INGO/15871,5/6/2021 8:36:32 AM,Host Communities,15779,17440,24084,25745,83048,78462,88265,34198,43021,243946
25,DRC,2020,DRC-20/HCG10/RA1/HLT-WaSH-PROT/INGO/15871,5/6/2021 8:36:32 AM,Overall,15779,17440,24084,25745,83048,78462,88265,34198,43021,243946
25,DRC,2020,DRC-20/HCG10/RA1/HLT-WaSH-PROT/INGO/15878,5/14/2021 1:43:18 PM,Host Communities,15987,22570,25391,30093,94041,55380,56525,44764,64213,220882
25,DRC,2020,DRC-20/HCG10/RA1/HLT-WaSH-PROT/INGO/15878,5/14/2021 1:43:18 PM,Other,4034,5695,6407,7593,23729,6900,9805,13073,11031,40809
25,DRC,2020,DRC-20/HCG10/RA1/HLT-WaSH-PROT/INGO/15878,5/14/2021 1:43:18 PM,Overall,20021,28265,31798,37686,117770,62280,66330,57837,75244,261691
25,DRC,2020,DRC-20/HCG10/RA1/HLT-WaSH-PROT/INGO/15880,4/21/2021 6:34:08 AM,Host Communities,59230,71413,40110,48714,219467,187650,227086,136274,167128,718138
25,DRC,2020,DRC-20/HCG10/RA1/HLT-WaSH-PROT/INGO/15880,4/21/2021 6:34:08 AM,Overall,59230,71413,40110,48714,219467,187650,227086,136274,167128,718138
25,DRC,2020,DRC-20/HCG10/RA1/HLT-WaSH-PROT/INGO/15884,3/11/2021 10:37:26 AM,Host Communities,113760,123240,188760,174240,600000,164673,212306,151327,195080,723386
25,DRC,2020,DRC-20/HCG10/RA1/HLT-WaSH-PROT/INGO/15884,3/11/2021 10:37:26 AM,Overall,113760,123240,188760,174240,600000,164673,212306,151327,195080,723386
25,DRC,2020,DRC-20/HCG10/RA1/PROT/INGO/15889,3/11/2021 10:31:22 AM,Host Communities,1500,2497,3000,3000,9997,5877,2712,1504,611,10704
25,DRC,2020,DRC-20/HCG10/RA1/PROT/INGO/15889,3/11/2021 10:31:22 AM,Overall,1500,2497,3000,3000,9997,5877,2712,1504,611,10704
25,DRC,2020,DRC-20/HCG10/RA1/WaSH/INGO/15883,5/14/2021 2:27:49 PM,Host Communities,9736,10760,14860,15884,51240,10370,14030,13745,15941,54086
25,DRC,2020,DRC-20/HCG10/RA1/WaSH/INGO/15883,5/14/2021 2:27:49 PM,Overall,9736,10760,14860,15884,51240,10370,14030,13745,15941,54086
25,DRC,2020,DRC-20/HCG10/RA1/WaSH/UN/15972,3/15/2021 6:16:56 AM,Host Communities,425,461,467,460,1813,466,484,498,486,1934
25,DRC,2020,DRC-20/HCG10/RA1/WaSH/UN/15972,3/15/2021 6:16:56 AM,Overall,1770,1850,2758,2666,9044,1820,1886,2895,2799,9400
25,DRC,2020,DRC-20/HCG10/RA1/WaSH/UN/15972,3/15/2021 6:16:56 AM,Refugees,1345,1389,2291,2206,7231,1354,1402,2397,2313,7466
25,DRC,2020,DRC-20/HCG10/RA1/WaSH-PROT/UN/15887,3/19/2021 7:28:44 AM,Other,1105,1105,6600,6350,15160,14357,5777,6569,6488,33191
25,DRC,2020,DRC-20/HCG10/RA1/WaSH-PROT/UN/15887,3/19/2021 7:28:44 AM,Overall,1105,1105,6600,6350,15160,14357,5777,6569,6488,33191
25,DRC,2020,DRC-20/HCG10/RA2/LOG/UN/16786,11/29/2021 9:01:02 AM,Host Communities,1,1,1,1,4,1,1,1,1,4
25,DRC,2020,DRC-20/HCG10/RA2/LOG/UN/16786,11/29/2021 9:01:02 AM,Internally Displaced People,1,1,1,1,4,1,1,1,1,4
25,DRC,2020,DRC-20/HCG10/RA2/LOG/UN/16786,11/29/2021 9:01:02 AM,Overall,4,4,4,4,16,4,4,4,4,16
25,DRC,2020,DRC-20/HCG10/RA2/LOG/UN/16786,11/29/2021 9:01:02 AM,Refugees,1,1,1,1,4,1,1,1,1,4
25,DRC,2020,DRC-20/HCG10/RA2/LOG/UN/16786,11/29/2021 9:01:02 AM,Returnees,1,1,1,1,4,1,1,1,1,4
25,DRC,2020,DRC-20/HCG10/RA2/LOG/UN/17116,4/23/2021 9:59:24 AM,Other,28704,31096,26496,28704,115000,146619,169370,18564,20474,355027
25,DRC,2020,DRC-20/HCG10/RA2/LOG/UN/17116,4/23/2021 9:59:24 AM,Overall,28704,31096,26496,28704,115000,146619,169370,18564,20474,355027
25,DRC,2020,DRC-20/HCG10/RA2/PROT/UN/16785,7/16/2021 3:05:23 PM,Host Communities,3024,4176,336,464,8000,10129,3501,1435,2563,17628
25,DRC,2020,DRC-20/HCG10/RA2/PROT/UN/16785,7/16/2021 3:05:23 PM,Overall,3024,4176,336,464,8000,10129,3501,1435,2563,17628
25,DRC,2020,DRC-20/HCG10/RA2/WaSH/UN/16788,3/15/2021 5:55:16 AM,Other,2025,2835,3000,5640,13500,1961,2728,2961,4647,12297
25,DRC,2020,DRC-20/HCG10/RA2/WaSH/UN/16788,3/15/2021 5:55:16 AM,Overall,2025,2835,3000,5640,13500,1961,2728,2961,4647,12297
25,DRC,2020,DRC-20/HCG10/RA3/FSEC/INGO/17151,8/4/2021 9:15:24 AM,Host Communities,832,907,945,1096,3780,89,103,408,102,702
25,DRC,2020,DRC-20/HCG10/RA3/FSEC/INGO/17151,8/4/2021 9:15:24 AM,Internally Displaced People,1478,1613,1680,1949,6720,2181,2415,3015,2663,10274
25,DRC,2020,DRC-20/HCG10/RA3/FSEC/INGO/17151,8/4/2021 9:15:24 AM,Overall,2310,2520,2625,3045,10500,2270,2518,3423,2765,10976
25,DRC,2020,DRC-20/HCG10/RA3/FSEC/INGO/17155,3/1/2022 6:53:30 AM,Host Communities,1065,1177,1625,1737,5604,368,488,839,915,2610
25,DRC,2020,DRC-20/HCG10/RA3/FSEC/INGO/17155,3/1/2022 6:53:30 AM,Internally Displaced People,1464,1618,2235,2389,7706,435,542,863,920,2760
25,DRC,2020,DRC-20/HCG10/RA3/FSEC/INGO/17155,3/1/2022 6:53:30 AM,Overall,2662,2942,4063,4343,14010,1827,2357,4089,4282,12555
25,DRC,2020,DRC-20/HCG10/RA3/FSEC/INGO/17155,3/1/2022 6:53:30 AM,Returnees,133,147,203,217,700,1024,1327,2387,2447,7185
25,DRC,2020,DRC-20/HCG10/RA3/HLT/UN/17187,3/23/2022 7:59:41 AM,Host Communities,9685,10003,14081,13640,47409,5735,5877,8128,7918,27658
25,DRC,2020,DRC-20/HCG10/RA3/HLT/UN/17187,3/23/2022 7:59:41 AM,Internally Displaced People,12243,12644,17797,17240,59924,8522,9196,11379,10443,39540
25,DRC,2020,DRC-20/HCG10/RA3/HLT/UN/17187,3/23/2022 7:59:41 AM,Overall,35901,37079,52192,50538,175710,20811,22200,28334,26541,97886
25,DRC,2020,DRC-20/HCG10/RA3/HLT/UN/17187,3/23/2022 7:59:41 AM,Refugees,3957,4087,5752,5552,19348,0,0,0,0,0
25,DRC,2020,DRC-20/HCG10/RA3/HLT/UN/17187,3/23/2022 7:59:41 AM,Returnees,10016,10345,14562,14106,49029,6554,7127,8827,8180,30688
25,DRC,2020,DRC-20/HCG10/RA3/NFI/NGO/17180,10/27/2021 9:20:54 AM,Internally Displaced People,1308,2036,2855,3260,9459,1938,2150,3851,3611,11550
25,DRC,2020,DRC-20/HCG10/RA3/NFI/NGO/17180,10/27/2021 9:20:54 AM,Overall,1644,2532,3544,3961,11681,2274,2640,4540,4312,13766
25,DRC,2020,DRC-20/HCG10/RA3/NFI/NGO/17180,10/27/2021 9:20:54 AM,Returnees,336,496,689,701,2222,336,490,689,701,2216
25,DRC,2020,DRC-20/HCG10/RA3/NUT/NGO/17176,11/7/2022 10:33:39 AM,Host Communities,7000,7000,150,162,14312,6145,10556,457,499,17657
25,DRC,2020,DRC-20/HCG10/RA3/NUT/NGO/17176,11/7/2022 10:33:39 AM,Internally Displaced People,960,960,349,379,2648,862,1882,310,705,3759
25,DRC,2020,DRC-20/HCG10/RA3/NUT/NGO/17176,11/7/2022 10:33:39 AM,Overall,7960,7960,499,541,16960,7007,12438,767,1204,21416
25,DRC,2020,DRC-20/HCG10/RA3/NUT/NGO/17193,10/25/2021 10:56:34 AM,Host Communities,324,494,399,487,1704,99,303,366,490,1258
25,DRC,2020,DRC-20/HCG10/RA3/NUT/NGO/17193,10/25/2021 10:56:34 AM,Internally Displaced People,176,269,218,266,929,13,260,309,377,959
25,DRC,2020,DRC-20/HCG10/RA3/NUT/NGO/17193,10/25/2021 10:56:34 AM,Overall,588,898,726,886,3098,166,746,1030,1256,3198
25,DRC,2020,DRC-20/HCG10/RA3/NUT/NGO/17193,10/25/2021 10:56:34 AM,Returnees,88,135,109,133,465,54,183,355,389,981
25,DRC,2020,DRC-20/HCG10/RA3/PROT/INGO/17175,9/6/2021 9:45:57 AM,Host Communities,0,0,1715,1673,3388,689,642,1244,1528,4103
25,DRC,2020,DRC-20/HCG10/RA3/PROT/INGO/17175,9/6/2021 9:45:57 AM,Internally Displaced People,0,0,1347,1315,2662,347,421,1354,1687,3809
25,DRC,2020,DRC-20/HCG10/RA3/PROT/INGO/17175,9/6/2021 9:45:57 AM,Overall,0,0,3062,2988,6050,1036,1063,2598,3215,7912
25,DRC,2020,DRC-20/HCG10/RA3/PROT/INGO/17203,10/27/2021 8:31:39 AM,Host Communities,11724,20000,12000,12000,55724,12365,25245,10126,13035,60771
25,DRC,2020,DRC-20/HCG10/RA3/PROT/INGO/17203,10/27/2021 8:31:39 AM,Internally Displaced People,39079,19539,3257,3257,65132,9963,10158,6431,7956,34508
25,DRC,2020,DRC-20/HCG10/RA3/PROT/INGO/17203,10/27/2021 8:31:39 AM,Other,7816,3908,651,651,13026,6236,3678,1853,1298,13065
25,DRC,2020,DRC-20/HCG10/RA3/PROT/INGO/17203,10/27/2021 8:31:39 AM,Overall,78158,53217,20908,20908,173191,41787,51024,26432,30058,149301
25,DRC,2020,DRC-20/HCG10/RA3/PROT/INGO/17203,10/27/2021 8:31:39 AM,Returnees,19539,9770,5000,5000,39309,13223,11943,8022,7769,40957
25,DRC,2020,DRC-20/HCG10/RA3/WaSH/NGO/17153,9/3/2021 10:17:38 AM,Other,6144,9216,6656,9984,32000,6090,9240,6673,9997,32000
25,DRC,2020,DRC-20/HCG10/RA3/WaSH/NGO/17153,9/3/2021 10:17:38 AM,Overall,6144,9216,6656,9984,32000,6090,9240,6673,9997,32000
25,DRC,2020,DRC-20/HCG10/RA3/WaSH/NGO/17185,9/6/2021 9:51:22 AM,Host Communities,2461,2096,2665,2770,9992,1971,1859,3207,3150,10187
25,DRC,2020,DRC-20/HCG10/RA3/WaSH/NGO/17185,9/6/2021 9:51:22 AM,Internally Displaced People,5653,6693,11289,11861,35496,6134,6620,11014,11547,35315
25,DRC,2020,DRC-20/HCG10/RA3/WaSH/NGO/17185,9/6/2021 9:51:22 AM,Overall,8114,8789,13954,14631,45488,8105,8479,14221,14697,45502
25,DRC,2020,DRC-20/HCG10/RA4/NFI/INGO/17411,12/2/2021 8:03:02 AM,Host Communities,241,260,324,330,1155,361,349,402,349,1461
25,DRC,2020,DRC-20/HCG10/RA4/NFI/INGO/17411,12/2/2021 8:03:02 AM,Internally Displaced People,238,251,409,422,1320,224,257,490,242,1213
25,DRC,2020,DRC-20/HCG10/RA4/NFI/INGO/17411,12/2/2021 8:03:02 AM,Overall,1045,1116,1488,1523,5172,2196,2139,2626,2286,9247
25,DRC,2020,DRC-20/HCG10/RA4/NFI/INGO/17411,12/2/2021 8:03:02 AM,Returnees,566,605,755,771,2697,1611,1533,1734,1695,6573
25,DRC,2020,DRC-20/HCG10/RA4/NFI-WaSH/O/17303,7/12/2021 11:12:03 AM,Host Communities,278,702,319,830,2129,278,702,319,830,2129
25,DRC,2020,DRC-20/HCG10/RA4/NFI-WaSH/O/17303,7/12/2021 11:12:03 AM,Internally Displaced People,1133,2873,1306,3396,8708,1133,2873,1306,3396,8708
25,DRC,2020,DRC-20/HCG10/RA4/NFI-WaSH/O/17303,7/12/2021 11:12:03 AM,Overall,2517,6385,2902,7546,19350,2517,6385,2902,7546,19350
25,DRC,2020,DRC-20/HCG10/RA4/NFI-WaSH/O/17303,7/12/2021 11:12:03 AM,Returnees,1106,2810,1277,3320,8513,1106,2810,1277,3320,8513
25,DRC,2020,DRC-20/HCG10/RA4/WaSH/NGO/17325,9/6/2021 10:01:37 AM,Host Communities,1160,1281,2778,2781,8000,1769,2082,3731,3808,11390
25,DRC,2020,DRC-20/HCG10/RA4/WaSH/NGO/17325,9/6/2021 10:01:37 AM,Internally Displaced People,6740,6924,7830,8506,30000,4587,4626,7956,8107,25276
25,DRC,2020,DRC-20/HCG10/RA4/WaSH/NGO/17325,9/6/2021 10:01:37 AM,Overall,11760,12650,16330,17260,58000,7511,7987,14368,14649,44515
25,DRC,2020,DRC-20/HCG10/RA4/WaSH/NGO/17325,9/6/2021 10:01:37 AM,Returnees,3860,4445,5722,5973,20000,1155,1279,2681,2734,7849
25,DRC,2020,DRC-20/HCG10/RA5/Multi/INGO/17670,3/11/2022 12:26:30 PM,Other,14,0,0,0,14,18,0,0,0,18
25,DRC,2020,DRC-20/HCG10/RA5/Multi/INGO/17670,3/11/2022 12:26:30 PM,Overall,14,0,0,0,14,18,0,0,0,18
25,DRC,2020,DRC-20/HCG10/RA6/HLT/INGO/17976,6/1/2022 7:06:08 AM,Host Communities,369,517,221,369,1476,149,302,126,159,736
25,DRC,2020,DRC-20/HCG10/RA6/HLT/INGO/17976,6/1/2022 7:06:08 AM,Internally Displaced People,3362,4706,2017,3362,13447,2053,2075,2325,1689,8142
25,DRC,2020,DRC-20/HCG10/RA6/HLT/INGO/17976,6/1/2022 7:06:08 AM,Overall,3731,5223,2238,3731,14923,2202,2377,2451,1848,8878
25,DRC,2020,DRC-20/HCG10/RA6/NFI-EDU-PROT/INGO/17972,7/13/2022 10:01:26 AM,Host Communities,814,631,5350,2050,8845,955,927,3667,3543,9092
25,DRC,2020,DRC-20/HCG10/RA6/NFI-EDU-PROT/INGO/17972,7/13/2022 10:01:26 AM,Internally Displaced People,1067,908,3320,3256,8551,1522,1446,3446,3592,10006
25,DRC,2020,DRC-20/HCG10/RA6/NFI-EDU-PROT/INGO/17972,7/13/2022 10:01:26 AM,Overall,1885,1541,8689,5314,17429,2477,2373,7113,7135,19098
25,DRC,2020,DRC-20/HCG10/RA6/NFI-EDU-PROT/INGO/17972,7/13/2022 10:01:26 AM,Refugees,4,2,19,8,33,0,0,0,0,0
25,DRC,2020,DRC-20/HCG10/RA6/NFI-WaSH/INGO/17966,10/26/2022 2:19:53 PM,Host Communities,1323,1388,1347,1372,5430,358,361,0,0,719
25,DRC,2020,DRC-20/HCG10/RA6/NFI-WaSH/INGO/17966,10/26/2022 2:19:53 PM,Internally Displaced People,4835,4961,2245,2287,14328,3226,3249,0,0,6475
25,DRC,2020,DRC-20/HCG10/RA6/NFI-WaSH/INGO/17966,10/26/2022 2:19:53 PM,Overall,6158,6349,3592,3659,19758,3584,3610,0,0,7194
25,DRC,2020,DRC-20/HCG10/RA6/NUT-PROT/INGO/17981,3/25/2022 9:19:09 AM,Host Communities,1936,24488,2443,4065,32932,1742,22640,2263,3949,30594
25,DRC,2020,DRC-20/HCG10/RA6/NUT-PROT/INGO/17981,3/25/2022 9:19:09 AM,Internally Displaced People,829,10494,1047,1741,14111,814,9693,978,1456,12941
25,DRC,2020,DRC-20/HCG10/RA6/NUT-PROT/INGO/17981,3/25/2022 9:19:09 AM,Overall,2765,34982,3490,5806,47043,2556,32333,3241,5405,43535
25,DRC,2020,DRC-20/HCG10/RA6/WaSH/NGO/17969,4/26/2022 8:51:09 AM,Host Communities,5428,7058,10359,12630,35475,443,845,114,244,1646
25,DRC,2020,DRC-20/HCG10/RA6/WaSH/NGO/17969,4/26/2022 8:51:09 AM,Internally Displaced People,2109,2746,4029,4912,13796,1750,3190,677,1216,6833
25,DRC,2020,DRC-20/HCG10/RA6/WaSH/NGO/17969,4/26/2022 8:51:09 AM,Overall,7537,9804,14388,17542,49271,2193,4035,791,1460,8479
25,DRC,2020,DRC-20/HCG10/RA7/CASH/INGO/17989,6/1/2022 10:12:25 AM,Other,60,40,0,0,100,60,40,0,0,100
25,DRC,2020,DRC-20/HCG10/RA7/CASH/INGO/17989,6/1/2022 10:12:25 AM,Overall,60,40,0,0,100,60,40,0,0,100
25,DRC,2020,DRC-20/HCG10/RA7/EDU-PROT-HLT/INGO/17991,11/30/2022 8:58:35 AM,Other,149,149,0,0,298,199,69,0,0,268
25,DRC,2020,DRC-20/HCG10/RA7/EDU-PROT-HLT/INGO/17991,11/30/2022 8:58:35 AM,Overall,149,149,0,0,298,199,69,0,0,268
25,DRC,2020,DRC-20/HCG10/RA7/HLT/INGO/17988,5/10/2022 12:37:45 PM,Internally Displaced People,8,12,8,12,40,8,12,8,12,40
25,DRC,2020,DRC-20/HCG10/RA7/HLT/INGO/17988,5/10/2022 12:37:45 PM,Other,11,15,10,14,50,11,15,10,14,50
25,DRC,2020,DRC-20/HCG10/RA7/HLT/INGO/17988,5/10/2022 12:37:45 PM,Overall,19,27,18,26,90,19,27,18,26,90
25,DRC,2020,DRC-20/HCG10/RA7/NFI-FSEC/INGO/17985,5/28/2022 11:52:22 AM,Other,2,0,0,0,2,2,0,0,0,2
25,DRC,2020,DRC-20/HCG10/RA7/NFI-FSEC/INGO/17985,5/28/2022 11:52:22 AM,Overall,2,0,0,0,2,2,0,0,0,2
25,DRC,2020,DRC-20/HCG10/RA7/NFI-PROT/INGO/17990,12/19/2022 3:41:39 PM,Other,124,0,0,0,124,169,0,0,0,169
25,DRC,2020,DRC-20/HCG10/RA7/NFI-PROT/INGO/17990,12/19/2022 3:41:39 PM,Overall,124,0,0,0,124,169,0,0,0,169
25,DRC,2020,DRC-20/HCG10/RA7/NUT/INGO/17987,6/1/2022 11:57:45 AM,Other,57,0,0,0,57,63,1,0,0,64
25,DRC,2020,DRC-20/HCG10/RA7/NUT/INGO/17987,6/1/2022 11:57:45 AM,Overall,57,0,0,0,57,63,1,0,0,64
25,DRC,2020,DRC-20/HCG10/RA7/PROT/NGO/17986,4/14/2022 10:26:46 AM,Host Communities,52,52,0,0,104,66,34,0,0,100
25,DRC,2020,DRC-20/HCG10/RA7/PROT/NGO/17986,4/14/2022 10:26:46 AM,Overall,52,52,0,0,104,66,34,0,0,100
25,DRC,2020,DRC-20/HCG10/RA7/PROT/NGO/18000,3/30/2022 8:37:00 AM,Host Communities,15,20,0,0,35,15,20,0,0,35
25,DRC,2020,DRC-20/HCG10/RA7/PROT/NGO/18000,3/30/2022 8:37:00 AM,Overall,15,20,0,0,35,15,20,0,0,35
25,DRC,2020,DRC-20/HCG10/RA7/WaSH/INGO/17984,7/22/2022 12:55:28 PM,Other,100,0,0,0,100,100,0,0,0,100
25,DRC,2020,DRC-20/HCG10/RA7/WaSH/INGO/17984,7/22/2022 12:55:28 PM,Overall,100,0,0,0,100,100,0,0,0,100
25,DRC,2020,DRC-20/HCG10/SA1/EDU/NGO/16789,1/12/2022 1:31:46 PM,Host Communities,180,87,0,0,267,179,92,0,0,271
25,DRC,2020,DRC-20/HCG10/SA1/EDU/NGO/16789,1/12/2022 1:31:46 PM,Internally Displaced People,0,0,2512,2513,5025,0,0,2582,2572,5154
25,DRC,2020,DRC-20/HCG10/SA1/EDU/NGO/16789,1/12/2022 1:31:46 PM,Overall,180,87,5512,5513,11292,179,92,5913,5921,12105
25,DRC,2020,DRC-20/HCG10/SA1/EDU/NGO/16789,1/12/2022 1:31:46 PM,Returnees,0,0,3000,3000,6000,0,0,3331,3349,6680
25,DRC,2020,DRC-20/HCG10/SA1/EDU/NGO/16912,1/12/2022 12:25:20 PM,Host Communities,1120,1028,2391,1810,6349,1112,1202,2341,1922,6577
25,DRC,2020,DRC-20/HCG10/SA1/EDU/NGO/16912,1/12/2022 12:25:20 PM,Internally Displaced People,971,1032,3182,3311,8496,1018,1271,3205,3281,8775
25,DRC,2020,DRC-20/HCG10/SA1/EDU/NGO/16912,1/12/2022 12:25:20 PM,Overall,2996,2870,8924,8608,23398,3096,3295,9399,8976,24766
25,DRC,2020,DRC-20/HCG10/SA1/EDU/NGO/16912,1/12/2022 12:25:20 PM,Returnees,905,810,3351,3487,8553,966,822,3853,3773,9414
25,DRC,2020,DRC-20/HCG10/SA1/EDU-PROT/INGO/16680,10/26/2022 2:18:23 PM,Internally Displaced People,6908,7659,8100,8000,30667,4771,5157,7703,7650,25281
25,DRC,2020,DRC-20/HCG10/SA1/EDU-PROT/INGO/16680,10/26/2022 2:18:23 PM,Overall,6908,7659,8100,8000,30667,4771,5157,7703,7650,25281
25,DRC,2020,DRC-20/HCG10/SA1/FSEC/INGO/16675,6/9/2022 12:01:52 PM,Host Communities,633,1066,1505,1628,4832,786,1310,1852,2007,5955
25,DRC,2020,DRC-20/HCG10/SA1/FSEC/INGO/16675,6/9/2022 12:01:52 PM,Internally Displaced People,1101,877,1955,2119,6052,496,397,886,963,2742
25,DRC,2020,DRC-20/HCG10/SA1/FSEC/INGO/16675,6/9/2022 12:01:52 PM,Overall,2836,2820,5415,5865,16936,2779,2899,5394,5848,16920
25,DRC,2020,DRC-20/HCG10/SA1/FSEC/INGO/16675,6/9/2022 12:01:52 PM,Returnees,1102,877,1955,2118,6052,1497,1192,2656,2878,8223
25,DRC,2020,DRC-20/HCG10/SA1/FSEC/INGO/16775,1/19/2022 11:34:14 AM,Host Communities,4368,5256,6960,7416,24000,4368,5256,6960,7416,24000
25,DRC,2020,DRC-20/HCG10/SA1/FSEC/INGO/16775,1/19/2022 11:34:14 AM,Overall,4368,5256,6960,7416,24000,4368,5256,6960,7416,24000
25,DRC,2020,DRC-20/HCG10/SA1/FSEC/INGO/16867,2/13/2022 6:10:36 PM,Host Communities,1643,1817,2594,2595,8649,852,1044,1804,2188,5888
25,DRC,2020,DRC-20/HCG10/SA1/FSEC/INGO/16867,2/13/2022 6:10:36 PM,Internally Displaced People,493,545,778,779,2595,372,164,381,349,1266
25,DRC,2020,DRC-20/HCG10/SA1/FSEC/INGO/16867,2/13/2022 6:10:36 PM,Overall,3286,3633,5188,5190,17297,1843,1814,3388,3497,10542
25,DRC,2020,DRC-20/HCG10/SA1/FSEC/INGO/16867,2/13/2022 6:10:36 PM,Returnees,1150,1271,1816,1816,6053,619,606,1203,960,3388
25,DRC,2020,DRC-20/HCG10/SA1/FSEC/INGO/16966,7/11/2022 1:10:41 PM,Host Communities,1890,1980,2520,2610,9000,1890,1980,2520,2610,9000
25,DRC,2020,DRC-20/HCG10/SA1/FSEC/INGO/16966,7/11/2022 1:10:41 PM,Internally Displaced People,3150,3300,4200,4350,15000,3150,3300,4200,4350,15000
25,DRC,2020,DRC-20/HCG10/SA1/FSEC/INGO/16966,7/11/2022 1:10:41 PM,Other,378,396,504,522,1800,378,396,504,522,1800
25,DRC,2020,DRC-20/HCG10/SA1/FSEC/INGO/16966,7/11/2022 1:10:41 PM,Overall,6300,6600,8400,8700,30000,6300,6600,8400,8700,30000
25,DRC,2020,DRC-20/HCG10/SA1/FSEC/INGO/16966,7/11/2022 1:10:41 PM,Refugees,441,462,588,609,2100,441,462,588,609,2100
25,DRC,2020,DRC-20/HCG10/SA1/FSEC/INGO/16966,7/11/2022 1:10:41 PM,Returnees,441,462,588,609,2100,441,462,588,609,2100
25,DRC,2020,DRC-20/HCG10/SA1/FSEC/INGO/17005,4/6/2022 8:09:10 AM,Host Communities,1596,1764,2436,2604,8400,1294,1531,2723,2563,8111
25,DRC,2020,DRC-20/HCG10/SA1/FSEC/INGO/17005,4/6/2022 8:09:10 AM,Overall,1596,1764,2436,2604,8400,1294,1531,2723,2563,8111
25,DRC,2020,DRC-20/HCG10/SA1/FSEC/NGO/16794,4/21/2022 12:17:08 PM,Host Communities,1014,1775,2367,3296,8452,1730,1835,3674,3447,10686
25,DRC,2020,DRC-20/HCG10/SA1/FSEC/NGO/16794,4/21/2022 12:17:08 PM,Internally Displaced People,1304,2282,3043,4239,10868,2136,2316,3586,4126,12164
25,DRC,2020,DRC-20/HCG10/SA1/FSEC/NGO/16794,4/21/2022 12:17:08 PM,Overall,2898,5071,6762,9419,24150,5342,5701,8755,9551,29349
25,DRC,2020,DRC-20/HCG10/SA1/FSEC/NGO/16794,4/21/2022 12:17:08 PM,Returnees,580,1014,1352,1884,4830,1476,1550,1495,1978,6499
25,DRC,2020,DRC-20/HCG10/SA1/FSEC/NGO/16818,7/22/2022 1:20:18 PM,Host Communities,920,1017,1307,1598,4842,451,482,936,898,2767
25,DRC,2020,DRC-20/HCG10/SA1/FSEC/NGO/16818,7/22/2022 1:20:18 PM,Internally Displaced People,450,497,639,781,2367,356,349,766,663,2134
25,DRC,2020,DRC-20/HCG10/SA1/FSEC/NGO/16818,7/22/2022 1:20:18 PM,Other,1300,1437,1848,2259,6844,612,648,1074,1082,3416
25,DRC,2020,DRC-20/HCG10/SA1/FSEC/NGO/16818,7/22/2022 1:20:18 PM,Overall,3420,3780,4860,5940,18000,4853,5037,9873,9032,28795
25,DRC,2020,DRC-20/HCG10/SA1/FSEC/NGO/16818,7/22/2022 1:20:18 PM,Returnees,750,829,1066,1302,3947,3434,3558,7097,6389,20478
25,DRC,2020,DRC-20/HCG10/SA1/FSEC/NGO/16879,3/3/2022 1:55:02 PM,Host Communities,2489,3322,3501,3858,13170,3120,3733,5614,6116,18583
25,DRC,2020,DRC-20/HCG10/SA1/FSEC/NGO/16879,3/3/2022 1:55:02 PM,Overall,2489,3322,3501,3858,13170,3120,3733,5614,6116,18583
25,DRC,2020,DRC-20/HCG10/SA1/FSEC/NGO/16965,3/24/2022 11:52:41 AM,Host Communities,750,1125,1025,1600,4500,543,1839,955,1765,5102
25,DRC,2020,DRC-20/HCG10/SA1/FSEC/NGO/16965,3/24/2022 11:52:41 AM,Other,500,756,757,987,3000,65,98,25,16,204
25,DRC,2020,DRC-20/HCG10/SA1/FSEC/NGO/16965,3/24/2022 11:52:41 AM,Overall,2450,4001,3562,4987,15000,1953,5261,3093,4693,15000
25,DRC,2020,DRC-20/HCG10/SA1/FSEC/NGO/16965,3/24/2022 11:52:41 AM,Returnees,1200,2120,1780,2400,7500,1345,3324,2113,2912,9694
25,DRC,2020,DRC-20/HCG10/SA1/FSEC/UN/16837,2/21/2023 2:07:31 PM,Host Communities,2202,2893,551,1239,6885,1610,2419,1075,1614,6718
25,DRC,2020,DRC-20/HCG10/SA1/FSEC/UN/16837,2/21/2023 2:07:31 PM,Internally Displaced People,1450,1905,362,816,4533,1014,1512,672,1007,4205
25,DRC,2020,DRC-20/HCG10/SA1/FSEC/UN/16837,2/21/2023 2:07:31 PM,Other,269,353,69,153,844,405,604,269,407,1685
25,DRC,2020,DRC-20/HCG10/SA1/FSEC/UN/16837,2/21/2023 2:07:31 PM,Overall,5371,7056,1344,3024,16795,4029,6047,2688,4035,16799
25,DRC,2020,DRC-20/HCG10/SA1/FSEC/UN/16837,2/21/2023 2:07:31 PM,Returnees,1450,1905,362,816,4533,1000,1512,672,1007,4191
25,DRC,2020,DRC-20/HCG10/SA1/FSEC-NFI/INGO/16849,8/27/2021 12:21:50 PM,Host Communities,566,584,934,916,3000,475,508,634,647,2264
25,DRC,2020,DRC-20/HCG10/SA1/FSEC-NFI/INGO/16849,8/27/2021 12:21:50 PM,Internally Displaced People,566,584,934,916,3000,782,835,1043,1065,3725
25,DRC,2020,DRC-20/HCG10/SA1/FSEC-NFI/INGO/16849,8/27/2021 12:21:50 PM,Overall,2266,2334,3734,3666,12000,2856,3049,3808,3888,13601
25,DRC,2020,DRC-20/HCG10/SA1/FSEC-NFI/INGO/16849,8/27/2021 12:21:50 PM,Returnees,1134,1166,1866,1834,6000,1599,1706,2131,2176,7612
25,DRC,2020,DRC-20/HCG10/SA1/FSEC-PROT/INGO/16729,7/21/2022 9:43:41 AM,Host Communities,7356,7970,8079,13086,36491,2060,2352,5335,4512,14259
25,DRC,2020,DRC-20/HCG10/SA1/FSEC-PROT/INGO/16729,7/21/2022 9:43:41 AM,Internally Displaced People,22070,23909,24238,39258,109475,561,641,1453,1229,3884
25,DRC,2020,DRC-20/HCG10/SA1/FSEC-PROT/INGO/16729,7/21/2022 9:43:41 AM,Overall,36783,39849,40396,65430,182458,3339,3814,8649,7315,23117
25,DRC,2020,DRC-20/HCG10/SA1/FSEC-PROT/INGO/16729,7/21/2022 9:43:41 AM,Returnees,7357,7970,8079,13086,36492,718,821,1861,1574,4974
25,DRC,2020,DRC-20/HCG10/SA1/FSEC-PROT/NGO/16791,9/19/2022 8:34:17 AM,Host Communities,13041,16545,17683,15189,62458,13040,16593,17735,15233,62601
25,DRC,2020,DRC-20/HCG10/SA1/FSEC-PROT/NGO/16791,9/19/2022 8:34:17 AM,Internally Displaced People,3520,4880,5700,6900,21000,3562,3861,5699,6900,20022
25,DRC,2020,DRC-20/HCG10/SA1/FSEC-PROT/NGO/16791,9/19/2022 8:34:17 AM,Overall,17914,23856,26495,25885,94150,18855,22895,26545,25929,94224
25,DRC,2020,DRC-20/HCG10/SA1/FSEC-PROT/NGO/16791,9/19/2022 8:34:17 AM,Returnees,1353,2431,3112,3796,10692,2253,2441,3111,3796,11601
25,DRC,2020,DRC-20/HCG10/SA1/HLT/INGO/17009,12/6/2021 8:01:02 PM,Other,2709,2961,4015,4291,13976,109,6487,6429,7047,20072
25,DRC,2020,DRC-20/HCG10/SA1/HLT/INGO/17009,12/6/2021 8:01:02 PM,Overall,2709,2961,4015,4291,13976,109,6487,6429,7047,20072
25,DRC,2020,DRC-20/HCG10/SA1/HLT/NGO/16694,9/6/2021 9:24:09 AM,Host Communities,4744,6035,4937,5798,21514,4802,6298,4986,5501,21587
25,DRC,2020,DRC-20/HCG10/SA1/HLT/NGO/16694,9/6/2021 9:24:09 AM,Internally Displaced People,882,1122,1078,918,4000,1012,1262,1118,1048,4440
25,DRC,2020,DRC-20/HCG10/SA1/HLT/NGO/16694,9/6/2021 9:24:09 AM,Overall,5626,7157,6015,6716,25514,5814,7560,6104,6549,26027
25,DRC,2020,DRC-20/HCG10/SA1/HLT/UN/16973,2/21/2023 8:37:50 AM,Other,6525,7069,6024,6525,26143,14032,23891,12952,22054,72929
25,DRC,2020,DRC-20/HCG10/SA1/HLT/UN/16973,2/21/2023 8:37:50 AM,Overall,6525,7069,6024,6525,26143,14032,23891,12952,22054,72929
25,DRC,2020,DRC-20/HCG10/SA1/HLT-NUT/INGO/16779,4/18/2022 10:12:55 AM,Host Communities,22420,63674,45199,48069,179362,25778,88912,35722,35002,185414
25,DRC,2020,DRC-20/HCG10/SA1/HLT-NUT/INGO/16779,4/18/2022 10:12:55 AM,Internally Displaced People,4492,12756,9055,9630,35933,2891,9971,4006,3926,20794
25,DRC,2020,DRC-20/HCG10/SA1/HLT-NUT/INGO/16779,4/18/2022 10:12:55 AM,Overall,26912,76430,54254,57699,215295,28669,98883,39728,38928,206208
25,DRC,2020,DRC-20/HCG10/SA1/HLT-NUT/INGO/16860,3/8/2022 10:12:50 AM,Host Communities,53,3994,2825,3059,9931,81,1613,3104,3161,7959
25,DRC,2020,DRC-20/HCG10/SA1/HLT-NUT/INGO/16860,3/8/2022 10:12:50 AM,Internally Displaced People,6,464,327,355,1152,0,266,430,495,1191
25,DRC,2020,DRC-20/HCG10/SA1/HLT-NUT/INGO/16860,3/8/2022 10:12:50 AM,Overall,59,4458,3152,3414,11083,81,1879,3534,3656,9150
25,DRC,2020,DRC-20/HCG10/SA1/HLT-NUT-WaSH/INGO/16822,2/14/2022 11:16:24 AM,Host Communities,5898,8841,5441,8161,28341,6692,10031,6173,9259,32155
25,DRC,2020,DRC-20/HCG10/SA1/HLT-NUT-WaSH/INGO/16822,2/14/2022 11:16:24 AM,Internally Displaced People,11323,16975,10447,15669,54414,12847,19260,11853,17778,61738
25,DRC,2020,DRC-20/HCG10/SA1/HLT-NUT-WaSH/INGO/16822,2/14/2022 11:16:24 AM,Overall,22883,34312,21111,31664,109970,25963,38930,23952,35925,124770
25,DRC,2020,DRC-20/HCG10/SA1/HLT-NUT-WaSH/INGO/16822,2/14/2022 11:16:24 AM,Returnees,5662,8496,5223,7834,27215,6424,9639,5926,8888,30877
25,DRC,2020,DRC-20/HCG10/SA1/HLT-NUT-WaSH/INGO/17035,3/13/2022 2:09:21 PM,Host Communities,5674,6373,4836,5239,22122,5037,6633,5862,5254,22786
25,DRC,2020,DRC-20/HCG10/SA1/HLT-NUT-WaSH/INGO/17035,3/13/2022 2:09:21 PM,Internally Displaced People,7836,8801,6678,7235,30550,7232,8691,7214,6702,29839
25,DRC,2020,DRC-20/HCG10/SA1/HLT-NUT-WaSH/INGO/17035,3/13/2022 2:09:21 PM,Overall,13510,15174,11514,12474,52672,12269,15324,13076,11956,52625
25,DRC,2020,DRC-20/HCG10/SA1/HLT-PROT/UN/16855,2/21/2023 8:36:41 AM,Host Communities,66000,56000,68000,70000,260000,18240,56532,17010,34899,126681
25,DRC,2020,DRC-20/HCG10/SA1/HLT-PROT/UN/16855,2/21/2023 8:36:41 AM,Internally Displaced People,2000,1500,2000,2500,8000,510,1431,510,822,3273
25,DRC,2020,DRC-20/HCG10/SA1/HLT-PROT/UN/16855,2/21/2023 8:36:41 AM,Other,900,900,800,800,3400,225,714,210,411,1560
25,DRC,2020,DRC-20/HCG10/SA1/HLT-PROT/UN/16855,2/21/2023 8:36:41 AM,Overall,76688,64400,73800,76800,291688,21549,67257,22230,41058,152094
25,DRC,2020,DRC-20/HCG10/SA1/HLT-PROT/UN/16855,2/21/2023 8:36:41 AM,Returnees,7788,6000,3000,3500,20288,2574,8580,4500,4926,20580
25,DRC,2020,DRC-20/HCG10/SA1/NFI/INGO/16773,1/25/2022 2:52:20 PM,Host Communities,214,226,369,381,1190,600,573,1141,1326,3640
25,DRC,2020,DRC-20/HCG10/SA1/NFI/INGO/16773,1/25/2022 2:52:20 PM,Internally Displaced People,428,452,738,762,2380,237,235,465,526,1463
25,DRC,2020,DRC-20/HCG10/SA1/NFI/INGO/16773,1/25/2022 2:52:20 PM,Overall,856,904,1476,1524,4760,874,846,1647,1896,5263
25,DRC,2020,DRC-20/HCG10/SA1/NFI/INGO/16773,1/25/2022 2:52:20 PM,Returnees,214,226,369,381,1190,37,38,41,44,160
25,DRC,2020,DRC-20/HCG10/SA1/NFI/NGO/16724,8/3/2021 9:32:20 AM,Host Communities,89,164,856,1141,2250,43,181,739,858,1821
25,DRC,2020,DRC-20/HCG10/SA1/NFI/NGO/16724,8/3/2021 9:32:20 AM,Internally Displaced People,153,482,950,1006,2591,35,161,546,668,1410
25,DRC,2020,DRC-20/HCG10/SA1/NFI/NGO/16724,8/3/2021 9:32:20 AM,Overall,354,1225,3227,4074,8880,243,1237,3938,4768,10186
25,DRC,2020,DRC-20/HCG10/SA1/NFI/NGO/16724,8/3/2021 9:32:20 AM,Returnees,112,579,1421,1927,4039,165,895,2653,3242,6955
25,DRC,2020,DRC-20/HCG10/SA1/NFI/NGO/16752,1/5/2022 1:19:27 PM,Host Communities,375,473,358,424,1630,285,270,585,548,1688
25,DRC,2020,DRC-20/HCG10/SA1/NFI/NGO/16752,1/5/2022 1:19:27 PM,Internally Displaced People,3035,3827,2902,3431,13195,2534,2653,5863,5370,16420
25,DRC,2020,DRC-20/HCG10/SA1/NFI/NGO/16752,1/5/2022 1:19:27 PM,Overall,3410,4300,3260,3855,14825,2819,2923,6448,5918,18108
25,DRC,2020,DRC-20/HCG10/SA1/NFI/NGO/16905,8/4/2021 11:06:26 AM,Internally Displaced People,532,1752,285,509,3078,966,1758,120,243,3087
25,DRC,2020,DRC-20/HCG10/SA1/NFI/NGO/16905,8/4/2021 11:06:26 AM,Overall,532,1752,285,509,3078,966,1758,120,243,3087
25,DRC,2020,DRC-20/HCG10/SA1/NFI/NGO/16971,11/10/2021 10:21:03 AM,Host Communities,612,633,862,892,2999,12,11,23,17,63
25,DRC,2020,DRC-20/HCG10/SA1/NFI/NGO/16971,11/10/2021 10:21:03 AM,Internally Displaced People,919,949,1295,1338,4501,602,749,1353,1383,4087
25,DRC,2020,DRC-20/HCG10/SA1/NFI/NGO/16971,11/10/2021 10:21:03 AM,Overall,2041,2109,2877,2973,10000,1601,1908,3816,3636,10961
25,DRC,2020,DRC-20/HCG10/SA1/NFI/NGO/16971,11/10/2021 10:21:03 AM,Returnees,510,527,720,743,2500,987,1148,2440,2236,6811
25,DRC,2020,DRC-20/HCG10/SA1/NFI/NGO/16990,8/4/2021 10:31:57 AM,Host Communities,259,259,360,358,1236,0,0,0,0,0
25,DRC,2020,DRC-20/HCG10/SA1/NFI/NGO/16990,8/4/2021 10:31:57 AM,Internally Displaced People,519,519,718,716,2472,0,0,0,0,0
25,DRC,2020,DRC-20/HCG10/SA1/NFI/NGO/16990,8/4/2021 10:31:57 AM,Overall,1297,1297,1796,1790,6180,1714,1730,2360,2436,8240
25,DRC,2020,DRC-20/HCG10/SA1/NFI/NGO/16990,8/4/2021 10:31:57 AM,Returnees,519,519,718,716,2472,1714,1730,2360,2436,8240
25,DRC,2020,DRC-20/HCG10/SA1/NFI/NGO/16993,9/21/2021 8:55:07 AM,Host Communities,182,211,259,308,960,182,211,259,308,960
25,DRC,2020,DRC-20/HCG10/SA1/NFI/NGO/16993,9/21/2021 8:55:07 AM,Internally Displaced People,683,792,972,1153,3600,683,792,972,1153,3600
25,DRC,2020,DRC-20/HCG10/SA1/NFI/NGO/16993,9/21/2021 8:55:07 AM,Overall,1138,1320,1619,1923,6000,1138,1320,1619,1923,6000
25,DRC,2020,DRC-20/HCG10/SA1/NFI/NGO/16993,9/21/2021 8:55:07 AM,Returnees,273,317,388,462,1440,273,317,388,462,1440
25,DRC,2020,DRC-20/HCG10/SA1/NFI/NGO/16995,12/30/2021 11:03:32 AM,Host Communities,282,288,379,386,1335,124,209,117,153,603
25,DRC,2020,DRC-20/HCG10/SA1/NFI/NGO/16995,12/30/2021 11:03:32 AM,Internally Displaced People,1128,1153,1517,1544,5342,1215,1896,1326,1990,6427
25,DRC,2020,DRC-20/HCG10/SA1/NFI/NGO/16995,12/30/2021 11:03:32 AM,Overall,1410,1441,1896,1930,6677,1339,2105,1443,2143,7030
25,DRC,2020,DRC-20/HCG10/SA1/NFI-FSEC/NGO/16957,10/5/2021 2:35:51 PM,Host Communities,2126,2845,3682,4562,13215,2126,2845,3603,4188,12762
25,DRC,2020,DRC-20/HCG10/SA1/NFI-FSEC/NGO/16957,10/5/2021 2:35:51 PM,Internally Displaced People,339,593,1062,1544,3538,299,416,511,597,1823
25,DRC,2020,DRC-20/HCG10/SA1/NFI-FSEC/NGO/16957,10/5/2021 2:35:51 PM,Overall,2465,3438,4744,6106,16753,2425,3261,4114,4785,14585
25,DRC,2020,DRC-20/HCG10/SA1/NFI-PROT/NGO/16948,1/12/2022 9:53:40 AM,Host Communities,985,2024,7816,4631,15456,985,2024,7816,4631,15456
25,DRC,2020,DRC-20/HCG10/SA1/NFI-PROT/NGO/16948,1/12/2022 9:53:40 AM,Internally Displaced People,2700,6750,1350,2700,13500,2700,6750,1350,2700,13500
25,DRC,2020,DRC-20/HCG10/SA1/NFI-PROT/NGO/16948,1/12/2022 9:53:40 AM,Overall,6385,15524,10516,10031,42456,6385,15524,10516,10031,42456
25,DRC,2020,DRC-20/HCG10/SA1/NFI-PROT/NGO/16948,1/12/2022 9:53:40 AM,Returnees,2700,6750,1350,2700,13500,2700,6750,1350,2700,13500
25,DRC,2020,DRC-20/HCG10/SA1/NUT/INGO/16937,2/14/2022 10:24:27 AM,Host Communities,340,11200,3379,3577,18496,1145,11115,4825,5181,22266
25,DRC,2020,DRC-20/HCG10/SA1/NUT/INGO/16937,2/14/2022 10:24:27 AM,Overall,340,11200,3379,3577,18496,1145,11115,4825,5181,22266
25,DRC,2020,DRC-20/HCG10/SA1/NUT/INGO/16960,2/17/2022 10:45:30 AM,Host Communities,37072,42216,52910,61187,193385,43673,126723,51504,58163,280063
25,DRC,2020,DRC-20/HCG10/SA1/NUT/INGO/16960,2/17/2022 10:45:30 AM,Internally Displaced People,10608,12079,15139,17508,55334,15745,28738,18560,20227,83270
25,DRC,2020,DRC-20/HCG10/SA1/NUT/INGO/16960,2/17/2022 10:45:30 AM,Overall,47680,54295,68049,78695,248719,59418,155461,70064,78390,363333
25,DRC,2020,DRC-20/HCG10/SA1/NUT/INGO/17031,2/11/2022 12:34:21 PM,Host Communities,0,0,3233,3365,6598,0,0,2192,2573,4765
25,DRC,2020,DRC-20/HCG10/SA1/NUT/INGO/17031,2/11/2022 12:34:21 PM,Overall,0,0,3233,3365,6598,0,0,2192,2573,4765
25,DRC,2020,DRC-20/HCG10/SA1/NUT/UN/16959,3/4/2022 7:44:18 AM,Other,0,0,0,6,6,0,0,0,28,28
25,DRC,2020,DRC-20/HCG10/SA1/NUT/UN/16959,3/4/2022 7:44:18 AM,Overall,0,0,0,6,6,0,0,0,28,28
25,DRC,2020,DRC-20/HCG10/SA1/PROT/INGO/16667,11/23/2021 11:09:54 AM,Host Communities,1082,1743,1840,2441,7106,1671,2957,2480,4116,11224
25,DRC,2020,DRC-20/HCG10/SA1/PROT/INGO/16667,11/23/2021 11:09:54 AM,Overall,1139,1835,1937,2569,7480,1768,3083,2596,4869,12316
25,DRC,2020,DRC-20/HCG10/SA1/PROT/INGO/16667,11/23/2021 11:09:54 AM,Returnees,57,92,97,128,374,97,126,116,753,1092
25,DRC,2020,DRC-20/HCG10/SA1/PROT/INGO/16719,6/1/2022 8:35:25 AM,Host Communities,650,500,1650,1550,4350,797,1025,1119,632,3573
25,DRC,2020,DRC-20/HCG10/SA1/PROT/INGO/16719,6/1/2022 8:35:25 AM,Overall,650,500,1650,1550,4350,797,1025,1119,632,3573
25,DRC,2020,DRC-20/HCG10/SA1/PROT/INGO/16911,6/3/2022 7:03:07 AM,Host Communities,536,536,1041,1040,3153,497,53,1338,1216,3104
25,DRC,2020,DRC-20/HCG10/SA1/PROT/INGO/16911,6/3/2022 7:03:07 AM,Internally Displaced People,330,330,1222,1223,3105,483,51,1301,1181,3016
25,DRC,2020,DRC-20/HCG10/SA1/PROT/INGO/16911,6/3/2022 7:03:07 AM,Overall,1191,1191,3486,3486,9354,1464,155,3938,3577,9134
25,DRC,2020,DRC-20/HCG10/SA1/PROT/INGO/16911,6/3/2022 7:03:07 AM,Returnees,325,325,1223,1223,3096,484,51,1299,1180,3014
25,DRC,2020,DRC-20/HCG10/SA1/PROT/INGO/16920,2/10/2022 2:53:53 PM,Host Communities,297,1769,8,2168,4242,498,1322,225,1746,3791
25,DRC,2020,DRC-20/HCG10/SA1/PROT/INGO/16920,2/10/2022 2:53:53 PM,Overall,297,1769,8,2168,4242,498,1322,225,1746,3791
25,DRC,2020,DRC-20/HCG10/SA1/PROT/INGO/16985,12/6/2021 8:04:47 PM,Host Communities,920,920,2220,2200,6260,3222,3055,8517,5778,20572
25,DRC,2020,DRC-20/HCG10/SA1/PROT/INGO/16985,12/6/2021 8:04:47 PM,Internally Displaced People,1379,1379,3330,3300,9388,4244,3993,9901,6666,24804
25,DRC,2020,DRC-20/HCG10/SA1/PROT/INGO/16985,12/6/2021 8:04:47 PM,Overall,2299,2299,5550,5500,15648,7466,7048,18418,12444,45376
25,DRC,2020,DRC-20/HCG10/SA1/PROT/INGO/17012,11/10/2021 7:32:48 AM,Other,32,80,821,438,1371,11,90,754,382,1237
25,DRC,2020,DRC-20/HCG10/SA1/PROT/INGO/17012,11/10/2021 7:32:48 AM,Overall,32,80,821,438,1371,11,90,754,382,1237
25,DRC,2020,DRC-20/HCG10/SA1/PROT/INGO/17044,1/27/2022 3:26:51 PM,Host Communities,425,580,201,487,1693,425,580,201,487,1693
25,DRC,2020,DRC-20/HCG10/SA1/PROT/INGO/17044,1/27/2022 3:26:51 PM,Internally Displaced People,275,1132,453,470,2330,275,1132,453,470,2330
25,DRC,2020,DRC-20/HCG10/SA1/PROT/INGO/17044,1/27/2022 3:26:51 PM,Overall,914,2564,1006,1322,5806,914,2564,1006,1322,5806
25,DRC,2020,DRC-20/HCG10/SA1/PROT/INGO/17044,1/27/2022 3:26:51 PM,Returnees,214,852,352,365,1783,214,852,352,365,1783
25,DRC,2020,DRC-20/HCG10/SA1/PROT/NGO/16769,11/7/2022 10:28:06 AM,Other,2187,3437,187,439,6250,2187,2961,594,508,6250
25,DRC,2020,DRC-20/HCG10/SA1/PROT/NGO/16769,11/7/2022 10:28:06 AM,Overall,2187,3437,187,439,6250,2187,2961,594,508,6250
25,DRC,2020,DRC-20/HCG10/SA1/PROT/NGO/16896,12/6/2021 8:13:24 AM,Host Communities,2,82,5,177,266,0,242,2,326,570
25,DRC,2020,DRC-20/HCG10/SA1/PROT/NGO/16896,12/6/2021 8:13:24 AM,Internally Displaced People,1,17,4,41,63,0,0,0,0,0
25,DRC,2020,DRC-20/HCG10/SA1/PROT/NGO/16896,12/6/2021 8:13:24 AM,Other,1,10,2,27,40,0,0,0,0,0
25,DRC,2020,DRC-20/HCG10/SA1/PROT/NGO/16896,12/6/2021 8:13:24 AM,Overall,11,309,19,545,884,0,478,2,667,1147
25,DRC,2020,DRC-20/HCG10/SA1/PROT/NGO/16896,12/6/2021 8:13:24 AM,Returnees,7,200,8,300,515,0,236,0,341,577
25,DRC,2020,DRC-20/HCG10/SA1/PROT/UN/16854,3/10/2022 7:13:51 AM,Host Communities,831,858,1208,1171,4068,3196,4705,3134,2937,13972
25,DRC,2020,DRC-20/HCG10/SA1/PROT/UN/16854,3/10/2022 7:13:51 AM,Internally Displaced People,340,351,494,477,1662,643,944,629,589,2805
25,DRC,2020,DRC-20/HCG10/SA1/PROT/UN/16854,3/10/2022 7:13:51 AM,Overall,3080,3182,4478,4338,15078,5613,7481,6341,6022,25457
25,DRC,2020,DRC-20/HCG10/SA1/PROT/UN/16854,3/10/2022 7:13:51 AM,Refugees,859,888,1249,1211,4207,0,0,0,0,0
25,DRC,2020,DRC-20/HCG10/SA1/PROT/UN/16854,3/10/2022 7:13:51 AM,Returnees,1050,1085,1527,1479,5141,1774,1832,2578,2496,8680
25,DRC,2020,DRC-20/HCG10/SA1/PROT-NFI/INGO/16852,3/9/2022 8:11:41 AM,Host Communities,1175,1050,1225,1203,4653,1175,1050,1225,1203,4653
25,DRC,2020,DRC-20/HCG10/SA1/PROT-NFI/INGO/16852,3/9/2022 8:11:41 AM,Internally Displaced People,9428,17079,25463,26096,78066,7071,15622,21977,22768,67438
25,DRC,2020,DRC-20/HCG10/SA1/PROT-NFI/INGO/16852,3/9/2022 8:11:41 AM,Overall,10603,18129,26688,27299,82719,8246,16672,23202,23971,72091
25,DRC,2020,DRC-20/HCG10/SA1/PROT-NUT/INGO/16793,2/14/2022 12:29:33 PM,Host Communities,1640,2319,3577,4778,12314,1968,2783,4292,5734,14777
25,DRC,2020,DRC-20/HCG10/SA1/PROT-NUT/INGO/16793,2/14/2022 12:29:33 PM,Internally Displaced People,1414,1529,1890,2103,6936,1697,1835,2268,2524,8324
25,DRC,2020,DRC-20/HCG10/SA1/PROT-NUT/INGO/16793,2/14/2022 12:29:33 PM,Other,1,9,9,24,43,1,11,11,29,52
25,DRC,2020,DRC-20/HCG10/SA1/PROT-NUT/INGO/16793,2/14/2022 12:29:33 PM,Overall,3403,4169,5676,7105,20353,4084,5900,8143,10036,28163
25,DRC,2020,DRC-20/HCG10/SA1/PROT-NUT/INGO/16793,2/14/2022 12:29:33 PM,Refugees,348,312,200,200,1060,418,1271,1572,1749,5010
25,DRC,2020,DRC-20/HCG10/SA1/WaSH/INGO/16824,11/23/2021 1:47:15 PM,Host Communities,13600,19200,21600,25600,80000,23061,32557,36627,43409,135654
25,DRC,2020,DRC-20/HCG10/SA1/WaSH/INGO/16824,11/23/2021 1:47:15 PM,Overall,13600,19200,21600,25600,80000,23061,32557,36627,43409,135654
25,DRC,2020,DRC-20/HCG10/SA1/WaSH/INGO/17024,1/31/2022 3:32:06 PM,Other,5590,16700,10379,10827,43496,5590,16700,10379,10827,43496
25,DRC,2020,DRC-20/HCG10/SA1/WaSH/INGO/17024,1/31/2022 3:32:06 PM,Overall,5590,16700,10379,10827,43496,5590,16700,10379,10827,43496
25,DRC,2020,DRC-20/HCG10/SA1/WaSH/NGO/16692,2/10/2022 8:19:50 AM,Host Communities,7569,5938,5938,4300,23745,7769,6342,6012,5011,25134
25,DRC,2020,DRC-20/HCG10/SA1/WaSH/NGO/16692,2/10/2022 8:19:50 AM,Internally Displaced People,1262,914,914,662,3752,1161,887,1064,849,3961
25,DRC,2020,DRC-20/HCG10/SA1/WaSH/NGO/16692,2/10/2022 8:19:50 AM,Other,1009,731,731,529,3000,1079,902,673,813,3467
25,DRC,2020,DRC-20/HCG10/SA1/WaSH/NGO/16692,2/10/2022 8:19:50 AM,Overall,11985,9136,9136,6616,36873,12025,9653,9193,7821,38692
25,DRC,2020,DRC-20/HCG10/SA1/WaSH/NGO/16692,2/10/2022 8:19:50 AM,Returnees,2145,1553,1553,1125,6376,2016,1522,1444,1148,6130
25,DRC,2020,DRC-20/HCG10/SA1/WaSH/NGO/16706,12/30/2021 11:48:58 AM,Host Communities,723,804,342,514,2383,723,804,342,514,2383
25,DRC,2020,DRC-20/HCG10/SA1/WaSH/NGO/16706,12/30/2021 11:48:58 AM,Internally Displaced People,221,386,104,192,903,221,386,104,192,903
25,DRC,2020,DRC-20/HCG10/SA1/WaSH/NGO/16706,12/30/2021 11:48:58 AM,Overall,1070,1494,634,914,4112,1070,1494,634,914,4112
25,DRC,2020,DRC-20/HCG10/SA1/WaSH/NGO/16706,12/30/2021 11:48:58 AM,Returnees,126,304,188,208,826,126,304,188,208,826
25,DRC,2020,DRC-20/HCG10/SA1/WaSH/NGO/16743,11/8/2021 8:02:33 AM,Host Communities,2623,2755,3804,3935,13117,2359,2617,5604,6014,16594
25,DRC,2020,DRC-20/HCG10/SA1/WaSH/NGO/16743,11/8/2021 8:02:33 AM,Internally Displaced People,3180,3339,4611,4770,15900,1646,1897,3738,4163,11444
25,DRC,2020,DRC-20/HCG10/SA1/WaSH/NGO/16743,11/8/2021 8:02:33 AM,Overall,7950,8348,11527,11925,39750,6025,7029,13304,14735,41093
25,DRC,2020,DRC-20/HCG10/SA1/WaSH/NGO/16743,11/8/2021 8:02:33 AM,Returnees,2147,2254,3112,3220,10733,2020,2515,3962,4558,13055
25,DRC,2020,DRC-20/HCG10/SA1/WaSH/NGO/16766,3/30/2022 8:38:05 AM,Host Communities,5963,6209,10333,10752,33257,14772,15202,25295,26772,82041
25,DRC,2020,DRC-20/HCG10/SA1/WaSH/NGO/16766,3/30/2022 8:38:05 AM,Internally Displaced People,1278,1331,2214,2304,7127,3166,3298,5486,5709,17659
25,DRC,2020,DRC-20/HCG10/SA1/WaSH/NGO/16766,3/30/2022 8:38:05 AM,Overall,8424,8771,14597,15188,46980,20869,21550,35860,37763,116042
25,DRC,2020,DRC-20/HCG10/SA1/WaSH/NGO/16766,3/30/2022 8:38:05 AM,Returnees,1183,1231,2050,2132,6596,2931,3050,5079,5282,16342
25,DRC,2020,DRC-20/HCG10/SA1/WaSH/NGO/16859,4/26/2022 11:52:53 AM,Host Communities,284,332,433,426,1475,284,332,433,426,1475
25,DRC,2020,DRC-20/HCG10/SA1/WaSH/NGO/16859,4/26/2022 11:52:53 AM,Internally Displaced People,284,332,433,426,1475,284,332,433,426,1475
25,DRC,2020,DRC-20/HCG10/SA1/WaSH/NGO/16859,4/26/2022 11:52:53 AM,Other,190,220,293,283,986,190,220,293,283,986
25,DRC,2020,DRC-20/HCG10/SA1/WaSH/NGO/16859,4/26/2022 11:52:53 AM,Overall,1888,2210,2884,2828,9810,1888,2210,2884,2828,9810
25,DRC,2020,DRC-20/HCG10/SA1/WaSH/NGO/16859,4/26/2022 11:52:53 AM,Returnees,1130,1326,1725,1693,5874,1130,1326,1725,1693,5874
25,DRC,2020,DRC-20/HCG10/SA1/WaSH-FSEC/NGO/16862,1/25/2022 10:11:54 AM,Host Communities,1895,2564,3122,3568,11149,2478,3352,4082,4665,14577
25,DRC,2020,DRC-20/HCG10/SA1/WaSH-FSEC/NGO/16862,1/25/2022 10:11:54 AM,Internally Displaced People,3475,4701,5724,6541,20441,4543,6147,7483,8552,26725
25,DRC,2020,DRC-20/HCG10/SA1/WaSH-FSEC/NGO/16862,1/25/2022 10:11:54 AM,Overall,6318,8547,10408,11893,37166,8260,11175,13606,15549,48590
25,DRC,2020,DRC-20/HCG10/SA1/WaSH-FSEC/NGO/16862,1/25/2022 10:11:54 AM,Returnees,948,1282,1562,1784,5576,1239,1676,2041,2332,7288
25,DRC,2020,DRC-20/HCG10/SA1/WaSH-NFI/INGO/16997,2/10/2022 2:23:27 PM,Host Communities,1111,1604,1766,1769,6250,1111,1604,1766,1769,6250
25,DRC,2020,DRC-20/HCG10/SA1/WaSH-NFI/INGO/16997,2/10/2022 2:23:27 PM,Internally Displaced People,5950,9100,9800,10150,35000,5950,9100,9800,10150,35000
25,DRC,2020,DRC-20/HCG10/SA1/WaSH-NFI/INGO/16997,2/10/2022 2:23:27 PM,Overall,9399,14279,15416,15906,55000,9399,14279,15416,15906,55000
25,DRC,2020,DRC-20/HCG10/SA1/WaSH-NFI/INGO/16997,2/10/2022 2:23:27 PM,Returnees,2338,3575,3850,3987,13750,2338,3575,3850,3987,13750
25,DRC,2020,DRC-20/HCG10/SA1/WaSH-NFI/NGO/16888,12/30/2021 12:00:07 PM,Host Communities,19640,20299,23147,24434,87520,20974,24931,28757,31430,106092
25,DRC,2020,DRC-20/HCG10/SA1/WaSH-NFI/NGO/16888,12/30/2021 12:00:07 PM,Internally Displaced People,8418,8727,9920,10242,37307,4989,4818,5800,6201,21808
25,DRC,2020,DRC-20/HCG10/SA1/WaSH-NFI/NGO/16888,12/30/2021 12:00:07 PM,Overall,28058,29026,33067,34676,124827,25963,29749,34557,37631,127900
25,DRC,2020,DRC-20/HCG10/SA1/WaSH-PROT/UN/16841,2/14/2022 12:37:38 PM,Host Communities,386,418,579,627,2010,448,498,698,847,2491
25,DRC,2020,DRC-20/HCG10/SA1/WaSH-PROT/UN/16841,2/14/2022 12:37:38 PM,Internally Displaced People,1158,1254,1737,1882,6031,1787,2088,2958,4028,10861
25,DRC,2020,DRC-20/HCG10/SA1/WaSH-PROT/UN/16841,2/14/2022 12:37:38 PM,Other,4000,4000,4542,4248,16790,2763,2301,6450,6993,18507
25,DRC,2020,DRC-20/HCG10/SA1/WaSH-PROT/UN/16841,2/14/2022 12:37:38 PM,Overall,7860,8181,10332,10520,36893,7211,7284,13426,15463,43384
25,DRC,2020,DRC-20/HCG10/SA1/WaSH-PROT/UN/16841,2/14/2022 12:37:38 PM,Returnees,2316,2509,3474,3763,12062,2213,2397,3320,3595,11525
25,DRC,2021,DRC-21/HCG10/AR5/LOG/NGO/21172,5/9/2023 11:54:41 AM,Internally Displaced People,4027,5477,2578,4028,16110,12863,16978,12862,8748,51451
25,DRC,2021,DRC-21/HCG10/AR5/LOG/NGO/21172,5/9/2023 11:54:41 AM,Overall,4027,5477,2578,4028,16110,12863,16978,12862,8748,51451
25,DRC,2021,DRC-21/HCG10/AR5/LOG/NGO/21239,6/19/2023 9:42:20 AM,Host Communities,1244,1684,2049,2342,7319,2484,3360,4091,4675,14610
25,DRC,2021,DRC-21/HCG10/AR5/LOG/NGO/21239,6/19/2023 9:42:20 AM,Internally Displaced People,4145,5607,6826,7801,24379,4145,5607,6826,7801,24379
25,DRC,2021,DRC-21/HCG10/AR5/LOG/NGO/21239,6/19/2023 9:42:20 AM,Overall,5668,7566,9231,10833,33298,6908,9242,11273,13166,40589
25,DRC,2021,DRC-21/HCG10/AR5/LOG/NGO/21239,6/19/2023 9:42:20 AM,Refugees,234,123,132,345,834,234,123,132,345,834
25,DRC,2021,DRC-21/HCG10/AR5/LOG/NGO/21239,6/19/2023 9:42:20 AM,Returnees,45,152,224,345,766,45,152,224,345,766
25,DRC,2021,DRC-21/HCG10/AS2/CASH/INGO/21161,3/1/2023 11:45:43 AM,Host Communities,639,755,784,726,2904,140,190,313,278,921
25,DRC,2021,DRC-21/HCG10/AS2/CASH/INGO/21161,3/1/2023 11:45:43 AM,Internally Displaced People,2059,2265,2986,2986,10296,2027,2424,3944,3921,12316
25,DRC,2021,DRC-21/HCG10/AS2/CASH/INGO/21161,3/1/2023 11:45:43 AM,Overall,2698,3020,3770,3712,13200,2167,2614,4257,4199,13237
25,DRC,2021,DRC-21/HCG10/AS2/CASH/INGO/21202,2/28/2023 8:30:52 AM,Host Communities,523,578,825,825,2751,959,2053,718,781,4511
25,DRC,2021,DRC-21/HCG10/AS2/CASH/INGO/21202,2/28/2023 8:30:52 AM,Internally Displaced People,1568,1733,2476,2476,8253,2633,5134,2633,2765,13165
25,DRC,2021,DRC-21/HCG10/AS2/CASH/INGO/21202,2/28/2023 8:30:52 AM,Overall,2614,2889,4126,4126,13755,4033,7889,4069,4263,20254
25,DRC,2021,DRC-21/HCG10/AS2/CASH/INGO/21202,2/28/2023 8:30:52 AM,Returnees,523,578,825,825,2751,441,702,718,717,2578
25,DRC,2021,DRC-21/HCG10/AS2/CASH/INGO/21232,3/23/2023 7:35:49 AM,Host Communities,563,687,906,969,3125,1285,1072,2226,2182,6765
25,DRC,2021,DRC-21/HCG10/AS2/CASH/INGO/21232,3/23/2023 7:35:49 AM,Overall,2251,2749,3625,3875,12500,2342,2673,2862,2792,10669
25,DRC,2021,DRC-21/HCG10/AS2/CASH/INGO/21232,3/23/2023 7:35:49 AM,Returnees,1688,2062,2719,2906,9375,1057,1601,636,610,3904
25,DRC,2021,DRC-21/HCG10/AS2/CASH/INGO/21274,2/23/2023 10:00:35 AM,Host Communities,7199,7492,10147,10562,35400,1122,1381,1926,1607,6036
25,DRC,2021,DRC-21/HCG10/AS2/CASH/INGO/21274,2/23/2023 10:00:35 AM,Internally Displaced People,5399,5619,7611,7921,26550,1987,2733,3928,3084,11732
25,DRC,2021,DRC-21/HCG10/AS2/CASH/INGO/21274,2/23/2023 10:00:35 AM,Overall,17997,18730,25369,26404,88500,3255,4337,6138,4945,18675
25,DRC,2021,DRC-21/HCG10/AS2/CASH/INGO/21274,2/23/2023 10:00:35 AM,Returnees,5399,5619,7611,7921,26550,146,223,284,254,907
25,DRC,2021,DRC-21/HCG10/AS2/CASH/INGO/21284,1/10/2023 12:16:46 PM,Host Communities,944,1043,1440,1539,4966,760,884,1810,1731,5185
25,DRC,2021,DRC-21/HCG10/AS2/CASH/INGO/21284,1/10/2023 12:16:46 PM,Internally Displaced People,6290,6952,9600,10262,33104,4835,6055,11548,11102,33540
25,DRC,2021,DRC-21/HCG10/AS2/CASH/INGO/21284,1/10/2023 12:16:46 PM,Overall,7234,7995,11040,11801,38070,5595,6939,13358,12833,38725
25,DRC,2021,DRC-21/HCG10/AS2/CASH/NGO/21113,2/28/2023 7:09:33 AM,Host Communities,60,140,360,440,1000,284,314,575,725,1898
25,DRC,2021,DRC-21/HCG10/AS2/CASH/NGO/21113,2/28/2023 7:09:33 AM,Internally Displaced People,390,910,2340,2860,6500,1553,1994,3921,4548,12016
25,DRC,2021,DRC-21/HCG10/AS2/CASH/NGO/21113,2/28/2023 7:09:33 AM,Overall,450,1050,2700,3300,7500,1837,2308,4496,5273,13914
25,DRC,2021,DRC-21/HCG10/AS2/CASH/NGO/21252,1/10/2023 1:22:37 PM,Host Communities,375,473,608,644,2100,380,512,688,780,2360
25,DRC,2021,DRC-21/HCG10/AS2/CASH/NGO/21252,1/10/2023 1:22:37 PM,Internally Displaced People,935,1427,2602,3436,8400,950,1811,2889,3399,9049
25,DRC,2021,DRC-21/HCG10/AS2/CASH/NGO/21252,1/10/2023 1:22:37 PM,Overall,1310,1900,3210,4080,10500,1330,2323,3577,4179,11409
25,DRC,2021,DRC-21/HCG10/AS2/CASH/NGO/21280,1/16/2023 9:12:31 AM,Host Communities,598,647,896,971,3112,723,847,456,782,2808
25,DRC,2021,DRC-21/HCG10/AS2/CASH/NGO/21280,1/16/2023 9:12:31 AM,Internally Displaced People,418,454,628,680,2180,399,647,412,568,2026
25,DRC,2021,DRC-21/HCG10/AS2/CASH/NGO/21280,1/16/2023 9:12:31 AM,Overall,1195,1295,1793,1942,6225,1334,1737,965,1467,5503
25,DRC,2021,DRC-21/HCG10/AS2/CASH/NGO/21280,1/16/2023 9:12:31 AM,Returnees,179,194,269,291,933,212,243,97,117,669
25,DRC,2021,DRC-21/HCG10/AS2/CASH/NGO/21319,2/10/2023 7:07:43 AM,Host Communities,441,483,568,610,2102,655,1097,1108,1648,4508
25,DRC,2021,DRC-21/HCG10/AS2/CASH/NGO/21319,2/10/2023 7:07:43 AM,Internally Displaced People,2010,2202,2585,2776,9573,3362,3469,3208,3881,13920
25,DRC,2021,DRC-21/HCG10/AS2/CASH/NGO/21319,2/10/2023 7:07:43 AM,Overall,2451,2685,3153,3386,11675,4017,4566,4316,5529,18428
25,DRC,2021,DRC-21/HCG10/AS2/CASH/UN/21249,3/6/2023 9:09:21 AM,Host Communities,810,893,1335,1403,4441,842,877,1211,1163,4093
25,DRC,2021,DRC-21/HCG10/AS2/CASH/UN/21249,3/6/2023 9:09:21 AM,Internally Displaced People,3239,3571,5339,5610,17759,3610,3759,5189,4986,17544
25,DRC,2021,DRC-21/HCG10/AS2/CASH/UN/21249,3/6/2023 9:09:21 AM,Overall,4049,4464,6674,7013,22200,4452,4636,6400,6149,21637
25,DRC,2021,DRC-21/HCG10/AS2/CASH-CP/INGO/21163,9/6/2023 11:19:27 AM,Host Communities,1325,2577,361,353,4616,413,597,992,1150,3152
25,DRC,2021,DRC-21/HCG10/AS2/CASH-CP/INGO/21163,9/6/2023 11:19:27 AM,Internally Displaced People,5300,10308,1446,1410,18464,3210,4143,5525,6956,19834
25,DRC,2021,DRC-21/HCG10/AS2/CASH-CP/INGO/21163,9/6/2023 11:19:27 AM,Overall,6625,12885,1807,1763,23080,3623,4740,6517,8106,22986
25,DRC,2021,DRC-21/HCG10/AS2/CP/NGO/21288,3/6/2023 9:31:47 AM,Host Communities,0,0,160,90,250,0,0,108,42,150
25,DRC,2021,DRC-21/HCG10/AS2/CP/NGO/21288,3/6/2023 9:31:47 AM,Internally Displaced People,1260,2450,750,870,5330,630,1225,375,435,2665
25,DRC,2021,DRC-21/HCG10/AS2/CP/NGO/21288,3/6/2023 9:31:47 AM,Overall,1260,2450,910,960,5580,630,1225,483,477,2815
25,DRC,2021,DRC-21/HCG10/AS2/CP/NGO/21293,3/1/2023 7:06:17 AM,Host Communities,1200,920,920,960,4000,1107,1151,979,1022,4259
25,DRC,2021,DRC-21/HCG10/AS2/CP/NGO/21293,3/1/2023 7:06:17 AM,Internally Displaced People,900,690,690,720,3000,830,863,735,767,3195
25,DRC,2021,DRC-21/HCG10/AS2/CP/NGO/21293,3/1/2023 7:06:17 AM,Overall,3000,2300,2300,2400,10000,2767,2877,2448,2556,10648
25,DRC,2021,DRC-21/HCG10/AS2/CP/NGO/21293,3/1/2023 7:06:17 AM,Returnees,900,690,690,720,3000,830,863,734,767,3194
25,DRC,2021,DRC-21/HCG10/AS2/GBV/INGO/21108,5/26/2023 8:48:54 AM,Internally Displaced People,1130,1694,752,1129,4705,2279,3421,1184,1635,8519
25,DRC,2021,DRC-21/HCG10/AS2/GBV/INGO/21108,5/26/2023 8:48:54 AM,Overall,1130,1694,752,1129,4705,2279,3421,1184,1635,8519
25,DRC,2021,DRC-21/HCG10/AS2/GBV/NGO/21221,7/24/2023 5:11:03 AM,Host Communities,89,1030,122,662,1903,89,1030,122,662,1903
25,DRC,2021,DRC-21/HCG10/AS2/GBV/NGO/21221,7/24/2023 5:11:03 AM,Internally Displaced People,134,1546,182,994,2856,134,1546,182,994,2856
25,DRC,2021,DRC-21/HCG10/AS2/GBV/NGO/21221,7/24/2023 5:11:03 AM,Overall,223,2576,304,1656,4759,223,2576,304,1656,4759
25,DRC,2021,DRC-21/HCG10/RA1/COORD/UN/18274,7/17/2023 2:32:56 PM,Host Communities,46485,193297,105669,152060,497511,46485,193297,105669,152060,497511
25,DRC,2021,DRC-21/HCG10/RA1/COORD/UN/18274,7/17/2023 2:32:56 PM,Internally Displaced People,6020,29365,16053,23101,74539,6020,29365,16053,23101,74539
25,DRC,2021,DRC-21/HCG10/RA1/COORD/UN/18274,7/17/2023 2:32:56 PM,Overall,53489,227462,124346,178937,584234,53489,227462,124346,178937,584234
25,DRC,2021,DRC-21/HCG10/RA1/COORD/UN/18274,7/17/2023 2:32:56 PM,Returnees,984,4800,2624,3776,12184,984,4800,2624,3776,12184
25,DRC,2021,DRC-21/HCG10/RA2/CP/INGO/19580,7/21/2022 6:53:57 AM,Host Communities,1065,1054,1957,2202,6278,1080,1234,1672,1897,5883
25,DRC,2021,DRC-21/HCG10/RA2/CP/INGO/19580,7/21/2022 6:53:57 AM,Internally Displaced People,304,301,559,629,1793,312,340,654,723,2029
25,DRC,2021,DRC-21/HCG10/RA2/CP/INGO/19580,7/21/2022 6:53:57 AM,Overall,1521,1506,2796,3146,8969,1514,1831,2607,2922,8874
25,DRC,2021,DRC-21/HCG10/RA2/CP/INGO/19580,7/21/2022 6:53:57 AM,Returnees,152,151,280,315,898,122,257,281,302,962
25,DRC,2021,DRC-21/HCG10/RA2/GBV-HLT/UN/19532,4/5/2022 11:42:52 AM,Host Communities,4393,4540,6391,6188,21512,1321,13718,589,1050,16678
25,DRC,2021,DRC-21/HCG10/RA2/GBV-HLT/UN/19532,4/5/2022 11:42:52 AM,Internally Displaced People,3944,4073,5733,5554,19304,1985,6276,1355,2815,12431
25,DRC,2021,DRC-21/HCG10/RA2/GBV-HLT/UN/19532,4/5/2022 11:42:52 AM,Overall,11563,11946,16815,16286,56610,4925,25346,2786,5767,38824
25,DRC,2021,DRC-21/HCG10/RA2/GBV-HLT/UN/19532,4/5/2022 11:42:52 AM,Returnees,3226,3333,4691,4544,15794,1619,5352,842,1902,9715
25,DRC,2021,DRC-21/HCG10/RA2/NFI/INGO/19461,7/19/2022 7:53:23 AM,Internally Displaced People,3339,3498,4452,4611,15900,3426,3881,5162,5089,17558
25,DRC,2021,DRC-21/HCG10/RA2/NFI/INGO/19461,7/19/2022 7:53:23 AM,Overall,3339,3498,4452,4611,15900,3426,3881,5162,5089,17558
25,DRC,2021,DRC-21/HCG10/RA2/NFI/UN/19582,9/8/2023 11:12:12 AM,Overall,2816,2930,4223,4396,14365,2809,2923,4212,4386,14330
25,DRC,2021,DRC-21/HCG10/RA2/NFI/UN/19582,9/8/2023 11:12:12 AM,Returnees,2816,2930,4223,4396,14365,2809,2923,4212,4386,14330
25,DRC,2021,DRC-21/HCG10/RA2/NUT/UN/19632,3/11/2022 11:56:25 AM,Other,123,139,0,0,262,138,124,0,0,262
25,DRC,2021,DRC-21/HCG10/RA2/NUT/UN/19632,3/11/2022 11:56:25 AM,Overall,123,139,462,638,1362,138,124,800,831,1893
25,DRC,2021,DRC-21/HCG10/RA2/NUT/UN/19632,3/11/2022 11:56:25 AM,Returnees,0,0,462,638,1100,0,0,800,831,1631
25,DRC,2021,DRC-21/HCG10/RA2/PROT/INGO/19579,6/14/2022 7:30:39 AM,Host Communities,8269,19293,928,1102,29592,7763,17704,6090,3238,34795
25,DRC,2021,DRC-21/HCG10/RA2/PROT/INGO/19579,6/14/2022 7:30:39 AM,Internally Displaced People,2263,11315,2263,6789,22630,3195,12125,3332,5665,24317
25,DRC,2021,DRC-21/HCG10/RA2/PROT/INGO/19579,6/14/2022 7:30:39 AM,Overall,31420,79348,10154,24138,145060,32188,77739,17004,26026,152957
25,DRC,2021,DRC-21/HCG10/RA2/PROT/INGO/19579,6/14/2022 7:30:39 AM,Returnees,20888,48740,6963,16247,92838,21230,47910,7582,17123,93845
25,DRC,2021,DRC-21/HCG10/RA2/WaSH/INGO/19467,3/30/2022 8:15:43 AM,Host Communities,948,1027,1452,1573,5000,3450,3737,5284,5724,18195
25,DRC,2021,DRC-21/HCG10/RA2/WaSH/INGO/19467,3/30/2022 8:15:43 AM,Internally Displaced People,1896,2054,2904,3146,10000,3396,5319,1074,1163,10952
25,DRC,2021,DRC-21/HCG10/RA2/WaSH/INGO/19467,3/30/2022 8:15:43 AM,Overall,3792,4108,5808,6292,20000,9110,12596,7114,7662,36482
25,DRC,2021,DRC-21/HCG10/RA2/WaSH/INGO/19467,3/30/2022 8:15:43 AM,Returnees,948,1027,1452,1573,5000,2264,3540,756,775,7335
25,DRC,2021,DRC-21/HCG10/RA2/WaSH/NGO/19470,2/7/2022 10:01:40 AM,Host Communities,2025,1552,1553,1620,6750,2025,1552,1553,1620,6750
25,DRC,2021,DRC-21/HCG10/RA2/WaSH/NGO/19470,2/7/2022 10:01:40 AM,Internally Displaced People,1350,1035,1035,1080,4500,1350,1035,1035,1080,4500
25,DRC,2021,DRC-21/HCG10/RA2/WaSH/NGO/19470,2/7/2022 10:01:40 AM,Overall,4500,3449,3451,3600,15000,4500,3449,3451,3600,15000
25,DRC,2021,DRC-21/HCG10/RA2/WaSH/NGO/19470,2/7/2022 10:01:40 AM,Returnees,1125,862,863,900,3750,1125,862,863,900,3750
25,DRC,2021,DRC-21/HCG10/RA3/EDU/INGO/20130,12/19/2022 3:37:24 PM,Host Communities,1086,1084,1158,1243,4571,1230,1515,1007,1046,4798
25,DRC,2021,DRC-21/HCG10/RA3/EDU/INGO/20130,12/19/2022 3:37:24 PM,Internally Displaced People,2534,2528,2732,2927,10721,422,1025,824,902,3173
25,DRC,2021,DRC-21/HCG10/RA3/EDU/INGO/20130,12/19/2022 3:37:24 PM,Overall,3620,3612,3890,4170,15292,1652,2540,1831,1948,7971
25,DRC,2021,DRC-21/HCG10/RA3/FSEC/UN/20129,10/12/2023 9:21:19 AM,Host Communities,2016,3024,1344,2016,8400,1952,3267,2016,1107,8342
25,DRC,2021,DRC-21/HCG10/RA3/FSEC/UN/20129,10/12/2023 9:21:19 AM,Internally Displaced People,1512,2268,1008,1512,6300,1305,2411,1250,1250,6216
25,DRC,2021,DRC-21/HCG10/RA3/FSEC/UN/20129,10/12/2023 9:21:19 AM,Overall,5040,7560,3360,5040,21000,4880,7701,4616,3803,21000
25,DRC,2021,DRC-21/HCG10/RA3/FSEC/UN/20129,10/12/2023 9:21:19 AM,Returnees,1512,2268,1008,1512,6300,1623,2023,1350,1446,6442
25,DRC,2021,DRC-21/HCG10/RA3/HLT/NGO/20126,11/29/2022 6:30:43 AM,Host Communities,937,843,625,564,2969,2306,3027,1508,1900,8741
25,DRC,2021,DRC-21/HCG10/RA3/HLT/NGO/20126,11/29/2022 6:30:43 AM,Internally Displaced People,2104,2107,1434,1442,7087,3020,3964,1975,2488,11447
25,DRC,2021,DRC-21/HCG10/RA3/HLT/NGO/20126,11/29/2022 6:30:43 AM,Overall,5301,5210,3672,3587,17770,5491,7207,3591,4523,20812
25,DRC,2021,DRC-21/HCG10/RA3/HLT/NGO/20126,11/29/2022 6:30:43 AM,Returnees,2260,2260,1613,1581,7714,165,216,108,135,624
25,DRC,2021,DRC-21/HCG10/RA3/HLT-GBV/UN/20111,2/20/2023 9:37:30 AM,Host Communities,1852,1913,2694,2608,9067,7374,13417,6857,11224,38872
25,DRC,2021,DRC-21/HCG10/RA3/HLT-GBV/UN/20111,2/20/2023 9:37:30 AM,Internally Displaced People,1662,1717,2416,2341,8136,2518,4315,2836,3764,13433
25,DRC,2021,DRC-21/HCG10/RA3/HLT-GBV/UN/20111,2/20/2023 9:37:30 AM,Overall,4874,5035,7087,6864,23860,10074,17926,9964,15254,53218
25,DRC,2021,DRC-21/HCG10/RA3/HLT-GBV/UN/20111,2/20/2023 9:37:30 AM,Returnees,1360,1405,1977,1915,6657,182,194,271,266,913
25,DRC,2021,DRC-21/HCG10/RA3/NFI/NGO/20125,7/29/2022 11:27:23 AM,Host Communities,382,473,653,742,2250,282,286,511,432,1511
25,DRC,2021,DRC-21/HCG10/RA3/NFI/NGO/20125,7/29/2022 11:27:23 AM,Internally Displaced People,1530,1890,2610,2970,9000,1772,1921,3594,3273,10560
25,DRC,2021,DRC-21/HCG10/RA3/NFI/NGO/20125,7/29/2022 11:27:23 AM,Overall,1912,2363,3263,3712,11250,2054,2207,4105,3705,12071
25,DRC,2021,DRC-21/HCG10/RA3/NFI/NGO/20131,1/11/2023 9:05:59 PM,Host Communities,126,138,162,174,600,160,318,192,294,964
25,DRC,2021,DRC-21/HCG10/RA3/NFI/NGO/20131,1/11/2023 9:05:59 PM,Internally Displaced People,1890,2070,2430,2610,9000,1695,2003,4163,4321,12182
25,DRC,2021,DRC-21/HCG10/RA3/NFI/NGO/20131,1/11/2023 9:05:59 PM,Overall,3150,3450,4050,4350,15000,3107,3509,7199,7378,21193
25,DRC,2021,DRC-21/HCG10/RA3/NFI/NGO/20131,1/11/2023 9:05:59 PM,Returnees,1134,1242,1458,1566,5400,1252,1188,2844,2763,8047
25,DRC,2021,DRC-21/HCG10/RA3/NFI/UN/20134,7/17/2023 8:10:02 AM,Host Communities,7996,8950,8458,9814,35218,7996,8950,8450,9809,35205
25,DRC,2021,DRC-21/HCG10/RA3/NFI/UN/20134,7/17/2023 8:10:02 AM,Internally Displaced People,7217,8752,7298,9147,32414,5180,8752,7298,9147,30377
25,DRC,2021,DRC-21/HCG10/RA3/NFI/UN/20134,7/17/2023 8:10:02 AM,Other,180,20,0,0,200,180,20,0,0,200
25,DRC,2021,DRC-21/HCG10/RA3/NFI/UN/20134,7/17/2023 8:10:02 AM,Overall,16893,20272,17286,20966,75417,14856,20222,17266,20943,73287
25,DRC,2021,DRC-21/HCG10/RA3/NFI/UN/20134,7/17/2023 8:10:02 AM,Returnees,1500,2550,1530,2005,7585,1500,2500,1518,1987,7505
25,DRC,2021,DRC-21/HCG10/RA3/NFI-PROT/INGO/20139,2/28/2023 4:07:17 PM,Host Communities,1604,3583,753,2574,8514,495,314,145,218,1172
25,DRC,2021,DRC-21/HCG10/RA3/NFI-PROT/INGO/20139,2/28/2023 4:07:17 PM,Internally Displaced People,1604,3583,753,3356,9296,4133,4542,11010,11162,30847
25,DRC,2021,DRC-21/HCG10/RA3/NFI-PROT/INGO/20139,2/28/2023 4:07:17 PM,Overall,3814,7948,1963,6275,20000,6062,6131,11778,11921,35892
25,DRC,2021,DRC-21/HCG10/RA3/NFI-PROT/INGO/20139,2/28/2023 4:07:17 PM,Returnees,606,782,457,345,2190,1434,1275,623,541,3873
25,DRC,2021,DRC-21/HCG10/RA3/NUT-CP/INGO/20138,10/25/2022 8:26:13 AM,Host Communities,1544,3979,3842,4020,13385,643,1174,1963,1827,5607
25,DRC,2021,DRC-21/HCG10/RA3/NUT-CP/INGO/20138,10/25/2022 8:26:13 AM,Internally Displaced People,653,986,1127,1143,3909,400,1506,2480,3248,7634
25,DRC,2021,DRC-21/HCG10/RA3/NUT-CP/INGO/20138,10/25/2022 8:26:13 AM,Overall,2199,5151,5114,5321,17785,1052,3456,5927,7039,17474
25,DRC,2021,DRC-21/HCG10/RA3/NUT-CP/INGO/20138,10/25/2022 8:26:13 AM,Returnees,2,186,145,158,491,9,776,1484,1964,4233
25,DRC,2021,DRC-21/HCG10/RA3/PROT/INGO/20113,1/24/2023 12:10:18 PM,Host Communities,10899,15900,18000,19000,63799,11000,15590,18670,18626,63886
25,DRC,2021,DRC-21/HCG10/RA3/PROT/INGO/20113,1/24/2023 12:10:18 PM,Internally Displaced People,5990,8766,6947,6856,28559,10549,12252,6372,6824,35997
25,DRC,2021,DRC-21/HCG10/RA3/PROT/INGO/20113,1/24/2023 12:10:18 PM,Overall,16889,24666,24947,25856,92358,21549,27842,25042,25450,99883
25,DRC,2021,DRC-21/HCG10/RA3/WaSH/INGO/20140,12/20/2022 1:20:14 PM,Host Communities,3651,4013,5750,6159,19573,2864,3327,6417,6785,19393
25,DRC,2021,DRC-21/HCG10/RA3/WaSH/INGO/20140,12/20/2022 1:20:14 PM,Internally Displaced People,8629,9453,10001,9762,37845,7320,8361,13011,9693,38385
25,DRC,2021,DRC-21/HCG10/RA3/WaSH/INGO/20140,12/20/2022 1:20:14 PM,Overall,12280,13466,15751,15921,57418,10184,11688,19428,16478,57778
25,DRC,2021,DRC-21/HCG10/RA6/FSEC/NGO/21112,1/23/2023 3:36:54 PM,Internally Displaced People,468,1092,4698,5742,12000,1620,3840,3532,3566,12558
25,DRC,2021,DRC-21/HCG10/RA6/FSEC/NGO/21112,1/23/2023 3:36:54 PM,Overall,468,1092,4698,5742,12000,1620,3840,3532,3566,12558
25,DRC,2021,DRC-21/HCG10/RA6/FSEC/NGO/21268,2/6/2023 8:00:22 AM,Internally Displaced People,468,1092,4698,5742,12000,293,1707,7341,7096,16437
25,DRC,2021,DRC-21/HCG10/RA6/FSEC/NGO/21268,2/6/2023 8:00:22 AM,Overall,468,1092,4698,5742,12000,293,1707,7341,7096,16437
25,DRC,2021,DRC-21/HCG10/RA6/NFI/UN/21188,10/12/2023 10:01:55 AM,Host Communities,381,393,536,553,1863,380,893,626,563,2462
25,DRC,2021,DRC-21/HCG10/RA6/NFI/UN/21188,10/12/2023 10:01:55 AM,Internally Displaced People,4899,7527,2984,4727,20137,4730,8027,2994,4747,20498
25,DRC,2021,DRC-21/HCG10/RA6/NFI/UN/21188,10/12/2023 10:01:55 AM,Overall,5280,7920,3520,5280,22000,5110,8920,3620,5310,22960
25,DRC,2021,DRC-21/HCG10/RA6/NFI/UN/21208,11/22/2022 6:44:06 AM,Internally Displaced People,11854,12338,16370,17038,57600,8658,10323,15757,14628,49366
25,DRC,2021,DRC-21/HCG10/RA6/NFI/UN/21208,11/22/2022 6:44:06 AM,Overall,11854,12338,16370,17038,57600,8658,10323,15757,14628,49366
25,DRC,2021,DRC-21/HCG10/SA1/CP/INGO/18840,12/19/2022 3:36:03 PM,Host Communities,190,190,10,10,400,63089,61220,15790,15873,155972
25,DRC,2021,DRC-21/HCG10/SA1/CP/INGO/18840,12/19/2022 3:36:03 PM,Internally Displaced People,891,891,729,1089,3600,9718,2869,3075,2868,18530
25,DRC,2021,DRC-21/HCG10/SA1/CP/INGO/18840,12/19/2022 3:36:03 PM,Overall,1081,1081,739,1099,4000,72807,64089,18865,18741,174502
25,DRC,2021,DRC-21/HCG10/SA1/CP/NGO/19397,10/24/2022 8:33:57 AM,Host Communities,0,0,110,90,200,0,0,43,57,100
25,DRC,2021,DRC-21/HCG10/SA1/CP/NGO/19397,10/24/2022 8:33:57 AM,Other,0,0,70,30,100,0,0,68,32,100
25,DRC,2021,DRC-21/HCG10/SA1/CP/NGO/19397,10/24/2022 8:33:57 AM,Overall,0,0,180,120,300,0,0,111,89,200
25,DRC,2021,DRC-21/HCG10/SA1/CP-GBV/INGO/19076,12/12/2022 1:41:49 PM,Host Communities,40,67,740,758,1605,73,76,1020,901,2070
25,DRC,2021,DRC-21/HCG10/SA1/CP-GBV/INGO/19076,12/12/2022 1:41:49 PM,Internally Displaced People,20,34,370,378,802,59,66,898,789,1812
25,DRC,2021,DRC-21/HCG10/SA1/CP-GBV/INGO/19076,12/12/2022 1:41:49 PM,Overall,100,169,1850,1894,4013,198,209,2540,2229,5176
25,DRC,2021,DRC-21/HCG10/SA1/CP-GBV/INGO/19076,12/12/2022 1:41:49 PM,Returnees,40,68,740,758,1606,66,67,622,539,1294
25,DRC,2021,DRC-21/HCG10/SA1/CP-NUT/INGO/19101,12/19/2022 4:52:54 AM,Host Communities,232,239,795,855,2121,618,637,2120,2280,5655
25,DRC,2021,DRC-21/HCG10/SA1/CP-NUT/INGO/19101,12/19/2022 4:52:54 AM,Internally Displaced People,479,1710,464,1591,4244,1916,2138,580,1988,6622
25,DRC,2021,DRC-21/HCG10/SA1/CP-NUT/INGO/19101,12/19/2022 4:52:54 AM,Other,286,11591,2384,2582,16843,5849,19120,9368,10521,44858
25,DRC,2021,DRC-21/HCG10/SA1/CP-NUT/INGO/19101,12/19/2022 4:52:54 AM,Overall,1229,13779,4438,5883,25329,8638,22158,12943,15730,59469
25,DRC,2021,DRC-21/HCG10/SA1/CP-NUT/INGO/19101,12/19/2022 4:52:54 AM,Returnees,232,239,795,855,2121,255,263,875,941,2334
25,DRC,2021,DRC-21/HCG10/SA1/CP-NUT-WaSH/UN/19360,6/21/2023 3:42:53 PM,Host Communities,40318,16216,7892,8467,72893,27986,62703,17469,15726,123884
25,DRC,2021,DRC-21/HCG10/SA1/CP-NUT-WaSH/UN/19360,6/21/2023 3:42:53 PM,Internally Displaced People,12473,5667,3686,3971,25797,11510,21058,15344,11358,59270
25,DRC,2021,DRC-21/HCG10/SA1/CP-NUT-WaSH/UN/19360,6/21/2023 3:42:53 PM,Overall,60597,26425,15788,16987,119797,46526,96299,50912,41008,234745
25,DRC,2021,DRC-21/HCG10/SA1/CP-NUT-WaSH/UN/19360,6/21/2023 3:42:53 PM,Returnees,7806,4542,4210,4549,21107,7030,12538,18099,13924,51591
25,DRC,2021,DRC-21/HCG10/SA1/EDU/NGO/18996,11/9/2022 11:39:40 AM,Host Communities,238,117,0,0,355,339,158,0,0,497
25,DRC,2021,DRC-21/HCG10/SA1/EDU/NGO/18996,11/9/2022 11:39:40 AM,Internally Displaced People,0,0,2799,2891,5690,0,0,3996,4125,8121
25,DRC,2021,DRC-21/HCG10/SA1/EDU/NGO/18996,11/9/2022 11:39:40 AM,Overall,238,117,6795,7016,14166,339,158,10791,11141,22429
25,DRC,2021,DRC-21/HCG10/SA1/EDU/NGO/18996,11/9/2022 11:39:40 AM,Returnees,0,0,3996,4125,8121,0,0,6795,7016,13811
25,DRC,2021,DRC-21/HCG10/SA1/EDU/NGO/19356,11/16/2022 12:52:35 PM,Host Communities,3866,4124,407,436,8833,3244,3999,2051,1697,10991
25,DRC,2021,DRC-21/HCG10/SA1/EDU/NGO/19356,11/16/2022 12:52:35 PM,Internally Displaced People,9450,11017,1793,1862,24122,8950,8880,1490,1397,20717
25,DRC,2021,DRC-21/HCG10/SA1/EDU/NGO/19356,11/16/2022 12:52:35 PM,Overall,21932,24206,3734,4066,53938,19394,21879,5375,4572,51220
25,DRC,2021,DRC-21/HCG10/SA1/EDU/NGO/19356,11/16/2022 12:52:35 PM,Returnees,8616,9065,1534,1768,20983,7200,9000,1834,1478,19512
25,DRC,2021,DRC-21/HCG10/SA1/EDU-CP/INGO/18917,12/16/2022 11:39:23 AM,Host Communities,141,109,3000,3000,6250,148,114,3150,3150,6562
25,DRC,2021,DRC-21/HCG10/SA1/EDU-CP/INGO/18917,12/16/2022 11:39:23 AM,Internally Displaced People,71,54,1500,1500,3125,75,57,1575,1575,3282
25,DRC,2021,DRC-21/HCG10/SA1/EDU-CP/INGO/18917,12/16/2022 11:39:23 AM,Overall,282,217,6000,6000,12499,296,228,6300,6300,13124
25,DRC,2021,DRC-21/HCG10/SA1/EDU-CP/INGO/18917,12/16/2022 11:39:23 AM,Returnees,70,54,1500,1500,3124,73,57,1575,1575,3280
25,DRC,2021,DRC-21/HCG10/SA1/EDU-CP/INGO/19322,2/10/2023 2:16:00 PM,Host Communities,74,64,1830,1830,3798,3502,3007,7686,7905,22100
25,DRC,2021,DRC-21/HCG10/SA1/EDU-CP/INGO/19322,2/10/2023 2:16:00 PM,Internally Displaced People,25,21,610,610,1266,3692,3411,8025,8280,23408
25,DRC,2021,DRC-21/HCG10/SA1/EDU-CP/INGO/19322,2/10/2023 2:16:00 PM,Overall,124,106,3050,3050,6330,8599,7705,19311,25990,61605
25,DRC,2021,DRC-21/HCG10/SA1/EDU-CP/INGO/19322,2/10/2023 2:16:00 PM,Returnees,25,21,610,610,1266,1405,1287,3600,9805,16097
25,DRC,2021,DRC-21/HCG10/SA1/FSEC/INGO/19198,1/5/2023 8:14:28 AM,Host Communities,831,918,1268,1357,4374,264,372,519,493,1648
25,DRC,2021,DRC-21/HCG10/SA1/FSEC/INGO/19198,1/5/2023 8:14:28 AM,Internally Displaced People,185,204,282,301,972,68,96,134,127,425
25,DRC,2021,DRC-21/HCG10/SA1/FSEC/INGO/19198,1/5/2023 8:14:28 AM,Overall,1847,2040,2818,3015,9720,1671,2354,3284,3118,10427
25,DRC,2021,DRC-21/HCG10/SA1/FSEC/INGO/19198,1/5/2023 8:14:28 AM,Returnees,831,918,1268,1357,4374,1339,1886,2631,2498,8354
25,DRC,2021,DRC-21/HCG10/SA1/FSEC/NGO/18706,11/9/2022 11:44:18 AM,Host Communities,286,666,2142,2618,5712,278,653,2198,2599,5728
25,DRC,2021,DRC-21/HCG10/SA1/FSEC/NGO/18706,11/9/2022 11:44:18 AM,Internally Displaced People,218,510,1638,2002,4368,183,367,1331,1575,3456
25,DRC,2021,DRC-21/HCG10/SA1/FSEC/NGO/18706,11/9/2022 11:44:18 AM,Overall,840,1960,6300,7700,16800,956,1844,6659,7874,17333
25,DRC,2021,DRC-21/HCG10/SA1/FSEC/NGO/18706,11/9/2022 11:44:18 AM,Returnees,336,784,2520,3080,6720,495,824,3130,3700,8149
25,DRC,2021,DRC-21/HCG10/SA1/FSEC/NGO/18776,11/9/2022 11:48:03 AM,Host Communities,645,1129,1505,2096,5375,815,1848,94,350,3107
25,DRC,2021,DRC-21/HCG10/SA1/FSEC/NGO/18776,11/9/2022 11:48:03 AM,Internally Displaced People,829,1452,1936,2696,6913,1023,2150,131,466,3770
25,DRC,2021,DRC-21/HCG10/SA1/FSEC/NGO/18776,11/9/2022 11:48:03 AM,Overall,1843,3226,4301,5990,15360,5288,10664,648,2116,18716
25,DRC,2021,DRC-21/HCG10/SA1/FSEC/NGO/18776,11/9/2022 11:48:03 AM,Returnees,369,645,860,1198,3072,3450,6666,423,1300,11839
25,DRC,2021,DRC-21/HCG10/SA1/FSEC/NGO/19243,9/30/2022 1:29:26 PM,Host Communities,446,638,1399,2016,4499,458,612,1099,1883,4052
25,DRC,2021,DRC-21/HCG10/SA1/FSEC/NGO/19243,9/30/2022 1:29:26 PM,Internally Displaced People,208,402,933,1044,2587,320,487,1022,1205,3034
25,DRC,2021,DRC-21/HCG10/SA1/FSEC/NGO/19243,9/30/2022 1:29:26 PM,Overall,654,1040,2332,3060,7086,778,1099,2121,3088,7086
25,DRC,2021,DRC-21/HCG10/SA1/FSEC/NGO/19291,11/9/2022 11:52:31 AM,Host Communities,1026,1396,656,1026,4104,1023,912,1294,1364,4593
25,DRC,2021,DRC-21/HCG10/SA1/FSEC/NGO/19291,11/9/2022 11:52:31 AM,Internally Displaced People,1539,2094,984,1539,6156,2933,2581,3695,3853,13062
25,DRC,2021,DRC-21/HCG10/SA1/FSEC/NGO/19291,11/9/2022 11:52:31 AM,Overall,2565,3490,1640,2565,10260,3956,3493,4989,5217,17655
25,DRC,2021,DRC-21/HCG10/SA1/FSEC-PROT/NGO/18852,2/20/2023 8:37:30 AM,Host Communities,1207,1587,890,808,4492,1246,1637,919,834,4636
25,DRC,2021,DRC-21/HCG10/SA1/FSEC-PROT/NGO/18852,2/20/2023 8:37:30 AM,Internally Displaced People,1299,1770,618,540,4227,1340,1827,638,557,4362
25,DRC,2021,DRC-21/HCG10/SA1/FSEC-PROT/NGO/18852,2/20/2023 8:37:30 AM,Overall,4003,5427,2369,2061,13860,4131,5600,2445,2127,14303
25,DRC,2021,DRC-21/HCG10/SA1/FSEC-PROT/NGO/18852,2/20/2023 8:37:30 AM,Returnees,1497,2070,861,713,5141,1545,2136,888,736,5305
25,DRC,2021,DRC-21/HCG10/SA1/FSEC-WaSH/INGO/18809,12/16/2022 8:15:37 AM,Host Communities,4542,4832,3749,3887,17010,5343,7111,7615,7743,27812
25,DRC,2021,DRC-21/HCG10/SA1/FSEC-WaSH/INGO/18809,12/16/2022 8:15:37 AM,Internally Displaced People,6489,6903,6940,6302,26634,7523,10120,13059,12393,43095
25,DRC,2021,DRC-21/HCG10/SA1/FSEC-WaSH/INGO/18809,12/16/2022 8:15:37 AM,Overall,12978,13806,12295,11855,50934,12881,17250,20708,20180,71019
25,DRC,2021,DRC-21/HCG10/SA1/FSEC-WaSH/INGO/18809,12/16/2022 8:15:37 AM,Returnees,1947,2071,1606,1666,7290,15,19,34,44,112
25,DRC,2021,DRC-21/HCG10/SA1/GBV/INGO/19192,2/6/2023 9:39:54 AM,Internally Displaced People,700,1482,450,350,2982,0,0,0,0,0
25,DRC,2021,DRC-21/HCG10/SA1/GBV/INGO/19192,2/6/2023 9:39:54 AM,Overall,4600,7012,1450,1850,14912,4499,5507,2778,3046,15830
25,DRC,2021,DRC-21/HCG10/SA1/GBV/INGO/19192,2/6/2023 9:39:54 AM,Returnees,3900,5530,1000,1500,11930,4499,5507,2778,3046,15830
25,DRC,2021,DRC-21/HCG10/SA1/GBV-HLT/UN/18717,2/28/2023 3:53:50 PM,Host Communities,6612,6833,9619,9313,32377,5374,6630,6308,6887,25199
25,DRC,2021,DRC-21/HCG10/SA1/GBV-HLT/UN/18717,2/28/2023 3:53:50 PM,Internally Displaced People,5935,6130,8628,8359,29052,6155,11223,6720,7162,31260
25,DRC,2021,DRC-21/HCG10/SA1/GBV-HLT/UN/18717,2/28/2023 3:53:50 PM,Overall,17403,17979,25306,24510,85198,16515,23348,18614,19757,78234
25,DRC,2021,DRC-21/HCG10/SA1/GBV-HLT/UN/18717,2/28/2023 3:53:50 PM,Returnees,4856,5016,7059,6838,23769,4986,5495,5586,5708,21775
25,DRC,2021,DRC-21/HCG10/SA1/GBV-WaSH/INGO/18878,12/19/2022 3:34:31 PM,Host Communities,3893,6339,5841,8007,24080,7298,10667,6973,7101,32039
25,DRC,2021,DRC-21/HCG10/SA1/GBV-WaSH/INGO/18878,12/19/2022 3:34:31 PM,Internally Displaced People,3058,4981,4589,6292,18920,5734,8382,5479,5580,25175
25,DRC,2021,DRC-21/HCG10/SA1/GBV-WaSH/INGO/18878,12/19/2022 3:34:31 PM,Overall,6951,11320,10430,14299,43000,13032,19049,12452,12681,57214
25,DRC,2021,DRC-21/HCG10/SA1/HLT/INGO/19275,11/9/2022 8:42:27 AM,Host Communities,178,217,286,306,987,791,1011,948,1272,4022
25,DRC,2021,DRC-21/HCG10/SA1/HLT/INGO/19275,11/9/2022 8:42:27 AM,Internally Displaced People,1333,1629,2148,2296,7406,1504,1778,1604,1856,6742
25,DRC,2021,DRC-21/HCG10/SA1/HLT/INGO/19275,11/9/2022 8:42:27 AM,Overall,1778,2172,2864,3061,9875,2846,3458,3112,3819,13235
25,DRC,2021,DRC-21/HCG10/SA1/HLT/INGO/19275,11/9/2022 8:42:27 AM,Returnees,267,326,430,459,1482,551,669,560,691,2471
25,DRC,2021,DRC-21/HCG10/SA1/HLT/UN/19279,2/23/2023 1:09:57 PM,Host Communities,834,998,1768,1893,5493,0,0,0,0,0
25,DRC,2021,DRC-21/HCG10/SA1/HLT/UN/19279,2/23/2023 1:09:57 PM,Internally Displaced People,2211,2646,4692,5022,14571,1031,1154,1074,1202,4461
25,DRC,2021,DRC-21/HCG10/SA1/HLT/UN/19279,2/23/2023 1:09:57 PM,Overall,3045,3644,6460,6915,20064,1031,1154,1074,1202,4461
25,DRC,2021,DRC-21/HCG10/SA1/HLT-NUT/INGO/19363,3/2/2023 9:07:01 AM,Host Communities,11748,12984,17929,19166,61827,16481,30619,16048,21447,84595
25,DRC,2021,DRC-21/HCG10/SA1/HLT-NUT/INGO/19363,3/2/2023 9:07:01 AM,Internally Displaced People,1921,2123,2931,3134,10109,5537,13006,6695,8616,33854
25,DRC,2021,DRC-21/HCG10/SA1/HLT-NUT/INGO/19363,3/2/2023 9:07:01 AM,Other,1545,9252,960,1124,12881,1097,2708,947,1364,6116
25,DRC,2021,DRC-21/HCG10/SA1/HLT-NUT/INGO/19363,3/2/2023 9:07:01 AM,Overall,15214,24359,21820,23424,84817,23115,46333,23690,31427,124565
25,DRC,2021,DRC-21/HCG10/SA1/HLT-WaSH/INGO/19183,2/17/2023 6:49:46 AM,Host Communities,5012,7398,4534,6921,23865,21356,18495,9188,16550,65589
25,DRC,2021,DRC-21/HCG10/SA1/HLT-WaSH/INGO/19183,2/17/2023 6:49:46 AM,Internally Displaced People,4176,6154,3778,5767,19875,22628,14194,11025,15461,63308
25,DRC,2021,DRC-21/HCG10/SA1/HLT-WaSH/INGO/19183,2/17/2023 6:49:46 AM,Overall,16705,24649,15113,23069,79536,82425,60980,36751,54201,234357
25,DRC,2021,DRC-21/HCG10/SA1/HLT-WaSH/INGO/19183,2/17/2023 6:49:46 AM,Returnees,7517,11097,6801,10381,35796,38441,28291,16538,22190,105460
25,DRC,2021,DRC-21/HCG10/SA1/NFI/INGO/18729,2/20/2023 8:45:08 AM,Overall,3726,4011,4051,4412,16200,5075,5942,3954,5079,20050
25,DRC,2021,DRC-21/HCG10/SA1/NFI/INGO/18729,2/20/2023 8:45:08 AM,Returnees,3726,4011,4051,4412,16200,5075,5942,3954,5079,20050
25,DRC,2021,DRC-21/HCG10/SA1/NFI/INGO/18893,1/30/2023 12:49:26 PM,Host Communities,269,287,300,306,1162,1132,1268,2366,2166,6932
25,DRC,2021,DRC-21/HCG10/SA1/NFI/INGO/18893,1/30/2023 12:49:26 PM,Internally Displaced People,2299,2441,2533,2585,9858,1787,2016,3999,3924,11726
25,DRC,2021,DRC-21/HCG10/SA1/NFI/INGO/18893,1/30/2023 12:49:26 PM,Overall,2568,2728,2833,2891,11020,2919,3284,6365,6090,18658
25,DRC,2021,DRC-21/HCG10/SA1/NFI/NGO/18830,2/28/2023 7:13:19 AM,Host Communities,160,640,1440,1760,4000,99,701,2219,2439,5458
25,DRC,2021,DRC-21/HCG10/SA1/NFI/NGO/18830,2/28/2023 7:13:19 AM,Internally Displaced People,240,960,2160,2640,6000,220,980,2790,3527,7517
25,DRC,2021,DRC-21/HCG10/SA1/NFI/NGO/18830,2/28/2023 7:13:19 AM,Overall,400,1600,3600,4400,10000,319,1681,5009,5966,12975
25,DRC,2021,DRC-21/HCG10/SA1/NFI/NGO/18889,12/14/2022 3:39:52 PM,Host Communities,2096,1849,1403,1658,7006,1149,1378,2227,2597,7351
25,DRC,2021,DRC-21/HCG10/SA1/NFI/NGO/18889,12/14/2022 3:39:52 PM,Internally Displaced People,5863,7398,5610,6633,25504,3600,4237,7447,7687,22971
25,DRC,2021,DRC-21/HCG10/SA1/NFI/NGO/18889,12/14/2022 3:39:52 PM,Overall,7959,9247,7013,8291,32510,4749,5615,9674,10284,30322
25,DRC,2021,DRC-21/HCG10/SA1/NFI/NGO/18931,9/12/2022 1:36:39 PM,Host Communities,210,315,520,1055,2100,309,464,766,1552,3091
25,DRC,2021,DRC-21/HCG10/SA1/NFI/NGO/18931,9/12/2022 1:36:39 PM,Internally Displaced People,1890,2835,4682,9493,18900,2783,4174,6901,13967,27825
25,DRC,2021,DRC-21/HCG10/SA1/NFI/NGO/18931,9/12/2022 1:36:39 PM,Overall,2100,3150,5202,10548,21000,3092,4638,7667,15519,30916
25,DRC,2021,DRC-21/HCG10/SA1/NFI/NGO/19199,11/15/2022 7:11:07 AM,Host Communities,110,180,78,107,475,190,179,96,98,563
25,DRC,2021,DRC-21/HCG10/SA1/NFI/NGO/19199,11/15/2022 7:11:07 AM,Internally Displaced People,823,1410,345,547,3125,924,1350,96,650,3020
25,DRC,2021,DRC-21/HCG10/SA1/NFI/NGO/19199,11/15/2022 7:11:07 AM,Overall,933,1590,423,654,3600,1114,1529,192,748,3583
25,DRC,2021,DRC-21/HCG10/SA1/NUT/NGO/18794,9/27/2022 2:13:23 PM,Host Communities,378,826,3978,4310,9492,513,299,4018,4282,9112
25,DRC,2021,DRC-21/HCG10/SA1/NUT/NGO/18794,9/27/2022 2:13:23 PM,Overall,378,826,3978,4310,9492,513,299,4018,4282,9112
25,DRC,2021,DRC-21/HCG10/SA1/NUT-WaSH/NGO/19238,3/6/2023 9:22:51 AM,Host Communities,799,1864,3190,3456,9309,1046,2442,4180,4528,12196
25,DRC,2021,DRC-21/HCG10/SA1/NUT-WaSH/NGO/19238,3/6/2023 9:22:51 AM,Internally Displaced People,499,1165,1994,2160,5818,654,1526,2612,2830,7622
25,DRC,2021,DRC-21/HCG10/SA1/NUT-WaSH/NGO/19238,3/6/2023 9:22:51 AM,Other,0,901,6757,4505,12163,0,447,3095,3675,7217
25,DRC,2021,DRC-21/HCG10/SA1/NUT-WaSH/NGO/19238,3/6/2023 9:22:51 AM,Overall,1997,5560,14733,13145,35435,2615,6551,13544,14995,37705
25,DRC,2021,DRC-21/HCG10/SA1/NUT-WaSH/NGO/19238,3/6/2023 9:22:51 AM,Returnees,699,1630,2792,3024,8145,915,2136,3657,3962,10670
25,DRC,2021,DRC-21/HCG10/SA1/PROT/INGO/19190,12/9/2022 1:18:03 PM,Host Communities,2417,4833,1208,3625,12083,16100,17863,8635,11828,54426
25,DRC,2021,DRC-21/HCG10/SA1/PROT/INGO/19190,12/9/2022 1:18:03 PM,Internally Displaced People,10875,21750,5437,16312,54374,20006,21491,12245,12803,66545
25,DRC,2021,DRC-21/HCG10/SA1/PROT/INGO/19190,12/9/2022 1:18:03 PM,Other,4833,9667,2417,7250,24167,3199,2343,1927,1874,9343
25,DRC,2021,DRC-21/HCG10/SA1/PROT/INGO/19190,12/9/2022 1:18:03 PM,Overall,24167,48333,12083,36249,120832,58393,64959,33719,38245,195316
25,DRC,2021,DRC-21/HCG10/SA1/PROT/INGO/19190,12/9/2022 1:18:03 PM,Returnees,6042,12083,3021,9062,30208,19088,23262,10912,11740,65002
25,DRC,2021,DRC-21/HCG10/SA1/WaSH/NGO/19094,8/11/2022 12:43:06 PM,Host Communities,1556,1615,1562,1603,6336,1503,1650,2289,2472,7914
25,DRC,2021,DRC-21/HCG10/SA1/WaSH/NGO/19094,8/11/2022 12:43:06 PM,Internally Displaced People,1777,1846,1785,1832,7240,705,778,1137,1267,3887
25,DRC,2021,DRC-21/HCG10/SA1/WaSH/NGO/19094,8/11/2022 12:43:06 PM,Overall,4440,4615,4465,4580,18100,3461,3799,5295,5836,18391
25,DRC,2021,DRC-21/HCG10/SA1/WaSH/NGO/19094,8/11/2022 12:43:06 PM,Returnees,1107,1154,1118,1145,4524,1253,1371,1869,2097,6590
25,DRC,2021,DRC-21/HCG10/SA1/WaSH/NGO/19115,8/15/2022 3:16:58 PM,Host Communities,660,709,832,830,3031,303,389,358,524,1574
25,DRC,2021,DRC-21/HCG10/SA1/WaSH/NGO/19115,8/15/2022 3:16:58 PM,Internally Displaced People,792,1073,1104,1143,4112,567,678,896,932,3073
25,DRC,2021,DRC-21/HCG10/SA1/WaSH/NGO/19115,8/15/2022 3:16:58 PM,Overall,3003,3727,4535,3868,15133,1882,2317,2243,2673,9115
25,DRC,2021,DRC-21/HCG10/SA1/WaSH/NGO/19115,8/15/2022 3:16:58 PM,Returnees,1551,1945,2599,1895,7990,1012,1250,989,1217,4468
25,DRC,2021,DRC-21/HCG10/SA1/WaSH/NGO/19162,11/15/2022 8:47:04 AM,Host Communities,3136,4704,3397,5096,16333,3136,4704,3397,5096,16333
25,DRC,2021,DRC-21/HCG10/SA1/WaSH/NGO/19162,11/15/2022 8:47:04 AM,Overall,8960,13440,9706,14560,46666,8960,13440,9706,14560,46666
25,DRC,2021,DRC-21/HCG10/SA1/WaSH/NGO/19162,11/15/2022 8:47:04 AM,Refugees,3584,5376,3882,5824,18666,3584,5376,3882,5824,18666
25,DRC,2021,DRC-21/HCG10/SA1/WaSH/NGO/19162,11/15/2022 8:47:04 AM,Returnees,2240,3360,2427,3640,11667,2240,3360,2427,3640,11667
25,DRC,2021,DRC-21/HCG10/SA1/WaSH-FSEC/INGO/18810,11/22/2022 9:29:45 AM,Host Communities,3061,3317,4690,5079,16147,4554,5703,3603,4208,18068
25,DRC,2021,DRC-21/HCG10/SA1/WaSH-FSEC/INGO/18810,11/22/2022 9:29:45 AM,Internally Displaced People,5524,5985,8461,9165,29135,5217,6569,6108,7062,24956
25,DRC,2021,DRC-21/HCG10/SA1/WaSH-FSEC/INGO/18810,11/22/2022 9:29:45 AM,Overall,10477,11352,16050,17384,55263,13208,16858,12284,14312,56662
25,DRC,2021,DRC-21/HCG10/SA1/WaSH-FSEC/INGO/18810,11/22/2022 9:29:45 AM,Returnees,1892,2050,2899,3140,9981,3437,4586,2573,3042,13638
25,DRC,2022,DRC-22/HCG10/RA1/NFI/UN/22463,10/17/2023 7:48:30 PM,Host Communities,92,153,158,208,611,0,0,0,0,0
25,DRC,2022,DRC-22/HCG10/RA1/NFI/UN/22463,10/17/2023 7:48:30 PM,Internally Displaced People,927,1545,1607,2100,6179,3434,5286,7116,7380,23216
25,DRC,2022,DRC-22/HCG10/RA1/NFI/UN/22463,10/17/2023 7:48:30 PM,Overall,1019,1698,1765,2308,6790,3434,5286,7116,7380,23216
25,DRC,2022,DRC-22/HCG10/RA1/WaSH/INGO/22427,2/28/2023 11:03:12 AM,Host Communities,1876,1979,1251,1277,6383,1864,1986,2802,3321,9973
25,DRC,2022,DRC-22/HCG10/RA1/WaSH/INGO/22427,2/28/2023 11:03:12 AM,Internally Displaced People,4591,4842,3061,3123,15617,5165,5661,10917,12094,33837
25,DRC,2022,DRC-22/HCG10/RA1/WaSH/INGO/22427,2/28/2023 11:03:12 AM,Overall,6467,6821,4312,4400,22000,7029,7647,13719,15415,43810
25,DRC,2022,DRC-22/HCG10/RA1/WaSH/UN/22430,12/20/2022 7:06:03 AM,Host Communities,1235,1716,1383,1382,5716,4151,4240,4701,4648,17740
25,DRC,2022,DRC-22/HCG10/RA1/WaSH/UN/22430,12/20/2022 7:06:03 AM,Internally Displaced People,7265,8410,4178,4177,24030,9685,9892,10968,10845,41390
25,DRC,2022,DRC-22/HCG10/RA1/WaSH/UN/22430,12/20/2022 7:06:03 AM,Overall,8500,10126,5561,5559,29746,13836,14132,15669,15493,59130
25,DRC,2022,DRC-22/HCG10/RA2/HLT/INGO/23079,8/30/2023 2:55:06 PM,Host Communities,2272,3114,3359,3490,12235,3199,4190,4930,5002,17321
25,DRC,2022,DRC-22/HCG10/RA2/HLT/INGO/23079,8/30/2023 2:55:06 PM,Internally Displaced People,4301,6726,5355,5775,22157,3791,6417,5109,5593,20910
25,DRC,2022,DRC-22/HCG10/RA2/HLT/INGO/23079,8/30/2023 2:55:06 PM,Overall,6573,9840,8714,9265,34392,6990,10607,10039,10595,38231
25,DRC,2022,DRC-22/HCG10/RA2/HLT/NGO/23078,10/10/2023 7:21:11 AM,Host Communities,2059,2901,2488,2936,10384,5075,8067,6659,7704,27505
25,DRC,2022,DRC-22/HCG10/RA2/HLT/NGO/23078,10/10/2023 7:21:11 AM,Internally Displaced People,1669,1935,1590,1555,6749,2205,3250,2744,2981,11180
25,DRC,2022,DRC-22/HCG10/RA2/HLT/NGO/23078,10/10/2023 7:21:11 AM,Overall,3728,4836,4078,4491,17133,7280,11317,9403,10685,38685
25,DRC,2022,DRC-22/HCG10/RA3/CP/NGO/23978,9/27/2023 10:40:42 AM,Host Communities,1050,900,1350,1950,5250,1230,900,1754,1691,5575
25,DRC,2022,DRC-22/HCG10/RA3/CP/NGO/23978,9/27/2023 10:40:42 AM,Internally Displaced People,1700,2000,3900,3500,11100,1740,2000,5866,5630,15236
25,DRC,2022,DRC-22/HCG10/RA3/CP/NGO/23978,9/27/2023 10:40:42 AM,Overall,3300,3500,5500,5700,18000,3560,3562,7879,7571,22572
25,DRC,2022,DRC-22/HCG10/RA3/CP/NGO/23978,9/27/2023 10:40:42 AM,Returnees,550,600,250,250,1650,590,662,259,250,1761
25,DRC,2022,DRC-22/HCG10/RA3/FSEC/O/23979,10/3/2023 9:13:08 AM,Internally Displaced People,7000,9000,5000,7000,28000,10398,18408,1880,3204,33890
25,DRC,2022,DRC-22/HCG10/RA3/FSEC/O/23979,10/3/2023 9:13:08 AM,Overall,7000,9000,5000,7000,28000,10398,18408,1880,3204,33890
25,DRC,2022,DRC-22/HCG10/SA1/CP/NGO/22436,6/21/2023 3:41:01 PM,Host Communities,43,43,172,172,430,75,62,782,684,1603
25,DRC,2022,DRC-22/HCG10/SA1/CP/NGO/22436,6/21/2023 3:41:01 PM,Internally Displaced People,237,237,950,950,2374,20,12,1179,1109,2320
25,DRC,2022,DRC-22/HCG10/SA1/CP/NGO/22436,6/21/2023 3:41:01 PM,Overall,472,472,1677,1677,4298,126,106,2442,2288,4962
25,DRC,2022,DRC-22/HCG10/SA1/CP/NGO/22436,6/21/2023 3:41:01 PM,Returnees,192,192,555,555,1494,31,32,481,495,1039
25,DRC,2022,DRC-22/HCG10/SA1/EDU/NGO/22395,10/12/2023 9:53:55 AM,Host Communities,223,95,5224,5394,10936,205,113,6234,5434,11986
25,DRC,2022,DRC-22/HCG10/SA1/EDU/NGO/22395,10/12/2023 9:53:55 AM,Internally Displaced People,0,0,2290,2365,4655,0,0,3245,2113,5358
25,DRC,2022,DRC-22/HCG10/SA1/EDU/NGO/22395,10/12/2023 9:53:55 AM,Overall,223,95,7514,7759,15591,205,113,9479,7547,17344
25,DRC,2022,DRC-22/HCG10/SA1/HLT/INGO/22360,9/8/2023 11:15:53 AM,Host Communities,2657,2840,1740,1924,9161,2003,2141,1312,1450,6906
25,DRC,2022,DRC-22/HCG10/SA1/HLT/INGO/22360,9/8/2023 11:15:53 AM,Internally Displaced People,6719,7182,4402,4866,23169,5183,5541,3396,3753,17873
25,DRC,2022,DRC-22/HCG10/SA1/HLT/INGO/22360,9/8/2023 11:15:53 AM,Overall,15436,16499,10113,11178,53226,11780,12593,7718,8530,40621
25,DRC,2022,DRC-22/HCG10/SA1/HLT/INGO/22360,9/8/2023 11:15:53 AM,Returnees,6060,6477,3971,4388,20896,4594,4911,3010,3327,15842
25,DRC,2022,DRC-22/HCG10/SA1/LTP/NGO/22351,6/13/2023 10:02:47 AM,Host Communities,276,379,184,311,1150,286,468,234,312,1300
25,DRC,2022,DRC-22/HCG10/SA1/LTP/NGO/22351,6/13/2023 10:02:47 AM,Internally Displaced People,652,772,418,708,2550,633,1034,517,690,2874
25,DRC,2022,DRC-22/HCG10/SA1/LTP/NGO/22351,6/13/2023 10:02:47 AM,Overall,1504,1943,986,1667,6100,1506,2462,1231,1641,6840
25,DRC,2022,DRC-22/HCG10/SA1/LTP/NGO/22351,6/13/2023 10:02:47 AM,Returnees,576,792,384,648,2400,587,960,480,639,2666
25,DRC,2022,DRC-22/HCG10/SA1/NFI/NGO/22303,10/4/2023 9:15:32 AM,Internally Displaced People,4600,4601,6352,6353,21906,4481,5302,6385,6378,22546
25,DRC,2022,DRC-22/HCG10/SA1/NFI/NGO/22303,10/4/2023 9:15:32 AM,Overall,4600,4601,6352,6353,21906,4481,5302,6385,6378,22546
24,DRC (UNDP),2014,DRC-14/HCG10/PF1/FSEC/UN/4500,1/23/2019 9:38:41 AM,Host Communities,771,1815,662,1546,4794,419,978,356,824,2577
24,DRC (UNDP),2014,DRC-14/HCG10/PF1/FSEC/UN/4500,1/23/2019 9:38:41 AM,Internally Displaced People,4346,10140,3702,8638,26826,2339,5458,1992,4648,14437
24,DRC (UNDP),2014,DRC-14/HCG10/PF1/FSEC/UN/4500,1/23/2019 9:38:41 AM,Other,1750,4083,1490,3478,10801,3702,8636,13344,7358,33040
24,DRC (UNDP),2014,DRC-14/HCG10/PF1/FSEC/UN/4500,1/23/2019 9:38:41 AM,Overall,6867,16038,5854,13662,42421,6459,15071,5502,12838,39870
24,DRC (UNDP),2014,DRC-14/HCG10/PF1/FSEC-HLT/INGO/32,2/6/2018 2:50:18 PM,Overall,9072,4212,3888,9828,27000,8445,4421,4092,10042,27000
24,DRC (UNDP),2014,DRC-14/HCG10/PF1/FSEC-HLT-WaSH/NGO/27,2/6/2018 12:11:52 PM,Overall,5011,5429,15509,16801,42750,5678,6174,17553,19055,48460
24,DRC (UNDP),2014,DRC-14/HCG10/PF1/FSEC-LOG-NFI/NGO/40,7/19/2017 1:19:32 PM,Overall,10530,26325,8775,12870,58500,175,2825,0,0,3000
24,DRC (UNDP),2014,DRC-14/HCG10/PF1/FSEC-NFI/NGO/33,11/6/2017 9:11:31 AM,Host Communities,500,1700,4100,4800,11100,500,1700,4100,4800,11100
24,DRC (UNDP),2014,DRC-14/HCG10/PF1/FSEC-NFI/NGO/33,11/6/2017 9:11:31 AM,Internally Displaced People,700,1100,3100,4000,8900,700,1100,3100,4000,8900
24,DRC (UNDP),2014,DRC-14/HCG10/PF1/FSEC-NFI/NGO/33,11/6/2017 9:11:31 AM,Overall,1200,2800,7200,8800,20000,1200,2800,7200,8800,20000
24,DRC (UNDP),2014,DRC-14/HCG10/PF1/FSEC-NFI/UN/43,12/27/2018 11:36:43 AM,Overall,3000,2000,12500,12500,30000,2582,2418,12099,12901,30000
24,DRC (UNDP),2014,DRC-14/HCG10/PF1/FSEC-NUT/INGO/36,2/27/2018 7:55:06 AM,Overall,3920,4480,9520,10080,28000,4039,7107,14728,17646,43520
24,DRC (UNDP),2014,DRC-14/HCG10/PF1/FSEC-NUT-PROT/INGO/31,4/24/2017 1:28:09 PM,Overall,1055,1476,3194,3553,9278,1226,1805,3908,4263,11202
24,DRC (UNDP),2014,DRC-14/HCG10/PF1/FSEC-NUT-PROT/INGO/38,4/24/2017 1:21:03 PM,Overall,2420,3629,3406,3144,12599,875,2392,3704,3955,10926
24,DRC (UNDP),2014,DRC-14/HCG10/PF1/FSEC-NUT-WaSH/INGO/37,8/17/2017 4:24:31 PM,Overall,6313,12683,4127,4823,27946,6716,10201,6062,6682,29661
24,DRC (UNDP),2014,DRC-14/HCG10/PF1/FSEC-NUT-WaSH/UN/44,1/21/2019 10:58:54 AM,Overall,8189,10644,9825,12282,40940,7897,11299,8721,11563,39480
24,DRC (UNDP),2014,DRC-14/HCG10/PF1/FSEC-PROT-NFI/UN/41,3/12/2018 3:10:27 PM,Internally Displaced People,17331,23290,20044,29427,90092,0,0,0,0,0
24,DRC (UNDP),2014,DRC-14/HCG10/PF1/FSEC-PROT-NFI/UN/41,3/12/2018 3:10:27 PM,Overall,17331,23290,20044,29427,90092,0,0,0,0,0
24,DRC (UNDP),2014,DRC-14/HCG10/PF1/FSEC-WaSH/INGO/26,5/24/2017 2:19:22 PM,Overall,4092,5001,6593,7048,22734,3412,4098,8672,8672,24854
24,DRC (UNDP),2014,DRC-14/HCG10/PF1/HLT-PROT/INGO/35,7/24/2017 1:37:41 PM,Host Communities,233,590,285,372,1480,4685,5847,5250,5339,21121
24,DRC (UNDP),2014,DRC-14/HCG10/PF1/HLT-PROT/INGO/35,7/24/2017 1:37:41 PM,Overall,233,590,285,372,1480,4509,5367,5008,5016,19900
24,DRC (UNDP),2014,DRC-14/HCG10/PF1/NFI-WaSH/INGO/34,3/1/2017 9:21:51 AM,Overall,2222,2222,11110,11110,26664,6063,6295,7351,8256,27965
24,DRC (UNDP),2014,DRC-14/HCG10/PF1/NUT-FSEC-WaSH/NGO/98,2/6/2018 2:32:09 PM,Overall,6461,7373,7391,10105,31330,5169,6636,5913,8084,25802
24,DRC (UNDP),2014,DRC-14/HCG10/PF1/NUT-WaSH/INGO/39,11/9/2017 1:48:47 PM,Overall,23104,10991,2914,2891,39900,11185,6270,2384,2615,22454
24,DRC (UNDP),2014,DRC-14/HCG10/PF1/PROT-EDU/UN/124,7/10/2017 10:56:22 AM,Overall,418,376,4410,3870,9074,417,246,6595,4867,12125
24,DRC (UNDP),2014,DRC-14/HCG10/PF1/WaSH-FSEC/INGO/123,3/29/2017 2:06:40 PM,Overall,5103,4617,7533,7047,24300,5190,4696,7661,7167,24714
24,DRC (UNDP),2015,DRC-15/HCG10/BUR/COORD/UN/47,2/13/2020 2:22:18 AM,Overall,1120,1600,2800,2480,8000,3692,3619,2759,2994,13064
24,DRC (UNDP),2015,DRC-15/HCG10/BUR/EDU/INGO/49,3/16/2017 3:51:31 PM,Overall,616,614,600,600,2430,554,903,2610,2445,6512
24,DRC (UNDP),2015,DRC-15/HCG10/BUR/NFI/NGO/51,4/1/2020 7:23:04 PM,Overall,448,619,672,928,2667,448,619,672,928,2667
24,DRC (UNDP),2015,DRC-15/HCG10/BUR/NFI/NGO/52,3/15/2017 9:14:52 AM,Overall,583,584,0,0,1167,452,556,685,926,2619
24,DRC (UNDP),2015,DRC-15/HCG10/BUR/NUT/INGO/54,4/13/2020 6:14:37 PM,Overall,0,10,1934,2089,4033,0,985,2229,2790,6004
24,DRC (UNDP),2015,DRC-15/HCG10/BUR/WaSH/INGO/53,4/7/2017 5:08:39 PM,Overall,10566,8812,10625,13730,43733,13608,15073,23521,21034,73236
24,DRC (UNDP),2015,DRC-15/HCG10/PS/LOG/UN/129,1/16/2019 3:17:55 PM,Overall,0,0,0,0,0,15251,15251,0,0,30502
24,DRC (UNDP),2015,DRC-15/HCG10/PS/NFI-WaSH-COORD-EDU-HLT/UN/128,3/31/2017 8:25:46 AM,Overall,54899,59890,64880,69870,249539,123455,134678,145901,157124,561158
24,DRC (UNDP),2015,DRC-15/HCG10/PU/FSEC/INGO/18,2/6/2017 2:46:08 PM,Host Communities,0,0,0,0,0,191,408,691,576,1866
24,DRC (UNDP),2015,DRC-15/HCG10/PU/FSEC/INGO/18,2/6/2017 2:46:08 PM,Overall,1080,1367,1753,1800,6000,0,0,0,0,0
24,DRC (UNDP),2015,DRC-15/HCG10/PU/FSEC/INGO/18,2/6/2017 2:46:08 PM,Refugees,0,0,0,0,0,404,715,1284,1221,3624
24,DRC (UNDP),2015,DRC-15/HCG10/PU/FSEC/INGO/19,2/6/2017 2:50:36 PM,Host Communities,250,253,532,465,1500,0,0,0,0,0
24,DRC (UNDP),2015,DRC-15/HCG10/PU/FSEC/INGO/19,2/6/2017 2:50:36 PM,Overall,540,683,877,900,3000,313,562,1002,946,2823
24,DRC (UNDP),2015,DRC-15/HCG10/PU/FSEC/INGO/19,2/6/2017 2:50:36 PM,Refugees,290,430,345,435,1500,313,562,1002,946,2823
24,DRC (UNDP),2015,DRC-15/HCG10/PU/FSEC/NGO/3,6/14/2016 10:41:39 AM,Overall,890,1600,400,680,3570,890,1275,400,680,3245
24,DRC (UNDP),2015,DRC-15/HCG10/PU/FSEC/NGO/3,6/14/2016 10:41:39 AM,Refugees,890,1600,400,680,3570,890,1275,400,680,3245
24,DRC (UNDP),2015,DRC-15/HCG10/PU/FSEC/UN/91,5/6/2020 5:16:29 PM,Overall,13500,15120,11880,13500,54000,8559,19972,7292,17013,52836
24,DRC (UNDP),2015,DRC-15/HCG10/PU/HLT/UN/17,8/17/2016 12:18:49 PM,Host Communities,3200,3750,5305,5150,17405,3200,3750,5305,5150,17405
24,DRC (UNDP),2015,DRC-15/HCG10/PU/HLT/UN/17,8/17/2016 12:18:49 PM,Overall,16025,18752,26527,25755,87059,13096,15040,21951,21407,71494
24,DRC (UNDP),2015,DRC-15/HCG10/PU/HLT/UN/17,8/17/2016 12:18:49 PM,Refugees,12825,15002,21222,20609,69658,0,0,0,0,0
24,DRC (UNDP),2015,DRC-15/HCG10/PU/LOG/INGO/109,8/9/2016 10:49:34 AM,Overall,149936,155431,0,0,305367,149936,155431,0,0,305367
24,DRC (UNDP),2015,DRC-15/HCG10/PU/NFI/INGO/46,6/29/2016 12:09:21 PM,Overall,494,595,936,975,3000,736,701,1266,1338,4041
24,DRC (UNDP),2015,DRC-15/HCG10/PU/NFI/NGO/20,6/14/2016 10:38:41 AM,Overall,1100,1900,1400,1600,6000,1142,4037,140,257,5576
24,DRC (UNDP),2015,DRC-15/HCG10/PU/NFI/NGO/20,6/14/2016 10:38:41 AM,Refugees,1100,1900,1400,1600,6000,1142,4037,140,257,5576
24,DRC (UNDP),2015,DRC-15/HCG10/PU/NUT/INGO/99,10/24/2016 10:10:55 AM,Host Communities,0,100,300,300,700,0,0,800,556,1356
24,DRC (UNDP),2015,DRC-15/HCG10/PU/NUT/INGO/99,10/24/2016 10:10:55 AM,Overall,0,132,420,420,972,0,9,877,620,1506
24,DRC (UNDP),2015,DRC-15/HCG10/PU/NUT/INGO/99,10/24/2016 10:10:55 AM,Refugees,0,32,120,120,272,0,0,77,64,141
24,DRC (UNDP),2015,DRC-15/HCG10/PU/PROT/UN/2,3/31/2017 8:31:30 AM,Overall,4500,4860,1260,1380,12000,7751,11980,13864,13752,47347
24,DRC (UNDP),2015,DRC-15/HCG10/PU/PROT/UN/2,3/31/2017 8:31:30 AM,Refugees,4500,4860,1260,1380,12000,7751,11980,13864,13752,47347
24,DRC (UNDP),2015,DRC-15/HCG10/PU/WaSH/INGO/110,2/6/2017 3:25:37 PM,Overall,5380,5600,9320,9700,30000,5380,5600,9320,9700,30000
24,DRC (UNDP),2015,DRC-15/HCG10/PU/WaSH/INGO/23,6/29/2016 12:02:19 PM,Overall,1270,1700,4164,4866,12000,0,0,0,0,0
24,DRC (UNDP),2015,DRC-15/HCG10/PU2/HLT/INGO/56,1/24/2018 9:07:30 AM,Overall,0,0,57224,59560,116784,0,0,90821,94907,185728
24,DRC (UNDP),2015,DRC-15/HCG10/PU2/HLT/INGO/57,3/28/2017 1:59:18 PM,Overall,0,0,110958,110958,221916,0,0,110958,110958,221916
24,DRC (UNDP),2015,DRC-15/HCG10/PU2/HLT/INGO/58,3/16/2017 12:57:14 PM,Overall,0,0,22106,23010,45116,0,0,23101,23569,46670
24,DRC (UNDP),2015,DRC-15/HCG10/PU2/HLT/NGO/55,3/14/2017 2:44:27 PM,Overall,0,0,182107,182106,364213,0,0,231688,231688,463376
24,DRC (UNDP),2015,DRC-15/HCG10/PU2/HLT/UN/60,5/4/2020 7:19:28 AM,Overall,0,0,472386,535640,1008026,0,0,682817,774743,1457560
24,DRC (UNDP),2015,DRC-15/HCG10/PU3/EDU/INGO/85,3/15/2017 8:40:23 AM,Overall,0,0,2812,2134,4946,105,26,2720,1781,4632
24,DRC (UNDP),2015,DRC-15/HCG10/PU3/HLT/NGO/83,3/20/2017 10:11:48 AM,Overall,2548,2744,7777,8712,21781,5775,6248,6256,6788,25067
24,DRC (UNDP),2015,DRC-15/HCG10/PU3/NFI/INGO/84,5/5/2021 1:20:20 PM,Overall,1823,2209,3173,3046,10251,1849,2183,3173,3046,10251
24,DRC (UNDP),2015,DRC-15/HCG10/PU3/NUT/INGO/87,8/18/2017 6:54:09 PM,Overall,0,0,2130,2130,4260,0,0,2258,2381,4639
24,DRC (UNDP),2015,DRC-15/HCG10/PU3/PROT/INGO/82,3/16/2017 2:35:28 PM,Overall,3870,4730,5805,7095,21500,3506,1374,5805,7095,17780
24,DRC (UNDP),2015,DRC-15/HCG10/PU3/PROT/NGO/86,3/23/2017 12:56:09 PM,Overall,150,150,50,50,400,285,327,125,117,854
24,DRC (UNDP),2015,DRC-15/HCG10/PU4/LOG/UN/154,4/29/2020 6:26:31 AM,Overall,200,200,10,10,420,375,375,5,4,759
24,DRC (UNDP),2015,DRC-15/HCG10/PU4/LOG-NUT/UN/150,5/6/2020 5:30:32 PM,Overall,0,500,750,750,2000,0,500,750,750,2000
24,DRC (UNDP),2015,DRC-15/HCG10/R/EDU/INGO/11,11/15/2016 10:16:16 AM,Host Communities,35,23,1404,2106,3568,0,0,0,0,0
24,DRC (UNDP),2015,DRC-15/HCG10/R/EDU/INGO/11,11/15/2016 10:16:16 AM,Internally Displaced People,24,16,936,1404,2380,0,0,0,0,0
24,DRC (UNDP),2015,DRC-15/HCG10/R/EDU/INGO/11,11/15/2016 10:16:16 AM,Overall,59,39,2340,3510,5948,80,47,2939,3087,6153
24,DRC (UNDP),2015,DRC-15/HCG10/R/EDU/INGO/118,8/2/2016 11:05:44 AM,Overall,552,495,1432,1414,3893,663,601,1291,1214,3769
24,DRC (UNDP),2015,DRC-15/HCG10/R/EDU/NGO/103,3/3/2017 2:20:38 PM,Overall,140,84,2940,2714,5878,171,53,3070,2720,6014
24,DRC (UNDP),2015,DRC-15/HCG10/R/FSEC/INGO/10,3/3/2017 11:31:17 AM,Host Communities,201,278,383,398,1260,151,185,308,333,977
24,DRC (UNDP),2015,DRC-15/HCG10/R/FSEC/INGO/10,3/3/2017 11:31:17 AM,Internally Displaced People,389,537,740,770,2436,248,316,534,444,1542
24,DRC (UNDP),2015,DRC-15/HCG10/R/FSEC/INGO/10,3/3/2017 11:31:17 AM,Other,751,1036,1429,1487,4703,754,769,1417,1306,4246
24,DRC (UNDP),2015,DRC-15/HCG10/R/FSEC/INGO/10,3/3/2017 11:31:17 AM,Overall,1341,1851,2552,2656,8400,1270,1153,2259,2083,6765
24,DRC (UNDP),2015,DRC-15/HCG10/R/FSEC/INGO/137,3/15/2017 8:41:59 AM,Internally Displaced People,1428,1609,2056,2107,7200,1428,1609,2056,2107,7200
24,DRC (UNDP),2015,DRC-15/HCG10/R/FSEC/INGO/137,3/15/2017 8:41:59 AM,Overall,1428,1609,2056,2107,7200,1428,1609,2056,2107,7200
24,DRC (UNDP),2015,DRC-15/HCG10/R/FSEC/INGO/22,2/8/2017 8:28:58 AM,Overall,2281,3422,2177,2490,10370,1803,1579,3211,3759,10352
24,DRC (UNDP),2015,DRC-15/HCG10/R/FSEC/INGO/6,6/14/2016 1:43:52 PM,Host Communities,0,0,0,4500,4500,1294,1347,1102,1147,4890
24,DRC (UNDP),2015,DRC-15/HCG10/R/FSEC/INGO/6,6/14/2016 1:43:52 PM,Internally Displaced People,0,0,0,10120,10120,2830,2945,2410,2509,10694
24,DRC (UNDP),2015,DRC-15/HCG10/R/FSEC/INGO/6,6/14/2016 1:43:52 PM,Overall,5270,5725,1740,1885,14620,4124,4292,3513,3655,15584
24,DRC (UNDP),2015,DRC-15/HCG10/R/FSEC/INGO/77,8/28/2018 9:03:52 AM,Internally Displaced People,6945,6945,0,0,13890,6945,6945,0,0,13890
24,DRC (UNDP),2015,DRC-15/HCG10/R/FSEC/INGO/77,8/28/2018 9:03:52 AM,Overall,6945,6945,0,0,13890,0,0,0,0,0
24,DRC (UNDP),2015,DRC-15/HCG10/R/FSEC/INGO/9,6/14/2016 11:35:40 AM,Internally Displaced People,936,1908,355,401,3600,1596,1386,318,300,3600
24,DRC (UNDP),2015,DRC-15/HCG10/R/FSEC/INGO/9,6/14/2016 11:35:40 AM,Overall,936,1908,355,401,3600,1596,1386,318,300,3600
24,DRC (UNDP),2015,DRC-15/HCG10/R/FSEC/INGO/96,6/15/2016 2:47:56 PM,Overall,1495,1750,2998,2757,9000,4583,4403,0,0,8986
24,DRC (UNDP),2015,DRC-15/HCG10/R/FSEC/NGO/116,6/14/2016 12:53:42 PM,Overall,50,650,0,0,700,157,843,1618,1892,4510
24,DRC (UNDP),2015,DRC-15/HCG10/R/FSEC/NGO/141,8/9/2016 12:45:23 PM,Host Communities,312,334,382,488,1516,309,326,387,493,1515
24,DRC (UNDP),2015,DRC-15/HCG10/R/FSEC/NGO/141,8/9/2016 12:45:23 PM,Internally Displaced People,298,436,431,482,1647,296,429,436,489,1650
24,DRC (UNDP),2015,DRC-15/HCG10/R/FSEC/NGO/141,8/9/2016 12:45:23 PM,Other,623,712,727,781,2843,621,702,729,791,2843
24,DRC (UNDP),2015,DRC-15/HCG10/R/FSEC/NGO/141,8/9/2016 12:45:23 PM,Overall,1233,1482,1540,1751,6006,1226,1457,1552,1773,6008
24,DRC (UNDP),2015,DRC-15/HCG10/R/FSEC/NGO/79,3/3/2017 1:35:06 PM,Host Communities,194,198,398,399,1189,192,197,399,401,1189
24,DRC (UNDP),2015,DRC-15/HCG10/R/FSEC/NGO/79,3/3/2017 1:35:06 PM,Internally Displaced People,39,43,81,83,246,39,43,81,83,246
24,DRC (UNDP),2015,DRC-15/HCG10/R/FSEC/NGO/79,3/3/2017 1:35:06 PM,Other,719,807,1426,1613,4565,703,799,1427,1636,4565
24,DRC (UNDP),2015,DRC-15/HCG10/R/FSEC/NGO/79,3/3/2017 1:35:06 PM,Overall,952,1048,1905,2095,6000,948,1045,1911,2096,6000
24,DRC (UNDP),2015,DRC-15/HCG10/R/FSEC/UN/4,8/16/2016 11:23:36 AM,Overall,4400,5600,0,0,10000,1703,3973,1450,3384,10510
24,DRC (UNDP),2015,DRC-15/HCG10/R/HLT/INGO/102,7/19/2016 11:51:30 AM,Host Communities,2262,3391,2087,3130,10870,8863,15138,7614,8060,39675
24,DRC (UNDP),2015,DRC-15/HCG10/R/HLT/INGO/102,7/19/2016 11:51:30 AM,Internally Displaced People,1205,1807,1112,1669,5793,4670,2474,717,3138,10999
24,DRC (UNDP),2015,DRC-15/HCG10/R/HLT/INGO/102,7/19/2016 11:51:30 AM,Other,9533,14302,8801,13201,45837,3993,1185,2595,5888,13661
24,DRC (UNDP),2015,DRC-15/HCG10/R/HLT/INGO/102,7/19/2016 11:51:30 AM,Overall,13000,19500,12000,18000,62500,17531,18797,10926,17086,64340
24,DRC (UNDP),2015,DRC-15/HCG10/R/HLT/INGO/73,8/8/2016 8:52:40 AM,Host Communities,618,710,926,1065,3319,442,512,652,876,2482
24,DRC (UNDP),2015,DRC-15/HCG10/R/HLT/INGO/73,8/8/2016 8:52:40 AM,Internally Displaced People,1941,2233,2912,3350,10436,1284,1783,2007,2527,7601
24,DRC (UNDP),2015,DRC-15/HCG10/R/HLT/INGO/73,8/8/2016 8:52:40 AM,Other,2988,3438,4482,5157,16065,1927,1934,3125,3509,10495
24,DRC (UNDP),2015,DRC-15/HCG10/R/HLT/INGO/73,8/8/2016 8:52:40 AM,Overall,5583,6424,8375,9636,30018,3672,4257,5821,6954,20704
24,DRC (UNDP),2015,DRC-15/HCG10/R/HLT/INGO/73,8/8/2016 8:52:40 AM,Refugees,36,43,55,64,198,19,28,37,42,126
24,DRC (UNDP),2015,DRC-15/HCG10/R/HLT/UN/5,1/16/2019 2:53:26 PM,Host Communities,1461,3041,1096,1216,6814,0,0,0,0,0
24,DRC (UNDP),2015,DRC-15/HCG10/R/HLT/UN/5,1/16/2019 2:53:26 PM,Internally Displaced People,2191,4561,1643,1825,10220,0,0,0,0,0
24,DRC (UNDP),2015,DRC-15/HCG10/R/HLT/UN/5,1/16/2019 2:53:26 PM,Overall,3652,7602,2739,3041,17034,2544,9934,7250,10326,30054
24,DRC (UNDP),2015,DRC-15/HCG10/R/LOG/INGO/94,6/15/2016 2:37:25 PM,Overall,10720,12552,21494,19770,64536,10720,12552,21494,19770,64536
24,DRC (UNDP),2015,DRC-15/HCG10/R/NFI/INGO/120,2/7/2017 2:50:51 PM,Overall,4897,5317,8675,8142,27031,4762,5535,8741,8366,27404
24,DRC (UNDP),2015,DRC-15/HCG10/R/NFI/INGO/13,6/20/2016 2:38:00 PM,Overall,1380,1620,1800,2700,7500,1423,1479,2883,2972,8757
24,DRC (UNDP),2015,DRC-15/HCG10/R/NFI/NGO/104,6/14/2016 12:59:58 PM,Overall,300,350,50,53,753,1013,2135,2609,3012,8769
24,DRC (UNDP),2015,DRC-15/HCG10/R/NFI/NGO/121,6/14/2016 11:51:27 AM,Host Communities,1965,0,0,0,1965,3636,0,0,0,3636
24,DRC (UNDP),2015,DRC-15/HCG10/R/NFI/NGO/121,6/14/2016 11:51:27 AM,Internally Displaced People,1065,0,0,0,1065,14549,0,0,0,14549
24,DRC (UNDP),2015,DRC-15/HCG10/R/NFI/NGO/121,6/14/2016 11:51:27 AM,Overall,3030,4125,1133,1542,9830,5605,7632,2096,2852,18185
24,DRC (UNDP),2015,DRC-15/HCG10/R/NFI/NGO/130,6/20/2016 3:29:25 PM,Overall,2460,3148,3215,2096,10919,3162,3850,3780,4239,15031
24,DRC (UNDP),2015,DRC-15/HCG10/R/NFI/NGO/138,3/2/2017 12:15:47 PM,Overall,640,2560,0,0,3200,155,3045,0,0,3200
24,DRC (UNDP),2015,DRC-15/HCG10/R/NFI/NGO/76,3/2/2017 11:57:37 AM,Host Communities,6345,25378,12689,19034,63446,6345,25378,12689,19034,63446
24,DRC (UNDP),2015,DRC-15/HCG10/R/NFI/NGO/76,3/2/2017 11:57:37 AM,Overall,686,1428,2137,3250,7501,616,1299,1949,2976,6840
24,DRC (UNDP),2015,DRC-15/HCG10/R/NUT/INGO/100,2/28/2017 9:46:28 AM,Overall,303,3517,4019,4186,12025,1145,5119,6129,6894,19287
24,DRC (UNDP),2015,DRC-15/HCG10/R/PROT/NGO/12,3/16/2017 2:59:38 PM,Overall,3000,3000,272,128,6400,4648,2252,240,160,7300
24,DRC (UNDP),2015,DRC-15/HCG10/R/WaSH/INGO/74,2/7/2017 2:35:37 PM,Host Communities,3483,4742,6093,7543,21861,3483,4742,6093,7543,21861
24,DRC (UNDP),2015,DRC-15/HCG10/R/WaSH/INGO/74,2/7/2017 2:35:37 PM,Internally Displaced People,1426,2697,2716,3060,9899,1462,2697,2716,3060,9935
24,DRC (UNDP),2015,DRC-15/HCG10/R/WaSH/INGO/74,2/7/2017 2:35:37 PM,Overall,4909,7439,8809,10603,31760,4909,7439,8809,10603,31760
24,DRC (UNDP),2015,DRC-15/HCG10/R/WaSH/NGO/117,3/7/2017 9:14:02 AM,Overall,6240,9360,6760,10140,32500,6010,9016,6224,9250,30500
24,DRC (UNDP),2015,DRC-15/HCG10/R/WaSH/NGO/7,10/28/2016 9:29:35 AM,Host Communities,1008,1092,1512,1638,5250,1008,1092,1512,1638,5250
24,DRC (UNDP),2015,DRC-15/HCG10/R/WaSH/NGO/7,10/28/2016 9:29:35 AM,Internally Displaced People,1872,2028,2808,3042,9750,1872,2028,2808,3042,9750
24,DRC (UNDP),2015,DRC-15/HCG10/R/WaSH/NGO/7,10/28/2016 9:29:35 AM,Overall,2880,3120,4320,4680,15000,2880,3120,4320,4680,15000
24,DRC (UNDP),2016,DRC-16/HCG10/PS/COORD/UN/4624,7/25/2018 2:17:08 PM,Overall,4,4,4,4,16,1,1,1,1,4
24,DRC (UNDP),2016,DRC-16/HCG10/PS/COORD-NFI-WaSH-HLT-EDU/UN/134,7/10/2017 12:13:07 PM,Host Communities,2118,2295,2487,2694,9594,2190,2372,3084,3258,10904
24,DRC (UNDP),2016,DRC-16/HCG10/PS/COORD-NFI-WaSH-HLT-EDU/UN/134,7/10/2017 12:13:07 PM,Internally Displaced People,31070,33658,36472,39512,140712,32112,34788,45225,47787,159912
24,DRC (UNDP),2016,DRC-16/HCG10/PS/COORD-NFI-WaSH-HLT-EDU/UN/134,7/10/2017 12:13:07 PM,Other,2118,2295,2487,2694,9594,2189,2372,3083,3258,10902
24,DRC (UNDP),2016,DRC-16/HCG10/PS/COORD-NFI-WaSH-HLT-EDU/UN/134,7/10/2017 12:13:07 PM,Overall,35306,38248,41446,44900,159900,36491,39532,51392,54304,181719
24,DRC (UNDP),2016,DRC-16/HCG10/PS/LOG/UN/105,1/17/2019 1:18:49 PM,Overall,11700,11700,0,0,23400,13453,13453,0,0,26906
24,DRC (UNDP),2016,DRC-16/HCG10/PS/LOG/UN/4388,1/3/2019 3:03:44 PM,Overall,1,1,0,0,2,1,1,0,0,2
24,DRC (UNDP),2016,DRC-16/HCG10/PU01/FSEC/UN/107,5/6/2020 5:24:06 PM,Host Communities,16220,37846,13816,32238,100120,5903,13160,12890,16954,48907
24,DRC (UNDP),2016,DRC-16/HCG10/PU01/FSEC/UN/107,5/6/2020 5:24:06 PM,Internally Displaced People,8618,20110,7342,17130,53200,3178,7986,6941,9129,27234
24,DRC (UNDP),2016,DRC-16/HCG10/PU01/FSEC/UN/107,5/6/2020 5:24:06 PM,Overall,12419,28977,10579,24685,76660,19034,19034,19034,19034,76136
24,DRC (UNDP),2016,DRC-16/HCG10/PU02/HLT/INGO/145,3/14/2017 10:53:28 AM,Other,427,494,107,122,1150,448,499,366,347,1660
24,DRC (UNDP),2016,DRC-16/HCG10/PU02/HLT/INGO/145,3/14/2017 10:53:28 AM,Overall,427,494,107,122,1150,448,499,366,347,1660
24,DRC (UNDP),2016,DRC-16/HCG10/PU02/HLT/INGO/149,7/13/2017 1:36:38 PM,Host Communities,800,803,252,262,2117,1104,1143,331,279,2857
24,DRC (UNDP),2016,DRC-16/HCG10/PU02/HLT/INGO/149,7/13/2017 1:36:38 PM,Overall,800,803,252,262,2117,1104,1143,331,279,2857
24,DRC (UNDP),2016,DRC-16/HCG10/PU02/HLT-WaSH-COORD/UN/147,7/10/2017 12:29:14 PM,Overall,5,0,0,0,5,6,0,0,0,6
24,DRC (UNDP),2016,DRC-16/HCG10/PU02/NFI/NGO/143,2/28/2017 10:20:15 AM,Host Communities,2000,3050,300,400,5750,767,1069,901,1410,4147
24,DRC (UNDP),2016,DRC-16/HCG10/PU02/NFI/NGO/143,2/28/2017 10:20:15 AM,Overall,2000,3050,300,400,5750,767,1069,901,1410,4147
24,DRC (UNDP),2016,DRC-16/HCG10/PU02/WaSH/INGO/148,9/19/2017 8:50:44 AM,Host Communities,21475,23987,5152,5636,56250,35625,40313,8438,93751,178127
24,DRC (UNDP),2016,DRC-16/HCG10/PU02/WaSH/INGO/148,9/19/2017 8:50:44 AM,Overall,21475,23987,5152,5636,56250,28634,31983,6871,7512,75000
24,DRC (UNDP),2016,DRC-16/HCG10/PU02/WaSH-NFI/INGO/146,3/2/2017 3:02:36 PM,Overall,15200,22800,0,0,38000,13394,23741,3026,5234,45395
24,DRC (UNDP),2016,DRC-16/HCG10/PU03/HLT/INGO/4329,8/14/2017 6:53:52 PM,Host Communities,960,1440,320,480,3200,787,848,521,460,2616
24,DRC (UNDP),2016,DRC-16/HCG10/PU03/HLT/INGO/4329,8/14/2017 6:53:52 PM,Overall,960,1440,320,480,3200,787,848,521,460,2616
24,DRC (UNDP),2016,DRC-16/HCG10/ST1/FSEC/NGO/166,1/21/2019 2:04:30 PM,Internally Displaced People,0,0,0,0,0,581,640,0,0,1221
24,DRC (UNDP),2016,DRC-16/HCG10/ST1/FSEC/NGO/166,1/21/2019 2:04:30 PM,Other,300,300,0,0,600,0,0,0,0,0
24,DRC (UNDP),2016,DRC-16/HCG10/ST1/FSEC/NGO/166,1/21/2019 2:04:30 PM,Overall,1000,1000,0,0,2000,581,640,0,0,1221
24,DRC (UNDP),2016,DRC-16/HCG10/ST1/FSEC-EDU/NGO/193,4/15/2019 12:03:19 PM,Host Communities,211,317,1695,1695,3918,0,0,0,0,0
24,DRC (UNDP),2016,DRC-16/HCG10/ST1/FSEC-EDU/NGO/193,4/15/2019 12:03:19 PM,Overall,704,1056,5650,5650,13060,704,1056,5905,5355,13020
24,DRC (UNDP),2016,DRC-16/HCG10/ST1/FSEC-NUT-HLT-PROT/INGO/175,2/8/2019 1:43:56 PM,Overall,8206,10645,8464,9647,36962,7628,10709,8396,10084,36817
24,DRC (UNDP),2016,DRC-16/HCG10/ST1/HLT-NUT-PROT/INGO/170,1/23/2019 11:58:20 AM,Overall,3361,5483,3945,4631,17420,3812,5436,10750,12151,32149
24,DRC (UNDP),2016,DRC-16/HCG10/ST1/LOG-EDU-PROT/INGO/159,4/2/2019 11:36:12 AM,Host Communities,3500,3500,6000,6000,19000,0,0,0,0,0
24,DRC (UNDP),2016,DRC-16/HCG10/ST1/LOG-EDU-PROT/INGO/159,4/2/2019 11:36:12 AM,Internally Displaced People,3000,3000,1500,1500,9000,0,0,0,0,0
24,DRC (UNDP),2016,DRC-16/HCG10/ST1/LOG-EDU-PROT/INGO/159,4/2/2019 11:36:12 AM,Overall,6500,6500,7500,7500,28000,9961,8771,5600,7107,31439
24,DRC (UNDP),2016,DRC-16/HCG10/ST1/WaSH/INGO/171,2/8/2019 1:44:43 PM,Host Communities,2121,2318,3105,3554,11098,2121,2318,3105,3554,11098
24,DRC (UNDP),2016,DRC-16/HCG10/ST1/WaSH/INGO/171,2/8/2019 1:44:43 PM,Other,225,276,353,398,1252,300,454,266,508,1528
24,DRC (UNDP),2016,DRC-16/HCG10/ST1/WaSH/INGO/171,2/8/2019 1:44:43 PM,Overall,2346,2594,3458,3952,12350,2346,2594,3458,3952,12350
24,DRC (UNDP),2016,DRC-16/HCG10/ST1/WaSH-LOG/INGO/202,1/22/2019 12:45:41 PM,Overall,7752,8183,13351,13782,43068,7330,6780,11576,12850,38536
24,DRC (UNDP),2016,DRC-16/HCG10/ST2/EDU/NGO/4065,10/5/2018 2:53:26 PM,Host Communities,131,37,2449,1532,4149,131,37,2449,1532,4149
24,DRC (UNDP),2016,DRC-16/HCG10/ST2/EDU/NGO/4065,10/5/2018 2:53:26 PM,Overall,131,37,2921,1864,4953,131,37,2921,1854,4943
24,DRC (UNDP),2016,DRC-16/HCG10/ST2/EDU/NGO/4065,10/5/2018 2:53:26 PM,Refugees,0,0,472,332,804,0,0,472,332,804
24,DRC (UNDP),2016,DRC-16/HCG10/ST2/FSEC-EDU/NGO/3925,8/28/2018 8:54:20 AM,Overall,500,750,5625,5625,12500,500,750,5799,6464,13513
24,DRC (UNDP),2016,DRC-16/HCG10/ST2/FSEC-EDU/NGO/3925,8/28/2018 8:54:20 AM,Refugees,100,150,1125,1125,2500,100,150,1120,1026,2396
24,DRC (UNDP),2016,DRC-16/HCG10/ST2/HLT-WaSH/INGO/4137,9/17/2018 11:43:54 AM,Host Communities,4017,5099,3090,3245,15451,3216,4237,4739,5502,17694
24,DRC (UNDP),2016,DRC-16/HCG10/ST2/HLT-WaSH/INGO/4137,9/17/2018 11:43:54 AM,Overall,6695,8498,5150,5408,25751,4897,6438,7100,8166,26601
24,DRC (UNDP),2016,DRC-16/HCG10/ST2/HLT-WaSH/INGO/4137,9/17/2018 11:43:54 AM,Refugees,2678,3399,2060,2163,10300,1681,2201,2361,2664,8907
24,DRC (UNDP),2016,DRC-16/HCG10/ST2/LOG-WaSH/INGO/4142,9/24/2018 10:35:23 AM,Overall,5120,6927,8433,9637,30117,14125,11677,10400,9282,45484
24,DRC (UNDP),2016,DRC-16/HCG10/ST2/NUT-FSEC/INGO/3973,10/4/2018 10:24:13 AM,Overall,3517,5289,3202,4022,16030,4507,5100,4156,5948,19711
24,DRC (UNDP),2016,DRC-16/HCG10/ST2/NUT-HLT/INGO/4132,9/18/2018 10:01:13 AM,Overall,10632,12187,6172,9372,38363,10428,11748,5458,7086,34720
24,DRC (UNDP),2016,DRC-16/HCG10/UR01/EDU/NGO/4392,2/26/2018 12:11:59 PM,Internally Displaced People,0,0,675,675,1350,0,0,558,445,1003
24,DRC (UNDP),2016,DRC-16/HCG10/UR01/EDU/NGO/4392,2/26/2018 12:11:59 PM,Overall,50,20,2250,2250,4570,85,16,2464,2135,4700
24,DRC (UNDP),2016,DRC-16/HCG10/UR01/HLT/INGO/4366,9/20/2017 9:35:19 AM,Overall,5174,5386,5834,5606,22000,3293,5922,3328,3536,16079
24,DRC (UNDP),2016,DRC-16/HCG10/UR01/LOG-NFI-WaSH/INGO/4434,2/20/2018 1:02:28 PM,Host Communities,515,556,848,694,2613,4443,6719,3571,4235,18968
24,DRC (UNDP),2016,DRC-16/HCG10/UR01/LOG-NFI-WaSH/INGO/4434,2/20/2018 1:02:28 PM,Internally Displaced People,613,697,917,786,3013,619,830,685,801,2935
24,DRC (UNDP),2016,DRC-16/HCG10/UR01/LOG-NFI-WaSH/INGO/4434,2/20/2018 1:02:28 PM,Other,2936,3219,4343,3919,14417,506,664,636,687,2493
24,DRC (UNDP),2016,DRC-16/HCG10/UR01/LOG-NFI-WaSH/INGO/4434,2/20/2018 1:02:28 PM,Overall,4064,4472,6108,5399,20043,5624,8295,4892,5723,24534
24,DRC (UNDP),2016,DRC-16/HCG10/UR01/NUT-WaSH/INGO/4400,12/21/2017 10:59:27 AM,Overall,1664,1566,2206,2264,7700,632,544,567,573,2316
24,DRC (UNDP),2016,DRC-16/HCG10/UR01/PROT/NGO/4393,2/8/2018 10:42:17 AM,Host Communities,85,75,95,105,360,101,59,186,96,442
24,DRC (UNDP),2016,DRC-16/HCG10/UR01/PROT/NGO/4393,2/8/2018 10:42:17 AM,Internally Displaced People,10,10,20,10,50,10,10,20,10,50
24,DRC (UNDP),2016,DRC-16/HCG10/UR01/PROT/NGO/4393,2/8/2018 10:42:17 AM,Overall,95,85,115,115,410,111,69,206,106,492
24,DRC (UNDP),2016,DRC-16/HCG10/UR02/EDU/INGO/4350,2/9/2018 11:00:46 AM,Overall,180,116,3150,3150,6596,211,63,3748,3557,7579
24,DRC (UNDP),2016,DRC-16/HCG10/UR02/EDU/INGO/4359,11/28/2017 11:31:12 AM,Host Communities,270,150,1080,720,2220,318,177,1381,1707,3583
24,DRC (UNDP),2016,DRC-16/HCG10/UR02/EDU/INGO/4359,11/28/2017 11:31:12 AM,Internally Displaced People,135,75,540,360,1110,144,89,986,985,2204
24,DRC (UNDP),2016,DRC-16/HCG10/UR02/EDU/INGO/4359,11/28/2017 11:31:12 AM,Other,45,25,180,120,370,40,52,268,198,558
24,DRC (UNDP),2016,DRC-16/HCG10/UR02/EDU/INGO/4359,11/28/2017 11:31:12 AM,Overall,450,250,1800,1200,3700,502,318,2635,2890,6345
24,DRC (UNDP),2016,DRC-16/HCG10/UR02/EDU/NGO/4407,2/6/2018 2:26:08 PM,Overall,181,89,3190,2310,5770,0,0,0,0,0
24,DRC (UNDP),2016,DRC-16/HCG10/UR02/FSEC/INGO/4341,8/23/2018 10:54:47 AM,Overall,3193,4407,6076,6324,20000,5622,6267,7200,6307,25396
24,DRC (UNDP),2016,DRC-16/HCG10/UR02/FSEC/INGO/4348,5/4/2018 10:36:34 AM,Overall,1474,1907,2774,2515,8670,1713,1852,2283,2301,8149
24,DRC (UNDP),2016,DRC-16/HCG10/UR02/HLT/INGO/4347,2/8/2018 9:55:41 AM,Overall,27707,12864,11874,30015,82460,32100,34775,7481,8104,82460
24,DRC (UNDP),2016,DRC-16/HCG10/UR02/HLT/INGO/4365,2/26/2018 8:18:36 AM,Host Communities,5141,5570,7713,8356,26780,3663,8685,5054,5784,23186
24,DRC (UNDP),2016,DRC-16/HCG10/UR02/HLT/INGO/4365,2/26/2018 8:18:36 AM,Internally Displaced People,3496,3786,5245,5693,18220,2093,5438,2817,3264,13612
24,DRC (UNDP),2016,DRC-16/HCG10/UR02/HLT/INGO/4365,2/26/2018 8:18:36 AM,Overall,8637,9356,12958,14049,45000,5756,14123,7871,9048,36798
24,DRC (UNDP),2016,DRC-16/HCG10/UR02/HLT-NUT/INGO/4404,2/27/2018 8:11:27 AM,Host Communities,2046,2129,2825,2941,9941,1897,987,3859,2987,9730
24,DRC (UNDP),2016,DRC-16/HCG10/UR02/HLT-NUT/INGO/4404,2/27/2018 8:11:27 AM,Internally Displaced People,894,931,1235,1285,4345,748,4013,4069,1525,10355
24,DRC (UNDP),2016,DRC-16/HCG10/UR02/HLT-NUT/INGO/4404,2/27/2018 8:11:27 AM,Other,1379,1435,1904,1982,6700,1589,1897,1050,895,5431
24,DRC (UNDP),2016,DRC-16/HCG10/UR02/HLT-NUT/INGO/4404,2/27/2018 8:11:27 AM,Overall,4319,4495,5964,6208,20986,4234,6897,8978,5407,25516
24,DRC (UNDP),2016,DRC-16/HCG10/UR02/LOG-NFI/NGO/4416,2/19/2018 3:00:55 PM,Overall,675,1110,1825,2490,6100,675,1110,1825,2490,6100
24,DRC (UNDP),2016,DRC-16/HCG10/UR02/NFI/NGO/4346,8/15/2017 12:37:58 PM,Host Communities,40,160,0,0,200,19,1148,0,0,1167
24,DRC (UNDP),2016,DRC-16/HCG10/UR02/NFI/NGO/4346,8/15/2017 12:37:58 PM,Internally Displaced People,360,1440,0,0,1800,18,815,0,0,833
24,DRC (UNDP),2016,DRC-16/HCG10/UR02/NFI/NGO/4346,8/15/2017 12:37:58 PM,Overall,400,1600,0,0,2000,37,1963,0,0,2000
24,DRC (UNDP),2016,DRC-16/HCG10/UR02/NUT/INGO/4389,1/16/2018 10:25:33 AM,Other,0,0,0,0,0,3744,22965,12200,14320,53229
24,DRC (UNDP),2016,DRC-16/HCG10/UR02/NUT/INGO/4389,1/16/2018 10:25:33 AM,Overall,216,64,1000,1015,2295,207,80,1089,1285,2661
24,DRC (UNDP),2016,DRC-16/HCG10/UR02/PROT/NGO/4387,2/22/2018 11:32:49 AM,Overall,340,265,29071,19369,49045,310,234,27094,23002,50640
24,DRC (UNDP),2016,DRC-16/HCG10/UR02/PROT/NGO/4406,2/6/2018 1:50:58 PM,Overall,25,150,5,70,250,20,278,0,58,356
24,DRC (UNDP),2016,DRC-16/HCG10/UR02/PROT/NGO/4411,12/12/2017 9:58:40 AM,Host Communities,3138,5458,2321,2731,13648,3139,5558,2320,2800,13817
24,DRC (UNDP),2016,DRC-16/HCG10/UR02/PROT/NGO/4411,12/12/2017 9:58:40 AM,Internally Displaced People,35,61,26,30,152,250,300,130,120,800
24,DRC (UNDP),2016,DRC-16/HCG10/UR02/PROT/NGO/4411,12/12/2017 9:58:40 AM,Other,245,426,180,212,1063,130,380,140,200,850
24,DRC (UNDP),2016,DRC-16/HCG10/UR02/PROT/NGO/4411,12/12/2017 9:58:40 AM,Overall,4569,7934,3365,3966,19834,5400,8785,3383,3100,20668
24,DRC (UNDP),2016,DRC-16/HCG10/UR02/PROT/NGO/4411,12/12/2017 9:58:40 AM,Refugees,70,121,52,60,303,0,0,0,0,0
24,DRC (UNDP),2016,DRC-16/HCG10/UR02/WaSH-LOG/NGO/4415,1/24/2018 9:18:06 AM,Host Communities,6355,7700,8723,9527,32305,7445,8905,10329,11363,38042
24,DRC (UNDP),2016,DRC-16/HCG10/UR02/WaSH-LOG/NGO/4415,1/24/2018 9:18:06 AM,Internally Displaced People,6355,7700,8723,9528,32306,7566,9040,10508,11568,38682
24,DRC (UNDP),2016,DRC-16/HCG10/UR02/WaSH-LOG/NGO/4415,1/24/2018 9:18:06 AM,Other,6355,7700,8723,9528,32306,7082,8504,9794,10752,36132
24,DRC (UNDP),2016,DRC-16/HCG10/UR02/WaSH-LOG/NGO/4415,1/24/2018 9:18:06 AM,Overall,38223,38223,38223,38226,152895,41251,41572,42685,43326,168834
24,DRC (UNDP),2016,DRC-16/HCG10/UR03/EDU/INGO/4354,2/8/2018 10:06:03 AM,Host Communities,1500,1145,2650,2650,7945,226,1653,1968,1931,5778
24,DRC (UNDP),2016,DRC-16/HCG10/UR03/EDU/INGO/4354,2/8/2018 10:06:03 AM,Internally Displaced People,528,709,1650,1650,4537,528,709,2167,2065,5469
24,DRC (UNDP),2016,DRC-16/HCG10/UR03/EDU/INGO/4354,2/8/2018 10:06:03 AM,Overall,2028,1854,4300,4300,12482,1027,3462,5414,5270,15173
24,DRC (UNDP),2016,DRC-16/HCG10/UR03/EDU/NGO/4395,8/14/2017 3:48:09 PM,Overall,174,85,3654,2646,6559,0,0,0,0,0
24,DRC (UNDP),2016,DRC-16/HCG10/UR03/FSEC/NGO/4385,4/14/2018 1:44:00 PM,Overall,2050,29150,454,141,31795,2050,29150,454,141,31795
24,DRC (UNDP),2016,DRC-16/HCG10/UR03/HLT/INGO/4360,8/16/2017 4:12:44 PM,Host Communities,3765,4035,3600,3600,15000,2425,4382,2409,2384,11600
24,DRC (UNDP),2016,DRC-16/HCG10/UR03/HLT/INGO/4360,8/16/2017 4:12:44 PM,Internally Displaced People,12927,13853,12360,12360,51500,7682,12115,5015,5528,30340
24,DRC (UNDP),2016,DRC-16/HCG10/UR03/HLT/INGO/4360,8/16/2017 4:12:44 PM,Overall,16692,17888,15960,15960,66500,10107,16497,7424,7912,41940
24,DRC (UNDP),2016,DRC-16/HCG10/UR03/HLT-FSEC-PROT/INGO/4402,12/12/2017 11:14:27 AM,Overall,24305,28533,0,0,52838,12417,19576,12003,15429,59425
24,DRC (UNDP),2016,DRC-16/HCG10/UR03/HLT-PROT/INGO/4363,12/14/2017 11:39:16 AM,Host Communities,37694,45994,8273,10096,102057,37694,45994,8273,10096,102057
24,DRC (UNDP),2016,DRC-16/HCG10/UR03/HLT-PROT/INGO/4363,12/14/2017 11:39:16 AM,Internally Displaced People,7686,9349,1687,2052,20774,7686,9349,1687,2052,20774
24,DRC (UNDP),2016,DRC-16/HCG10/UR03/HLT-PROT/INGO/4363,12/14/2017 11:39:16 AM,Overall,45380,55464,9961,12175,122980,45380,55464,9961,12175,122980
24,DRC (UNDP),2016,DRC-16/HCG10/UR03/LOG-PROT/INGO/4401,2/22/2018 11:09:41 AM,Host Communities,500,0,0,0,500,858,0,0,0,858
24,DRC (UNDP),2016,DRC-16/HCG10/UR03/LOG-PROT/INGO/4401,2/22/2018 11:09:41 AM,Other,25,0,0,0,25,29,0,0,0,29
24,DRC (UNDP),2016,DRC-16/HCG10/UR03/LOG-PROT/INGO/4401,2/22/2018 11:09:41 AM,Overall,525,0,0,0,525,887,0,0,0,887
24,DRC (UNDP),2016,DRC-16/HCG10/UR03/MSREF/INGO/4336,2/8/2018 10:01:33 AM,Overall,5604,5604,5604,5604,22416,4902,6721,4291,8423,24337
24,DRC (UNDP),2016,DRC-16/HCG10/UR03/NFI/NGO/4334,10/9/2017 10:08:56 AM,Host Communities,1807,1906,3111,3212,10036,1424,1699,2687,3832,9642
24,DRC (UNDP),2016,DRC-16/HCG10/UR03/NFI/NGO/4334,10/9/2017 10:08:56 AM,Internally Displaced People,3076,3247,5298,5468,17089,2928,3570,8474,8094,23066
24,DRC (UNDP),2016,DRC-16/HCG10/UR03/NFI/NGO/4334,10/9/2017 10:08:56 AM,Overall,4883,5153,8409,8680,27125,4352,5269,11161,11926,32708
24,DRC (UNDP),2016,DRC-16/HCG10/UR03/NFI-FSEC/INGO/4356,8/24/2018 3:18:50 PM,Host Communities,2048,3072,2134,2406,9660,729,597,973,977,3276
24,DRC (UNDP),2016,DRC-16/HCG10/UR03/NFI-FSEC/INGO/4356,8/24/2018 3:18:50 PM,Internally Displaced People,5735,8601,5975,6737,27048,5519,5806,11912,12393,35630
24,DRC (UNDP),2016,DRC-16/HCG10/UR03/NFI-FSEC/INGO/4356,8/24/2018 3:18:50 PM,Other,410,614,426,481,1931,1612,1648,3388,3330,9978
24,DRC (UNDP),2016,DRC-16/HCG10/UR03/NFI-FSEC/INGO/4356,8/24/2018 3:18:50 PM,Overall,8194,12287,8535,9624,38640,7860,8051,16273,16700,48884
24,DRC (UNDP),2016,DRC-16/HCG10/UR03/NFI-FSEC/NGO/4386,8/24/2018 2:15:58 PM,Host Communities,420,1080,1784,3916,7200,420,1080,1784,3916,7200
24,DRC (UNDP),2016,DRC-16/HCG10/UR03/NFI-FSEC/NGO/4386,8/24/2018 2:15:58 PM,Internally Displaced People,6780,9720,16036,32264,64800,6780,9720,16036,32264,64800
24,DRC (UNDP),2016,DRC-16/HCG10/UR03/NFI-FSEC/NGO/4386,8/24/2018 2:15:58 PM,Overall,7200,10800,17820,36180,72000,7200,10800,17820,36180,72000
24,DRC (UNDP),2016,DRC-16/HCG10/UR03/PROT/INGO/4342,2/8/2018 9:52:27 AM,Host Communities,87075,106425,58050,70950,322500,13061,21285,6386,6386,47118
24,DRC (UNDP),2016,DRC-16/HCG10/UR03/PROT/INGO/4342,2/8/2018 9:52:27 AM,Internally Displaced People,29025,35475,19350,23650,107500,4354,7095,6385,2128,19962
24,DRC (UNDP),2016,DRC-16/HCG10/UR03/PROT/INGO/4342,2/8/2018 9:52:27 AM,Overall,146610,179190,97740,119460,543000,21991,35838,10751,10751,79331
24,DRC (UNDP),2016,DRC-16/HCG10/UR03/PROT/NGO/4335,9/20/2017 9:22:17 AM,Overall,0,0,110,90,200,0,0,177,64,241
24,DRC (UNDP),2016,DRC-16/HCG10/UR03/PROT/NGO/4369,8/15/2017 9:22:50 AM,Host Communities,0,0,0,0,0,176,66,356,214,812
24,DRC (UNDP),2016,DRC-16/HCG10/UR03/PROT/NGO/4369,8/15/2017 9:22:50 AM,Overall,80,80,418,225,803,176,66,356,214,812
24,DRC (UNDP),2016,DRC-16/HCG10/UR03/PROT/NGO/8968,4/16/2019 8:59:03 AM,Host Communities,182,137,0,0,319,158,134,1,44,337
24,DRC (UNDP),2016,DRC-16/HCG10/UR03/PROT/NGO/8968,4/16/2019 8:59:03 AM,Internally Displaced People,61,50,0,0,111,46,51,0,9,106
24,DRC (UNDP),2016,DRC-16/HCG10/UR03/PROT/NGO/8968,4/16/2019 8:59:03 AM,Overall,243,187,0,0,430,204,185,1,53,443
24,DRC (UNDP),2016,DRC-16/HCG10/UR03/PROT/NGO/9198,3/6/2019 9:16:13 AM,Host Communities,18596,43391,15846,36962,114795,0,0,0,0,0
24,DRC (UNDP),2016,DRC-16/HCG10/UR03/PROT/NGO/9198,3/6/2019 9:16:13 AM,Internally Displaced People,2206,5121,1874,4352,13553,20790,48509,17727,41322,128348
24,DRC (UNDP),2016,DRC-16/HCG10/UR03/PROT/NGO/9198,3/6/2019 9:16:13 AM,Overall,20802,48512,17720,41314,128348,20802,48512,17720,41314,128348
24,DRC (UNDP),2016,DRC-16/HCG10/UR03/PROT-HLT/INGO/4349,8/24/2018 3:08:23 PM,Overall,6226,8878,6516,7877,29497,4216,10666,4879,5497,25258
24,DRC (UNDP),2016,DRC-16/HCG10/UR03/WaSH/INGO/4403,10/16/2017 3:44:58 PM,Overall,18900,21600,22500,27000,90000,16522,18940,19609,23195,78266
24,DRC (UNDP),2016,DRC-16/HCG10/UR03/WaSH/NGO/4391,8/24/2018 3:03:43 PM,Host Communities,2624,3672,4373,6822,17491,2624,3672,4373,6822,17491
24,DRC (UNDP),2016,DRC-16/HCG10/UR03/WaSH/NGO/4391,8/24/2018 3:03:43 PM,Internally Displaced People,1093,1531,1823,2842,7289,1958,2398,2688,3705,10749
24,DRC (UNDP),2016,DRC-16/HCG10/UR03/WaSH/NGO/4391,8/24/2018 3:03:43 PM,Other,656,918,1093,1706,4373,656,918,1093,1706,4373
24,DRC (UNDP),2016,DRC-16/HCG10/UR03/WaSH/NGO/4391,8/24/2018 3:03:43 PM,Overall,9545,6818,11364,17727,45454,9260,11428,11708,16518,48914
24,DRC (UNDP),2016,DRC-16/HCG10/UR03/WaSH/NGO/4397,11/9/2017 1:36:39 PM,Overall,5453,6831,11618,13556,37458,5098,6227,13771,13015,38111
24,DRC (UNDP),2016,DRC-16/HCG10/UR03/WaSH/NGO/4418,2/8/2018 10:11:32 AM,Host Communities,2395,3248,2346,3263,11252,2174,3108,1915,2797,9994
24,DRC (UNDP),2016,DRC-16/HCG10/UR03/WaSH/NGO/4418,2/8/2018 10:11:32 AM,Internally Displaced People,5691,7323,5697,7737,26448,7520,8912,9281,9729,35442
24,DRC (UNDP),2016,DRC-16/HCG10/UR03/WaSH/NGO/4418,2/8/2018 10:11:32 AM,Overall,8086,10571,8043,11000,37700,9694,12020,11196,12526,45436
24,DRC (UNDP),2017,DRC-17/HCG10/PU1/LOG/UN/6293,1/18/2019 8:20:00 AM,Overall,15,0,0,0,15,0,0,0,0,0
24,DRC (UNDP),2017,DRC-17/HCG10/PU1/LOG-PROT/INGO/6284,5/9/2018 3:29:32 PM,Overall,1208,1177,250,150,2785,1183,2043,705,1219,5150
24,DRC (UNDP),2017,DRC-17/HCG10/PU1/PROT/NGO/6881,8/24/2018 12:15:02 PM,Host Communities,2270,2460,1858,2012,8600,3800,3500,2714,2603,12617
24,DRC (UNDP),2017,DRC-17/HCG10/PU1/PROT/NGO/6881,8/24/2018 12:15:02 PM,Internally Displaced People,6358,6356,5202,5636,23552,9522,8813,6834,6556,31725
24,DRC (UNDP),2017,DRC-17/HCG10/PU1/PROT/NGO/6881,8/24/2018 12:15:02 PM,Other,454,492,370,402,1718,704,648,503,1105,2960
24,DRC (UNDP),2017,DRC-17/HCG10/PU1/PROT/NGO/6881,8/24/2018 12:15:02 PM,Overall,9082,9838,7430,8050,34400,14681,13413,10274,9866,48234
24,DRC (UNDP),2017,DRC-17/HCG10/ST1/HLT-PROT-EDU/INGO/5850,12/20/2019 1:52:39 PM,Overall,1245,2816,6064,9203,19328,2842,4284,5247,7645,20018
24,DRC (UNDP),2017,DRC-17/HCG10/ST1/LOG-WaSH-PROT/NGO/5849,10/22/2019 1:59:04 PM,Host Communities,1120,1550,1250,1200,5120,2103,1420,927,1002,5452
24,DRC (UNDP),2017,DRC-17/HCG10/ST1/LOG-WaSH-PROT/NGO/5849,10/22/2019 1:59:04 PM,Overall,1120,1550,1250,1200,5120,2103,1420,927,1002,5452
24,DRC (UNDP),2017,DRC-17/HCG10/ST1/NUT-PROT-WaSH-FSEC/INGO/5702,10/22/2019 2:33:47 PM,Overall,7275,16464,10112,10234,44085,3114,19279,3603,3648,29644
24,DRC (UNDP),2017,DRC-17/HCG10/UR1/EDU/INGO/5564,2/14/2018 10:46:22 AM,Host Communities,859,859,1890,1890,5498,1172,1074,2242,2140,6628
24,DRC (UNDP),2017,DRC-17/HCG10/UR1/EDU/INGO/5564,2/14/2018 10:46:22 AM,Internally Displaced People,700,700,6300,6300,14000,641,547,5345,5001,11534
24,DRC (UNDP),2017,DRC-17/HCG10/UR1/EDU/INGO/5564,2/14/2018 10:46:22 AM,Overall,1559,1559,8190,8190,19498,1813,1621,7587,7141,18162
24,DRC (UNDP),2017,DRC-17/HCG10/UR1/NFI/NGO/5710,1/11/2018 1:21:41 PM,Overall,4200,6800,13620,15380,40000,5467,3759,13774,16329,39329
24,DRC (UNDP),2017,DRC-17/HCG10/UR1/PROT/NGO/5605,1/23/2018 1:29:14 PM,Overall,0,0,18765,12530,31295,0,0,13681,11999,25680
24,DRC (UNDP),2017,DRC-17/HCG10/UR1/PROT/NGO/5697,1/16/2019 9:28:06 AM,Other,0,0,0,0,0,10,13,6,9,38
24,DRC (UNDP),2017,DRC-17/HCG10/UR1/PROT/NGO/5697,1/16/2019 9:28:06 AM,Overall,592,441,172,163,1368,592,441,172,163,1368
24,DRC (UNDP),2017,DRC-17/HCG10/UR1/WaSH/NGO/5695,2/26/2018 11:54:33 AM,Internally Displaced People,4140,8080,9152,11020,32392,7440,11099,8213,9669,36421
24,DRC (UNDP),2017,DRC-17/HCG10/UR1/WaSH/NGO/5695,2/26/2018 11:54:33 AM,Overall,4180,8110,9152,11020,32462,7480,11129,8213,9669,36491
24,DRC (UNDP),2017,DRC-17/HCG10/UR2/EDU-PROT/INGO/6653,9/4/2018 2:23:31 PM,Overall,580,440,10000,10000,21020,684,884,8903,9684,20155
24,DRC (UNDP),2017,DRC-17/HCG10/UR2/EDU-PROT/NGO/6687,8/24/2018 12:01:00 PM,Overall,369,363,4800,4800,10332,396,368,5485,4250,10499
24,DRC (UNDP),2017,DRC-17/HCG10/UR2/PROT/INGO/6656,1/11/2019 2:57:50 PM,Overall,0,0,1978,1574,3552,0,0,1911,1641,3552
24,DRC (UNDP),2017,DRC-17/HCG10/UR3/NUT/UN/7443,1/21/2019 8:10:38 AM,Overall,0,0,32160,34840,67000,0,0,32160,34840,67000
24,DRC (UNDP),2017,DRC-17/HCG10/UR4/LOG/UN/7405,10/11/2018 3:08:29 PM,Other,600,600,0,0,1200,0,0,0,0,0
24,DRC (UNDP),2017,DRC-17/HCG10/UR4/LOG/UN/7405,10/11/2018 3:08:29 PM,Overall,600,600,0,0,1200,106,106,0,0,212
24,DRC (UNDP),2017,DRC-17/HCG10/UR5/FSEC/INGO/7431,9/24/2018 11:18:17 AM,Overall,2772,3828,2904,3696,13200,1690,2366,4683,4227,12966
24,DRC (UNDP),2017,DRC-17/HCG10/UR5/FSEC/INGO/7465,8/24/2018 1:35:54 PM,Overall,1760,2640,0,0,4400,1760,2640,0,0,4400
24,DRC (UNDP),2017,DRC-17/HCG10/UR5/FSEC/INGO/7466,11/13/2018 2:52:52 PM,Host Communities,1181,1279,1558,1982,6000,0,0,0,0,0
24,DRC (UNDP),2017,DRC-17/HCG10/UR5/FSEC/INGO/7466,11/13/2018 2:52:52 PM,Internally Displaced People,590,640,779,991,3000,0,0,0,0,0
24,DRC (UNDP),2017,DRC-17/HCG10/UR5/FSEC/INGO/7466,11/13/2018 2:52:52 PM,Other,2362,2558,3115,3965,12000,0,0,0,0,0
24,DRC (UNDP),2017,DRC-17/HCG10/UR5/FSEC/INGO/7466,11/13/2018 2:52:52 PM,Overall,5166,5597,6815,8672,26250,9185,10908,3339,3660,27092
24,DRC (UNDP),2017,DRC-17/HCG10/UR5/FSEC/INGO/7466,11/13/2018 2:52:52 PM,Refugees,1033,1119,1363,1734,5249,0,0,0,0,0
24,DRC (UNDP),2017,DRC-17/HCG10/UR5/FSEC/INGO/7526,8/14/2018 4:16:11 PM,Host Communities,936,1890,360,396,3582,738,1822,8207,7723,18490
24,DRC (UNDP),2017,DRC-17/HCG10/UR5/FSEC/INGO/7526,8/14/2018 4:16:11 PM,Internally Displaced People,3744,7650,1440,1584,14418,127,313,1415,1337,3192
24,DRC (UNDP),2017,DRC-17/HCG10/UR5/FSEC/INGO/7526,8/14/2018 4:16:11 PM,Overall,4680,9540,1800,1980,18000,865,2135,9622,9060,21682
24,DRC (UNDP),2017,DRC-17/HCG10/UR5/FSEC/INGO/7543,10/8/2018 6:30:16 PM,Host Communities,1506,3513,0,0,5019,1959,4572,1669,3895,12095
24,DRC (UNDP),2017,DRC-17/HCG10/UR5/FSEC/INGO/7543,10/8/2018 6:30:16 PM,Internally Displaced People,1702,3972,2733,6376,14783,1249,2913,1064,2481,7707
24,DRC (UNDP),2017,DRC-17/HCG10/UR5/FSEC/INGO/7543,10/8/2018 6:30:16 PM,Overall,3208,7485,2733,6376,19802,3208,7485,2733,6376,19802
24,DRC (UNDP),2017,DRC-17/HCG10/UR5/FSEC/INGO/7559,8/24/2018 3:22:03 PM,Host Communities,1593,1593,1593,1593,6372,1321,2168,4391,4737,12617
24,DRC (UNDP),2017,DRC-17/HCG10/UR5/FSEC/INGO/7559,8/24/2018 3:22:03 PM,Internally Displaced People,1593,1593,1593,1593,6372,1129,1508,510,2615,5762
24,DRC (UNDP),2017,DRC-17/HCG10/UR5/FSEC/INGO/7559,8/24/2018 3:22:03 PM,Overall,3982,3982,3981,3982,15927,2450,3676,4901,7352,18379
24,DRC (UNDP),2017,DRC-17/HCG10/UR5/FSEC/INGO/7559,8/24/2018 3:22:03 PM,Refugees,796,796,795,796,3183,0,0,0,0,0
24,DRC (UNDP),2017,DRC-17/HCG10/UR5/FSEC/NGO/7428,7/28/2018 3:11:44 PM,Host Communities,150,260,1265,1265,2940,150,260,1265,1265,2940
24,DRC (UNDP),2017,DRC-17/HCG10/UR5/FSEC/NGO/7428,7/28/2018 3:11:44 PM,Internally Displaced People,850,1540,4935,6535,13860,850,1540,4936,6536,13862
24,DRC (UNDP),2017,DRC-17/HCG10/UR5/FSEC/NGO/7428,7/28/2018 3:11:44 PM,Overall,1000,1800,6200,7800,16800,1000,1800,6200,7800,16800
24,DRC (UNDP),2017,DRC-17/HCG10/UR5/FSEC/NGO/7486,8/24/2018 2:51:48 PM,Host Communities,840,1240,760,1160,4000,840,1240,760,1160,4000
24,DRC (UNDP),2017,DRC-17/HCG10/UR5/FSEC/NGO/7486,8/24/2018 2:51:48 PM,Internally Displaced People,340,495,300,465,1600,340,495,300,465,1600
24,DRC (UNDP),2017,DRC-17/HCG10/UR5/FSEC/NGO/7486,8/24/2018 2:51:48 PM,Other,504,774,456,696,2430,504,774,456,666,2400
24,DRC (UNDP),2017,DRC-17/HCG10/UR5/FSEC/NGO/7486,8/24/2018 2:51:48 PM,Overall,12000,12960,11040,12000,48000,12000,12960,11040,12000,48000
24,DRC (UNDP),2017,DRC-17/HCG10/UR5/FSEC/NGO/7498,8/29/2018 1:38:08 PM,Host Communities,3271,3605,2006,2315,11197,1284,1287,2341,2273,7185
24,DRC (UNDP),2017,DRC-17/HCG10/UR5/FSEC/NGO/7498,8/29/2018 1:38:08 PM,Internally Displaced People,3549,4115,2558,2831,13053,3200,3270,5783,5675,17928
24,DRC (UNDP),2017,DRC-17/HCG10/UR5/FSEC/NGO/7498,8/29/2018 1:38:08 PM,Overall,6820,7720,4564,5146,24250,4484,4557,8124,7948,25113
24,DRC (UNDP),2017,DRC-17/HCG10/UR5/FSEC/NGO/7500,9/20/2018 5:25:58 PM,Overall,3120,5280,5040,7560,21000,3120,5280,5040,7560,21000
24,DRC (UNDP),2017,DRC-17/HCG10/UR5/FSEC/NGO/7506,8/29/2018 1:48:28 PM,Host Communities,1078,1797,1797,2517,7189,2008,2494,1964,2437,8903
24,DRC (UNDP),2017,DRC-17/HCG10/UR5/FSEC/NGO/7506,8/29/2018 1:48:28 PM,Internally Displaced People,943,1572,1572,2200,6287,1918,2602,1937,2630,9087
24,DRC (UNDP),2017,DRC-17/HCG10/UR5/FSEC/NGO/7506,8/29/2018 1:48:28 PM,Other,2017,3364,3364,4702,13447,2209,2704,2059,2417,9389
24,DRC (UNDP),2017,DRC-17/HCG10/UR5/FSEC/NGO/7506,8/29/2018 1:48:28 PM,Overall,4038,6733,6733,9419,26923,4233,6749,6825,9572,27379
24,DRC (UNDP),2017,DRC-17/HCG10/UR5/FSEC/NGO/7542,7/30/2018 3:30:32 PM,Overall,2700,2927,2395,3300,11322,2762,3151,2564,3367,11844
24,DRC (UNDP),2017,DRC-17/HCG10/UR5/HLT/INGO/7482,9/26/2018 8:37:16 AM,Host Communities,9120,9882,2215,2215,23432,8078,12988,4397,6299,31762
24,DRC (UNDP),2017,DRC-17/HCG10/UR5/HLT/INGO/7482,9/26/2018 8:37:16 AM,Internally Displaced People,5711,6184,1386,1386,14667,3891,7217,2168,2518,15794
24,DRC (UNDP),2017,DRC-17/HCG10/UR5/HLT/INGO/7482,9/26/2018 8:37:16 AM,Overall,14831,16066,3601,3601,38099,11969,20205,6565,8817,47556
24,DRC (UNDP),2017,DRC-17/HCG10/UR5/HLT/NGO/7439,8/28/2018 9:01:01 AM,Host Communities,161,1290,1808,2054,5313,243,1382,1958,2130,5713
24,DRC (UNDP),2017,DRC-17/HCG10/UR5/HLT/NGO/7439,8/28/2018 9:01:01 AM,Internally Displaced People,375,3010,4219,4794,12398,479,3136,4501,4881,12997
24,DRC (UNDP),2017,DRC-17/HCG10/UR5/HLT/NGO/7439,8/28/2018 9:01:01 AM,Overall,536,4300,6027,6848,17711,722,4518,6459,7011,18710
24,DRC (UNDP),2017,DRC-17/HCG10/UR5/LOG/INGO/7426,10/4/2018 9:36:00 AM,Overall,4320,2880,17640,18360,43200,2960,4539,0,0,7499
24,DRC (UNDP),2017,DRC-17/HCG10/UR5/LOG/INGO/7448,11/14/2018 8:51:13 AM,Overall,368,32,0,0,400,653,230,0,0,883
24,DRC (UNDP),2017,DRC-17/HCG10/UR5/NFI/INGO/7432,1/10/2020 9:19:03 AM,Overall,10186,10186,15279,15279,50930,10861,10861,16291,16292,54305
24,DRC (UNDP),2017,DRC-17/HCG10/UR5/NFI/NGO/7430,6/25/2018 10:03:28 AM,Host Communities,3704,14818,76,302,18900,3502,15175,1401,3269,23347
24,DRC (UNDP),2017,DRC-17/HCG10/UR5/NFI/NGO/7430,6/25/2018 10:03:28 AM,Internally Displaced People,8644,34574,176,706,44100,5948,25775,2380,5551,39654
24,DRC (UNDP),2017,DRC-17/HCG10/UR5/NFI/NGO/7430,6/25/2018 10:03:28 AM,Overall,12348,49392,252,1008,63000,3320,39786,2842,17052,63000
24,DRC (UNDP),2017,DRC-17/HCG10/UR5/NFI/NGO/7451,8/14/2018 1:34:36 PM,Host Communities,580,960,1364,1096,4000,580,960,1364,1096,4000
24,DRC (UNDP),2017,DRC-17/HCG10/UR5/NFI/NGO/7451,8/14/2018 1:34:36 PM,Internally Displaced People,5220,8640,12276,9864,36000,5220,8640,12276,9864,36000
24,DRC (UNDP),2017,DRC-17/HCG10/UR5/NFI/NGO/7451,8/14/2018 1:34:36 PM,Overall,5800,9600,13640,10960,40000,5800,9600,13640,10960,40000
24,DRC (UNDP),2017,DRC-17/HCG10/UR5/NUT/INGO/7508,10/4/2018 10:35:34 AM,Host Communities,0,0,800,960,1760,0,0,0,0,0
24,DRC (UNDP),2017,DRC-17/HCG10/UR5/NUT/INGO/7508,10/4/2018 10:35:34 AM,Internally Displaced People,0,0,1200,1440,2640,0,0,0,0,0
24,DRC (UNDP),2017,DRC-17/HCG10/UR5/NUT/INGO/7508,10/4/2018 10:35:34 AM,Overall,0,0,2000,2400,4400,0,0,663,1668,2331
24,DRC (UNDP),2017,DRC-17/HCG10/UR5/PROT/INGO/7438,7/4/2018 2:05:16 PM,Host Communities,596,674,780,853,2903,381,502,405,558,1846
24,DRC (UNDP),2017,DRC-17/HCG10/UR5/PROT/INGO/7438,7/4/2018 2:05:16 PM,Internally Displaced People,313,496,401,515,1725,794,912,1109,856,3671
24,DRC (UNDP),2017,DRC-17/HCG10/UR5/PROT/INGO/7438,7/4/2018 2:05:16 PM,Other,30,20,24,16,90,131,257,168,180,736
24,DRC (UNDP),2017,DRC-17/HCG10/UR5/PROT/INGO/7438,7/4/2018 2:05:16 PM,Overall,939,1190,1205,1384,4718,1306,1671,1682,1594,6253
24,DRC (UNDP),2017,DRC-17/HCG10/UR5/PROT/INGO/7568,1/22/2019 12:51:46 PM,Host Communities,12000,14000,16000,16000,58000,12926,7007,32135,20204,72272
24,DRC (UNDP),2017,DRC-17/HCG10/UR5/PROT/INGO/7568,1/22/2019 12:51:46 PM,Internally Displaced People,13000,12000,14000,14000,53000,6463,4231,15795,10286,36775
24,DRC (UNDP),2017,DRC-17/HCG10/UR5/PROT/INGO/7568,1/22/2019 12:51:46 PM,Other,0,0,0,0,0,2154,1983,6536,6245,16918
24,DRC (UNDP),2017,DRC-17/HCG10/UR5/PROT/INGO/7568,1/22/2019 12:51:46 PM,Overall,25000,26000,30000,30000,111000,21453,13221,54466,36735,125875
24,DRC (UNDP),2017,DRC-17/HCG10/UR5/PROT/NGO/7470,8/14/2018 12:48:32 PM,Host Communities,140,123,30,29,322,275,143,37,62,517
24,DRC (UNDP),2017,DRC-17/HCG10/UR5/PROT/NGO/7470,8/14/2018 12:48:32 PM,Internally Displaced People,152,115,30,41,338,51,60,18,15,144
24,DRC (UNDP),2017,DRC-17/HCG10/UR5/PROT/NGO/7470,8/14/2018 12:48:32 PM,Overall,292,238,60,70,660,382,207,55,77,721
24,DRC (UNDP),2017,DRC-17/HCG10/UR5/WaSH/INGO/7547,7/2/2020 9:31:18 AM,Host Communities,2520,2880,3000,3600,12000,44975,49953,61966,65147,222041
24,DRC (UNDP),2017,DRC-17/HCG10/UR5/WaSH/INGO/7547,7/2/2020 9:31:18 AM,Overall,25064,28644,29838,35806,119352,44975,49953,61966,65147,222041
24,DRC (UNDP),2017,DRC-17/HCG10/UR5/WaSH/NGO/7433,8/27/2018 11:17:24 AM,Host Communities,3857,5142,10606,12536,32141,2845,3077,16094,17132,39148
24,DRC (UNDP),2017,DRC-17/HCG10/UR5/WaSH/NGO/7433,8/27/2018 11:17:24 AM,Internally Displaced People,3737,4983,10277,12145,31142,1744,1891,9888,10712,24235
24,DRC (UNDP),2017,DRC-17/HCG10/UR5/WaSH/NGO/7433,8/27/2018 11:17:24 AM,Overall,7594,10125,20883,24681,63283,4589,4968,25982,27844,63383
24,DRC (UNDP),2017,DRC-17/HCG10/UR5/WaSH/NGO/7462,8/29/2018 1:44:15 PM,Host Communities,690,748,748,810,2996,690,748,748,810,2996
24,DRC (UNDP),2017,DRC-17/HCG10/UR5/WaSH/NGO/7462,8/29/2018 1:44:15 PM,Overall,6903,7478,7478,8101,29960,6903,7478,7478,8101,29960
24,DRC (UNDP),2017,DRC-17/HCG10/UR5/WaSH/NGO/7511,7/12/2018 9:59:39 AM,Host Communities,1797,2196,2795,3195,9983,3444,4659,5673,6483,20259
24,DRC (UNDP),2017,DRC-17/HCG10/UR5/WaSH/NGO/7511,7/12/2018 9:59:39 AM,Internally Displaced People,7187,8785,11181,12778,39931,6314,8543,10399,11885,37141
24,DRC (UNDP),2017,DRC-17/HCG10/UR5/WaSH/NGO/7511,7/12/2018 9:59:39 AM,Other,2995,3661,4659,5324,16639,1722,2330,2836,3241,10129
24,DRC (UNDP),2017,DRC-17/HCG10/UR5/WaSH/NGO/7511,7/12/2018 9:59:39 AM,Overall,11979,14642,18635,21297,66553,11480,15532,18908,21609,67529
24,DRC (UNDP),2018,DRC-18/HCG10/PU1/HLT/INGO/10116,7/19/2019 11:18:03 AM,Host Communities,1016,739,47,46,1848,566,510,88,59,1223
24,DRC (UNDP),2018,DRC-18/HCG10/PU1/HLT/INGO/10116,7/19/2019 11:18:03 AM,Overall,1016,739,47,46,1848,566,510,88,59,1223
24,DRC (UNDP),2018,DRC-18/HCG10/PU1/HLT/NGO/10136,6/10/2019 9:57:10 AM,Overall,31042,35228,64153,64429,194852,65958,75377,124551,127525,393411
24,DRC (UNDP),2018,DRC-18/HCG10/PU1/WaSH/INGO/10079,7/4/2019 9:37:28 AM,Host Communities,14184,17020,31204,32149,94557,67436,80923,148360,152856,449575
24,DRC (UNDP),2018,DRC-18/HCG10/PU1/WaSH/INGO/10079,7/4/2019 9:37:28 AM,Overall,14184,17020,31204,32149,94557,67436,80923,148360,152856,449575
24,DRC (UNDP),2018,DRC-18/HCG10/PU1/WaSH/INGO/10124,2/7/2019 12:40:08 PM,Host Communities,3100,3358,3564,4018,14040,101261,114192,118868,134063,468384
24,DRC (UNDP),2018,DRC-18/HCG10/PU1/WaSH/INGO/10124,2/7/2019 12:40:08 PM,Overall,3100,3358,3564,4018,14040,101261,114192,118876,134055,468384
24,DRC (UNDP),2018,DRC-18/HCG10/PU1/WaSH/INGO/10128,4/1/2019 2:12:31 PM,Host Communities,2824,3956,5534,6285,18599,12313,10677,6785,7486,37261
24,DRC (UNDP),2018,DRC-18/HCG10/PU1/WaSH/INGO/10128,4/1/2019 2:12:31 PM,Internally Displaced People,1883,2637,3690,4191,12401,2673,2499,1696,1872,8740
24,DRC (UNDP),2018,DRC-18/HCG10/PU1/WaSH/INGO/10128,4/1/2019 2:12:31 PM,Overall,4707,6593,9224,10476,31000,14986,13176,8481,9358,46001
24,DRC (UNDP),2018,DRC-18/HCG10/PU1/WaSH/NGO/10132,5/15/2019 12:19:11 PM,Host Communities,648,964,974,1453,4039,648,964,974,1453,4039
24,DRC (UNDP),2018,DRC-18/HCG10/PU1/WaSH/NGO/10132,5/15/2019 12:19:11 PM,Internally Displaced People,208,311,314,469,1302,208,311,314,469,1302
24,DRC (UNDP),2018,DRC-18/HCG10/PU1/WaSH/NGO/10132,5/15/2019 12:19:11 PM,Other,187,280,283,423,1173,187,280,283,423,1173
24,DRC (UNDP),2018,DRC-18/HCG10/PU1/WaSH/NGO/10132,5/15/2019 12:19:11 PM,Overall,1043,1555,1571,2345,6514,1043,1555,1571,2345,6514
24,DRC (UNDP),2018,DRC-18/HCG10/PU2/FSEC-NFI/INGO/10898,11/6/2019 3:13:27 PM,Host Communities,1680,1860,1140,1320,6000,2560,2664,4981,4738,14943
24,DRC (UNDP),2018,DRC-18/HCG10/PU2/FSEC-NFI/INGO/10898,11/6/2019 3:13:27 PM,Internally Displaced People,3920,4340,2660,3080,14000,1008,1069,2063,1959,6099
24,DRC (UNDP),2018,DRC-18/HCG10/PU2/FSEC-NFI/INGO/10898,11/6/2019 3:13:27 PM,Overall,5600,6200,3800,4400,20000,3568,3733,7044,6697,21042
24,DRC (UNDP),2018,DRC-18/HCG10/PU2/LOG/NGO/10924,8/5/2019 2:06:05 PM,Host Communities,542,342,108,85,1077,237,68,97,29,431
24,DRC (UNDP),2018,DRC-18/HCG10/PU2/LOG/NGO/10924,8/5/2019 2:06:05 PM,Internally Displaced People,541,342,109,86,1078,355,101,145,43,644
24,DRC (UNDP),2018,DRC-18/HCG10/PU2/LOG/NGO/10924,8/5/2019 2:06:05 PM,Overall,1083,684,217,171,2155,592,169,242,72,1075
24,DRC (UNDP),2018,DRC-18/HCG10/PU2/NUT-HLT/INGO/10902,10/15/2019 12:02:54 PM,Host Communities,1010,1203,1790,1790,5793,902,923,1237,1253,4315
24,DRC (UNDP),2018,DRC-18/HCG10/PU2/NUT-HLT/INGO/10902,10/15/2019 12:02:54 PM,Internally Displaced People,2052,2441,3633,3633,11759,1831,1874,2511,2544,8760
24,DRC (UNDP),2018,DRC-18/HCG10/PU2/NUT-HLT/INGO/10902,10/15/2019 12:02:54 PM,Overall,3062,3644,5423,5423,17552,2733,2797,3748,3797,13075
24,DRC (UNDP),2018,DRC-18/HCG10/PU2/PROT/NGO/10934,1/9/2020 1:19:26 PM,Overall,7920,12760,4280,5040,30000,8010,12797,4871,4753,30431
24,DRC (UNDP),2018,DRC-18/HCG10/PU2/WaSH/INGO/10909,7/18/2019 10:06:06 AM,Host Communities,609,1030,999,1487,4125,1867,2704,2933,4155,11659
24,DRC (UNDP),2018,DRC-18/HCG10/PU2/WaSH/INGO/10909,7/18/2019 10:06:06 AM,Internally Displaced People,2436,4120,3996,5848,16400,1829,2206,2520,3711,10266
24,DRC (UNDP),2018,DRC-18/HCG10/PU2/WaSH/INGO/10909,7/18/2019 10:06:06 AM,Overall,3045,5150,4995,7435,20625,3696,4910,5453,7866,21925
24,DRC (UNDP),2018,DRC-18/HCG10/PU3/HLT-PROT/NGO/10899,12/20/2019 5:09:17 PM,Overall,4085,5000,7462,7143,23690,3980,5289,7345,7468,24082
24,DRC (UNDP),2018,DRC-18/HCG10/PU3/HLT-PROT/NGO/10899,12/20/2019 5:09:17 PM,Returnees,1000,3360,5015,4845,14220,3980,5289,7345,7468,24082
24,DRC (UNDP),2018,DRC-18/HCG10/PU3/PROT-WaSH/NGO/10904,11/6/2019 1:54:12 PM,Internally Displaced People,4264,5212,6396,7818,23690,4666,5891,6620,7901,25078
24,DRC (UNDP),2018,DRC-18/HCG10/PU3/PROT-WaSH/NGO/10904,11/6/2019 1:54:12 PM,Overall,4264,5212,6396,7818,23690,4666,5891,6620,7901,25078
24,DRC (UNDP),2018,DRC-18/HCG10/RA11/LOG/INGO/11429,10/22/2019 2:35:00 PM,Overall,10,0,0,0,10,12,0,0,0,12
24,DRC (UNDP),2018,DRC-18/HCG10/RA11/LOG/NGO/11425,5/13/2020 6:35:13 PM,Host Communities,3547,4256,4611,5320,17734,3652,4465,4707,5413,18237
24,DRC (UNDP),2018,DRC-18/HCG10/RA11/LOG/NGO/11425,5/13/2020 6:35:13 PM,Internally Displaced People,1324,1589,1721,1986,6620,1338,1602,1752,2281,6973
24,DRC (UNDP),2018,DRC-18/HCG10/RA11/LOG/NGO/11425,5/13/2020 6:35:13 PM,Other,2846,3415,3700,4269,14230,2871,3501,3780,4381,14533
24,DRC (UNDP),2018,DRC-18/HCG10/RA11/LOG/NGO/11425,5/13/2020 6:35:13 PM,Overall,7717,9260,10032,11575,38584,7861,9568,10239,12075,39743
24,DRC (UNDP),2018,DRC-18/HCG10/RA11/LOG/NGO/11426,1/28/2020 9:51:13 AM,Host Communities,0,0,0,0,0,54,39,0,0,93
24,DRC (UNDP),2018,DRC-18/HCG10/RA11/LOG/NGO/11426,1/28/2020 9:51:13 AM,Internally Displaced People,0,0,0,0,0,40,31,0,0,71
24,DRC (UNDP),2018,DRC-18/HCG10/RA11/LOG/NGO/11426,1/28/2020 9:51:13 AM,Overall,120,87,0,0,207,120,87,0,0,207
24,DRC (UNDP),2018,DRC-18/HCG10/RA11/LOG/NGO/11426,1/28/2020 9:51:13 AM,Refugees,0,0,0,0,0,26,17,0,0,43
24,DRC (UNDP),2018,DRC-18/HCG10/ST1/EDU-LOG/INGO/9813,2/17/2021 11:21:56 AM,Host Communities,4746,4344,5295,5295,19680,4746,4344,5296,5296,19682
24,DRC (UNDP),2018,DRC-18/HCG10/ST1/EDU-LOG/INGO/9813,2/17/2021 11:21:56 AM,Internally Displaced People,1186,1086,1324,1324,4920,1186,1086,1323,1323,4918
24,DRC (UNDP),2018,DRC-18/HCG10/ST1/EDU-LOG/INGO/9813,2/17/2021 11:21:56 AM,Overall,5932,5430,6619,6619,24600,5932,5430,6619,6619,24600
24,DRC (UNDP),2018,DRC-18/HCG10/ST1/EDU-PROT/NGO/10475,2/17/2021 10:51:18 AM,Host Communities,12500,12500,21000,21000,67000,13917,11620,13562,10452,49551
24,DRC (UNDP),2018,DRC-18/HCG10/ST1/EDU-PROT/NGO/10475,2/17/2021 10:51:18 AM,Internally Displaced People,2500,2500,250,250,5500,11488,8956,7868,9070,37382
24,DRC (UNDP),2018,DRC-18/HCG10/ST1/EDU-PROT/NGO/10475,2/17/2021 10:51:18 AM,Overall,15000,15000,21250,21250,72500,25405,20576,21430,19522,86933
24,DRC (UNDP),2018,DRC-18/HCG10/ST1/FSEC/INGO/10463,2/24/2021 11:10:17 AM,Overall,5373,12537,4578,10680,33168,9597,9195,8176,7833,34801
24,DRC (UNDP),2018,DRC-18/HCG10/ST1/FSEC-PROT/NGO/9893,10/29/2020 8:22:39 AM,Overall,4655,5145,7105,7595,24500,15246,10315,10946,15710,52217
24,DRC (UNDP),2018,DRC-18/HCG10/ST1/HLT/INGO/10148,1/25/2021 10:05:40 PM,Other,4855,5366,7410,7920,25551,4581,7169,10081,11373,33204
24,DRC (UNDP),2018,DRC-18/HCG10/ST1/HLT/INGO/10148,1/25/2021 10:05:40 PM,Overall,4855,5366,7410,7920,25551,4581,7169,10081,11373,33204
24,DRC (UNDP),2018,DRC-18/HCG10/ST1/WaSH-NFI/INGO/10378,3/9/2021 5:24:02 PM,Host Communities,578,1350,493,1150,3571,5783,13495,4927,11495,35700
24,DRC (UNDP),2018,DRC-18/HCG10/ST1/WaSH-NFI/INGO/10378,3/9/2021 5:24:02 PM,Internally Displaced People,1156,2700,986,2300,7142,0,0,0,0,0
24,DRC (UNDP),2018,DRC-18/HCG10/ST1/WaSH-NFI/INGO/10378,3/9/2021 5:24:02 PM,Other,4049,9445,3448,8045,24987,0,0,0,0,0
24,DRC (UNDP),2018,DRC-18/HCG10/ST1/WaSH-NFI/INGO/10378,3/9/2021 5:24:02 PM,Overall,5783,13495,4927,11495,35700,5783,13495,4927,11495,35700
24,DRC (UNDP),2018,DRC-18/HCG10/ST1/WaSH-NFI/INGO/9851,9/8/2020 2:26:18 PM,Host Communities,3724,4116,5684,6076,19600,3758,5748,7579,8146,25231
24,DRC (UNDP),2018,DRC-18/HCG10/ST1/WaSH-NFI/INGO/9851,9/8/2020 2:26:18 PM,Internally Displaced People,931,1029,1421,1519,4900,880,1834,1856,2558,7128
24,DRC (UNDP),2018,DRC-18/HCG10/ST1/WaSH-NFI/INGO/9851,9/8/2020 2:26:18 PM,Overall,4655,5145,7105,7595,24500,4638,7582,9435,10704,32359
24,DRC (UNDP),2018,DRC-18/HCG10/UR1/EDU/INGO/8789,1/22/2019 3:49:09 PM,Host Communities,166,97,679,443,1385,166,97,679,443,1385
24,DRC (UNDP),2018,DRC-18/HCG10/UR1/EDU/INGO/8789,1/22/2019 3:49:09 PM,Internally Displaced People,83,49,339,221,692,83,49,339,221,692
24,DRC (UNDP),2018,DRC-18/HCG10/UR1/EDU/INGO/8789,1/22/2019 3:49:09 PM,Other,28,16,113,74,231,28,16,113,74,231
24,DRC (UNDP),2018,DRC-18/HCG10/UR1/EDU/INGO/8789,1/22/2019 3:49:09 PM,Overall,277,162,1131,738,2308,277,162,1045,824,2308
24,DRC (UNDP),2018,DRC-18/HCG10/UR1/EDU/INGO/8804,1/21/2019 1:54:24 PM,Host Communities,0,0,1850,2025,3875,0,0,1890,2310,4200
24,DRC (UNDP),2018,DRC-18/HCG10/UR1/EDU/INGO/8804,1/21/2019 1:54:24 PM,Internally Displaced People,0,0,1369,1756,3125,0,0,1006,1094,2100
24,DRC (UNDP),2018,DRC-18/HCG10/UR1/EDU/INGO/8804,1/21/2019 1:54:24 PM,Other,0,0,0,0,0,0,0,315,385,700
24,DRC (UNDP),2018,DRC-18/HCG10/UR1/EDU/INGO/8804,1/21/2019 1:54:24 PM,Overall,0,0,3219,3781,7000,0,0,3150,3850,7000
24,DRC (UNDP),2018,DRC-18/HCG10/UR1/EDU/INGO/8908,1/11/2019 2:54:59 PM,Host Communities,39,10,560,560,1169,0,0,0,0,0
24,DRC (UNDP),2018,DRC-18/HCG10/UR1/EDU/INGO/8908,1/11/2019 2:54:59 PM,Internally Displaced People,0,0,490,490,980,0,0,0,0,0
24,DRC (UNDP),2018,DRC-18/HCG10/UR1/EDU/INGO/8908,1/11/2019 2:54:59 PM,Overall,39,10,1050,1050,2149,37,12,1173,1137,2359
24,DRC (UNDP),2018,DRC-18/HCG10/UR1/EDU/NGO/8778,1/9/2019 2:42:22 PM,Host Communities,196,35,3439,3438,7108,0,0,0,0,0
24,DRC (UNDP),2018,DRC-18/HCG10/UR1/EDU/NGO/8778,1/9/2019 2:42:22 PM,Internally Displaced People,0,0,1473,1474,2947,0,0,0,0,0
24,DRC (UNDP),2018,DRC-18/HCG10/UR1/EDU/NGO/8778,1/9/2019 2:42:22 PM,Overall,196,35,4912,4912,10055,190,41,5416,4750,10397
24,DRC (UNDP),2018,DRC-18/HCG10/UR1/EDU-PROT/INGO/8776,1/8/2019 10:04:21 AM,Host Communities,90,47,595,595,1327,0,0,0,0,0
24,DRC (UNDP),2018,DRC-18/HCG10/UR1/EDU-PROT/INGO/8776,1/8/2019 10:04:21 AM,Internally Displaced People,40,35,675,675,1425,0,0,0,0,0
24,DRC (UNDP),2018,DRC-18/HCG10/UR1/EDU-PROT/INGO/8776,1/8/2019 10:04:21 AM,Overall,130,82,1270,1270,2752,254,307,1320,1320,3201
24,DRC (UNDP),2018,DRC-18/HCG10/UR1/EDU-PROT/NGO/8769,1/9/2019 8:39:41 AM,Host Communities,455,456,411,412,1734,455,456,363,457,1731
24,DRC (UNDP),2018,DRC-18/HCG10/UR1/EDU-PROT/NGO/8769,1/9/2019 8:39:41 AM,Internally Displaced People,815,816,804,804,3239,815,816,821,786,3238
24,DRC (UNDP),2018,DRC-18/HCG10/UR1/EDU-PROT/NGO/8769,1/9/2019 8:39:41 AM,Other,815,816,778,778,3187,993,994,781,552,3320
24,DRC (UNDP),2018,DRC-18/HCG10/UR1/EDU-PROT/NGO/8769,1/9/2019 8:39:41 AM,Overall,2085,2088,1993,1994,8160,2263,2266,1965,1795,8289
24,DRC (UNDP),2018,DRC-18/HCG10/UR1/FSEC/INGO/8770,1/11/2019 2:55:25 PM,Internally Displaced People,3094,3712,6806,7013,20625,0,0,0,0,0
24,DRC (UNDP),2018,DRC-18/HCG10/UR1/FSEC/INGO/8770,1/11/2019 2:55:25 PM,Overall,3094,3712,6806,7013,20625,3081,3598,8516,8706,23901
24,DRC (UNDP),2018,DRC-18/HCG10/UR1/FSEC/INGO/8777,11/29/2018 5:48:02 PM,Host Communities,847,1979,104,245,3175,0,0,0,0,0
24,DRC (UNDP),2018,DRC-18/HCG10/UR1/FSEC/INGO/8777,11/29/2018 5:48:02 PM,Internally Displaced People,3391,7912,419,978,12700,4238,9891,523,1223,15875
24,DRC (UNDP),2018,DRC-18/HCG10/UR1/FSEC/INGO/8777,11/29/2018 5:48:02 PM,Overall,4238,9891,523,1223,15875,4238,9891,523,1223,15875
24,DRC (UNDP),2018,DRC-18/HCG10/UR1/FSEC/INGO/8786,1/17/2019 2:18:24 PM,Host Communities,933,1011,795,861,3600,934,1011,795,861,3601
24,DRC (UNDP),2018,DRC-18/HCG10/UR1/FSEC/INGO/8786,1/17/2019 2:18:24 PM,Internally Displaced People,1400,1516,1192,1292,5400,1400,1516,1192,1292,5400
24,DRC (UNDP),2018,DRC-18/HCG10/UR1/FSEC/INGO/8786,1/17/2019 2:18:24 PM,Overall,2333,2527,1987,2153,9000,2333,2527,1987,2153,9000
24,DRC (UNDP),2018,DRC-18/HCG10/UR1/FSEC/INGO/8819,11/28/2018 2:53:41 PM,Host Communities,732,732,1464,1464,4392,1253,2923,1067,2490,7733
24,DRC (UNDP),2018,DRC-18/HCG10/UR1/FSEC/INGO/8819,11/28/2018 2:53:41 PM,Internally Displaced People,733,733,1465,1464,4395,171,398,146,339,1054
24,DRC (UNDP),2018,DRC-18/HCG10/UR1/FSEC/INGO/8819,11/28/2018 2:53:41 PM,Overall,1465,1465,2929,2928,8787,1424,3321,1213,2829,8787
24,DRC (UNDP),2018,DRC-18/HCG10/UR1/FSEC/NGO/8771,1/11/2019 2:51:32 PM,Internally Displaced People,1174,1755,1756,2634,7319,1579,2367,2366,3548,9860
24,DRC (UNDP),2018,DRC-18/HCG10/UR1/FSEC/NGO/8771,1/11/2019 2:51:32 PM,Other,405,610,610,916,2541,0,0,0,0,0
24,DRC (UNDP),2018,DRC-18/HCG10/UR1/FSEC/NGO/8771,1/11/2019 2:51:32 PM,Overall,1579,2365,2366,3550,9860,1579,2365,2366,3550,9860
24,DRC (UNDP),2018,DRC-18/HCG10/UR1/FSEC/NGO/8779,2/8/2019 9:47:37 AM,Host Communities,904,898,862,826,3490,904,898,862,826,3490
24,DRC (UNDP),2018,DRC-18/HCG10/UR1/FSEC/NGO/8779,2/8/2019 9:47:37 AM,Internally Displaced People,1809,1347,1294,1238,5688,1809,1347,1294,1238,5688
24,DRC (UNDP),2018,DRC-18/HCG10/UR1/FSEC/NGO/8779,2/8/2019 9:47:37 AM,Other,304,449,431,413,1597,304,449,431,413,1597
24,DRC (UNDP),2018,DRC-18/HCG10/UR1/FSEC/NGO/8779,2/8/2019 9:47:37 AM,Overall,3017,2694,2587,2477,10775,3017,2694,2587,2477,10775
24,DRC (UNDP),2018,DRC-18/HCG10/UR1/FSEC/NGO/8780,12/7/2018 10:11:22 PM,Overall,981,1061,857,1185,4084,713,788,1302,1431,4234
24,DRC (UNDP),2018,DRC-18/HCG10/UR1/FSEC/NGO/8792,1/21/2019 1:32:37 PM,Host Communities,0,0,0,0,0,5373,8271,6637,8848,29129
24,DRC (UNDP),2018,DRC-18/HCG10/UR1/FSEC/NGO/8792,1/21/2019 1:32:37 PM,Overall,4012,8024,5350,9361,26747,5373,8271,6637,8848,29129
24,DRC (UNDP),2018,DRC-18/HCG10/UR1/FSEC/NGO/8793,11/29/2018 9:05:36 AM,Host Communities,766,1005,3993,4392,10156,0,0,0,0,0
24,DRC (UNDP),2018,DRC-18/HCG10/UR1/FSEC/NGO/8793,11/29/2018 9:05:36 AM,Internally Displaced People,513,677,2706,2972,6868,0,0,0,0,0
24,DRC (UNDP),2018,DRC-18/HCG10/UR1/FSEC/NGO/8793,11/29/2018 9:05:36 AM,Overall,1640,2160,8632,9488,21920,1640,2160,8632,9488,21920
24,DRC (UNDP),2018,DRC-18/HCG10/UR1/FSEC/NGO/8793,11/29/2018 9:05:36 AM,Refugees,361,478,1933,2124,4896,0,0,0,0,0
24,DRC (UNDP),2018,DRC-18/HCG10/UR1/FSEC/NGO/8871,1/22/2019 12:47:29 PM,Host Communities,114,294,485,1065,1958,2460,3960,5633,14347,26400
24,DRC (UNDP),2018,DRC-18/HCG10/UR1/FSEC/NGO/8871,1/22/2019 12:47:29 PM,Internally Displaced People,1844,2644,4362,8776,17626,2460,3960,5633,14347,26400
24,DRC (UNDP),2018,DRC-18/HCG10/UR1/FSEC/NGO/8871,1/22/2019 12:47:29 PM,Overall,1959,2938,4847,9841,19585,1959,2938,4847,9841,19585
24,DRC (UNDP),2018,DRC-18/HCG10/UR1/HLT/INGO/8782,1/16/2019 10:19:58 AM,Host Communities,447,485,685,742,2359,1844,3085,2226,3133,10288
24,DRC (UNDP),2018,DRC-18/HCG10/UR1/HLT/INGO/8782,1/16/2019 10:19:58 AM,Internally Displaced People,1306,1415,2000,2166,6887,285,475,344,483,1587
24,DRC (UNDP),2018,DRC-18/HCG10/UR1/HLT/INGO/8782,1/16/2019 10:19:58 AM,Other,125,135,192,208,660,189,314,225,319,1047
24,DRC (UNDP),2018,DRC-18/HCG10/UR1/HLT/INGO/8782,1/16/2019 10:19:58 AM,Overall,1878,2035,2877,3116,9906,2318,3874,2795,3935,12922
24,DRC (UNDP),2018,DRC-18/HCG10/UR1/HLT/INGO/8788,11/30/2018 4:48:09 PM,Host Communities,3446,4021,3159,3734,14360,0,0,0,0,0
24,DRC (UNDP),2018,DRC-18/HCG10/UR1/HLT/INGO/8788,11/30/2018 4:48:09 PM,Internally Displaced People,1340,1564,1229,1452,5585,0,0,0,0,0
24,DRC (UNDP),2018,DRC-18/HCG10/UR1/HLT/INGO/8788,11/30/2018 4:48:09 PM,Overall,4787,5585,4388,5186,19946,7006,11992,1115,1199,21312
24,DRC (UNDP),2018,DRC-18/HCG10/UR1/HLT/INGO/8791,1/15/2019 1:41:34 PM,Host Communities,1225,1322,1003,1082,4632,0,0,0,0,0
24,DRC (UNDP),2018,DRC-18/HCG10/UR1/HLT/INGO/8791,1/15/2019 1:41:34 PM,Internally Displaced People,2859,3085,2339,2524,10807,1843,2881,5761,6239,16724
24,DRC (UNDP),2018,DRC-18/HCG10/UR1/HLT/INGO/8791,1/15/2019 1:41:34 PM,Overall,4085,4408,3342,3606,15441,1845,2878,5762,6239,16724
24,DRC (UNDP),2018,DRC-18/HCG10/UR1/HLT/INGO/8799,2/13/2019 3:31:47 PM,Host Communities,9767,11466,0,0,21233,6253,6282,0,0,12535
24,DRC (UNDP),2018,DRC-18/HCG10/UR1/HLT/INGO/8799,2/13/2019 3:31:47 PM,Internally Displaced People,4886,5736,0,0,10622,8565,9462,0,0,18027
24,DRC (UNDP),2018,DRC-18/HCG10/UR1/HLT/INGO/8799,2/13/2019 3:31:47 PM,Overall,14653,17202,0,0,31855,14818,15744,0,0,30562
24,DRC (UNDP),2018,DRC-18/HCG10/UR1/HLT/INGO/8805,1/21/2019 12:58:15 PM,Host Communities,3142,3824,3278,3414,13658,3040,3686,3159,3280,13165
24,DRC (UNDP),2018,DRC-18/HCG10/UR1/HLT/INGO/8805,1/21/2019 12:58:15 PM,Internally Displaced People,2094,2549,2185,2276,9104,2340,2849,2427,2545,10161
24,DRC (UNDP),2018,DRC-18/HCG10/UR1/HLT/INGO/8805,1/21/2019 12:58:15 PM,Overall,5236,6373,5463,5690,22762,5380,6535,5586,5825,23326
24,DRC (UNDP),2018,DRC-18/HCG10/UR1/HLT/INGO/8887,3/7/2019 2:00:43 PM,Host Communities,19687,23186,4321,5090,52284,0,0,0,0,0
24,DRC (UNDP),2018,DRC-18/HCG10/UR1/HLT/INGO/8887,3/7/2019 2:00:43 PM,Internally Displaced People,3083,4230,677,929,8919,0,0,0,0,0
24,DRC (UNDP),2018,DRC-18/HCG10/UR1/HLT/INGO/8887,3/7/2019 2:00:43 PM,Overall,22770,27416,4998,6019,61203,66014,96052,13663,15496,191225
24,DRC (UNDP),2018,DRC-18/HCG10/UR1/HLT/INGO/8956,1/15/2019 2:32:13 PM,Host Communities,3768,4082,859,969,9678,5570,8788,2151,2697,19206
24,DRC (UNDP),2018,DRC-18/HCG10/UR1/HLT/INGO/8956,1/15/2019 2:32:13 PM,Internally Displaced People,8299,8991,1895,2137,21322,4102,5917,1390,2213,13622
24,DRC (UNDP),2018,DRC-18/HCG10/UR1/HLT/INGO/8956,1/15/2019 2:32:13 PM,Overall,12067,13073,2754,3106,31000,9672,14705,3541,4910,32828
24,DRC (UNDP),2018,DRC-18/HCG10/UR1/HLT/NGO/8808,4/15/2019 12:28:46 PM,Host Communities,0,6329,15188,16453,37970,0,0,0,0,0
24,DRC (UNDP),2018,DRC-18/HCG10/UR1/HLT/NGO/8808,4/15/2019 12:28:46 PM,Internally Displaced People,4691,6740,1173,1685,14289,0,0,0,0,0
24,DRC (UNDP),2018,DRC-18/HCG10/UR1/HLT/NGO/8808,4/15/2019 12:28:46 PM,Overall,4691,13069,16361,18138,52259,11616,15374,10988,12656,50634
24,DRC (UNDP),2018,DRC-18/HCG10/UR1/HLT-NUT/INGO/8899,1/15/2019 2:44:02 PM,Host Communities,2210,2414,600,677,5901,2030,5774,1853,2124,11781
24,DRC (UNDP),2018,DRC-18/HCG10/UR1/HLT-NUT/INGO/8899,1/15/2019 2:44:02 PM,Internally Displaced People,3207,3504,864,977,8552,939,1293,248,326,2806
24,DRC (UNDP),2018,DRC-18/HCG10/UR1/HLT-NUT/INGO/8899,1/15/2019 2:44:02 PM,Overall,5417,5918,1475,1663,14473,2969,7067,2101,2450,14587
24,DRC (UNDP),2018,DRC-18/HCG10/UR1/LOG/INGO/8810,8/24/2018 12:07:30 PM,Overall,20,1,1,1,23,16,0,0,0,16
24,DRC (UNDP),2018,DRC-18/HCG10/UR1/LOG/INGO/8890,1/22/2019 10:19:23 AM,Overall,2,2,0,0,4,17,0,0,0,17
24,DRC (UNDP),2018,DRC-18/HCG10/UR1/LOG/NGO/8798,9/24/2018 2:21:47 PM,Host Communities,1045,1752,2006,2730,7533,1288,1417,1803,1932,6440
24,DRC (UNDP),2018,DRC-18/HCG10/UR1/LOG/NGO/8798,9/24/2018 2:21:47 PM,Internally Displaced People,780,795,1070,950,3595,901,992,1262,1352,4507
24,DRC (UNDP),2018,DRC-18/HCG10/UR1/LOG/NGO/8798,9/24/2018 2:21:47 PM,Other,364,415,530,441,1750,386,425,541,580,1932
24,DRC (UNDP),2018,DRC-18/HCG10/UR1/LOG/NGO/8798,9/24/2018 2:21:47 PM,Overall,2189,2962,3606,4121,12878,2189,2962,3606,4121,12878
24,DRC (UNDP),2018,DRC-18/HCG10/UR1/LOG/NGO/8855,9/27/2018 4:03:12 PM,Internally Displaced People,811,1336,1098,1527,4772,811,1336,1098,1527,4772
24,DRC (UNDP),2018,DRC-18/HCG10/UR1/LOG/NGO/8855,9/27/2018 4:03:12 PM,Overall,811,1336,1098,1527,4772,811,1336,1098,1527,4772
24,DRC (UNDP),2018,DRC-18/HCG10/UR1/LOG/UN/8795,12/26/2018 1:25:12 PM,Overall,15,0,0,0,15,58,0,0,0,58
24,DRC (UNDP),2018,DRC-18/HCG10/UR1/NFI/INGO/8891,1/11/2019 2:53:50 PM,Host Communities,512,544,768,815,2639,0,0,0,0,0
24,DRC (UNDP),2018,DRC-18/HCG10/UR1/NFI/INGO/8891,1/11/2019 2:53:50 PM,Internally Displaced People,2902,3082,4354,4623,14961,0,0,0,0,0
24,DRC (UNDP),2018,DRC-18/HCG10/UR1/NFI/INGO/8891,1/11/2019 2:53:50 PM,Overall,3414,3626,5122,5438,17600,6532,6938,9800,10405,33675
24,DRC (UNDP),2018,DRC-18/HCG10/UR1/NFI/NGO/8773,9/18/2018 1:28:34 PM,Overall,920,2330,3377,3763,10390,1323,1495,4980,5293,13091
24,DRC (UNDP),2018,DRC-18/HCG10/UR1/NFI/NGO/8774,8/27/2018 11:07:39 AM,Host Communities,350,560,1800,1840,4550,350,560,1800,1840,4550
24,DRC (UNDP),2018,DRC-18/HCG10/UR1/NFI/NGO/8774,8/27/2018 11:07:39 AM,Internally Displaced People,520,1200,2936,3530,8186,520,1200,2936,3530,8186
24,DRC (UNDP),2018,DRC-18/HCG10/UR1/NFI/NGO/8774,8/27/2018 11:07:39 AM,Overall,1800,2700,8100,9900,22500,1800,2700,8100,9900,22500
24,DRC (UNDP),2018,DRC-18/HCG10/UR1/NFI/NGO/8796,1/22/2019 12:50:31 PM,Host Communities,1069,1307,1604,1960,5940,725,796,1878,1857,5256
24,DRC (UNDP),2018,DRC-18/HCG10/UR1/NFI/NGO/8796,1/22/2019 12:50:31 PM,Internally Displaced People,1604,1960,2405,2941,8910,994,1868,2729,2729,8320
24,DRC (UNDP),2018,DRC-18/HCG10/UR1/NFI/NGO/8796,1/22/2019 12:50:31 PM,Overall,2970,3630,4455,5445,16500,1719,2664,4607,4586,13576
24,DRC (UNDP),2018,DRC-18/HCG10/UR1/NUT/INGO/8775,1/8/2019 10:33:39 AM,Overall,0,0,480,488,968,0,5,511,635,1151
24,DRC (UNDP),2018,DRC-18/HCG10/UR1/NUT/INGO/8797,2/8/2019 1:39:30 PM,Overall,10,76,2588,2390,5064,12,60,3889,4165,8126
24,DRC (UNDP),2018,DRC-18/HCG10/UR1/NUT/INGO/8864,1/11/2019 2:58:10 PM,Host Communities,0,216,326,489,1031,0,0,0,0,0
24,DRC (UNDP),2018,DRC-18/HCG10/UR1/NUT/INGO/8864,1/11/2019 2:58:10 PM,Internally Displaced People,0,324,1304,1955,3583,0,0,0,0,0
24,DRC (UNDP),2018,DRC-18/HCG10/UR1/NUT/INGO/8864,1/11/2019 2:58:10 PM,Overall,0,540,1630,2444,4614,0,469,1442,1660,3571
24,DRC (UNDP),2018,DRC-18/HCG10/UR1/NUT/NGO/8783,1/21/2019 1:38:43 PM,Overall,0,123,8157,9199,17479,0,27,7492,8568,16087
24,DRC (UNDP),2018,DRC-18/HCG10/UR1/PROT/INGO/8896,11/30/2018 3:04:14 PM,Host Communities,1315,1391,572,661,3939,3344,3579,1483,1732,10138
24,DRC (UNDP),2018,DRC-18/HCG10/UR1/PROT/INGO/8896,11/30/2018 3:04:14 PM,Internally Displaced People,2632,2786,1145,1323,7886,1671,1813,711,874,5069
24,DRC (UNDP),2018,DRC-18/HCG10/UR1/PROT/INGO/8896,11/30/2018 3:04:14 PM,Other,439,465,192,203,1299,560,624,236,270,1690
24,DRC (UNDP),2018,DRC-18/HCG10/UR1/PROT/INGO/8896,11/30/2018 3:04:14 PM,Overall,4386,4642,1909,2187,13124,3149,3862,5450,4436,16897
24,DRC (UNDP),2018,DRC-18/HCG10/UR1/PROT/INGO/8958,1/11/2019 2:57:33 PM,Overall,4431,6193,4834,6272,21730,4588,5190,6706,6699,23183
24,DRC (UNDP),2018,DRC-18/HCG10/UR1/PROT/NGO/8772,1/11/2019 2:49:45 PM,Internally Displaced People,3127,3387,2558,2772,11844,2644,1747,1555,1044,6990
24,DRC (UNDP),2018,DRC-18/HCG10/UR1/PROT/NGO/8772,1/11/2019 2:49:45 PM,Overall,3127,3387,2558,2772,11844,3911,4159,2027,1643,11740
24,DRC (UNDP),2018,DRC-18/HCG10/UR1/PROT/NGO/8801,1/22/2019 12:56:29 PM,Host Communities,35,20,10,5,70,0,0,0,0,0
24,DRC (UNDP),2018,DRC-18/HCG10/UR1/PROT/NGO/8801,1/22/2019 12:56:29 PM,Overall,35,20,10,5,70,42,12,11,5,70
24,DRC (UNDP),2018,DRC-18/HCG10/UR1/PROT/NGO/8806,1/18/2019 9:25:51 AM,Overall,12566,20819,6505,3483,43373,12566,20819,6505,3483,43373
24,DRC (UNDP),2018,DRC-18/HCG10/UR1/PROT/NGO/8847,1/22/2019 12:48:39 PM,Host Communities,41560,62340,13853,20781,138534,33241,49827,11162,16744,110974
24,DRC (UNDP),2018,DRC-18/HCG10/UR1/PROT/NGO/8847,1/22/2019 12:48:39 PM,Internally Displaced People,5927,8841,2093,3139,20000,14246,21354,4784,7176,47560
24,DRC (UNDP),2018,DRC-18/HCG10/UR1/PROT/NGO/8847,1/22/2019 12:48:39 PM,Overall,51950,77925,17317,25975,173167,47487,71181,15946,23920,158534
24,DRC (UNDP),2018,DRC-18/HCG10/UR1/WaSH/INGO/8856,5/7/2019 12:36:59 PM,Host Communities,2924,3274,2117,4287,12602,8884,18047,17999,26205,71135
24,DRC (UNDP),2018,DRC-18/HCG10/UR1/WaSH/INGO/8856,5/7/2019 12:36:59 PM,Internally Displaced People,6822,7639,4940,10004,29405,3207,4319,6551,6477,20554
24,DRC (UNDP),2018,DRC-18/HCG10/UR1/WaSH/INGO/8856,5/7/2019 12:36:59 PM,Overall,9746,10913,7057,14291,42007,8872,9709,13242,16119,47942
24,DRC (UNDP),2018,DRC-18/HCG10/UR1/WaSH/NGO/8790,1/31/2019 1:47:46 PM,Overall,983,2063,2947,3831,9824,983,2063,2947,3831,9824
24,DRC (UNDP),2018,DRC-18/HCG10/UR1/WaSH/NGO/8800,1/18/2019 9:03:43 AM,Host Communities,978,612,698,945,3233,0,0,0,0,0
24,DRC (UNDP),2018,DRC-18/HCG10/UR1/WaSH/NGO/8800,1/18/2019 9:03:43 AM,Internally Displaced People,688,924,721,812,3145,0,0,0,0,0
24,DRC (UNDP),2018,DRC-18/HCG10/UR1/WaSH/NGO/8800,1/18/2019 9:03:43 AM,Other,821,1021,818,834,3494,0,0,0,0,0
24,DRC (UNDP),2018,DRC-18/HCG10/UR1/WaSH/NGO/8800,1/18/2019 9:03:43 AM,Overall,2487,2557,2237,2591,9872,2487,2557,2237,2591,9872
24,DRC (UNDP),2018,DRC-18/HCG10/UR1/WaSH/NGO/8809,11/13/2018 2:26:42 PM,Overall,977,1058,854,1180,4069,1472,1595,1288,1779,6134
24,DRC (UNDP),2018,DRC-18/HCG10/UR1/WaSH/NGO/8957,1/22/2019 12:55:22 PM,Host Communities,10983,16475,11898,17848,57204,13571,19988,16675,18582,68816
24,DRC (UNDP),2018,DRC-18/HCG10/UR1/WaSH/NGO/8957,1/22/2019 12:55:22 PM,Internally Displaced People,5621,8432,6090,9135,29278,6946,10230,8535,9510,35221
24,DRC (UNDP),2018,DRC-18/HCG10/UR1/WaSH/NGO/8957,1/22/2019 12:55:22 PM,Overall,16604,24907,17988,26983,86482,20517,30218,25210,28092,104037
24,DRC (UNDP),2018,DRC-18/HCG10/UR3/EDU/INGO/9302,5/16/2019 10:47:39 AM,Overall,23,96,3000,3000,6119,74,50,5858,4921,10903
24,DRC (UNDP),2018,DRC-18/HCG10/UR3/EDU/NGO/9286,11/6/2019 3:01:06 PM,Overall,141,74,2560,2363,5138,141,74,2405,2574,5194
24,DRC (UNDP),2018,DRC-18/HCG10/UR3/FSEC/INGO/9280,10/15/2019 11:56:58 AM,Overall,916,1012,1446,1446,4820,916,1012,1446,1446,4820
24,DRC (UNDP),2018,DRC-18/HCG10/UR3/FSEC/INGO/9312,5/27/2019 1:46:57 PM,Host Communities,180,420,1152,1848,3600,671,870,2050,1791,5382
24,DRC (UNDP),2018,DRC-18/HCG10/UR3/FSEC/INGO/9312,5/27/2019 1:46:57 PM,Internally Displaced People,420,980,2688,4312,8400,1166,1542,3253,2844,8805
24,DRC (UNDP),2018,DRC-18/HCG10/UR3/FSEC/INGO/9312,5/27/2019 1:46:57 PM,Overall,600,1400,3840,6160,12000,1843,2402,5326,4616,14187
24,DRC (UNDP),2018,DRC-18/HCG10/UR3/FSEC-NFI/INGO/9232,4/16/2019 9:00:06 AM,Host Communities,776,624,576,644,2620,1211,1153,2487,2383,7234
24,DRC (UNDP),2018,DRC-18/HCG10/UR3/FSEC-NFI/INGO/9232,4/16/2019 9:00:06 AM,Internally Displaced People,1764,2136,1144,1336,6380,404,384,829,794,2411
24,DRC (UNDP),2018,DRC-18/HCG10/UR3/FSEC-NFI/INGO/9232,4/16/2019 9:00:06 AM,Overall,2540,2760,1720,1980,9000,1615,1537,3316,3177,9645
24,DRC (UNDP),2018,DRC-18/HCG10/UR3/FSEC-NFI-HLT/INGO/9408,5/22/2019 9:32:06 AM,Host Communities,500,500,1000,1000,3000,1,1,4,1,7
24,DRC (UNDP),2018,DRC-18/HCG10/UR3/FSEC-NFI-HLT/INGO/9408,5/22/2019 9:32:06 AM,Internally Displaced People,3000,3000,6000,6000,18000,775,821,1352,1271,4219
24,DRC (UNDP),2018,DRC-18/HCG10/UR3/FSEC-NFI-HLT/INGO/9408,5/22/2019 9:32:06 AM,Other,3800,3800,7600,7600,22800,3780,3399,5351,4943,17473
24,DRC (UNDP),2018,DRC-18/HCG10/UR3/FSEC-NFI-HLT/INGO/9408,5/22/2019 9:32:06 AM,Overall,7300,7300,14600,14600,43800,4556,4221,6707,6215,21699
24,DRC (UNDP),2018,DRC-18/HCG10/UR3/HLT/INGO/9260,10/22/2019 2:38:04 PM,Host Communities,3290,4606,1974,3290,13160,9570,15509,3537,3870,32486
24,DRC (UNDP),2018,DRC-18/HCG10/UR3/HLT/INGO/9260,10/22/2019 2:38:04 PM,Internally Displaced People,1194,1672,717,1195,4778,2163,2825,581,649,6218
24,DRC (UNDP),2018,DRC-18/HCG10/UR3/HLT/INGO/9260,10/22/2019 2:38:04 PM,Overall,4519,7262,2691,4485,18957,11733,18334,4118,4519,38704
24,DRC (UNDP),2018,DRC-18/HCG10/UR3/HLT-NUT/INGO/9230,7/18/2019 2:02:41 PM,Host Communities,668,1907,1001,1192,4768,595,684,1035,942,3256
24,DRC (UNDP),2018,DRC-18/HCG10/UR3/HLT-NUT/INGO/9230,7/18/2019 2:02:41 PM,Internally Displaced People,452,1293,679,808,3232,892,1026,1553,1414,4885
24,DRC (UNDP),2018,DRC-18/HCG10/UR3/HLT-NUT/INGO/9230,7/18/2019 2:02:41 PM,Overall,1120,3200,1680,2000,8000,1487,1710,2588,2356,8141
24,DRC (UNDP),2018,DRC-18/HCG10/UR3/HLT-NUT/INGO/9354,10/15/2019 12:15:21 PM,Host Communities,4776,5814,4983,5192,20765,5221,6547,5449,5547,22764
24,DRC (UNDP),2018,DRC-18/HCG10/UR3/HLT-NUT/INGO/9354,10/15/2019 12:15:21 PM,Internally Displaced People,3184,3876,3323,3462,13845,2823,3444,2954,3122,12343
24,DRC (UNDP),2018,DRC-18/HCG10/UR3/HLT-NUT/INGO/9354,10/15/2019 12:15:21 PM,Overall,7960,9690,8306,8654,34610,8044,9991,8403,8669,35107
24,DRC (UNDP),2018,DRC-18/HCG10/UR3/HLT-PROT-EDU/INGO/9401,10/22/2019 2:15:02 PM,Host Communities,5847,6335,1053,1477,14712,0,0,0,0,0
24,DRC (UNDP),2018,DRC-18/HCG10/UR3/HLT-PROT-EDU/INGO/9401,10/22/2019 2:15:02 PM,Internally Displaced People,1096,1187,255,276,2814,0,0,0,0,0
24,DRC (UNDP),2018,DRC-18/HCG10/UR3/HLT-PROT-EDU/INGO/9401,10/22/2019 2:15:02 PM,Other,365,395,395,92,1247,0,0,0,0,0
24,DRC (UNDP),2018,DRC-18/HCG10/UR3/HLT-PROT-EDU/INGO/9401,10/22/2019 2:15:02 PM,Overall,7308,7917,1703,1845,18773,5533,8820,4604,5001,23958
24,DRC (UNDP),2018,DRC-18/HCG10/UR3/HLT-PROT-NUT/INGO/9403,8/5/2019 3:07:38 PM,Host Communities,9444,9451,2531,2752,24178,0,0,0,0,0
24,DRC (UNDP),2018,DRC-18/HCG10/UR3/HLT-PROT-NUT/INGO/9403,8/5/2019 3:07:38 PM,Internally Displaced People,4722,4726,1265,1376,12089,0,0,0,0,0
24,DRC (UNDP),2018,DRC-18/HCG10/UR3/HLT-PROT-NUT/INGO/9403,8/5/2019 3:07:38 PM,Other,1574,1575,422,459,4030,0,0,0,0,0
24,DRC (UNDP),2018,DRC-18/HCG10/UR3/HLT-PROT-NUT/INGO/9403,8/5/2019 3:07:38 PM,Overall,15740,15752,4218,4587,40297,14944,19971,5644,6541,47100
24,DRC (UNDP),2018,DRC-18/HCG10/UR3/LOG/INGO/9340,7/18/2019 2:01:28 PM,Other,0,3,0,0,3,635,212,0,0,847
24,DRC (UNDP),2018,DRC-18/HCG10/UR3/LOG/INGO/9340,7/18/2019 2:01:28 PM,Overall,0,3,0,0,3,0,5,0,0,5
24,DRC (UNDP),2018,DRC-18/HCG10/UR3/LOG-WaSH/NGO/9294,10/22/2019 2:45:50 PM,Host Communities,1242,1682,2047,2340,7311,3766,5096,6203,7090,22155
24,DRC (UNDP),2018,DRC-18/HCG10/UR3/LOG-WaSH/NGO/9294,10/22/2019 2:45:50 PM,Internally Displaced People,4143,5605,6824,7799,24371,2637,3567,4343,4962,15509
24,DRC (UNDP),2018,DRC-18/HCG10/UR3/LOG-WaSH/NGO/9294,10/22/2019 2:45:50 PM,Other,187,252,307,351,1097,1130,1529,1861,2127,6647
24,DRC (UNDP),2018,DRC-18/HCG10/UR3/LOG-WaSH/NGO/9294,10/22/2019 2:45:50 PM,Overall,7533,10191,12407,14180,44311,7533,10191,12407,14180,44311
24,DRC (UNDP),2018,DRC-18/HCG10/UR3/NFI/NGO/9268,7/18/2019 9:42:07 AM,Host Communities,1365,1668,708,1315,5056,367,406,651,699,2123
24,DRC (UNDP),2018,DRC-18/HCG10/UR3/NFI/NGO/9268,7/18/2019 9:42:07 AM,Internally Displaced People,3705,4548,1968,3835,14056,3348,4011,4822,5899,18080
24,DRC (UNDP),2018,DRC-18/HCG10/UR3/NFI/NGO/9268,7/18/2019 9:42:07 AM,Other,1365,1666,707,1315,5053,0,0,0,0,0
24,DRC (UNDP),2018,DRC-18/HCG10/UR3/NFI/NGO/9268,7/18/2019 9:42:07 AM,Overall,6435,7886,3383,6465,24169,3742,4310,5794,6357,20203
24,DRC (UNDP),2018,DRC-18/HCG10/UR3/NFI/NGO/9337,7/18/2019 10:05:47 AM,Host Communities,1048,1003,1455,1536,5042,1376,1627,2836,2366,8205
24,DRC (UNDP),2018,DRC-18/HCG10/UR3/NFI/NGO/9337,7/18/2019 10:05:47 AM,Internally Displaced People,1299,1830,2870,3153,9152,924,1272,2055,1837,6088
24,DRC (UNDP),2018,DRC-18/HCG10/UR3/NFI/NGO/9337,7/18/2019 10:05:47 AM,Overall,2347,2833,4325,4689,14194,2183,2915,4285,4910,14293
24,DRC (UNDP),2018,DRC-18/HCG10/UR3/NFI-FSEC-LOG/INGO/9306,4/16/2019 8:56:46 AM,Overall,864,912,1488,1536,4800,2842,2954,2905,2832,11533
24,DRC (UNDP),2018,DRC-18/HCG10/UR3/NFI-FSEC-LOG/NGO/9253,10/15/2019 1:11:36 PM,Host Communities,108,252,98,214,672,0,0,0,0,0
24,DRC (UNDP),2018,DRC-18/HCG10/UR3/NFI-FSEC-LOG/NGO/9253,10/15/2019 1:11:36 PM,Internally Displaced People,980,2286,834,1948,6048,0,0,0,0,0
24,DRC (UNDP),2018,DRC-18/HCG10/UR3/NFI-FSEC-LOG/NGO/9253,10/15/2019 1:11:36 PM,Overall,1088,2538,932,2162,6720,1088,2538,932,2162,6720
24,DRC (UNDP),2018,DRC-18/HCG10/UR3/NFI-FSEC-WaSH/INGO/9227,11/6/2019 12:53:09 PM,Overall,4541,4303,7648,7410,23902,4894,4637,7986,8243,25760
24,DRC (UNDP),2018,DRC-18/HCG10/UR3/NFI-WaSH/INGO/9370,7/10/2019 12:17:47 PM,Host Communities,3201,3537,4885,5220,16843,2129,2371,3592,3713,11805
24,DRC (UNDP),2018,DRC-18/HCG10/UR3/NFI-WaSH/INGO/9370,7/10/2019 12:17:47 PM,Internally Displaced People,1119,1237,1708,1828,5892,2520,2806,4250,4395,13971
24,DRC (UNDP),2018,DRC-18/HCG10/UR3/NFI-WaSH/INGO/9370,7/10/2019 12:17:47 PM,Overall,4320,4774,6593,7048,22735,4649,5177,7842,8108,25776
24,DRC (UNDP),2018,DRC-18/HCG10/UR3/NUT-FSEC/INGO/9333,5/8/2019 10:58:01 AM,Host Communities,0,0,589,900,1489,0,0,775,618,1393
24,DRC (UNDP),2018,DRC-18/HCG10/UR3/NUT-FSEC/INGO/9333,5/8/2019 10:58:01 AM,Internally Displaced People,0,0,300,434,734,0,0,450,308,758
24,DRC (UNDP),2018,DRC-18/HCG10/UR3/NUT-FSEC/INGO/9333,5/8/2019 10:58:01 AM,Overall,0,0,889,1334,2223,0,0,1225,926,2151
24,DRC (UNDP),2018,DRC-18/HCG10/UR3/NUT-HLT/INGO/9386,6/18/2019 2:40:01 PM,Overall,2752,4201,3187,4345,14485,2674,3076,3352,4742,13844
24,DRC (UNDP),2018,DRC-18/HCG10/UR3/NUT-HLT-PROT/INGO/9368,5/31/2019 10:09:47 AM,Overall,14413,22000,16690,22759,75862,17744,34501,6294,15208,73747
24,DRC (UNDP),2018,DRC-18/HCG10/UR3/NUT-PROT/INGO/9381,5/16/2019 10:34:09 AM,Overall,363,728,651,859,2601,657,563,833,851,2904
24,DRC (UNDP),2018,DRC-18/HCG10/UR3/PROT/NGO/9291,10/15/2019 2:44:52 PM,Host Communities,301,340,201,166,1008,634,385,254,138,1411
24,DRC (UNDP),2018,DRC-18/HCG10/UR3/PROT/NGO/9291,10/15/2019 2:44:52 PM,Internally Displaced People,248,256,158,125,787,51,141,76,65,333
24,DRC (UNDP),2018,DRC-18/HCG10/UR3/PROT/NGO/9291,10/15/2019 2:44:52 PM,Overall,612,641,383,303,1939,685,526,330,203,1744
24,DRC (UNDP),2018,DRC-18/HCG10/UR3/PROT/NGO/9291,10/15/2019 2:44:52 PM,Refugees,63,45,24,12,144,0,0,0,0,0
24,DRC (UNDP),2018,DRC-18/HCG10/UR3/PROT/NGO/9336,10/22/2019 2:43:52 PM,Internally Displaced People,245,426,180,212,1063,327,233,250,403,1213
24,DRC (UNDP),2018,DRC-18/HCG10/UR3/PROT/NGO/9336,10/22/2019 2:43:52 PM,Other,80,90,70,120,360,83,93,51,55,282
24,DRC (UNDP),2018,DRC-18/HCG10/UR3/PROT/NGO/9336,10/22/2019 2:43:52 PM,Overall,3999,5998,2667,3999,16663,4365,7520,4920,3921,20726
24,DRC (UNDP),2018,DRC-18/HCG10/UR3/PROT/NGO/9336,10/22/2019 2:43:52 PM,Refugees,88,111,98,131,428,199,120,170,217,706
24,DRC (UNDP),2018,DRC-18/HCG10/UR3/PROT/NGO/9347,4/15/2019 10:00:28 AM,Other,0,0,0,0,0,124,76,2849,2323,5372
24,DRC (UNDP),2018,DRC-18/HCG10/UR3/PROT/NGO/9347,4/15/2019 10:00:28 AM,Overall,100,100,1674,1706,3580,124,76,2849,2323,5372
24,DRC (UNDP),2018,DRC-18/HCG10/UR3/PROT/NGO/9402,3/30/2020 7:50:51 PM,Host Communities,3,40,87,124,254,0,3,90,102,195
24,DRC (UNDP),2018,DRC-18/HCG10/UR3/PROT/NGO/9402,3/30/2020 7:50:51 PM,Internally Displaced People,3,20,135,304,462,0,0,0,0,0
24,DRC (UNDP),2018,DRC-18/HCG10/UR3/PROT/NGO/9402,3/30/2020 7:50:51 PM,Other,0,27,150,150,327,0,0,0,0,0
24,DRC (UNDP),2018,DRC-18/HCG10/UR3/PROT/NGO/9402,3/30/2020 7:50:51 PM,Overall,9,107,622,728,1466,0,3,90,102,195
24,DRC (UNDP),2018,DRC-18/HCG10/UR3/PROT/NGO/9402,3/30/2020 7:50:51 PM,Refugees,3,20,250,150,423,0,0,0,0,0
24,DRC (UNDP),2018,DRC-18/HCG10/UR3/WaSH/INGO/9247,7/4/2019 9:45:08 AM,Host Communities,1225,1354,1871,2000,6450,4011,4433,6122,6545,21111
24,DRC (UNDP),2018,DRC-18/HCG10/UR3/WaSH/INGO/9247,7/4/2019 9:45:08 AM,Internally Displaced People,2859,3160,4365,4666,15050,119,132,182,194,627
24,DRC (UNDP),2018,DRC-18/HCG10/UR3/WaSH/INGO/9247,7/4/2019 9:45:08 AM,Overall,4084,4514,6236,6666,21500,4130,4565,6304,6739,21738
24,DRC (UNDP),2018,DRC-18/HCG10/UR3/WaSH/INGO/9252,11/6/2019 2:28:17 PM,Host Communities,4737,5131,3875,4198,17941,4737,5131,3875,4198,17941
24,DRC (UNDP),2018,DRC-18/HCG10/UR3/WaSH/INGO/9252,11/6/2019 2:28:17 PM,Internally Displaced People,2125,2302,1739,1884,8050,1456,2282,1763,1918,7419
24,DRC (UNDP),2018,DRC-18/HCG10/UR3/WaSH/INGO/9252,11/6/2019 2:28:17 PM,Other,4858,5262,3974,4306,18400,4858,5262,3974,4306,18400
24,DRC (UNDP),2018,DRC-18/HCG10/UR3/WaSH/INGO/9252,11/6/2019 2:28:17 PM,Overall,11720,12695,9588,10388,44391,11051,12675,9612,10422,43760
24,DRC (UNDP),2018,DRC-18/HCG10/UR3/WaSH/NGO/9276,7/18/2019 9:34:42 AM,Host Communities,4254,6188,13148,15083,38673,5878,6161,13112,13560,38711
24,DRC (UNDP),2018,DRC-18/HCG10/UR3/WaSH/NGO/9276,7/18/2019 9:34:42 AM,Internally Displaced People,5620,6977,14829,16183,43609,6629,6947,14786,15291,43653
24,DRC (UNDP),2018,DRC-18/HCG10/UR3/WaSH/NGO/9276,7/18/2019 9:34:42 AM,Overall,9874,13165,27977,31268,82284,12507,13108,27898,28851,82364
24,DRC (UNDP),2018,DRC-18/HCG10/UR3/WaSH-HLT/NGO/9357,5/16/2019 10:09:03 AM,Overall,13045,15348,23012,25333,76738,13045,15348,23012,25333,76738
24,DRC (UNDP),2018,DRC-18/HCG10/UR4/LOG/UN/9274,12/26/2018 1:43:33 PM,Other,310,310,0,0,620,142,141,0,0,283
24,DRC (UNDP),2018,DRC-18/HCG10/UR4/LOG/UN/9274,12/26/2018 1:43:33 PM,Overall,310,310,0,0,620,141,142,0,0,283
24,DRC (UNDP),2018,DRC-18/HCG10/UR4/Multi/INGO/9653,3/10/2021 9:59:30 AM,Overall,225,0,0,0,225,443,0,0,0,443
24,DRC (UNDP),2018,DRC-18/HCG10/UR4/Multi/INGO/9686,3/9/2021 8:49:11 AM,Other,250,250,0,0,500,463,199,0,0,662
24,DRC (UNDP),2018,DRC-18/HCG10/UR4/Multi/INGO/9686,3/9/2021 8:49:11 AM,Overall,250,250,0,0,500,463,199,0,0,662
24,DRC (UNDP),2018,DRC-18/HCG10/UR4/Multi/INGO/9718,4/1/2020 7:18:37 PM,Other,0,0,0,0,0,34744,47155,39671,38415,159985
24,DRC (UNDP),2018,DRC-18/HCG10/UR4/Multi/INGO/9718,4/1/2020 7:18:37 PM,Overall,22225,25225,15000,18000,80450,34744,47155,39671,38415,159985
24,DRC (UNDP),2018,DRC-18/HCG10/UR4/Multi/NGO/9666,2/17/2021 11:18:11 AM,Other,0,0,0,0,0,237,50,0,0,287
24,DRC (UNDP),2018,DRC-18/HCG10/UR4/Multi/NGO/9666,2/17/2021 11:18:11 AM,Overall,225,0,0,0,225,237,50,0,0,287
24,DRC (UNDP),2018,DRC-18/HCG10/UR4/Multi/UN/9684,9/3/2021 12:34:56 PM,Host Communities,0,0,0,0,0,170,253,0,0,423
24,DRC (UNDP),2018,DRC-18/HCG10/UR4/Multi/UN/9684,9/3/2021 12:34:56 PM,Internally Displaced People,0,0,0,0,0,178,249,0,0,427
24,DRC (UNDP),2018,DRC-18/HCG10/UR4/Multi/UN/9684,9/3/2021 12:34:56 PM,Other,360,520,0,0,880,0,0,0,0,0
24,DRC (UNDP),2018,DRC-18/HCG10/UR4/Multi/UN/9684,9/3/2021 12:34:56 PM,Overall,360,520,0,0,880,348,502,0,0,850
24,DRC (UNDP),2018,DRC-18/HCG10/UR5/EDU/NGO/11072,10/22/2019 1:53:12 PM,Overall,159,100,3789,3095,7143,159,100,3789,3095,7143
24,DRC (UNDP),2018,DRC-18/HCG10/UR5/EDU-PROT/INGO/10984,1/26/2021 12:31:17 PM,Host Communities,2000,2800,1400,1600,7800,4289,5368,3676,2755,16088
24,DRC (UNDP),2018,DRC-18/HCG10/UR5/EDU-PROT/INGO/10984,1/26/2021 12:31:17 PM,Overall,2300,2800,3096,2094,10290,4289,5368,3676,2755,16088
24,DRC (UNDP),2018,DRC-18/HCG10/UR5/FSEC-EDU/INGO/10976,4/30/2020 4:29:45 PM,Host Communities,3399,3732,3537,3516,14184,4180,4183,4092,3638,16093
24,DRC (UNDP),2018,DRC-18/HCG10/UR5/FSEC-EDU/INGO/10976,4/30/2020 4:29:45 PM,Internally Displaced People,991,928,723,774,3416,679,674,181,89,1623
24,DRC (UNDP),2018,DRC-18/HCG10/UR5/FSEC-EDU/INGO/10976,4/30/2020 4:29:45 PM,Overall,4390,4660,4260,4290,17600,4859,4857,4273,3727,17716
24,DRC (UNDP),2018,DRC-18/HCG10/UR5/FSEC-LOG/NGO/11109,3/4/2020 1:26:30 PM,Host Communities,1549,2582,2479,3718,10328,1812,3935,3777,5666,15190
24,DRC (UNDP),2018,DRC-18/HCG10/UR5/FSEC-LOG/NGO/11109,3/4/2020 1:26:30 PM,Internally Displaced People,3615,6025,5784,8676,24100,4090,5902,5666,8498,24156
24,DRC (UNDP),2018,DRC-18/HCG10/UR5/FSEC-LOG/NGO/11109,3/4/2020 1:26:30 PM,Overall,5164,8607,8263,12394,34428,5902,9837,9443,14164,39346
24,DRC (UNDP),2018,DRC-18/HCG10/UR5/FSEC-WaSH/INGO/11092,3/4/2020 1:16:23 PM,Overall,3264,4896,5304,6936,20400,3264,4896,5304,6936,20400
24,DRC (UNDP),2018,DRC-18/HCG10/UR5/HLT/INGO/11062,10/22/2019 2:04:49 PM,Host Communities,759,949,1025,2132,4865,435,539,439,660,2073
24,DRC (UNDP),2018,DRC-18/HCG10/UR5/HLT/INGO/11062,10/22/2019 2:04:49 PM,Internally Displaced People,1518,1897,1599,1062,6076,1825,1905,2063,2143,7936
24,DRC (UNDP),2018,DRC-18/HCG10/UR5/HLT/INGO/11062,10/22/2019 2:04:49 PM,Other,2783,3479,3756,3889,13907,1308,1487,1546,1605,5946
24,DRC (UNDP),2018,DRC-18/HCG10/UR5/HLT/INGO/11062,10/22/2019 2:04:49 PM,Overall,5060,6325,6830,7083,25298,3568,3931,4048,4408,15955
24,DRC (UNDP),2018,DRC-18/HCG10/UR5/NFI/NGO/11002,10/22/2019 2:20:48 PM,Host Communities,400,900,2600,5100,9000,0,0,0,0,0
24,DRC (UNDP),2018,DRC-18/HCG10/UR5/NFI/NGO/11002,10/22/2019 2:20:48 PM,Internally Displaced People,500,1100,2000,2600,6200,0,0,0,0,0
24,DRC (UNDP),2018,DRC-18/HCG10/UR5/NFI/NGO/11002,10/22/2019 2:20:48 PM,Overall,1100,2900,7150,8850,20000,1100,2900,7150,8850,20000
24,DRC (UNDP),2018,DRC-18/HCG10/UR5/NUT/NGO/11047,12/23/2020 5:45:52 PM,Overall,8,389,1678,1754,3829,3,48,2335,2664,5050
24,DRC (UNDP),2018,DRC-18/HCG10/UR5/NUT-FSEC-PROT/INGO/11078,1/22/2020 3:53:03 PM,Overall,16141,24804,19784,26537,87266,40750,43445,17230,17410,118835
24,DRC (UNDP),2018,DRC-18/HCG10/UR5/PROT/NGO/11040,10/22/2019 3:04:39 PM,Host Communities,425,280,910,707,2322,194,370,2093,2112,4769
24,DRC (UNDP),2018,DRC-18/HCG10/UR5/PROT/NGO/11040,10/22/2019 3:04:39 PM,Internally Displaced People,240,121,202,375,938,29,80,387,702,1198
24,DRC (UNDP),2018,DRC-18/HCG10/UR5/PROT/NGO/11040,10/22/2019 3:04:39 PM,Overall,665,401,1112,1082,3260,223,450,2480,2814,5967
24,DRC (UNDP),2018,DRC-18/HCG10/UR5/PROT/NGO/11049,1/28/2020 10:04:49 AM,Host Communities,68,52,766,613,1499,68,62,1438,1087,2655
24,DRC (UNDP),2018,DRC-18/HCG10/UR5/PROT/NGO/11049,1/28/2020 10:04:49 AM,Internally Displaced People,50,32,568,557,1207,50,22,409,339,820
24,DRC (UNDP),2018,DRC-18/HCG10/UR5/PROT/NGO/11049,1/28/2020 10:04:49 AM,Overall,118,84,1334,1170,2706,118,84,1847,1426,3475
24,DRC (UNDP),2018,DRC-18/HCG10/UR5/PROT/NGO/11088,1/8/2021 6:14:16 PM,Overall,2251,2751,3376,4127,12505,2788,3263,4265,3595,13911
24,DRC (UNDP),2018,DRC-18/HCG10/UR5/PROT/UN/11110,2/4/2020 7:21:59 AM,Internally Displaced People,4176,7308,3758,5638,20880,0,0,0,0,0
24,DRC (UNDP),2018,DRC-18/HCG10/UR5/PROT/UN/11110,2/4/2020 7:21:59 AM,Other,1566,2741,1409,2114,7830,6911,12094,6220,9329,34554
24,DRC (UNDP),2018,DRC-18/HCG10/UR5/PROT/UN/11110,2/4/2020 7:21:59 AM,Overall,5742,10049,5167,7752,28710,6911,12094,6220,9329,34554
24,DRC (UNDP),2018,DRC-18/HCG10/UR5/PROT-EDU-HLT/INGO/11126,2/4/2020 3:17:59 PM,Overall,0,0,26853,29978,56831,0,865,37166,36889,74920
24,DRC (UNDP),2018,DRC-18/HCG10/UR5/WaSH-NFI/INGO/10993,12/23/2020 5:49:30 PM,Host Communities,0,0,0,0,0,3104,3282,2225,2510,11121
24,DRC (UNDP),2018,DRC-18/HCG10/UR5/WaSH-NFI/INGO/10993,12/23/2020 5:49:30 PM,Other,0,0,0,0,0,3103,3281,2225,2510,11119
24,DRC (UNDP),2018,DRC-18/HCG10/UR5/WaSH-NFI/INGO/10993,12/23/2020 5:49:30 PM,Overall,3577,3953,5460,5836,18826,6207,6563,4450,5020,22240
24,DRC (UNDP),2018,DRC-18/HCG10/UR5/WaSH-NFI/INGO/10993,12/23/2020 5:49:30 PM,Returnees,3577,3953,5460,5836,18826,0,0,0,0,0
24,DRC (UNDP),2019,DRC-19/HCG10/ST1/COORD/INGO/13200,4/15/2021 12:06:29 PM,Other,60,40,0,0,100,60,40,0,0,100
24,DRC (UNDP),2019,DRC-19/HCG10/ST1/COORD/INGO/13200,4/15/2021 12:06:29 PM,Overall,60,40,0,0,100,60,40,0,0,100
24,DRC (UNDP),2019,DRC-19/HCG10/ST1/EDU/NGO/12146,3/1/2021 7:50:09 AM,Host Communities,228,378,4484,4512,9602,221,367,5329,5132,11049
24,DRC (UNDP),2019,DRC-19/HCG10/ST1/EDU/NGO/12146,3/1/2021 7:50:09 AM,Internally Displaced People,12,20,236,238,506,11,19,228,243,501
24,DRC (UNDP),2019,DRC-19/HCG10/ST1/EDU/NGO/12146,3/1/2021 7:50:09 AM,Overall,240,398,4720,4750,10108,232,386,5557,5375,11550
24,DRC (UNDP),2019,DRC-19/HCG10/ST1/EDU-PROT/INGO/12062,10/13/2020 9:43:30 AM,Host Communities,98,123,3894,3979,8094,98,123,3894,3979,8094
24,DRC (UNDP),2019,DRC-19/HCG10/ST1/EDU-PROT/INGO/12062,10/13/2020 9:43:30 AM,Internally Displaced People,189,158,4600,4784,9731,189,158,4600,4784,9731
24,DRC (UNDP),2019,DRC-19/HCG10/ST1/EDU-PROT/INGO/12062,10/13/2020 9:43:30 AM,Overall,287,281,8494,8763,17825,287,281,8494,8763,17825
24,DRC (UNDP),2019,DRC-19/HCG10/ST1/FSEC-NFI/INGO/12069,2/11/2021 6:45:19 PM,Host Communities,596,646,700,758,2700,620,791,825,794,3030
24,DRC (UNDP),2019,DRC-19/HCG10/ST1/FSEC-NFI/INGO/12069,2/11/2021 6:45:19 PM,Overall,1988,2153,2332,2527,9000,1868,2353,3663,3537,11421
24,DRC (UNDP),2019,DRC-19/HCG10/ST1/FSEC-NFI/INGO/12069,2/11/2021 6:45:19 PM,Returnees,1392,1507,1632,1769,6300,1248,1562,2838,2743,8391
24,DRC (UNDP),2019,DRC-19/HCG10/ST1/FSEC-NFI/INGO/12114,3/10/2021 1:44:07 PM,Host Communities,345,303,90,105,843,130,167,175,165,637
24,DRC (UNDP),2019,DRC-19/HCG10/ST1/FSEC-NFI/INGO/12114,3/10/2021 1:44:07 PM,Internally Displaced People,408,541,187,216,1352,21,35,62,72,190
24,DRC (UNDP),2019,DRC-19/HCG10/ST1/FSEC-NFI/INGO/12114,3/10/2021 1:44:07 PM,Overall,2149,2434,491,566,5640,1076,1343,2209,2114,6742
24,DRC (UNDP),2019,DRC-19/HCG10/ST1/FSEC-NFI/INGO/12114,3/10/2021 1:44:07 PM,Returnees,1396,1590,214,245,3445,925,1141,1972,1877,5915
24,DRC (UNDP),2019,DRC-19/HCG10/ST1/FSEC-NFI/INGO/13113,5/2/2021 8:04:42 AM,Other,2,0,0,0,2,2,0,0,0,2
24,DRC (UNDP),2019,DRC-19/HCG10/ST1/FSEC-NFI/INGO/13113,5/2/2021 8:04:42 AM,Overall,2,0,0,0,2,2,0,0,0,2
24,DRC (UNDP),2019,DRC-19/HCG10/ST1/FSEC-NFI/NGO/11910,3/9/2021 8:22:25 AM,Host Communities,240,320,860,1380,2800,129,231,949,1637,2946
24,DRC (UNDP),2019,DRC-19/HCG10/ST1/FSEC-NFI/NGO/11910,3/9/2021 8:22:25 AM,Internally Displaced People,550,1100,2990,3610,8250,101,619,2712,3176,6608
24,DRC (UNDP),2019,DRC-19/HCG10/ST1/FSEC-NFI/NGO/11910,3/9/2021 8:22:25 AM,Overall,1500,2500,6950,9050,20000,507,3493,10975,14667,29642
24,DRC (UNDP),2019,DRC-19/HCG10/ST1/FSEC-NFI/NGO/11910,3/9/2021 8:22:25 AM,Returnees,710,1080,3100,4060,8950,277,2643,7314,9854,20088
24,DRC (UNDP),2019,DRC-19/HCG10/ST1/FSEC-NFI-WaSH/INGO/12048,3/16/2021 8:02:53 AM,Host Communities,408,699,660,702,2469,408,699,660,702,2469
24,DRC (UNDP),2019,DRC-19/HCG10/ST1/FSEC-NFI-WaSH/INGO/12048,3/16/2021 8:02:53 AM,Internally Displaced People,1226,1499,1979,2106,6810,1226,1499,1979,2106,6810
24,DRC (UNDP),2019,DRC-19/HCG10/ST1/FSEC-NFI-WaSH/INGO/12048,3/16/2021 8:02:53 AM,Other,108,159,202,198,667,108,159,202,198,667
24,DRC (UNDP),2019,DRC-19/HCG10/ST1/FSEC-NFI-WaSH/INGO/12048,3/16/2021 8:02:53 AM,Overall,8171,9986,13194,14042,45393,8171,9986,13194,14042,45393
24,DRC (UNDP),2019,DRC-19/HCG10/ST1/FSEC-NFI-WaSH/INGO/12048,3/16/2021 8:02:53 AM,Returnees,6429,7629,10353,11036,35447,6429,7629,10353,11036,35447
24,DRC (UNDP),2019,DRC-19/HCG10/ST1/FSEC-PROT/NGO/12093,11/25/2021 10:17:11 AM,Host Communities,798,895,703,799,3195,80,90,70,80,320
24,DRC (UNDP),2019,DRC-19/HCG10/ST1/FSEC-PROT/NGO/12093,11/25/2021 10:17:11 AM,Internally Displaced People,266,298,235,266,1065,27,30,24,27,108
24,DRC (UNDP),2019,DRC-19/HCG10/ST1/FSEC-PROT/NGO/12093,11/25/2021 10:17:11 AM,Overall,2660,2983,2344,2663,10650,267,299,235,267,1068
24,DRC (UNDP),2019,DRC-19/HCG10/ST1/FSEC-PROT/NGO/12093,11/25/2021 10:17:11 AM,Returnees,1596,1790,1406,1598,6390,160,179,141,160,640
24,DRC (UNDP),2019,DRC-19/HCG10/ST1/FSEC-WaSH/INGO/11902,9/8/2020 2:29:26 PM,Host Communities,3125,3454,4770,5099,16448,5870,6887,9628,10725,33110
24,DRC (UNDP),2019,DRC-19/HCG10/ST1/FSEC-WaSH/INGO/11902,9/8/2020 2:29:26 PM,Internally Displaced People,3125,3454,4770,5099,16448,3913,4591,6419,7150,22073
24,DRC (UNDP),2019,DRC-19/HCG10/ST1/FSEC-WaSH/INGO/11902,9/8/2020 2:29:26 PM,Overall,6250,6908,9540,10198,32896,9783,11478,16047,17875,55183
24,DRC (UNDP),2019,DRC-19/HCG10/ST1/FSEC-WaSH/INGO/11930,1/26/2021 2:05:09 PM,Host Communities,3845,4165,3145,3408,14563,3857,4243,3652,3713,15465
24,DRC (UNDP),2019,DRC-19/HCG10/ST1/FSEC-WaSH/INGO/11930,1/26/2021 2:05:09 PM,Internally Displaced People,5396,5846,4415,4783,20440,5396,5846,4415,4783,20440
24,DRC (UNDP),2019,DRC-19/HCG10/ST1/FSEC-WaSH/INGO/11930,1/26/2021 2:05:09 PM,Overall,13482,14606,11030,11950,51068,13585,14808,11579,12327,52299
24,DRC (UNDP),2019,DRC-19/HCG10/ST1/FSEC-WaSH/INGO/11930,1/26/2021 2:05:09 PM,Returnees,4241,4595,3470,3759,16065,4332,4719,3512,3831,16394
24,DRC (UNDP),2019,DRC-19/HCG10/ST1/FSEC-WaSH/INGO/12150,3/9/2021 8:43:33 AM,Host Communities,1628,1705,2171,2248,7752,1628,1705,2171,2248,7752
24,DRC (UNDP),2019,DRC-19/HCG10/ST1/FSEC-WaSH/INGO/12150,3/9/2021 8:43:33 AM,Internally Displaced People,1408,1475,1877,1944,6704,1408,1475,1877,1944,6704
24,DRC (UNDP),2019,DRC-19/HCG10/ST1/FSEC-WaSH/INGO/12150,3/9/2021 8:43:33 AM,Overall,4400,4609,5867,6076,20952,4400,4609,5867,6076,20952
24,DRC (UNDP),2019,DRC-19/HCG10/ST1/FSEC-WaSH/INGO/12150,3/9/2021 8:43:33 AM,Refugees,1364,1429,1819,1884,6496,1364,1429,1819,1884,6496
24,DRC (UNDP),2019,DRC-19/HCG10/ST1/HLT/INGO/13125,3/9/2021 9:09:25 AM,Internally Displaced People,10,15,5,6,36,10,15,5,6,36
24,DRC (UNDP),2019,DRC-19/HCG10/ST1/HLT/INGO/13125,3/9/2021 9:09:25 AM,Other,25,20,0,0,45,25,20,0,0,45
24,DRC (UNDP),2019,DRC-19/HCG10/ST1/HLT/INGO/13125,3/9/2021 9:09:25 AM,Overall,35,35,5,6,81,35,35,5,6,81
24,DRC (UNDP),2019,DRC-19/HCG10/ST1/HLT-NFI/INGO/11969,1/26/2021 1:31:12 PM,Overall,2520,3080,4060,4340,14000,3936,5811,4311,4686,18744
24,DRC (UNDP),2019,DRC-19/HCG10/ST1/HLT-NFI/INGO/11969,1/26/2021 1:31:12 PM,Returnees,2520,3080,4060,4340,14000,3936,5811,4311,4686,18744
24,DRC (UNDP),2019,DRC-19/HCG10/ST1/HLT-NUT/INGO/12089,1/27/2021 11:24:39 AM,Host Communities,5975,6602,9251,9901,31729,10796,44211,12900,13992,81899
24,DRC (UNDP),2019,DRC-19/HCG10/ST1/HLT-NUT/INGO/12089,1/27/2021 11:24:39 AM,Internally Displaced People,2749,3038,4252,4551,14590,247,428,181,202,1058
24,DRC (UNDP),2019,DRC-19/HCG10/ST1/HLT-NUT/INGO/12089,1/27/2021 11:24:39 AM,Overall,8724,9640,13503,14452,46319,11043,44639,13081,14194,82957
24,DRC (UNDP),2019,DRC-19/HCG10/ST1/HLT-NUT-PROT/INGO/12030,12/16/2020 1:04:23 PM,Host Communities,3747,4059,873,946,9625,2513,2716,2345,3191,10765
24,DRC (UNDP),2019,DRC-19/HCG10/ST1/HLT-NUT-PROT/INGO/12030,12/16/2020 1:04:23 PM,Overall,5353,5799,1247,1351,13750,3232,3669,3186,3853,13940
24,DRC (UNDP),2019,DRC-19/HCG10/ST1/HLT-NUT-PROT/INGO/12030,12/16/2020 1:04:23 PM,Returnees,1606,1740,374,405,4125,719,953,841,662,3175
24,DRC (UNDP),2019,DRC-19/HCG10/ST1/HLT-PROT-NUT/INGO/12164,4/14/2021 7:57:38 AM,Host Communities,7239,8489,15981,16786,48495,11690,15581,9594,10881,47746
24,DRC (UNDP),2019,DRC-19/HCG10/ST1/HLT-PROT-NUT/INGO/12164,4/14/2021 7:57:38 AM,Internally Displaced People,3565,4181,7871,8268,23885,3095,3977,1637,2153,10862
24,DRC (UNDP),2019,DRC-19/HCG10/ST1/HLT-PROT-NUT/INGO/12164,4/14/2021 7:57:38 AM,Overall,10804,12670,23852,25054,72380,14785,19558,11231,13034,58608
24,DRC (UNDP),2019,DRC-19/HCG10/ST1/HLT-WaSH/INGO/12133,1/26/2021 3:16:09 PM,Host Communities,17429,25097,12549,14640,69715,17429,25097,12549,17640,72715
24,DRC (UNDP),2019,DRC-19/HCG10/ST1/HLT-WaSH/INGO/12133,1/26/2021 3:16:09 PM,Overall,17429,25097,12549,14640,69715,17429,25097,12549,17640,72715
24,DRC (UNDP),2019,DRC-19/HCG10/ST1/LOG/INGO/11832,3/1/2021 9:22:04 AM,Other,15,0,0,0,15,17,13,0,0,30
24,DRC (UNDP),2019,DRC-19/HCG10/ST1/LOG/INGO/11832,3/1/2021 9:22:04 AM,Overall,15,0,0,0,15,17,13,0,0,30
24,DRC (UNDP),2019,DRC-19/HCG10/ST1/LOG/INGO/12023,8/21/2020 12:23:58 AM,Other,78,0,0,0,78,65,0,0,0,65
24,DRC (UNDP),2019,DRC-19/HCG10/ST1/LOG/INGO/12023,8/21/2020 12:23:58 AM,Overall,78,0,0,0,78,65,0,0,0,65
24,DRC (UNDP),2019,DRC-19/HCG10/ST1/LOG/INGO/12031,10/1/2020 11:04:43 AM,Other,64,0,0,0,64,64,0,0,0,64
24,DRC (UNDP),2019,DRC-19/HCG10/ST1/LOG/INGO/12031,10/1/2020 11:04:43 AM,Overall,64,0,0,0,64,64,0,0,0,64
24,DRC (UNDP),2019,DRC-19/HCG10/ST1/LOG/INGO/12149,10/19/2020 1:38:27 PM,Other,15,0,0,0,15,16,0,0,0,16
24,DRC (UNDP),2019,DRC-19/HCG10/ST1/LOG/INGO/12149,10/19/2020 1:38:27 PM,Overall,15,0,0,0,15,16,0,0,0,16
24,DRC (UNDP),2019,DRC-19/HCG10/ST1/LOG/INGO/13123,3/9/2021 8:53:56 AM,Other,5,0,0,0,5,5,0,0,0,5
24,DRC (UNDP),2019,DRC-19/HCG10/ST1/LOG/INGO/13123,3/9/2021 8:53:56 AM,Overall,5,0,0,0,5,5,0,0,0,5
24,DRC (UNDP),2019,DRC-19/HCG10/ST1/LOG/NGO/11850,9/28/2020 12:20:02 PM,Other,24,0,0,0,24,26,0,0,0,26
24,DRC (UNDP),2019,DRC-19/HCG10/ST1/LOG/NGO/11850,9/28/2020 12:20:02 PM,Overall,24,0,0,0,24,26,0,0,0,26
24,DRC (UNDP),2019,DRC-19/HCG10/ST1/LOG/NGO/11978,10/14/2020 8:06:30 AM,Other,40,0,0,0,40,15,0,0,0,15
24,DRC (UNDP),2019,DRC-19/HCG10/ST1/LOG/NGO/11978,10/14/2020 8:06:30 AM,Overall,40,0,0,0,40,15,0,0,0,15
24,DRC (UNDP),2019,DRC-19/HCG10/ST1/LOG/NGO/12096,9/15/2020 5:25:47 PM,Other,74,0,0,0,74,80,0,0,0,80
24,DRC (UNDP),2019,DRC-19/HCG10/ST1/LOG/NGO/12096,9/15/2020 5:25:47 PM,Overall,74,0,0,0,74,80,0,0,0,80
24,DRC (UNDP),2019,DRC-19/HCG10/ST1/NFI/NGO/12073,10/13/2020 11:28:05 AM,Host Communities,2032,2128,2709,2806,9675,2032,2128,2709,2806,9675
24,DRC (UNDP),2019,DRC-19/HCG10/ST1/NFI/NGO/12073,10/13/2020 11:28:05 AM,Internally Displaced People,1232,1290,1642,1702,5866,1232,1290,1642,1702,5866
24,DRC (UNDP),2019,DRC-19/HCG10/ST1/NFI/NGO/12073,10/13/2020 11:28:05 AM,Other,21,23,29,30,103,21,23,29,30,103
24,DRC (UNDP),2019,DRC-19/HCG10/ST1/NFI/NGO/12073,10/13/2020 11:28:05 AM,Overall,5133,5377,6843,7091,24444,5133,5377,6843,7091,24444
24,DRC (UNDP),2019,DRC-19/HCG10/ST1/NFI/NGO/12073,10/13/2020 11:28:05 AM,Returnees,1848,1936,2463,2553,8800,1848,1936,2463,2553,8800
24,DRC (UNDP),2019,DRC-19/HCG10/ST1/NFI-FSEC/INGO/11835,1/13/2021 3:22:10 PM,Other,4228,4005,7120,6897,22250,4887,5363,6925,7492,24667
24,DRC (UNDP),2019,DRC-19/HCG10/ST1/NFI-FSEC/INGO/11835,1/13/2021 3:22:10 PM,Overall,4228,4005,7120,6897,22250,4887,5363,6925,7492,24667
24,DRC (UNDP),2019,DRC-19/HCG10/ST1/NFI-FSEC/NGO/11946,10/30/2020 4:29:40 PM,Host Communities,200,325,401,824,1750,168,289,373,792,1622
24,DRC (UNDP),2019,DRC-19/HCG10/ST1/NFI-FSEC/NGO/11946,10/30/2020 4:29:40 PM,Internally Displaced People,1800,2925,3614,7411,15750,1760,2887,3576,7371,15594
24,DRC (UNDP),2019,DRC-19/HCG10/ST1/NFI-FSEC/NGO/11946,10/30/2020 4:29:40 PM,Overall,2000,3250,4015,8235,17500,1928,3176,3949,8163,17216
24,DRC (UNDP),2019,DRC-19/HCG10/ST1/NFI-WaSH/NGO/12074,10/13/2020 10:53:31 AM,Host Communities,1710,1890,2610,2790,9000,3352,4236,3169,3273,14030
24,DRC (UNDP),2019,DRC-19/HCG10/ST1/NFI-WaSH/NGO/12074,10/13/2020 10:53:31 AM,Overall,1710,1890,2610,2790,9000,3352,4236,3169,3273,14030
24,DRC (UNDP),2019,DRC-19/HCG10/ST1/NFI-WaSH-PROT/NGO/12163,10/13/2020 10:57:40 AM,Host Communities,1030,1120,2460,2476,7086,2330,3398,901,457,7086
24,DRC (UNDP),2019,DRC-19/HCG10/ST1/NFI-WaSH-PROT/NGO/12163,10/13/2020 10:57:40 AM,Overall,1030,1120,2460,2476,7086,2330,3398,901,457,7086
24,DRC (UNDP),2019,DRC-19/HCG10/ST1/NUT/INGO/12098,6/23/2020 3:38:57 PM,Host Communities,0,0,335,345,680,750,815,300,296,2161
24,DRC (UNDP),2019,DRC-19/HCG10/ST1/NUT/INGO/12098,6/23/2020 3:38:57 PM,Internally Displaced People,0,0,250,400,650,496,502,230,198,1426
24,DRC (UNDP),2019,DRC-19/HCG10/ST1/NUT/INGO/12098,6/23/2020 3:38:57 PM,Overall,0,0,1001,1295,2296,1509,1559,662,620,4350
24,DRC (UNDP),2019,DRC-19/HCG10/ST1/NUT/INGO/12098,6/23/2020 3:38:57 PM,Returnees,0,0,416,550,966,263,242,132,126,763
24,DRC (UNDP),2019,DRC-19/HCG10/ST1/NUT/INGO/13130,4/1/2021 12:18:17 PM,Other,27,0,0,0,27,74,0,0,0,74
24,DRC (UNDP),2019,DRC-19/HCG10/ST1/NUT/INGO/13130,4/1/2021 12:18:17 PM,Overall,27,0,0,0,27,74,0,0,0,74
24,DRC (UNDP),2019,DRC-19/HCG10/ST1/NUT-HLT-FSEC/INGO/11845,7/20/2020 10:46:12 PM,Host Communities,813,2632,4121,4477,12043,1438,4649,4740,5733,16560
24,DRC (UNDP),2019,DRC-19/HCG10/ST1/NUT-HLT-FSEC/INGO/11845,7/20/2020 10:46:12 PM,Internally Displaced People,244,790,1181,1404,3619,431,1395,1422,1720,4968
24,DRC (UNDP),2019,DRC-19/HCG10/ST1/NUT-HLT-FSEC/INGO/11845,7/20/2020 10:46:12 PM,Overall,1626,5264,8058,9158,24106,2876,9298,9480,11466,33120
24,DRC (UNDP),2019,DRC-19/HCG10/ST1/NUT-HLT-FSEC/INGO/11845,7/20/2020 10:46:12 PM,Returnees,569,1842,2756,3277,8444,1007,3254,3318,4013,11592
24,DRC (UNDP),2019,DRC-19/HCG10/ST1/PROT/INGO/11890,10/1/2020 11:08:18 AM,Host Communities,108,148,755,764,1775,157,114,1069,635,1975
24,DRC (UNDP),2019,DRC-19/HCG10/ST1/PROT/INGO/11890,10/1/2020 11:08:18 AM,Internally Displaced People,28,28,493,489,1038,92,67,675,410,1244
24,DRC (UNDP),2019,DRC-19/HCG10/ST1/PROT/INGO/11890,10/1/2020 11:08:18 AM,Overall,212,292,2233,2239,4976,437,317,3021,1804,5579
24,DRC (UNDP),2019,DRC-19/HCG10/ST1/PROT/INGO/11890,10/1/2020 11:08:18 AM,Returnees,76,116,985,986,2163,188,136,1277,759,2360
24,DRC (UNDP),2019,DRC-19/HCG10/ST1/PROT/INGO/13115,5/2/2021 7:48:12 AM,Other,124,0,0,0,124,323,0,0,0,323
24,DRC (UNDP),2019,DRC-19/HCG10/ST1/PROT/INGO/13115,5/2/2021 7:48:12 AM,Overall,124,0,0,0,124,323,0,0,0,323
24,DRC (UNDP),2019,DRC-19/HCG10/ST1/PROT/NGO/11947,6/2/2020 10:36:45 AM,Host Communities,69,37,816,768,1690,73,47,1509,979,2608
24,DRC (UNDP),2019,DRC-19/HCG10/ST1/PROT/NGO/11947,6/2/2020 10:36:45 AM,Internally Displaced People,24,24,784,522,1354,18,16,720,324,1078
24,DRC (UNDP),2019,DRC-19/HCG10/ST1/PROT/NGO/11947,6/2/2020 10:36:45 AM,Overall,93,61,1600,1290,3044,91,63,2229,1303,3686
24,DRC (UNDP),2019,DRC-19/HCG10/ST1/PROT/NGO/12014,10/1/2020 11:23:31 AM,Host Communities,4675,5739,10768,11058,32240,4692,5759,10850,11124,32425
24,DRC (UNDP),2019,DRC-19/HCG10/ST1/PROT/NGO/12014,10/1/2020 11:23:31 AM,Overall,4675,5739,10768,11058,32240,4692,5759,10850,11124,32425
24,DRC (UNDP),2019,DRC-19/HCG10/ST1/PROT/NGO/12036,7/14/2020 2:04:43 PM,Host Communities,2390,2486,5192,6215,16283,2812,3401,5272,7114,18599
24,DRC (UNDP),2019,DRC-19/HCG10/ST1/PROT/NGO/12036,7/14/2020 2:04:43 PM,Internally Displaced People,4223,4455,4330,4607,17615,4689,5802,4719,6598,21808
24,DRC (UNDP),2019,DRC-19/HCG10/ST1/PROT/NGO/12036,7/14/2020 2:04:43 PM,Overall,7052,7460,9932,11304,35748,8283,10693,11667,16208,46851
24,DRC (UNDP),2019,DRC-19/HCG10/ST1/PROT/NGO/12036,7/14/2020 2:04:43 PM,Returnees,439,519,410,482,1850,782,1490,1676,2496,6444
24,DRC (UNDP),2019,DRC-19/HCG10/ST1/PROT/NGO/12043,11/25/2021 10:41:03 AM,Host Communities,6457,8278,6297,8379,29411,12796,16803,11811,14189,55599
24,DRC (UNDP),2019,DRC-19/HCG10/ST1/PROT/NGO/12043,11/25/2021 10:41:03 AM,Overall,6457,8278,6297,8379,29411,12796,16803,11811,14189,55599
24,DRC (UNDP),2019,DRC-19/HCG10/ST1/PROT/NGO/12061,3/29/2021 9:18:19 AM,Host Communities,111,135,202,166,614,198,179,188,144,709
24,DRC (UNDP),2019,DRC-19/HCG10/ST1/PROT/NGO/12061,3/29/2021 9:18:19 AM,Overall,2361,2885,3577,4291,13114,3708,3579,3996,3893,15176
24,DRC (UNDP),2019,DRC-19/HCG10/ST1/PROT/NGO/12061,3/29/2021 9:18:19 AM,Returnees,2250,2750,3375,4125,12500,3510,3400,3808,3749,14467
24,DRC (UNDP),2019,DRC-19/HCG10/ST1/PROT/NGO/12140,1/8/2021 6:19:24 PM,Host Communities,5041,5917,4653,5462,21073,4015,5960,3670,4489,18134
24,DRC (UNDP),2019,DRC-19/HCG10/ST1/PROT/NGO/12140,1/8/2021 6:19:24 PM,Internally Displaced People,720,845,665,780,3010,4029,4217,3225,3631,15102
24,DRC (UNDP),2019,DRC-19/HCG10/ST1/PROT/NGO/12140,1/8/2021 6:19:24 PM,Overall,14402,16906,13294,15606,60208,15934,17993,14812,14542,63281
24,DRC (UNDP),2019,DRC-19/HCG10/ST1/PROT/NGO/12140,1/8/2021 6:19:24 PM,Returnees,8641,10144,7976,9364,36125,7890,7816,7917,6422,30045
24,DRC (UNDP),2019,DRC-19/HCG10/ST1/PROT-EDU/INGO/11831,1/8/2021 6:34:33 PM,Host Communities,133,286,1568,1568,3555,156,408,2215,2291,5070
24,DRC (UNDP),2019,DRC-19/HCG10/ST1/PROT-EDU/INGO/11831,1/8/2021 6:34:33 PM,Internally Displaced People,32,144,1365,1366,2907,49,95,1132,975,2251
24,DRC (UNDP),2019,DRC-19/HCG10/ST1/PROT-EDU/INGO/11831,1/8/2021 6:34:33 PM,Overall,207,607,4257,4259,9330,294,673,4863,4967,10797
24,DRC (UNDP),2019,DRC-19/HCG10/ST1/PROT-EDU/INGO/11831,1/8/2021 6:34:33 PM,Returnees,42,177,1324,1325,2868,89,170,1516,1701,3476
24,DRC (UNDP),2019,DRC-19/HCG10/ST1/PROT-EDU/INGO/11959,10/21/2021 12:20:45 PM,Host Communities,154,145,625,530,1454,305,245,1075,1020,2645
24,DRC (UNDP),2019,DRC-19/HCG10/ST1/PROT-EDU/INGO/11959,10/21/2021 12:20:45 PM,Internally Displaced People,820,889,3220,3154,8083,1250,1389,5170,5504,13313
24,DRC (UNDP),2019,DRC-19/HCG10/ST1/PROT-EDU/INGO/11959,10/21/2021 12:20:45 PM,Overall,1224,1264,4859,4704,12051,2240,2014,8259,8530,21043
24,DRC (UNDP),2019,DRC-19/HCG10/ST1/PROT-EDU/INGO/11959,10/21/2021 12:20:45 PM,Returnees,250,230,1014,1020,2514,685,380,2014,2006,5085
24,DRC (UNDP),2019,DRC-19/HCG10/ST1/PROT-EDU/INGO/13127,5/3/2021 7:29:30 AM,Other,25,25,0,0,50,50,59,0,0,109
24,DRC (UNDP),2019,DRC-19/HCG10/ST1/PROT-EDU/INGO/13127,5/3/2021 7:29:30 AM,Overall,25,25,0,0,50,50,59,0,0,109
24,DRC (UNDP),2019,DRC-19/HCG10/ST1/PROT-EDU-FSEC/INGO/11891,4/9/2021 3:16:02 PM,Internally Displaced People,5036,5491,2960,3232,16719,9238,9390,2960,3232,24820
24,DRC (UNDP),2019,DRC-19/HCG10/ST1/PROT-EDU-FSEC/INGO/11891,4/9/2021 3:16:02 PM,Overall,5036,5491,2960,3232,16719,9238,9390,2960,3232,24820
24,DRC (UNDP),2019,DRC-19/HCG10/ST1/PROT-HLT/INGO/12001,3/16/2021 8:24:50 AM,Host Communities,392,1303,113,126,1934,412,1368,119,132,2031
24,DRC (UNDP),2019,DRC-19/HCG10/ST1/PROT-HLT/INGO/12001,3/16/2021 8:24:50 AM,Internally Displaced People,465,2605,225,253,3548,488,2735,236,266,3725
24,DRC (UNDP),2019,DRC-19/HCG10/ST1/PROT-HLT/INGO/12001,3/16/2021 8:24:50 AM,Overall,1322,6513,563,632,9030,1388,6838,591,664,9481
24,DRC (UNDP),2019,DRC-19/HCG10/ST1/PROT-HLT/INGO/12001,3/16/2021 8:24:50 AM,Returnees,465,2605,225,253,3548,488,2735,236,266,3725
24,DRC (UNDP),2019,DRC-19/HCG10/ST1/PROT-HLT/INGO/12016,1/26/2021 2:49:48 PM,Host Communities,2148,6309,3875,4684,17016,7162,9897,6181,7372,30612
24,DRC (UNDP),2019,DRC-19/HCG10/ST1/PROT-HLT/INGO/12016,1/26/2021 2:49:48 PM,Internally Displaced People,771,2290,1403,1704,6168,2574,3596,2241,2685,11096
24,DRC (UNDP),2019,DRC-19/HCG10/ST1/PROT-HLT/INGO/12016,1/26/2021 2:49:48 PM,Other,197,573,352,425,1547,656,898,561,669,2784
24,DRC (UNDP),2019,DRC-19/HCG10/ST1/PROT-HLT/INGO/12016,1/26/2021 2:49:48 PM,Overall,3897,11466,7038,8515,30916,12996,17989,11229,13405,55619
24,DRC (UNDP),2019,DRC-19/HCG10/ST1/PROT-HLT/INGO/12016,1/26/2021 2:49:48 PM,Returnees,781,2294,1408,1702,6185,2604,3598,2246,2679,11127
24,DRC (UNDP),2019,DRC-19/HCG10/ST1/WaSH/INGO/12169,9/8/2020 2:15:08 PM,Host Communities,4180,4620,6380,6820,22000,4684,8686,12319,13727,39416
24,DRC (UNDP),2019,DRC-19/HCG10/ST1/WaSH/INGO/12169,9/8/2020 2:15:08 PM,Internally Displaced People,1045,1155,1595,1705,5500,0,0,0,0,0
24,DRC (UNDP),2019,DRC-19/HCG10/ST1/WaSH/INGO/12169,9/8/2020 2:15:08 PM,Overall,5225,5775,7975,8525,27500,4684,8686,12319,13727,39416
24,DRC (UNDP),2019,DRC-19/HCG10/ST1/WaSH/INGO/13142,4/12/2021 3:48:07 AM,Other,244,0,0,0,244,244,0,0,0,244
24,DRC (UNDP),2019,DRC-19/HCG10/ST1/WaSH/INGO/13142,4/12/2021 3:48:07 AM,Overall,244,0,0,0,244,244,0,0,0,244
24,DRC (UNDP),2019,DRC-19/HCG10/ST1/WaSH/NGO/11900,12/23/2020 5:04:02 PM,Host Communities,4847,5924,7808,8347,26926,5411,6613,8617,9319,29960
24,DRC (UNDP),2019,DRC-19/HCG10/ST1/WaSH/NGO/11900,12/23/2020 5:04:02 PM,Internally Displaced People,2520,3080,4060,4340,14000,2520,3080,4060,4340,14000
24,DRC (UNDP),2019,DRC-19/HCG10/ST1/WaSH/NGO/11900,12/23/2020 5:04:02 PM,Overall,7367,9004,11868,12687,40926,7931,9693,12677,13659,43960
24,DRC (UNDP),2019,DRC-19/HCG10/ST1/WaSH/NGO/11990,10/14/2020 8:23:02 AM,Host Communities,1332,1938,4118,4724,12112,994,1019,4371,4696,11080
24,DRC (UNDP),2019,DRC-19/HCG10/ST1/WaSH/NGO/11990,10/14/2020 8:23:02 AM,Internally Displaced People,2017,2483,5276,5742,15518,898,898,3684,4502,9982
24,DRC (UNDP),2019,DRC-19/HCG10/ST1/WaSH/NGO/11990,10/14/2020 8:23:02 AM,Overall,4575,6056,12869,14350,37850,3787,4124,15000,16573,39484
24,DRC (UNDP),2019,DRC-19/HCG10/ST1/WaSH/NGO/11990,10/14/2020 8:23:02 AM,Returnees,1226,1635,3475,3884,10220,1895,2207,6945,7375,18422
24,DRC (UNDP),2019,DRC-19/HCG10/ST1/WaSH/NGO/12113,3/9/2021 8:38:06 AM,Overall,4050,4860,6750,11340,27000,4011,4813,6686,11232,26742
24,DRC (UNDP),2019,DRC-19/HCG10/ST1/WaSH/NGO/12113,3/9/2021 8:38:06 AM,Returnees,4050,4860,6750,11340,27000,4011,4813,6686,11232,26742
24,DRC (UNDP),2019,DRC-19/HCG10/ST1/WaSH-HLT/NGO/11839,10/13/2020 10:50:19 AM,Host Communities,4660,5301,8035,9004,27000,6336,7572,8387,9490,31785
24,DRC (UNDP),2019,DRC-19/HCG10/ST1/WaSH-HLT/NGO/11839,10/13/2020 10:50:19 AM,Overall,4660,5301,8035,9004,27000,6336,7572,8387,9490,31785
24,DRC (UNDP),2019,DRC-19/HCG10/ST1/WaSH-PROT/NGO/12059,9/22/2020 5:14:14 PM,Internally Displaced People,2868,3348,3088,3648,12952,2590,3303,3034,3468,12395
24,DRC (UNDP),2019,DRC-19/HCG10/ST1/WaSH-PROT/NGO/12059,9/22/2020 5:14:14 PM,Overall,6900,8052,7432,8780,31164,6495,7901,7157,8419,29972
24,DRC (UNDP),2019,DRC-19/HCG10/ST1/WaSH-PROT/NGO/12059,9/22/2020 5:14:14 PM,Returnees,4032,4704,4344,5132,18212,3905,4598,4123,4951,17577
24,DRC (UNDP),2019,DRC-19/HCG10/ST1/WaSH-PROT-FSEC/NGO/11879,10/15/2020 3:26:27 PM,Other,4997,5449,10800,10994,32240,9778,10250,11718,10158,41904
24,DRC (UNDP),2019,DRC-19/HCG10/ST1/WaSH-PROT-FSEC/NGO/11879,10/15/2020 3:26:27 PM,Overall,26736,29153,57784,58819,172492,31513,33957,54266,53964,173700
24,DRC (UNDP),2019,DRC-19/HCG10/ST1/WaSH-PROT-FSEC/NGO/11879,10/15/2020 3:26:27 PM,Returnees,21739,23704,46984,47825,140252,21735,23707,42548,43806,131796
24,DRC (UNDP),2019,DRC-19/HCG10/UR1/HLT-NUT/INGO/12233,11/6/2019 4:15:12 PM,Host Communities,665,718,1015,1102,3500,666,1072,921,1246,3905
24,DRC (UNDP),2019,DRC-19/HCG10/UR1/HLT-NUT/INGO/12233,11/6/2019 4:15:12 PM,Internally Displaced People,551,595,841,913,2900,567,912,784,1060,3323
24,DRC (UNDP),2019,DRC-19/HCG10/UR1/HLT-NUT/INGO/12233,11/6/2019 4:15:12 PM,Overall,1900,2051,2900,3149,10000,1914,3080,2647,3580,11221
24,DRC (UNDP),2019,DRC-19/HCG10/UR1/HLT-NUT/INGO/12233,11/6/2019 4:15:12 PM,Returnees,684,738,1044,1134,3600,681,1096,942,1274,3993
24,DRC (UNDP),2019,DRC-19/HCG10/UR1/WaSH/INGO/12241,5/1/2020 11:23:50 AM,Host Communities,1260,1440,1500,1800,6000,1056,1207,1257,1509,5029
24,DRC (UNDP),2019,DRC-19/HCG10/UR1/WaSH/INGO/12241,5/1/2020 11:23:50 AM,Internally Displaced People,2520,2880,3000,3600,12000,3696,4224,4400,5281,17601
24,DRC (UNDP),2019,DRC-19/HCG10/UR1/WaSH/INGO/12241,5/1/2020 11:23:50 AM,Overall,4200,4800,5000,6000,20000,5280,6035,6286,7544,25145
24,DRC (UNDP),2019,DRC-19/HCG10/UR1/WaSH/INGO/12241,5/1/2020 11:23:50 AM,Returnees,420,480,500,600,2000,528,604,629,754,2515
24,DRC (UNDP),2019,DRC-19/HCG10/UR2/HLT-PROT/INGO/13239,12/23/2020 3:52:35 PM,Host Communities,42965,46055,10013,10733,109766,10639,17153,2872,4935,35599
24,DRC (UNDP),2019,DRC-19/HCG10/UR2/HLT-PROT/INGO/13239,12/23/2020 3:52:35 PM,Internally Displaced People,2261,2940,527,685,6413,0,0,0,0,0
24,DRC (UNDP),2019,DRC-19/HCG10/UR2/HLT-PROT/INGO/13239,12/23/2020 3:52:35 PM,Overall,45226,48995,10540,11418,116179,10639,17153,2872,4935,35599
24,DRC (UNDP),2019,DRC-19/HCG10/UR2/PROT-WaSH-HLT/INGO/13242,2/11/2021 7:24:46 PM,Host Communities,6717,26866,24180,26194,83957,17003,28079,7822,12568,65472
24,DRC (UNDP),2019,DRC-19/HCG10/UR2/PROT-WaSH-HLT/INGO/13242,2/11/2021 7:24:46 PM,Internally Displaced People,1679,6717,6045,6549,20990,9352,11520,4273,6044,31189
24,DRC (UNDP),2019,DRC-19/HCG10/UR2/PROT-WaSH-HLT/INGO/13242,2/11/2021 7:24:46 PM,Overall,8396,33583,30225,32743,104947,26355,39599,12095,18612,96661
24,DRC (UNDP),2019,DRC-19/HCG10/UR2/WaSH/INGO/13236,12/18/2020 9:33:37 AM,Host Communities,105181,113945,113946,123441,456513,105181,113945,113946,123441,456513
24,DRC (UNDP),2019,DRC-19/HCG10/UR2/WaSH/INGO/13236,12/18/2020 9:33:37 AM,Overall,105181,113945,113946,123441,456513,105181,113945,113946,123441,456513
24,DRC (UNDP),2019,DRC-19/HCG10/UR2/WaSH/INGO/13241,12/1/2020 1:27:56 AM,Host Communities,18816,25984,9600,9600,64000,41025,58001,21220,21220,141466
24,DRC (UNDP),2019,DRC-19/HCG10/UR2/WaSH/INGO/13241,12/1/2020 1:27:56 AM,Overall,18816,25984,9600,9600,64000,41025,58001,21220,21220,141466
24,DRC (UNDP),2019,DRC-19/HCG10/UR2/WaSH-HLT/INGO/13238,12/16/2020 12:29:25 PM,Host Communities,91223,94947,136835,142420,465425,8606,9788,6546,8762,33702
24,DRC (UNDP),2019,DRC-19/HCG10/UR2/WaSH-HLT/INGO/13238,12/16/2020 12:29:25 PM,Overall,91223,94947,136835,142420,465425,8606,9788,6546,8762,33702
24,DRC (UNDP),2019,DRC-19/HCG10/UR3/EDU/NGO/13864,9/28/2020 12:10:48 PM,Host Communities,180,82,1873,1356,3491,180,70,4338,3891,8479
24,DRC (UNDP),2019,DRC-19/HCG10/UR3/EDU/NGO/13864,9/28/2020 12:10:48 PM,Internally Displaced People,0,0,1868,1353,3221,0,0,0,0,0
24,DRC (UNDP),2019,DRC-19/HCG10/UR3/EDU/NGO/13864,9/28/2020 12:10:48 PM,Overall,180,82,3741,2709,6712,180,70,4338,3891,8479
24,DRC (UNDP),2019,DRC-19/HCG10/UR3/EDU/NGO/14425,3/9/2021 8:31:47 AM,Host Communities,1300,1200,1872,1610,5982,1300,1200,1872,1610,5982
24,DRC (UNDP),2019,DRC-19/HCG10/UR3/EDU/NGO/14425,3/9/2021 8:31:47 AM,Internally Displaced People,4400,2160,4838,4292,15690,4400,2160,4838,4292,15690
24,DRC (UNDP),2019,DRC-19/HCG10/UR3/EDU/NGO/14425,3/9/2021 8:31:47 AM,Overall,5700,3360,6710,5902,21672,5700,3360,6710,5902,21672
24,DRC (UNDP),2019,DRC-19/HCG10/UR3/EDU-PROT/NGO/13891,1/26/2021 3:51:21 PM,Host Communities,347,209,2288,2270,5114,347,209,2288,2259,5103
24,DRC (UNDP),2019,DRC-19/HCG10/UR3/EDU-PROT/NGO/13891,1/26/2021 3:51:21 PM,Internally Displaced People,349,332,1970,2420,5071,349,342,1975,2480,5146
24,DRC (UNDP),2019,DRC-19/HCG10/UR3/EDU-PROT/NGO/13891,1/26/2021 3:51:21 PM,Overall,1033,1018,6208,7440,15699,1033,1028,6141,7476,15678
24,DRC (UNDP),2019,DRC-19/HCG10/UR3/EDU-PROT/NGO/13891,1/26/2021 3:51:21 PM,Returnees,337,477,1950,2750,5514,337,477,1878,2737,5429
24,DRC (UNDP),2019,DRC-19/HCG10/UR3/FSEC/INGO/13849,3/10/2021 1:45:01 PM,Host Communities,700,2800,0,0,3500,771,2711,0,0,3482
24,DRC (UNDP),2019,DRC-19/HCG10/UR3/FSEC/INGO/13849,3/10/2021 1:45:01 PM,Internally Displaced People,703,2812,0,0,3515,703,2817,0,0,3520
24,DRC (UNDP),2019,DRC-19/HCG10/UR3/FSEC/INGO/13849,3/10/2021 1:45:01 PM,Overall,1450,5800,0,0,7250,1516,5721,0,0,7237
24,DRC (UNDP),2019,DRC-19/HCG10/UR3/FSEC/INGO/13849,3/10/2021 1:45:01 PM,Returnees,47,188,0,0,235,42,193,0,0,235
24,DRC (UNDP),2019,DRC-19/HCG10/UR3/FSEC/INGO/13863,3/18/2021 1:41:07 PM,Host Communities,833,868,1019,1060,3780,645,2001,277,861,3784
24,DRC (UNDP),2019,DRC-19/HCG10/UR3/FSEC/INGO/13863,3/18/2021 1:41:07 PM,Internally Displaced People,357,372,437,454,1620,277,857,118,369,1621
24,DRC (UNDP),2019,DRC-19/HCG10/UR3/FSEC/INGO/13863,3/18/2021 1:41:07 PM,Overall,1322,1378,1618,1682,6000,1024,3176,439,1367,6006
24,DRC (UNDP),2019,DRC-19/HCG10/UR3/FSEC/INGO/13863,3/18/2021 1:41:07 PM,Returnees,132,138,162,168,600,102,318,44,137,601
24,DRC (UNDP),2019,DRC-19/HCG10/UR3/FSEC/INGO/14423,3/30/2021 11:24:35 AM,Host Communities,271,330,435,465,1501,326,926,533,758,2543
24,DRC (UNDP),2019,DRC-19/HCG10/UR3/FSEC/INGO/14423,3/30/2021 11:24:35 AM,Internally Displaced People,1981,2421,3192,3412,11006,1015,3348,1655,2740,8758
24,DRC (UNDP),2019,DRC-19/HCG10/UR3/FSEC/INGO/14423,3/30/2021 11:24:35 AM,Overall,2701,3299,4350,4650,15000,1548,6008,2527,4917,15000
24,DRC (UNDP),2019,DRC-19/HCG10/UR3/FSEC/INGO/14423,3/30/2021 11:24:35 AM,Returnees,449,548,723,773,2493,207,1734,339,1419,3699
24,DRC (UNDP),2019,DRC-19/HCG10/UR3/HLT/INGO/14042,11/20/2020 10:26:21 AM,Host Communities,652,434,33389,39196,73671,655,173,22895,23825,47548
24,DRC (UNDP),2019,DRC-19/HCG10/UR3/HLT/INGO/14042,11/20/2020 10:26:21 AM,Overall,652,434,34294,40258,75638,655,173,22895,23825,47548
24,DRC (UNDP),2019,DRC-19/HCG10/UR3/HLT/INGO/14042,11/20/2020 10:26:21 AM,Returnees,0,0,905,1062,1967,0,0,0,0,0
24,DRC (UNDP),2019,DRC-19/HCG10/UR3/HLT/INGO/14421,3/9/2021 9:24:41 AM,Host Communities,7299,7907,1701,1843,18750,2747,5244,2008,2924,12923
24,DRC (UNDP),2019,DRC-19/HCG10/UR3/HLT/INGO/14421,3/9/2021 9:24:41 AM,Internally Displaced People,3649,3954,851,921,9375,2605,2617,2145,2366,9733
24,DRC (UNDP),2019,DRC-19/HCG10/UR3/HLT/INGO/14421,3/9/2021 9:24:41 AM,Overall,12164,13179,2836,3071,31250,8115,10670,5985,7748,32518
24,DRC (UNDP),2019,DRC-19/HCG10/UR3/HLT/INGO/14421,3/9/2021 9:24:41 AM,Returnees,1216,1318,284,307,3125,2763,2809,1832,2458,9862
24,DRC (UNDP),2019,DRC-19/HCG10/UR3/HLT/UN/13897,10/27/2020 10:22:54 AM,Other,0,0,138634,137539,276173,0,0,240336,236518,476854
24,DRC (UNDP),2019,DRC-19/HCG10/UR3/HLT/UN/13897,10/27/2020 10:22:54 AM,Overall,0,0,138634,137539,276173,0,0,240336,236518,476854
24,DRC (UNDP),2019,DRC-19/HCG10/UR3/HLT/UN/13898,9/30/2020 7:22:42 AM,Other,0,0,308427,334055,642482,0,0,317018,343437,660455
24,DRC (UNDP),2019,DRC-19/HCG10/UR3/HLT/UN/13898,9/30/2020 7:22:42 AM,Overall,0,0,308427,334055,642482,0,0,317018,343437,660455
24,DRC (UNDP),2019,DRC-19/HCG10/UR3/HLT-NUT/INGO/13869,4/29/2021 3:58:44 PM,Host Communities,20722,19128,29819,27525,97194,14664,15870,7518,8695,46747
24,DRC (UNDP),2019,DRC-19/HCG10/UR3/HLT-NUT/INGO/13869,4/29/2021 3:58:44 PM,Internally Displaced People,5181,4782,7455,6881,24299,5231,5985,3467,3181,17864
24,DRC (UNDP),2019,DRC-19/HCG10/UR3/HLT-NUT/INGO/13869,4/29/2021 3:58:44 PM,Overall,25903,23910,37274,34406,121493,19895,21855,10985,11876,64611
24,DRC (UNDP),2019,DRC-19/HCG10/UR3/LOG/INGO/13762,12/7/2020 2:03:30 PM,Other,0,18,0,0,18,16,18,0,0,34
24,DRC (UNDP),2019,DRC-19/HCG10/UR3/LOG/INGO/13762,12/7/2020 2:03:30 PM,Overall,0,18,0,0,18,16,18,0,0,34
24,DRC (UNDP),2019,DRC-19/HCG10/UR3/LOG/NGO/13847,2/11/2021 8:06:27 PM,Host Communities,74,86,73,12,245,306,148,18,9,481
24,DRC (UNDP),2019,DRC-19/HCG10/UR3/LOG/NGO/13847,2/11/2021 8:06:27 PM,Internally Displaced People,44,50,43,7,144,37,14,2,1,54
24,DRC (UNDP),2019,DRC-19/HCG10/UR3/LOG/NGO/13847,2/11/2021 8:06:27 PM,Other,8,0,0,0,8,8,0,0,0,8
24,DRC (UNDP),2019,DRC-19/HCG10/UR3/LOG/NGO/13847,2/11/2021 8:06:27 PM,Overall,191,212,180,30,613,695,271,40,21,1027
24,DRC (UNDP),2019,DRC-19/HCG10/UR3/LOG/NGO/13847,2/11/2021 8:06:27 PM,Returnees,65,76,64,11,216,344,109,20,11,484
24,DRC (UNDP),2019,DRC-19/HCG10/UR3/NFI/INGO/13791,10/15/2020 3:52:07 PM,Host Communities,388,409,668,689,2154,3,3,5,6,17
24,DRC (UNDP),2019,DRC-19/HCG10/UR3/NFI/INGO/13791,10/15/2020 3:52:07 PM,Overall,776,818,1336,1378,4308,954,877,868,979,3678
24,DRC (UNDP),2019,DRC-19/HCG10/UR3/NFI/INGO/13791,10/15/2020 3:52:07 PM,Returnees,388,409,668,689,2154,951,874,863,973,3661
24,DRC (UNDP),2019,DRC-19/HCG10/UR3/NFI/NGO/13844,10/15/2020 3:35:58 PM,Internally Displaced People,2882,2530,4362,4506,14280,1669,2050,5430,5685,14834
24,DRC (UNDP),2019,DRC-19/HCG10/UR3/NFI/NGO/13844,10/15/2020 3:35:58 PM,Overall,2882,2530,4362,4506,14280,1669,2050,5430,5685,14834
24,DRC (UNDP),2019,DRC-19/HCG10/UR3/NFI/NGO/13862,3/9/2021 8:33:18 AM,Host Communities,87,205,76,172,540,0,0,0,0,0
24,DRC (UNDP),2019,DRC-19/HCG10/UR3/NFI/NGO/13862,3/9/2021 8:33:18 AM,Internally Displaced People,826,1798,680,1556,4860,682,805,1731,2025,5243
24,DRC (UNDP),2019,DRC-19/HCG10/UR3/NFI/NGO/13862,3/9/2021 8:33:18 AM,Overall,913,2003,756,1728,5400,682,805,1731,2025,5243
24,DRC (UNDP),2019,DRC-19/HCG10/UR3/NFI/NGO/14426,4/1/2021 7:01:18 AM,Host Communities,1194,1470,648,1286,4598,99,148,203,201,651
24,DRC (UNDP),2019,DRC-19/HCG10/UR3/NFI/NGO/14426,4/1/2021 7:01:18 AM,Internally Displaced People,1195,1470,648,1286,4599,2998,3556,4487,4789,15830
24,DRC (UNDP),2019,DRC-19/HCG10/UR3/NFI/NGO/14426,4/1/2021 7:01:18 AM,Overall,3583,4410,1944,3858,13795,3100,3710,4703,4998,16511
24,DRC (UNDP),2019,DRC-19/HCG10/UR3/NFI/NGO/14426,4/1/2021 7:01:18 AM,Returnees,1194,1470,648,1286,4598,3,6,13,8,30
24,DRC (UNDP),2019,DRC-19/HCG10/UR3/NUT/INGO/14422,1/30/2021 1:41:55 AM,Internally Displaced People,67,7586,344,373,8370,4080,15206,306,314,19906
24,DRC (UNDP),2019,DRC-19/HCG10/UR3/NUT/INGO/14422,1/30/2021 1:41:55 AM,Overall,184,20384,974,1056,22598,13601,50686,1019,1048,66354
24,DRC (UNDP),2019,DRC-19/HCG10/UR3/NUT/INGO/14422,1/30/2021 1:41:55 AM,Returnees,117,12798,630,683,14228,9521,35480,713,734,46448
24,DRC (UNDP),2019,DRC-19/HCG10/UR3/NUT-HLT/INGO/13790,12/23/2020 5:29:38 PM,Host Communities,5546,6126,8460,9045,29177,6835,7566,9946,9303,33650
24,DRC (UNDP),2019,DRC-19/HCG10/UR3/NUT-HLT/INGO/13790,12/23/2020 5:29:38 PM,Internally Displaced People,637,702,970,1037,3346,678,768,897,1056,3399
24,DRC (UNDP),2019,DRC-19/HCG10/UR3/NUT-HLT/INGO/13790,12/23/2020 5:29:38 PM,Overall,8164,9016,12452,13312,42944,9559,10733,13987,13815,48094
24,DRC (UNDP),2019,DRC-19/HCG10/UR3/NUT-HLT/INGO/13790,12/23/2020 5:29:38 PM,Returnees,1981,2188,3022,3230,10421,2046,2399,3144,3456,11045
24,DRC (UNDP),2019,DRC-19/HCG10/UR3/NUT-HLT/INGO/13848,4/7/2021 9:34:25 AM,Host Communities,2164,5049,8643,9363,25219,4180,7072,8014,9865,29131
24,DRC (UNDP),2019,DRC-19/HCG10/UR3/NUT-HLT/INGO/13848,4/7/2021 9:34:25 AM,Internally Displaced People,1352,3155,5402,5852,15761,1265,3054,5210,6254,15783
24,DRC (UNDP),2019,DRC-19/HCG10/UR3/NUT-HLT/INGO/13848,4/7/2021 9:34:25 AM,Overall,5409,12621,21608,23408,63046,6624,12405,19787,23134,61950
24,DRC (UNDP),2019,DRC-19/HCG10/UR3/NUT-HLT/INGO/13848,4/7/2021 9:34:25 AM,Returnees,1893,4417,7563,8193,22066,1179,2279,6563,7015,17036
24,DRC (UNDP),2019,DRC-19/HCG10/UR3/PROT/INGO/13840,12/23/2020 5:02:58 PM,Host Communities,25000,28000,30000,32000,115000,100467,27789,111353,111722,351331
24,DRC (UNDP),2019,DRC-19/HCG10/UR3/PROT/INGO/13840,12/23/2020 5:02:58 PM,Internally Displaced People,9000,9600,14600,15800,49000,9000,6600,14600,15800,46000
24,DRC (UNDP),2019,DRC-19/HCG10/UR3/PROT/INGO/13840,12/23/2020 5:02:58 PM,Other,330,348,480,520,1678,330,348,480,520,1678
24,DRC (UNDP),2019,DRC-19/HCG10/UR3/PROT/INGO/13840,12/23/2020 5:02:58 PM,Overall,38730,43048,50980,54920,187678,113089,38811,130654,133065,415619
24,DRC (UNDP),2019,DRC-19/HCG10/UR3/PROT/INGO/13840,12/23/2020 5:02:58 PM,Refugees,1700,1800,2200,2300,8000,592,774,521,723,2610
24,DRC (UNDP),2019,DRC-19/HCG10/UR3/PROT/INGO/13840,12/23/2020 5:02:58 PM,Returnees,2700,3300,3700,4300,14000,2700,3300,3700,4300,14000
24,DRC (UNDP),2019,DRC-19/HCG10/UR3/PROT/INGO/13865,12/18/2020 9:43:56 AM,Host Communities,2888,2407,3073,3634,12002,2273,2430,2793,3216,10712
24,DRC (UNDP),2019,DRC-19/HCG10/UR3/PROT/INGO/13865,12/18/2020 9:43:56 AM,Internally Displaced People,1282,1445,1922,2167,6816,1515,1620,1862,2144,7141
24,DRC (UNDP),2019,DRC-19/HCG10/UR3/PROT/INGO/13865,12/18/2020 9:43:56 AM,Overall,4170,3852,4995,5801,18818,3788,4050,4655,5360,17853
24,DRC (UNDP),2019,DRC-19/HCG10/UR3/PROT/NGO/13845,6/13/2020 12:25:10 AM,Overall,3031,7039,4000,3039,17109,4580,11025,5774,5000,26379
24,DRC (UNDP),2019,DRC-19/HCG10/UR3/PROT/NGO/13845,6/13/2020 12:25:10 AM,Returnees,3031,7039,4000,3039,17109,4580,11025,5774,5000,26379
24,DRC (UNDP),2019,DRC-19/HCG10/UR3/PROT/NGO/14424,12/8/2020 2:18:12 PM,Host Communities,2838,3007,8809,10244,24898,3548,5662,12796,15518,37524
24,DRC (UNDP),2019,DRC-19/HCG10/UR3/PROT/NGO/14424,12/8/2020 2:18:12 PM,Internally Displaced People,3717,3944,11818,13718,33197,4578,3950,10171,13579,32278
24,DRC (UNDP),2019,DRC-19/HCG10/UR3/PROT/NGO/14424,12/8/2020 2:18:12 PM,Overall,9341,9908,29487,34248,82984,11444,13169,32810,38797,96220
24,DRC (UNDP),2019,DRC-19/HCG10/UR3/PROT/NGO/14424,12/8/2020 2:18:12 PM,Returnees,2786,2957,8860,10286,24889,3318,3557,9843,9700,26418
24,DRC (UNDP),2019,DRC-19/HCG10/UR3/PROT/NGO/14433,10/19/2020 9:37:23 AM,Host Communities,10612,12320,5482,5820,34234,9017,10211,5482,4500,29210
24,DRC (UNDP),2019,DRC-19/HCG10/UR3/PROT/NGO/14433,10/19/2020 9:37:23 AM,Internally Displaced People,24053,26438,13470,15912,79873,18938,21967,10061,12369,63335
24,DRC (UNDP),2019,DRC-19/HCG10/UR3/PROT/NGO/14433,10/19/2020 9:37:23 AM,Overall,34665,38758,18952,21732,114107,27955,32178,15543,16869,92545
24,DRC (UNDP),2019,DRC-19/HCG10/UR3/PROT-NUT-HLT/NGO/13871,1/26/2021 4:09:22 PM,Internally Displaced People,1878,3708,4578,5266,15430,3682,7888,2854,3002,17426
24,DRC (UNDP),2019,DRC-19/HCG10/UR3/PROT-NUT-HLT/NGO/13871,1/26/2021 4:09:22 PM,Overall,1878,3708,4578,5266,15430,3682,7888,2854,3002,17426
24,DRC (UNDP),2019,DRC-19/HCG10/UR3/WaSH/INGO/13842,10/29/2020 11:11:50 AM,Host Communities,3360,4480,4000,4160,16000,2349,4008,4230,4424,15011
24,DRC (UNDP),2019,DRC-19/HCG10/UR3/WaSH/INGO/13842,10/29/2020 11:11:50 AM,Internally Displaced People,4040,6420,6600,6940,24000,3765,6876,7154,7546,25341
24,DRC (UNDP),2019,DRC-19/HCG10/UR3/WaSH/INGO/13842,10/29/2020 11:11:50 AM,Overall,7400,10900,10600,11100,40000,6114,10884,11384,11970,40352
24,DRC (UNDP),2019,DRC-19/HCG10/UR3/WaSH/INGO/14419,1/8/2021 6:51:25 PM,Other,15561,17199,23751,25389,81900,18335,21257,26777,29095,95464
24,DRC (UNDP),2019,DRC-19/HCG10/UR3/WaSH/INGO/14419,1/8/2021 6:51:25 PM,Overall,15561,17199,23751,25389,81900,18335,21257,26777,29095,95464
24,DRC (UNDP),2019,DRC-19/HCG10/UR3/WaSH/NGO/14420,1/30/2021 1:31:26 AM,Other,8960,13440,9707,14560,46667,8764,12817,10619,14467,46667
24,DRC (UNDP),2019,DRC-19/HCG10/UR3/WaSH/NGO/14420,1/30/2021 1:31:26 AM,Overall,8960,13440,9707,14560,46667,8764,12817,10619,14467,46667
24,DRC (UNDP),2019,DRC-19/HCG10/UR3/WaSH-LOG/UN/13870,9/30/2020 7:04:50 AM,Internally Displaced People,4400,5600,0,0,10000,4229,5026,0,0,9255
24,DRC (UNDP),2019,DRC-19/HCG10/UR3/WaSH-LOG/UN/13870,9/30/2020 7:04:50 AM,Overall,4400,5600,0,0,10000,4229,5026,0,0,9255
24,DRC (UNDP),2019,DRC-19/HCG10/UR4/NUT-HLT-PROT-WaSH/INGO/14737,3/9/2021 8:58:56 AM,Host Communities,554,1003,2794,3112,7463,5174,12533,8012,8851,34570
24,DRC (UNDP),2019,DRC-19/HCG10/UR4/NUT-HLT-PROT-WaSH/INGO/14737,3/9/2021 8:58:56 AM,Overall,1386,2509,6983,7779,18657,12934,31233,20031,22128,86326
24,DRC (UNDP),2019,DRC-19/HCG10/UR4/NUT-HLT-PROT-WaSH/INGO/14737,3/9/2021 8:58:56 AM,Returnees,832,1506,4189,4667,11194,7760,18700,12019,13277,51756
24,DRC (UNDP),2019,DRC-19/HCG10/UR4/PROT/INGO/14735,10/13/2020 9:51:38 AM,Overall,15742,15742,15742,15742,62968,15742,15742,15742,15742,62968
24,DRC (UNDP),2019,DRC-19/HCG10/UR4/PROT/INGO/14735,10/13/2020 9:51:38 AM,Returnees,15742,15742,15742,15742,62968,15742,15742,15742,15742,62968
24,DRC (UNDP),2019,DRC-19/HCG10/UR4/PROT/NGO/14736,10/14/2020 8:45:47 AM,Host Communities,1513,3021,1513,1513,7560,1575,2439,1177,1254,6445
24,DRC (UNDP),2019,DRC-19/HCG10/UR4/PROT/NGO/14736,10/14/2020 8:45:47 AM,Internally Displaced People,672,1347,672,672,3363,1345,2542,1964,2450,8301
24,DRC (UNDP),2019,DRC-19/HCG10/UR4/PROT/NGO/14736,10/14/2020 8:45:47 AM,Other,101,202,101,101,505,249,200,29,33,511
24,DRC (UNDP),2019,DRC-19/HCG10/UR4/PROT/NGO/14736,10/14/2020 8:45:47 AM,Overall,3295,6588,3295,3295,16473,3289,5422,3271,3883,15865
24,DRC (UNDP),2019,DRC-19/HCG10/UR4/PROT/NGO/14736,10/14/2020 8:45:47 AM,Returnees,1009,2018,1009,1009,5045,120,241,101,146,608
24,DRC (UNDP),2019,DRC-19/HCG10/UR5/HLT/INGO/14440,1/8/2021 6:15:39 PM,Host Communities,0,0,97842,101835,199677,0,0,130724,141411,272135
24,DRC (UNDP),2019,DRC-19/HCG10/UR5/HLT/INGO/14440,1/8/2021 6:15:39 PM,Overall,0,0,97842,101835,199677,0,0,130724,141411,272135
24,DRC (UNDP),2019,DRC-19/HCG10/UR5/HLT/INGO/14494,12/7/2020 1:53:53 PM,Host Communities,0,0,49519,47578,97097,0,0,570,401,971
24,DRC (UNDP),2019,DRC-19/HCG10/UR5/HLT/INGO/14494,12/7/2020 1:53:53 PM,Overall,0,0,49519,47578,97097,0,0,570,401,971
24,DRC (UNDP),2019,DRC-19/HCG10/UR5/HLT/NGO/14437,6/2/2020 9:44:09 AM,Other,0,0,47568,51531,99099,0,0,50242,54428,104670
24,DRC (UNDP),2019,DRC-19/HCG10/UR5/HLT/NGO/14437,6/2/2020 9:44:09 AM,Overall,0,0,47568,51531,99099,0,0,50242,54428,104670
24,DRC (UNDP),2019,DRC-19/HCG10/UR5/HLT/UN/14441,1/12/2021 7:10:11 AM,Other,0,0,171268,185540,356808,0,0,168807,182874,351681
24,DRC (UNDP),2019,DRC-19/HCG10/UR5/HLT/UN/14441,1/12/2021 7:10:11 AM,Overall,0,0,171268,185540,356808,0,0,168807,182874,351681
24,DRC (UNDP),2019,DRC-19/HCG10/UR5/HLT/UN/14442,5/12/2020 1:40:28 PM,Other,0,0,25817,27968,53785,0,0,98603,102603,201206
24,DRC (UNDP),2019,DRC-19/HCG10/UR5/HLT/UN/14442,5/12/2020 1:40:28 PM,Overall,0,0,25817,27968,53785,0,0,98603,102603,201206
53,Ethiopia,2015,ETH-15/DDA-3379/CP/A/INGO/1766,8/10/2016 12:03:27 PM,Overall,4156,5348,4019,4324,17847,5687,11621,15024,16028,48360
53,Ethiopia,2015,ETH-15/DDA-3379/CP/CSS/UN/2067,8/12/2016 6:45:59 AM,Overall,200,200,0,0,400,396,355,0,0,751
53,Ethiopia,2015,ETH-15/DDA-3379/CP/FSL/INGO/2073,4/10/2017 11:10:10 AM,Host Communities,27750,9250,0,0,37000,0,0,0,0,0
53,Ethiopia,2015,ETH-15/DDA-3379/CP/FSL/INGO/2073,4/10/2017 11:10:10 AM,Overall,27750,9250,0,0,37000,97807,25897,0,0,123704
53,Ethiopia,2015,ETH-15/DDA-3379/CP/FSL-N-WASH/INGO/1865,4/7/2017 9:14:43 AM,Host Communities,11151,12081,6273,6795,36300,11597,12345,6360,7108,37410
53,Ethiopia,2015,ETH-15/DDA-3379/CP/FSL-N-WASH/INGO/1865,4/7/2017 9:14:43 AM,Overall,11151,12081,6273,6795,36300,11597,12345,6360,7108,37410
53,Ethiopia,2015,ETH-15/DDA-3379/CP/FSL-N-WASH/INGO/1941,4/4/2017 6:11:14 AM,Overall,12368,13398,6957,7537,40260,12628,13680,7103,7695,41106
53,Ethiopia,2015,ETH-15/DDA-3379/CP/H/UN/1952,10/11/2016 8:01:06 AM,Overall,0,0,2707767,2601580,5309347,0,0,2820519,2709910,5530429
53,Ethiopia,2015,ETH-15/DDA-3379/CP/N/INGO/1783,7/26/2016 12:24:09 AM,Host Communities,0,487,358,365,1210,0,437,366,415,1218
53,Ethiopia,2015,ETH-15/DDA-3379/CP/N/INGO/1783,7/26/2016 12:24:09 AM,Overall,0,487,358,365,1210,0,437,366,415,1218
53,Ethiopia,2015,ETH-15/DDA-3379/CP/N/INGO/1813,8/18/2016 2:39:18 PM,Host Communities,0,6277,3833,3682,13792,0,7326,4377,4558,16261
53,Ethiopia,2015,ETH-15/DDA-3379/CP/N/INGO/1813,8/18/2016 2:39:18 PM,Overall,0,6277,3833,3682,13792,0,7326,4377,4558,16261
53,Ethiopia,2015,ETH-15/DDA-3379/CP/N/INGO/1953,3/7/2017 1:46:15 PM,Overall,0,4816,6803,7082,18701,0,13863,4555,4023,22441
53,Ethiopia,2015,ETH-15/DDA-3379/CP/N/INGO/1960,9/2/2016 8:03:11 AM,Host Communities,0,6602,5972,6215,18789,0,6385,7615,7297,21297
53,Ethiopia,2015,ETH-15/DDA-3379/CP/N/INGO/1960,9/2/2016 8:03:11 AM,Overall,0,6602,5972,6215,18789,0,6385,7615,7297,21297
53,Ethiopia,2015,ETH-15/DDA-3379/CP/N/INGO/2046,3/7/2017 1:44:58 PM,Overall,0,1936,2089,2175,6200,0,2552,2580,2646,7778
53,Ethiopia,2015,ETH-15/DDA-3379/CP/N/INGO/2068,9/19/2016 3:29:49 PM,Other,18927,19966,0,0,38893,18958,20166,0,0,39124
53,Ethiopia,2015,ETH-15/DDA-3379/CP/N/INGO/2068,9/19/2016 3:29:49 PM,Overall,0,21920,11838,12321,46079,0,15789,8762,10639,35190
53,Ethiopia,2015,ETH-15/DDA-3379/CP/N/INGO/2071,9/23/2016 9:10:35 AM,Host Communities,0,4015,653,680,5348,0,0,0,0,0
53,Ethiopia,2015,ETH-15/DDA-3379/CP/N/INGO/2071,9/23/2016 9:10:35 AM,Overall,0,4015,653,680,5348,0,5284,850,947,7081
53,Ethiopia,2015,ETH-15/DDA-3379/CP/N/INGO/2072,4/12/2017 9:00:24 AM,Host Communities,0,5248,1025,1066,7339,5480,13260,1612,2417,22769
53,Ethiopia,2015,ETH-15/DDA-3379/CP/N/INGO/2072,4/12/2017 9:00:24 AM,Overall,0,5248,1025,1066,7339,5480,13260,1612,2417,22769
53,Ethiopia,2015,ETH-15/DDA-3379/CP/N-WASH/INGO/1929,9/21/2016 8:39:28 AM,Host Communities,8503,17163,10676,10676,47018,8637,11415,13558,13450,47060
53,Ethiopia,2015,ETH-15/DDA-3379/CP/N-WASH/INGO/1929,9/21/2016 8:39:28 AM,Overall,8503,17163,10676,10676,47018,8637,11415,13558,13450,47060
53,Ethiopia,2015,ETH-15/DDA-3379/CP/N-WASH/INGO/1938,9/19/2016 3:30:39 PM,Host Communities,0,2890,1416,1474,5780,0,3881,752,711,5344
53,Ethiopia,2015,ETH-15/DDA-3379/CP/N-WASH/INGO/1938,9/19/2016 3:30:39 PM,Overall,0,2890,1416,1474,5780,0,3881,752,711,5344
53,Ethiopia,2015,ETH-15/DDA-3379/CP/N-WASH-A/INGO/1843,9/14/2016 12:01:58 PM,Host Communities,49674,39030,8279,8617,105600,49674,39030,8279,8617,105600
53,Ethiopia,2015,ETH-15/DDA-3379/CP/N-WASH-A/INGO/1843,9/14/2016 12:01:58 PM,Overall,49674,39030,8279,8617,105600,49674,39030,8279,8617,105600
53,Ethiopia,2015,ETH-15/DDA-3379/CP/WASH/INGO/1735,8/12/2016 10:14:33 AM,Host Communities,4322,4969,437,438,10166,190,5947,2933,3043,12113
53,Ethiopia,2015,ETH-15/DDA-3379/CP/WASH/INGO/1735,8/12/2016 10:14:33 AM,Overall,4322,4969,437,438,10166,190,5947,2933,3043,12113
53,Ethiopia,2015,ETH-15/DDA-3379/CP/WASH/INGO/1738,7/26/2016 12:22:36 AM,Overall,26055,31845,0,0,57900,28752,35142,0,0,63894
53,Ethiopia,2015,ETH-15/DDA-3379/CP/WASH/INGO/1806,9/7/2016 9:00:09 AM,Overall,0,10670,8335,8676,27681,0,10267,6017,7354,23638
53,Ethiopia,2015,ETH-15/DDA-3379/CP/WASH/INGO/2217,3/8/2017 7:01:28 AM,Host Communities,10294,9890,2108,2026,24318,9900,9850,2001,2567,24318
53,Ethiopia,2015,ETH-15/DDA-3379/CP/WASH/INGO/2217,3/8/2017 7:01:28 AM,Overall,10294,9890,2108,2026,24318,9900,9850,2001,2567,24318
53,Ethiopia,2015,ETH-15/DDA-3379/CP/WASH/INGO/2237,7/7/2017 6:11:03 AM,Host Communities,29127,23259,0,0,52386,0,0,0,0,0
53,Ethiopia,2015,ETH-15/DDA-3379/CP/WASH/INGO/2237,7/7/2017 6:11:03 AM,Overall,29127,23259,0,0,52386,34993,37909,0,0,72902
53,Ethiopia,2015,ETH-15/DDA-3379/CP/WASH/INGO/2242,3/23/2017 6:32:55 AM,Host Communities,19562,18795,0,0,38357,7711,8164,14514,14968,45357
53,Ethiopia,2015,ETH-15/DDA-3379/CP/WASH/INGO/2242,3/23/2017 6:32:55 AM,Overall,19562,18795,0,0,38357,7711,8164,14514,14968,45357
53,Ethiopia,2015,ETH-15/DDA-3379/CP/WASH/INGO/2257,4/6/2017 4:02:09 PM,Overall,10108,20190,5700,5700,41698,13964,27633,3285,3571,48453
53,Ethiopia,2015,ETH-15/DDA-3379/CP/WASH/INGO/2258,10/23/2017 8:31:58 AM,Host Communities,10374,7826,8750,8050,35000,27220,22586,4344,3764,57914
53,Ethiopia,2015,ETH-15/DDA-3379/CP/WASH/INGO/2258,10/23/2017 8:31:58 AM,Overall,10374,7826,8750,8050,35000,27220,22586,4344,3764,57914
53,Ethiopia,2015,ETH-15/DDA-3379/CP/WASH/INGO/2263,5/22/2017 1:18:32 PM,Host Communities,1842,3418,2764,2876,10900,1701,3573,2580,2610,10464
53,Ethiopia,2015,ETH-15/DDA-3379/CP/WASH/INGO/2263,5/22/2017 1:18:32 PM,Overall,1842,3418,2764,2876,10900,1701,3573,2580,2610,10464
53,Ethiopia,2015,ETH-15/DDA-3379/CP/WASH/INGO/2266,4/14/2017 7:20:22 AM,Host Communities,12024,13666,18037,18772,62499,16917,19581,23882,25004,85384
53,Ethiopia,2015,ETH-15/DDA-3379/CP/WASH/INGO/2266,4/14/2017 7:20:22 AM,Overall,12024,13666,18037,18772,62499,16917,19581,23882,25004,85384
53,Ethiopia,2015,ETH-15/DDA-3379/CP/WASH/INGO/2267,4/12/2017 12:12:47 PM,Host Communities,6006,4634,7433,7027,25100,6184,11957,7637,7968,33746
53,Ethiopia,2015,ETH-15/DDA-3379/CP/WASH/INGO/2267,4/12/2017 12:12:47 PM,Overall,6006,4634,7433,7027,25100,6184,11957,7637,7968,33746
53,Ethiopia,2015,ETH-15/DDA-3379/CP/WASH/INGO/2268,4/12/2017 12:28:08 PM,Overall,31224,32499,0,0,63723,52908,44478,11045,16569,125000
53,Ethiopia,2015,ETH-15/DDA-3379/CP/WASH/INGO/2291,4/7/2017 10:25:22 AM,Host Communities,6720,6623,9680,9541,32564,7700,8230,9178,9337,34445
53,Ethiopia,2015,ETH-15/DDA-3379/CP/WASH/INGO/2291,4/7/2017 10:25:22 AM,Overall,6720,6623,9680,9541,32564,7700,8230,9178,9337,34445
53,Ethiopia,2015,ETH-15/DDA-3379/CP/WASH/INGO/2292,4/12/2017 8:57:10 AM,Host Communities,36714,36329,0,0,73043,36714,36329,0,0,73043
53,Ethiopia,2015,ETH-15/DDA-3379/CP/WASH/INGO/2292,4/12/2017 8:57:10 AM,Overall,36714,36329,0,0,73043,36714,36329,0,0,73043
53,Ethiopia,2015,ETH-15/DDA-3379/CP/WASH/INGO/2293,4/12/2017 11:14:55 AM,Host Communities,3161,3218,4324,3772,14475,4905,5345,5105,4755,20110
53,Ethiopia,2015,ETH-15/DDA-3379/CP/WASH/INGO/2293,4/12/2017 11:14:55 AM,Overall,3161,3218,4324,3772,14475,4905,5345,5105,4755,20110
53,Ethiopia,2015,ETH-15/DDA-3379/CP/WASH/INGO/2297,4/12/2017 12:09:01 PM,Overall,37449,31978,42080,41492,152999,38367,32762,43111,42509,156749
53,Ethiopia,2015,ETH-15/DDA-3379/CP/WASH/INGO/2303,5/11/2017 2:08:29 PM,Overall,5909,6151,0,0,12060,5929,6249,0,0,12178
53,Ethiopia,2015,ETH-15/DDA-3379/CP/WASH/INGO/2308,7/25/2017 6:33:31 AM,Host Communities,12005,9987,11796,9796,43584,12005,9987,11796,9796,43584
53,Ethiopia,2015,ETH-15/DDA-3379/CP/WASH/INGO/2308,7/25/2017 6:33:31 AM,Other,306,306,204,204,1020,306,306,204,204,1020
53,Ethiopia,2015,ETH-15/DDA-3379/CP/WASH/INGO/2308,7/25/2017 6:33:31 AM,Overall,12311,10293,12000,10000,44604,12311,10293,12000,10000,44604
53,Ethiopia,2015,ETH-15/DDA-3379/CP/WASH/INGO/2309,7/12/2017 9:17:08 AM,Host Communities,2500,6550,2000,5450,16500,2350,5800,1750,5200,15100
53,Ethiopia,2015,ETH-15/DDA-3379/CP/WASH/INGO/2309,7/12/2017 9:17:08 AM,Internally Displaced People,2500,6550,2000,5450,16500,2350,5800,1750,5200,15100
53,Ethiopia,2015,ETH-15/DDA-3379/CP/WASH/INGO/2309,7/12/2017 9:17:08 AM,Overall,5000,13100,4000,10900,33000,4700,11600,3500,10400,30200
53,Ethiopia,2015,ETH-15/DDA-3379/CP/WASH/INGO/2310,4/7/2017 11:12:37 AM,Host Communities,5880,6120,8820,9180,30000,5435,5657,8153,8487,27732
53,Ethiopia,2015,ETH-15/DDA-3379/CP/WASH/INGO/2310,4/7/2017 11:12:37 AM,Overall,5880,6120,8820,9180,30000,5435,5657,8153,8487,27732
53,Ethiopia,2015,ETH-15/DDA-3379/RB/A/INGO/2136,3/15/2017 9:07:52 AM,Overall,12884,21114,27610,27040,88648,43124,59695,11389,12907,127115
53,Ethiopia,2015,ETH-15/DDA-3379/RB/A/INGO/2315,4/6/2017 2:40:31 PM,Host Communities,171324,164605,0,0,335929,0,0,0,0,0
53,Ethiopia,2015,ETH-15/DDA-3379/RB/A/INGO/2315,4/6/2017 2:40:31 PM,Overall,126535,131700,0,0,258235,130332,130063,0,0,260395
53,Ethiopia,2015,ETH-15/DDA-3379/RB/N/INGO/2098,3/15/2017 8:55:21 AM,Overall,0,45199,16644,16644,78487,0,44385,15603,15763,75751
53,Ethiopia,2015,ETH-15/DDA-3379/RB/N/INGO/2103,3/23/2017 6:44:33 AM,Host Communities,0,1947,380,395,2722,0,2628,1870,2014,6512
53,Ethiopia,2015,ETH-15/DDA-3379/RB/N/INGO/2103,3/23/2017 6:44:33 AM,Overall,0,1947,380,395,2722,0,2628,1870,2014,6512
53,Ethiopia,2015,ETH-15/DDA-3379/RB/N/INGO/2104,4/26/2017 8:08:19 AM,Host Communities,4274,16024,5981,5879,32158,0,0,0,0,0
53,Ethiopia,2015,ETH-15/DDA-3379/RB/N/INGO/2104,4/26/2017 8:08:19 AM,Overall,4274,16024,5981,5879,32158,4517,21440,8357,8441,42755
53,Ethiopia,2015,ETH-15/DDA-3379/RB/N/INGO/2123,4/6/2017 2:51:39 PM,Overall,0,6173,4153,4322,14648,0,8493,4134,4870,17497
53,Ethiopia,2015,ETH-15/DDA-3379/RB/N/INGO/2152,3/8/2017 8:43:13 AM,Host Communities,69,8121,5830,5602,19622,0,0,0,0,0
53,Ethiopia,2015,ETH-15/DDA-3379/RB/N/INGO/2152,3/8/2017 8:43:13 AM,Overall,69,8121,5830,5602,19622,0,15342,10187,11016,36545
53,Ethiopia,2015,ETH-15/DDA-3379/RB/N/INGO/2227,3/23/2017 6:34:54 AM,Host Communities,0,5543,2521,1981,10045,0,26080,11875,9323,47278
53,Ethiopia,2015,ETH-15/DDA-3379/RB/N/INGO/2227,3/23/2017 6:34:54 AM,Overall,0,5543,2521,1981,10045,0,26080,11875,9323,47278
53,Ethiopia,2015,ETH-15/DDA-3379/RB/P/UN/2296,3/8/2021 7:01:19 PM,Internally Displaced People,75,55,7685,5565,13380,0,0,8569,6243,14812
53,Ethiopia,2015,ETH-15/DDA-3379/RB/P/UN/2296,3/8/2021 7:01:19 PM,Other,75,55,7685,5565,13380,0,0,8569,6243,14812
53,Ethiopia,2015,ETH-15/DDA-3379/RB/P/UN/2296,3/8/2021 7:01:19 PM,Overall,150,110,15370,11130,26760,0,0,8569,6243,14812
53,Ethiopia,2015,ETH-15/DDA-3379/RB/WASH/INGO/2101,3/13/2017 7:52:00 AM,Host Communities,17488,20786,28535,29956,96765,31344,22761,20674,19619,94398
53,Ethiopia,2015,ETH-15/DDA-3379/RB/WASH/INGO/2101,3/13/2017 7:52:00 AM,Overall,17488,20786,28535,29956,96765,31344,22761,20674,19619,94398
53,Ethiopia,2015,ETH-15/DDA-3379/RB/WASH/INGO/2102,3/15/2017 8:56:36 AM,Host Communities,18625,44567,16180,16180,95552,33486,78081,6225,6919,124711
53,Ethiopia,2015,ETH-15/DDA-3379/RB/WASH/INGO/2102,3/15/2017 8:56:36 AM,Overall,18625,44567,16180,16180,95552,33486,75081,6225,6919,121711
53,Ethiopia,2015,ETH-15/DDA-3379/RB/WASH/INGO/2107,12/11/2017 1:43:33 PM,Host Communities,8182,12371,15115,15783,51451,10200,12170,10003,10447,42820
53,Ethiopia,2015,ETH-15/DDA-3379/RB/WASH/INGO/2107,12/11/2017 1:43:33 PM,Overall,8182,12371,15115,15783,51451,10200,12170,10003,10447,42820
53,Ethiopia,2015,ETH-15/DDA-3379/RB/WASH/INGO/2108,3/20/2017 7:46:38 AM,Host Communities,13688,55809,22438,22438,114373,10008,36283,9863,11276,67430
53,Ethiopia,2015,ETH-15/DDA-3379/RB/WASH/INGO/2108,3/20/2017 7:46:38 AM,Overall,13688,55809,22438,22438,114373,10008,36283,9863,11276,67430
53,Ethiopia,2015,ETH-15/DDA-3379/RB/WASH/INGO/2146,10/6/2016 12:11:16 PM,Overall,9950,10990,8635,9935,39510,17114,18885,14603,15797,66399
53,Ethiopia,2015,ETH-15/DDA-3379/RB/WASH/INGO/2212,3/15/2017 8:48:15 AM,Host Communities,5150,7063,8146,8654,29013,14584,17359,17303,18752,67998
53,Ethiopia,2015,ETH-15/DDA-3379/RB/WASH/INGO/2212,3/15/2017 8:48:15 AM,Overall,5150,7063,8146,8654,29013,14584,17359,17303,18752,67998
53,Ethiopia,2015,ETH-15/DDA-3379/RB/WASH/INGO/2269,5/15/2017 12:56:54 PM,Host Communities,2792,4537,6426,6314,20069,2774,4958,7482,6667,21881
53,Ethiopia,2015,ETH-15/DDA-3379/RB/WASH/INGO/2269,5/15/2017 12:56:54 PM,Overall,2792,4537,6426,6314,20069,2774,4958,7482,6667,21881
53,Ethiopia,2015,ETH-15/DDA-3379/RB/WASH/INGO/2282,3/23/2017 6:43:01 AM,Overall,4764,4958,5372,5591,20685,18833,19638,21663,22368,82502
53,Ethiopia,2015,ETH-15/DDA-3379/RB/WASH/INGO/2289,4/20/2017 7:28:42 AM,Overall,17330,18038,0,0,35368,10389,9979,0,0,20368
53,Ethiopia,2015,ETH-15/DDA-3379/RB/WASH/NGO/2294,3/8/2017 11:04:58 AM,Overall,17152,18213,0,0,35365,18507,19578,0,0,38085
53,Ethiopia,2016,ETH-16/DDA-3379/CP/A/INGO/2490,3/8/2017 10:53:06 AM,Host Communities,84893,88357,0,0,173250,84893,88357,0,0,173250
53,Ethiopia,2016,ETH-16/DDA-3379/CP/A/INGO/2490,3/8/2017 10:53:06 AM,Overall,84893,88357,0,0,173250,84893,88357,0,0,173250
53,Ethiopia,2016,ETH-16/DDA-3379/CP/A/INGO/2508,4/14/2017 8:01:48 AM,Host Communities,13711,14484,11042,12026,51263,21081,22269,16977,18490,78817
53,Ethiopia,2016,ETH-16/DDA-3379/CP/A/INGO/2508,4/14/2017 8:01:48 AM,Overall,13711,14484,11042,12026,51263,21081,22269,16977,18490,78817
53,Ethiopia,2016,ETH-16/DDA-3379/CP/A/INGO/2517,4/6/2017 4:08:38 PM,Overall,53513,55240,29346,34425,172524,64087,66156,35145,41227,206615
53,Ethiopia,2016,ETH-16/DDA-3379/CP/A/INGO/2519,3/8/2017 8:47:35 AM,Other,9872,10482,16770,16439,53563,13325,12549,21741,20474,68089
53,Ethiopia,2016,ETH-16/DDA-3379/CP/A/INGO/2519,3/8/2017 8:47:35 AM,Overall,9872,10482,16770,16439,53563,13325,12549,21741,20474,68089
53,Ethiopia,2016,ETH-16/DDA-3379/CP/A/INGO/2522,4/17/2017 6:54:42 AM,Overall,9811,9921,10000,9328,39060,16979,17171,17306,16144,67600
53,Ethiopia,2016,ETH-16/DDA-3379/CP/A/UN/2526,3/2/2018 9:20:38 AM,Overall,19180,27400,41648,48772,137000,28910,37741,61026,61028,188705
53,Ethiopia,2016,ETH-16/DDA-3379/CP/A-N-WASH/INGO/2428,5/1/2017 11:22:12 AM,Host Communities,22366,25092,19310,19985,86753,28942,32377,17587,17219,96125
53,Ethiopia,2016,ETH-16/DDA-3379/CP/A-N-WASH/INGO/2428,5/1/2017 11:22:12 AM,Overall,22366,25092,19310,19985,86753,28942,32377,17587,17219,96125
53,Ethiopia,2016,ETH-16/DDA-3379/CP/A-WASH/INGO/2520,7/11/2017 1:40:39 PM,Overall,24301,24302,6075,6075,60753,28543,19213,6575,8199,62530
53,Ethiopia,2016,ETH-16/DDA-3379/CP/FSL-N-H-WASH/INGO/2863,11/7/2017 8:51:00 AM,Overall,20405,15765,8360,8111,52641,14569,44827,28875,29566,117837
53,Ethiopia,2016,ETH-16/DDA-3379/CP/H/INGO/2415,7/12/2017 1:12:35 PM,Overall,24353,24549,7337,7278,63517,23351,21210,6650,6621,57832
53,Ethiopia,2016,ETH-16/DDA-3379/CP/H/INGO/2445,3/23/2017 6:49:20 AM,Host Communities,7800,19000,6100,6100,39000,11300,11406,8460,7834,39000
53,Ethiopia,2016,ETH-16/DDA-3379/CP/H/INGO/2445,3/23/2017 6:49:20 AM,Overall,7800,19500,5850,5850,39000,11300,11406,8460,7834,39000
53,Ethiopia,2016,ETH-16/DDA-3379/CP/H/INGO/2452,3/23/2017 6:50:29 AM,Overall,11256,12507,18712,20057,62532,11709,42414,5153,4970,64246
53,Ethiopia,2016,ETH-16/DDA-3379/CP/H/UN/2154,7/12/2017 2:11:46 PM,Overall,1000000,2200000,1000000,1000000,5200000,1000000,2250000,1000000,1000000,5250000
53,Ethiopia,2016,ETH-16/DDA-3379/CP/H/UN/2392,7/11/2017 2:23:50 PM,Internally Displaced People,11960,11324,17321,14395,55000,14050,13411,19798,16604,63863
53,Ethiopia,2016,ETH-16/DDA-3379/CP/H/UN/2392,7/11/2017 2:23:50 PM,Other,1005,4751,2199,3489,11444,937,4753,2199,3555,11444
53,Ethiopia,2016,ETH-16/DDA-3379/CP/H/UN/2392,7/11/2017 2:23:50 PM,Overall,12965,16075,19520,17884,66444,16568,15814,23345,19580,75307
53,Ethiopia,2016,ETH-16/DDA-3379/CP/H/UN/3767,4/17/2017 7:19:10 AM,Overall,850,850,150,150,2000,769,800,513,533,2615
53,Ethiopia,2016,ETH-16/DDA-3379/CP/H-WASH/INGO/3387,8/1/2017 9:05:59 AM,Host Communities,116454,140621,26729,27450,311254,143089,169468,34817,35180,382554
53,Ethiopia,2016,ETH-16/DDA-3379/CP/H-WASH/INGO/3387,8/1/2017 9:05:59 AM,Overall,123824,146651,30129,30650,331254,143089,169468,34817,35180,382554
53,Ethiopia,2016,ETH-16/DDA-3379/CP/N/INGO/2322,5/22/2017 1:19:15 PM,Host Communities,0,1663,1523,1586,4772,0,2078,802,1082,3962
53,Ethiopia,2016,ETH-16/DDA-3379/CP/N/INGO/2322,5/22/2017 1:19:15 PM,Overall,0,1663,1523,1586,4772,0,2078,802,1082,3962
53,Ethiopia,2016,ETH-16/DDA-3379/CP/N/INGO/2417,4/17/2017 6:53:35 AM,Host Communities,0,2295,722,591,3608,0,4831,2809,2992,10632
53,Ethiopia,2016,ETH-16/DDA-3379/CP/N/INGO/2417,4/17/2017 6:53:35 AM,Overall,0,2295,722,591,3608,0,4831,2809,2992,10632
53,Ethiopia,2016,ETH-16/DDA-3379/CP/N/INGO/2554,3/7/2018 12:57:56 PM,Overall,765,14069,7396,7991,30221,1207,13461,7242,8752,30662
53,Ethiopia,2016,ETH-16/DDA-3379/CP/N/UN/2345,7/12/2017 8:39:48 AM,Overall,0,212781,60522,60200,333503,0,182465,123459,128457,434381
53,Ethiopia,2016,ETH-16/DDA-3379/CP/N/UN/2358,4/17/2017 6:52:52 AM,Overall,4900000,5300000,0,0,10200000,0,0,0,0,0
53,Ethiopia,2016,ETH-16/DDA-3379/CP/NFI/ES/INGO/2400,7/31/2017 12:00:59 PM,Overall,6113,6507,11762,11368,35750,6578,7222,12770,12840,39410
53,Ethiopia,2016,ETH-16/DDA-3379/CP/NFI/ES/INGO/2418,7/19/2017 11:17:18 AM,Internally Displaced People,3578,3658,4986,4473,16695,2882,3358,4896,5536,16672
53,Ethiopia,2016,ETH-16/DDA-3379/CP/NFI/ES/INGO/2418,7/19/2017 11:17:18 AM,Overall,21,22,30,27,100,17,20,30,33,100
53,Ethiopia,2016,ETH-16/DDA-3379/CP/NFI/ES/UN/2349,7/14/2017 10:17:37 AM,Internally Displaced People,7893,7474,11432,9501,36300,8373,7993,11798,9896,38060
53,Ethiopia,2016,ETH-16/DDA-3379/CP/NFI/ES/UN/2349,7/14/2017 10:17:37 AM,Overall,7893,7474,11432,9501,36300,8373,7993,11798,9896,38060
53,Ethiopia,2016,ETH-16/DDA-3379/CP/N-H/INGO/2423,7/13/2017 8:56:08 AM,Host Communities,7788,55044,15121,15122,93075,8629,86210,15017,7224,117080
53,Ethiopia,2016,ETH-16/DDA-3379/CP/N-H/INGO/2423,7/13/2017 8:56:08 AM,Overall,7788,55044,15121,15122,93075,8629,86210,15017,7224,117080
53,Ethiopia,2016,ETH-16/DDA-3379/CP/N-H/INGO/2742,7/26/2017 11:31:23 AM,Host Communities,16638,48456,14757,14764,94615,14850,84812,13880,23575,137117
53,Ethiopia,2016,ETH-16/DDA-3379/CP/N-H/INGO/2742,7/26/2017 11:31:23 AM,Overall,16638,48456,14757,14764,94615,14850,84812,13880,23575,137117
53,Ethiopia,2016,ETH-16/DDA-3379/CP/N-H-FSL-WASH/INGO/2424,11/8/2017 12:13:25 PM,Host Communities,12428,84810,66317,69447,233002,38124,97236,47254,50869,233483
53,Ethiopia,2016,ETH-16/DDA-3379/CP/N-H-FSL-WASH/INGO/2424,11/8/2017 12:13:25 PM,Overall,12428,84810,66317,69447,233002,38124,97236,47254,50869,233483
53,Ethiopia,2016,ETH-16/DDA-3379/CP/NUTRITION/INGO/2324,3/23/2017 6:47:57 AM,Host Communities,4031,6753,7369,7719,25872,3140,4090,10020,10430,27680
53,Ethiopia,2016,ETH-16/DDA-3379/CP/NUTRITION/INGO/2324,3/23/2017 6:47:57 AM,Overall,4031,6753,7369,7719,25872,3140,4090,10020,10430,27680
53,Ethiopia,2016,ETH-16/DDA-3379/CP/N-WASH/INGO/2577,7/19/2017 1:16:18 PM,Overall,66,6589,8871,8523,24049,0,19660,12963,13547,46170
53,Ethiopia,2016,ETH-16/DDA-3379/CP/N-WASH-H/INGO/2450,3/1/2018 8:34:05 AM,Host Communities,0,1311,2482,2582,6375,0,10687,3674,3826,18187
53,Ethiopia,2016,ETH-16/DDA-3379/CP/N-WASH-H/INGO/2450,3/1/2018 8:34:05 AM,Overall,0,1311,2482,2582,6375,0,10687,3674,3826,18187
53,Ethiopia,2016,ETH-16/DDA-3379/CP/N-WASH-NFI/ES-FSL/INGO/2459,7/19/2017 7:33:39 AM,Host Communities,15408,9913,2461,1772,29554,14174,9202,1820,1358,26554
53,Ethiopia,2016,ETH-16/DDA-3379/CP/N-WASH-NFI/ES-FSL/INGO/2459,7/19/2017 7:33:39 AM,Overall,15408,9913,2461,1772,29554,14174,9202,1820,1358,26554
53,Ethiopia,2016,ETH-16/DDA-3379/CP/WASH/INGO/2332,7/14/2017 8:19:13 AM,Overall,5621,7186,7695,8030,28532,5415,7332,7573,8558,28878
53,Ethiopia,2016,ETH-16/DDA-3379/CP/WASH/INGO/2440,3/15/2017 9:04:59 AM,Overall,3187,3774,688,541,8190,23040,25920,4608,4032,57600
53,Ethiopia,2016,ETH-16/DDA-3379/CP/WASH/INGO/3451,8/10/2017 2:23:02 PM,Host Communities,170412,161319,0,0,331731,0,0,0,0,0
53,Ethiopia,2016,ETH-16/DDA-3379/CP/WASH/INGO/3451,8/10/2017 2:23:02 PM,Overall,170412,161319,0,0,331731,0,0,0,0,0
53,Ethiopia,2016,ETH-16/DDA-3379/CP/WASH/INGO/3506,10/30/2017 2:36:22 PM,Host Communities,9591,9454,13814,13616,46475,14522,13489,14711,14542,57264
53,Ethiopia,2016,ETH-16/DDA-3379/CP/WASH/INGO/3506,10/30/2017 2:36:22 PM,Overall,9591,9454,13814,13616,46475,14522,13489,14711,14542,57264
53,Ethiopia,2016,ETH-16/DDA-3379/CP/WASH/INGO/3512,8/8/2017 12:57:45 PM,Overall,12027,11556,2123,2039,27745,13973,13648,2599,2275,32495
53,Ethiopia,2016,ETH-16/DDA-3379/CP/WASH/INGO/3557,7/17/2017 6:59:22 AM,Overall,174345,179256,238189,226730,818520,143787,151036,169840,306299,770962
53,Ethiopia,2016,ETH-16/DDA-3379/CP/WASH-H/INGO/3446,7/19/2017 9:02:07 AM,Overall,28778,29953,5079,5286,69096,72967,75945,12877,13402,175191
53,Ethiopia,2016,ETH-16/DDA-3379/CP/WASH-H/INGO/3483,7/31/2017 12:19:15 PM,Overall,32000,32000,8000,8000,80000,51940,54060,12985,13515,132500
53,Ethiopia,2016,ETH-16/DDA-3379/CP/WASH-H/INGO/3543,1/22/2018 9:09:33 AM,Host Communities,66667,49990,33339,16670,166666,72019,82906,18005,14630,187560
53,Ethiopia,2016,ETH-16/DDA-3379/CP/WASH-H/INGO/3543,1/22/2018 9:09:33 AM,Overall,66667,49990,33339,16670,166666,72019,82906,18005,14630,187560
53,Ethiopia,2016,ETH-16/DDA-3379/RB/A/INGO/2963,3/23/2017 6:47:13 AM,Overall,265007,284995,61544,67950,679496,293024,315125,68050,75134,751333
53,Ethiopia,2016,ETH-16/DDA-3379/RB/A/UN/3133,7/13/2017 7:51:52 AM,Overall,26250,37500,57000,66750,187500,47538,63789,103806,103810,318943
53,Ethiopia,2016,ETH-16/DDA-3379/RB/CSS/UN/3152,4/17/2017 6:55:52 AM,Overall,2282123,2406125,0,0,4688248,4164172,4081711,0,0,8245883
53,Ethiopia,2016,ETH-16/DDA-3379/RB/H/UN/3141,9/5/2018 7:32:25 AM,Overall,14689,17363,5409,6139,43600,16241,19198,5981,6788,48208
53,Ethiopia,2016,ETH-16/DDA-3379/RB/H-WASH-NFI/ES/INGO/4427,11/7/2017 7:57:57 AM,Other,10000,10000,20000,20000,60000,85701,89199,143100,72981,390981
53,Ethiopia,2016,ETH-16/DDA-3379/RB/H-WASH-NFI/ES/INGO/4427,11/7/2017 7:57:57 AM,Overall,10000,10000,20000,20000,60000,48607,50589,30778,24274,154248
53,Ethiopia,2016,ETH-16/DDA-3379/RB/L/INGO/3755,11/9/2017 12:11:49 PM,Overall,0,443686,221843,221843,887372,0,406671,203336,203336,813343
53,Ethiopia,2016,ETH-16/DDA-3379/RB/L/UN/3480,8/7/2017 11:35:15 AM,Overall,43418,124570,93040,100792,361820,43418,124570,93040,100792,361820
53,Ethiopia,2016,ETH-16/DDA-3379/RB/L/UN/4431,11/7/2017 9:10:19 AM,Overall,65823,186498,142616,153586,548523,65828,187255,142620,152897,548600
53,Ethiopia,2016,ETH-16/DDA-3379/RB/N/INGO/2804,4/4/2017 8:06:22 AM,Overall,0,3920,2160,2200,8280,0,4821,3076,3030,10927
53,Ethiopia,2016,ETH-16/DDA-3379/RB/N/INGO/2992,12/8/2017 10:31:06 AM,Host Communities,8534,39389,34645,33284,115852,15336,52400,26953,27615,122304
53,Ethiopia,2016,ETH-16/DDA-3379/RB/N/INGO/2992,12/8/2017 10:31:06 AM,Overall,8534,39389,34645,33284,115852,15336,52400,26953,27615,122304
53,Ethiopia,2016,ETH-16/DDA-3379/RB/N/INGO/3175,3/23/2017 6:45:19 AM,Host Communities,0,3311,1910,1989,7210,0,4035,1452,1573,7060
53,Ethiopia,2016,ETH-16/DDA-3379/RB/N/INGO/3175,3/23/2017 6:45:19 AM,Overall,0,3311,1910,1989,7210,0,4035,1452,1573,7060
53,Ethiopia,2016,ETH-16/DDA-3379/RB/NFI/ES/INGO/3143,8/7/2017 8:49:41 AM,Internally Displaced People,10489,10636,14911,13668,49704,9314,10395,14574,13359,47642
53,Ethiopia,2016,ETH-16/DDA-3379/RB/NFI/ES/INGO/3143,8/7/2017 8:49:41 AM,Overall,10489,10636,14911,13668,49704,9314,10395,14574,13359,47642
53,Ethiopia,2016,ETH-16/DDA-3379/RB/P/INGO/3145,8/2/2017 11:02:26 AM,Overall,3000,7000,3000,5000,18000,1889,9029,559,3878,15355
53,Ethiopia,2016,ETH-16/DDA-3379/RB/P/UN/3142,12/12/2017 8:34:15 AM,Host Communities,16459,38405,10973,25603,91440,8625,23724,6213,17325,55887
53,Ethiopia,2016,ETH-16/DDA-3379/RB/P/UN/3142,12/12/2017 8:34:15 AM,Internally Displaced People,5096,4260,3398,2840,15594,2568,2976,1874,2163,9581
53,Ethiopia,2016,ETH-16/DDA-3379/RB/P/UN/3142,12/12/2017 8:34:15 AM,Overall,21555,42665,14371,28443,107034,11193,26700,8087,19488,65468
53,Ethiopia,2016,ETH-16/DDA-3379/RB/WASH/INGO/2323,5/12/2017 8:33:20 AM,Host Communities,4840,6600,5060,5500,22000,4840,6600,5060,5500,22000
53,Ethiopia,2016,ETH-16/DDA-3379/RB/WASH/INGO/2323,5/12/2017 8:33:20 AM,Internally Displaced People,4840,6600,5060,5500,22000,4840,6600,5060,5500,22000
53,Ethiopia,2016,ETH-16/DDA-3379/RB/WASH/INGO/2323,5/12/2017 8:33:20 AM,Overall,10560,14400,11040,12000,48000,10560,14400,11040,12000,48000
53,Ethiopia,2016,ETH-16/DDA-3379/RB/WASH/INGO/2326,4/18/2017 6:25:51 AM,Other,6105,6463,11491,11850,35909,33207,22138,0,0,55345
53,Ethiopia,2016,ETH-16/DDA-3379/RB/WASH/INGO/2326,4/18/2017 6:25:51 AM,Overall,6227,6593,11720,12086,36626,12518,13028,0,0,25546
53,Ethiopia,2016,ETH-16/DDA-3379/RB/WASH/UN/2734,10/30/2017 11:12:58 AM,Host Communities,76832,79968,79968,83232,320000,26337,27412,27412,28530,109691
53,Ethiopia,2016,ETH-16/DDA-3379/RB/WASH/UN/2734,10/30/2017 11:12:58 AM,Internally Displaced People,38416,39984,39984,41616,160000,0,0,0,0,0
53,Ethiopia,2016,ETH-16/DDA-3379/RB/WASH/UN/2734,10/30/2017 11:12:58 AM,Overall,115248,119952,119952,124848,480000,26337,27412,27412,28530,109691
53,Ethiopia,2017,ETH-17/DDA-3379/CP/A/INGO/4465,10/31/2017 7:47:14 AM,Host Communities,3350,3350,7236,4489,18425,3350,3350,7236,4489,18425
53,Ethiopia,2017,ETH-17/DDA-3379/CP/A/INGO/4465,10/31/2017 7:47:14 AM,Overall,3350,3350,7236,4489,18425,3350,3350,7236,4489,18425
53,Ethiopia,2017,ETH-17/DDA-3379/CP/A/INGO/4467,12/14/2017 7:38:51 AM,Overall,604,906,3020,4530,9060,873,1201,4365,6005,12444
53,Ethiopia,2017,ETH-17/DDA-3379/CP/A/INGO/4481,11/15/2017 1:15:31 PM,Overall,3320,3456,4981,5184,16941,5350,5568,8025,8352,27295
53,Ethiopia,2017,ETH-17/DDA-3379/CP/A/INGO/4501,2/28/2018 7:54:00 AM,Host Communities,19900,19900,39800,39800,119400,19900,19900,39800,39800,119400
53,Ethiopia,2017,ETH-17/DDA-3379/CP/A/INGO/4501,2/28/2018 7:54:00 AM,Overall,19900,19900,39800,39800,119400,19900,19900,39800,39800,119400
53,Ethiopia,2017,ETH-17/DDA-3379/CP/A/INGO/4506,12/14/2017 2:08:05 PM,Overall,524,786,2620,3930,7860,786,1179,2948,4912,9825
53,Ethiopia,2017,ETH-17/DDA-3379/CP/A/INGO/4513,2/9/2018 8:02:06 AM,Host Communities,17787,7623,0,0,25410,5478,10362,4804,3836,24480
53,Ethiopia,2017,ETH-17/DDA-3379/CP/A/INGO/4513,2/9/2018 8:02:06 AM,Overall,17787,7623,0,0,25410,5478,10362,4804,3836,24480
53,Ethiopia,2017,ETH-17/DDA-3379/CP/A/INGO/4826,12/11/2017 1:28:05 PM,Host Communities,6457,6203,0,0,12660,7065,6789,0,0,13854
53,Ethiopia,2017,ETH-17/DDA-3379/CP/A/INGO/4826,12/11/2017 1:28:05 PM,Overall,6457,6203,0,0,12660,7065,6789,0,0,13854
53,Ethiopia,2017,ETH-17/DDA-3379/CP/A/INGO/4834,6/14/2019 6:56:44 AM,Host Communities,7425,7425,14850,14850,44550,7425,7425,14850,14850,44550
53,Ethiopia,2017,ETH-17/DDA-3379/CP/A/INGO/4834,6/14/2019 6:56:44 AM,Overall,7425,7425,14850,14850,44550,7425,7425,14850,14850,44550
53,Ethiopia,2017,ETH-17/DDA-3379/CP/A/INGO/5414,6/2/2018 12:21:43 PM,Overall,32460,19476,6492,6492,64920,44370,22086,5760,3967,76183
53,Ethiopia,2017,ETH-17/DDA-3379/CP/A/INGO/5421,3/7/2018 6:13:35 AM,Host Communities,3192,2408,0,0,5600,3010,4270,2195,1725,11200
53,Ethiopia,2017,ETH-17/DDA-3379/CP/A/INGO/5421,3/7/2018 6:13:35 AM,Overall,3192,2408,0,0,5600,3010,4270,2195,1725,11200
53,Ethiopia,2017,ETH-17/DDA-3379/CP/A/INGO/5455,12/18/2017 11:42:46 AM,Overall,1114,1098,1605,1583,5400,1114,1098,1605,1583,5400
53,Ethiopia,2017,ETH-17/DDA-3379/CP/A/INGO/5457,3/16/2018 10:32:41 AM,Host Communities,2601,2499,0,0,5100,3160,3240,0,0,6400
53,Ethiopia,2017,ETH-17/DDA-3379/CP/A/INGO/5457,3/16/2018 10:32:41 AM,Overall,2601,2499,0,0,5100,3160,3240,0,0,6400
53,Ethiopia,2017,ETH-17/DDA-3379/CP/A/INGO/5459,2/8/2018 7:28:07 AM,Overall,604,906,3020,4530,9060,546,964,2730,4820,9060
53,Ethiopia,2017,ETH-17/DDA-3379/CP/A/INGO/5465,1/2/2018 8:53:00 AM,Host Communities,1250,1250,2700,1675,6875,1250,1250,2700,1675,6875
53,Ethiopia,2017,ETH-17/DDA-3379/CP/A/INGO/5465,1/2/2018 8:53:00 AM,Overall,1250,1250,2700,1675,6875,1250,1250,2700,1675,6875
53,Ethiopia,2017,ETH-17/DDA-3379/CP/A/NGO/4508,11/1/2017 1:49:54 PM,Host Communities,4040,2649,16160,8260,31109,4216,2134,15912,7225,29487
53,Ethiopia,2017,ETH-17/DDA-3379/CP/A/NGO/4508,11/1/2017 1:49:54 PM,Overall,4040,2649,16160,8260,31109,4216,2134,15912,7225,29487
53,Ethiopia,2017,ETH-17/DDA-3379/CP/A/NGO/5337,1/9/2018 1:17:36 PM,Overall,9288,2310,0,0,11598,9288,2310,0,0,11598
53,Ethiopia,2017,ETH-17/DDA-3379/CP/A/UN/4452,12/28/2017 11:48:12 AM,Host Communities,52500,52500,0,0,105000,26836,31315,72700,72697,203548
53,Ethiopia,2017,ETH-17/DDA-3379/CP/A/UN/4452,12/28/2017 11:48:12 AM,Overall,52500,52500,0,0,105000,26836,31315,72700,72697,203548
53,Ethiopia,2017,ETH-17/DDA-3379/CP/A-H-WASH/INGO/4485,8/2/2018 12:38:55 PM,Host Communities,0,0,0,0,0,11998,13640,2567,2980,31185
53,Ethiopia,2017,ETH-17/DDA-3379/CP/A-H-WASH/INGO/4485,8/2/2018 12:38:55 PM,Overall,13697,13157,0,0,26854,11998,13640,2567,2980,31185
53,Ethiopia,2017,ETH-17/DDA-3379/CP/CSS/UN/7329,2/5/2020 4:21:00 AM,Host Communities,80,30,0,0,110,120,40,0,0,160
53,Ethiopia,2017,ETH-17/DDA-3379/CP/CSS/UN/7329,2/5/2020 4:21:00 AM,Internally Displaced People,40,10,0,0,50,0,0,0,0,0
53,Ethiopia,2017,ETH-17/DDA-3379/CP/CSS/UN/7329,2/5/2020 4:21:00 AM,Overall,120,40,0,0,160,120,40,0,0,160
53,Ethiopia,2017,ETH-17/DDA-3379/CP/H/INGO/4512,11/29/2017 9:04:13 AM,Host Communities,9756,14634,0,0,24390,9756,14634,0,0,24390
53,Ethiopia,2017,ETH-17/DDA-3379/CP/H/INGO/4512,11/29/2017 9:04:13 AM,Overall,9756,14634,0,0,24390,9756,14634,0,0,24390
53,Ethiopia,2017,ETH-17/DDA-3379/CP/H/INGO/5312,6/5/2018 8:16:08 AM,Host Communities,7350,7650,0,0,15000,0,0,0,0,0
53,Ethiopia,2017,ETH-17/DDA-3379/CP/H/INGO/5312,6/5/2018 8:16:08 AM,Overall,9246,9624,0,0,18870,0,0,0,0,0
53,Ethiopia,2017,ETH-17/DDA-3379/CP/H/INGO/5344,1/25/2018 1:32:33 PM,Overall,22944,25056,0,0,48000,19503,22551,3441,2505,48000
53,Ethiopia,2017,ETH-17/DDA-3379/CP/H/UN/4448,11/14/2018 11:18:08 AM,Overall,38000,41000,42000,44000,165000,35485,38287,39220,41088,154080
53,Ethiopia,2017,ETH-17/DDA-3379/CP/H/UN/4511,10/31/2017 6:40:07 AM,Host Communities,55328,57586,44027,44027,200968,57971,60501,46166,46167,210805
53,Ethiopia,2017,ETH-17/DDA-3379/CP/H/UN/4511,10/31/2017 6:40:07 AM,Overall,55328,57586,44027,44027,200968,57971,60501,46166,46167,210805
53,Ethiopia,2017,ETH-17/DDA-3379/CP/H/UN/5784,12/6/2017 7:51:03 AM,Overall,1271678,1125079,1925914,1426326,5748997,1271678,1125079,1925914,1426326,5748997
53,Ethiopia,2017,ETH-17/DDA-3379/CP/H/UN/7608,2/4/2019 6:22:48 AM,Internally Displaced People,238996,179249,89624,89624,597493,167301,125477,62734,62734,418246
53,Ethiopia,2017,ETH-17/DDA-3379/CP/H/UN/7608,2/4/2019 6:22:48 AM,Other,0,0,0,0,0,71700,53779,26884,26884,179247
53,Ethiopia,2017,ETH-17/DDA-3379/CP/H/UN/7608,2/4/2019 6:22:48 AM,Overall,238996,179249,89624,89624,597493,238996,179249,89624,89624,597493
53,Ethiopia,2017,ETH-17/DDA-3379/CP/H-N/UN/7607,12/28/2018 8:42:50 AM,Host Communities,10955,11187,12255,12023,46420,23535,24033,26327,25828,99723
53,Ethiopia,2017,ETH-17/DDA-3379/CP/H-N/UN/7607,12/28/2018 8:42:50 AM,Internally Displaced People,12580,12846,14072,13805,53303,5289,5049,5550,5481,21369
53,Ethiopia,2017,ETH-17/DDA-3379/CP/H-N/UN/7607,12/28/2018 8:42:50 AM,Overall,23535,24033,26327,25828,99723,47070,48066,52654,51656,199446
53,Ethiopia,2017,ETH-17/DDA-3379/CP/N/INGO/4515,12/26/2017 1:17:31 PM,Host Communities,0,1867,3627,3049,8543,0,4981,2382,2732,10095
53,Ethiopia,2017,ETH-17/DDA-3379/CP/N/INGO/4515,12/26/2017 1:17:31 PM,Overall,0,1867,3627,3049,8543,0,4981,2382,2732,10095
53,Ethiopia,2017,ETH-17/DDA-3379/CP/N/INGO/4516,2/16/2018 9:48:23 AM,Overall,0,13686,5431,5884,25001,0,6622,2180,2361,11163
53,Ethiopia,2017,ETH-17/DDA-3379/CP/N/INGO/4778,3/30/2018 7:25:02 AM,Host Communities,27132,32203,7537,7241,74113,17604,61740,20562,21303,121209
53,Ethiopia,2017,ETH-17/DDA-3379/CP/N/INGO/4778,3/30/2018 7:25:02 AM,Overall,27132,32203,7537,7241,74113,17604,61740,20562,21303,121209
53,Ethiopia,2017,ETH-17/DDA-3379/CP/N/INGO/4787,3/15/2018 9:08:09 AM,Overall,0,936,5296,4840,11072,109,12457,5791,6507,24864
53,Ethiopia,2017,ETH-17/DDA-3379/CP/N/INGO/4791,2/22/2018 2:33:17 PM,Host Communities,0,3419,2195,2108,7722,0,6158,1845,1794,9797
53,Ethiopia,2017,ETH-17/DDA-3379/CP/N/INGO/4791,2/22/2018 2:33:17 PM,Overall,0,3419,2195,2108,7722,0,6158,1845,1794,9797
53,Ethiopia,2017,ETH-17/DDA-3379/CP/N/INGO/4896,3/12/2018 10:54:31 AM,Host Communities,205,1704,2377,2377,6663,16541,33532,0,0,50073
53,Ethiopia,2017,ETH-17/DDA-3379/CP/N/INGO/4896,3/12/2018 10:54:31 AM,Overall,205,1704,2377,2377,6663,382,4381,2987,3058,10808
53,Ethiopia,2017,ETH-17/DDA-3379/CP/N/INGO/4948,8/31/2018 9:17:16 AM,Host Communities,0,0,0,0,0,0,26141,46706,48810,121657
53,Ethiopia,2017,ETH-17/DDA-3379/CP/N/INGO/4948,8/31/2018 9:17:16 AM,Overall,0,21905,43315,42117,107337,0,26141,46706,48810,121657
53,Ethiopia,2017,ETH-17/DDA-3379/CP/N/INGO/5307,3/29/2018 8:00:18 AM,Host Communities,0,1754,3952,3106,8812,0,3879,5480,4395,13754
53,Ethiopia,2017,ETH-17/DDA-3379/CP/N/INGO/5307,3/29/2018 8:00:18 AM,Overall,0,1754,3952,3106,8812,0,3879,5480,4395,13754
53,Ethiopia,2017,ETH-17/DDA-3379/CP/N/INGO/5310,3/7/2018 12:12:28 PM,Host Communities,335,6803,1155,1202,9495,0,1890,971,1185,4046
53,Ethiopia,2017,ETH-17/DDA-3379/CP/N/INGO/5310,3/7/2018 12:12:28 PM,Overall,335,6803,1155,1202,9495,0,1890,971,1185,4046
53,Ethiopia,2017,ETH-17/DDA-3379/CP/N/INGO/5326,2/8/2018 11:44:39 AM,Host Communities,0,6044,4844,4892,15780,0,3576,2653,2772,9001
53,Ethiopia,2017,ETH-17/DDA-3379/CP/N/INGO/5326,2/8/2018 11:44:39 AM,Overall,0,6044,4844,4892,15780,0,3576,2653,2772,9001
53,Ethiopia,2017,ETH-17/DDA-3379/CP/N/INGO/5386,6/2/2018 12:52:06 PM,Host Communities,0,4273,3513,3774,11560,0,15137,10633,10936,36706
53,Ethiopia,2017,ETH-17/DDA-3379/CP/N/INGO/5386,6/2/2018 12:52:06 PM,Overall,0,4273,3513,3774,11560,0,15137,10633,10936,36706
53,Ethiopia,2017,ETH-17/DDA-3379/CP/N/INGO/5392,4/11/2018 8:45:52 AM,Overall,169,1556,1473,1415,4613,23,7640,3777,3931,15371
53,Ethiopia,2017,ETH-17/DDA-3379/CP/N/INGO/5451,3/8/2018 12:50:48 PM,Host Communities,0,2494,2443,2542,7479,0,3618,1636,2010,7264
53,Ethiopia,2017,ETH-17/DDA-3379/CP/N/INGO/5451,3/8/2018 12:50:48 PM,Overall,0,2494,2443,2542,7479,0,3618,1636,2010,7264
53,Ethiopia,2017,ETH-17/DDA-3379/CP/N/INGO/5460,6/8/2018 8:40:25 AM,Other,0,1580,894,932,3406,0,1742,977,1016,3735
53,Ethiopia,2017,ETH-17/DDA-3379/CP/N/INGO/5460,6/8/2018 8:40:25 AM,Overall,0,1580,894,932,3406,0,1742,977,1016,3735
53,Ethiopia,2017,ETH-17/DDA-3379/CP/N/INGO/5480,5/29/2018 9:53:53 AM,Host Communities,0,9527,17862,17862,45251,0,16380,17662,17798,51840
53,Ethiopia,2017,ETH-17/DDA-3379/CP/N/INGO/5480,5/29/2018 9:53:53 AM,Overall,0,9527,17862,17862,45251,0,16388,17662,17808,51858
53,Ethiopia,2017,ETH-17/DDA-3379/CP/N/INGO/7328,11/19/2018 7:41:39 AM,Host Communities,246,2322,3382,3382,9332,301,10616,8756,9610,29283
53,Ethiopia,2017,ETH-17/DDA-3379/CP/N/INGO/7328,11/19/2018 7:41:39 AM,Overall,246,2322,3382,3382,9332,301,10616,8756,9610,29283
53,Ethiopia,2017,ETH-17/DDA-3379/CP/N/INGO/7612,11/15/2018 12:43:11 PM,Host Communities,0,0,0,0,0,1179,5584,1873,2221,10857
53,Ethiopia,2017,ETH-17/DDA-3379/CP/N/INGO/7612,11/15/2018 12:43:11 PM,Internally Displaced People,0,0,58,68,126,0,0,0,0,0
53,Ethiopia,2017,ETH-17/DDA-3379/CP/N/INGO/7612,11/15/2018 12:43:11 PM,Overall,0,0,1442,1696,3138,1179,5584,1873,2221,10857
53,Ethiopia,2017,ETH-17/DDA-3379/CP/N/INGO/7628,12/28/2018 9:21:54 AM,Host Communities,0,6953,5516,5741,18210,0,11127,5299,5644,22070
53,Ethiopia,2017,ETH-17/DDA-3379/CP/N/INGO/7628,12/28/2018 9:21:54 AM,Overall,0,6953,5516,5741,18210,0,11127,5299,5644,22070
53,Ethiopia,2017,ETH-17/DDA-3379/CP/N/INGO/7637,9/4/2019 8:09:46 AM,Host Communities,0,22215,28608,27486,78309,4360,30233,31240,32540,98373
53,Ethiopia,2017,ETH-17/DDA-3379/CP/N/INGO/7637,9/4/2019 8:09:46 AM,Overall,0,22215,28608,27486,78309,4360,30233,31240,32540,98373
53,Ethiopia,2017,ETH-17/DDA-3379/CP/N/NGO/7632,11/19/2018 6:44:34 AM,Overall,0,2017,5944,6185,14146,0,5091,6760,7058,18909
53,Ethiopia,2017,ETH-17/DDA-3379/CP/N/UN/5306,3/7/2021 11:06:25 AM,Host Communities,0,0,6650,6650,13300,0,0,7270,7271,14541
53,Ethiopia,2017,ETH-17/DDA-3379/CP/N/UN/5306,3/7/2021 11:06:25 AM,Overall,0,0,6650,6650,13300,0,0,7270,7271,14541
53,Ethiopia,2017,ETH-17/DDA-3379/CP/N/UN/5790,8/7/2018 11:36:57 AM,Overall,26500,26500,26500,26500,106000,8828,34488,43658,43659,130633
53,Ethiopia,2017,ETH-17/DDA-3379/CP/N/UN/7664,11/15/2018 1:26:19 PM,Internally Displaced People,0,3500,8000,8000,19500,0,3500,7865,7866,19231
53,Ethiopia,2017,ETH-17/DDA-3379/CP/N/UN/7664,11/15/2018 1:26:19 PM,Overall,0,3500,8000,8000,19500,0,3500,7865,7866,19231
53,Ethiopia,2017,ETH-17/DDA-3379/CP/NFI/ES/INGO/5348,3/15/2018 12:45:25 PM,Internally Displaced People,7023,6703,9896,8300,31922,7223,6894,10178,8536,32831
53,Ethiopia,2017,ETH-17/DDA-3379/CP/NFI/ES/INGO/5348,3/15/2018 12:45:25 PM,Overall,7023,6703,9896,8300,31922,0,0,0,0,0
53,Ethiopia,2017,ETH-17/DDA-3379/CP/NFI/ES/UN/5479,12/13/2017 2:14:16 PM,Overall,154000,147000,217000,182000,700000,655260,674437,413527,414954,2158178
53,Ethiopia,2017,ETH-17/DDA-3379/CP/NFI/ES/UN/5481,9/3/2018 1:31:39 PM,Internally Displaced People,6325,6038,8913,7476,28752,6516,6220,9181,7700,29617
53,Ethiopia,2017,ETH-17/DDA-3379/CP/NFI/ES/UN/5481,9/3/2018 1:31:39 PM,Overall,6325,6038,8913,7476,28752,6515,6220,9181,7701,29617
53,Ethiopia,2017,ETH-17/DDA-3379/CP/NFI/ES/UN/7661,12/28/2018 9:03:11 AM,Internally Displaced People,12083,12871,23595,22951,71500,15015,17160,15730,23595,71500
53,Ethiopia,2017,ETH-17/DDA-3379/CP/NFI/ES/UN/7661,12/28/2018 9:03:11 AM,Overall,12083,12871,23595,22951,71500,15015,17160,15730,23595,71500
53,Ethiopia,2017,ETH-17/DDA-3379/CP/P/INGO/4476,11/10/2017 6:56:19 AM,Overall,2500,2500,1000,4000,10000,7600,3210,2120,4538,17468
53,Ethiopia,2017,ETH-17/DDA-3379/CP/P/INGO/4476,11/10/2017 6:56:19 AM,Refugees,2500,2500,1000,4000,10000,7600,3210,2120,4538,17468
53,Ethiopia,2017,ETH-17/DDA-3379/CP/P/INGO/5068,10/26/2018 8:57:25 AM,Overall,3578,5058,3660,2525,14821,477,503,371,283,1634
53,Ethiopia,2017,ETH-17/DDA-3379/CP/P/INGO/5334,4/10/2019 1:58:53 PM,Overall,3000,6500,6969,6969,23438,8626,7324,6076,6490,28516
53,Ethiopia,2017,ETH-17/DDA-3379/CP/P/INGO/5336,7/31/2018 9:24:39 AM,Internally Displaced People,9630,9683,22093,21627,63033,12100,15770,21792,28792,78454
53,Ethiopia,2017,ETH-17/DDA-3379/CP/P/INGO/5336,7/31/2018 9:24:39 AM,Other,40,40,0,0,80,0,0,0,0,0
53,Ethiopia,2017,ETH-17/DDA-3379/CP/P/INGO/5336,7/31/2018 9:24:39 AM,Overall,9695,9748,22093,21627,63163,14440,18028,18970,16941,68379
53,Ethiopia,2017,ETH-17/DDA-3379/CP/P/INGO/5358,6/2/2018 12:10:47 PM,Overall,7520,7923,5684,5134,26261,1481,8735,1109,1339,12664
53,Ethiopia,2017,ETH-17/DDA-3379/CP/WASH/INGO/4504,11/6/2017 7:28:32 AM,Host Communities,3140,3097,1750,1890,9877,3140,3100,1750,2000,9990
53,Ethiopia,2017,ETH-17/DDA-3379/CP/WASH/INGO/4504,11/6/2017 7:28:32 AM,Overall,8466,18637,27345,25714,80162,9981,19487,27320,25868,82656
53,Ethiopia,2017,ETH-17/DDA-3379/CP/WASH/INGO/4505,12/29/2017 10:13:36 AM,Host Communities,3615,3583,3076,2892,13166,3615,3583,3076,2892,13166
53,Ethiopia,2017,ETH-17/DDA-3379/CP/WASH/INGO/4505,12/29/2017 10:13:36 AM,Overall,6948,6215,10939,9308,33410,8183,7091,12335,10474,38083
53,Ethiopia,2017,ETH-17/DDA-3379/CP/WASH/INGO/4507,7/27/2017 9:08:20 AM,Host Communities,76228,114340,0,0,190568,76874,115312,0,0,192186
53,Ethiopia,2017,ETH-17/DDA-3379/CP/WASH/INGO/4507,7/27/2017 9:08:20 AM,Overall,76228,114340,0,0,190568,76874,115312,0,0,192186
53,Ethiopia,2017,ETH-17/DDA-3379/CP/WASH/INGO/4514,6/8/2018 8:00:17 AM,Overall,24168,25274,4265,4460,58167,21368,22471,3480,3488,50807
53,Ethiopia,2017,ETH-17/DDA-3379/CP/WASH/INGO/5303,3/8/2018 9:00:10 AM,Host Communities,10050,16081,11557,12563,50251,9838,15740,11313,12297,49188
53,Ethiopia,2017,ETH-17/DDA-3379/CP/WASH/INGO/5303,3/8/2018 9:00:10 AM,Internally Displaced People,10050,16080,11558,12563,50251,9838,15740,11313,12297,49188
53,Ethiopia,2017,ETH-17/DDA-3379/CP/WASH/INGO/5303,3/8/2018 9:00:10 AM,Overall,20100,32161,23115,25126,100502,19675,32200,22627,24593,99095
53,Ethiopia,2017,ETH-17/DDA-3379/CP/WASH/INGO/5380,8/2/2018 2:07:11 PM,Other,20452,26100,31210,33362,111124,21573,24509,32008,34219,112309
53,Ethiopia,2017,ETH-17/DDA-3379/CP/WASH/INGO/5380,8/2/2018 2:07:11 PM,Overall,20452,26100,31210,33362,111124,21643,24775,31846,34045,112309
53,Ethiopia,2017,ETH-17/DDA-3379/CP/WASH/INGO/5814,4/11/2018 9:05:34 AM,Host Communities,36510,38467,28627,23896,127500,19000,25894,4898,7608,57400
53,Ethiopia,2017,ETH-17/DDA-3379/CP/WASH/INGO/5814,4/11/2018 9:05:34 AM,Internally Displaced People,4009,4224,2000,3767,14000,21291,45461,13578,20649,100979
53,Ethiopia,2017,ETH-17/DDA-3379/CP/WASH/INGO/5814,4/11/2018 9:05:34 AM,Overall,40519,42691,30627,27663,141500,40291,71355,18476,28257,158379
53,Ethiopia,2017,ETH-17/DDA-3379/CP/WASH/UN/4451,8/14/2017 9:27:01 AM,Overall,215103,223887,216396,237340,892726,225769,234988,227126,249108,936991
53,Ethiopia,2017,ETH-17/DDA-3379/CP/WASH/UN/5442,1/30/2019 7:53:34 AM,Overall,61466,63974,64000,66560,256000,103300,107515,107559,111861,430235
53,Ethiopia,2017,ETH-17/DDA-3379/CP/WASH/UN/7680,1/30/2019 8:13:16 AM,Internally Displaced People,49731,49335,39052,38031,176149,62418,63141,58402,59107,243068
53,Ethiopia,2017,ETH-17/DDA-3379/CP/WASH/UN/7680,1/30/2019 8:13:16 AM,Overall,49731,49335,39052,38031,176149,62418,63141,58402,59107,243068
53,Ethiopia,2017,ETH-17/DDA-3379/CP/WASH-H/INGO/6033,3/8/2018 1:04:29 PM,Host Communities,4360,4190,5330,5120,19000,3155,5682,5411,4892,19140
53,Ethiopia,2017,ETH-17/DDA-3379/CP/WASH-H/INGO/6033,3/8/2018 1:04:29 PM,Overall,4360,4190,5330,5120,19000,4155,4682,5411,4892,19140
53,Ethiopia,2017,ETH-17/DDA-3379/CP/WASH-NFI/ES/INGO/7660,1/18/2019 8:48:13 AM,Internally Displaced People,29022,43408,7254,10852,90536,51667,31212,13393,8279,104551
53,Ethiopia,2017,ETH-17/DDA-3379/CP/WASH-NFI/ES/INGO/7660,1/18/2019 8:48:13 AM,Overall,29022,43408,7254,10852,90536,51667,31212,13392,8278,104549
53,Ethiopia,2017,ETH-17/DDA-3379/CP/WASH-NFI/ES/INGO/7663,1/30/2019 12:46:47 PM,Internally Displaced People,12523,13328,15538,13086,54475,14865,13359,16097,15538,59859
53,Ethiopia,2017,ETH-17/DDA-3379/CP/WASH-NFI/ES/INGO/7663,1/30/2019 12:46:47 PM,Overall,12523,13328,15538,13086,54475,14865,13359,16097,15538,59859
53,Ethiopia,2017,ETH-17/DDA-3379/CP/WASH-NFI/ES/INGO/7679,2/27/2019 7:52:03 AM,Internally Displaced People,12666,11693,4222,3897,32478,11154,13775,3550,4569,33048
53,Ethiopia,2017,ETH-17/DDA-3379/CP/WASH-NFI/ES/INGO/7679,2/27/2019 7:52:03 AM,Overall,12666,11693,4222,3897,32478,0,0,0,0,0
53,Ethiopia,2017,ETH-17/DDA-3379/ETH-17/DDA-3379/A/INGO/6625,12/28/2018 4:53:42 AM,Overall,17787,7623,0,0,25410,12127,12623,0,0,24750
53,Ethiopia,2017,ETH-17/DDA-3379/ETH-17/DDA-3379/A/INGO/6722,11/15/2018 12:50:57 PM,Host Communities,5496,5720,2959,3080,17255,8899,9277,4779,5060,28015
53,Ethiopia,2017,ETH-17/DDA-3379/ETH-17/DDA-3379/A/INGO/6722,11/15/2018 12:50:57 PM,Overall,5496,5720,2959,3080,17255,8899,9277,4779,5060,28015
53,Ethiopia,2017,ETH-17/DDA-3379/ETH-17/DDA-3379/A/INGO/6723,9/3/2018 1:03:33 PM,Overall,38367,16443,16443,7047,78300,71034,22626,6501,363,100524
53,Ethiopia,2017,ETH-17/DDA-3379/ETH-17/DDA-3379/A/INGO/6741,8/3/2018 7:28:19 AM,Host Communities,3556,3416,0,0,6972,4766,4373,0,0,9139
53,Ethiopia,2017,ETH-17/DDA-3379/ETH-17/DDA-3379/A/INGO/6741,8/3/2018 7:28:19 AM,Overall,3556,3416,0,0,6972,4766,4373,0,0,9139
53,Ethiopia,2017,ETH-17/DDA-3379/ETH-17/DDA-3379/A/INGO/6743,11/19/2018 11:03:49 AM,Host Communities,2376,2376,5148,3300,13200,0,0,0,0,0
53,Ethiopia,2017,ETH-17/DDA-3379/ETH-17/DDA-3379/A/INGO/6743,11/19/2018 11:03:49 AM,Overall,2376,2376,5148,3300,13200,2376,2376,5148,3300,13200
53,Ethiopia,2017,ETH-17/DDA-3379/ETH-17/DDA-3379/A/INGO/6754,5/10/2018 11:59:58 AM,Host Communities,1053,1037,1516,1494,5100,1102,1086,1588,1564,5340
53,Ethiopia,2017,ETH-17/DDA-3379/ETH-17/DDA-3379/A/INGO/6754,5/10/2018 11:59:58 AM,Overall,1053,1037,1516,1494,5100,1102,1086,1588,1564,5340
53,Ethiopia,2017,ETH-17/DDA-3379/ETH-17/DDA-3379/A/INGO/6770,8/30/2018 8:36:29 AM,Host Communities,900,900,1800,1800,5400,700,1100,2200,1400,5400
53,Ethiopia,2017,ETH-17/DDA-3379/ETH-17/DDA-3379/A/INGO/6770,8/30/2018 8:36:29 AM,Overall,900,900,1800,1800,5400,700,1100,2200,1400,5400
53,Ethiopia,2017,ETH-17/DDA-3379/ETH-17/DDA-3379/A/INGO/6799,8/7/2018 7:20:25 AM,Host Communities,2964,2964,0,0,5928,0,0,0,0,0
53,Ethiopia,2017,ETH-17/DDA-3379/ETH-17/DDA-3379/A/INGO/6799,8/7/2018 7:20:25 AM,Overall,2964,2964,0,0,5928,3432,2722,0,0,6154
53,Ethiopia,2017,ETH-17/DDA-3379/ETH-17/DDA-3379/CSS/UN/6822,6/21/2019 10:13:13 AM,Overall,600,400,0,0,1000,600,400,0,0,1000
53,Ethiopia,2017,ETH-17/DDA-3379/ETH-17/DDA-3379/E/INGO/6726,4/10/2019 2:11:52 PM,Internally Displaced People,180,76,4074,3333,7663,304,415,4364,3871,8954
53,Ethiopia,2017,ETH-17/DDA-3379/ETH-17/DDA-3379/E/INGO/6726,4/10/2019 2:11:52 PM,Overall,180,76,4074,3333,7663,304,415,4364,3871,8954
53,Ethiopia,2017,ETH-17/DDA-3379/ETH-17/DDA-3379/H/INGO/6724,2/27/2019 7:34:21 AM,Overall,2366,45204,17745,18469,83784,4938,56319,56818,60728,178803
53,Ethiopia,2017,ETH-17/DDA-3379/ETH-17/DDA-3379/H/INGO/6775,1/16/2019 1:52:11 PM,Host Communities,28387,27273,23224,22314,101198,28387,27273,23224,22314,101198
53,Ethiopia,2017,ETH-17/DDA-3379/ETH-17/DDA-3379/H/INGO/6775,1/16/2019 1:52:11 PM,Overall,28387,27273,23224,22314,101198,11954,29667,29185,32180,102986
53,Ethiopia,2017,ETH-17/DDA-3379/ETH-17/DDA-3379/H/INGO/6869,9/5/2019 9:13:44 AM,Overall,3815,3665,2999,3121,13600,37290,36723,9761,12085,95859
53,Ethiopia,2017,ETH-17/DDA-3379/ETH-17/DDA-3379/H/NGO/6793,11/21/2018 2:14:28 PM,Overall,63485,66075,13936,14504,158000,17660,18613,16741,30667,83681
53,Ethiopia,2017,ETH-17/DDA-3379/ETH-17/DDA-3379/H/UN/6712,12/28/2018 8:13:48 AM,Overall,42336,44064,45864,47736,180000,43367,45076,44784,47897,181124
53,Ethiopia,2017,ETH-17/DDA-3379/ETH-17/DDA-3379/H/UN/6738,12/4/2018 12:29:42 PM,Overall,42336,44064,45864,47736,180000,42323,44057,45987,47098,179465
53,Ethiopia,2017,ETH-17/DDA-3379/ETH-17/DDA-3379/H/UN/6745,1/30/2019 8:27:08 AM,Other,488,415,0,0,903,488164,501987,674078,639061,2303290
53,Ethiopia,2017,ETH-17/DDA-3379/ETH-17/DDA-3379/H/UN/6745,1/30/2019 8:27:08 AM,Overall,1203062,1047265,967354,782319,4000000,366124,376490,505558,479295,1727467
53,Ethiopia,2017,ETH-17/DDA-3379/ETH-17/DDA-3379/N/INGO/6685,5/11/2018 6:47:34 AM,Host Communities,0,0,0,0,0,431,684,615,1013,2743
53,Ethiopia,2017,ETH-17/DDA-3379/ETH-17/DDA-3379/N/INGO/6685,5/11/2018 6:47:34 AM,Overall,222,714,649,675,2260,431,684,615,673,2403
53,Ethiopia,2017,ETH-17/DDA-3379/ETH-17/DDA-3379/N/INGO/6730,11/19/2018 5:11:37 AM,Host Communities,9580,11502,2047,2928,26057,0,0,0,0,0
53,Ethiopia,2017,ETH-17/DDA-3379/ETH-17/DDA-3379/N/INGO/6730,11/19/2018 5:11:37 AM,Overall,9580,11502,3047,2928,27057,6530,12992,880,902,21304
53,Ethiopia,2017,ETH-17/DDA-3379/ETH-17/DDA-3379/N/INGO/6737,8/2/2018 11:56:33 AM,Overall,100,3789,1304,1360,6553,85,4881,1317,1546,7829
53,Ethiopia,2017,ETH-17/DDA-3379/ETH-17/DDA-3379/N/INGO/6768,8/2/2018 1:14:44 PM,Host Communities,0,3204,2309,2214,7727,0,5638,2711,3211,11560
53,Ethiopia,2017,ETH-17/DDA-3379/ETH-17/DDA-3379/N/INGO/6768,8/2/2018 1:14:44 PM,Overall,0,3204,2309,2214,7727,0,5638,2711,3211,11560
53,Ethiopia,2017,ETH-17/DDA-3379/ETH-17/DDA-3379/N/INGO/6781,8/7/2018 11:46:01 AM,Overall,0,4551,3583,3728,11862,1046,3538,3108,3156,10848
53,Ethiopia,2017,ETH-17/DDA-3379/ETH-17/DDA-3379/N/INGO/6798,8/31/2018 8:49:08 AM,Overall,0,14431,27747,28534,70712,0,14614,32598,33928,81140
53,Ethiopia,2017,ETH-17/DDA-3379/ETH-17/DDA-3379/N/INGO/6800,8/10/2018 10:31:39 AM,Host Communities,0,1024,1991,2112,5127,0,9609,5590,6059,21258
53,Ethiopia,2017,ETH-17/DDA-3379/ETH-17/DDA-3379/N/INGO/6800,8/10/2018 10:31:39 AM,Overall,0,1024,1991,2112,5127,0,9609,5663,5976,21248
53,Ethiopia,2017,ETH-17/DDA-3379/ETH-17/DDA-3379/N/INGO/6803,7/30/2018 1:10:30 PM,Host Communities,0,0,0,0,0,4983,5337,7475,7780,25575
53,Ethiopia,2017,ETH-17/DDA-3379/ETH-17/DDA-3379/N/INGO/6803,7/30/2018 1:10:30 PM,Overall,0,1426,1153,1200,3779,0,2638,1529,1445,5612
53,Ethiopia,2017,ETH-17/DDA-3379/ETH-17/DDA-3379/N/INGO/6873,1/24/2019 1:17:16 PM,Overall,60,2256,7324,7225,16865,242,10210,11652,12535,34639
53,Ethiopia,2017,ETH-17/DDA-3379/ETH-17/DDA-3379/N/NGO/6791,8/2/2018 12:54:51 PM,Host Communities,0,0,0,0,0,0,2635,6706,6751,16092
53,Ethiopia,2017,ETH-17/DDA-3379/ETH-17/DDA-3379/N/NGO/6791,8/2/2018 12:54:51 PM,Overall,0,1832,8718,9074,19624,0,2635,6615,6842,16092
53,Ethiopia,2017,ETH-17/DDA-3379/ETH-17/DDA-3379/N/NGO/6838,6/2/2018 1:02:20 PM,Host Communities,0,9694,2097,2113,13904,0,13780,4302,4482,22564
53,Ethiopia,2017,ETH-17/DDA-3379/ETH-17/DDA-3379/N/NGO/6838,6/2/2018 1:02:20 PM,Overall,0,14767,4671,4725,24163,0,13780,4302,4482,22564
53,Ethiopia,2017,ETH-17/DDA-3379/ETH-17/DDA-3379/N/UN/6588,9/5/2019 8:10:35 AM,Host Communities,0,112560,87703,84264,284527,0,103945,80990,77814,262749
53,Ethiopia,2017,ETH-17/DDA-3379/ETH-17/DDA-3379/N/UN/6588,9/5/2019 8:10:35 AM,Overall,0,112560,87703,84264,284527,0,103945,80990,77814,262749
53,Ethiopia,2017,ETH-17/DDA-3379/ETH-17/DDA-3379/N/UN/6779,10/18/2022 1:47:41 PM,Host Communities,0,0,93250,93250,186500,0,0,120280,120281,240561
53,Ethiopia,2017,ETH-17/DDA-3379/ETH-17/DDA-3379/N/UN/6779,10/18/2022 1:47:41 PM,Overall,0,0,93250,93250,186500,0,0,120280,120281,240561
53,Ethiopia,2017,ETH-17/DDA-3379/ETH-17/DDA-3379/NFI/ES/INGO/6725,11/19/2018 8:11:54 AM,Internally Displaced People,4754,5169,7260,7040,24223,14245,13076,1903,1756,30980
53,Ethiopia,2017,ETH-17/DDA-3379/ETH-17/DDA-3379/NFI/ES/INGO/6725,11/19/2018 8:11:54 AM,Overall,4754,5169,7260,7040,24223,14245,13077,1903,1755,30980
53,Ethiopia,2017,ETH-17/DDA-3379/ETH-17/DDA-3379/NFI/ES/INGO/6769,11/15/2018 12:48:58 PM,Internally Displaced People,6170,9028,8695,10429,34322,6170,9028,8695,10429,34322
53,Ethiopia,2017,ETH-17/DDA-3379/ETH-17/DDA-3379/NFI/ES/INGO/6769,11/15/2018 12:48:58 PM,Overall,6170,9028,8695,10429,34322,6170,9028,8695,10429,34322
53,Ethiopia,2017,ETH-17/DDA-3379/ETH-17/DDA-3379/NFI/ES/UN/6765,8/13/2018 9:16:34 AM,Internally Displaced People,5060,5358,9823,9525,29766,0,0,0,0,0
53,Ethiopia,2017,ETH-17/DDA-3379/ETH-17/DDA-3379/NFI/ES/UN/6765,8/13/2018 9:16:34 AM,Overall,5060,5358,9823,9525,29766,6205,7300,11680,11314,36499
53,Ethiopia,2017,ETH-17/DDA-3379/ETH-17/DDA-3379/P/INGO/6732,1/30/2019 9:00:55 AM,Internally Displaced People,260,3668,1100,2668,7696,188,5636,1267,2833,9924
53,Ethiopia,2017,ETH-17/DDA-3379/ETH-17/DDA-3379/P/INGO/6732,1/30/2019 9:00:55 AM,Overall,260,3668,1100,2668,7696,188,5636,1267,2833,9924
53,Ethiopia,2017,ETH-17/DDA-3379/ETH-17/DDA-3379/P/INGO/6897,1/16/2019 2:09:00 PM,Internally Displaced People,1425,4365,500,500,6790,2800,8973,1329,1863,14965
53,Ethiopia,2017,ETH-17/DDA-3379/ETH-17/DDA-3379/P/INGO/6897,1/16/2019 2:09:00 PM,Overall,1425,4365,500,500,6790,2800,8973,1329,1863,14965
53,Ethiopia,2017,ETH-17/DDA-3379/ETH-17/DDA-3379/P/INGO/6916,9/5/2018 7:49:12 AM,Internally Displaced People,535,490,0,0,1025,469,850,0,0,1319
53,Ethiopia,2017,ETH-17/DDA-3379/ETH-17/DDA-3379/P/INGO/6916,9/5/2018 7:49:12 AM,Overall,535,490,0,0,1025,469,850,0,0,1319
53,Ethiopia,2017,ETH-17/DDA-3379/ETH-17/DDA-3379/P/INGO/6917,11/19/2018 6:57:37 AM,Host Communities,440,930,520,980,2870,205,179,959,1250,2593
53,Ethiopia,2017,ETH-17/DDA-3379/ETH-17/DDA-3379/P/INGO/6917,11/19/2018 6:57:37 AM,Internally Displaced People,990,2950,1020,2670,7630,934,884,2403,4395,8616
53,Ethiopia,2017,ETH-17/DDA-3379/ETH-17/DDA-3379/P/INGO/6917,11/19/2018 6:57:37 AM,Overall,1430,3880,1540,3650,10500,1139,1063,3362,5645,11209
53,Ethiopia,2017,ETH-17/DDA-3379/ETH-17/DDA-3379/P/UN/6757,9/5/2018 7:52:39 AM,Overall,2189,2519,3245,3047,11000,6891,7924,9992,9647,34454
53,Ethiopia,2017,ETH-17/DDA-3379/ETH-17/DDA-3379/P/UN/6757,9/5/2018 7:52:39 AM,Refugees,2189,2519,3245,3047,11000,0,0,0,0,0
53,Ethiopia,2017,ETH-17/DDA-3379/ETH-17/DDA-3379/WASH/INGO/6684,4/4/2019 7:44:02 AM,Host Communities,0,0,0,0,0,51018,62350,12758,15591,141717
53,Ethiopia,2017,ETH-17/DDA-3379/ETH-17/DDA-3379/WASH/INGO/6684,4/4/2019 7:44:02 AM,Internally Displaced People,33678,38097,8421,9525,89721,0,0,0,0,0
53,Ethiopia,2017,ETH-17/DDA-3379/ETH-17/DDA-3379/WASH/INGO/6684,4/4/2019 7:44:02 AM,Overall,50571,52880,12643,13220,129314,51018,62350,12758,15591,141717
53,Ethiopia,2017,ETH-17/DDA-3379/ETH-17/DDA-3379/WASH/INGO/6686,6/12/2019 12:14:37 PM,Internally Displaced People,73500,76500,0,0,150000,61332,77818,0,0,139150
53,Ethiopia,2017,ETH-17/DDA-3379/ETH-17/DDA-3379/WASH/INGO/6686,6/12/2019 12:14:37 PM,Overall,73500,76500,0,0,150000,61332,77818,0,0,139150
53,Ethiopia,2017,ETH-17/DDA-3379/ETH-17/DDA-3379/WASH/INGO/6716,12/28/2018 6:36:19 AM,Host Communities,7059,7713,4345,4028,23145,7259,8188,3320,3103,21870
53,Ethiopia,2017,ETH-17/DDA-3379/ETH-17/DDA-3379/WASH/INGO/6716,12/28/2018 6:36:19 AM,Internally Displaced People,6916,10823,4165,3940,25844,7278,9728,4383,3982,25371
53,Ethiopia,2017,ETH-17/DDA-3379/ETH-17/DDA-3379/WASH/INGO/6716,12/28/2018 6:36:19 AM,Overall,13975,18536,8510,7968,48989,9530,24590,6614,6507,47241
53,Ethiopia,2017,ETH-17/DDA-3379/ETH-17/DDA-3379/WASH/INGO/6735,5/8/2019 6:51:11 AM,Host Communities,6426,6174,2142,2058,16800,0,0,0,0,0
53,Ethiopia,2017,ETH-17/DDA-3379/ETH-17/DDA-3379/WASH/INGO/6735,5/8/2019 6:51:11 AM,Internally Displaced People,4284,4116,1428,1372,11200,0,0,0,0,0
53,Ethiopia,2017,ETH-17/DDA-3379/ETH-17/DDA-3379/WASH/INGO/6735,5/8/2019 6:51:11 AM,Overall,10710,10290,3570,3430,28000,10710,10290,3570,3430,28000
53,Ethiopia,2017,ETH-17/DDA-3379/ETH-17/DDA-3379/WASH/INGO/6759,11/19/2018 8:17:18 AM,Host Communities,5890,6510,8990,9610,31000,9097,10290,11244,12307,42938
53,Ethiopia,2017,ETH-17/DDA-3379/ETH-17/DDA-3379/WASH/INGO/6759,11/19/2018 8:17:18 AM,Overall,5890,6510,8990,9610,31000,9097,10290,11244,12307,42938
53,Ethiopia,2017,ETH-17/DDA-3379/ETH-17/DDA-3379/WASH/INGO/6760,9/5/2018 7:44:34 AM,Internally Displaced People,0,0,0,0,0,10143,6486,13984,12555,43168
53,Ethiopia,2017,ETH-17/DDA-3379/ETH-17/DDA-3379/WASH/INGO/6760,9/5/2018 7:44:34 AM,Overall,10143,6486,13984,12555,43168,10143,6486,13984,12555,43168
53,Ethiopia,2017,ETH-17/DDA-3379/ETH-17/DDA-3379/WASH/INGO/6761,12/27/2018 9:31:20 AM,Host Communities,7160,11456,8234,8950,35800,9605,15369,11047,12004,48025
53,Ethiopia,2017,ETH-17/DDA-3379/ETH-17/DDA-3379/WASH/INGO/6761,12/27/2018 9:31:20 AM,Internally Displaced People,7160,11456,8234,8950,35800,9605,15369,11047,12004,48025
53,Ethiopia,2017,ETH-17/DDA-3379/ETH-17/DDA-3379/WASH/INGO/6761,12/27/2018 9:31:20 AM,Overall,14320,22912,16468,17900,71600,19210,30735,22091,24014,96050
53,Ethiopia,2017,ETH-17/DDA-3379/ETH-17/DDA-3379/WASH/INGO/6785,9/3/2018 1:22:06 PM,Host Communities,14346,15288,7961,9115,46710,19397,19462,10865,12500,62224
53,Ethiopia,2017,ETH-17/DDA-3379/ETH-17/DDA-3379/WASH/INGO/6785,9/3/2018 1:22:06 PM,Internally Displaced People,6606,9189,4015,5190,25000,6105,6862,3119,3953,20039
53,Ethiopia,2017,ETH-17/DDA-3379/ETH-17/DDA-3379/WASH/INGO/6785,9/3/2018 1:22:06 PM,Overall,20952,24477,11976,14305,71710,25502,26324,13984,16453,82263
53,Ethiopia,2017,ETH-17/DDA-3379/ETH-17/DDA-3379/WASH/INGO/6819,7/5/2018 8:26:15 AM,Overall,744,1506,1938,1812,6000,615,1245,1602,1499,4961
53,Ethiopia,2017,ETH-17/DDA-3379/ETH-17/DDA-3379/WASH/INGO/6820,1/30/2019 6:26:01 AM,Overall,4156,3479,0,0,7635,3308,4478,0,0,7786
53,Ethiopia,2017,ETH-17/DDA-3379/ETH-17/DDA-3379/WASH/INGO/6820,1/30/2019 6:26:01 AM,Refugees,4156,3479,0,0,7635,3308,4478,0,0,7786
53,Ethiopia,2017,ETH-17/DDA-3379/ETH-17/DDA-3379/WASH/UN/6674,1/31/2019 7:11:17 AM,Overall,1071749,1115515,1078191,1182545,4448000,1443883,1461314,1351005,1367314,5623516
53,Ethiopia,2017,ETH-17/DDA-3379/ETH-17/DDA-3379/WASH-H/INGO/6773,1/16/2019 1:21:52 PM,Overall,35233,36672,6218,6471,84594,28369,30142,17387,18474,94372
53,Ethiopia,2018,ETH-18/DDA-3379/RA1/A/INGO/10262,10/18/2019 8:56:00 AM,Overall,13541,13761,12252,12450,52004,61285,63786,126706,131877,383654
53,Ethiopia,2018,ETH-18/DDA-3379/RA1/A/INGO/10270,6/18/2019 8:05:54 AM,Host Communities,10370,9963,0,0,20333,34986,33614,0,0,68600
53,Ethiopia,2018,ETH-18/DDA-3379/RA1/A/INGO/10270,6/18/2019 8:05:54 AM,Overall,10370,9963,0,0,20333,34986,33614,0,0,68600
53,Ethiopia,2018,ETH-18/DDA-3379/RA1/A/INGO/10950,8/16/2019 8:00:20 AM,Overall,3364,3716,5134,5486,17700,2100,2890,5221,5579,15790
53,Ethiopia,2018,ETH-18/DDA-3379/RA1/A/INGO/10952,10/30/2019 4:14:01 AM,Internally Displaced People,14352,14352,0,0,28704,33379,7961,0,0,41340
53,Ethiopia,2018,ETH-18/DDA-3379/RA1/A/INGO/10952,10/30/2019 4:14:01 AM,Overall,14352,14352,0,0,28704,33379,7961,0,0,41340
53,Ethiopia,2018,ETH-18/DDA-3379/RA1/A/NGO/10296,10/18/2019 8:34:48 AM,Overall,9300,6200,0,0,15500,13445,4050,0,0,17495
53,Ethiopia,2018,ETH-18/DDA-3379/RA1/A/UN/10321,9/5/2019 2:31:54 PM,Host Communities,11273,21883,16578,16578,66312,23127,23125,23126,23122,92500
53,Ethiopia,2018,ETH-18/DDA-3379/RA1/A/UN/10321,9/5/2019 2:31:54 PM,Overall,11273,21883,16578,16578,66312,23127,23125,23126,23122,92500
53,Ethiopia,2018,ETH-18/DDA-3379/RA1/E/INGO/10223,1/8/2020 11:56:34 AM,Internally Displaced People,0,0,4080,3920,8000,166,169,1444,1533,3312
53,Ethiopia,2018,ETH-18/DDA-3379/RA1/E/INGO/10223,1/8/2020 11:56:34 AM,Other,166,169,0,0,335,0,0,0,0,0
53,Ethiopia,2018,ETH-18/DDA-3379/RA1/E/INGO/10223,1/8/2020 11:56:34 AM,Overall,166,169,4080,3920,8335,166,169,1444,1533,3312
53,Ethiopia,2018,ETH-18/DDA-3379/RA1/E/INGO/10277,9/5/2019 2:44:24 PM,Host Communities,0,0,2391,1619,4010,0,0,3198,2388,5586
53,Ethiopia,2018,ETH-18/DDA-3379/RA1/E/INGO/10277,9/5/2019 2:44:24 PM,Overall,0,0,2391,1619,4010,0,0,3198,2388,5586
53,Ethiopia,2018,ETH-18/DDA-3379/RA1/E/INGO/10962,2/4/2020 8:37:36 AM,Internally Displaced People,135,147,2040,1960,4282,135,147,1498,1533,3313
53,Ethiopia,2018,ETH-18/DDA-3379/RA1/E/INGO/10962,2/4/2020 8:37:36 AM,Overall,153,147,2040,1960,4300,135,147,1498,1533,3313
53,Ethiopia,2018,ETH-18/DDA-3379/RA1/E/INGO/10966,9/9/2019 8:51:05 AM,Internally Displaced People,0,0,2500,2500,5000,0,0,3057,2438,5495
53,Ethiopia,2018,ETH-18/DDA-3379/RA1/E/INGO/10966,9/9/2019 8:51:05 AM,Overall,0,0,2500,2500,5000,0,0,3057,2438,5495
53,Ethiopia,2018,ETH-18/DDA-3379/RA1/H/INGO/10269,6/6/2019 6:19:10 AM,Overall,1459,3552,15294,17362,37667,2009,4104,14959,15960,37032
53,Ethiopia,2018,ETH-18/DDA-3379/RA1/H/INGO/10326,6/19/2019 4:23:04 AM,Host Communities,2940,3060,0,0,6000,14709,27386,2395,4457,48947
53,Ethiopia,2018,ETH-18/DDA-3379/RA1/H/INGO/10326,6/19/2019 4:23:04 AM,Overall,12521,13032,0,0,25553,9898,10302,0,0,20200
53,Ethiopia,2018,ETH-18/DDA-3379/RA1/H/INGO/10329,8/13/2019 10:37:56 AM,Host Communities,2832,2948,420,437,6637,0,0,0,0,0
53,Ethiopia,2018,ETH-18/DDA-3379/RA1/H/INGO/10329,8/13/2019 10:37:56 AM,Internally Displaced People,915,1270,181,141,2507,3400,4046,2400,3160,13006
53,Ethiopia,2018,ETH-18/DDA-3379/RA1/H/INGO/10329,8/13/2019 10:37:56 AM,Overall,3747,4218,601,578,9144,3400,4046,2400,3160,13006
53,Ethiopia,2018,ETH-18/DDA-3379/RA1/H/NGO/10959,9/5/2019 3:09:20 PM,Overall,25329,25755,4879,4954,60917,11424,23714,12410,11904,59452
53,Ethiopia,2018,ETH-18/DDA-3379/RA1/H/UN/10236,7/1/2019 5:03:20 AM,Overall,57154,59486,61916,64444,243000,59049,65899,63683,69629,258260
53,Ethiopia,2018,ETH-18/DDA-3379/RA1/H/UN/10318,6/7/2019 5:21:29 AM,Internally Displaced People,49411,50819,68232,64679,233141,106891,109916,147651,139983,504441
53,Ethiopia,2018,ETH-18/DDA-3379/RA1/H/UN/10318,6/7/2019 5:21:29 AM,Overall,164701,169398,227442,215596,777137,152703,157027,210931,199972,720633
53,Ethiopia,2018,ETH-18/DDA-3379/RA1/H/UN/10325,6/11/2019 4:33:06 AM,Host Communities,0,0,0,0,0,56183,58476,84275,87716,286650
53,Ethiopia,2018,ETH-18/DDA-3379/RA1/H/UN/10325,6/11/2019 4:33:06 AM,Overall,56183,58477,84275,87715,286650,56183,58477,84275,87715,286650
53,Ethiopia,2018,ETH-18/DDA-3379/RA1/H/UN/10337,9/5/2019 8:39:36 AM,Overall,83150,86543,124724,129815,424232,83150,86543,124724,129815,424232
53,Ethiopia,2018,ETH-18/DDA-3379/RA1/H/UN/10344,8/13/2019 7:04:00 AM,Host Communities,35139,36573,38067,39621,149400,35322,37524,38420,39728,150994
53,Ethiopia,2018,ETH-18/DDA-3379/RA1/H/UN/10344,8/13/2019 7:04:00 AM,Internally Displaced People,7197,7491,7797,8115,30600,7234,7686,7860,8274,31054
53,Ethiopia,2018,ETH-18/DDA-3379/RA1/H/UN/10344,8/13/2019 7:04:00 AM,Overall,42336,44064,45864,47736,180000,42556,45210,46280,48002,182048
53,Ethiopia,2018,ETH-18/DDA-3379/RA1/H/UN/10348,6/12/2019 12:41:36 PM,Host Communities,9,13,3,5,30,0,0,0,0,0
53,Ethiopia,2018,ETH-18/DDA-3379/RA1/H/UN/10348,6/12/2019 12:41:36 PM,Internally Displaced People,8400,21381,2800,7127,39708,8408,21396,2800,7134,39738
53,Ethiopia,2018,ETH-18/DDA-3379/RA1/H/UN/10348,6/12/2019 12:41:36 PM,Overall,8409,21394,2803,7132,39738,8409,21394,2803,7132,39738
53,Ethiopia,2018,ETH-18/DDA-3379/RA1/H/UN/10352,7/16/2019 12:02:18 PM,Internally Displaced People,8400,20455,2800,6819,38474,9230,23204,4730,11013,48177
53,Ethiopia,2018,ETH-18/DDA-3379/RA1/H/UN/10352,7/16/2019 12:02:18 PM,Overall,8400,20455,2800,6819,38474,9230,23204,4730,11013,48177
53,Ethiopia,2018,ETH-18/DDA-3379/RA1/N/INGO/10258,6/28/2019 5:21:11 AM,Host Communities,0,8710,4449,4631,17790,0,7509,3867,4468,15844
53,Ethiopia,2018,ETH-18/DDA-3379/RA1/N/INGO/10258,6/28/2019 5:21:11 AM,Overall,0,8710,4449,4631,17790,0,7509,3867,4468,15844
53,Ethiopia,2018,ETH-18/DDA-3379/RA1/N/INGO/10263,6/21/2019 10:00:03 AM,Overall,486,3916,4014,4212,12628,2650,17761,4846,5310,30567
53,Ethiopia,2018,ETH-18/DDA-3379/RA1/N/INGO/10292,6/7/2019 9:17:52 AM,Host Communities,1880,12521,16523,17198,48122,78,28446,26968,33338,88830
53,Ethiopia,2018,ETH-18/DDA-3379/RA1/N/INGO/10292,6/7/2019 9:17:52 AM,Internally Displaced People,10,33,62,64,169,0,0,0,0,0
53,Ethiopia,2018,ETH-18/DDA-3379/RA1/N/INGO/10292,6/7/2019 9:17:52 AM,Overall,1890,12554,16585,17262,48291,78,28446,26968,33338,88830
53,Ethiopia,2018,ETH-18/DDA-3379/RA1/N/INGO/10305,6/18/2019 5:16:49 AM,Host Communities,0,4206,1591,1528,7325,0,2534,1578,2148,6260
53,Ethiopia,2018,ETH-18/DDA-3379/RA1/N/INGO/10305,6/18/2019 5:16:49 AM,Internally Displaced People,0,457,416,399,1272,0,364,516,410,1290
53,Ethiopia,2018,ETH-18/DDA-3379/RA1/N/INGO/10305,6/18/2019 5:16:49 AM,Overall,0,4663,2007,1927,8597,0,2898,2094,2558,7550
53,Ethiopia,2018,ETH-18/DDA-3379/RA1/N/INGO/10362,10/28/2019 5:43:24 AM,Host Communities,0,5108,3202,3333,11643,0,8341,4141,4569,17051
53,Ethiopia,2018,ETH-18/DDA-3379/RA1/N/INGO/10362,10/28/2019 5:43:24 AM,Overall,0,5108,3202,3333,11643,0,8341,4141,4569,17051
53,Ethiopia,2018,ETH-18/DDA-3379/RA1/N/NGO/10285,7/11/2019 3:46:49 AM,Overall,500,5912,5895,5671,17978,500,11897,4147,4421,20965
53,Ethiopia,2018,ETH-18/DDA-3379/RA1/N/NGO/10961,9/30/2019 9:06:30 AM,Overall,1500,11668,5354,5573,24095,5242,18988,5821,6587,36638
53,Ethiopia,2018,ETH-18/DDA-3379/RA1/N/UN/10255,9/30/2019 9:03:20 AM,Host Communities,0,0,1119,1131,2250,0,0,2271,1871,4142
53,Ethiopia,2018,ETH-18/DDA-3379/RA1/N/UN/10255,9/30/2019 9:03:20 AM,Internally Displaced People,0,0,1493,1507,3000,0,0,741,640,1381
53,Ethiopia,2018,ETH-18/DDA-3379/RA1/N/UN/10255,9/30/2019 9:03:20 AM,Overall,0,0,2612,2638,5250,0,0,3012,2511,5523
53,Ethiopia,2018,ETH-18/DDA-3379/RA1/N/UN/10331,9/5/2019 2:36:34 PM,Host Communities,0,0,27087,27087,54174,0,0,27365,27365,54730
53,Ethiopia,2018,ETH-18/DDA-3379/RA1/N/UN/10331,9/5/2019 2:36:34 PM,Internally Displaced People,0,0,4324,4328,8652,0,0,4135,4135,8270
53,Ethiopia,2018,ETH-18/DDA-3379/RA1/N/UN/10331,9/5/2019 2:36:34 PM,Overall,0,0,31411,31415,62826,0,0,31500,31500,63000
53,Ethiopia,2018,ETH-18/DDA-3379/RA1/N/UN/10954,9/5/2019 9:12:43 AM,Internally Displaced People,0,0,448,452,900,0,0,421,632,1053
53,Ethiopia,2018,ETH-18/DDA-3379/RA1/N/UN/10954,9/5/2019 9:12:43 AM,Overall,0,0,448,452,900,0,0,421,632,1053
53,Ethiopia,2018,ETH-18/DDA-3379/RA1/NFI/ES/INGO/10209,10/21/2019 8:39:07 AM,Internally Displaced People,6654,6353,9378,7865,30250,7841,7545,10913,9330,35629
53,Ethiopia,2018,ETH-18/DDA-3379/RA1/NFI/ES/INGO/10209,10/21/2019 8:39:07 AM,Overall,6654,6353,9378,7865,30250,7841,7545,10913,9330,35629
53,Ethiopia,2018,ETH-18/DDA-3379/RA1/NFI/ES/INGO/10218,10/22/2019 4:53:48 AM,Internally Displaced People,2293,3440,2867,2867,11467,2009,2279,3524,3655,11467
53,Ethiopia,2018,ETH-18/DDA-3379/RA1/NFI/ES/INGO/10218,10/22/2019 4:53:48 AM,Overall,2293,3440,2867,2867,11467,2009,2279,3524,3655,11467
53,Ethiopia,2018,ETH-18/DDA-3379/RA1/NFI/ES/INGO/10264,8/13/2019 6:54:16 AM,Overall,1286,1286,1890,1968,6430,3112,2546,637,778,7073
53,Ethiopia,2018,ETH-18/DDA-3379/RA1/NFI/ES/INGO/10299,2/4/2020 8:40:07 AM,Other,2188,2188,3282,3283,10941,1241,392,4653,4655,10941
53,Ethiopia,2018,ETH-18/DDA-3379/RA1/NFI/ES/INGO/10299,2/4/2020 8:40:07 AM,Overall,2188,2188,3282,3283,10941,1241,392,4653,4655,10941
53,Ethiopia,2018,ETH-18/DDA-3379/RA1/NFI/ES/INGO/10315,8/13/2019 10:34:48 AM,Internally Displaced People,2666,3130,3682,4322,13800,5128,4861,2154,1933,14076
53,Ethiopia,2018,ETH-18/DDA-3379/RA1/NFI/ES/INGO/10315,8/13/2019 10:34:48 AM,Overall,2666,3130,3682,4322,13800,5128,4861,2154,1933,14076
53,Ethiopia,2018,ETH-18/DDA-3379/RA1/NFI/ES/INGO/10319,9/4/2019 12:16:46 PM,Internally Displaced People,665,735,1014,1084,3498,712,787,1085,1160,3744
53,Ethiopia,2018,ETH-18/DDA-3379/RA1/NFI/ES/INGO/10319,9/4/2019 12:16:46 PM,Overall,665,735,1014,1084,3498,712,787,1085,1160,3744
53,Ethiopia,2018,ETH-18/DDA-3379/RA1/NFI/ES/INGO/10330,9/5/2019 2:12:37 PM,Internally Displaced People,833,867,1666,1734,5100,816,867,1683,1734,5100
53,Ethiopia,2018,ETH-18/DDA-3379/RA1/NFI/ES/INGO/10330,9/5/2019 2:12:37 PM,Overall,980,1020,1960,2040,6000,816,867,1683,1734,5100
53,Ethiopia,2018,ETH-18/DDA-3379/RA1/NFI/ES/INGO/10957,8/13/2019 7:16:02 AM,Internally Displaced People,6737,7013,6737,7013,27500,6462,15503,2691,2801,27457
53,Ethiopia,2018,ETH-18/DDA-3379/RA1/NFI/ES/INGO/10957,8/13/2019 7:16:02 AM,Overall,6737,7013,6737,7013,27500,6462,15503,2691,2801,27457
53,Ethiopia,2018,ETH-18/DDA-3379/RA1/NFI/ES/INGO/10963,10/22/2019 4:58:52 AM,Internally Displaced People,1006,1006,1509,1509,5030,99,232,943,944,2218
53,Ethiopia,2018,ETH-18/DDA-3379/RA1/NFI/ES/INGO/10963,10/22/2019 4:58:52 AM,Overall,1006,1006,1509,1509,5030,99,232,943,944,2218
53,Ethiopia,2018,ETH-18/DDA-3379/RA1/P/INGO/10224,10/22/2019 4:50:34 AM,Internally Displaced People,3200,4800,7867,10000,25867,6743,6260,9163,9546,31712
53,Ethiopia,2018,ETH-18/DDA-3379/RA1/P/INGO/10224,10/22/2019 4:50:34 AM,Overall,3200,4800,7867,10000,25867,6743,6260,9163,9546,31712
53,Ethiopia,2018,ETH-18/DDA-3379/RA1/P/INGO/10295,8/13/2019 6:58:18 AM,Host Communities,521,521,1497,1589,4128,521,521,1427,1589,4058
53,Ethiopia,2018,ETH-18/DDA-3379/RA1/P/INGO/10295,8/13/2019 6:58:18 AM,Internally Displaced People,2954,2954,9935,10550,26393,2954,3164,10140,10653,26911
53,Ethiopia,2018,ETH-18/DDA-3379/RA1/P/INGO/10295,8/13/2019 6:58:18 AM,Other,60,60,0,0,120,60,60,0,0,120
53,Ethiopia,2018,ETH-18/DDA-3379/RA1/P/INGO/10295,8/13/2019 6:58:18 AM,Overall,3535,3535,11478,12139,30687,3535,3745,11567,12242,31089
53,Ethiopia,2018,ETH-18/DDA-3379/RA1/P/INGO/10917,6/11/2019 5:02:54 AM,Other,280,220,0,0,500,877,105,0,0,982
53,Ethiopia,2018,ETH-18/DDA-3379/RA1/P/INGO/10917,6/11/2019 5:02:54 AM,Overall,280,220,0,0,500,877,105,0,0,982
53,Ethiopia,2018,ETH-18/DDA-3379/RA1/P/UN/10704,10/31/2019 5:53:08 AM,Internally Displaced People,17280,18720,30720,33280,100000,22800,31771,14951,17793,87315
53,Ethiopia,2018,ETH-18/DDA-3379/RA1/P/UN/10704,10/31/2019 5:53:08 AM,Overall,17280,18720,30720,33280,100000,22800,31771,14951,17793,87315
53,Ethiopia,2018,ETH-18/DDA-3379/RA1/P/UN/10705,11/6/2019 4:54:42 AM,Internally Displaced People,17280,18720,30720,33280,100000,11232,12168,16896,18304,58600
53,Ethiopia,2018,ETH-18/DDA-3379/RA1/P/UN/10705,11/6/2019 4:54:42 AM,Overall,17280,18720,30720,33280,100000,11232,12168,16896,18304,58600
53,Ethiopia,2018,ETH-18/DDA-3379/RA1/P/UN/10791,4/21/2020 3:47:25 PM,Internally Displaced People,800,700,250,250,2000,2523,2158,470,534,5685
53,Ethiopia,2018,ETH-18/DDA-3379/RA1/P/UN/10791,4/21/2020 3:47:25 PM,Overall,800,700,250,250,2000,2523,2158,470,534,5685
53,Ethiopia,2018,ETH-18/DDA-3379/RA1/P/UN/10846,12/3/2019 12:32:31 PM,Internally Displaced People,17280,18720,30720,33280,100000,16000,17700,26500,28670,88870
53,Ethiopia,2018,ETH-18/DDA-3379/RA1/P/UN/10846,12/3/2019 12:32:31 PM,Overall,17280,18720,30720,33280,100000,16000,17700,26500,28670,88870
53,Ethiopia,2018,ETH-18/DDA-3379/RA1/WASH/INGO/10205,6/14/2019 4:46:23 AM,Host Communities,5880,6119,8820,9181,30000,4948,5150,7422,7726,25246
53,Ethiopia,2018,ETH-18/DDA-3379/RA1/WASH/INGO/10205,6/14/2019 4:46:23 AM,Internally Displaced People,6807,7087,10213,10631,34738,0,0,0,0,0
53,Ethiopia,2018,ETH-18/DDA-3379/RA1/WASH/INGO/10205,6/14/2019 4:46:23 AM,Overall,12687,13206,19033,19812,64738,12687,13206,19033,19812,64738
53,Ethiopia,2018,ETH-18/DDA-3379/RA1/WASH/INGO/10208,10/31/2019 7:30:32 AM,Internally Displaced People,2555,3558,5008,5734,16855,3020,3197,5684,5861,17762
53,Ethiopia,2018,ETH-18/DDA-3379/RA1/WASH/INGO/10208,10/31/2019 7:30:32 AM,Other,2555,3558,5008,5734,16855,3022,3199,5686,5864,17771
53,Ethiopia,2018,ETH-18/DDA-3379/RA1/WASH/INGO/10208,10/31/2019 7:30:32 AM,Overall,5110,7116,10016,11468,33710,6042,6396,11370,11725,35533
53,Ethiopia,2018,ETH-18/DDA-3379/RA1/WASH/INGO/10233,9/9/2019 7:01:19 AM,Host Communities,0,0,0,0,0,90,109,0,0,199
53,Ethiopia,2018,ETH-18/DDA-3379/RA1/WASH/INGO/10233,9/9/2019 7:01:19 AM,Internally Displaced People,6198,6254,5214,5242,22908,6108,6144,5214,5242,22708
53,Ethiopia,2018,ETH-18/DDA-3379/RA1/WASH/INGO/10233,9/9/2019 7:01:19 AM,Overall,6198,6254,5214,5242,22908,6198,6253,5214,5242,22907
53,Ethiopia,2018,ETH-18/DDA-3379/RA1/WASH/INGO/10267,8/13/2019 7:01:12 AM,Internally Displaced People,16985,17794,23455,22646,80880,16985,17794,23455,22646,80880
53,Ethiopia,2018,ETH-18/DDA-3379/RA1/WASH/INGO/10267,8/13/2019 7:01:12 AM,Overall,16985,17794,23455,22646,80880,16985,17794,23455,22646,80880
53,Ethiopia,2018,ETH-18/DDA-3379/RA1/WASH/INGO/10307,10/22/2019 4:55:56 AM,Overall,894,1032,598,639,3163,1460,2110,1280,1700,6550
53,Ethiopia,2018,ETH-18/DDA-3379/RA1/WASH/INGO/10317,10/22/2019 4:52:08 AM,Overall,13486,15434,24726,23601,77247,15836,23755,19795,19795,79181
53,Ethiopia,2018,ETH-18/DDA-3379/RA1/WASH/INGO/10948,10/31/2019 11:47:58 AM,Overall,24610,20951,0,0,45561,24610,23236,0,0,47846
53,Ethiopia,2018,ETH-18/DDA-3379/RA1/WASH/INGO/10951,9/30/2019 9:09:16 AM,Internally Displaced People,5540,5323,8309,7984,27156,4960,6226,7438,9340,27964
53,Ethiopia,2018,ETH-18/DDA-3379/RA1/WASH/INGO/10951,9/30/2019 9:09:16 AM,Overall,5540,5323,8309,7984,27156,4960,6226,7438,9340,27964
53,Ethiopia,2018,ETH-18/DDA-3379/RA1/WASH/UN/10265,1/8/2020 11:46:24 AM,Overall,1378,1424,1766,1832,6400,2776,5065,0,0,7841
53,Ethiopia,2018,ETH-18/DDA-3379/RA1/WASH/UN/10328,8/13/2019 7:20:49 AM,Overall,61622,62366,57658,58354,240000,39591,40540,41710,42651,164492
53,Ethiopia,2018,ETH-18/DDA-3379/RA1/WASH/UN/10964,1/8/2020 11:40:32 AM,Host Communities,13480,13642,12613,12765,52500,9458,9383,13061,12957,44859
53,Ethiopia,2018,ETH-18/DDA-3379/RA1/WASH/UN/10964,1/8/2020 11:40:32 AM,Internally Displaced People,31453,31833,29429,29785,122500,8520,8452,11766,11672,40410
53,Ethiopia,2018,ETH-18/DDA-3379/RA1/WASH/UN/10964,1/8/2020 11:40:32 AM,Overall,44933,45475,42042,42550,175000,17978,17835,24827,24629,85269
53,Ethiopia,2018,ETH-18/DDA-3379/RA2/N/INGO/11506,10/18/2019 8:58:36 AM,Overall,342,7006,57,58,7463,348,5695,109,163,6315
53,Ethiopia,2018,ETH-18/DDA-3379/RA2/N/INGO/11511,10/28/2019 6:29:28 AM,Host Communities,0,1100,621,621,2342,21,2739,1336,1247,5343
53,Ethiopia,2018,ETH-18/DDA-3379/RA2/N/INGO/11511,10/28/2019 6:29:28 AM,Internally Displaced People,0,3820,3921,3921,11662,0,3512,5972,6132,15616
53,Ethiopia,2018,ETH-18/DDA-3379/RA2/N/INGO/11511,10/28/2019 6:29:28 AM,Overall,31,4920,4542,4542,14035,21,6251,7308,7379,20959
53,Ethiopia,2018,ETH-18/DDA-3379/RA2/N/INGO/11533,10/21/2019 8:36:12 AM,Overall,1783,12517,5407,5627,25334,115,12555,4880,4174,21724
53,Ethiopia,2018,ETH-18/DDA-3379/RA2/N/INGO/11565,10/21/2019 8:30:33 AM,Host Communities,43,17166,22788,23564,63561,1064,14073,4756,5356,25249
53,Ethiopia,2018,ETH-18/DDA-3379/RA2/N/INGO/11565,10/21/2019 8:30:33 AM,Internally Displaced People,71,9318,13062,13595,36046,2226,3809,3877,3834,13746
53,Ethiopia,2018,ETH-18/DDA-3379/RA2/N/INGO/11565,10/21/2019 8:30:33 AM,Overall,114,26484,35850,37159,99607,3290,17882,8633,9190,38995
53,Ethiopia,2018,ETH-18/DDA-3379/RA2/N/NGO/11548,10/21/2019 8:23:44 AM,Overall,0,5939,1441,1500,8880,590,6982,642,724,8938
53,Ethiopia,2018,ETH-18/DDA-3379/RA2/N/UN/11528,10/21/2019 8:41:17 AM,Host Communities,0,0,206,169,375,0,0,187,170,357
53,Ethiopia,2018,ETH-18/DDA-3379/RA2/N/UN/11528,10/21/2019 8:41:17 AM,Internally Displaced People,0,0,207,168,375,0,0,222,192,414
53,Ethiopia,2018,ETH-18/DDA-3379/RA2/N/UN/11528,10/21/2019 8:41:17 AM,Overall,0,0,413,337,750,0,0,409,362,771
53,Ethiopia,2018,ETH-18/DDA-3379/RA2/N/UN/11540,10/18/2019 8:47:25 AM,Internally Displaced People,0,15707,19015,19015,53737,0,13717,18809,18810,51336
53,Ethiopia,2018,ETH-18/DDA-3379/RA2/N/UN/11540,10/18/2019 8:47:25 AM,Overall,0,15707,19015,19015,53737,0,13717,18809,18810,51336
53,Ethiopia,2018,ETH-18/DDA-3379/RA2/N/UN/11551,4/2/2020 1:57:42 PM,Internally Displaced People,0,27156,17000,16333,60489,0,81467,53040,50960,185467
53,Ethiopia,2018,ETH-18/DDA-3379/RA2/N/UN/11551,4/2/2020 1:57:42 PM,Overall,0,27156,17000,16333,60489,0,81467,53040,50960,185467
53,Ethiopia,2018,ETH-18/DDA-3379/RA2/NFI/ES-WASH-H/INGO/11514,12/10/2020 5:54:06 AM,Internally Displaced People,251820,240551,351923,295582,1139876,264769,365695,360061,327596,1318121
53,Ethiopia,2018,ETH-18/DDA-3379/RA2/NFI/ES-WASH-H/INGO/11514,12/10/2020 5:54:06 AM,Overall,252552,240671,352035,295622,1140880,367743,469698,497084,448808,1783333
53,Ethiopia,2018,ETH-18/DDA-3379/RA2/NFI/ES-WASH-H/INGO/11514,12/10/2020 5:54:06 AM,Returnees,732,120,112,40,1004,102974,104003,137023,121212,465212
53,Ethiopia,2018,ETH-18/DDA-3379/RA2/P/UN/11626,3/22/2021 1:03:40 PM,Other,989,990,0,0,1979,1800,1800,0,0,3600
53,Ethiopia,2018,ETH-18/DDA-3379/RA2/P/UN/11626,3/22/2021 1:03:40 PM,Overall,989,990,0,0,1979,1800,1800,0,0,3600
53,Ethiopia,2018,ETH-18/DDA-3379/SA1/A/INGO/8982,6/17/2019 5:52:15 AM,Host Communities,23042,10534,7681,2633,43890,0,0,0,0,0
53,Ethiopia,2018,ETH-18/DDA-3379/SA1/A/INGO/8982,6/17/2019 5:52:15 AM,Overall,23042,10534,7681,2633,43890,30230,13820,10077,3455,57582
53,Ethiopia,2018,ETH-18/DDA-3379/SA1/A/INGO/8985,4/3/2019 11:46:45 AM,Host Communities,19971,34024,36277,62307,152579,0,0,0,0,0
53,Ethiopia,2018,ETH-18/DDA-3379/SA1/A/INGO/8985,4/3/2019 11:46:45 AM,Internally Displaced People,30891,15944,56115,28757,131707,0,0,0,0,0
53,Ethiopia,2018,ETH-18/DDA-3379/SA1/A/INGO/8985,4/3/2019 11:46:45 AM,Other,42385,41640,77122,76255,237402,215524,211740,391762,386892,1205918
53,Ethiopia,2018,ETH-18/DDA-3379/SA1/A/INGO/8985,4/3/2019 11:46:45 AM,Overall,110201,108264,200311,197821,616597,111695,109732,203027,200504,624958
53,Ethiopia,2018,ETH-18/DDA-3379/SA1/A/INGO/9207,6/12/2019 12:05:52 PM,Host Communities,14275,13338,11462,10525,49600,21371,17300,18893,16880,74444
53,Ethiopia,2018,ETH-18/DDA-3379/SA1/A/INGO/9207,6/12/2019 12:05:52 PM,Overall,14275,13338,11462,10525,49600,21371,17300,18893,16880,74444
53,Ethiopia,2018,ETH-18/DDA-3379/SA1/E/INGO/9098,7/26/2019 8:40:08 AM,Host Communities,1600,2560,1840,2000,8000,2872,3561,4069,5771,16273
53,Ethiopia,2018,ETH-18/DDA-3379/SA1/E/INGO/9098,7/26/2019 8:40:08 AM,Internally Displaced People,17628,21368,24932,29012,92940,16396,17884,24815,26274,85369
53,Ethiopia,2018,ETH-18/DDA-3379/SA1/E/INGO/9098,7/26/2019 8:40:08 AM,Overall,19228,23928,26772,31012,100940,19268,21445,28884,32045,101642
53,Ethiopia,2018,ETH-18/DDA-3379/SA1/E/INGO/9105,9/5/2019 2:58:49 PM,Overall,0,0,7091,7382,14473,0,0,7971,6516,14487
53,Ethiopia,2018,ETH-18/DDA-3379/SA1/E/INGO/9115,2/25/2021 8:11:00 PM,Internally Displaced People,150,100,6391,8992,15633,184,66,7213,7633,15096
53,Ethiopia,2018,ETH-18/DDA-3379/SA1/E/INGO/9115,2/25/2021 8:11:00 PM,Overall,150,100,6391,8992,15633,184,66,7213,7633,15096
53,Ethiopia,2018,ETH-18/DDA-3379/SA1/H/INGO/9089,6/14/2019 8:15:54 AM,Host Communities,6360,7467,752,784,15363,0,0,0,0,0
53,Ethiopia,2018,ETH-18/DDA-3379/SA1/H/INGO/9089,6/14/2019 8:15:54 AM,Internally Displaced People,11433,20131,2219,2310,36093,7386,12350,20849,22476,63061
53,Ethiopia,2018,ETH-18/DDA-3379/SA1/H/INGO/9089,6/14/2019 8:15:54 AM,Overall,17793,27598,2972,3094,51457,7387,12349,20850,22475,63061
53,Ethiopia,2018,ETH-18/DDA-3379/SA1/H/NGO/9049,1/31/2019 11:30:36 AM,Overall,16024,16281,3086,3134,38525,9220,18813,7940,7435,43408
53,Ethiopia,2018,ETH-18/DDA-3379/SA1/H/UN/9025,6/12/2019 12:19:28 PM,Overall,26342,27418,28538,29702,112000,28186,29337,30536,31781,119840
53,Ethiopia,2018,ETH-18/DDA-3379/SA1/H/UN/9041,1/30/2019 7:33:05 AM,Overall,17640,18360,19110,19890,75000,17783,18345,19201,20100,75429
53,Ethiopia,2018,ETH-18/DDA-3379/SA1/H/UN/9097,1/30/2019 7:46:17 AM,Overall,136170,138720,185443,177035,637368,136170,138720,185443,177035,637368
53,Ethiopia,2018,ETH-18/DDA-3379/SA1/N/INGO/8960,6/12/2019 11:31:03 AM,Overall,0,2214,1134,1081,4429,0,4000,1968,2047,8015
53,Ethiopia,2018,ETH-18/DDA-3379/SA1/N/INGO/8961,5/6/2019 11:11:54 AM,Host Communities,0,14630,8785,8932,32347,0,9894,10268,10758,30920
53,Ethiopia,2018,ETH-18/DDA-3379/SA1/N/INGO/8961,5/6/2019 11:11:54 AM,Internally Displaced People,0,280,200,420,900,0,953,1271,1128,3352
53,Ethiopia,2018,ETH-18/DDA-3379/SA1/N/INGO/8961,5/6/2019 11:11:54 AM,Overall,0,14910,8985,9352,33247,0,10845,11508,11920,34273
53,Ethiopia,2018,ETH-18/DDA-3379/SA1/N/INGO/9043,2/26/2019 12:55:03 PM,Host Communities,0,5233,4803,5204,15240,0,7421,4596,4447,16464
53,Ethiopia,2018,ETH-18/DDA-3379/SA1/N/INGO/9043,2/26/2019 12:55:03 PM,Overall,0,5233,4803,5204,15240,0,7421,4596,4447,16464
53,Ethiopia,2018,ETH-18/DDA-3379/SA1/N/INGO/9063,6/19/2019 11:43:30 AM,Overall,62,13353,9600,9993,33008,1353,27233,11009,11739,51334
53,Ethiopia,2018,ETH-18/DDA-3379/SA1/N/INGO/9064,6/14/2019 7:35:42 AM,Host Communities,0,616,722,724,2062,0,2330,1491,1055,4876
53,Ethiopia,2018,ETH-18/DDA-3379/SA1/N/INGO/9064,6/14/2019 7:35:42 AM,Internally Displaced People,0,150,344,300,794,0,840,586,970,2396
53,Ethiopia,2018,ETH-18/DDA-3379/SA1/N/INGO/9064,6/14/2019 7:35:42 AM,Overall,0,766,1066,1024,2856,0,3170,2077,2025,7272
53,Ethiopia,2018,ETH-18/DDA-3379/SA1/N/INGO/9093,8/13/2019 6:51:14 AM,Host Communities,1668,31469,60504,62222,155863,23743,42858,47297,39219,153117
53,Ethiopia,2018,ETH-18/DDA-3379/SA1/N/INGO/9093,8/13/2019 6:51:14 AM,Internally Displaced People,835,7440,14307,14713,37295,8682,47524,25586,27010,108802
53,Ethiopia,2018,ETH-18/DDA-3379/SA1/N/INGO/9093,8/13/2019 6:51:14 AM,Overall,2503,38909,74811,76935,193158,21107,78085,58469,61239,218900
53,Ethiopia,2018,ETH-18/DDA-3379/SA1/N/NGO/8991,2/4/2019 11:59:34 AM,Overall,0,1065,3809,3965,8839,0,1924,2763,2885,7572
53,Ethiopia,2018,ETH-18/DDA-3379/SA1/N/NGO/8992,2/4/2019 11:50:47 AM,Overall,0,1758,4963,5164,11885,0,6728,2441,2580,11749
53,Ethiopia,2018,ETH-18/DDA-3379/SA1/N-H/INGO/8964,6/14/2019 7:45:41 AM,Internally Displaced People,883,1145,343,403,2774,1783,15049,2737,3299,22868
53,Ethiopia,2018,ETH-18/DDA-3379/SA1/N-H/INGO/8964,6/14/2019 7:45:41 AM,Overall,1454,7283,6411,7531,22679,1783,15049,2737,3299,22868
53,Ethiopia,2018,ETH-18/DDA-3379/SA1/N-H/INGO/8993,1/31/2019 1:23:15 PM,Host Communities,620,7752,3182,3181,14735,2983,9671,2954,3612,19220
53,Ethiopia,2018,ETH-18/DDA-3379/SA1/N-H/INGO/8993,1/31/2019 1:23:15 PM,Internally Displaced People,1719,8552,5916,5917,22104,4828,15334,4686,6496,31344
53,Ethiopia,2018,ETH-18/DDA-3379/SA1/N-H/INGO/8993,1/31/2019 1:23:15 PM,Overall,2339,16304,9098,9098,36839,7811,25005,7640,10108,50564
53,Ethiopia,2018,ETH-18/DDA-3379/SA1/N-H-WASH/INGO/9111,6/14/2019 6:52:13 AM,Host Communities,18625,44567,0,0,63192,106484,172952,15848,18332,313616
53,Ethiopia,2018,ETH-18/DDA-3379/SA1/N-H-WASH/INGO/9111,6/14/2019 6:52:13 AM,Overall,36368,53893,9044,9417,108722,24700,49281,21259,24069,119309
53,Ethiopia,2018,ETH-18/DDA-3379/SA1/P/INGO/9018,6/14/2019 5:53:07 AM,Other,25,25,0,0,50,10406,11211,8071,5653,35341
53,Ethiopia,2018,ETH-18/DDA-3379/SA1/P/INGO/9018,6/14/2019 5:53:07 AM,Overall,9441,8655,14145,14823,47064,10406,11211,8071,5653,35341
53,Ethiopia,2018,ETH-18/DDA-3379/SA1/P/INGO/9096,6/12/2019 11:18:02 AM,Host Communities,206,671,475,708,2060,5379,5955,6283,7144,24761
53,Ethiopia,2018,ETH-18/DDA-3379/SA1/P/INGO/9096,6/12/2019 11:18:02 AM,Internally Displaced People,712,2270,1088,2711,6781,6693,6566,6731,9211,29201
53,Ethiopia,2018,ETH-18/DDA-3379/SA1/P/INGO/9096,6/12/2019 11:18:02 AM,Overall,918,2941,1563,3419,8841,1274,1494,3271,2870,8909
53,Ethiopia,2018,ETH-18/DDA-3379/SA1/WASH/INGO/8962,2/6/2019 7:16:03 AM,Internally Displaced People,0,0,0,0,0,2722,2998,867,1118,7705
53,Ethiopia,2018,ETH-18/DDA-3379/SA1/WASH/INGO/8962,2/6/2019 7:16:03 AM,Overall,2400,2122,1355,1301,7178,2200,2550,1455,1500,7705
53,Ethiopia,2018,ETH-18/DDA-3379/SA1/WASH/INGO/8980,8/15/2019 4:08:10 AM,Internally Displaced People,4981,4097,7472,6146,22696,12453,10243,0,0,22696
53,Ethiopia,2018,ETH-18/DDA-3379/SA1/WASH/INGO/8980,8/15/2019 4:08:10 AM,Overall,4981,4097,7472,6146,22696,12453,10243,0,0,22696
53,Ethiopia,2018,ETH-18/DDA-3379/SA1/WASH/INGO/9019,9/10/2019 12:18:22 PM,Host Communities,583,595,185,151,1514,583,595,185,151,1514
53,Ethiopia,2018,ETH-18/DDA-3379/SA1/WASH/INGO/9019,9/10/2019 12:18:22 PM,Internally Displaced People,17868,18237,5675,4642,46422,16801,18966,6063,5126,46956
53,Ethiopia,2018,ETH-18/DDA-3379/SA1/WASH/INGO/9019,9/10/2019 12:18:22 PM,Overall,18451,18832,5860,4793,47936,17384,19561,6248,5277,48470
53,Ethiopia,2018,ETH-18/DDA-3379/SA1/WASH/INGO/9090,6/14/2019 8:08:27 AM,Internally Displaced People,25504,24503,6251,6251,62509,23977,26254,5000,7502,62733
53,Ethiopia,2018,ETH-18/DDA-3379/SA1/WASH/INGO/9090,6/14/2019 8:08:27 AM,Overall,25504,24503,6251,6251,62509,23753,26254,5000,7502,62509
53,Ethiopia,2018,ETH-18/DDA-3379/SA1/WASH/INGO/9100,1/30/2019 6:50:24 AM,Internally Displaced People,2091,2301,0,0,4392,2265,2127,0,0,4392
53,Ethiopia,2018,ETH-18/DDA-3379/SA1/WASH/INGO/9100,1/30/2019 6:50:24 AM,Overall,2091,2301,0,0,4392,2265,2127,0,0,4392
53,Ethiopia,2018,ETH-18/DDA-3379/SA2/A/INGO/9607,10/24/2019 12:50:51 PM,Host Communities,104098,81842,0,0,185940,62915,51308,2671,1229,118123
53,Ethiopia,2018,ETH-18/DDA-3379/SA2/A/INGO/9607,10/24/2019 12:50:51 PM,Internally Displaced People,326,256,436,342,1360,34,116,0,0,150
53,Ethiopia,2018,ETH-18/DDA-3379/SA2/A/INGO/9607,10/24/2019 12:50:51 PM,Overall,104424,82098,436,342,187300,62949,51424,2671,1229,118273
53,Ethiopia,2018,ETH-18/DDA-3379/SA2/A/INGO/9618,6/19/2019 11:36:39 AM,Overall,18913,19523,12202,10372,61010,19637,19598,12554,10096,61885
53,Ethiopia,2018,ETH-18/DDA-3379/SA2/A/INGO/9619,6/7/2019 9:25:24 AM,Internally Displaced People,2773,3005,0,0,5778,4139,3737,0,0,7876
53,Ethiopia,2018,ETH-18/DDA-3379/SA2/A/INGO/9619,6/7/2019 9:25:24 AM,Overall,2773,3005,0,0,5778,4139,3737,0,0,7876
53,Ethiopia,2018,ETH-18/DDA-3379/SA2/A/INGO/9647,10/21/2019 8:51:04 AM,Host Communities,22932,10484,7644,2620,43680,0,0,0,0,0
53,Ethiopia,2018,ETH-18/DDA-3379/SA2/A/INGO/9647,10/21/2019 8:51:04 AM,Overall,22932,10484,7644,2620,43680,25462,11640,8487,2909,48498
53,Ethiopia,2018,ETH-18/DDA-3379/SA2/A/INGO/9665,10/18/2019 8:49:37 AM,Host Communities,360,360,778,482,1980,360,360,778,482,1980
53,Ethiopia,2018,ETH-18/DDA-3379/SA2/A/INGO/9665,10/18/2019 8:49:37 AM,Overall,360,360,778,482,1980,360,360,778,482,1980
53,Ethiopia,2018,ETH-18/DDA-3379/SA2/H/INGO/9621,5/6/2019 11:08:36 AM,Overall,6025,13821,16174,15480,51500,9547,12993,16220,17334,56094
53,Ethiopia,2018,ETH-18/DDA-3379/SA2/H/INGO/9674,6/18/2019 8:07:28 AM,Host Communities,11689,12166,3429,3569,30853,0,0,0,0,0
53,Ethiopia,2018,ETH-18/DDA-3379/SA2/H/INGO/9674,6/18/2019 8:07:28 AM,Internally Displaced People,4728,6563,2663,2774,16728,38620,47441,11189,12309,109559
53,Ethiopia,2018,ETH-18/DDA-3379/SA2/H/INGO/9674,6/18/2019 8:07:28 AM,Overall,16417,18729,6092,6343,47581,38620,47441,11189,12309,109559
53,Ethiopia,2018,ETH-18/DDA-3379/SA2/H/NGO/9633,6/12/2019 12:54:41 PM,Overall,12459,12263,2399,2361,29482,12858,17888,6609,6380,43735
53,Ethiopia,2018,ETH-18/DDA-3379/SA2/H/NGO/9659,2/6/2019 4:59:43 AM,Overall,19504,19200,3754,3694,46152,6407,15513,10481,10068,42469
53,Ethiopia,2018,ETH-18/DDA-3379/SA2/H/UN/9625,6/19/2019 12:45:25 PM,Host Communities,42,52,20,24,138,0,0,0,0,0
53,Ethiopia,2018,ETH-18/DDA-3379/SA2/H/UN/9625,6/19/2019 12:45:25 PM,Internally Displaced People,8332,23822,4606,2029,38789,13188,24297,5784,8069,51338
53,Ethiopia,2018,ETH-18/DDA-3379/SA2/H/UN/9625,6/19/2019 12:45:25 PM,Overall,8374,23874,4626,2053,38927,13188,24297,5784,8069,51338
53,Ethiopia,2018,ETH-18/DDA-3379/SA2/H/UN/9630,6/12/2019 1:42:29 PM,Overall,42336,44064,45864,47736,180000,42918,45930,43233,53762,185843
53,Ethiopia,2018,ETH-18/DDA-3379/SA2/H/UN/9640,1/31/2019 1:48:57 PM,Internally Displaced People,8332,8749,12499,12082,41662,13333,13999,19999,19333,66664
53,Ethiopia,2018,ETH-18/DDA-3379/SA2/H/UN/9640,1/31/2019 1:48:57 PM,Overall,13888,14582,20832,20138,69440,13333,13999,19999,19333,66664
53,Ethiopia,2018,ETH-18/DDA-3379/SA2/N/INGO/9627,6/14/2019 6:35:16 AM,Internally Displaced People,0,4850,3305,4386,12541,0,0,0,0,0
53,Ethiopia,2018,ETH-18/DDA-3379/SA2/N/INGO/9627,6/14/2019 6:35:16 AM,Overall,0,4850,3305,4386,12541,0,2999,1543,1605,6147
53,Ethiopia,2018,ETH-18/DDA-3379/SA2/N/INGO/9649,6/18/2019 7:58:30 AM,Host Communities,0,13890,8013,8483,30386,0,14998,6624,8180,29802
53,Ethiopia,2018,ETH-18/DDA-3379/SA2/N/INGO/9649,6/18/2019 7:58:30 AM,Internally Displaced People,0,629,209,220,1058,0,1428,679,731,2838
53,Ethiopia,2018,ETH-18/DDA-3379/SA2/N/INGO/9649,6/18/2019 7:58:30 AM,Overall,0,14519,8222,8703,31444,0,16426,7303,8911,32640
53,Ethiopia,2018,ETH-18/DDA-3379/SA2/N/INGO/9671,9/5/2019 8:41:46 AM,Host Communities,7441,64641,44832,46662,163576,5500,68887,45782,46147,166316
53,Ethiopia,2018,ETH-18/DDA-3379/SA2/N/INGO/9671,9/5/2019 8:41:46 AM,Overall,7441,64641,44832,46662,163576,5500,68887,45782,46147,166316
53,Ethiopia,2018,ETH-18/DDA-3379/SA2/N/INGO/9672,6/10/2019 5:00:20 AM,Host Communities,0,4173,2469,2570,9212,0,0,0,0,0
53,Ethiopia,2018,ETH-18/DDA-3379/SA2/N/INGO/9672,6/10/2019 5:00:20 AM,Internally Displaced People,0,464,1058,1101,2623,0,0,0,0,0
53,Ethiopia,2018,ETH-18/DDA-3379/SA2/N/INGO/9672,6/10/2019 5:00:20 AM,Overall,0,4637,3527,3671,11835,0,10789,5345,5602,21736
53,Ethiopia,2018,ETH-18/DDA-3379/SA2/N/INGO/9682,6/17/2019 4:42:04 AM,Host Communities,0,400,800,700,1900,0,1533,630,776,2939
53,Ethiopia,2018,ETH-18/DDA-3379/SA2/N/INGO/9682,6/17/2019 4:42:04 AM,Internally Displaced People,0,202,209,270,681,0,685,560,445,1690
53,Ethiopia,2018,ETH-18/DDA-3379/SA2/N/INGO/9682,6/17/2019 4:42:04 AM,Overall,0,602,1009,970,2581,0,2684,894,1051,4629
53,Ethiopia,2018,ETH-18/DDA-3379/SA2/N/INGO/9719,6/17/2019 5:56:24 AM,Host Communities,0,3774,2999,3000,9773,0,2564,3378,3660,9602
53,Ethiopia,2018,ETH-18/DDA-3379/SA2/N/INGO/9719,6/17/2019 5:56:24 AM,Internally Displaced People,0,295,642,642,1579,0,1785,1589,1723,5097
53,Ethiopia,2018,ETH-18/DDA-3379/SA2/N/INGO/9719,6/17/2019 5:56:24 AM,Overall,0,4069,5538,5538,15145,0,3748,4968,5382,14098
53,Ethiopia,2018,ETH-18/DDA-3379/SA2/N/NGO/9645,4/4/2019 10:33:44 AM,Overall,0,4988,9967,10374,25329,0,9116,9012,9460,27588
53,Ethiopia,2018,ETH-18/DDA-3379/SA2/N/NGO/9663,5/6/2019 11:16:42 AM,Overall,0,4500,5449,5457,15406,0,6835,3851,3938,14624
53,Ethiopia,2018,ETH-18/DDA-3379/SA2/N/UN/9629,6/12/2019 12:25:25 PM,Overall,0,0,508,434,942,0,0,471,402,873
53,Ethiopia,2018,ETH-18/DDA-3379/SA2/N/UN/9687,6/6/2019 10:44:55 AM,Host Communities,0,0,3350,3350,6700,0,0,0,0,0
53,Ethiopia,2018,ETH-18/DDA-3379/SA2/N/UN/9687,6/6/2019 10:44:55 AM,Internally Displaced People,0,0,1900,1900,3800,0,0,5845,5845,11690
53,Ethiopia,2018,ETH-18/DDA-3379/SA2/N/UN/9687,6/6/2019 10:44:55 AM,Overall,0,0,5250,5250,10500,0,0,5845,5845,11690
53,Ethiopia,2018,ETH-18/DDA-3379/SA2/NFI/ES/INGO/9604,6/10/2019 11:00:24 AM,Internally Displaced People,3932,3754,5541,4648,17875,4235,4043,5967,5005,19250
53,Ethiopia,2018,ETH-18/DDA-3379/SA2/NFI/ES/INGO/9604,6/10/2019 11:00:24 AM,Overall,3932,3754,5541,4648,17875,4235,4043,5967,5005,19250
53,Ethiopia,2018,ETH-18/DDA-3379/SA2/NFI/ES/INGO/9620,6/14/2019 9:02:21 AM,Overall,3039,3218,5899,5720,17876,2147,2273,4167,4041,12628
53,Ethiopia,2018,ETH-18/DDA-3379/SA2/NFI/ES-P-WASH/UN/9662,8/13/2019 7:09:56 AM,Internally Displaced People,81245,73120,125928,125928,406221,89222,80299,138293,138290,446104
53,Ethiopia,2018,ETH-18/DDA-3379/SA2/NFI/ES-P-WASH/UN/9662,8/13/2019 7:09:56 AM,Overall,81245,73120,125928,125928,406221,98543,88688,152739,152739,492709
53,Ethiopia,2018,ETH-18/DDA-3379/SA2/N-H/INGO/9596,7/1/2019 12:19:24 PM,Internally Displaced People,7400,11011,4388,5240,28039,13786,28588,9545,9729,61648
53,Ethiopia,2018,ETH-18/DDA-3379/SA2/N-H/INGO/9596,7/1/2019 12:19:24 PM,Overall,7599,21836,13509,15723,58667,0,0,0,0,0
53,Ethiopia,2018,ETH-18/DDA-3379/SA2/N-H/INGO/9631,6/12/2019 12:18:25 PM,Host Communities,1504,46680,11696,11697,71577,2812,35231,22745,24794,85582
53,Ethiopia,2018,ETH-18/DDA-3379/SA2/N-H/INGO/9631,6/12/2019 12:18:25 PM,Internally Displaced People,0,2471,619,619,3709,1112,12161,7854,10390,31517
53,Ethiopia,2018,ETH-18/DDA-3379/SA2/N-H/INGO/9631,6/12/2019 12:18:25 PM,Overall,1504,49151,12315,12316,75286,3924,47392,30599,35184,117099
53,Ethiopia,2018,ETH-18/DDA-3379/SA2/P/INGO/9634,7/1/2019 4:49:58 AM,Host Communities,190,60,0,0,250,629,193,0,0,822
53,Ethiopia,2018,ETH-18/DDA-3379/SA2/P/INGO/9634,7/1/2019 4:49:58 AM,Internally Displaced People,680,1020,0,0,1700,760,1711,0,0,2471
53,Ethiopia,2018,ETH-18/DDA-3379/SA2/P/INGO/9634,7/1/2019 4:49:58 AM,Overall,870,1080,0,0,1950,1389,1904,0,0,3293
53,Ethiopia,2018,ETH-18/DDA-3379/SA2/P/INGO/9661,10/18/2019 8:38:31 AM,Overall,917,2161,25,925,4028,1044,3538,0,396,4978
53,Ethiopia,2018,ETH-18/DDA-3379/SA2/P/INGO/9679,2/10/2020 6:51:49 AM,Internally Displaced People,4418,5258,4880,7000,21556,5226,4321,7240,6957,23744
53,Ethiopia,2018,ETH-18/DDA-3379/SA2/P/INGO/9679,2/10/2020 6:51:49 AM,Overall,4418,5258,4880,7000,21556,5226,4321,7240,6957,23744
53,Ethiopia,2018,ETH-18/DDA-3379/SA2/P/UN/9616,9/5/2019 7:34:43 AM,Internally Displaced People,400942,417308,0,0,818250,0,0,0,0,0
53,Ethiopia,2018,ETH-18/DDA-3379/SA2/P/UN/9616,9/5/2019 7:34:43 AM,Other,0,0,0,0,0,115000,141040,0,0,256040
53,Ethiopia,2018,ETH-18/DDA-3379/SA2/P/UN/9616,9/5/2019 7:34:43 AM,Overall,400942,417308,0,0,818250,115000,141040,0,0,256040
53,Ethiopia,2018,ETH-18/DDA-3379/SA2/WASH/INGO/9622,7/3/2019 5:05:05 AM,Overall,28254,29891,0,0,58145,24802,21843,0,0,46645
53,Ethiopia,2018,ETH-18/DDA-3379/SA2/WASH/INGO/9628,6/6/2019 10:34:50 AM,Host Communities,912,1008,1392,1488,4800,2208,2362,3327,3479,11376
53,Ethiopia,2018,ETH-18/DDA-3379/SA2/WASH/INGO/9628,6/6/2019 10:34:50 AM,Internally Displaced People,6314,6978,9637,10302,33231,6032,6165,7182,8025,27404
53,Ethiopia,2018,ETH-18/DDA-3379/SA2/WASH/INGO/9628,6/6/2019 10:34:50 AM,Overall,7226,7986,11030,11790,38032,8528,8719,11881,11216,40344
53,Ethiopia,2018,ETH-18/DDA-3379/SA2/WASH/INGO/9635,8/13/2019 7:07:12 AM,Internally Displaced People,3852,4064,7051,7320,22287,2981,4889,7155,8825,23850
53,Ethiopia,2018,ETH-18/DDA-3379/SA2/WASH/INGO/9635,8/13/2019 7:07:12 AM,Overall,3852,4064,7051,7320,22287,2981,4889,7155,8825,23850
53,Ethiopia,2018,ETH-18/DDA-3379/SA2/WASH/INGO/9637,7/9/2019 7:56:33 AM,Host Communities,2281,2521,3481,3722,12005,1786,1763,2150,2324,8023
53,Ethiopia,2018,ETH-18/DDA-3379/SA2/WASH/INGO/9637,7/9/2019 7:56:33 AM,Internally Displaced People,2179,2405,3322,3551,11457,1911,2869,4578,5008,14366
53,Ethiopia,2018,ETH-18/DDA-3379/SA2/WASH/INGO/9637,7/9/2019 7:56:33 AM,Overall,4460,4926,6803,7273,23462,3697,4632,6728,7332,22389
53,Ethiopia,2018,ETH-18/DDA-3379/SA2/WASH/INGO/9651,7/1/2019 5:10:54 AM,Host Communities,3232,3225,2613,2601,11671,0,0,0,0,0
53,Ethiopia,2018,ETH-18/DDA-3379/SA2/WASH/INGO/9651,7/1/2019 5:10:54 AM,Internally Displaced People,10299,10276,8325,8289,37189,17527,17748,5778,6187,47240
53,Ethiopia,2018,ETH-18/DDA-3379/SA2/WASH/INGO/9651,7/1/2019 5:10:54 AM,Overall,13531,13501,10938,10890,48860,17526,17750,5778,6187,47241
53,Ethiopia,2018,ETH-18/DDA-3379/SA2/WASH/INGO/9656,9/5/2019 1:36:03 PM,Internally Displaced People,6532,15243,0,0,21775,11332,9989,0,0,21321
53,Ethiopia,2018,ETH-18/DDA-3379/SA2/WASH/INGO/9656,9/5/2019 1:36:03 PM,Overall,6532,15243,0,0,21775,11332,9989,0,0,21321
53,Ethiopia,2018,ETH-18/DDA-3379/SA2/WASH/INGO/9667,10/21/2019 8:33:24 AM,Host Communities,7430,6822,3313,3525,21090,23594,24557,14461,15051,77663
53,Ethiopia,2018,ETH-18/DDA-3379/SA2/WASH/INGO/9667,10/21/2019 8:33:24 AM,Internally Displaced People,16884,17740,9424,9575,53623,24184,25169,14820,15427,79600
53,Ethiopia,2018,ETH-18/DDA-3379/SA2/WASH/INGO/9667,10/21/2019 8:33:24 AM,Overall,24314,24562,12737,13100,74713,47778,49726,29281,30478,157263
53,Ethiopia,2018,ETH-18/DDA-3379/SA2/WASH/INGO/9668,6/12/2019 1:09:12 PM,Host Communities,2843,2778,0,0,5621,2958,2876,0,0,5834
53,Ethiopia,2018,ETH-18/DDA-3379/SA2/WASH/INGO/9668,6/12/2019 1:09:12 PM,Internally Displaced People,3518,3353,0,0,6871,3303,4099,0,0,7402
53,Ethiopia,2018,ETH-18/DDA-3379/SA2/WASH/INGO/9668,6/12/2019 1:09:12 PM,Overall,6361,6131,0,0,12492,6261,6975,0,0,13236
53,Ethiopia,2018,ETH-18/DDA-3379/SA2/WASH/INGO/9670,6/28/2019 5:24:03 AM,Internally Displaced People,21179,31063,9177,9178,70597,21179,31063,9177,9178,70597
53,Ethiopia,2018,ETH-18/DDA-3379/SA2/WASH/INGO/9670,6/28/2019 5:24:03 AM,Overall,21179,31063,9177,9178,70597,24779,36344,10737,10738,82598
53,Ethiopia,2018,ETH-18/DDA-3379/SA2/WASH/INGO/9673,6/17/2019 5:04:57 AM,Host Communities,2374,2473,3564,3709,12120,4898,5100,7352,7650,25000
53,Ethiopia,2018,ETH-18/DDA-3379/SA2/WASH/INGO/9673,6/17/2019 5:04:57 AM,Internally Displaced People,887,923,1331,1385,4526,0,0,0,0,0
53,Ethiopia,2018,ETH-18/DDA-3379/SA2/WASH/INGO/9673,6/17/2019 5:04:57 AM,Overall,3261,3396,4895,5094,16646,3075,3202,4616,4803,15696
53,Ethiopia,2018,ETH-18/DDA-3379/SA2/WASH-NFI/ES/INGO/9632,6/21/2019 9:33:05 AM,Internally Displaced People,12240,11760,3264,3136,30400,0,0,0,0,0
53,Ethiopia,2018,ETH-18/DDA-3379/SA2/WASH-NFI/ES/INGO/9632,6/21/2019 9:33:05 AM,Overall,12240,11760,3264,3136,30400,29724,28981,16115,17214,92034
53,Ethiopia,2018,ETH-18/DDA-3379/SA2/WASH-NFI/ES/INGO/9641,6/17/2019 4:47:00 AM,Internally Displaced People,27540,33660,6885,8415,76500,75948,79050,18988,19762,193748
53,Ethiopia,2018,ETH-18/DDA-3379/SA2/WASH-NFI/ES/INGO/9641,6/17/2019 4:47:00 AM,Overall,27540,33660,6885,8415,76500,75950,79050,18988,19762,193750
53,Ethiopia,2018,ETH-18/DDA-3379/SA2/WASH-N-NFI/ES/INGO/9664,6/26/2019 7:24:08 AM,Host Communities,5880,27328,2167,1757,37132,20121,28290,2217,2795,53423
53,Ethiopia,2018,ETH-18/DDA-3379/SA2/WASH-N-NFI/ES/INGO/9664,6/26/2019 7:24:08 AM,Internally Displaced People,14323,23281,2081,2168,41853,9631,12088,6114,5359,33192
53,Ethiopia,2018,ETH-18/DDA-3379/SA2/WASH-N-NFI/ES/INGO/9664,6/26/2019 7:24:08 AM,Overall,20203,50609,4248,3925,78985,22476,32226,21250,20649,96601
53,Ethiopia,2019,ETH-19/DDA-3379/SA1/A/INGO/13057,4/9/2020 1:05:13 PM,Host Communities,5760,5760,0,0,11520,19063,31428,0,1,50492
53,Ethiopia,2019,ETH-19/DDA-3379/SA1/A/INGO/13057,4/9/2020 1:05:13 PM,Internally Displaced People,5760,5760,0,0,11520,19063,31429,0,0,50492
53,Ethiopia,2019,ETH-19/DDA-3379/SA1/A/INGO/13057,4/9/2020 1:05:13 PM,Overall,11520,11520,0,0,23040,38126,62857,0,1,100984
53,Ethiopia,2019,ETH-19/DDA-3379/SA1/A/INGO/13082,12/5/2020 5:34:25 PM,Host Communities,31598,13317,9713,3321,57949,32136,9686,8076,2352,52250
53,Ethiopia,2019,ETH-19/DDA-3379/SA1/A/INGO/13082,12/5/2020 5:34:25 PM,Internally Displaced People,1911,874,638,219,3642,1334,614,466,149,2563
53,Ethiopia,2019,ETH-19/DDA-3379/SA1/A/INGO/13082,12/5/2020 5:34:25 PM,Overall,33509,14191,10351,3540,61591,33470,10300,8542,2501,54813
53,Ethiopia,2019,ETH-19/DDA-3379/SA1/A/INGO/13086,2/4/2020 8:42:31 AM,Overall,37410,38657,23693,24940,124700,34544,35955,21167,22039,113705
53,Ethiopia,2019,ETH-19/DDA-3379/SA1/A/INGO/13086,2/4/2020 8:42:31 AM,Returnees,37410,38657,23693,24940,124700,34544,35955,21167,22039,113705
53,Ethiopia,2019,ETH-19/DDA-3379/SA1/A/INGO/13088,4/9/2020 9:04:06 AM,Host Communities,2309,2228,8388,8904,21829,9605,2121,42230,36205,90161
53,Ethiopia,2019,ETH-19/DDA-3379/SA1/A/INGO/13088,4/9/2020 9:04:06 AM,Internally Displaced People,5380,5195,19564,20679,50818,765,736,2772,2945,7218
53,Ethiopia,2019,ETH-19/DDA-3379/SA1/A/INGO/13088,4/9/2020 9:04:06 AM,Overall,7689,7423,27952,29583,72647,10370,2857,45002,39150,97379
53,Ethiopia,2019,ETH-19/DDA-3379/SA1/A/INGO/13089,5/4/2020 7:42:11 AM,Host Communities,36536,28824,0,0,65360,34227,25463,0,0,59690
53,Ethiopia,2019,ETH-19/DDA-3379/SA1/A/INGO/13089,5/4/2020 7:42:11 AM,Internally Displaced People,1300,1000,0,0,2300,1120,823,0,0,1943
53,Ethiopia,2019,ETH-19/DDA-3379/SA1/A/INGO/13089,5/4/2020 7:42:11 AM,Overall,37836,29824,0,0,67660,35347,26286,0,0,61633
53,Ethiopia,2019,ETH-19/DDA-3379/SA1/CSS/UN/13231,6/29/2023 8:38:09 AM,Other,2000,1500,4000,2500,10000,2000,1500,4000,2500,10000
53,Ethiopia,2019,ETH-19/DDA-3379/SA1/CSS/UN/13231,6/29/2023 8:38:09 AM,Overall,2000,1500,4000,2500,10000,2000,1500,4000,2500,10000
53,Ethiopia,2019,ETH-19/DDA-3379/SA1/E/INGO/12960,1/22/2020 5:12:43 PM,Internally Displaced People,200,185,3564,2358,6307,305,47,3020,2902,6274
53,Ethiopia,2019,ETH-19/DDA-3379/SA1/E/INGO/12960,1/22/2020 5:12:43 PM,Overall,200,185,5078,3522,8985,305,47,4585,4015,8952
53,Ethiopia,2019,ETH-19/DDA-3379/SA1/E/INGO/12960,1/22/2020 5:12:43 PM,Returnees,0,0,1514,1164,2678,0,0,1565,1113,2678
53,Ethiopia,2019,ETH-19/DDA-3379/SA1/E/INGO/13048,2/22/2021 8:13:13 PM,Internally Displaced People,60,60,5270,5486,10876,60,60,2360,2348,4828
53,Ethiopia,2019,ETH-19/DDA-3379/SA1/E/INGO/13048,2/22/2021 8:13:13 PM,Overall,60,60,5270,5486,10876,60,60,2360,2348,4828
53,Ethiopia,2019,ETH-19/DDA-3379/SA1/E/INGO/13080,1/13/2020 5:32:08 AM,Overall,100,50,3998,3850,7998,48,32,3163,3127,6370
53,Ethiopia,2019,ETH-19/DDA-3379/SA1/E/INGO/13080,1/13/2020 5:32:08 AM,Returnees,100,50,3998,3850,7998,48,32,3163,3127,6370
53,Ethiopia,2019,ETH-19/DDA-3379/SA1/E/INGO/13094,4/21/2020 9:01:38 AM,Internally Displaced People,60,60,7258,7554,14932,60,60,6979,6858,13957
53,Ethiopia,2019,ETH-19/DDA-3379/SA1/E/INGO/13094,4/21/2020 9:01:38 AM,Overall,60,60,7258,7554,14932,60,60,6979,6858,13957
53,Ethiopia,2019,ETH-19/DDA-3379/SA1/E/INGO/13099,4/25/2020 8:11:51 AM,Internally Displaced People,97,98,3250,3250,6695,97,98,3008,2379,5582
53,Ethiopia,2019,ETH-19/DDA-3379/SA1/E/INGO/13099,4/25/2020 8:11:51 AM,Overall,97,98,3250,3250,6695,97,98,3008,2379,5582
53,Ethiopia,2019,ETH-19/DDA-3379/SA1/E/INGO/13221,5/6/2020 9:49:50 AM,Internally Displaced People,0,0,2170,2500,4670,0,0,3337,1802,5139
53,Ethiopia,2019,ETH-19/DDA-3379/SA1/E/INGO/13221,5/6/2020 9:49:50 AM,Overall,0,0,2170,2500,4670,0,0,3337,1802,5139
53,Ethiopia,2019,ETH-19/DDA-3379/SA1/H/INGO/13013,3/31/2020 8:51:02 PM,Internally Displaced People,105146,121964,67620,56813,351543,91322,86275,71423,65262,314282
53,Ethiopia,2019,ETH-19/DDA-3379/SA1/H/INGO/13013,3/31/2020 8:51:02 PM,Overall,105146,121964,67620,56813,351543,91322,86275,71423,65262,314282
53,Ethiopia,2019,ETH-19/DDA-3379/SA1/H/INGO/13063,8/18/2020 7:34:56 AM,Host Communities,6665,15389,7145,6931,36130,14358,22470,23303,23887,84018
53,Ethiopia,2019,ETH-19/DDA-3379/SA1/H/INGO/13063,8/18/2020 7:34:56 AM,Internally Displaced People,8978,18697,7573,7381,42629,9980,13533,7805,7707,39025
53,Ethiopia,2019,ETH-19/DDA-3379/SA1/H/INGO/13063,8/18/2020 7:34:56 AM,Overall,15643,34086,14718,14312,78759,24338,36003,31108,31594,123043
53,Ethiopia,2019,ETH-19/DDA-3379/SA1/H/NGO/13075,2/10/2020 5:24:05 AM,Host Communities,26410,37126,6426,6328,76290,22906,44374,12276,11452,91008
53,Ethiopia,2019,ETH-19/DDA-3379/SA1/H/NGO/13075,2/10/2020 5:24:05 AM,Internally Displaced People,11164,15691,2607,2563,32025,6891,15883,3030,3159,28963
53,Ethiopia,2019,ETH-19/DDA-3379/SA1/H/NGO/13075,2/10/2020 5:24:05 AM,Overall,52821,74253,12592,12391,152057,59875,117021,33520,32950,243366
53,Ethiopia,2019,ETH-19/DDA-3379/SA1/H/NGO/13075,2/10/2020 5:24:05 AM,Returnees,15247,21436,3559,3500,43742,30078,56764,18214,18339,123395
53,Ethiopia,2019,ETH-19/DDA-3379/SA1/H/UN/12918,9/17/2020 12:12:42 PM,Host Communities,70560,73440,76440,79560,300000,64420,67049,69788,72635,273892
53,Ethiopia,2019,ETH-19/DDA-3379/SA1/H/UN/12918,9/17/2020 12:12:42 PM,Internally Displaced People,70560,73440,76440,79560,300000,64420,67049,69788,72636,273893
53,Ethiopia,2019,ETH-19/DDA-3379/SA1/H/UN/12918,9/17/2020 12:12:42 PM,Overall,141120,146880,152880,159120,600000,128840,134098,139576,145271,547785
53,Ethiopia,2019,ETH-19/DDA-3379/SA1/H/UN/12998,10/25/2022 12:13:56 PM,Host Communities,96882,93028,33244,31012,254166,94260,92997,32969,30938,251164
53,Ethiopia,2019,ETH-19/DDA-3379/SA1/H/UN/12998,10/25/2022 12:13:56 PM,Internally Displaced People,96882,93028,33244,31013,254167,95690,93071,33052,31016,252829
53,Ethiopia,2019,ETH-19/DDA-3379/SA1/H/UN/12998,10/25/2022 12:13:56 PM,Overall,193764,186056,66488,62025,508333,189950,186068,66021,61954,503993
53,Ethiopia,2019,ETH-19/DDA-3379/SA1/H/UN/13085,4/3/2020 12:11:39 PM,Host Communities,6222,5307,9422,6974,27925,5683,4636,8107,6065,24491
53,Ethiopia,2019,ETH-19/DDA-3379/SA1/H/UN/13085,4/3/2020 12:11:39 PM,Internally Displaced People,11906,12510,19086,22107,65609,10968,11618,17416,20339,60341
53,Ethiopia,2019,ETH-19/DDA-3379/SA1/H/UN/13085,4/3/2020 12:11:39 PM,Overall,18128,17817,28508,29081,93534,16651,16254,25523,26404,84832
53,Ethiopia,2019,ETH-19/DDA-3379/SA1/H/UN/13100,4/3/2020 12:21:13 PM,Host Communities,8467,8813,9173,9547,36000,8789,9148,9528,9985,37450
53,Ethiopia,2019,ETH-19/DDA-3379/SA1/H/UN/13100,4/3/2020 12:21:13 PM,Internally Displaced People,8467,8813,9173,9547,36000,8789,9148,9528,9985,37450
53,Ethiopia,2019,ETH-19/DDA-3379/SA1/H/UN/13100,4/3/2020 12:21:13 PM,Overall,16934,17626,18346,19094,72000,17578,18296,19056,19970,74900
53,Ethiopia,2019,ETH-19/DDA-3379/SA1/N/INGO/13050,6/20/2020 1:16:33 PM,Host Communities,0,3735,1987,1909,7631,0,6472,2568,2643,11683
53,Ethiopia,2019,ETH-19/DDA-3379/SA1/N/INGO/13050,6/20/2020 1:16:33 PM,Internally Displaced People,0,80,223,232,535,0,0,52,56,108
53,Ethiopia,2019,ETH-19/DDA-3379/SA1/N/INGO/13050,6/20/2020 1:16:33 PM,Overall,0,3815,2210,2141,8166,0,6472,2620,2699,11791
53,Ethiopia,2019,ETH-19/DDA-3379/SA1/N/INGO/13053,4/1/2020 6:53:08 AM,Host Communities,249,36322,50154,52201,138926,1268,44730,47035,49335,142368
53,Ethiopia,2019,ETH-19/DDA-3379/SA1/N/INGO/13053,4/1/2020 6:53:08 AM,Overall,249,36322,50154,52201,138926,1268,44730,47035,49335,142368
53,Ethiopia,2019,ETH-19/DDA-3379/SA1/N/INGO/13066,6/27/2020 10:04:49 PM,Host Communities,0,18410,17623,18342,54375,0,23607,17089,17461,58157
53,Ethiopia,2019,ETH-19/DDA-3379/SA1/N/INGO/13066,6/27/2020 10:04:49 PM,Overall,0,18410,17623,18342,54375,0,23607,17089,17461,58157
53,Ethiopia,2019,ETH-19/DDA-3379/SA1/N/INGO/13071,4/9/2020 1:29:31 PM,Host Communities,0,1231,1407,1614,4252,0,898,823,1244,2965
53,Ethiopia,2019,ETH-19/DDA-3379/SA1/N/INGO/13071,4/9/2020 1:29:31 PM,Internally Displaced People,0,269,308,333,910,0,179,239,310,728
53,Ethiopia,2019,ETH-19/DDA-3379/SA1/N/INGO/13071,4/9/2020 1:29:31 PM,Overall,0,1500,1715,1947,5162,0,1077,1062,1554,3693
53,Ethiopia,2019,ETH-19/DDA-3379/SA1/N/INGO/13084,7/22/2020 10:32:31 AM,Host Communities,0,6025,4723,4685,15433,0,15022,11275,12828,39125
53,Ethiopia,2019,ETH-19/DDA-3379/SA1/N/INGO/13084,7/22/2020 10:32:31 AM,Internally Displaced People,0,2687,2770,3000,8457,0,3466,2623,2436,8525
53,Ethiopia,2019,ETH-19/DDA-3379/SA1/N/INGO/13084,7/22/2020 10:32:31 AM,Overall,0,8712,7493,7685,23890,0,18488,13898,15264,47650
53,Ethiopia,2019,ETH-19/DDA-3379/SA1/N/INGO/13090,4/3/2020 12:42:33 PM,Host Communities,0,6845,3606,3210,13661,0,5385,3075,3718,12178
53,Ethiopia,2019,ETH-19/DDA-3379/SA1/N/INGO/13090,4/3/2020 12:42:33 PM,Internally Displaced People,0,47,28,20,95,0,0,0,0,0
53,Ethiopia,2019,ETH-19/DDA-3379/SA1/N/INGO/13090,4/3/2020 12:42:33 PM,Overall,0,6892,3634,3230,13756,0,5385,3075,3718,12178
53,Ethiopia,2019,ETH-19/DDA-3379/SA1/N/INGO/13096,4/3/2020 11:26:00 AM,Host Communities,190,473,1504,1565,3732,163,17405,10833,5175,33576
53,Ethiopia,2019,ETH-19/DDA-3379/SA1/N/INGO/13096,4/3/2020 11:26:00 AM,Internally Displaced People,232,604,2509,2652,5997,110,3403,2730,2619,8862
53,Ethiopia,2019,ETH-19/DDA-3379/SA1/N/INGO/13096,4/3/2020 11:26:00 AM,Other,606,4605,11393,11899,28503,318,15598,25043,25733,66692
53,Ethiopia,2019,ETH-19/DDA-3379/SA1/N/INGO/13096,4/3/2020 11:26:00 AM,Overall,1028,5682,15406,16116,38232,591,36406,38606,33527,109130
53,Ethiopia,2019,ETH-19/DDA-3379/SA1/N/INGO/13098,4/22/2020 6:32:22 AM,Host Communities,5562,11215,22649,21760,61186,367,18387,19143,20694,58591
53,Ethiopia,2019,ETH-19/DDA-3379/SA1/N/INGO/13098,4/22/2020 6:32:22 AM,Internally Displaced People,273,9239,2155,2073,13740,265,9340,2018,2031,13654
53,Ethiopia,2019,ETH-19/DDA-3379/SA1/N/INGO/13098,4/22/2020 6:32:22 AM,Other,70,165,0,0,235,33,16,0,0,49
53,Ethiopia,2019,ETH-19/DDA-3379/SA1/N/INGO/13098,4/22/2020 6:32:22 AM,Overall,5905,20619,24804,23833,75161,665,27743,21161,22725,72294
53,Ethiopia,2019,ETH-19/DDA-3379/SA1/N/NGO/13097,4/21/2020 3:02:36 PM,Host Communities,0,9007,6737,7079,22823,0,18561,8292,9458,36311
53,Ethiopia,2019,ETH-19/DDA-3379/SA1/N/NGO/13097,4/21/2020 3:02:36 PM,Internally Displaced People,0,2648,2076,2164,6888,0,6586,2828,3463,12877
53,Ethiopia,2019,ETH-19/DDA-3379/SA1/N/NGO/13097,4/21/2020 3:02:36 PM,Overall,0,11655,8813,9243,29711,0,25147,11120,12921,49188
53,Ethiopia,2019,ETH-19/DDA-3379/SA1/N/UN/13078,4/4/2020 2:11:57 PM,Host Communities,0,0,412,413,825,0,0,414,539,953
53,Ethiopia,2019,ETH-19/DDA-3379/SA1/N/UN/13078,4/4/2020 2:11:57 PM,Internally Displaced People,0,0,963,962,1925,0,0,955,907,1862
53,Ethiopia,2019,ETH-19/DDA-3379/SA1/N/UN/13078,4/4/2020 2:11:57 PM,Overall,0,0,1375,1375,2750,0,0,1369,1446,2815
53,Ethiopia,2019,ETH-19/DDA-3379/SA1/N/UN/13106,4/21/2020 9:46:39 AM,Internally Displaced People,0,0,708,690,1398,0,114702,37316,37221,189239
53,Ethiopia,2019,ETH-19/DDA-3379/SA1/N/UN/13106,4/21/2020 9:46:39 AM,Overall,0,0,708,690,1398,0,114702,37316,37221,189239
53,Ethiopia,2019,ETH-19/DDA-3379/SA1/NFI/ES/INGO/12965,4/9/2020 1:21:55 PM,Internally Displaced People,3988,4222,7742,7504,23456,3992,4226,7748,7514,23480
53,Ethiopia,2019,ETH-19/DDA-3379/SA1/NFI/ES/INGO/12965,4/9/2020 1:21:55 PM,Overall,3988,4222,7742,7504,23456,3992,4226,7748,7514,23480
53,Ethiopia,2019,ETH-19/DDA-3379/SA1/NFI/ES/INGO/13030,2/10/2021 12:45:01 PM,Internally Displaced People,6360,6030,9630,7980,30000,3731,4014,5886,5522,19153
53,Ethiopia,2019,ETH-19/DDA-3379/SA1/NFI/ES/INGO/13030,2/10/2021 12:45:01 PM,Other,75,75,75,75,300,461,161,0,0,622
53,Ethiopia,2019,ETH-19/DDA-3379/SA1/NFI/ES/INGO/13030,2/10/2021 12:45:01 PM,Overall,6435,6105,9705,8055,30300,4192,4175,5886,5522,19775
53,Ethiopia,2019,ETH-19/DDA-3379/SA1/NFI/ES/INGO/13046,4/20/2020 7:09:52 AM,Host Communities,348,420,557,594,1919,386,465,617,658,2126
53,Ethiopia,2019,ETH-19/DDA-3379/SA1/NFI/ES/INGO/13046,4/20/2020 7:09:52 AM,Internally Displaced People,4049,4884,6478,6924,22335,3698,4461,5916,6325,20400
53,Ethiopia,2019,ETH-19/DDA-3379/SA1/NFI/ES/INGO/13046,4/20/2020 7:09:52 AM,Overall,4397,5304,7035,7518,24254,4084,4926,6533,6983,22526
53,Ethiopia,2019,ETH-19/DDA-3379/SA1/NFI/ES/INGO/13058,4/1/2020 7:38:29 PM,Internally Displaced People,3520,3740,7260,7480,22000,5255,5350,12092,12080,34777
53,Ethiopia,2019,ETH-19/DDA-3379/SA1/NFI/ES/INGO/13058,4/1/2020 7:38:29 PM,Overall,3520,3740,7260,7480,22000,5255,5350,12092,12080,34777
53,Ethiopia,2019,ETH-19/DDA-3379/SA1/NFI/ES/INGO/13061,5/6/2020 9:32:30 AM,Internally Displaced People,5943,6186,5943,6186,24258,6630,6900,6630,6900,27060
53,Ethiopia,2019,ETH-19/DDA-3379/SA1/NFI/ES/INGO/13061,5/6/2020 9:32:30 AM,Overall,5943,6186,5943,6186,24258,6630,6900,6630,6900,27060
53,Ethiopia,2019,ETH-19/DDA-3379/SA1/NFI/ES/INGO/13064,4/20/2020 6:45:28 AM,Host Communities,439,527,637,593,2196,433,527,637,593,2190
53,Ethiopia,2019,ETH-19/DDA-3379/SA1/NFI/ES/INGO/13064,4/20/2020 6:45:28 AM,Internally Displaced People,3955,4747,5735,5339,19776,3526,4174,5493,6591,19784
53,Ethiopia,2019,ETH-19/DDA-3379/SA1/NFI/ES/INGO/13064,4/20/2020 6:45:28 AM,Overall,4394,5274,6372,5932,21972,3959,4701,6130,7184,21974
53,Ethiopia,2019,ETH-19/DDA-3379/SA1/NFI/ES/UN/13091,4/4/2020 9:53:39 AM,Internally Displaced People,5775,6325,7425,7975,27500,5174,6068,8501,9437,29180
53,Ethiopia,2019,ETH-19/DDA-3379/SA1/NFI/ES/UN/13091,4/4/2020 9:53:39 AM,Overall,5775,6325,7425,7975,27500,5174,6068,8501,9437,29180
53,Ethiopia,2019,ETH-19/DDA-3379/SA1/NFI/ES-WASH-P/UN/13081,9/17/2020 7:55:43 AM,Host Communities,301,330,388,416,1435,332,363,458,426,1579
53,Ethiopia,2019,ETH-19/DDA-3379/SA1/NFI/ES-WASH-P/UN/13081,9/17/2020 7:55:43 AM,Internally Displaced People,14765,16167,18983,20389,70304,16249,17796,22439,20892,77376
53,Ethiopia,2019,ETH-19/DDA-3379/SA1/NFI/ES-WASH-P/UN/13081,9/17/2020 7:55:43 AM,Overall,15066,16497,19371,20805,71739,16581,18159,22897,21318,78955
53,Ethiopia,2019,ETH-19/DDA-3379/SA1/N-H/INGO/12990,4/21/2020 8:29:58 AM,Host Communities,40,11505,10477,11068,33090,13588,31056,1972,2237,48853
53,Ethiopia,2019,ETH-19/DDA-3379/SA1/N-H/INGO/12990,4/21/2020 8:29:58 AM,Internally Displaced People,1622,2257,819,860,5558,850,1808,324,471,3453
53,Ethiopia,2019,ETH-19/DDA-3379/SA1/N-H/INGO/12990,4/21/2020 8:29:58 AM,Overall,1662,13762,11296,11928,38648,14438,32864,2296,2708,52306
53,Ethiopia,2019,ETH-19/DDA-3379/SA1/N-H/INGO/12992,4/21/2020 3:30:56 PM,Host Communities,4423,66742,23256,23256,117677,4649,51692,21304,24773,102418
53,Ethiopia,2019,ETH-19/DDA-3379/SA1/N-H/INGO/12992,4/21/2020 3:30:56 PM,Internally Displaced People,316,4238,1526,1526,7606,1612,10767,5494,6441,24314
53,Ethiopia,2019,ETH-19/DDA-3379/SA1/N-H/INGO/12992,4/21/2020 3:30:56 PM,Overall,4739,70980,24782,24782,125283,6261,62459,26798,31214,126732
53,Ethiopia,2019,ETH-19/DDA-3379/SA1/N-H-P/INGO/13076,4/1/2020 3:32:28 PM,Host Communities,24725,121675,26862,28285,201547,15232,54843,7891,9017,86983
53,Ethiopia,2019,ETH-19/DDA-3379/SA1/N-H-P/INGO/13076,4/1/2020 3:32:28 PM,Internally Displaced People,27596,52310,13506,16549,109961,16334,25234,6900,7745,56213
53,Ethiopia,2019,ETH-19/DDA-3379/SA1/N-H-P/INGO/13076,4/1/2020 3:32:28 PM,Overall,52321,173985,40368,44834,311508,31566,80077,14791,16762,143196
53,Ethiopia,2019,ETH-19/DDA-3379/SA1/N-WASH/INGO/13052,4/5/2020 8:18:50 AM,Host Communities,2282,15410,10277,10461,38430,3103,16185,11303,10705,41296
53,Ethiopia,2019,ETH-19/DDA-3379/SA1/N-WASH/INGO/13052,4/5/2020 8:18:50 AM,Internally Displaced People,5799,8121,4723,4588,23231,5122,6623,3758,4149,19652
53,Ethiopia,2019,ETH-19/DDA-3379/SA1/N-WASH/INGO/13052,4/5/2020 8:18:50 AM,Overall,8081,23531,15000,15049,61661,8225,22808,15061,14854,60948
53,Ethiopia,2019,ETH-19/DDA-3379/SA1/P/INGO/12966,6/22/2020 1:44:22 PM,Internally Displaced People,375,1000,212,463,2050,815,1330,840,930,3915
53,Ethiopia,2019,ETH-19/DDA-3379/SA1/P/INGO/12966,6/22/2020 1:44:22 PM,Overall,1500,4000,850,1850,8200,2400,4830,3840,4930,16000
53,Ethiopia,2019,ETH-19/DDA-3379/SA1/P/INGO/12966,6/22/2020 1:44:22 PM,Returnees,1125,3000,638,1387,6150,1585,3500,3000,4000,12085
53,Ethiopia,2019,ETH-19/DDA-3379/SA1/P/INGO/13035,9/21/2020 1:46:49 PM,Host Communities,100,150,0,0,250,192,206,0,0,398
53,Ethiopia,2019,ETH-19/DDA-3379/SA1/P/INGO/13035,9/21/2020 1:46:49 PM,Internally Displaced People,900,1350,0,0,2250,1648,1935,0,0,3583
53,Ethiopia,2019,ETH-19/DDA-3379/SA1/P/INGO/13035,9/21/2020 1:46:49 PM,Other,25,15,0,0,40,31,9,0,0,40
53,Ethiopia,2019,ETH-19/DDA-3379/SA1/P/INGO/13035,9/21/2020 1:46:49 PM,Overall,1025,1515,0,0,2540,1871,2150,0,0,4021
53,Ethiopia,2019,ETH-19/DDA-3379/SA1/P/INGO/13036,4/5/2020 8:48:07 AM,Host Communities,129,205,31,60,425,165,220,59,82,526
53,Ethiopia,2019,ETH-19/DDA-3379/SA1/P/INGO/13036,4/5/2020 8:48:07 AM,Internally Displaced People,1164,1849,276,536,3825,994,1732,422,618,3766
53,Ethiopia,2019,ETH-19/DDA-3379/SA1/P/INGO/13036,4/5/2020 8:48:07 AM,Overall,1293,2054,307,596,4250,1159,1952,481,700,4292
53,Ethiopia,2019,ETH-19/DDA-3379/SA1/P/INGO/13045,6/20/2020 1:46:15 PM,Host Communities,9963,12177,16051,17159,55350,10220,15000,16000,17000,58220
53,Ethiopia,2019,ETH-19/DDA-3379/SA1/P/INGO/13045,6/20/2020 1:46:15 PM,Internally Displaced People,3321,4059,5350,5720,18450,3500,6400,5500,6200,21600
53,Ethiopia,2019,ETH-19/DDA-3379/SA1/P/INGO/13045,6/20/2020 1:46:15 PM,Overall,13284,16236,21401,22879,73800,13720,21400,21500,23200,79820
53,Ethiopia,2019,ETH-19/DDA-3379/SA1/P/INGO/13051,5/11/2020 6:45:50 AM,Internally Displaced People,1472,6110,5925,7963,21470,1520,760,2700,7260,12240
53,Ethiopia,2019,ETH-19/DDA-3379/SA1/P/INGO/13051,5/11/2020 6:45:50 AM,Overall,2326,12018,6279,8284,28907,8816,4394,15674,18214,47098
53,Ethiopia,2019,ETH-19/DDA-3379/SA1/P/INGO/13051,5/11/2020 6:45:50 AM,Returnees,854,5908,354,321,7437,7296,3634,12974,10954,34858
53,Ethiopia,2019,ETH-19/DDA-3379/SA1/P/INGO/13059,7/30/2020 8:12:50 AM,Internally Displaced People,2204,4580,2380,2420,11584,2779,6239,4411,4130,17559
53,Ethiopia,2019,ETH-19/DDA-3379/SA1/P/INGO/13059,7/30/2020 8:12:50 AM,Overall,2204,4580,2380,2420,11584,2779,6239,4411,4130,17559
53,Ethiopia,2019,ETH-19/DDA-3379/SA1/P/INGO/13067,4/1/2020 9:05:34 AM,Host Communities,207,208,546,544,1505,207,208,796,594,1805
53,Ethiopia,2019,ETH-19/DDA-3379/SA1/P/INGO/13067,4/1/2020 9:05:34 AM,Internally Displaced People,3946,3946,10366,10333,28591,4046,4046,10866,10883,29841
53,Ethiopia,2019,ETH-19/DDA-3379/SA1/P/INGO/13067,4/1/2020 9:05:34 AM,Overall,4153,4154,10912,10877,30096,4253,4254,11662,11477,31646
53,Ethiopia,2019,ETH-19/DDA-3379/SA1/P/UN/13109,12/5/2020 6:31:55 PM,Internally Displaced People,800,1000,200,300,2300,1429,1020,210,110,2769
53,Ethiopia,2019,ETH-19/DDA-3379/SA1/P/UN/13109,12/5/2020 6:31:55 PM,Other,800,1000,200,300,2300,1552,910,175,315,2952
53,Ethiopia,2019,ETH-19/DDA-3379/SA1/P/UN/13109,12/5/2020 6:31:55 PM,Overall,1600,2000,400,600,4600,2981,1930,385,425,5721
53,Ethiopia,2019,ETH-19/DDA-3379/SA1/P/UN/13228,4/1/2020 7:21:46 PM,Internally Displaced People,4868,6954,2086,3477,17385,5247,5256,10077,10078,30658
53,Ethiopia,2019,ETH-19/DDA-3379/SA1/P/UN/13228,4/1/2020 7:21:46 PM,Overall,42356,74116,21139,39470,177081,37263,46510,51474,45870,181117
53,Ethiopia,2019,ETH-19/DDA-3379/SA1/P/UN/13228,4/1/2020 7:21:46 PM,Returnees,37488,67162,19053,35993,159696,32016,41254,41397,35792,150459
53,Ethiopia,2019,ETH-19/DDA-3379/SA1/P/UN/13230,4/20/2020 8:56:30 AM,Internally Displaced People,8500,9500,20000,24000,62000,9700,10200,20000,26000,65900
53,Ethiopia,2019,ETH-19/DDA-3379/SA1/P/UN/13230,4/20/2020 8:56:30 AM,Overall,8500,9500,20000,24000,62000,9700,10200,20000,26000,65900
53,Ethiopia,2019,ETH-19/DDA-3379/SA1/P-NFI/ES/UN/13093,5/14/2020 7:21:32 AM,Internally Displaced People,25464,26506,0,0,51970,15912,17602,0,0,33514
53,Ethiopia,2019,ETH-19/DDA-3379/SA1/P-NFI/ES/UN/13093,5/14/2020 7:21:32 AM,Overall,50512,52578,0,0,103090,28703,32047,0,0,60750
53,Ethiopia,2019,ETH-19/DDA-3379/SA1/P-NFI/ES/UN/13093,5/14/2020 7:21:32 AM,Returnees,25048,26072,0,0,51120,12791,14445,0,0,27236
53,Ethiopia,2019,ETH-19/DDA-3379/SA1/WASH/INGO/12962,5/6/2020 1:27:24 PM,Host Communities,8516,20864,0,0,29380,12401,13577,0,0,25978
53,Ethiopia,2019,ETH-19/DDA-3379/SA1/WASH/INGO/12962,5/6/2020 1:27:24 PM,Internally Displaced People,14667,12129,0,0,26796,14667,12719,0,0,27386
53,Ethiopia,2019,ETH-19/DDA-3379/SA1/WASH/INGO/12962,5/6/2020 1:27:24 PM,Overall,23183,32993,0,0,56176,27068,26296,0,0,53364
53,Ethiopia,2019,ETH-19/DDA-3379/SA1/WASH/INGO/12972,5/6/2020 12:48:21 PM,Host Communities,2578,2720,5589,7593,18480,2578,2720,5589,7593,18480
53,Ethiopia,2019,ETH-19/DDA-3379/SA1/WASH/INGO/12972,5/6/2020 12:48:21 PM,Internally Displaced People,4467,4407,9056,11790,29720,4467,4407,9056,11440,29370
53,Ethiopia,2019,ETH-19/DDA-3379/SA1/WASH/INGO/12972,5/6/2020 12:48:21 PM,Overall,7045,7127,14645,19383,48200,7045,7127,14645,19033,47850
53,Ethiopia,2019,ETH-19/DDA-3379/SA1/WASH/INGO/13032,5/4/2020 8:25:16 AM,Host Communities,821,990,1313,1403,4527,821,990,1313,1403,4527
53,Ethiopia,2019,ETH-19/DDA-3379/SA1/WASH/INGO/13032,5/4/2020 8:25:16 AM,Internally Displaced People,1899,2290,3037,3247,10473,1899,2290,3037,3247,10473
53,Ethiopia,2019,ETH-19/DDA-3379/SA1/WASH/INGO/13032,5/4/2020 8:25:16 AM,Overall,2720,3280,4350,4650,15000,2720,3280,4350,4650,15000
53,Ethiopia,2019,ETH-19/DDA-3379/SA1/WASH/INGO/13044,4/3/2020 11:34:56 AM,Host Communities,2940,3060,0,0,6000,9167,9298,799,644,19908
53,Ethiopia,2019,ETH-19/DDA-3379/SA1/WASH/INGO/13044,4/3/2020 11:34:56 AM,Internally Displaced People,6300,8700,231,319,15550,6108,6166,289,298,12861
53,Ethiopia,2019,ETH-19/DDA-3379/SA1/WASH/INGO/13044,4/3/2020 11:34:56 AM,Overall,9240,11760,231,319,21550,15275,15464,1088,942,32769
53,Ethiopia,2019,ETH-19/DDA-3379/SA1/WASH/INGO/13055,5/21/2020 12:00:28 PM,Internally Displaced People,5428,6313,9668,10554,31963,12462,13226,9986,9801,45475
53,Ethiopia,2019,ETH-19/DDA-3379/SA1/WASH/INGO/13055,5/21/2020 12:00:28 PM,Overall,5428,6313,9668,10554,31963,12462,13226,9986,9801,45475
53,Ethiopia,2019,ETH-19/DDA-3379/SA1/WASH/INGO/13056,9/3/2020 6:10:34 PM,Internally Displaced People,6856,10838,8015,8571,34280,5912,6503,8277,8868,29560
53,Ethiopia,2019,ETH-19/DDA-3379/SA1/WASH/INGO/13056,9/3/2020 6:10:34 PM,Overall,6856,10838,8015,8571,34280,5912,6503,8277,8868,29560
53,Ethiopia,2019,ETH-19/DDA-3379/SA1/WASH/INGO/13062,12/8/2020 7:24:27 PM,Host Communities,811,845,1217,1267,4140,2529,2681,4388,4681,14279
53,Ethiopia,2019,ETH-19/DDA-3379/SA1/WASH/INGO/13062,12/8/2020 7:24:27 PM,Internally Displaced People,4285,4459,6427,6689,21860,4578,3812,4056,8590,21036
53,Ethiopia,2019,ETH-19/DDA-3379/SA1/WASH/INGO/13062,12/8/2020 7:24:27 PM,Overall,5096,5304,7644,7956,26000,7107,6493,8444,13271,35315
53,Ethiopia,2019,ETH-19/DDA-3379/SA1/WASH/INGO/13068,7/23/2020 6:49:28 AM,Internally Displaced People,17033,16365,4258,4091,41747,17580,18400,4796,4824,45600
53,Ethiopia,2019,ETH-19/DDA-3379/SA1/WASH/INGO/13068,7/23/2020 6:49:28 AM,Overall,17033,16365,4258,4091,41747,17580,18400,4796,4824,45600
53,Ethiopia,2019,ETH-19/DDA-3379/SA1/WASH/INGO/13072,9/14/2020 1:33:09 PM,Host Communities,13041,11828,11154,9759,45782,16671,17100,10927,11044,55742
53,Ethiopia,2019,ETH-19/DDA-3379/SA1/WASH/INGO/13072,9/14/2020 1:33:09 PM,Internally Displaced People,1667,1704,1035,1021,5427,2490,2554,1632,1650,8326
53,Ethiopia,2019,ETH-19/DDA-3379/SA1/WASH/INGO/13072,9/14/2020 1:33:09 PM,Overall,14708,13532,12189,10780,51209,19161,19654,12559,12694,64068
53,Ethiopia,2019,ETH-19/DDA-3379/SA1/WASH/INGO/13074,9/4/2020 3:18:38 PM,Internally Displaced People,26708,22364,16685,13056,78813,26371,21692,17237,13577,78877
53,Ethiopia,2019,ETH-19/DDA-3379/SA1/WASH/INGO/13074,9/4/2020 3:18:38 PM,Overall,26708,22364,16685,13056,78813,26371,21692,17237,13577,78877
53,Ethiopia,2019,ETH-19/DDA-3379/SA1/WASH/INGO/13083,5/14/2020 8:50:54 AM,Host Communities,5546,5771,2714,2616,16647,4573,2816,4597,2573,14559
53,Ethiopia,2019,ETH-19/DDA-3379/SA1/WASH/INGO/13083,5/14/2020 8:50:54 AM,Internally Displaced People,16270,16934,6973,7258,47435,8424,8953,6364,3495,27236
53,Ethiopia,2019,ETH-19/DDA-3379/SA1/WASH/INGO/13083,5/14/2020 8:50:54 AM,Overall,21816,22705,9687,9874,64082,12997,11769,10961,6068,41795
53,Ethiopia,2019,ETH-19/DDA-3379/SA1/WASH/INGO/13087,4/4/2020 2:41:58 PM,Internally Displaced People,4274,6706,7201,7849,26030,6591,10341,11104,12104,40140
53,Ethiopia,2019,ETH-19/DDA-3379/SA1/WASH/INGO/13087,4/4/2020 2:41:58 PM,Overall,4274,6706,7201,7849,26030,6591,10341,11104,12104,40140
53,Ethiopia,2019,ETH-19/DDA-3379/SA1/WASH/INGO/13102,7/23/2020 8:32:03 AM,Host Communities,475,500,750,775,2500,233,1549,569,723,3074
53,Ethiopia,2019,ETH-19/DDA-3379/SA1/WASH/INGO/13102,7/23/2020 8:32:03 AM,Internally Displaced People,18850,20669,31151,38653,109323,14741,75221,8941,9846,108749
53,Ethiopia,2019,ETH-19/DDA-3379/SA1/WASH/INGO/13102,7/23/2020 8:32:03 AM,Overall,19325,21169,31901,39428,111823,14974,76770,9510,10569,111823
53,Ethiopia,2019,ETH-19/DDA-3379/SA1/WASH/INGO/13103,7/23/2020 5:10:00 PM,Host Communities,22510,22014,3926,3926,52376,9389,18489,8461,16661,53000
53,Ethiopia,2019,ETH-19/DDA-3379/SA1/WASH/INGO/13103,7/23/2020 5:10:00 PM,Internally Displaced People,22510,22013,3926,3926,52375,9389,18488,8461,16661,52999
53,Ethiopia,2019,ETH-19/DDA-3379/SA1/WASH/INGO/13103,7/23/2020 5:10:00 PM,Overall,45020,44027,7852,7852,104751,18778,36977,16922,33322,105999
53,Ethiopia,2019,ETH-19/DDA-3379/SA1/WASH/INGO/13105,4/4/2020 8:09:05 AM,Host Communities,4083,4231,264,168,8746,3587,4505,1034,1011,10137
53,Ethiopia,2019,ETH-19/DDA-3379/SA1/WASH/INGO/13105,4/4/2020 8:09:05 AM,Internally Displaced People,3872,3326,264,168,7630,3868,3321,232,157,7578
53,Ethiopia,2019,ETH-19/DDA-3379/SA1/WASH/INGO/13105,4/4/2020 8:09:05 AM,Overall,7955,7557,528,336,16376,7455,7826,1266,1168,17715
53,Ethiopia,2019,ETH-19/DDA-3379/SA1/WASH/UN/13054,1/11/2021 11:00:39 AM,Host Communities,14146,14863,20520,21219,70748,49348,50329,56799,59075,215551
53,Ethiopia,2019,ETH-19/DDA-3379/SA1/WASH/UN/13054,1/11/2021 11:00:39 AM,Internally Displaced People,33019,34676,47488,49539,164722,15099,19364,20671,24880,80014
53,Ethiopia,2019,ETH-19/DDA-3379/SA1/WASH/UN/13054,1/11/2021 11:00:39 AM,Overall,47165,49539,68008,70758,235470,64447,69693,77470,83955,295565
53,Ethiopia,2019,ETH-19/DDA-3379/SA2/A/INGO/14662,3/27/2021 5:53:28 AM,Host Communities,55081,25180,18360,6295,104916,72068,32945,24023,8238,137274
53,Ethiopia,2019,ETH-19/DDA-3379/SA2/A/INGO/14662,3/27/2021 5:53:28 AM,Internally Displaced People,900,1050,600,450,3000,1275,900,480,345,3000
53,Ethiopia,2019,ETH-19/DDA-3379/SA2/A/INGO/14662,3/27/2021 5:53:28 AM,Overall,55981,26230,18960,6745,107916,73343,33845,24503,8583,140274
53,Ethiopia,2019,ETH-19/DDA-3379/SA2/A/INGO/14671,2/25/2021 8:29:10 PM,Host Communities,1410,1544,2770,2276,8000,3091,285,6171,7335,16882
53,Ethiopia,2019,ETH-19/DDA-3379/SA2/A/INGO/14671,2/25/2021 8:29:10 PM,Overall,8253,8937,11376,11434,40000,7245,755,14521,17479,40000
53,Ethiopia,2019,ETH-19/DDA-3379/SA2/A/INGO/14671,2/25/2021 8:29:10 PM,Returnees,6843,7393,8606,9158,32000,4154,470,8350,10144,23118
53,Ethiopia,2019,ETH-19/DDA-3379/SA2/A/INGO/14745,11/10/2020 6:37:02 AM,Host Communities,418,462,638,682,2200,1980,1161,6915,6718,16774
53,Ethiopia,2019,ETH-19/DDA-3379/SA2/A/INGO/14745,11/10/2020 6:37:02 AM,Overall,2090,2310,3190,3410,11000,2529,1391,7553,7308,18781
53,Ethiopia,2019,ETH-19/DDA-3379/SA2/A/INGO/14745,11/10/2020 6:37:02 AM,Returnees,1672,1848,2552,2728,8800,549,230,638,590,2007
53,Ethiopia,2019,ETH-19/DDA-3379/SA2/A/INGO/14786,12/5/2020 4:40:36 PM,Host Communities,198,198,0,0,396,273,381,0,0,654
53,Ethiopia,2019,ETH-19/DDA-3379/SA2/A/INGO/14786,12/5/2020 4:40:36 PM,Internally Displaced People,11443,11941,15242,15749,54375,6655,5359,0,0,12014
53,Ethiopia,2019,ETH-19/DDA-3379/SA2/A/INGO/14786,12/5/2020 4:40:36 PM,Overall,12121,12613,15242,15749,55725,10139,8832,0,0,18971
53,Ethiopia,2019,ETH-19/DDA-3379/SA2/A/INGO/14786,12/5/2020 4:40:36 PM,Returnees,480,474,0,0,954,3211,3092,0,0,6303
53,Ethiopia,2019,ETH-19/DDA-3379/SA2/A/NGO/14664,2/25/2021 8:59:38 PM,Overall,4600,2900,0,0,7500,5624,1876,0,0,7500
53,Ethiopia,2019,ETH-19/DDA-3379/SA2/A/NGO/14664,2/25/2021 8:59:38 PM,Returnees,4600,2900,0,0,7500,5624,1876,0,0,7500
53,Ethiopia,2019,ETH-19/DDA-3379/SA2/E/INGO/14656,2/25/2021 8:15:13 PM,Internally Displaced People,414,596,3400,3012,7422,490,721,4491,3105,8807
53,Ethiopia,2019,ETH-19/DDA-3379/SA2/E/INGO/14656,2/25/2021 8:15:13 PM,Overall,1381,1989,11333,10045,24748,1457,2114,14970,10346,28887
53,Ethiopia,2019,ETH-19/DDA-3379/SA2/E/INGO/14656,2/25/2021 8:15:13 PM,Returnees,967,1393,7933,7033,17326,967,1393,10479,7241,20080
53,Ethiopia,2019,ETH-19/DDA-3379/SA2/E/INGO/14673,3/15/2021 10:57:35 PM,Internally Displaced People,50,50,4160,4160,8420,50,50,4160,4160,8420
53,Ethiopia,2019,ETH-19/DDA-3379/SA2/E/INGO/14673,3/15/2021 10:57:35 PM,Overall,50,50,4160,4160,8420,50,50,4160,4160,8420
53,Ethiopia,2019,ETH-19/DDA-3379/SA2/E/INGO/14696,5/18/2021 10:21:15 AM,Internally Displaced People,793,312,9678,6966,17749,0,0,10741,5903,16644
53,Ethiopia,2019,ETH-19/DDA-3379/SA2/E/INGO/14696,5/18/2021 10:21:15 AM,Overall,793,312,9678,6966,17749,0,0,10741,5903,16644
53,Ethiopia,2019,ETH-19/DDA-3379/SA2/E/INGO/14702,2/25/2021 8:23:44 PM,Internally Displaced People,134,201,636,424,1395,136,204,636,424,1400
53,Ethiopia,2019,ETH-19/DDA-3379/SA2/E/INGO/14702,2/25/2021 8:23:44 PM,Overall,447,671,2120,1412,4650,452,678,2120,1412,4662
53,Ethiopia,2019,ETH-19/DDA-3379/SA2/E/INGO/14702,2/25/2021 8:23:44 PM,Returnees,313,470,1484,988,3255,316,474,1484,988,3262
53,Ethiopia,2019,ETH-19/DDA-3379/SA2/E/INGO/14766,5/4/2021 6:58:09 PM,Internally Displaced People,0,0,2401,1969,4370,0,0,2673,1697,4370
53,Ethiopia,2019,ETH-19/DDA-3379/SA2/E/INGO/14766,5/4/2021 6:58:09 PM,Overall,0,0,2401,1969,4370,0,0,2673,1697,4370
53,Ethiopia,2019,ETH-19/DDA-3379/SA2/H/INGO/14555,8/21/2020 8:56:07 AM,Overall,37721,30800,6657,5435,80613,11087,11733,35139,40393,98352
53,Ethiopia,2019,ETH-19/DDA-3379/SA2/H/INGO/14555,8/21/2020 8:56:07 AM,Returnees,37721,30800,6657,5435,80613,11087,11733,35139,40393,98352
53,Ethiopia,2019,ETH-19/DDA-3379/SA2/H/NGO/14729,8/18/2020 9:53:48 AM,Host Communities,16384,23030,3905,3844,47163,12922,24957,7139,6672,51690
53,Ethiopia,2019,ETH-19/DDA-3379/SA2/H/NGO/14729,8/18/2020 9:53:48 AM,Overall,33655,47306,8021,7896,96878,27721,57042,17314,17148,119225
53,Ethiopia,2019,ETH-19/DDA-3379/SA2/H/NGO/14729,8/18/2020 9:53:48 AM,Returnees,17271,24276,4116,4052,49715,14799,32085,10175,10476,67535
53,Ethiopia,2019,ETH-19/DDA-3379/SA2/H/UN/14578,4/2/2021 8:25:57 AM,Host Communities,8885,9248,2962,3082,24177,8717,9202,2897,3058,23874
53,Ethiopia,2019,ETH-19/DDA-3379/SA2/H/UN/14578,4/2/2021 8:25:57 AM,Overall,44425,46238,14808,15412,120883,44093,46078,14475,15375,120021
53,Ethiopia,2019,ETH-19/DDA-3379/SA2/H/UN/14578,4/2/2021 8:25:57 AM,Returnees,35540,36990,11846,12330,96706,35376,36876,11578,12317,96147
53,Ethiopia,2019,ETH-19/DDA-3379/SA2/H/UN/14739,2/17/2021 11:59:39 AM,Host Communities,84670,88130,91730,95470,360000,120738,125670,130794,143200,520402
53,Ethiopia,2019,ETH-19/DDA-3379/SA2/H/UN/14739,2/17/2021 11:59:39 AM,Internally Displaced People,18816,19584,20384,21216,80000,25778,26830,27926,29066,109600
53,Ethiopia,2019,ETH-19/DDA-3379/SA2/H/UN/14739,2/17/2021 11:59:39 AM,Overall,188156,195844,203844,212156,800000,267254,278170,289514,315466,1150404
53,Ethiopia,2019,ETH-19/DDA-3379/SA2/H/UN/14739,2/17/2021 11:59:39 AM,Returnees,84670,88130,91730,95470,360000,120738,125670,130794,143200,520402
53,Ethiopia,2019,ETH-19/DDA-3379/SA2/H/UN/14775,12/6/2020 9:03:38 PM,Host Communities,0,0,0,0,0,3706,3959,2632,2774,13071
53,Ethiopia,2019,ETH-19/DDA-3379/SA2/H/UN/14775,12/6/2020 9:03:38 PM,Internally Displaced People,9114,15190,15190,21266,60760,15352,30217,8152,9526,63247
53,Ethiopia,2019,ETH-19/DDA-3379/SA2/H/UN/14775,12/6/2020 9:03:38 PM,Overall,9114,15190,15190,21266,60760,19058,34176,10784,12300,76318
53,Ethiopia,2019,ETH-19/DDA-3379/SA2/H/UN/14801,3/22/2021 8:07:14 AM,Host Communities,45070,38442,68250,50517,202279,44691,42655,70840,71286,229472
53,Ethiopia,2019,ETH-19/DDA-3379/SA2/H/UN/14801,3/22/2021 8:07:14 AM,Internally Displaced People,51378,53985,82284,95399,283046,57169,56420,80286,104044,297919
53,Ethiopia,2019,ETH-19/DDA-3379/SA2/H/UN/14801,3/22/2021 8:07:14 AM,Overall,96448,92427,150534,145916,485325,101860,99075,151126,175330,527391
53,Ethiopia,2019,ETH-19/DDA-3379/SA2/N/INGO/14667,12/5/2020 6:00:41 PM,Host Communities,0,5374,3361,3498,12233,0,6863,3748,3942,14553
53,Ethiopia,2019,ETH-19/DDA-3379/SA2/N/INGO/14667,12/5/2020 6:00:41 PM,Internally Displaced People,0,1343,840,875,3058,0,1203,640,793,2636
53,Ethiopia,2019,ETH-19/DDA-3379/SA2/N/INGO/14667,12/5/2020 6:00:41 PM,Overall,0,6717,4201,4373,15291,0,8066,4388,4735,17189
53,Ethiopia,2019,ETH-19/DDA-3379/SA2/N/INGO/14674,2/25/2021 8:27:41 PM,Host Communities,0,6428,1516,1522,9466,55,8044,4702,4893,17694
53,Ethiopia,2019,ETH-19/DDA-3379/SA2/N/INGO/14674,2/25/2021 8:27:41 PM,Internally Displaced People,0,43,30,38,111,0,1045,1760,1876,4681
53,Ethiopia,2019,ETH-19/DDA-3379/SA2/N/INGO/14674,2/25/2021 8:27:41 PM,Other,158,579,802,772,2311,0,0,0,0,0
53,Ethiopia,2019,ETH-19/DDA-3379/SA2/N/INGO/14674,2/25/2021 8:27:41 PM,Overall,158,7050,2348,2332,11888,55,9089,6462,6769,22375
53,Ethiopia,2019,ETH-19/DDA-3379/SA2/N/INGO/14747,1/8/2021 11:44:21 AM,Host Communities,1290,6452,10353,10775,28870,444,8476,10074,10008,29002
53,Ethiopia,2019,ETH-19/DDA-3379/SA2/N/INGO/14747,1/8/2021 11:44:21 AM,Overall,1290,6452,10353,10775,28870,444,8476,10074,10008,29002
53,Ethiopia,2019,ETH-19/DDA-3379/SA2/N/INGO/14752,9/28/2020 4:48:14 PM,Host Communities,0,15204,4083,4229,23516,2483,14107,5259,5912,27761
53,Ethiopia,2019,ETH-19/DDA-3379/SA2/N/INGO/14752,9/28/2020 4:48:14 PM,Overall,0,15204,4083,4229,23516,2483,14107,5259,5912,27761
53,Ethiopia,2019,ETH-19/DDA-3379/SA2/N/INGO/14759,2/25/2021 8:13:04 PM,Host Communities,0,2740,2491,2593,7824,210,10901,3992,5091,20194
53,Ethiopia,2019,ETH-19/DDA-3379/SA2/N/INGO/14759,2/25/2021 8:13:04 PM,Overall,0,2740,2491,2593,7824,210,10901,3992,5091,20194
53,Ethiopia,2019,ETH-19/DDA-3379/SA2/N/INGO/14792,1/8/2021 11:23:27 AM,Host Communities,8,12507,8583,12158,33256,839,15544,7317,8608,32308
53,Ethiopia,2019,ETH-19/DDA-3379/SA2/N/INGO/14792,1/8/2021 11:23:27 AM,Overall,8,12507,8583,12158,33256,839,15544,7317,8608,32308
53,Ethiopia,2019,ETH-19/DDA-3379/SA2/N/NGO/14666,9/14/2020 1:42:38 PM,Host Communities,0,7427,4714,4889,17030,0,7875,4626,5249,17750
53,Ethiopia,2019,ETH-19/DDA-3379/SA2/N/NGO/14666,9/14/2020 1:42:38 PM,Overall,0,10463,9223,9441,29127,0,11166,7454,8751,27371
53,Ethiopia,2019,ETH-19/DDA-3379/SA2/N/NGO/14666,9/14/2020 1:42:38 PM,Returnees,0,3036,4509,4552,12097,0,3291,2828,3502,9621
53,Ethiopia,2019,ETH-19/DDA-3379/SA2/N/UN/14742,9/21/2020 1:51:22 PM,Host Communities,0,0,490,410,900,0,0,520,433,953
53,Ethiopia,2019,ETH-19/DDA-3379/SA2/N/UN/14742,9/21/2020 1:51:22 PM,Overall,0,0,490,410,900,0,0,520,433,953
53,Ethiopia,2019,ETH-19/DDA-3379/SA2/N/UN/14758,9/21/2020 2:03:06 PM,Host Communities,0,0,204,171,375,0,0,187,207,394
53,Ethiopia,2019,ETH-19/DDA-3379/SA2/N/UN/14758,9/21/2020 2:03:06 PM,Internally Displaced People,0,0,477,398,875,0,0,450,420,870
53,Ethiopia,2019,ETH-19/DDA-3379/SA2/N/UN/14758,9/21/2020 2:03:06 PM,Overall,0,0,681,569,1250,0,0,637,627,1264
53,Ethiopia,2019,ETH-19/DDA-3379/SA2/NFI/ES/INGO/14587,3/5/2021 5:51:01 AM,Host Communities,102,109,236,256,703,0,0,0,0,0
53,Ethiopia,2019,ETH-19/DDA-3379/SA2/NFI/ES/INGO/14587,3/5/2021 5:51:01 AM,Overall,1033,1078,2364,2560,7035,983,819,1174,836,3812
53,Ethiopia,2019,ETH-19/DDA-3379/SA2/NFI/ES/INGO/14587,3/5/2021 5:51:01 AM,Returnees,931,969,2128,2304,6332,983,819,1174,836,3812
53,Ethiopia,2019,ETH-19/DDA-3379/SA2/NFI/ES/INGO/14623,12/8/2020 6:56:59 PM,Internally Displaced People,1414,1570,878,906,4768,1370,1645,883,870,4768
53,Ethiopia,2019,ETH-19/DDA-3379/SA2/NFI/ES/INGO/14623,12/8/2020 6:56:59 PM,Overall,1414,1570,878,906,4768,1370,1645,883,870,4768
53,Ethiopia,2019,ETH-19/DDA-3379/SA2/NFI/ES/INGO/14691,2/10/2021 12:46:59 PM,Overall,946,947,1157,1157,4207,1043,1027,1276,1255,4601
53,Ethiopia,2019,ETH-19/DDA-3379/SA2/NFI/ES/INGO/14691,2/10/2021 12:46:59 PM,Returnees,946,947,1157,1157,4207,1043,1027,1276,1255,4601
53,Ethiopia,2019,ETH-19/DDA-3379/SA2/NFI/ES/INGO/14711,2/10/2021 2:59:07 PM,Internally Displaced People,495,495,550,550,2090,1266,1254,318,312,3150
53,Ethiopia,2019,ETH-19/DDA-3379/SA2/NFI/ES/INGO/14711,2/10/2021 2:59:07 PM,Overall,995,995,1150,1150,4290,2106,2238,528,558,5430
53,Ethiopia,2019,ETH-19/DDA-3379/SA2/NFI/ES/INGO/14711,2/10/2021 2:59:07 PM,Returnees,500,500,600,600,2200,840,984,210,246,2280
53,Ethiopia,2019,ETH-19/DDA-3379/SA2/NFI/ES/INGO/14751,1/11/2021 10:32:04 AM,Overall,1200,2080,320,400,4000,1240,1895,385,480,4000
53,Ethiopia,2019,ETH-19/DDA-3379/SA2/NFI/ES/INGO/14751,1/11/2021 10:32:04 AM,Returnees,1200,2080,320,400,4000,1240,1895,385,480,4000
53,Ethiopia,2019,ETH-19/DDA-3379/SA2/NFI/ES/INGO/14777,9/6/2021 9:49:03 AM,Internally Displaced People,800,800,600,600,2800,0,0,0,0,0
53,Ethiopia,2019,ETH-19/DDA-3379/SA2/NFI/ES/INGO/14777,9/6/2021 9:49:03 AM,Overall,1875,1875,1250,1250,6250,1028,1070,1476,1538,5112
53,Ethiopia,2019,ETH-19/DDA-3379/SA2/NFI/ES/INGO/14777,9/6/2021 9:49:03 AM,Returnees,1075,1075,650,650,3450,1028,1070,1476,1538,5112
53,Ethiopia,2019,ETH-19/DDA-3379/SA2/NFI/ES/INGO/14781,2/10/2021 12:18:47 PM,Overall,656,1415,449,932,3452,624,1104,828,896,3452
53,Ethiopia,2019,ETH-19/DDA-3379/SA2/NFI/ES/INGO/14781,2/10/2021 12:18:47 PM,Returnees,656,1415,449,932,3452,624,1104,828,896,3452
53,Ethiopia,2019,ETH-19/DDA-3379/SA2/NFI/ES/UN/14676,2/10/2021 12:42:21 PM,Host Communities,197,216,253,273,939,65,72,84,90,311
53,Ethiopia,2019,ETH-19/DDA-3379/SA2/NFI/ES/UN/14676,2/10/2021 12:42:21 PM,Internally Displaced People,1507,1650,1937,2082,7176,991,1086,1274,1370,4721
53,Ethiopia,2019,ETH-19/DDA-3379/SA2/NFI/ES/UN/14676,2/10/2021 12:42:21 PM,Overall,2816,3085,3620,3892,13413,2297,2517,2953,3175,10942
53,Ethiopia,2019,ETH-19/DDA-3379/SA2/NFI/ES/UN/14676,2/10/2021 12:42:21 PM,Returnees,1112,1219,1430,1537,5298,1241,1359,1595,1715,5910
53,Ethiopia,2019,ETH-19/DDA-3379/SA2/NFI/ES-WASH/UN/14784,2/14/2021 4:32:34 AM,Host Communities,1317,1442,1693,1818,6270,1317,1442,1693,1818,6270
53,Ethiopia,2019,ETH-19/DDA-3379/SA2/NFI/ES-WASH/UN/14784,2/14/2021 4:32:34 AM,Internally Displaced People,3573,3914,4594,4934,17015,3846,4212,4945,5312,18315
53,Ethiopia,2019,ETH-19/DDA-3379/SA2/NFI/ES-WASH/UN/14784,2/14/2021 4:32:34 AM,Overall,8778,9614,11286,12122,41800,12894,14121,16578,17805,61398
53,Ethiopia,2019,ETH-19/DDA-3379/SA2/NFI/ES-WASH/UN/14784,2/14/2021 4:32:34 AM,Returnees,3888,4258,4999,5370,18515,7731,8467,9940,10675,36813
53,Ethiopia,2019,ETH-19/DDA-3379/SA2/NFI/ES-WASH-H/INGO/14898,8/21/2021 2:19:30 PM,Internally Displaced People,145376,618768,204849,171807,1140800,414743,639485,547084,498808,2100120
53,Ethiopia,2019,ETH-19/DDA-3379/SA2/NFI/ES-WASH-H/INGO/14898,8/21/2021 2:19:30 PM,Overall,145376,618768,204849,171807,1140800,414743,639485,547084,498808,2100120
53,Ethiopia,2019,ETH-19/DDA-3379/SA2/N-H/INGO/14547,11/10/2020 6:29:14 AM,Host Communities,871,9980,3542,3344,17737,1589,11959,5228,6106,24882
53,Ethiopia,2019,ETH-19/DDA-3379/SA2/N-H/INGO/14547,11/10/2020 6:29:14 AM,Internally Displaced People,675,5200,1675,1871,9421,1060,7459,4678,5928,19125
53,Ethiopia,2019,ETH-19/DDA-3379/SA2/N-H/INGO/14547,11/10/2020 6:29:14 AM,Overall,1546,15180,5217,5215,27158,2649,19418,9906,12034,44007
53,Ethiopia,2019,ETH-19/DDA-3379/SA2/N-H/INGO/14648,3/6/2021 10:08:19 PM,Host Communities,10237,54855,8154,8660,81906,50918,129845,7785,9240,197788
53,Ethiopia,2019,ETH-19/DDA-3379/SA2/N-H/INGO/14648,3/6/2021 10:08:19 PM,Internally Displaced People,5710,9950,11132,11097,37889,1823,2741,857,847,6268
53,Ethiopia,2019,ETH-19/DDA-3379/SA2/N-H/INGO/14648,3/6/2021 10:08:19 PM,Overall,15947,64805,19286,19757,119795,52741,132586,8642,10087,204056
53,Ethiopia,2019,ETH-19/DDA-3379/SA2/N-H/INGO/14782,12/6/2020 5:13:48 PM,Host Communities,2967,25124,15438,13654,57183,2372,25371,20481,19246,67470
53,Ethiopia,2019,ETH-19/DDA-3379/SA2/N-H/INGO/14782,12/6/2020 5:13:48 PM,Internally Displaced People,9299,48753,27051,25012,110115,5679,55018,27454,28068,116219
53,Ethiopia,2019,ETH-19/DDA-3379/SA2/N-H/INGO/14782,12/6/2020 5:13:48 PM,Overall,12266,73877,42489,38666,167298,8051,80389,47935,47314,183689
53,Ethiopia,2019,ETH-19/DDA-3379/SA2/N-H-WASH-P-NFI/ES/INGO/14603,12/8/2020 8:51:45 PM,Host Communities,16010,68910,18666,19217,122803,22592,55053,16600,21228,115473
53,Ethiopia,2019,ETH-19/DDA-3379/SA2/N-H-WASH-P-NFI/ES/INGO/14603,12/8/2020 8:51:45 PM,Internally Displaced People,20938,35974,15250,16186,88348,33288,55482,15848,19210,123828
53,Ethiopia,2019,ETH-19/DDA-3379/SA2/N-H-WASH-P-NFI/ES/INGO/14603,12/8/2020 8:51:45 PM,Overall,36948,104884,33916,35403,211151,55880,110535,32448,40438,239301
53,Ethiopia,2019,ETH-19/DDA-3379/SA2/P/INGO/14643,12/4/2020 6:34:45 PM,Host Communities,4994,7938,607,583,14122,4550,14129,691,1539,20909
53,Ethiopia,2019,ETH-19/DDA-3379/SA2/P/INGO/14643,12/4/2020 6:34:45 PM,Internally Displaced People,2996,4763,364,350,8473,3008,9384,503,1945,14840
53,Ethiopia,2019,ETH-19/DDA-3379/SA2/P/INGO/14643,12/4/2020 6:34:45 PM,Overall,9987,15876,1214,1166,28243,9791,29264,1557,4796,45408
53,Ethiopia,2019,ETH-19/DDA-3379/SA2/P/INGO/14643,12/4/2020 6:34:45 PM,Returnees,1997,3175,243,233,5648,2233,5751,363,1312,9659
53,Ethiopia,2019,ETH-19/DDA-3379/SA2/P/INGO/14679,2/25/2021 8:32:00 PM,Host Communities,1500,3000,4600,4500,13600,1395,2685,3767,3853,11700
53,Ethiopia,2019,ETH-19/DDA-3379/SA2/P/INGO/14679,2/25/2021 8:32:00 PM,Internally Displaced People,1200,2000,1500,1500,6200,1207,1748,2607,2648,8210
53,Ethiopia,2019,ETH-19/DDA-3379/SA2/P/INGO/14679,2/25/2021 8:32:00 PM,Overall,4200,12500,14400,14400,45500,4726,11973,13714,14574,44987
53,Ethiopia,2019,ETH-19/DDA-3379/SA2/P/INGO/14679,2/25/2021 8:32:00 PM,Returnees,1500,7500,8300,8400,25700,2124,7540,7340,8073,25077
53,Ethiopia,2019,ETH-19/DDA-3379/SA2/P/INGO/14693,12/5/2020 5:17:42 PM,Host Communities,122,150,39,84,395,161,288,58,133,640
53,Ethiopia,2019,ETH-19/DDA-3379/SA2/P/INGO/14693,12/5/2020 5:17:42 PM,Internally Displaced People,386,474,125,266,1251,364,734,193,385,1676
53,Ethiopia,2019,ETH-19/DDA-3379/SA2/P/INGO/14693,12/5/2020 5:17:42 PM,Overall,508,624,164,350,1646,525,1022,251,518,2316
53,Ethiopia,2019,ETH-19/DDA-3379/SA2/P/INGO/14695,5/19/2021 11:20:01 AM,Overall,1250,1550,1750,1750,6300,1238,1522,1627,1654,6041
53,Ethiopia,2019,ETH-19/DDA-3379/SA2/P/INGO/14695,5/19/2021 11:20:01 AM,Returnees,1250,1550,1750,1750,6300,1238,1522,1627,1654,6041
53,Ethiopia,2019,ETH-19/DDA-3379/SA2/P/INGO/14698,4/2/2021 3:01:48 AM,Host Communities,166,244,90,192,692,2192,2168,79,274,4713
53,Ethiopia,2019,ETH-19/DDA-3379/SA2/P/INGO/14698,4/2/2021 3:01:48 AM,Internally Displaced People,666,977,359,768,2770,2007,2161,195,330,4693
53,Ethiopia,2019,ETH-19/DDA-3379/SA2/P/INGO/14698,4/2/2021 3:01:48 AM,Overall,832,1221,449,960,3462,4199,4329,274,604,9406
53,Ethiopia,2019,ETH-19/DDA-3379/SA2/P/INGO/14773,9/26/2020 2:45:37 PM,Host Communities,187,187,641,649,1664,345,345,744,849,2283
53,Ethiopia,2019,ETH-19/DDA-3379/SA2/P/INGO/14773,9/26/2020 2:45:37 PM,Internally Displaced People,1057,1058,3631,3679,9425,1395,1370,2894,3147,8806
53,Ethiopia,2019,ETH-19/DDA-3379/SA2/P/INGO/14773,9/26/2020 2:45:37 PM,Overall,1244,1245,4272,4328,11089,1740,1715,3638,3996,11089
53,Ethiopia,2019,ETH-19/DDA-3379/SA2/P/INGO/14780,12/8/2020 8:33:43 PM,Host Communities,319,1136,75,585,2115,268,1096,39,564,1967
53,Ethiopia,2019,ETH-19/DDA-3379/SA2/P/INGO/14780,12/8/2020 8:33:43 PM,Internally Displaced People,106,379,25,195,705,407,1588,77,771,2843
53,Ethiopia,2019,ETH-19/DDA-3379/SA2/P/INGO/14780,12/8/2020 8:33:43 PM,Overall,425,1515,100,780,2820,675,2684,116,1335,4810
53,Ethiopia,2019,ETH-19/DDA-3379/SA2/P/UN/14655,3/15/2021 12:22:07 PM,Internally Displaced People,1250,6500,950,3250,11950,1823,7893,1157,3661,14534
53,Ethiopia,2019,ETH-19/DDA-3379/SA2/P/UN/14655,3/15/2021 12:22:07 PM,Overall,3750,16260,2400,7750,30160,4477,17743,2304,8202,32726
53,Ethiopia,2019,ETH-19/DDA-3379/SA2/P/UN/14655,3/15/2021 12:22:07 PM,Returnees,2500,9760,1450,4500,18210,2654,9850,1147,4541,18192
53,Ethiopia,2019,ETH-19/DDA-3379/SA2/P/UN/14687,5/25/2021 1:02:54 PM,Internally Displaced People,50842,50147,0,0,100989,21402,20999,0,0,42401
53,Ethiopia,2019,ETH-19/DDA-3379/SA2/P/UN/14687,5/25/2021 1:02:54 PM,Overall,177561,165341,0,0,342902,46494,47943,0,0,94437
53,Ethiopia,2019,ETH-19/DDA-3379/SA2/P/UN/14687,5/25/2021 1:02:54 PM,Returnees,126719,115194,0,0,241913,25092,26944,0,0,52036
53,Ethiopia,2019,ETH-19/DDA-3379/SA2/P/UN/14757,10/25/2021 1:38:59 PM,Host Communities,500,500,200,200,1400,521,490,189,196,1396
53,Ethiopia,2019,ETH-19/DDA-3379/SA2/P/UN/14757,10/25/2021 1:38:59 PM,Internally Displaced People,2000,2000,500,500,5000,2145,2080,481,533,5239
53,Ethiopia,2019,ETH-19/DDA-3379/SA2/P/UN/14757,10/25/2021 1:38:59 PM,Other,200,130,50,50,430,193,149,49,43,434
53,Ethiopia,2019,ETH-19/DDA-3379/SA2/P/UN/14757,10/25/2021 1:38:59 PM,Overall,8700,8630,1750,1750,20830,8401,8089,1591,1599,19680
53,Ethiopia,2019,ETH-19/DDA-3379/SA2/P/UN/14757,10/25/2021 1:38:59 PM,Returnees,6000,6000,1000,1000,14000,5542,5370,872,827,12611
53,Ethiopia,2019,ETH-19/DDA-3379/SA2/P/UN/14783,3/16/2021 1:01:15 PM,Host Communities,330,363,425,457,1575,1937,1919,2685,2674,9215
53,Ethiopia,2019,ETH-19/DDA-3379/SA2/P/UN/14783,3/16/2021 1:01:15 PM,Internally Displaced People,4600,5038,5915,6353,21906,11205,10759,8420,8966,39350
53,Ethiopia,2019,ETH-19/DDA-3379/SA2/P/UN/14783,3/16/2021 1:01:15 PM,Overall,8236,9022,10590,11376,39224,18578,18111,18522,19094,74305
53,Ethiopia,2019,ETH-19/DDA-3379/SA2/P/UN/14783,3/16/2021 1:01:15 PM,Returnees,3306,3621,4250,4566,15743,5436,5433,7417,7454,25740
53,Ethiopia,2019,ETH-19/DDA-3379/SA2/WASH/INGO/14678,2/25/2021 9:03:48 PM,Host Communities,14321,17525,3564,4356,39766,15291,18910,4226,4761,43188
53,Ethiopia,2019,ETH-19/DDA-3379/SA2/WASH/INGO/14678,2/25/2021 9:03:48 PM,Internally Displaced People,14554,17802,3609,4411,40376,17242,21324,4766,5370,48702
53,Ethiopia,2019,ETH-19/DDA-3379/SA2/WASH/INGO/14678,2/25/2021 9:03:48 PM,Overall,28875,35327,7173,8767,80142,32533,40234,8992,10131,91890
53,Ethiopia,2019,ETH-19/DDA-3379/SA2/WASH/INGO/14743,12/6/2020 5:28:52 PM,Host Communities,3822,4004,4914,5460,18200,3453,3618,4440,4932,16443
53,Ethiopia,2019,ETH-19/DDA-3379/SA2/WASH/INGO/14743,12/6/2020 5:28:52 PM,Internally Displaced People,7098,7436,9126,10140,33800,6413,6718,8245,9161,30537
53,Ethiopia,2019,ETH-19/DDA-3379/SA2/WASH/INGO/14743,12/6/2020 5:28:52 PM,Overall,21840,22880,28080,31200,104000,9866,10336,12685,14093,46980
53,Ethiopia,2019,ETH-19/DDA-3379/SA2/WASH/INGO/14785,2/25/2021 8:39:04 PM,Internally Displaced People,2736,3906,4104,7254,18000,4794,5859,3470,4243,18366
53,Ethiopia,2019,ETH-19/DDA-3379/SA2/WASH/INGO/14785,2/25/2021 8:39:04 PM,Overall,2736,3906,4104,7254,18000,4794,5859,3470,4243,18366
53,Ethiopia,2019,ETH-19/DDA-3379/SA2/WASH/UN/14549,9/2/2021 2:34:56 AM,Host Communities,60039,59282,55379,54633,229333,48468,48059,42559,42318,181404
53,Ethiopia,2019,ETH-19/DDA-3379/SA2/WASH/UN/14549,9/2/2021 2:34:56 AM,Internally Displaced People,6767,6694,7015,6968,27444,4331,4306,3797,3769,16203
53,Ethiopia,2019,ETH-19/DDA-3379/SA2/WASH/UN/14549,9/2/2021 2:34:56 AM,Overall,66806,65976,62394,61601,256777,52799,52365,46356,46087,197607
53,Ethiopia,2019,ETH-19/DDA-3379/SA2/WASH-N-A/INGO/14712,7/7/2021 8:10:06 AM,Host Communities,4944,23189,12004,12493,52630,8716,39135,16004,17851,81706
53,Ethiopia,2019,ETH-19/DDA-3379/SA2/WASH-N-A/INGO/14712,7/7/2021 8:10:06 AM,Overall,4944,23189,12004,12493,52630,8716,39135,16004,17851,81706
53,Ethiopia,2019,ETH-19/DDA-3379/SA2/WASH-NFI/ES/INGO/14604,3/16/2021 1:05:44 PM,Host Communities,420,438,455,437,1750,460,490,512,618,2080
53,Ethiopia,2019,ETH-19/DDA-3379/SA2/WASH-NFI/ES/INGO/14604,3/16/2021 1:05:44 PM,Internally Displaced People,3900,4063,4225,4063,16251,5693,5986,8850,4553,25082
53,Ethiopia,2019,ETH-19/DDA-3379/SA2/WASH-NFI/ES/INGO/14604,3/16/2021 1:05:44 PM,Overall,4320,4501,4680,4500,18001,6153,6476,9362,5171,27162
53,Ethiopia,2019,ETH-19/DDA-3379/SA2/WASH-P/INGO/14579,2/25/2021 8:36:08 PM,Host Communities,1265,1570,765,840,4440,519,2447,274,351,3591
53,Ethiopia,2019,ETH-19/DDA-3379/SA2/WASH-P/INGO/14579,2/25/2021 8:36:08 PM,Internally Displaced People,22963,28585,13914,15039,80501,17315,55079,7732,10724,90850
53,Ethiopia,2019,ETH-19/DDA-3379/SA2/WASH-P/INGO/14579,2/25/2021 8:36:08 PM,Overall,28672,35671,17368,18829,100540,21013,60053,8221,11567,100854
53,Ethiopia,2019,ETH-19/DDA-3379/SA2/WASH-P/INGO/14579,2/25/2021 8:36:08 PM,Returnees,4444,5516,2689,2950,15599,3179,2527,215,492,6413
53,Ethiopia,2019,ETH-19/DDA-3379/SA2/WASH-P/INGO/14779,2/22/2021 8:16:48 PM,Internally Displaced People,7072,6785,6198,6674,26729,10951,10480,10347,10724,42502
53,Ethiopia,2019,ETH-19/DDA-3379/SA2/WASH-P/INGO/14779,2/22/2021 8:16:48 PM,Overall,7072,6785,6198,6674,26729,10951,10480,10347,10724,42502
53,Ethiopia,2020,ETH-20/DDA-3379/RA1/WASH-H-NFI/ES-P/UN/16884,12/29/2021 11:15:23 AM,Internally Displaced People,578,519,647,632,2376,0,0,0,0,0
53,Ethiopia,2020,ETH-20/DDA-3379/RA1/WASH-H-NFI/ES-P/UN/16884,12/29/2021 11:15:23 AM,Other,6837,2878,880,440,11035,12522,2550,1336,421,16829
53,Ethiopia,2020,ETH-20/DDA-3379/RA1/WASH-H-NFI/ES-P/UN/16884,12/29/2021 11:15:23 AM,Overall,7415,3397,1527,1072,13411,12522,2550,1336,421,16829
53,Ethiopia,2020,ETH-20/DDA-3379/RA2/H/INGO/17956,11/19/2021 7:04:27 AM,Host Communities,7679,16236,3915,4076,31906,25429,43256,12594,10859,92138
53,Ethiopia,2020,ETH-20/DDA-3379/RA2/H/INGO/17956,11/19/2021 7:04:27 AM,Internally Displaced People,23036,34053,10638,11068,78795,5463,8530,2523,2773,19289
53,Ethiopia,2020,ETH-20/DDA-3379/RA2/H/INGO/17956,11/19/2021 7:04:27 AM,Overall,30715,50289,14553,15144,110701,30892,51786,15117,13632,111427
53,Ethiopia,2020,ETH-20/DDA-3379/RA2/H/NGO/17945,9/16/2021 5:36:07 PM,Host Communities,27160,38180,24352,25342,115034,20769,28991,8394,8690,66844
53,Ethiopia,2020,ETH-20/DDA-3379/RA2/H/NGO/17945,9/16/2021 5:36:07 PM,Internally Displaced People,27160,38180,24352,25342,115034,3064,4202,1253,1303,9822
53,Ethiopia,2020,ETH-20/DDA-3379/RA2/H/NGO/17945,9/16/2021 5:36:07 PM,Overall,54320,76360,48704,50684,230068,23833,33193,9647,9993,76666
53,Ethiopia,2020,ETH-20/DDA-3379/RA2/H-WASH-NFI/ES-P/INGO/17963,10/3/2022 12:32:30 PM,Internally Displaced People,251536,387271,252776,284416,1175999,348164,765504,434881,478569,2027118
53,Ethiopia,2020,ETH-20/DDA-3379/RA2/H-WASH-NFI/ES-P/INGO/17963,10/3/2022 12:32:30 PM,Overall,251536,387271,252776,284416,1175999,348164,765504,434881,478569,2027118
53,Ethiopia,2020,ETH-20/DDA-3379/RA2/L/UN/17947,9/4/2021 12:33:10 PM,Other,25,0,0,0,25,42,0,0,0,42
53,Ethiopia,2020,ETH-20/DDA-3379/RA2/L/UN/17947,9/4/2021 12:33:10 PM,Overall,25,0,0,0,25,42,0,0,0,42
53,Ethiopia,2020,ETH-20/DDA-3379/SA1/A/INGO/15967,11/5/2021 7:33:10 AM,Host Communities,6570,5665,0,0,12235,6570,5665,0,0,12235
53,Ethiopia,2020,ETH-20/DDA-3379/SA1/A/INGO/15967,11/5/2021 7:33:10 AM,Internally Displaced People,2418,2397,0,0,4815,2418,2397,0,0,4815
53,Ethiopia,2020,ETH-20/DDA-3379/SA1/A/INGO/15967,11/5/2021 7:33:10 AM,Overall,8988,8062,0,0,17050,8988,8062,0,0,17050
53,Ethiopia,2020,ETH-20/DDA-3379/SA1/A/INGO/15979,5/22/2021 6:35:32 AM,Host Communities,12000,12000,31,4,24035,8773,8859,35,0,17667
53,Ethiopia,2020,ETH-20/DDA-3379/SA1/A/INGO/15979,5/22/2021 6:35:32 AM,Internally Displaced People,1200,10800,4,1,12005,8872,8825,3,2,17702
53,Ethiopia,2020,ETH-20/DDA-3379/SA1/A/INGO/15979,5/22/2021 6:35:32 AM,Overall,13200,22800,35,5,36040,17645,17684,38,2,35369
53,Ethiopia,2020,ETH-20/DDA-3379/SA1/A/INGO/15981,5/22/2021 6:38:43 AM,Host Communities,7696,6811,11661,8632,34800,8459,9130,11562,12040,41191
53,Ethiopia,2020,ETH-20/DDA-3379/SA1/A/INGO/15981,5/22/2021 6:38:43 AM,Internally Displaced People,5838,5167,8846,6549,26400,4449,5320,6172,4845,20786
53,Ethiopia,2020,ETH-20/DDA-3379/SA1/A/INGO/15981,5/22/2021 6:38:43 AM,Overall,13534,11978,20507,15181,61200,12908,14450,17734,16885,61977
53,Ethiopia,2020,ETH-20/DDA-3379/SA1/E/INGO/15763,2/25/2021 8:58:22 PM,Host Communities,323,95,11710,7462,19590,323,95,11710,7462,19590
53,Ethiopia,2020,ETH-20/DDA-3379/SA1/E/INGO/15763,2/25/2021 8:58:22 PM,Internally Displaced People,0,0,3090,1865,4955,0,0,3090,1865,4955
53,Ethiopia,2020,ETH-20/DDA-3379/SA1/E/INGO/15763,2/25/2021 8:58:22 PM,Overall,323,95,14800,9327,24545,323,95,14800,9327,24545
53,Ethiopia,2020,ETH-20/DDA-3379/SA1/E/INGO/15894,3/15/2021 12:25:56 PM,Host Communities,1000,1000,3268,2180,7448,1000,1000,3268,2180,7448
53,Ethiopia,2020,ETH-20/DDA-3379/SA1/E/INGO/15894,3/15/2021 12:25:56 PM,Internally Displaced People,2500,2500,8172,5448,18620,2500,2500,8172,5448,18620
53,Ethiopia,2020,ETH-20/DDA-3379/SA1/E/INGO/15894,3/15/2021 12:25:56 PM,Overall,5000,5000,16343,10897,37240,5000,5000,16343,10897,37240
53,Ethiopia,2020,ETH-20/DDA-3379/SA1/E/INGO/15894,3/15/2021 12:25:56 PM,Returnees,1500,1500,4903,3269,11172,1500,1500,4903,3269,11172
53,Ethiopia,2020,ETH-20/DDA-3379/SA1/H/INGO/15846,2/10/2021 12:20:52 PM,Host Communities,26123,27189,32677,34011,120000,47104,47109,81775,76838,252826
53,Ethiopia,2020,ETH-20/DDA-3379/SA1/H/INGO/15846,2/10/2021 12:20:52 PM,Overall,26123,27189,32677,34011,120000,47104,47109,81775,76838,252826
53,Ethiopia,2020,ETH-20/DDA-3379/SA1/H/INGO/15926,5/17/2021 7:24:02 AM,Host Communities,3674,3826,8574,8926,25000,3712,3898,8652,8754,25016
53,Ethiopia,2020,ETH-20/DDA-3379/SA1/H/INGO/15926,5/17/2021 7:24:02 AM,Overall,3674,3826,8574,8926,25000,3712,3898,8652,8754,25016
53,Ethiopia,2020,ETH-20/DDA-3379/SA1/H/INGO/16007,2/10/2021 12:37:38 PM,Host Communities,14904,21482,3726,3872,43984,16300,21641,5568,5602,49111
53,Ethiopia,2020,ETH-20/DDA-3379/SA1/H/INGO/16007,2/10/2021 12:37:38 PM,Overall,14904,21482,3726,3872,43984,16300,21641,5568,5602,49111
53,Ethiopia,2020,ETH-20/DDA-3379/SA1/H/INGO/16013,8/17/2021 2:03:57 PM,Host Communities,2602,3180,4191,4480,14453,2234,3062,3637,4273,13206
53,Ethiopia,2020,ETH-20/DDA-3379/SA1/H/INGO/16013,8/17/2021 2:03:57 PM,Internally Displaced People,3132,3828,5045,5393,17398,4660,3704,7602,7480,23446
53,Ethiopia,2020,ETH-20/DDA-3379/SA1/H/INGO/16013,8/17/2021 2:03:57 PM,Overall,5734,7008,9236,9873,31851,6894,6766,11239,11753,36652
53,Ethiopia,2020,ETH-20/DDA-3379/SA1/H/NGO/16039,3/5/2021 6:19:34 AM,Host Communities,10000,8000,3000,2000,23000,11073,11276,5960,6286,34595
53,Ethiopia,2020,ETH-20/DDA-3379/SA1/H/NGO/16039,3/5/2021 6:19:34 AM,Internally Displaced People,3000,2000,1000,1000,7000,0,0,0,0,0
53,Ethiopia,2020,ETH-20/DDA-3379/SA1/H/NGO/16039,3/5/2021 6:19:34 AM,Overall,13000,10000,4000,3000,30000,11073,11276,5960,6286,34595
53,Ethiopia,2020,ETH-20/DDA-3379/SA1/H/UN/15753,2/16/2021 12:50:14 PM,Host Communities,19992,20808,21658,22542,85000,25330,26364,27441,28561,107696
53,Ethiopia,2020,ETH-20/DDA-3379/SA1/H/UN/15753,2/16/2021 12:50:14 PM,Internally Displaced People,1176,1224,1274,1326,5000,1490,1551,1614,1680,6335
53,Ethiopia,2020,ETH-20/DDA-3379/SA1/H/UN/15753,2/16/2021 12:50:14 PM,Overall,23990,24970,25990,27050,102000,30395,31638,32929,34273,129235
53,Ethiopia,2020,ETH-20/DDA-3379/SA1/H/UN/15753,2/16/2021 12:50:14 PM,Refugees,1646,1714,1784,1856,7000,2085,2172,2260,2352,8869
53,Ethiopia,2020,ETH-20/DDA-3379/SA1/H/UN/15753,2/16/2021 12:50:14 PM,Returnees,1176,1224,1274,1326,5000,1490,1551,1614,1680,6335
53,Ethiopia,2020,ETH-20/DDA-3379/SA1/H/UN/15909,2/10/2021 11:50:20 AM,Other,3892,15672,26349,30435,76348,35975,69217,8206,9776,123174
53,Ethiopia,2020,ETH-20/DDA-3379/SA1/H/UN/15909,2/10/2021 11:50:20 AM,Overall,3892,15672,26349,30435,76348,35975,69217,8206,9776,123174
53,Ethiopia,2020,ETH-20/DDA-3379/SA1/H/UN/15922,5/14/2021 1:46:04 PM,Host Communities,35437,82688,15187,35439,168751,35753,80197,14549,34277,164776
53,Ethiopia,2020,ETH-20/DDA-3379/SA1/H/UN/15922,5/14/2021 1:46:04 PM,Internally Displaced People,5276,12310,2261,5275,25122,4116,8699,1800,4480,19095
53,Ethiopia,2020,ETH-20/DDA-3379/SA1/H/UN/15922,5/14/2021 1:46:04 PM,Overall,70874,165374,30374,70875,337497,66128,149696,27487,65355,308666
53,Ethiopia,2020,ETH-20/DDA-3379/SA1/H/UN/15922,5/14/2021 1:46:04 PM,Returnees,30161,70376,12926,30161,143624,26259,60800,11138,26598,124795
53,Ethiopia,2020,ETH-20/DDA-3379/SA1/H/UN/16034,2/10/2021 12:52:45 PM,Overall,31919,30833,8772,8510,80034,37805,46695,7791,8388,100679
53,Ethiopia,2020,ETH-20/DDA-3379/SA1/H/UN/16034,2/10/2021 12:52:45 PM,Returnees,31919,30833,8772,8510,80034,37805,46695,7791,8388,100679
53,Ethiopia,2020,ETH-20/DDA-3379/SA1/H-N/NGO/15998,2/8/2021 7:01:12 PM,Host Communities,15902,52621,27391,28364,124278,33061,88900,19630,24690,166281
53,Ethiopia,2020,ETH-20/DDA-3379/SA1/H-N/NGO/15998,2/8/2021 7:01:12 PM,Overall,26988,72682,38815,40772,179257,61517,136413,29746,36259,263935
53,Ethiopia,2020,ETH-20/DDA-3379/SA1/H-N/NGO/15998,2/8/2021 7:01:12 PM,Returnees,11086,20061,11424,12408,54979,28456,47513,10116,11569,97654
53,Ethiopia,2020,ETH-20/DDA-3379/SA1/H-N-P-WASH/INGO/15985,6/1/2021 8:23:29 AM,Host Communities,7817,30276,12030,12522,62645,17965,28260,7128,9492,62845
53,Ethiopia,2020,ETH-20/DDA-3379/SA1/H-N-P-WASH/INGO/15985,6/1/2021 8:23:29 AM,Internally Displaced People,19737,23746,10003,11091,64577,22219,35392,9361,13441,80413
53,Ethiopia,2020,ETH-20/DDA-3379/SA1/H-N-P-WASH/INGO/15985,6/1/2021 8:23:29 AM,Overall,27554,54022,22033,23613,127222,40184,63652,16489,22933,143258
53,Ethiopia,2020,ETH-20/DDA-3379/SA1/H-N-WASH/INGO/16015,3/5/2021 6:28:25 AM,Host Communities,11654,17145,12560,13084,54443,11450,16845,12341,13141,53777
53,Ethiopia,2020,ETH-20/DDA-3379/SA1/H-N-WASH/INGO/16015,3/5/2021 6:28:25 AM,Internally Displaced People,3224,4077,3373,3490,14164,3201,4047,3347,3441,14036
53,Ethiopia,2020,ETH-20/DDA-3379/SA1/H-N-WASH/INGO/16015,3/5/2021 6:28:25 AM,Overall,16737,23659,17814,18643,76853,16518,23340,17578,18642,76078
53,Ethiopia,2020,ETH-20/DDA-3379/SA1/H-N-WASH/INGO/16015,3/5/2021 6:28:25 AM,Returnees,1859,2437,1881,2069,8246,1867,2448,1890,2060,8265
53,Ethiopia,2020,ETH-20/DDA-3379/SA1/L/UN/15853,3/23/2021 5:17:51 PM,Other,25,0,0,0,25,30,0,0,0,30
53,Ethiopia,2020,ETH-20/DDA-3379/SA1/L/UN/15853,3/23/2021 5:17:51 PM,Overall,25,0,0,0,25,30,0,0,0,30
53,Ethiopia,2020,ETH-20/DDA-3379/SA1/N/INGO/16026,6/1/2021 7:11:53 PM,Host Communities,0,10089,7095,7385,24569,436,11082,6724,7342,25584
53,Ethiopia,2020,ETH-20/DDA-3379/SA1/N/INGO/16026,6/1/2021 7:11:53 PM,Overall,0,10089,7095,7385,24569,436,11082,6724,7342,25584
53,Ethiopia,2020,ETH-20/DDA-3379/SA1/N/INGO/16040,2/25/2021 8:49:23 PM,Host Communities,47,10149,2687,2911,15794,57,18832,2843,3436,25168
53,Ethiopia,2020,ETH-20/DDA-3379/SA1/N/INGO/16040,2/25/2021 8:49:23 PM,Overall,47,10149,2687,2911,15794,57,18832,2843,3436,25168
53,Ethiopia,2020,ETH-20/DDA-3379/SA1/N/UN/15997,3/8/2021 6:59:42 PM,Internally Displaced People,0,3343,3967,3811,11121,0,3325,3649,4059,11033
53,Ethiopia,2020,ETH-20/DDA-3379/SA1/N/UN/15997,3/8/2021 6:59:42 PM,Overall,0,3343,3967,3811,11121,0,3325,3649,4059,11033
53,Ethiopia,2020,ETH-20/DDA-3379/SA1/N/UN/16005,3/19/2021 3:21:24 AM,Host Communities,0,0,235,215,450,0,0,250,261,511
53,Ethiopia,2020,ETH-20/DDA-3379/SA1/N/UN/16005,3/19/2021 3:21:24 AM,Internally Displaced People,0,0,550,500,1050,0,0,628,549,1177
53,Ethiopia,2020,ETH-20/DDA-3379/SA1/N/UN/16005,3/19/2021 3:21:24 AM,Overall,0,0,785,715,1500,0,0,878,810,1688
53,Ethiopia,2020,ETH-20/DDA-3379/SA1/NFI/ES/INGO/15770,4/2/2021 2:56:35 AM,Internally Displaced People,2403,2476,1165,1238,7282,2590,2684,1320,1507,8101
53,Ethiopia,2020,ETH-20/DDA-3379/SA1/NFI/ES/INGO/15770,4/2/2021 2:56:35 AM,Overall,3336,3437,1617,1719,10109,4469,4665,1990,2198,13322
53,Ethiopia,2020,ETH-20/DDA-3379/SA1/NFI/ES/INGO/15770,4/2/2021 2:56:35 AM,Returnees,933,961,452,481,2827,1879,1981,670,691,5221
53,Ethiopia,2020,ETH-20/DDA-3379/SA1/NFI/ES/INGO/15906,2/14/2021 4:26:18 AM,Internally Displaced People,1975,2091,3833,3717,11616,2518,2667,4889,4740,14814
53,Ethiopia,2020,ETH-20/DDA-3379/SA1/NFI/ES/INGO/15906,2/14/2021 4:26:18 AM,Overall,3016,3194,5855,5678,17743,3730,3951,7243,7023,21947
53,Ethiopia,2020,ETH-20/DDA-3379/SA1/NFI/ES/INGO/15906,2/14/2021 4:26:18 AM,Returnees,1041,1103,2022,1961,6127,1212,1284,2354,2283,7133
53,Ethiopia,2020,ETH-20/DDA-3379/SA1/NFI/ES/INGO/15974,4/15/2021 2:01:46 PM,Internally Displaced People,1658,1613,2232,1881,7384,1658,1613,2232,1881,7384
53,Ethiopia,2020,ETH-20/DDA-3379/SA1/NFI/ES/INGO/15974,4/15/2021 2:01:46 PM,Overall,1658,1613,2232,1881,7384,1658,1613,2232,1881,7384
53,Ethiopia,2020,ETH-20/DDA-3379/SA1/NFI/ES/INGO/15976,7/7/2021 7:10:15 AM,Internally Displaced People,4901,5990,7624,8713,27228,5636,6616,6889,8087,27228
53,Ethiopia,2020,ETH-20/DDA-3379/SA1/NFI/ES/INGO/15976,7/7/2021 7:10:15 AM,Overall,5595,6839,8704,9948,31086,6326,7701,7699,9360,31086
53,Ethiopia,2020,ETH-20/DDA-3379/SA1/NFI/ES/INGO/15976,7/7/2021 7:10:15 AM,Returnees,694,849,1080,1235,3858,690,1085,810,1273,3858
53,Ethiopia,2020,ETH-20/DDA-3379/SA1/NFI/ES/INGO/15984,10/18/2021 3:31:04 PM,Internally Displaced People,1773,1773,7093,7093,17732,4297,3891,2838,3141,14167
53,Ethiopia,2020,ETH-20/DDA-3379/SA1/NFI/ES/INGO/15984,10/18/2021 3:31:04 PM,Overall,1773,1773,7093,7093,17732,4297,3891,2838,3141,14167
53,Ethiopia,2020,ETH-20/DDA-3379/SA1/NFI/ES/UN/16014,6/1/2021 7:17:24 PM,Host Communities,943,943,1302,1303,4491,412,430,994,863,2699
53,Ethiopia,2020,ETH-20/DDA-3379/SA1/NFI/ES/UN/16014,6/1/2021 7:17:24 PM,Internally Displaced People,8562,8563,11824,11824,40773,4218,4387,10120,8797,27522
53,Ethiopia,2020,ETH-20/DDA-3379/SA1/NFI/ES/UN/16014,6/1/2021 7:17:24 PM,Overall,11997,11997,16567,16568,57129,9751,9710,23050,19679,62190
53,Ethiopia,2020,ETH-20/DDA-3379/SA1/NFI/ES/UN/16014,6/1/2021 7:17:24 PM,Returnees,2492,2491,3441,3441,11865,5121,4893,11936,10019,31969
53,Ethiopia,2020,ETH-20/DDA-3379/SA1/N-H/INGO/15901,3/5/2021 6:32:50 AM,Host Communities,1725,16814,6760,6760,32059,1869,4838,3164,3947,13818
53,Ethiopia,2020,ETH-20/DDA-3379/SA1/N-H/INGO/15901,3/5/2021 6:32:50 AM,Internally Displaced People,298,1667,857,857,3679,1389,4050,3466,4583,13488
53,Ethiopia,2020,ETH-20/DDA-3379/SA1/N-H/INGO/15901,3/5/2021 6:32:50 AM,Overall,2023,18481,7617,7617,35738,3258,8888,6630,8530,27306
53,Ethiopia,2020,ETH-20/DDA-3379/SA1/N-H/INGO/15961,7/7/2021 6:47:26 AM,Host Communities,4330,9097,5753,5988,25168,4063,11557,6882,6937,29439
53,Ethiopia,2020,ETH-20/DDA-3379/SA1/N-H/INGO/15961,7/7/2021 6:47:26 AM,Internally Displaced People,0,94,85,89,268,0,50,21,21,92
53,Ethiopia,2020,ETH-20/DDA-3379/SA1/N-H/INGO/15961,7/7/2021 6:47:26 AM,Overall,4330,9191,5838,6077,25436,4063,11607,6903,6958,29531
53,Ethiopia,2020,ETH-20/DDA-3379/SA1/N-H/INGO/16028,5/17/2021 8:02:27 AM,Host Communities,54557,101678,1820,1895,159950,47059,130413,4618,5429,187519
53,Ethiopia,2020,ETH-20/DDA-3379/SA1/N-H/INGO/16028,5/17/2021 8:02:27 AM,Internally Displaced People,3878,5496,720,780,10874,604,1091,286,346,2327
53,Ethiopia,2020,ETH-20/DDA-3379/SA1/N-H/INGO/16028,5/17/2021 8:02:27 AM,Overall,58435,107174,2540,2675,170824,47663,131504,4904,5775,189846
53,Ethiopia,2020,ETH-20/DDA-3379/SA1/N-H/INGO/16045,4/14/2021 7:10:13 AM,Host Communities,21719,68434,37064,38577,165794,66299,92167,26480,26130,211076
53,Ethiopia,2020,ETH-20/DDA-3379/SA1/N-H/INGO/16045,4/14/2021 7:10:13 AM,Internally Displaced People,9256,16988,27623,25150,79017,7782,8882,6712,9323,32699
53,Ethiopia,2020,ETH-20/DDA-3379/SA1/N-H/INGO/16045,4/14/2021 7:10:13 AM,Overall,30975,85422,64687,63727,244811,74081,101049,33192,35453,243775
53,Ethiopia,2020,ETH-20/DDA-3379/SA1/N-H/NGO/16006,3/17/2021 2:28:48 PM,Host Communities,3489,11433,12461,16491,43874,5779,12148,13456,17545,48928
53,Ethiopia,2020,ETH-20/DDA-3379/SA1/N-H/NGO/16006,3/17/2021 2:28:48 PM,Internally Displaced People,1559,2365,2169,2871,8964,2182,3330,3367,2406,11285
53,Ethiopia,2020,ETH-20/DDA-3379/SA1/N-H/NGO/16006,3/17/2021 2:28:48 PM,Overall,5048,13798,14630,19362,52838,7961,15478,16823,19951,60213
53,Ethiopia,2020,ETH-20/DDA-3379/SA1/N-H-WASH/INGO/15933,7/7/2021 7:01:25 AM,Host Communities,16421,17392,14805,18749,67367,13369,15648,13258,24571,66846
53,Ethiopia,2020,ETH-20/DDA-3379/SA1/N-H-WASH/INGO/15933,7/7/2021 7:01:25 AM,Internally Displaced People,2566,7928,7516,8847,26857,6109,7145,9940,15809,39003
53,Ethiopia,2020,ETH-20/DDA-3379/SA1/N-H-WASH/INGO/15933,7/7/2021 7:01:25 AM,Overall,18987,25320,22321,27596,94224,19478,22793,23198,40380,105849
53,Ethiopia,2020,ETH-20/DDA-3379/SA1/P/INGO/15943,8/21/2021 2:07:09 PM,Host Communities,629,1080,129,287,2125,1094,1685,277,470,3526
53,Ethiopia,2020,ETH-20/DDA-3379/SA1/P/INGO/15943,8/21/2021 2:07:09 PM,Internally Displaced People,1409,1716,1117,1179,5421,2403,3147,1498,1603,8651
53,Ethiopia,2020,ETH-20/DDA-3379/SA1/P/INGO/15943,8/21/2021 2:07:09 PM,Overall,2038,2796,1246,1466,7546,3497,4832,1775,2073,12177
53,Ethiopia,2020,ETH-20/DDA-3379/SA1/P/INGO/15977,6/1/2021 7:14:28 PM,Internally Displaced People,313,302,833,844,2292,315,375,915,985,2590
53,Ethiopia,2020,ETH-20/DDA-3379/SA1/P/INGO/15977,6/1/2021 7:14:28 PM,Overall,3126,3024,8325,8435,22910,3145,3165,5093,5310,16713
53,Ethiopia,2020,ETH-20/DDA-3379/SA1/P/INGO/15977,6/1/2021 7:14:28 PM,Returnees,2813,2722,7492,7591,20618,2830,2790,4178,4325,14123
53,Ethiopia,2020,ETH-20/DDA-3379/SA1/P/INGO/15999,3/8/2021 6:57:44 PM,Internally Displaced People,4518,4701,2769,2881,14869,3536,11610,1352,4523,21021
53,Ethiopia,2020,ETH-20/DDA-3379/SA1/P/INGO/15999,3/8/2021 6:57:44 PM,Overall,4518,4701,2769,2881,14869,3536,11610,1352,4523,21021
53,Ethiopia,2020,ETH-20/DDA-3379/SA1/P/INGO/16033,5/4/2021 7:46:41 PM,Internally Displaced People,8058,8058,11000,12000,39116,9074,13842,14944,15354,53214
53,Ethiopia,2020,ETH-20/DDA-3379/SA1/P/INGO/16033,5/4/2021 7:46:41 PM,Overall,8058,8058,11000,12000,39116,9074,13842,14944,15354,53214
53,Ethiopia,2020,ETH-20/DDA-3379/SA1/P/INGO/16035,6/1/2021 7:20:11 PM,Host Communities,324,321,739,784,2168,355,372,739,784,2250
53,Ethiopia,2020,ETH-20/DDA-3379/SA1/P/INGO/16035,6/1/2021 7:20:11 PM,Internally Displaced People,1835,1822,4186,4441,12284,1945,1912,4676,4822,13355
53,Ethiopia,2020,ETH-20/DDA-3379/SA1/P/INGO/16035,6/1/2021 7:20:11 PM,Overall,2159,2143,4925,5225,14452,2300,2284,5415,5606,15605
53,Ethiopia,2020,ETH-20/DDA-3379/SA1/P/NGO/15925,5/10/2021 4:41:56 AM,Host Communities,1000,11144,1200,3269,16613,1000,11144,1200,3269,16613
53,Ethiopia,2020,ETH-20/DDA-3379/SA1/P/NGO/15925,5/10/2021 4:41:56 AM,Internally Displaced People,1000,12243,1200,6444,20887,1000,12243,1200,6444,20887
53,Ethiopia,2020,ETH-20/DDA-3379/SA1/P/NGO/15925,5/10/2021 4:41:56 AM,Overall,2000,23387,2400,9713,37500,2000,23387,2400,9713,37500
53,Ethiopia,2020,ETH-20/DDA-3379/SA1/P/UN/15774,2/14/2022 6:13:09 AM,Host Communities,700,700,325,325,2050,1149,1107,517,528,3301
53,Ethiopia,2020,ETH-20/DDA-3379/SA1/P/UN/15774,2/14/2022 6:13:09 AM,Internally Displaced People,1700,1700,450,450,4300,3100,3075,1019,898,8092
53,Ethiopia,2020,ETH-20/DDA-3379/SA1/P/UN/15774,2/14/2022 6:13:09 AM,Other,170,170,55,50,445,317,354,125,137,933
53,Ethiopia,2020,ETH-20/DDA-3379/SA1/P/UN/15774,2/14/2022 6:13:09 AM,Overall,3770,3770,1205,1200,9945,6513,6236,2521,2275,17545
53,Ethiopia,2020,ETH-20/DDA-3379/SA1/P/UN/15774,2/14/2022 6:13:09 AM,Returnees,1200,1200,375,375,3150,1947,1700,860,712,5219
53,Ethiopia,2020,ETH-20/DDA-3379/SA1/P/UN/15971,3/5/2021 6:41:34 AM,Internally Displaced People,5040,8385,50,170,13645,1410,11758,222,3099,16489
53,Ethiopia,2020,ETH-20/DDA-3379/SA1/P/UN/15971,3/5/2021 6:41:34 AM,Overall,5040,8385,50,170,13645,1410,11758,222,3099,16489
53,Ethiopia,2020,ETH-20/DDA-3379/SA1/P/UN/16044,6/2/2021 9:26:33 AM,Host Communities,1285,1286,1775,1775,6121,2769,2765,3780,3777,13091
53,Ethiopia,2020,ETH-20/DDA-3379/SA1/P/UN/16044,6/2/2021 9:26:33 AM,Internally Displaced People,8439,8439,11653,11653,40184,10933,10907,15061,15061,51962
53,Ethiopia,2020,ETH-20/DDA-3379/SA1/P/UN/16044,6/2/2021 9:26:33 AM,Overall,15714,15715,21699,21699,74827,25551,25329,33060,32885,116825
53,Ethiopia,2020,ETH-20/DDA-3379/SA1/P/UN/16044,6/2/2021 9:26:33 AM,Returnees,5990,5990,8271,8271,28522,11849,11657,14219,14047,51772
53,Ethiopia,2020,ETH-20/DDA-3379/SA1/WASH/INGO/15895,3/16/2021 1:07:56 PM,Host Communities,580,638,1134,1212,3564,521,580,1042,1157,3300
53,Ethiopia,2020,ETH-20/DDA-3379/SA1/WASH/INGO/15895,3/16/2021 1:07:56 PM,Internally Displaced People,3613,3898,7583,7793,22887,3244,3608,6488,7201,20541
53,Ethiopia,2020,ETH-20/DDA-3379/SA1/WASH/INGO/15895,3/16/2021 1:07:56 PM,Overall,4193,4536,8717,9005,26451,3765,4188,7530,8358,23841
53,Ethiopia,2020,ETH-20/DDA-3379/SA1/WASH/INGO/15905,3/31/2021 11:26:41 AM,Host Communities,20522,18578,0,0,39100,15096,16584,0,0,31680
53,Ethiopia,2020,ETH-20/DDA-3379/SA1/WASH/INGO/15905,3/31/2021 11:26:41 AM,Internally Displaced People,9686,10038,0,0,19724,14544,13327,0,0,27871
53,Ethiopia,2020,ETH-20/DDA-3379/SA1/WASH/INGO/15905,3/31/2021 11:26:41 AM,Overall,30208,28616,0,0,58824,29640,29911,0,0,59551
53,Ethiopia,2020,ETH-20/DDA-3379/SA1/WASH/INGO/15907,2/25/2021 8:54:30 PM,Host Communities,4112,6500,3567,3303,17482,4112,6500,3567,3303,17482
53,Ethiopia,2020,ETH-20/DDA-3379/SA1/WASH/INGO/15907,2/25/2021 8:54:30 PM,Internally Displaced People,11182,9462,11613,10756,43013,11182,9462,11613,10756,43013
53,Ethiopia,2020,ETH-20/DDA-3379/SA1/WASH/INGO/15907,2/25/2021 8:54:30 PM,Overall,15294,15962,15180,14059,60495,15294,15962,15180,14059,60495
53,Ethiopia,2020,ETH-20/DDA-3379/SA1/WASH/INGO/15924,8/27/2021 6:35:48 PM,Other,14419,14947,17539,18354,65259,15564,16155,19577,20221,71517
53,Ethiopia,2020,ETH-20/DDA-3379/SA1/WASH/INGO/15924,8/27/2021 6:35:48 PM,Overall,14419,14947,17539,18354,65259,15564,16155,19577,20221,71517
53,Ethiopia,2020,ETH-20/DDA-3379/SA1/WASH/INGO/15937,3/16/2021 1:03:44 PM,Host Communities,5311,4680,0,0,9991,5311,4680,0,0,9991
53,Ethiopia,2020,ETH-20/DDA-3379/SA1/WASH/INGO/15937,3/16/2021 1:03:44 PM,Internally Displaced People,4311,3397,0,0,7708,4311,3397,0,0,7708
53,Ethiopia,2020,ETH-20/DDA-3379/SA1/WASH/INGO/15937,3/16/2021 1:03:44 PM,Overall,10015,8466,0,0,18481,10015,8466,0,0,18481
53,Ethiopia,2020,ETH-20/DDA-3379/SA1/WASH/INGO/15937,3/16/2021 1:03:44 PM,Returnees,393,389,0,0,782,393,389,0,0,782
53,Ethiopia,2020,ETH-20/DDA-3379/SA1/WASH/INGO/15978,5/4/2021 7:17:47 PM,Host Communities,2618,2881,3882,4244,13625,5876,6495,8969,9588,30928
53,Ethiopia,2020,ETH-20/DDA-3379/SA1/WASH/INGO/15978,5/4/2021 7:17:47 PM,Internally Displaced People,4044,4456,6056,6569,21125,3326,3676,5077,5427,17506
53,Ethiopia,2020,ETH-20/DDA-3379/SA1/WASH/INGO/15978,5/4/2021 7:17:47 PM,Overall,6662,7337,9938,10813,34750,9202,10171,14046,15015,48434
53,Ethiopia,2020,ETH-20/DDA-3379/SA1/WASH/INGO/15996,2/28/2021 9:52:22 PM,Host Communities,7513,8035,6371,7131,29050,5970,7085,5812,5821,24688
53,Ethiopia,2020,ETH-20/DDA-3379/SA1/WASH/INGO/15996,2/28/2021 9:52:22 PM,Internally Displaced People,4760,4573,4663,4304,18300,4760,4573,4663,4304,18300
53,Ethiopia,2020,ETH-20/DDA-3379/SA1/WASH/INGO/15996,2/28/2021 9:52:22 PM,Overall,12273,12608,11034,11435,47350,10730,11658,10475,10125,42988
53,Ethiopia,2020,ETH-20/DDA-3379/SA1/WASH/INGO/16043,2/25/2021 8:42:24 PM,Host Communities,741,712,815,781,3049,700,710,790,850,3050
53,Ethiopia,2020,ETH-20/DDA-3379/SA1/WASH/INGO/16043,2/25/2021 8:42:24 PM,Internally Displaced People,7407,7117,8146,7830,30500,7150,8550,7600,8100,31400
53,Ethiopia,2020,ETH-20/DDA-3379/SA1/WASH/INGO/16043,2/25/2021 8:42:24 PM,Overall,8148,7829,8961,8611,33549,7850,9260,8390,8950,34450
53,Ethiopia,2020,ETH-20/DDA-3379/SA1/WASH/NGO/16011,3/17/2021 2:19:35 PM,Host Communities,930,966,854,966,3716,1389,1308,1183,1733,5613
53,Ethiopia,2020,ETH-20/DDA-3379/SA1/WASH/NGO/16011,3/17/2021 2:19:35 PM,Internally Displaced People,6038,6520,5554,6038,24150,5730,6176,4235,6246,22387
53,Ethiopia,2020,ETH-20/DDA-3379/SA1/WASH/NGO/16011,3/17/2021 2:19:35 PM,Overall,7680,8290,7182,7808,30960,8052,8722,6663,9372,32809
53,Ethiopia,2020,ETH-20/DDA-3379/SA1/WASH/NGO/16011,3/17/2021 2:19:35 PM,Returnees,712,804,774,804,3094,933,1238,1245,1393,4809
53,Ethiopia,2020,ETH-20/DDA-3379/SA1/WASH/UN/15855,8/28/2021 11:59:09 AM,Host Communities,4996,4801,5634,5413,20844,10748,10327,12119,11644,44838
53,Ethiopia,2020,ETH-20/DDA-3379/SA1/WASH/UN/15855,8/28/2021 11:59:09 AM,Internally Displaced People,10265,9863,11577,11121,42826,9033,8678,10188,9787,37686
53,Ethiopia,2020,ETH-20/DDA-3379/SA1/WASH/UN/15855,8/28/2021 11:59:09 AM,Overall,15261,14664,17211,16534,63670,19781,19005,22307,21431,82524
53,Ethiopia,2020,ETH-20/DDA-3379/SA1/WASH-NFI/ES/INGO/15980,9/16/2021 5:31:29 PM,Host Communities,1886,1888,3936,3849,11559,1779,2848,3381,3700,11708
53,Ethiopia,2020,ETH-20/DDA-3379/SA1/WASH-NFI/ES/INGO/15980,9/16/2021 5:31:29 PM,Internally Displaced People,4103,4111,8565,8375,25154,5522,9571,9710,10338,35141
53,Ethiopia,2020,ETH-20/DDA-3379/SA1/WASH-NFI/ES/INGO/15980,9/16/2021 5:31:29 PM,Overall,5989,5999,12501,12224,36713,7301,12419,13091,14038,46849
53,Ethiopia,2020,ETH-20/DDA-3379/SA2/A/INGO/17551,8/13/2021 9:14:36 AM,Host Communities,176054,160412,158188,180034,674688,140802,128292,126514,143987,539595
53,Ethiopia,2020,ETH-20/DDA-3379/SA2/A/INGO/17551,8/13/2021 9:14:36 AM,Internally Displaced People,16596,16836,17682,24198,75312,7563,7673,8058,11029,34323
53,Ethiopia,2020,ETH-20/DDA-3379/SA2/A/INGO/17551,8/13/2021 9:14:36 AM,Overall,192650,177248,175870,204232,750000,148365,135965,134572,155016,573918
53,Ethiopia,2020,ETH-20/DDA-3379/SA2/A/INGO/17565,12/3/2021 6:30:12 AM,Host Communities,8972,9030,0,0,18002,14946,9295,0,0,24241
53,Ethiopia,2020,ETH-20/DDA-3379/SA2/A/INGO/17565,12/3/2021 6:30:12 AM,Internally Displaced People,5793,4648,0,0,10441,9794,8508,0,0,18302
53,Ethiopia,2020,ETH-20/DDA-3379/SA2/A/INGO/17565,12/3/2021 6:30:12 AM,Overall,14765,13678,0,0,28443,24740,17803,0,0,42543
53,Ethiopia,2020,ETH-20/DDA-3379/SA2/A/INGO/17580,2/24/2022 7:17:48 AM,Host Communities,3570,3430,0,0,7000,3332,3669,0,0,7001
53,Ethiopia,2020,ETH-20/DDA-3379/SA2/A/INGO/17580,2/24/2022 7:17:48 AM,Internally Displaced People,1530,1470,0,0,3000,1427,1572,0,0,2999
53,Ethiopia,2020,ETH-20/DDA-3379/SA2/A/INGO/17580,2/24/2022 7:17:48 AM,Overall,5100,4900,0,0,10000,4759,5241,0,0,10000
53,Ethiopia,2020,ETH-20/DDA-3379/SA2/E/INGO/17560,7/5/2022 8:22:18 AM,Host Communities,361,460,1694,2413,4928,361,460,1694,2413,4928
53,Ethiopia,2020,ETH-20/DDA-3379/SA2/E/INGO/17560,7/5/2022 8:22:18 AM,Internally Displaced People,543,690,2540,3619,7392,543,690,2540,3619,7392
53,Ethiopia,2020,ETH-20/DDA-3379/SA2/E/INGO/17560,7/5/2022 8:22:18 AM,Overall,904,1150,4234,6032,12320,904,1150,4234,6032,12320
53,Ethiopia,2020,ETH-20/DDA-3379/SA2/H/INGO/17476,8/21/2021 2:13:14 PM,Host Communities,0,7000,31000,30000,68000,0,7050,29000,29200,65250
53,Ethiopia,2020,ETH-20/DDA-3379/SA2/H/INGO/17476,8/21/2021 2:13:14 PM,Internally Displaced People,0,1408,2190,3025,6623,0,1610,5214,2912,9736
53,Ethiopia,2020,ETH-20/DDA-3379/SA2/H/INGO/17476,8/21/2021 2:13:14 PM,Overall,0,8408,33190,33025,74623,0,8660,34214,32112,74986
53,Ethiopia,2020,ETH-20/DDA-3379/SA2/H/INGO/17497,8/14/2021 1:56:56 PM,Host Communities,2232,2420,402,419,5473,1551,1811,345,385,4092
53,Ethiopia,2020,ETH-20/DDA-3379/SA2/H/INGO/17497,8/14/2021 1:56:56 PM,Internally Displaced People,2427,2627,443,448,5945,1681,1962,373,418,4434
53,Ethiopia,2020,ETH-20/DDA-3379/SA2/H/INGO/17497,8/14/2021 1:56:56 PM,Overall,4659,5047,845,867,11418,3232,3773,718,803,8526
53,Ethiopia,2020,ETH-20/DDA-3379/SA2/H/INGO/17541,10/16/2021 2:24:14 PM,Host Communities,850,1983,1417,1417,5667,300,3020,655,726,4701
53,Ethiopia,2020,ETH-20/DDA-3379/SA2/H/INGO/17541,10/16/2021 2:24:14 PM,Internally Displaced People,150,350,250,250,1000,99,361,188,197,845
53,Ethiopia,2020,ETH-20/DDA-3379/SA2/H/INGO/17541,10/16/2021 2:24:14 PM,Overall,1000,2333,1667,1667,6667,399,3381,843,923,5546
53,Ethiopia,2020,ETH-20/DDA-3379/SA2/H/INGO/17561,7/8/2021 9:27:05 AM,Host Communities,7376,11001,8269,7948,34594,7645,12012,10032,9624,39313
53,Ethiopia,2020,ETH-20/DDA-3379/SA2/H/INGO/17561,7/8/2021 9:27:05 AM,Internally Displaced People,1509,2251,1694,1628,7082,1732,2564,1714,1884,7894
53,Ethiopia,2020,ETH-20/DDA-3379/SA2/H/INGO/17561,7/8/2021 9:27:05 AM,Overall,8885,13252,9963,9576,41676,9377,14576,11746,11508,47207
53,Ethiopia,2020,ETH-20/DDA-3379/SA2/H/INGO/17567,2/14/2022 6:09:30 AM,Host Communities,5145,5355,12005,12495,35000,5966,6807,12692,12779,38244
53,Ethiopia,2020,ETH-20/DDA-3379/SA2/H/INGO/17567,2/14/2022 6:09:30 AM,Overall,5145,5355,12005,12495,35000,5966,6807,12692,12779,38244
53,Ethiopia,2020,ETH-20/DDA-3379/SA2/H/NGO/17460,8/6/2021 5:52:08 AM,Host Communities,13878,19509,12445,12949,58781,8619,17521,8439,8784,43363
53,Ethiopia,2020,ETH-20/DDA-3379/SA2/H/NGO/17460,8/6/2021 5:52:08 AM,Internally Displaced People,3137,4409,2812,2927,13285,1703,4038,4105,4608,14454
53,Ethiopia,2020,ETH-20/DDA-3379/SA2/H/NGO/17460,8/6/2021 5:52:08 AM,Overall,17015,23918,15257,15876,72066,10322,21559,12544,13392,57817
53,Ethiopia,2020,ETH-20/DDA-3379/SA2/H/NGO/17477,9/13/2021 7:23:08 PM,Host Communities,2423,5966,5196,9282,22867,2490,6012,6234,10520,25256
53,Ethiopia,2020,ETH-20/DDA-3379/SA2/H/NGO/17477,9/13/2021 7:23:08 PM,Internally Displaced People,933,1211,1664,2903,6711,1182,1521,1820,3320,7843
53,Ethiopia,2020,ETH-20/DDA-3379/SA2/H/NGO/17477,9/13/2021 7:23:08 PM,Overall,3356,7177,6860,12185,29578,3672,7533,8054,13840,33099
53,Ethiopia,2020,ETH-20/DDA-3379/SA2/H/NGO/17543,8/2/2021 11:54:53 AM,Host Communities,23192,21841,0,0,45033,12619,12902,8301,9469,43291
53,Ethiopia,2020,ETH-20/DDA-3379/SA2/H/NGO/17543,8/2/2021 11:54:53 AM,Internally Displaced People,2558,2409,0,0,4967,119,122,78,89,408
53,Ethiopia,2020,ETH-20/DDA-3379/SA2/H/NGO/17543,8/2/2021 11:54:53 AM,Overall,25750,24250,0,0,50000,12738,13024,8379,9558,43699
53,Ethiopia,2020,ETH-20/DDA-3379/SA2/H-E/NGO/17500,10/28/2021 6:31:29 PM,Host Communities,7603,10689,6818,7095,32205,9338,15551,5996,6223,37108
53,Ethiopia,2020,ETH-20/DDA-3379/SA2/H-E/NGO/17500,10/28/2021 6:31:29 PM,Internally Displaced People,1124,1579,1007,1048,4758,5483,9145,3865,4056,22549
53,Ethiopia,2020,ETH-20/DDA-3379/SA2/H-E/NGO/17500,10/28/2021 6:31:29 PM,Overall,14668,20620,13152,13687,62127,20820,34540,13779,14343,83482
53,Ethiopia,2020,ETH-20/DDA-3379/SA2/H-E/NGO/17500,10/28/2021 6:31:29 PM,Returnees,5941,8352,5327,5544,25164,5999,9844,3918,4064,23825
53,Ethiopia,2020,ETH-20/DDA-3379/SA2/H-N/INGO/17544,8/14/2021 1:54:39 PM,Host Communities,1580,13828,2053,2137,19598,2616,15083,15980,18206,51885
53,Ethiopia,2020,ETH-20/DDA-3379/SA2/H-N/INGO/17544,8/14/2021 1:54:39 PM,Internally Displaced People,4361,5892,2021,2104,14378,3595,5916,3675,4432,17618
53,Ethiopia,2020,ETH-20/DDA-3379/SA2/H-N/INGO/17544,8/14/2021 1:54:39 PM,Overall,5941,19720,4074,4241,33976,6211,20999,19655,22638,69503
53,Ethiopia,2020,ETH-20/DDA-3379/SA2/H-N-WASH-P-NFI/ES/INGO/17538,12/3/2021 6:17:29 AM,Internally Displaced People,1305,1258,863,859,4285,8862,10595,2492,3296,25245
53,Ethiopia,2020,ETH-20/DDA-3379/SA2/H-N-WASH-P-NFI/ES/INGO/17538,12/3/2021 6:17:29 AM,Overall,1305,1258,863,859,4285,8862,10595,2492,3296,25245
53,Ethiopia,2020,ETH-20/DDA-3379/SA2/H-WASH-NFI/ES/INGO/17423,12/16/2021 11:39:31 AM,Internally Displaced People,1394,1476,2706,2624,8200,2983,3272,7753,8038,22046
53,Ethiopia,2020,ETH-20/DDA-3379/SA2/H-WASH-NFI/ES/INGO/17423,12/16/2021 11:39:31 AM,Overall,1394,1476,2706,2624,8200,2983,3272,7753,8038,22046
53,Ethiopia,2020,ETH-20/DDA-3379/SA2/L/UN/17387,10/22/2021 2:10:43 AM,Other,25,0,0,0,25,29,0,0,0,29
53,Ethiopia,2020,ETH-20/DDA-3379/SA2/L/UN/17387,10/22/2021 2:10:43 AM,Overall,25,0,0,0,25,29,0,0,0,29
53,Ethiopia,2020,ETH-20/DDA-3379/SA2/N/INGO/17507,2/14/2022 6:06:18 AM,Host Communities,0,1665,2364,2460,6489,0,2608,3611,4201,10420
53,Ethiopia,2020,ETH-20/DDA-3379/SA2/N/INGO/17507,2/14/2022 6:06:18 AM,Overall,0,1665,2364,2460,6489,0,2608,3611,4201,10420
53,Ethiopia,2020,ETH-20/DDA-3379/SA2/N/INGO/17532,10/16/2021 2:29:11 PM,Host Communities,0,5187,4608,4797,14592,0,6808,5663,4449,16920
53,Ethiopia,2020,ETH-20/DDA-3379/SA2/N/INGO/17532,10/16/2021 2:29:11 PM,Internally Displaced People,0,409,293,305,1007,0,512,426,335,1273
53,Ethiopia,2020,ETH-20/DDA-3379/SA2/N/INGO/17532,10/16/2021 2:29:11 PM,Overall,0,5596,4901,5102,15599,0,7320,6089,4784,18193
53,Ethiopia,2020,ETH-20/DDA-3379/SA2/N/INGO/17537,12/9/2021 7:42:48 AM,Host Communities,0,1391,2759,2872,7022,27,4685,7070,7379,19161
53,Ethiopia,2020,ETH-20/DDA-3379/SA2/N/INGO/17537,12/9/2021 7:42:48 AM,Internally Displaced People,0,1134,1512,1573,4219,3323,1510,2983,3104,10920
53,Ethiopia,2020,ETH-20/DDA-3379/SA2/N/INGO/17537,12/9/2021 7:42:48 AM,Overall,0,2525,4271,4445,11241,3350,6195,10053,10483,30081
53,Ethiopia,2020,ETH-20/DDA-3379/SA2/N/INGO/17546,7/24/2021 10:59:24 AM,Host Communities,0,2159,2631,2737,7527,61,15310,17921,22121,55413
53,Ethiopia,2020,ETH-20/DDA-3379/SA2/N/INGO/17546,7/24/2021 10:59:24 AM,Internally Displaced People,0,769,809,843,2421,0,461,367,453,1281
53,Ethiopia,2020,ETH-20/DDA-3379/SA2/N/INGO/17546,7/24/2021 10:59:24 AM,Overall,0,2928,3440,3580,9948,61,15771,18288,22574,56694
53,Ethiopia,2020,ETH-20/DDA-3379/SA2/N/INGO/17557,10/29/2021 5:42:32 PM,Host Communities,6260,62596,4160,4328,77344,14297,52057,3869,4965,75188
53,Ethiopia,2020,ETH-20/DDA-3379/SA2/N/INGO/17557,10/29/2021 5:42:32 PM,Internally Displaced People,9298,10024,1508,1584,22414,5654,8398,948,1088,16088
53,Ethiopia,2020,ETH-20/DDA-3379/SA2/N/INGO/17557,10/29/2021 5:42:32 PM,Overall,15558,72620,5668,5912,99758,19951,60455,4817,6053,91276
53,Ethiopia,2020,ETH-20/DDA-3379/SA2/N/NGO/17564,8/14/2021 1:58:20 PM,Host Communities,0,4224,3211,3267,10702,0,9511,2939,3591,16041
53,Ethiopia,2020,ETH-20/DDA-3379/SA2/N/NGO/17564,8/14/2021 1:58:20 PM,Overall,0,9803,4880,5573,20256,0,16858,4463,5267,26588
53,Ethiopia,2020,ETH-20/DDA-3379/SA2/N/NGO/17564,8/14/2021 1:58:20 PM,Returnees,0,5579,1669,2306,9554,0,7347,1524,1676,10547
53,Ethiopia,2020,ETH-20/DDA-3379/SA2/NFI/ES/INGO/17465,11/5/2021 7:47:06 AM,Host Communities,123,150,82,105,460,24,50,150,296,520
53,Ethiopia,2020,ETH-20/DDA-3379/SA2/NFI/ES/INGO/17465,11/5/2021 7:47:06 AM,Internally Displaced People,729,911,501,592,2733,450,646,1000,500,2596
53,Ethiopia,2020,ETH-20/DDA-3379/SA2/NFI/ES/INGO/17465,11/5/2021 7:47:06 AM,Overall,1353,1653,902,1152,5060,624,896,1600,2080,5200
53,Ethiopia,2020,ETH-20/DDA-3379/SA2/NFI/ES/INGO/17465,11/5/2021 7:47:06 AM,Returnees,501,592,319,455,1867,150,200,450,1284,2084
53,Ethiopia,2020,ETH-20/DDA-3379/SA2/NFI/ES/INGO/17492,9/1/2021 4:22:30 PM,Host Communities,182,193,376,387,1138,84,54,140,145,423
53,Ethiopia,2020,ETH-20/DDA-3379/SA2/NFI/ES/INGO/17492,9/1/2021 4:22:30 PM,Internally Displaced People,1481,1574,3055,3147,9257,3125,2448,1890,1661,9124
53,Ethiopia,2020,ETH-20/DDA-3379/SA2/NFI/ES/INGO/17492,9/1/2021 4:22:30 PM,Overall,1821,1935,3758,3871,11385,3453,2705,2459,2149,10766
53,Ethiopia,2020,ETH-20/DDA-3379/SA2/NFI/ES/INGO/17492,9/1/2021 4:22:30 PM,Returnees,158,168,327,337,990,244,203,429,343,1219
53,Ethiopia,2020,ETH-20/DDA-3379/SA2/NFI/ES/INGO/17539,10/16/2021 2:33:24 PM,Host Communities,134,135,269,269,807,0,0,0,0,0
53,Ethiopia,2020,ETH-20/DDA-3379/SA2/NFI/ES/INGO/17539,10/16/2021 2:33:24 PM,Internally Displaced People,2286,2287,4573,4573,13719,1882,1828,1249,1227,6186
53,Ethiopia,2020,ETH-20/DDA-3379/SA2/NFI/ES/INGO/17539,10/16/2021 2:33:24 PM,Overall,2689,2691,5380,5380,16140,1882,1828,1249,1227,6186
53,Ethiopia,2020,ETH-20/DDA-3379/SA2/NFI/ES/INGO/17539,10/16/2021 2:33:24 PM,Returnees,269,269,538,538,1614,0,0,0,0,0
53,Ethiopia,2020,ETH-20/DDA-3379/SA2/NFI/ES/NGO/17504,8/14/2021 1:53:14 PM,Host Communities,124,80,34,26,264,124,80,34,26,264
53,Ethiopia,2020,ETH-20/DDA-3379/SA2/NFI/ES/NGO/17504,8/14/2021 1:53:14 PM,Overall,1160,827,424,229,2640,1160,827,424,229,2640
53,Ethiopia,2020,ETH-20/DDA-3379/SA2/NFI/ES/NGO/17504,8/14/2021 1:53:14 PM,Returnees,1036,747,390,203,2376,1036,747,390,203,2376
53,Ethiopia,2020,ETH-20/DDA-3379/SA2/NFI/ES-P-H-N-WASH-E/UN/17689,12/16/2021 11:30:41 AM,Host Communities,1565,1561,2245,2255,7626,1135,1218,1527,1521,5401
53,Ethiopia,2020,ETH-20/DDA-3379/SA2/NFI/ES-P-H-N-WASH-E/UN/17689,12/16/2021 11:30:41 AM,Internally Displaced People,7825,7806,11225,11282,38138,9248,11072,9969,10221,40510
53,Ethiopia,2020,ETH-20/DDA-3379/SA2/NFI/ES-P-H-N-WASH-E/UN/17689,12/16/2021 11:30:41 AM,Overall,11432,11498,15867,15844,54641,13008,14909,15262,15527,58706
53,Ethiopia,2020,ETH-20/DDA-3379/SA2/NFI/ES-P-H-N-WASH-E/UN/17689,12/16/2021 11:30:41 AM,Returnees,2042,2131,2397,2307,8877,2625,2619,3766,3785,12795
53,Ethiopia,2020,ETH-20/DDA-3379/SA2/NFI/ES-WASH-N-H/INGO/17584,9/13/2021 5:02:27 PM,Host Communities,461,444,521,500,1926,453,519,571,536,2079
53,Ethiopia,2020,ETH-20/DDA-3379/SA2/NFI/ES-WASH-N-H/INGO/17584,9/13/2021 5:02:27 PM,Internally Displaced People,2309,2218,2603,2501,9631,2354,2375,2681,2609,10019
53,Ethiopia,2020,ETH-20/DDA-3379/SA2/NFI/ES-WASH-N-H/INGO/17584,9/13/2021 5:02:27 PM,Overall,2770,2662,3124,3001,11557,2807,2894,3252,3145,12098
53,Ethiopia,2020,ETH-20/DDA-3379/SA2/NFI/ES-WASH-P/INGO/17569,3/21/2022 8:06:23 AM,Host Communities,44605,54744,11861,14313,125523,35349,43384,9400,11343,99476
53,Ethiopia,2020,ETH-20/DDA-3379/SA2/NFI/ES-WASH-P/INGO/17569,3/21/2022 8:06:23 AM,Internally Displaced People,46216,57279,14125,16600,134220,51379,63678,15703,18454,149214
53,Ethiopia,2020,ETH-20/DDA-3379/SA2/NFI/ES-WASH-P/INGO/17569,3/21/2022 8:06:23 AM,Overall,90821,112023,25986,30913,259743,86728,107062,25103,29797,248690
53,Ethiopia,2020,ETH-20/DDA-3379/SA2/N-H-P-E-NFI/ES-WASH/INGO/17549,8/11/2021 8:20:36 AM,Host Communities,2767,2265,6294,5452,16778,3291,5853,11126,10749,31019
53,Ethiopia,2020,ETH-20/DDA-3379/SA2/N-H-P-E-NFI/ES-WASH/INGO/17549,8/11/2021 8:20:36 AM,Internally Displaced People,830,679,1692,1460,4661,1225,1423,2625,2865,8138
53,Ethiopia,2020,ETH-20/DDA-3379/SA2/N-H-P-E-NFI/ES-WASH/INGO/17549,8/11/2021 8:20:36 AM,Overall,3597,2944,7986,6912,21439,4516,7276,13751,13614,39157
53,Ethiopia,2020,ETH-20/DDA-3379/SA2/N-H-WASH-P-NFI/ES/INGO/17432,12/29/2021 11:30:03 AM,Internally Displaced People,49973,43188,32173,33858,159192,44524,72288,17940,26089,160841
53,Ethiopia,2020,ETH-20/DDA-3379/SA2/N-H-WASH-P-NFI/ES/INGO/17432,12/29/2021 11:30:03 AM,Overall,49973,43188,32173,33858,159192,44524,72288,17940,26089,160841
53,Ethiopia,2020,ETH-20/DDA-3379/SA2/P/INGO/17487,12/16/2021 11:33:36 AM,Host Communities,1320,4000,3200,4800,13320,1550,3200,3650,4800,13200
53,Ethiopia,2020,ETH-20/DDA-3379/SA2/P/INGO/17487,12/16/2021 11:33:36 AM,Internally Displaced People,5140,4140,5640,6560,21480,3988,3625,5530,6023,19166
53,Ethiopia,2020,ETH-20/DDA-3379/SA2/P/INGO/17487,12/16/2021 11:33:36 AM,Overall,7960,12820,13100,17060,50940,10238,10403,12440,16723,49804
53,Ethiopia,2020,ETH-20/DDA-3379/SA2/P/INGO/17487,12/16/2021 11:33:36 AM,Returnees,1500,4680,4260,5700,16140,4700,3578,3260,5900,17438
53,Ethiopia,2020,ETH-20/DDA-3379/SA2/P/INGO/17573,12/9/2021 7:34:18 AM,Host Communities,18429,18492,16607,16661,70189,830,7249,2060,4075,14214
53,Ethiopia,2020,ETH-20/DDA-3379/SA2/P/INGO/17573,12/9/2021 7:34:18 AM,Internally Displaced People,3866,4468,2615,3086,14035,220,1925,548,1082,3775
53,Ethiopia,2020,ETH-20/DDA-3379/SA2/P/INGO/17573,12/9/2021 7:34:18 AM,Overall,22295,22960,19222,19747,84224,1050,9174,2608,5157,17989
53,Ethiopia,2020,ETH-20/DDA-3379/SA2/P/UN/17506,4/30/2022 9:21:47 AM,Internally Displaced People,4000,3750,0,0,7750,4432,3560,0,0,7992
53,Ethiopia,2020,ETH-20/DDA-3379/SA2/P/UN/17506,4/30/2022 9:21:47 AM,Overall,8000,7500,0,0,15500,6382,5136,0,0,11518
53,Ethiopia,2020,ETH-20/DDA-3379/SA2/P/UN/17506,4/30/2022 9:21:47 AM,Returnees,4000,3750,0,0,7750,1950,1576,0,0,3526
53,Ethiopia,2020,ETH-20/DDA-3379/SA2/P-E-H-WASH-NFI/ES/INGO/17499,6/29/2022 9:36:25 AM,Host Communities,18124,45404,9376,9750,82654,11333,28642,8613,7875,56463
53,Ethiopia,2020,ETH-20/DDA-3379/SA2/P-E-H-WASH-NFI/ES/INGO/17499,6/29/2022 9:36:25 AM,Overall,31407,58472,13361,13670,116910,26204,43934,14406,12325,96869
53,Ethiopia,2020,ETH-20/DDA-3379/SA2/P-E-H-WASH-NFI/ES/INGO/17499,6/29/2022 9:36:25 AM,Returnees,13283,13068,3985,3920,34256,14871,15292,5793,4450,40406
53,Ethiopia,2020,ETH-20/DDA-3379/SA2/P-H-WASH-NFI/ES-N/INGO/17433,1/4/2022 3:05:33 PM,Host Communities,0,4225,1120,1165,6510,5301,7440,5960,5780,24481
53,Ethiopia,2020,ETH-20/DDA-3379/SA2/P-H-WASH-NFI/ES-N/INGO/17433,1/4/2022 3:05:33 PM,Internally Displaced People,3570,5100,7180,7130,22980,1701,3719,3105,3117,11642
53,Ethiopia,2020,ETH-20/DDA-3379/SA2/P-H-WASH-NFI/ES-N/INGO/17433,1/4/2022 3:05:33 PM,Overall,3570,9325,8300,8295,29490,7002,11159,9065,8897,36123
53,Ethiopia,2020,ETH-20/DDA-3379/SA2/P-NFI/ES-H-N-WASH/UN/17575,1/4/2022 2:55:05 PM,Host Communities,1909,1902,2736,2751,9298,1562,1603,1708,1862,6735
53,Ethiopia,2020,ETH-20/DDA-3379/SA2/P-NFI/ES-H-N-WASH/UN/17575,1/4/2022 2:55:05 PM,Internally Displaced People,20980,20929,30101,30251,102261,18031,19613,21769,21572,80985
53,Ethiopia,2020,ETH-20/DDA-3379/SA2/P-NFI/ES-H-N-WASH/UN/17575,1/4/2022 2:55:05 PM,Overall,22889,22831,32837,33002,111559,19593,21216,23477,23434,87720
53,Ethiopia,2020,ETH-20/DDA-3379/SA2/WASH/INGO/17480,1/4/2022 3:20:29 PM,Host Communities,8822,9181,5407,5629,29039,9197,9568,5675,5850,30290
53,Ethiopia,2020,ETH-20/DDA-3379/SA2/WASH/INGO/17480,1/4/2022 3:20:29 PM,Internally Displaced People,19666,20977,12127,12783,65553,17361,18058,10744,11029,57192
53,Ethiopia,2020,ETH-20/DDA-3379/SA2/WASH/INGO/17480,1/4/2022 3:20:29 PM,Overall,28488,30158,17534,18412,94592,26558,27626,16419,16879,87482
53,Ethiopia,2020,ETH-20/DDA-3379/SA2/WASH/INGO/17486,8/18/2021 5:44:40 PM,Other,18000,15750,6750,4500,45000,14562,15788,7959,6691,45000
53,Ethiopia,2020,ETH-20/DDA-3379/SA2/WASH/INGO/17486,8/18/2021 5:44:40 PM,Overall,18000,15750,6750,4500,45000,14562,15788,7959,6691,45000
53,Ethiopia,2020,ETH-20/DDA-3379/SA2/WASH-H-P/INGO/17490,10/22/2021 2:16:37 AM,Host Communities,3060,3420,5400,6120,18000,4550,4283,4106,4816,17755
53,Ethiopia,2020,ETH-20/DDA-3379/SA2/WASH-H-P/INGO/17490,10/22/2021 2:16:37 AM,Internally Displaced People,7140,7980,12600,14280,42000,11639,9976,9563,10392,41570
53,Ethiopia,2020,ETH-20/DDA-3379/SA2/WASH-H-P/INGO/17490,10/22/2021 2:16:37 AM,Overall,10200,11400,18000,20400,60000,16189,14259,13669,15208,59325
53,Ethiopia,2020,ETH-20/DDA-3379/SA2/WASH-NFI/ES/INGO/17452,4/22/2022 8:19:32 PM,Host Communities,1601,1642,452,410,4105,1162,1253,1487,1809,5711
53,Ethiopia,2020,ETH-20/DDA-3379/SA2/WASH-NFI/ES/INGO/17452,4/22/2022 8:19:32 PM,Internally Displaced People,12867,13197,3629,3299,32992,5902,6125,9621,11906,33554
53,Ethiopia,2020,ETH-20/DDA-3379/SA2/WASH-NFI/ES/INGO/17452,4/22/2022 8:19:32 PM,Overall,14468,14839,4081,3709,37097,7064,7378,11108,13715,39265
53,Ethiopia,2020,ETH-20/DDA-3379/SA2/WASH-NFI/ES-H/INGO/17542,2/14/2022 6:36:29 AM,Host Communities,4294,4337,4379,4337,17347,14532,11248,130,480,26390
53,Ethiopia,2020,ETH-20/DDA-3379/SA2/WASH-NFI/ES-H/INGO/17542,2/14/2022 6:36:29 AM,Internally Displaced People,3393,3427,3461,3427,13708,4256,2622,4154,4659,15691
53,Ethiopia,2020,ETH-20/DDA-3379/SA2/WASH-NFI/ES-H/INGO/17542,2/14/2022 6:36:29 AM,Overall,7687,7764,7840,7764,31055,18788,13870,4284,5139,42081
53,Ethiopia,2020,ETH-20/DDA-3379/SA2/WASH-NFI/ES-H-N-E-P/INGO/17467,2/14/2022 7:17:43 AM,Host Communities,2804,9715,5275,4986,22780,6541,18162,7704,8275,40682
53,Ethiopia,2020,ETH-20/DDA-3379/SA2/WASH-NFI/ES-H-N-E-P/INGO/17467,2/14/2022 7:17:43 AM,Internally Displaced People,1045,7294,6891,5951,21181,3227,10640,7618,8046,29531
53,Ethiopia,2020,ETH-20/DDA-3379/SA2/WASH-NFI/ES-H-N-E-P/INGO/17467,2/14/2022 7:17:43 AM,Overall,3849,17009,12166,10937,43961,9768,28802,15322,16321,70213
53,Ethiopia,2020,ETH-20/DDA-3379/SA2/WASH-NFI/ES-P-H-N/INGO/17581,10/29/2021 11:24:34 AM,Host Communities,425,1623,1257,1544,4849,2287,4878,1470,1837,10472
53,Ethiopia,2020,ETH-20/DDA-3379/SA2/WASH-NFI/ES-P-H-N/INGO/17581,10/29/2021 11:24:34 AM,Internally Displaced People,3262,7072,4697,6019,21050,2447,5604,2383,2608,13042
53,Ethiopia,2020,ETH-20/DDA-3379/SA2/WASH-NFI/ES-P-H-N/INGO/17581,10/29/2021 11:24:34 AM,Overall,3687,8695,5954,7563,25899,4734,10482,3853,4445,23514
53,Ethiopia,2020,ETH-20/DDA-3379/SA2/WASH-N-H-P-NFI/ES/INGO/17572,11/5/2021 7:34:23 AM,Host Communities,12398,17510,7599,10733,48240,13504,19786,7974,11299,52563
53,Ethiopia,2020,ETH-20/DDA-3379/SA2/WASH-N-H-P-NFI/ES/INGO/17572,11/5/2021 7:34:23 AM,Internally Displaced People,6975,9852,4390,5868,27085,7085,10054,4428,5948,27515
53,Ethiopia,2020,ETH-20/DDA-3379/SA2/WASH-N-H-P-NFI/ES/INGO/17572,11/5/2021 7:34:23 AM,Overall,19373,27362,11989,16601,75325,20589,29840,12402,17247,80078
53,Ethiopia,2020,ETH-20/DDA-3379/SA2/WASH-P-NFI/ES-N/INGO/17442,12/29/2021 11:18:35 AM,Host Communities,458,458,129,134,1179,1115,1417,1370,1274,5176
53,Ethiopia,2020,ETH-20/DDA-3379/SA2/WASH-P-NFI/ES-N/INGO/17442,12/29/2021 11:18:35 AM,Internally Displaced People,1353,1436,1016,1018,4823,1338,1700,1644,1528,6210
53,Ethiopia,2020,ETH-20/DDA-3379/SA2/WASH-P-NFI/ES-N/INGO/17442,12/29/2021 11:18:35 AM,Overall,4624,4616,8637,8743,26620,5574,7084,6849,6368,25875
53,Ethiopia,2020,ETH-20/DDA-3379/SA2/WASH-P-NFI/ES-N/INGO/17442,12/29/2021 11:18:35 AM,Returnees,2813,2722,7492,7591,20618,3121,3967,3835,3566,14489
53,Ethiopia,2021,ETH-21/DDA-3379/RA1/CSS/UN/18097,10/3/2022 11:42:07 AM,Other,60,60,0,0,120,1250,1250,0,0,2500
53,Ethiopia,2021,ETH-21/DDA-3379/RA1/CSS/UN/18097,10/3/2022 11:42:07 AM,Overall,60,60,0,0,120,1250,1250,0,0,2500
53,Ethiopia,2021,ETH-21/DDA-3379/RA2/CCCM/INGO/20069,3/3/2023 8:47:50 AM,Host Communities,1178,1368,570,684,3800,1275,1451,621,784,4131
53,Ethiopia,2021,ETH-21/DDA-3379/RA2/CCCM/INGO/20069,3/3/2023 8:47:50 AM,Internally Displaced People,6200,7200,3000,3600,20000,5983,7002,3121,3848,19954
53,Ethiopia,2021,ETH-21/DDA-3379/RA2/CCCM/INGO/20069,3/3/2023 8:47:50 AM,Overall,7378,8568,3570,4284,23800,7258,8453,3742,4632,24085
53,Ethiopia,2021,ETH-21/DDA-3379/RA2/CCCM/UN/20060,9/14/2022 7:08:55 AM,Host Communities,1411,1410,2046,2057,6924,1322,1333,1912,1928,6495
53,Ethiopia,2021,ETH-21/DDA-3379/RA2/CCCM/UN/20060,9/14/2022 7:08:55 AM,Internally Displaced People,7034,7084,10216,10287,34621,8723,8754,12583,12655,42715
53,Ethiopia,2021,ETH-21/DDA-3379/RA2/CCCM/UN/20060,9/14/2022 7:08:55 AM,Overall,8445,8494,12262,12344,41545,10045,10087,14495,14583,49210
53,Ethiopia,2021,ETH-21/DDA-3379/RA2/H/INGO/20012,8/3/2023 6:40:50 AM,Host Communities,34166,35418,26833,27214,123631,33458,33890,25007,26891,119246
53,Ethiopia,2021,ETH-21/DDA-3379/RA2/H/INGO/20012,8/3/2023 6:40:50 AM,Internally Displaced People,454,410,364,386,1614,441,379,344,367,1531
53,Ethiopia,2021,ETH-21/DDA-3379/RA2/H/INGO/20012,8/3/2023 6:40:50 AM,Overall,34620,35828,27197,27600,125245,33899,34269,25351,27258,120777
53,Ethiopia,2021,ETH-21/DDA-3379/RA2/H/INGO/20016,5/26/2022 8:32:32 AM,Host Communities,6967,10452,1522,1585,20526,3024,5343,1394,1904,11665
53,Ethiopia,2021,ETH-21/DDA-3379/RA2/H/INGO/20016,5/26/2022 8:32:32 AM,Internally Displaced People,8970,13457,1937,2017,26381,4771,10154,2370,3423,20718
53,Ethiopia,2021,ETH-21/DDA-3379/RA2/H/INGO/20016,5/26/2022 8:32:32 AM,Overall,15937,23909,3459,3602,46907,7795,15497,3764,5327,32383
53,Ethiopia,2021,ETH-21/DDA-3379/RA2/H/INGO/20040,9/21/2022 8:37:40 AM,Host Communities,1911,1989,4459,4641,13000,1911,2508,1047,1009,6475
53,Ethiopia,2021,ETH-21/DDA-3379/RA2/H/INGO/20040,9/21/2022 8:37:40 AM,Internally Displaced People,2058,2142,4802,4998,14000,6841,7850,5633,6789,27113
53,Ethiopia,2021,ETH-21/DDA-3379/RA2/H/INGO/20040,9/21/2022 8:37:40 AM,Overall,3969,4131,9261,9639,27000,8752,10358,6680,7798,33588
53,Ethiopia,2021,ETH-21/DDA-3379/RA2/H/INGO/20091,12/5/2022 6:12:03 AM,Host Communities,23433,36401,4771,4965,69570,13029,44305,2833,3830,63997
53,Ethiopia,2021,ETH-21/DDA-3379/RA2/H/INGO/20091,12/5/2022 6:12:03 AM,Internally Displaced People,3899,6424,841,877,12041,686,1911,149,202,2948
53,Ethiopia,2021,ETH-21/DDA-3379/RA2/H/INGO/20091,12/5/2022 6:12:03 AM,Overall,27332,42825,5612,5842,81611,13715,46216,2982,4032,66945
53,Ethiopia,2021,ETH-21/DDA-3379/RA2/H/NGO/20023,8/8/2022 4:33:00 AM,Host Communities,10165,14289,9114,9484,43052,17050,15765,13534,13683,60032
53,Ethiopia,2021,ETH-21/DDA-3379/RA2/H/NGO/20023,8/8/2022 4:33:00 AM,Internally Displaced People,6434,9045,5769,6004,27252,5520,5823,2436,2607,16386
53,Ethiopia,2021,ETH-21/DDA-3379/RA2/H/NGO/20023,8/8/2022 4:33:00 AM,Overall,16599,23334,14883,15488,70304,22570,21588,15970,16290,76418
53,Ethiopia,2021,ETH-21/DDA-3379/RA2/H/UN/20050,10/3/2022 12:20:04 PM,Host Communities,11041,15244,3714,4000,33999,4006,5570,434,474,10484
53,Ethiopia,2021,ETH-21/DDA-3379/RA2/H/UN/20050,10/3/2022 12:20:04 PM,Internally Displaced People,17749,20942,4115,4007,46813,32124,33262,6868,7822,80076
53,Ethiopia,2021,ETH-21/DDA-3379/RA2/H/UN/20050,10/3/2022 12:20:04 PM,Overall,28790,36186,7829,8007,80812,36130,38832,7302,8296,90560
53,Ethiopia,2021,ETH-21/DDA-3379/RA2/H/UN/20054,9/16/2022 9:16:35 AM,Host Communities,280338,282549,325915,334514,1223316,272631,289580,315709,341989,1219909
53,Ethiopia,2021,ETH-21/DDA-3379/RA2/H/UN/20054,9/16/2022 9:16:35 AM,Internally Displaced People,529240,533415,615019,631518,2309192,519615,541029,595453,636246,2292343
53,Ethiopia,2021,ETH-21/DDA-3379/RA2/H/UN/20054,9/16/2022 9:16:35 AM,Overall,809578,815964,940934,966032,3532508,792246,830609,911162,978235,3512252
53,Ethiopia,2021,ETH-21/DDA-3379/RA2/H/UN/20056,11/21/2022 8:26:04 AM,Host Communities,4416,10348,2944,6869,24577,4359,10270,2869,7037,24535
53,Ethiopia,2021,ETH-21/DDA-3379/RA2/H/UN/20056,11/21/2022 8:26:04 AM,Internally Displaced People,7360,17174,4907,11449,40890,6950,15927,4298,10912,38087
53,Ethiopia,2021,ETH-21/DDA-3379/RA2/H/UN/20056,11/21/2022 8:26:04 AM,Overall,14720,34392,9814,22898,81824,14227,33200,9006,22556,78989
53,Ethiopia,2021,ETH-21/DDA-3379/RA2/H/UN/20056,11/21/2022 8:26:04 AM,Returnees,2944,6870,1963,4580,16357,2918,7003,1839,4607,16367
53,Ethiopia,2021,ETH-21/DDA-3379/RA2/H-P/INGO/20081,12/7/2022 4:44:09 AM,Host Communities,2709,3321,1180,1554,8764,955,1231,1052,873,4111
53,Ethiopia,2021,ETH-21/DDA-3379/RA2/H-P/INGO/20081,12/7/2022 4:44:09 AM,Internally Displaced People,10317,12745,4488,5987,33537,464,591,215,216,1486
53,Ethiopia,2021,ETH-21/DDA-3379/RA2/H-P/INGO/20081,12/7/2022 4:44:09 AM,Overall,13026,16066,5668,7541,42301,1419,1822,1267,1089,5597
53,Ethiopia,2021,ETH-21/DDA-3379/RA2/H-P-N/INGO/20082,10/3/2022 11:55:33 AM,Host Communities,6565,21923,16939,17797,63224,13374,46405,70128,72872,202779
53,Ethiopia,2021,ETH-21/DDA-3379/RA2/H-P-N/INGO/20082,10/3/2022 11:55:33 AM,Internally Displaced People,1976,14695,6643,7633,30947,4773,8694,2540,3163,19170
53,Ethiopia,2021,ETH-21/DDA-3379/RA2/H-P-N/INGO/20082,10/3/2022 11:55:33 AM,Overall,8541,36618,23582,25430,94171,18147,55099,72668,76035,221949
53,Ethiopia,2021,ETH-21/DDA-3379/RA2/N/INGO/20015,7/26/2022 5:33:17 AM,Host Communities,80,4775,3922,4082,12859,114,14545,6075,6324,27058
53,Ethiopia,2021,ETH-21/DDA-3379/RA2/N/INGO/20015,7/26/2022 5:33:17 AM,Internally Displaced People,1285,10300,10111,10609,32305,0,17617,11051,11500,40168
53,Ethiopia,2021,ETH-21/DDA-3379/RA2/N/INGO/20015,7/26/2022 5:33:17 AM,Overall,1365,15075,14033,14691,45164,114,32162,17126,17824,67226
53,Ethiopia,2021,ETH-21/DDA-3379/RA2/N/INGO/20039,11/21/2022 9:02:41 AM,Host Communities,0,15178,16373,16231,47782,824,13039,16902,16976,47741
53,Ethiopia,2021,ETH-21/DDA-3379/RA2/N/INGO/20039,11/21/2022 9:02:41 AM,Internally Displaced People,0,6505,7017,6959,20481,9707,12749,1902,2146,26504
53,Ethiopia,2021,ETH-21/DDA-3379/RA2/N/INGO/20039,11/21/2022 9:02:41 AM,Overall,0,21683,23390,23190,68263,10531,25788,18804,19122,74245
53,Ethiopia,2021,ETH-21/DDA-3379/RA2/N/INGO/20044,10/18/2022 10:10:23 AM,Host Communities,0,2000,4125,4193,10318,0,5056,4995,5411,15462
53,Ethiopia,2021,ETH-21/DDA-3379/RA2/N/INGO/20044,10/18/2022 10:10:23 AM,Internally Displaced People,0,126,175,175,476,0,381,376,407,1164
53,Ethiopia,2021,ETH-21/DDA-3379/RA2/N/INGO/20044,10/18/2022 10:10:23 AM,Overall,0,2126,4300,4368,10794,0,5437,5371,5818,16626
53,Ethiopia,2021,ETH-21/DDA-3379/RA2/N/INGO/20058,9/14/2022 7:19:08 AM,Host Communities,18,16108,11411,11671,39208,1078,18337,13129,12654,45198
53,Ethiopia,2021,ETH-21/DDA-3379/RA2/N/INGO/20058,9/14/2022 7:19:08 AM,Internally Displaced People,247,310,161,153,871,0,0,0,0,0
53,Ethiopia,2021,ETH-21/DDA-3379/RA2/N/INGO/20058,9/14/2022 7:19:08 AM,Overall,265,16418,11572,11824,40079,1078,18337,13129,12654,45198
53,Ethiopia,2021,ETH-21/DDA-3379/RA2/N/INGO/20064,8/3/2023 6:38:22 AM,Host Communities,34166,35418,26833,27214,123631,28712,29701,21870,24691,104974
53,Ethiopia,2021,ETH-21/DDA-3379/RA2/N/INGO/20064,8/3/2023 6:38:22 AM,Internally Displaced People,454,410,364,386,1614,354,363,272,261,1250
53,Ethiopia,2021,ETH-21/DDA-3379/RA2/N/INGO/20064,8/3/2023 6:38:22 AM,Overall,34620,35828,27197,27600,125245,29066,30064,22142,24952,106224
53,Ethiopia,2021,ETH-21/DDA-3379/RA2/N/INGO/20093,11/22/2022 6:31:06 AM,Host Communities,2799,34718,19034,19811,76362,1977,24466,22988,24735,74166
53,Ethiopia,2021,ETH-21/DDA-3379/RA2/N/INGO/20093,11/22/2022 6:31:06 AM,Internally Displaced People,806,1052,163,197,2218,38,560,812,702,2112
53,Ethiopia,2021,ETH-21/DDA-3379/RA2/N/INGO/20093,11/22/2022 6:31:06 AM,Overall,3605,35770,19197,20008,78580,2015,25026,23800,25437,76278
53,Ethiopia,2021,ETH-21/DDA-3379/RA2/N/INGO/20102,12/6/2022 5:47:12 AM,Host Communities,4248,46942,18626,19386,89202,10482,81406,2473,2593,96954
53,Ethiopia,2021,ETH-21/DDA-3379/RA2/N/INGO/20102,12/6/2022 5:47:12 AM,Internally Displaced People,298,4035,1465,1524,7322,524,4070,124,130,4848
53,Ethiopia,2021,ETH-21/DDA-3379/RA2/N/INGO/20102,12/6/2022 5:47:12 AM,Overall,4546,50977,20091,20910,96524,11006,85476,2597,2723,101802
53,Ethiopia,2021,ETH-21/DDA-3379/RA2/N/NGO/20088,9/14/2022 7:05:43 AM,Host Communities,1000,5687,12437,12963,32087,3122,29052,13842,16433,62449
53,Ethiopia,2021,ETH-21/DDA-3379/RA2/N/NGO/20088,9/14/2022 7:05:43 AM,Internally Displaced People,0,440,948,962,2350,1078,4056,368,1882,7384
53,Ethiopia,2021,ETH-21/DDA-3379/RA2/N/NGO/20088,9/14/2022 7:05:43 AM,Overall,1000,6127,13385,13925,34437,4200,33108,14210,18315,69833
53,Ethiopia,2021,ETH-21/DDA-3379/RA2/N/UN/20022,10/25/2022 11:33:45 AM,Host Communities,0,0,3535,3535,7070,0,0,3377,3377,6754
53,Ethiopia,2021,ETH-21/DDA-3379/RA2/N/UN/20022,10/25/2022 11:33:45 AM,Internally Displaced People,0,0,884,884,1768,0,0,1202,1202,2404
53,Ethiopia,2021,ETH-21/DDA-3379/RA2/N/UN/20022,10/25/2022 11:33:45 AM,Overall,0,0,4419,4419,8838,0,0,4579,4579,9158
53,Ethiopia,2021,ETH-21/DDA-3379/RA2/N/UN/20098,10/18/2022 10:01:55 AM,Host Communities,0,2600,3822,3978,10400,0,3546,3467,3608,10621
53,Ethiopia,2021,ETH-21/DDA-3379/RA2/N/UN/20098,10/18/2022 10:01:55 AM,Overall,0,2600,3822,3978,10400,0,3546,3467,3608,10621
53,Ethiopia,2021,ETH-21/DDA-3379/RA2/N/UN/20108,9/15/2022 8:55:24 AM,Host Communities,0,0,351,294,645,0,0,397,283,680
53,Ethiopia,2021,ETH-21/DDA-3379/RA2/N/UN/20108,9/15/2022 8:55:24 AM,Internally Displaced People,0,0,820,685,1505,0,0,883,671,1554
53,Ethiopia,2021,ETH-21/DDA-3379/RA2/N/UN/20108,9/15/2022 8:55:24 AM,Overall,0,0,1171,979,2150,0,0,1280,954,2234
53,Ethiopia,2021,ETH-21/DDA-3379/RA2/NFI/ES/INGO/20032,9/14/2022 7:20:41 AM,Host Communities,131,142,89,95,457,181,192,189,195,757
53,Ethiopia,2021,ETH-21/DDA-3379/RA2/NFI/ES/INGO/20032,9/14/2022 7:20:41 AM,Internally Displaced People,1183,1282,805,838,4108,1356,1493,1282,1147,5278
53,Ethiopia,2021,ETH-21/DDA-3379/RA2/NFI/ES/INGO/20032,9/14/2022 7:20:41 AM,Overall,1314,1424,894,933,4565,1537,1685,1471,1342,6035
53,Ethiopia,2021,ETH-21/DDA-3379/RA2/NFI/ES/INGO/20061,8/23/2023 4:38:40 AM,Internally Displaced People,2113,2688,4140,4140,13081,1413,1952,2778,2750,8893
53,Ethiopia,2021,ETH-21/DDA-3379/RA2/NFI/ES/INGO/20061,8/23/2023 4:38:40 AM,Overall,3833,4644,6975,6974,22426,3208,4010,5759,5728,18705
53,Ethiopia,2021,ETH-21/DDA-3379/RA2/NFI/ES/INGO/20061,8/23/2023 4:38:40 AM,Returnees,1720,1956,2835,2834,9345,1795,2058,2981,2978,9812
53,Ethiopia,2021,ETH-21/DDA-3379/RA2/NFI/ES/INGO/20071,12/5/2022 6:47:06 AM,Internally Displaced People,3012,2316,1432,1490,8250,2600,4100,825,725,8250
53,Ethiopia,2021,ETH-21/DDA-3379/RA2/NFI/ES/INGO/20071,12/5/2022 6:47:06 AM,Overall,3012,2316,1432,1490,8250,2600,4100,825,725,8250
53,Ethiopia,2021,ETH-21/DDA-3379/RA2/NFI/ES/INGO/20079,11/21/2022 9:06:30 AM,Internally Displaced People,701,789,130,148,1768,880,663,104,121,1768
53,Ethiopia,2021,ETH-21/DDA-3379/RA2/NFI/ES/INGO/20079,11/21/2022 9:06:30 AM,Overall,1108,1248,224,260,2840,1201,1198,218,223,2840
53,Ethiopia,2021,ETH-21/DDA-3379/RA2/NFI/ES/INGO/20079,11/21/2022 9:06:30 AM,Returnees,407,459,94,112,1072,321,535,114,102,1072
53,Ethiopia,2021,ETH-21/DDA-3379/RA2/NFI/ES/INGO/20087,10/3/2022 11:51:16 AM,Internally Displaced People,2311,2456,4767,4911,14445,1788,2075,3818,4149,11830
53,Ethiopia,2021,ETH-21/DDA-3379/RA2/NFI/ES/INGO/20087,10/3/2022 11:51:16 AM,Overall,2311,2456,4767,4911,14445,1788,2075,3818,4149,11830
53,Ethiopia,2021,ETH-21/DDA-3379/RA2/NFI/ES/INGO/20101,8/28/2023 6:37:30 AM,Internally Displaced People,7041,7229,7452,7263,28985,5206,5635,6623,6843,24307
53,Ethiopia,2021,ETH-21/DDA-3379/RA2/NFI/ES/INGO/20101,8/28/2023 6:37:30 AM,Overall,7041,7229,7452,7263,28985,5206,5635,6623,6843,24307
53,Ethiopia,2021,ETH-21/DDA-3379/RA2/NFI/ES/NGO/20074,9/21/2022 8:42:43 AM,Host Communities,250,250,300,350,1150,250,260,300,360,1170
53,Ethiopia,2021,ETH-21/DDA-3379/RA2/NFI/ES/NGO/20074,9/21/2022 8:42:43 AM,Internally Displaced People,1100,1800,1000,1000,4900,1100,2475,1000,1060,5635
53,Ethiopia,2021,ETH-21/DDA-3379/RA2/NFI/ES/NGO/20074,9/21/2022 8:42:43 AM,Overall,1350,2050,1300,1350,6050,1350,2735,1300,1420,6805
53,Ethiopia,2021,ETH-21/DDA-3379/RA2/NFI/ES/UN/20059,11/21/2022 8:37:52 AM,Host Communities,168,184,216,232,800,0,0,0,0,0
53,Ethiopia,2021,ETH-21/DDA-3379/RA2/NFI/ES/UN/20059,11/21/2022 8:37:52 AM,Internally Displaced People,4439,4862,5708,6111,21120,4978,5280,6079,6301,22638
53,Ethiopia,2021,ETH-21/DDA-3379/RA2/NFI/ES/UN/20059,11/21/2022 8:37:52 AM,Overall,4896,5362,6295,6742,23295,5262,5576,6363,6620,23821
53,Ethiopia,2021,ETH-21/DDA-3379/RA2/NFI/ES/UN/20059,11/21/2022 8:37:52 AM,Returnees,289,316,371,399,1375,284,296,284,319,1183
53,Ethiopia,2021,ETH-21/DDA-3379/RA2/NFI/ES/UN/20103,10/3/2022 1:15:31 PM,Internally Displaced People,5385,5605,0,0,10990,5385,5605,0,0,10990
53,Ethiopia,2021,ETH-21/DDA-3379/RA2/NFI/ES/UN/20103,10/3/2022 1:15:31 PM,Overall,5385,5605,0,0,10990,5385,5605,0,0,10990
53,Ethiopia,2021,ETH-21/DDA-3379/RA2/P/INGO/20020,4/19/2023 7:22:47 AM,Host Communities,2000,2000,500,500,5000,46,38,38,36,158
53,Ethiopia,2021,ETH-21/DDA-3379/RA2/P/INGO/20020,4/19/2023 7:22:47 AM,Internally Displaced People,5000,5000,2000,2000,14000,1518,2131,349,458,4456
53,Ethiopia,2021,ETH-21/DDA-3379/RA2/P/INGO/20020,4/19/2023 7:22:47 AM,Overall,7000,7000,2500,2500,19000,1564,2169,387,494,4614
53,Ethiopia,2021,ETH-21/DDA-3379/RA2/P/INGO/20057,10/3/2022 11:23:56 AM,Internally Displaced People,20278,22704,10660,12480,66122,14586,17132,16683,18175,66576
53,Ethiopia,2021,ETH-21/DDA-3379/RA2/P/INGO/20057,10/3/2022 11:23:56 AM,Overall,20278,22704,10660,12480,66122,14586,17132,16683,18175,66576
53,Ethiopia,2021,ETH-21/DDA-3379/RA2/P/INGO/20089,1/17/2023 10:03:17 AM,Host Communities,428,4524,1436,2056,8444,1135,2804,1813,1196,6948
53,Ethiopia,2021,ETH-21/DDA-3379/RA2/P/INGO/20089,1/17/2023 10:03:17 AM,Internally Displaced People,1000,10552,3376,4828,19756,3450,8628,4032,3951,20061
53,Ethiopia,2021,ETH-21/DDA-3379/RA2/P/INGO/20089,1/17/2023 10:03:17 AM,Overall,1428,15076,4812,6884,28200,4585,11432,5845,5147,27009
53,Ethiopia,2021,ETH-21/DDA-3379/RA2/P/INGO/20106,11/21/2022 9:10:25 AM,Host Communities,95991,126982,67209,79708,369890,24222,40336,26655,29290,120503
53,Ethiopia,2021,ETH-21/DDA-3379/RA2/P/INGO/20106,11/21/2022 9:10:25 AM,Internally Displaced People,28312,28398,15633,21571,93914,12474,20774,13727,15095,62070
53,Ethiopia,2021,ETH-21/DDA-3379/RA2/P/INGO/20106,11/21/2022 9:10:25 AM,Overall,124303,155380,82842,101279,463804,36696,61110,40382,44385,182573
53,Ethiopia,2021,ETH-21/DDA-3379/RA2/P/NGO/20038,1/3/2023 6:08:13 AM,Host Communities,2000,4000,2000,4500,12500,3962,4534,2696,2808,14000
53,Ethiopia,2021,ETH-21/DDA-3379/RA2/P/NGO/20038,1/3/2023 6:08:13 AM,Internally Displaced People,8000,15500,6500,11000,41000,12418,18026,4737,5919,41100
53,Ethiopia,2021,ETH-21/DDA-3379/RA2/P/NGO/20038,1/3/2023 6:08:13 AM,Overall,10000,19500,8500,15500,53500,16380,22560,7433,8727,55100
53,Ethiopia,2021,ETH-21/DDA-3379/RA2/P/UN/20053,10/17/2022 5:15:40 AM,Host Communities,290,328,175,225,1018,973,1167,203,215,2558
53,Ethiopia,2021,ETH-21/DDA-3379/RA2/P/UN/20053,10/17/2022 5:15:40 AM,Internally Displaced People,16470,21453,2476,3348,43747,31215,35825,6835,7297,81172
53,Ethiopia,2021,ETH-21/DDA-3379/RA2/P/UN/20053,10/17/2022 5:15:40 AM,Overall,18336,23645,4140,5217,51338,37058,42511,8091,8635,96295
53,Ethiopia,2021,ETH-21/DDA-3379/RA2/P/UN/20053,10/17/2022 5:15:40 AM,Returnees,1576,1864,1489,1644,6573,4870,5519,1053,1123,12565
53,Ethiopia,2021,ETH-21/DDA-3379/RA2/P/UN/20097,1/30/2023 11:28:59 AM,Host Communities,2300,2200,1000,900,6400,2401,2277,1058,978,6714
53,Ethiopia,2021,ETH-21/DDA-3379/RA2/P/UN/20097,1/30/2023 11:28:59 AM,Internally Displaced People,5000,5500,1700,1800,14000,6163,6617,1857,1810,16447
53,Ethiopia,2021,ETH-21/DDA-3379/RA2/P/UN/20097,1/30/2023 11:28:59 AM,Other,50,50,25,25,150,47,50,21,32,150
53,Ethiopia,2021,ETH-21/DDA-3379/RA2/P/UN/20097,1/30/2023 11:28:59 AM,Overall,9850,10250,3425,3525,27050,11225,11449,3631,3675,29980
53,Ethiopia,2021,ETH-21/DDA-3379/RA2/P/UN/20097,1/30/2023 11:28:59 AM,Returnees,2500,2500,700,800,6500,2614,2505,695,855,6669
53,Ethiopia,2021,ETH-21/DDA-3379/RA2/P/UN/20109,1/9/2023 12:23:22 PM,Host Communities,834,1485,1639,1081,5039,7425,7925,7470,8207,31027
53,Ethiopia,2021,ETH-21/DDA-3379/RA2/P/UN/20109,1/9/2023 12:23:22 PM,Internally Displaced People,834,1486,1639,1082,5041,4853,7302,4417,5380,21952
53,Ethiopia,2021,ETH-21/DDA-3379/RA2/P/UN/20109,1/9/2023 12:23:22 PM,Overall,1668,2971,3278,2163,10080,12278,15227,11887,13587,52979
53,Ethiopia,2021,ETH-21/DDA-3379/RA2/WASH/INGO/20011,9/14/2022 7:24:28 AM,Host Communities,14998,18330,24163,25829,83320,14998,18330,24163,25829,83320
53,Ethiopia,2021,ETH-21/DDA-3379/RA2/WASH/INGO/20011,9/14/2022 7:24:28 AM,Internally Displaced People,2256,2757,3635,3885,12533,2256,2757,3635,3885,12533
53,Ethiopia,2021,ETH-21/DDA-3379/RA2/WASH/INGO/20011,9/14/2022 7:24:28 AM,Overall,17254,21087,27798,29714,95853,17254,21087,27798,29714,95853
53,Ethiopia,2021,ETH-21/DDA-3379/RA2/WASH/INGO/20013,8/14/2023 5:50:52 AM,Host Communities,10693,15038,4582,4770,35083,8556,8905,3667,3817,24945
53,Ethiopia,2021,ETH-21/DDA-3379/RA2/WASH/INGO/20013,8/14/2023 5:50:52 AM,Internally Displaced People,25811,22956,11062,11513,71342,19964,20779,8556,8905,58204
53,Ethiopia,2021,ETH-21/DDA-3379/RA2/WASH/INGO/20013,8/14/2023 5:50:52 AM,Overall,36504,37994,15644,16283,106425,28520,29684,12223,12722,83149
53,Ethiopia,2021,ETH-21/DDA-3379/RA2/WASH/INGO/20063,10/18/2022 10:12:24 AM,Host Communities,5422,5783,3433,3432,18070,949,1061,630,629,3269
53,Ethiopia,2021,ETH-21/DDA-3379/RA2/WASH/INGO/20063,10/18/2022 10:12:24 AM,Internally Displaced People,21546,22980,13645,13647,71818,26653,28176,17062,16554,88445
53,Ethiopia,2021,ETH-21/DDA-3379/RA2/WASH/INGO/20063,10/18/2022 10:12:24 AM,Overall,26968,28763,17078,17079,89888,27602,29237,17692,17183,91714
53,Ethiopia,2021,ETH-21/DDA-3379/RA2/WASH/INGO/20070,11/21/2022 9:13:51 AM,Internally Displaced People,3800,4200,5800,6200,20000,0,575,0,321,896
53,Ethiopia,2021,ETH-21/DDA-3379/RA2/WASH/INGO/20070,11/21/2022 9:13:51 AM,Other,13034,14406,19894,21266,68600,21947,22432,22490,23607,90476
53,Ethiopia,2021,ETH-21/DDA-3379/RA2/WASH/INGO/20070,11/21/2022 9:13:51 AM,Overall,16834,18606,25694,27466,88600,21947,23007,22490,23928,91372
53,Ethiopia,2021,ETH-21/DDA-3379/RA2/WASH/INGO/20076,4/19/2023 7:26:56 AM,Host Communities,47369,10927,11893,12450,82639,30051,30290,12889,14328,87558
53,Ethiopia,2021,ETH-21/DDA-3379/RA2/WASH/INGO/20076,4/19/2023 7:26:56 AM,Internally Displaced People,7411,7735,8418,9015,32579,12111,13471,12621,13210,51413
53,Ethiopia,2021,ETH-21/DDA-3379/RA2/WASH/INGO/20076,4/19/2023 7:26:56 AM,Overall,54780,18662,20311,21465,115218,42162,43761,25510,27538,138971
53,Ethiopia,2021,ETH-21/DDA-3379/RA2/WASH/INGO/20078,3/6/2023 6:44:23 AM,Host Communities,14934,15487,12168,12721,55310,15281,15847,12452,13017,56597
53,Ethiopia,2021,ETH-21/DDA-3379/RA2/WASH/INGO/20078,3/6/2023 6:44:23 AM,Overall,32761,33975,26694,27907,121337,32582,32544,26421,27651,119198
53,Ethiopia,2021,ETH-21/DDA-3379/RA2/WASH/INGO/20078,3/6/2023 6:44:23 AM,Returnees,17827,18488,14526,15186,66027,17301,16697,13969,14634,62601
53,Ethiopia,2021,ETH-21/DDA-3379/RA2/WASH/INGO/20086,7/5/2023 12:48:12 PM,Host Communities,4326,5207,6123,6112,21768,2103,2037,2499,2420,9059
53,Ethiopia,2021,ETH-21/DDA-3379/RA2/WASH/INGO/20086,7/5/2023 12:48:12 PM,Internally Displaced People,3370,4045,4758,4740,16913,6309,6110,7497,7261,27177
53,Ethiopia,2021,ETH-21/DDA-3379/RA2/WASH/INGO/20086,7/5/2023 12:48:12 PM,Overall,7696,9252,10881,10852,38681,8412,8147,9996,9681,36236
53,Ethiopia,2021,ETH-21/DDA-3379/RA2/WASH/INGO/20105,10/3/2022 12:04:18 PM,Host Communities,911,935,964,940,3750,17149,15650,6428,5655,44882
53,Ethiopia,2021,ETH-21/DDA-3379/RA2/WASH/INGO/20105,10/3/2022 12:04:18 PM,Internally Displaced People,8198,8417,8677,8458,33750,2843,3558,2140,2577,11118
53,Ethiopia,2021,ETH-21/DDA-3379/RA2/WASH/INGO/20105,10/3/2022 12:04:18 PM,Overall,9109,9352,9641,9398,37500,19992,19208,8568,8232,56000
53,Ethiopia,2021,ETH-21/DDA-3379/RA2/WASH/NGO/20096,9/15/2022 8:06:58 AM,Host Communities,1398,1492,885,885,4660,1398,1631,699,933,4661
53,Ethiopia,2021,ETH-21/DDA-3379/RA2/WASH/NGO/20096,9/15/2022 8:06:58 AM,Internally Displaced People,13980,14912,8854,8854,46600,13989,16310,6990,9329,46618
53,Ethiopia,2021,ETH-21/DDA-3379/RA2/WASH/NGO/20096,9/15/2022 8:06:58 AM,Overall,15378,16404,9739,9739,51260,15387,17941,7689,10262,51279
53,Ethiopia,2021,ETH-21/DDA-3379/SA1/A/INGO/18548,3/6/2023 6:56:34 AM,Host Communities,68620,40127,17569,15180,141496,56017,36379,23894,16676,132966
53,Ethiopia,2021,ETH-21/DDA-3379/SA1/A/INGO/18548,3/6/2023 6:56:34 AM,Overall,68620,40127,17569,15180,141496,56017,36379,23894,16676,132966
53,Ethiopia,2021,ETH-21/DDA-3379/SA1/A/INGO/18567,6/17/2022 7:50:56 AM,Host Communities,25610,26650,13791,14349,80400,61436,24115,59027,25100,169678
53,Ethiopia,2021,ETH-21/DDA-3379/SA1/A/INGO/18567,6/17/2022 7:50:56 AM,Internally Displaced People,1147,1193,618,642,3600,717,746,386,401,2250
53,Ethiopia,2021,ETH-21/DDA-3379/SA1/A/INGO/18567,6/17/2022 7:50:56 AM,Overall,26757,27843,14409,14991,84000,62153,24861,59413,25501,171928
53,Ethiopia,2021,ETH-21/DDA-3379/SA1/A/INGO/18581,8/31/2022 8:51:02 AM,Host Communities,12632,13068,1829,1895,29424,5722,5726,10243,6925,28616
53,Ethiopia,2021,ETH-21/DDA-3379/SA1/A/INGO/18581,8/31/2022 8:51:02 AM,Overall,36102,37335,5225,5414,84076,16830,16842,30125,20367,84164
53,Ethiopia,2021,ETH-21/DDA-3379/SA1/A/INGO/18581,8/31/2022 8:51:02 AM,Returnees,23470,24267,3396,3519,54652,11108,11116,19882,13442,55548
53,Ethiopia,2021,ETH-21/DDA-3379/SA1/A/INGO/18589,5/23/2022 4:37:20 AM,Host Communities,17890,18506,12337,12954,61687,10539,11149,20613,21817,64118
53,Ethiopia,2021,ETH-21/DDA-3379/SA1/A/INGO/18589,5/23/2022 4:37:20 AM,Overall,17890,18506,12337,12954,61687,10539,11149,20613,21817,64118
53,Ethiopia,2021,ETH-21/DDA-3379/SA1/A/INGO/18632,3/30/2022 10:40:01 AM,Host Communities,3300,2200,10780,11220,27500,5597,5784,8778,8976,29135
53,Ethiopia,2021,ETH-21/DDA-3379/SA1/A/INGO/18632,3/30/2022 10:40:01 AM,Overall,3300,2200,10780,11220,27500,5597,5784,8778,8976,29135
53,Ethiopia,2021,ETH-21/DDA-3379/SA1/A/NGO/18574,7/26/2022 8:41:55 AM,Host Communities,7000,3000,0,0,10000,7000,3000,0,0,10000
53,Ethiopia,2021,ETH-21/DDA-3379/SA1/A/NGO/18574,7/26/2022 8:41:55 AM,Overall,7000,3000,0,0,10000,7000,3000,0,0,10000
53,Ethiopia,2021,ETH-21/DDA-3379/SA1/A-E-H-P/INGO/18580,10/18/2022 10:14:14 AM,Host Communities,9622,11044,11484,11358,43508,42187,78479,4362,6044,131072
53,Ethiopia,2021,ETH-21/DDA-3379/SA1/A-E-H-P/INGO/18580,10/18/2022 10:14:14 AM,Overall,32074,36812,38281,37861,145028,46047,85673,4542,6328,142590
53,Ethiopia,2021,ETH-21/DDA-3379/SA1/A-E-H-P/INGO/18580,10/18/2022 10:14:14 AM,Returnees,22452,25768,26797,26503,101520,3860,7194,180,284,11518
53,Ethiopia,2021,ETH-21/DDA-3379/SA1/A-WASH-NFI/ES-E/INGO/18557,10/3/2022 12:13:38 PM,Host Communities,6300,14700,1892,1357,24249,15131,17691,1844,1451,36117
53,Ethiopia,2021,ETH-21/DDA-3379/SA1/A-WASH-NFI/ES-E/INGO/18557,10/3/2022 12:13:38 PM,Other,30,16,0,0,46,123,70,0,0,193
53,Ethiopia,2021,ETH-21/DDA-3379/SA1/A-WASH-NFI/ES-E/INGO/18557,10/3/2022 12:13:38 PM,Overall,12630,29416,2704,1939,46689,21817,25264,2753,2374,52208
53,Ethiopia,2021,ETH-21/DDA-3379/SA1/A-WASH-NFI/ES-E/INGO/18557,10/3/2022 12:13:38 PM,Returnees,6300,14700,812,582,22394,6563,7503,909,923,15898
53,Ethiopia,2021,ETH-21/DDA-3379/SA1/CCCM/INGO/18607,11/21/2022 8:28:37 AM,Host Communities,1010,1278,492,528,3308,2989,3779,1479,1592,9839
53,Ethiopia,2021,ETH-21/DDA-3379/SA1/CCCM/INGO/18607,11/21/2022 8:28:37 AM,Internally Displaced People,4116,5205,2037,2192,13550,12305,15569,5994,6432,40300
53,Ethiopia,2021,ETH-21/DDA-3379/SA1/CCCM/INGO/18607,11/21/2022 8:28:37 AM,Overall,5126,6483,2529,2720,16858,15294,19348,7473,8024,50139
53,Ethiopia,2021,ETH-21/DDA-3379/SA1/CCCM/NGO/18631,9/21/2022 2:04:48 PM,Internally Displaced People,11420,12180,7232,7232,38064,11420,12180,7232,7232,38064
53,Ethiopia,2021,ETH-21/DDA-3379/SA1/CCCM/NGO/18631,9/21/2022 2:04:48 PM,Overall,11420,12180,7232,7232,38064,11420,12180,7232,7232,38064
53,Ethiopia,2021,ETH-21/DDA-3379/SA1/CCCM/UN/18601,9/15/2022 7:37:05 AM,Host Communities,4694,4684,6725,6759,22862,6384,6392,9185,9227,31188
53,Ethiopia,2021,ETH-21/DDA-3379/SA1/CCCM/UN/18601,9/15/2022 7:37:05 AM,Internally Displaced People,38228,38134,54837,55115,186314,52406,52423,75448,75840,256117
53,Ethiopia,2021,ETH-21/DDA-3379/SA1/CCCM/UN/18601,9/15/2022 7:37:05 AM,Overall,42922,42818,61562,61874,209176,58790,58815,84633,85067,287305
53,Ethiopia,2021,ETH-21/DDA-3379/SA1/E/INGO/18645,12/6/2022 8:29:19 AM,Host Communities,30,31,833,833,1727,126,44,2592,2433,5195
53,Ethiopia,2021,ETH-21/DDA-3379/SA1/E/INGO/18645,12/6/2022 8:29:19 AM,Internally Displaced People,267,267,7500,7501,15535,133,89,5608,4267,10097
53,Ethiopia,2021,ETH-21/DDA-3379/SA1/E/INGO/18645,12/6/2022 8:29:19 AM,Overall,297,298,8333,8334,17262,259,133,8200,6700,15292
53,Ethiopia,2021,ETH-21/DDA-3379/SA1/E-A-N/INGO/18573,4/17/2022 3:44:43 PM,Internally Displaced People,20085,20998,24650,25563,91296,20085,20998,24650,25563,91296
53,Ethiopia,2021,ETH-21/DDA-3379/SA1/E-A-N/INGO/18573,4/17/2022 3:44:43 PM,Overall,20085,20998,24650,25563,91296,20085,20998,24650,25563,91296
53,Ethiopia,2021,ETH-21/DDA-3379/SA1/E-N-A/INGO/18594,12/22/2022 4:40:55 AM,Host Communities,3127,3684,4981,5230,17022,6410,7552,10210,10721,34893
53,Ethiopia,2021,ETH-21/DDA-3379/SA1/E-N-A/INGO/18594,12/22/2022 4:40:55 AM,Internally Displaced People,826,967,1248,1404,4445,1246,1467,1984,2083,6780
53,Ethiopia,2021,ETH-21/DDA-3379/SA1/E-N-A/INGO/18594,12/22/2022 4:40:55 AM,Overall,3953,4651,6229,6634,21467,7656,9019,12194,12804,41673
53,Ethiopia,2021,ETH-21/DDA-3379/SA1/E-N-P/NGO/18560,7/26/2022 5:35:36 AM,Host Communities,6217,4501,6332,7849,24899,6197,4525,6121,7760,24603
53,Ethiopia,2021,ETH-21/DDA-3379/SA1/E-N-P/NGO/18560,7/26/2022 5:35:36 AM,Internally Displaced People,3425,3934,4234,5435,17028,3124,3765,4110,5276,16275
53,Ethiopia,2021,ETH-21/DDA-3379/SA1/E-N-P/NGO/18560,7/26/2022 5:35:36 AM,Overall,9642,8435,10566,13284,41927,9321,8290,10231,13036,40878
53,Ethiopia,2021,ETH-21/DDA-3379/SA1/E-P-NFI/ES/INGO/18620,11/22/2022 6:42:57 AM,Host Communities,48539,50052,20802,23554,142947,7094,4538,16240,25625,53497
53,Ethiopia,2021,ETH-21/DDA-3379/SA1/E-P-NFI/ES/INGO/18620,11/22/2022 6:42:57 AM,Internally Displaced People,7068,6683,3029,3145,19925,4730,3025,10827,17084,35666
53,Ethiopia,2021,ETH-21/DDA-3379/SA1/E-P-NFI/ES/INGO/18620,11/22/2022 6:42:57 AM,Overall,55607,56735,23831,26699,162872,11824,7563,27067,42709,89163
53,Ethiopia,2021,ETH-21/DDA-3379/SA1/E-P-WASH-N/INGO/18644,2/5/2023 8:33:37 AM,Host Communities,5033,9981,14239,11922,41175,3941,7243,13684,10870,35738
53,Ethiopia,2021,ETH-21/DDA-3379/SA1/E-P-WASH-N/INGO/18644,2/5/2023 8:33:37 AM,Internally Displaced People,24188,28106,41725,40623,134642,15991,25640,34217,31654,107502
53,Ethiopia,2021,ETH-21/DDA-3379/SA1/E-P-WASH-N/INGO/18644,2/5/2023 8:33:37 AM,Overall,29221,38087,55964,52545,175817,19932,32883,47901,42524,143240
53,Ethiopia,2021,ETH-21/DDA-3379/SA1/H/INGO/18520,11/22/2022 6:04:12 AM,Host Communities,28642,36282,4543,4730,74197,44300,261185,246,261,305992
53,Ethiopia,2021,ETH-21/DDA-3379/SA1/H/INGO/18520,11/22/2022 6:04:12 AM,Internally Displaced People,12325,19310,2530,2634,36799,0,0,0,0,0
53,Ethiopia,2021,ETH-21/DDA-3379/SA1/H/INGO/18520,11/22/2022 6:04:12 AM,Overall,40967,55592,7073,7364,110996,44300,261185,246,261,305992
53,Ethiopia,2021,ETH-21/DDA-3379/SA1/H/INGO/18653,9/14/2022 7:26:53 AM,Host Communities,1852,1928,4322,4498,12600,2754,4349,2607,3252,12962
53,Ethiopia,2021,ETH-21/DDA-3379/SA1/H/INGO/18653,9/14/2022 7:26:53 AM,Internally Displaced People,3293,3427,7683,7997,22400,4896,7730,4635,5766,23027
53,Ethiopia,2021,ETH-21/DDA-3379/SA1/H/INGO/18653,9/14/2022 7:26:53 AM,Overall,5145,5355,12005,12495,35000,7650,12079,7242,9018,35989
53,Ethiopia,2021,ETH-21/DDA-3379/SA1/H/INGO/18655,3/6/2023 6:28:11 AM,Host Communities,245,708,153,154,1260,3386,4412,2028,1793,11619
53,Ethiopia,2021,ETH-21/DDA-3379/SA1/H/INGO/18655,3/6/2023 6:28:11 AM,Internally Displaced People,2204,6369,1373,1384,11330,8676,17341,6441,6458,38916
53,Ethiopia,2021,ETH-21/DDA-3379/SA1/H/INGO/18655,3/6/2023 6:28:11 AM,Overall,2449,7077,1526,1538,12590,12062,21753,8469,8251,50535
53,Ethiopia,2021,ETH-21/DDA-3379/SA1/H/NGO/18591,3/28/2022 11:01:57 AM,Host Communities,6343,7912,6348,6849,27452,7473,8839,12119,15273,43704
53,Ethiopia,2021,ETH-21/DDA-3379/SA1/H/NGO/18591,3/28/2022 11:01:57 AM,Internally Displaced People,2312,2937,2234,2835,10318,2312,2412,3101,2943,10768
53,Ethiopia,2021,ETH-21/DDA-3379/SA1/H/NGO/18591,3/28/2022 11:01:57 AM,Overall,8655,10849,8582,9684,37770,9785,11251,15220,18216,54472
53,Ethiopia,2021,ETH-21/DDA-3379/SA1/H/NGO/18592,5/23/2022 4:35:07 AM,Host Communities,17199,24178,15422,16048,72847,44793,48058,13644,14783,121278
53,Ethiopia,2021,ETH-21/DDA-3379/SA1/H/NGO/18592,5/23/2022 4:35:07 AM,Internally Displaced People,18874,26532,16923,17611,79940,992,1215,274,313,2794
53,Ethiopia,2021,ETH-21/DDA-3379/SA1/H/NGO/18592,5/23/2022 4:35:07 AM,Overall,36073,50710,32345,33659,152787,45785,49273,13918,15096,124072
53,Ethiopia,2021,ETH-21/DDA-3379/SA1/H/NGO/18612,4/17/2022 2:52:40 PM,Host Communities,4428,6641,4428,6641,22138,29221,36948,1106,1613,68888
53,Ethiopia,2021,ETH-21/DDA-3379/SA1/H/NGO/18612,4/17/2022 2:52:40 PM,Internally Displaced People,16822,17112,7270,6658,47862,22319,20996,989,1266,45570
53,Ethiopia,2021,ETH-21/DDA-3379/SA1/H/NGO/18612,4/17/2022 2:52:40 PM,Overall,21250,23753,11698,13299,70000,51540,57944,2095,2879,114458
53,Ethiopia,2021,ETH-21/DDA-3379/SA1/H/UN/18534,8/31/2022 8:54:02 AM,Host Communities,3368,3505,3649,3798,14320,3594,3740,3893,4052,15279
53,Ethiopia,2021,ETH-21/DDA-3379/SA1/H/UN/18534,8/31/2022 8:54:02 AM,Internally Displaced People,4119,4299,4488,4685,17591,4395,4587,4789,4999,18770
53,Ethiopia,2021,ETH-21/DDA-3379/SA1/H/UN/18534,8/31/2022 8:54:02 AM,Overall,7833,8152,8486,8832,33303,8358,8698,9054,9423,35533
53,Ethiopia,2021,ETH-21/DDA-3379/SA1/H/UN/18534,8/31/2022 8:54:02 AM,Refugees,346,348,349,349,1392,369,371,372,372,1484
53,Ethiopia,2021,ETH-21/DDA-3379/SA1/H/UN/18600,6/29/2022 8:21:31 AM,Host Communities,1602,2392,496,541,5031,1503,2150,502,412,4567
53,Ethiopia,2021,ETH-21/DDA-3379/SA1/H/UN/18600,6/29/2022 8:21:31 AM,Internally Displaced People,26029,44202,18320,16348,104899,34558,56165,14995,12598,118316
53,Ethiopia,2021,ETH-21/DDA-3379/SA1/H/UN/18600,6/29/2022 8:21:31 AM,Overall,27631,46594,18816,16889,109930,36061,58315,15497,13010,122883
53,Ethiopia,2021,ETH-21/DDA-3379/SA1/H/UN/18629,9/21/2022 2:07:21 PM,Host Communities,10605,11542,4545,4946,31638,10331,11615,4503,5049,31498
53,Ethiopia,2021,ETH-21/DDA-3379/SA1/H/UN/18629,9/21/2022 2:07:21 PM,Internally Displaced People,17675,19236,7575,8244,52730,17506,19462,7484,8343,52795
53,Ethiopia,2021,ETH-21/DDA-3379/SA1/H/UN/18629,9/21/2022 2:07:21 PM,Overall,35350,38472,15150,16488,105460,34798,38775,14978,16752,105303
53,Ethiopia,2021,ETH-21/DDA-3379/SA1/H/UN/18629,9/21/2022 2:07:21 PM,Returnees,7070,7694,3030,3298,21092,6961,7698,2991,3360,21010
53,Ethiopia,2021,ETH-21/DDA-3379/SA1/H-N-P-E/INGO/18565,10/18/2022 10:22:03 AM,Host Communities,3897,24887,5069,4413,38266,3343,17662,4347,4240,29592
53,Ethiopia,2021,ETH-21/DDA-3379/SA1/H-N-P-E/INGO/18565,10/18/2022 10:22:03 AM,Overall,3897,24887,5069,4413,38266,3343,17662,4347,4240,29592
53,Ethiopia,2021,ETH-21/DDA-3379/SA1/H-WASH-NFI/ES-P/INGO/18595,3/6/2023 7:01:02 AM,Host Communities,208632,299202,272708,231487,1012029,169555,173005,226575,201606,770741
53,Ethiopia,2021,ETH-21/DDA-3379/SA1/H-WASH-NFI/ES-P/INGO/18595,3/6/2023 7:01:02 AM,Internally Displaced People,526232,807732,802512,680191,2816667,508662,519011,679720,604817,2312210
53,Ethiopia,2021,ETH-21/DDA-3379/SA1/H-WASH-NFI/ES-P/INGO/18595,3/6/2023 7:01:02 AM,Overall,734864,1106934,1075220,911678,3828696,678217,692016,906295,806423,3082951
53,Ethiopia,2021,ETH-21/DDA-3379/SA1/N/INGO/18584,5/23/2022 4:44:30 AM,Host Communities,13609,101548,7282,7579,130018,7037,36817,2997,3632,50483
53,Ethiopia,2021,ETH-21/DDA-3379/SA1/N/INGO/18584,5/23/2022 4:44:30 AM,Overall,13609,101548,7282,7579,130018,7037,36817,2997,3632,50483
53,Ethiopia,2021,ETH-21/DDA-3379/SA1/N/INGO/18608,9/21/2022 2:08:42 PM,Host Communities,0,6765,12430,12540,31735,4652,15703,7859,8329,36543
53,Ethiopia,2021,ETH-21/DDA-3379/SA1/N/INGO/18608,9/21/2022 2:08:42 PM,Internally Displaced People,0,850,1943,2015,4808,518,1454,1786,1919,5677
53,Ethiopia,2021,ETH-21/DDA-3379/SA1/N/INGO/18608,9/21/2022 2:08:42 PM,Overall,0,7615,14373,14555,36543,5170,17157,9645,10248,42220
53,Ethiopia,2021,ETH-21/DDA-3379/SA1/N/INGO/18625,2/14/2022 6:55:39 AM,Host Communities,0,5967,5463,5685,17115,183,19414,6262,5990,31849
53,Ethiopia,2021,ETH-21/DDA-3379/SA1/N/INGO/18625,2/14/2022 6:55:39 AM,Internally Displaced People,0,185,168,177,530,0,194,172,177,543
53,Ethiopia,2021,ETH-21/DDA-3379/SA1/N/INGO/18625,2/14/2022 6:55:39 AM,Overall,0,6152,5631,5862,17645,183,19608,6434,6167,32392
53,Ethiopia,2021,ETH-21/DDA-3379/SA1/N/INGO/18634,6/29/2022 8:19:40 AM,Host Communities,0,19291,8639,8993,36923,0,21443,44281,45721,111445
53,Ethiopia,2021,ETH-21/DDA-3379/SA1/N/INGO/18634,6/29/2022 8:19:40 AM,Internally Displaced People,0,1107,219,225,1551,0,351,1353,1775,3479
53,Ethiopia,2021,ETH-21/DDA-3379/SA1/N/INGO/18634,6/29/2022 8:19:40 AM,Overall,0,20398,8858,9218,38474,0,21794,45634,47496,114924
53,Ethiopia,2021,ETH-21/DDA-3379/SA1/N/NGO/18590,4/17/2022 3:47:34 PM,Host Communities,5217,7501,2832,3321,18871,2903,4355,4133,4249,15640
53,Ethiopia,2021,ETH-21/DDA-3379/SA1/N/NGO/18590,4/17/2022 3:47:34 PM,Internally Displaced People,1920,1523,1034,1321,5798,2375,3563,1533,1889,9360
53,Ethiopia,2021,ETH-21/DDA-3379/SA1/N/NGO/18590,4/17/2022 3:47:34 PM,Overall,7137,9024,3866,4642,24669,5278,7918,5666,6138,25000
53,Ethiopia,2021,ETH-21/DDA-3379/SA1/N/NGO/18593,6/29/2022 9:39:49 AM,Host Communities,2100,4639,5025,5494,17258,2225,36096,7649,16615,62585
53,Ethiopia,2021,ETH-21/DDA-3379/SA1/N/NGO/18593,6/29/2022 9:39:49 AM,Internally Displaced People,300,1122,2209,2036,5667,403,9098,2360,7853,19714
53,Ethiopia,2021,ETH-21/DDA-3379/SA1/N/NGO/18593,6/29/2022 9:39:49 AM,Overall,2400,5761,7234,7530,22925,2628,45194,10009,24468,82299
53,Ethiopia,2021,ETH-21/DDA-3379/SA1/N/NGO/18609,5/23/2022 4:40:22 AM,Host Communities,650,2927,2993,2993,9563,440,3649,6569,6646,17304
53,Ethiopia,2021,ETH-21/DDA-3379/SA1/N/NGO/18609,5/23/2022 4:40:22 AM,Internally Displaced People,850,5070,8799,9159,23878,673,5474,10119,10140,26406
53,Ethiopia,2021,ETH-21/DDA-3379/SA1/N/NGO/18609,5/23/2022 4:40:22 AM,Overall,1500,7997,11792,12152,33441,1113,9123,16688,16786,43710
53,Ethiopia,2021,ETH-21/DDA-3379/SA1/N/UN/18633,7/4/2022 11:53:02 AM,Host Communities,0,0,375,375,750,0,0,388,389,777
53,Ethiopia,2021,ETH-21/DDA-3379/SA1/N/UN/18633,7/4/2022 11:53:02 AM,Internally Displaced People,0,0,875,875,1750,0,0,905,905,1810
53,Ethiopia,2021,ETH-21/DDA-3379/SA1/N/UN/18633,7/4/2022 11:53:02 AM,Overall,0,0,1250,1250,2500,0,0,1293,1294,2587
53,Ethiopia,2021,ETH-21/DDA-3379/SA1/N/UN/18654,4/22/2022 8:11:18 PM,Host Communities,0,2186,5989,6233,14408,0,2143,6957,7241,16341
53,Ethiopia,2021,ETH-21/DDA-3379/SA1/N/UN/18654,4/22/2022 8:11:18 PM,Overall,0,2186,5989,6233,14408,0,2143,6957,7241,16341
53,Ethiopia,2021,ETH-21/DDA-3379/SA1/NFI/ES/INGO/18530,4/4/2023 6:41:20 AM,Host Communities,114,108,159,134,515,0,0,0,0,0
53,Ethiopia,2021,ETH-21/DDA-3379/SA1/NFI/ES/INGO/18530,4/4/2023 6:41:20 AM,Internally Displaced People,1943,1855,2738,2299,8835,5468,4826,1636,1252,13182
53,Ethiopia,2021,ETH-21/DDA-3379/SA1/NFI/ES/INGO/18530,4/4/2023 6:41:20 AM,Overall,2057,1963,2897,2433,9350,5468,4826,1636,1252,13182
53,Ethiopia,2021,ETH-21/DDA-3379/SA1/NFI/ES/INGO/18559,10/17/2022 6:15:59 AM,Host Communities,195,205,42,42,484,0,0,0,0,0
53,Ethiopia,2021,ETH-21/DDA-3379/SA1/NFI/ES/INGO/18559,10/17/2022 6:15:59 AM,Internally Displaced People,1730,1814,390,390,4324,1427,1470,167,200,3264
53,Ethiopia,2021,ETH-21/DDA-3379/SA1/NFI/ES/INGO/18559,10/17/2022 6:15:59 AM,Overall,1925,2019,432,432,4808,1427,1470,167,200,3264
53,Ethiopia,2021,ETH-21/DDA-3379/SA1/NFI/ES/INGO/18571,12/7/2022 4:30:03 AM,Host Communities,2640,2756,191,241,5828,0,0,0,0,0
53,Ethiopia,2021,ETH-21/DDA-3379/SA1/NFI/ES/INGO/18571,12/7/2022 4:30:03 AM,Internally Displaced People,2390,2694,934,1134,7152,3772,3925,944,982,9623
53,Ethiopia,2021,ETH-21/DDA-3379/SA1/NFI/ES/INGO/18571,12/7/2022 4:30:03 AM,Overall,5030,5450,1125,1375,12980,3772,3925,944,982,9623
53,Ethiopia,2021,ETH-21/DDA-3379/SA1/NFI/ES/INGO/18579,8/8/2022 4:39:09 AM,Host Communities,499,519,360,319,1697,3042,3358,2335,2196,10931
53,Ethiopia,2021,ETH-21/DDA-3379/SA1/NFI/ES/INGO/18579,8/8/2022 4:39:09 AM,Internally Displaced People,4495,4679,3241,2875,15290,0,0,0,0,0
53,Ethiopia,2021,ETH-21/DDA-3379/SA1/NFI/ES/INGO/18579,8/8/2022 4:39:09 AM,Overall,4994,5198,3601,3194,16987,3042,3358,2335,2196,10931
53,Ethiopia,2021,ETH-21/DDA-3379/SA1/NFI/ES/INGO/18627,8/2/2023 7:05:08 AM,Internally Displaced People,3777,3878,3997,3897,15549,3144,3024,3527,3379,13074
53,Ethiopia,2021,ETH-21/DDA-3379/SA1/NFI/ES/INGO/18627,8/2/2023 7:05:08 AM,Overall,3777,3878,3997,3897,15549,3144,3024,3527,3379,13074
53,Ethiopia,2021,ETH-21/DDA-3379/SA1/NFI/ES/NGO/18598,3/22/2022 9:20:03 AM,Host Communities,108,129,10,22,269,118,130,8,13,269
53,Ethiopia,2021,ETH-21/DDA-3379/SA1/NFI/ES/NGO/18598,3/22/2022 9:20:03 AM,Internally Displaced People,1654,4164,1010,1263,8091,1458,4270,1060,1303,8091
53,Ethiopia,2021,ETH-21/DDA-3379/SA1/NFI/ES/NGO/18598,3/22/2022 9:20:03 AM,Overall,1762,4293,1020,1285,8360,1576,4400,1068,1316,8360
53,Ethiopia,2021,ETH-21/DDA-3379/SA1/NFI/ES/NGO/18606,7/4/2022 12:01:23 PM,Host Communities,309,328,196,196,1029,258,336,470,224,1288
53,Ethiopia,2021,ETH-21/DDA-3379/SA1/NFI/ES/NGO/18606,7/4/2022 12:01:23 PM,Internally Displaced People,2783,2969,1763,1763,9278,2343,3034,1519,2011,8907
53,Ethiopia,2021,ETH-21/DDA-3379/SA1/NFI/ES/NGO/18606,7/4/2022 12:01:23 PM,Overall,3092,3297,1959,1959,10307,2601,3370,1989,2235,10195
53,Ethiopia,2021,ETH-21/DDA-3379/SA1/NFI/ES/NGO/18614,2/14/2022 6:16:05 AM,Host Communities,309,261,348,297,1215,309,261,348,297,1215
53,Ethiopia,2021,ETH-21/DDA-3379/SA1/NFI/ES/NGO/18614,2/14/2022 6:16:05 AM,Internally Displaced People,2070,1749,2346,1984,8149,2070,1749,2346,1984,8149
53,Ethiopia,2021,ETH-21/DDA-3379/SA1/NFI/ES/NGO/18614,2/14/2022 6:16:05 AM,Overall,2379,2010,2694,2281,9364,2379,2010,2694,2281,9364
53,Ethiopia,2021,ETH-21/DDA-3379/SA1/NFI/ES/UN/18522,10/17/2022 6:13:34 AM,Host Communities,774,804,774,869,3221,0,0,0,0,0
53,Ethiopia,2021,ETH-21/DDA-3379/SA1/NFI/ES/UN/18522,10/17/2022 6:13:34 AM,Internally Displaced People,8468,8823,8468,9527,35286,9106,9361,9019,9559,37045
53,Ethiopia,2021,ETH-21/DDA-3379/SA1/NFI/ES/UN/18522,10/17/2022 6:13:34 AM,Overall,9242,9627,9242,10396,38507,9106,9361,9019,9559,37045
53,Ethiopia,2021,ETH-21/DDA-3379/SA1/NFI/ES-CCCM/UN/18588,7/5/2023 8:45:21 AM,Internally Displaced People,278747,290353,0,0,569100,278747,290353,0,0,569100
53,Ethiopia,2021,ETH-21/DDA-3379/SA1/NFI/ES-CCCM/UN/18588,7/5/2023 8:45:21 AM,Overall,278747,290353,0,0,569100,278747,290353,0,0,569100
53,Ethiopia,2021,ETH-21/DDA-3379/SA1/NFI/ES-E-P-H-N-WASH/INGO/18626,1/13/2023 10:33:35 AM,Host Communities,5922,6044,10654,10535,33155,4271,5702,9724,10624,30321
53,Ethiopia,2021,ETH-21/DDA-3379/SA1/NFI/ES-E-P-H-N-WASH/INGO/18626,1/13/2023 10:33:35 AM,Internally Displaced People,8531,8473,15359,15503,47866,7638,8257,13162,14099,43156
53,Ethiopia,2021,ETH-21/DDA-3379/SA1/NFI/ES-E-P-H-N-WASH/INGO/18626,1/13/2023 10:33:35 AM,Overall,19562,19936,35179,35239,109916,17148,18824,30818,31638,98428
53,Ethiopia,2021,ETH-21/DDA-3379/SA1/NFI/ES-E-P-H-N-WASH/INGO/18626,1/13/2023 10:33:35 AM,Returnees,5109,5419,9166,9201,28895,5239,4865,7932,6915,24951
53,Ethiopia,2021,ETH-21/DDA-3379/SA1/NFI/ES-WASH-E-N-P/UN/18603,11/22/2022 6:11:03 AM,Host Communities,664,702,995,1259,3620,669,695,724,753,2841
53,Ethiopia,2021,ETH-21/DDA-3379/SA1/NFI/ES-WASH-E-N-P/UN/18603,11/22/2022 6:11:03 AM,Internally Displaced People,3869,4267,4539,4127,16802,7509,7817,8137,8468,31931
53,Ethiopia,2021,ETH-21/DDA-3379/SA1/NFI/ES-WASH-E-N-P/UN/18603,11/22/2022 6:11:03 AM,Overall,6979,7517,7980,8137,30613,10707,11144,11601,12073,45525
53,Ethiopia,2021,ETH-21/DDA-3379/SA1/NFI/ES-WASH-E-N-P/UN/18603,11/22/2022 6:11:03 AM,Returnees,2446,2548,2446,2751,10191,2529,2632,2740,2852,10753
53,Ethiopia,2021,ETH-21/DDA-3379/SA1/P/INGO/18585,7/5/2023 12:24:15 PM,Host Communities,2901,5773,6728,7343,22745,7976,12122,1718,3281,25097
53,Ethiopia,2021,ETH-21/DDA-3379/SA1/P/INGO/18585,7/5/2023 12:24:15 PM,Internally Displaced People,2901,5772,6727,7342,22742,11920,15747,2160,3759,33586
53,Ethiopia,2021,ETH-21/DDA-3379/SA1/P/INGO/18585,7/5/2023 12:24:15 PM,Overall,5802,11545,13455,14685,45487,19896,27869,3878,7040,58683
53,Ethiopia,2021,ETH-21/DDA-3379/SA1/P/INGO/18602,7/26/2022 5:44:14 AM,Host Communities,5177,5148,2396,2600,15321,10083,10712,4119,4375,29289
53,Ethiopia,2021,ETH-21/DDA-3379/SA1/P/INGO/18602,7/26/2022 5:44:14 AM,Overall,10477,10463,3792,3879,28611,17123,18972,6994,7749,50838
53,Ethiopia,2021,ETH-21/DDA-3379/SA1/P/INGO/18602,7/26/2022 5:44:14 AM,Returnees,5300,5315,1396,1279,13290,7040,8260,2875,3374,21549
53,Ethiopia,2021,ETH-21/DDA-3379/SA1/P/INGO/18611,10/18/2022 10:20:10 AM,Host Communities,5441,3338,1821,1799,12399,7524,7012,3007,2892,20435
53,Ethiopia,2021,ETH-21/DDA-3379/SA1/P/INGO/18611,10/18/2022 10:20:10 AM,Internally Displaced People,13500,13650,4250,4350,35750,16752,15684,5157,4890,42483
53,Ethiopia,2021,ETH-21/DDA-3379/SA1/P/INGO/18611,10/18/2022 10:20:10 AM,Other,312,313,0,0,625,337,381,0,0,718
53,Ethiopia,2021,ETH-21/DDA-3379/SA1/P/INGO/18611,10/18/2022 10:20:10 AM,Overall,19253,17301,6071,6149,48774,24613,23077,8164,7782,63636
53,Ethiopia,2021,ETH-21/DDA-3379/SA1/P/INGO/18637,3/3/2023 9:11:41 AM,Internally Displaced People,12260,12286,5469,6167,36182,0,11272,0,6910,18182
53,Ethiopia,2021,ETH-21/DDA-3379/SA1/P/INGO/18637,3/3/2023 9:11:41 AM,Overall,12260,12286,5469,6167,36182,0,11272,0,6910,18182
53,Ethiopia,2021,ETH-21/DDA-3379/SA1/P/NGO/18535,11/25/2022 7:55:23 AM,Internally Displaced People,8000,15000,2000,12000,37000,8850,18678,2416,11226,41170
53,Ethiopia,2021,ETH-21/DDA-3379/SA1/P/NGO/18535,11/25/2022 7:55:23 AM,Overall,8000,15000,2000,12000,37000,8850,18678,2416,11226,41170
53,Ethiopia,2021,ETH-21/DDA-3379/SA1/P/UN/18550,10/7/2023 12:59:42 PM,Host Communities,1400,1400,700,700,4200,1305,1342,658,611,3916
53,Ethiopia,2021,ETH-21/DDA-3379/SA1/P/UN/18550,10/7/2023 12:59:42 PM,Internally Displaced People,3100,3090,1300,1300,8790,3277,3355,1457,1558,9647
53,Ethiopia,2021,ETH-21/DDA-3379/SA1/P/UN/18550,10/7/2023 12:59:42 PM,Other,65,65,35,35,200,81,96,54,60,291
53,Ethiopia,2021,ETH-21/DDA-3379/SA1/P/UN/18550,10/7/2023 12:59:42 PM,Overall,7205,7195,3170,3145,20715,7343,7470,3249,3367,21429
53,Ethiopia,2021,ETH-21/DDA-3379/SA1/P/UN/18550,10/7/2023 12:59:42 PM,Returnees,2640,2640,1135,1110,7525,2680,2677,1080,1138,7575
53,Ethiopia,2021,ETH-21/DDA-3379/SA1/P/UN/18583,6/17/2022 7:48:45 AM,Other,79,52,0,0,131,79,52,0,0,131
53,Ethiopia,2021,ETH-21/DDA-3379/SA1/P/UN/18583,6/17/2022 7:48:45 AM,Overall,79,52,0,0,131,79,52,0,0,131
53,Ethiopia,2021,ETH-21/DDA-3379/SA1/P/UN/18635,3/3/2023 8:29:20 AM,Internally Displaced People,7500,7500,0,0,15000,19316,19417,0,0,38733
53,Ethiopia,2021,ETH-21/DDA-3379/SA1/P/UN/18635,3/3/2023 8:29:20 AM,Other,400,400,0,0,800,415,333,0,0,748
53,Ethiopia,2021,ETH-21/DDA-3379/SA1/P/UN/18635,3/3/2023 8:29:20 AM,Overall,7900,7900,0,0,15800,19731,19750,0,0,39481
53,Ethiopia,2021,ETH-21/DDA-3379/SA1/P-E-WASH/INGO/18572,11/30/2022 9:21:21 AM,Host Communities,8066,9468,8918,9756,36208,8600,8322,6391,6924,30237
53,Ethiopia,2021,ETH-21/DDA-3379/SA1/P-E-WASH/INGO/18572,11/30/2022 9:21:21 AM,Internally Displaced People,3118,3394,3358,5084,14954,2079,3773,2089,2091,10032
53,Ethiopia,2021,ETH-21/DDA-3379/SA1/P-E-WASH/INGO/18572,11/30/2022 9:21:21 AM,Overall,11184,12862,12276,14840,51162,10679,12095,8480,9015,40269
53,Ethiopia,2021,ETH-21/DDA-3379/SA1/WASH/INGO/18532,10/3/2022 12:21:23 PM,Host Communities,969,957,37,37,2000,1563,1484,529,423,3999
53,Ethiopia,2021,ETH-21/DDA-3379/SA1/WASH/INGO/18532,10/3/2022 12:21:23 PM,Internally Displaced People,20231,19989,777,768,41765,31685,32930,18796,26883,110294
53,Ethiopia,2021,ETH-21/DDA-3379/SA1/WASH/INGO/18532,10/3/2022 12:21:23 PM,Overall,21200,20946,814,805,43765,33248,34414,19325,27306,114293
53,Ethiopia,2021,ETH-21/DDA-3379/SA1/WASH/INGO/18575,10/18/2022 10:16:18 AM,Host Communities,40730,42228,24963,25883,133804,44407,46055,27219,28228,145909
53,Ethiopia,2021,ETH-21/DDA-3379/SA1/WASH/INGO/18575,10/18/2022 10:16:18 AM,Internally Displaced People,6567,6835,4025,4189,21616,6799,6243,3677,3827,20546
53,Ethiopia,2021,ETH-21/DDA-3379/SA1/WASH/INGO/18575,10/18/2022 10:16:18 AM,Overall,47297,49063,28988,30072,155420,51206,52298,30896,32055,166455
53,Ethiopia,2021,ETH-21/DDA-3379/SA1/WASH/INGO/18624,12/7/2022 4:50:08 AM,Host Communities,40639,41079,44983,43659,170360,73677,76205,110311,115320,375513
53,Ethiopia,2021,ETH-21/DDA-3379/SA1/WASH/INGO/18624,12/7/2022 4:50:08 AM,Internally Displaced People,82298,83191,91095,88416,345000,25249,26279,37872,39418,128818
53,Ethiopia,2021,ETH-21/DDA-3379/SA1/WASH/INGO/18624,12/7/2022 4:50:08 AM,Overall,122937,124270,136078,132075,515360,98926,102484,148183,154738,504331
53,Ethiopia,2021,ETH-21/DDA-3379/SA1/WASH/NGO/18638,10/17/2022 6:32:15 AM,Host Communities,1350,1440,855,855,4500,1350,1440,855,855,4500
53,Ethiopia,2021,ETH-21/DDA-3379/SA1/WASH/NGO/18638,10/17/2022 6:32:15 AM,Internally Displaced People,4200,4480,2660,2660,14000,4200,4480,2660,2660,14000
53,Ethiopia,2021,ETH-21/DDA-3379/SA1/WASH/NGO/18638,10/17/2022 6:32:15 AM,Overall,5550,5920,3515,3515,18500,5550,5920,3515,3515,18500
53,Ethiopia,2021,ETH-21/DDA-3379/SA1/WASH/UN/18599,10/3/2022 12:16:16 PM,Host Communities,4016,4464,3680,3840,16000,84339,93982,77385,80749,336455
53,Ethiopia,2021,ETH-21/DDA-3379/SA1/WASH/UN/18599,10/3/2022 12:16:16 PM,Internally Displaced People,19495,21669,17863,18640,77667,28883,32036,26703,27932,115554
53,Ethiopia,2021,ETH-21/DDA-3379/SA1/WASH/UN/18599,10/3/2022 12:16:16 PM,Overall,23511,26133,21543,22480,93667,113222,126018,104088,108681,452009
53,Ethiopia,2021,ETH-21/DDA-3379/SA1/WASH-NFI/ES-E-P/INGO/18640,2/5/2023 8:30:13 AM,Host Communities,11866,12361,12855,12361,49443,10005,10296,10588,10193,41082
53,Ethiopia,2021,ETH-21/DDA-3379/SA1/WASH-NFI/ES-E-P/INGO/18640,2/5/2023 8:30:13 AM,Internally Displaced People,12373,12889,13404,12889,51555,10551,10149,7641,7514,35855
53,Ethiopia,2021,ETH-21/DDA-3379/SA1/WASH-NFI/ES-E-P/INGO/18640,2/5/2023 8:30:13 AM,Overall,24239,25250,26259,25250,100998,20556,20445,18229,17707,76937
53,Ethiopia,2021,ETH-21/DDA-3379/SA1/WASH-P-N-E/INGO/18521,5/18/2022 8:27:09 AM,Host Communities,4160,5200,5616,5840,20816,4160,5200,5616,5840,20816
53,Ethiopia,2021,ETH-21/DDA-3379/SA1/WASH-P-N-E/INGO/18521,5/18/2022 8:27:09 AM,Internally Displaced People,6240,7720,9360,7880,31200,6240,7720,9360,7880,31200
53,Ethiopia,2021,ETH-21/DDA-3379/SA1/WASH-P-N-E/INGO/18521,5/18/2022 8:27:09 AM,Overall,10400,12920,14976,13720,52016,10400,12920,14976,13720,52016
53,Ethiopia,2021,ETH-21/DDA-3379/SA2/A/INGO/21083,12/22/2022 4:34:43 AM,Host Communities,1675,4775,0,0,6450,2865,2710,0,0,5575
53,Ethiopia,2021,ETH-21/DDA-3379/SA2/A/INGO/21083,12/22/2022 4:34:43 AM,Internally Displaced People,985,3040,0,0,4025,2365,2535,0,0,4900
53,Ethiopia,2021,ETH-21/DDA-3379/SA2/A/INGO/21083,12/22/2022 4:34:43 AM,Overall,2660,7815,0,0,10475,5230,5245,0,0,10475
53,Ethiopia,2021,ETH-21/DDA-3379/SA2/A/INGO/21139,4/17/2023 5:05:24 AM,Host Communities,2851,2979,2076,2149,10055,5136,5367,3741,3873,18117
53,Ethiopia,2021,ETH-21/DDA-3379/SA2/A/INGO/21139,4/17/2023 5:05:24 AM,Internally Displaced People,11405,11916,8306,8598,40225,15410,16102,11222,11617,54351
53,Ethiopia,2021,ETH-21/DDA-3379/SA2/A/INGO/21139,4/17/2023 5:05:24 AM,Overall,14256,14895,10382,10747,50280,20546,21469,14963,15490,72468
53,Ethiopia,2021,ETH-21/DDA-3379/SA2/A/INGO/21185,1/30/2023 11:33:19 AM,Host Communities,2500,2500,0,0,5000,3217,2803,0,0,6020
53,Ethiopia,2021,ETH-21/DDA-3379/SA2/A/INGO/21185,1/30/2023 11:33:19 AM,Internally Displaced People,1000,1000,0,0,2000,430,550,0,0,980
53,Ethiopia,2021,ETH-21/DDA-3379/SA2/A/INGO/21185,1/30/2023 11:33:19 AM,Overall,3500,3500,0,0,7000,3647,3353,0,0,7000
53,Ethiopia,2021,ETH-21/DDA-3379/SA2/A/INGO/21209,11/17/2022 9:43:26 AM,Host Communities,3326,3488,3614,4050,14478,2716,2619,4719,4422,14476
53,Ethiopia,2021,ETH-21/DDA-3379/SA2/A/INGO/21209,11/17/2022 9:43:26 AM,Internally Displaced People,7762,8082,8440,9450,33734,6338,6113,11010,10317,33778
53,Ethiopia,2021,ETH-21/DDA-3379/SA2/A/INGO/21209,11/17/2022 9:43:26 AM,Overall,11088,11570,12054,13500,48212,9054,8732,15729,14739,48254
53,Ethiopia,2021,ETH-21/DDA-3379/SA2/A/NGO/21192,11/17/2022 9:39:26 AM,Host Communities,127,106,143,122,498,106,101,170,85,462
53,Ethiopia,2021,ETH-21/DDA-3379/SA2/A/NGO/21192,11/17/2022 9:39:26 AM,Internally Displaced People,381,323,430,366,1500,316,310,676,727,2029
53,Ethiopia,2021,ETH-21/DDA-3379/SA2/A/NGO/21192,11/17/2022 9:39:26 AM,Overall,761,649,859,731,3000,633,608,1194,988,3423
53,Ethiopia,2021,ETH-21/DDA-3379/SA2/A/NGO/21192,11/17/2022 9:39:26 AM,Returnees,253,220,286,243,1002,211,197,348,176,932
53,Ethiopia,2021,ETH-21/DDA-3379/SA2/CCCM/INGO/21212,1/9/2023 5:22:08 AM,Internally Displaced People,4065,4172,1459,1579,11275,4127,4012,1505,1487,11131
53,Ethiopia,2021,ETH-21/DDA-3379/SA2/CCCM/INGO/21212,1/9/2023 5:22:08 AM,Overall,4065,4172,1459,1579,11275,4127,4012,1505,1487,11131
53,Ethiopia,2021,ETH-21/DDA-3379/SA2/CCCM/INGO/21276,4/4/2023 7:00:10 AM,Host Communities,926,1075,448,537,2986,968,1117,490,579,3154
53,Ethiopia,2021,ETH-21/DDA-3379/SA2/CCCM/INGO/21276,4/4/2023 7:00:10 AM,Internally Displaced People,4872,5657,2357,2829,15715,4914,5699,2399,2871,15883
53,Ethiopia,2021,ETH-21/DDA-3379/SA2/CCCM/INGO/21276,4/4/2023 7:00:10 AM,Overall,5798,6732,2805,3366,18701,5882,6816,2889,3450,19037
53,Ethiopia,2021,ETH-21/DDA-3379/SA2/CCCM/NGO/21250,5/12/2023 6:19:28 AM,Host Communities,434,418,556,574,1982,434,418,556,574,1982
53,Ethiopia,2021,ETH-21/DDA-3379/SA2/CCCM/NGO/21250,5/12/2023 6:19:28 AM,Internally Displaced People,4329,4189,5554,5733,19805,4300,4100,5500,5700,19600
53,Ethiopia,2021,ETH-21/DDA-3379/SA2/CCCM/NGO/21250,5/12/2023 6:19:28 AM,Overall,4763,4607,6110,6307,21787,4734,4518,6056,6274,21582
53,Ethiopia,2021,ETH-21/DDA-3379/SA2/CCCM/UN/21149,3/2/2023 8:52:00 AM,Host Communities,2263,2257,3246,3263,11029,2814,3011,3626,3519,12970
53,Ethiopia,2021,ETH-21/DDA-3379/SA2/CCCM/UN/21149,3/2/2023 8:52:00 AM,Internally Displaced People,29466,29393,42268,42482,143609,27255,29778,41983,40462,139478
53,Ethiopia,2021,ETH-21/DDA-3379/SA2/CCCM/UN/21149,3/2/2023 8:52:00 AM,Overall,31729,31650,45514,45745,154638,30069,32789,45609,43981,152448
53,Ethiopia,2021,ETH-21/DDA-3379/SA2/E/NGO/21087,2/3/2023 9:26:49 AM,Host Communities,50,55,1000,1000,2105,50,55,1000,1000,2105
53,Ethiopia,2021,ETH-21/DDA-3379/SA2/E/NGO/21087,2/3/2023 9:26:49 AM,Internally Displaced People,100,100,5000,5000,10200,100,100,5000,5000,10200
53,Ethiopia,2021,ETH-21/DDA-3379/SA2/E/NGO/21087,2/3/2023 9:26:49 AM,Overall,150,155,6000,6000,12305,150,155,6000,6000,12305
53,Ethiopia,2021,ETH-21/DDA-3379/SA2/E-P/INGO/21168,8/7/2023 6:29:31 AM,Host Communities,1134,1188,1512,1566,5400,1114,993,1269,1450,4826
53,Ethiopia,2021,ETH-21/DDA-3379/SA2/E-P/INGO/21168,8/7/2023 6:29:31 AM,Internally Displaced People,4082,4277,5443,5638,19440,1759,1797,1962,2055,7573
53,Ethiopia,2021,ETH-21/DDA-3379/SA2/E-P/INGO/21168,8/7/2023 6:29:31 AM,Overall,5670,5940,7560,7830,27000,3606,3640,4288,4466,16000
53,Ethiopia,2021,ETH-21/DDA-3379/SA2/E-P/INGO/21168,8/7/2023 6:29:31 AM,Returnees,454,475,605,626,2160,733,850,1057,961,3601
53,Ethiopia,2021,ETH-21/DDA-3379/SA2/H/INGO/21094,7/5/2023 7:20:25 AM,Host Communities,35441,35942,10595,10995,92973,24776,25783,11115,14953,76627
53,Ethiopia,2021,ETH-21/DDA-3379/SA2/H/INGO/21094,7/5/2023 7:20:25 AM,Internally Displaced People,21022,22185,5885,5897,54989,16511,17195,7419,9975,51100
53,Ethiopia,2021,ETH-21/DDA-3379/SA2/H/INGO/21094,7/5/2023 7:20:25 AM,Overall,56463,58127,16480,16892,147962,41287,42978,18534,24928,127727
53,Ethiopia,2021,ETH-21/DDA-3379/SA2/H/INGO/21140,2/3/2023 9:35:33 AM,Host Communities,38991,42332,16821,17694,115838,31200,39202,15999,13201,99602
53,Ethiopia,2021,ETH-21/DDA-3379/SA2/H/INGO/21140,2/3/2023 9:35:33 AM,Internally Displaced People,3412,3551,649,676,8288,3120,3631,1609,1708,10068
53,Ethiopia,2021,ETH-21/DDA-3379/SA2/H/INGO/21140,2/3/2023 9:35:33 AM,Overall,42403,45883,17470,18370,124126,34320,42833,17608,14909,109670
53,Ethiopia,2021,ETH-21/DDA-3379/SA2/H/INGO/21196,1/9/2023 5:20:06 AM,Host Communities,3675,3825,8575,8925,25000,4733,6568,12323,13919,37543
53,Ethiopia,2021,ETH-21/DDA-3379/SA2/H/INGO/21196,1/9/2023 5:20:06 AM,Overall,3675,3825,8575,8925,25000,4733,6568,12323,13919,37543
53,Ethiopia,2021,ETH-21/DDA-3379/SA2/H/INGO/21216,1/30/2023 11:46:20 AM,Host Communities,5023,5228,2153,2241,14645,2251,3163,875,885,7174
53,Ethiopia,2021,ETH-21/DDA-3379/SA2/H/INGO/21216,1/30/2023 11:46:20 AM,Internally Displaced People,9917,10322,4250,4424,28913,4328,6084,1694,1692,13798
53,Ethiopia,2021,ETH-21/DDA-3379/SA2/H/INGO/21216,1/30/2023 11:46:20 AM,Overall,14940,15550,6403,6665,43558,6579,9247,2569,2577,20972
53,Ethiopia,2021,ETH-21/DDA-3379/SA2/H/NGO/21170,3/13/2023 7:42:24 AM,Host Communities,11116,11872,14081,15201,52270,12854,13218,16725,17326,60123
53,Ethiopia,2021,ETH-21/DDA-3379/SA2/H/NGO/21170,3/13/2023 7:42:24 AM,Internally Displaced People,4984,5581,6300,8806,25671,5343,5849,6752,9740,27684
53,Ethiopia,2021,ETH-21/DDA-3379/SA2/H/NGO/21170,3/13/2023 7:42:24 AM,Overall,16100,17453,20381,24007,77941,18197,19067,23477,27066,87807
53,Ethiopia,2021,ETH-21/DDA-3379/SA2/H/NGO/21198,3/6/2023 6:53:56 AM,Host Communities,19331,18490,23114,23112,84047,73479,78628,11958,13484,177549
53,Ethiopia,2021,ETH-21/DDA-3379/SA2/H/NGO/21198,3/6/2023 6:53:56 AM,Overall,19331,18490,23114,23112,84047,73479,78628,11958,13484,177549
53,Ethiopia,2021,ETH-21/DDA-3379/SA2/H/NGO/21215,1/13/2023 7:20:50 AM,Host Communities,4844,6810,4344,4520,20518,3300,3521,1265,2248,10334
53,Ethiopia,2021,ETH-21/DDA-3379/SA2/H/NGO/21215,1/13/2023 7:20:50 AM,Internally Displaced People,5395,7584,4838,5034,22851,42428,45871,3204,4898,96401
53,Ethiopia,2021,ETH-21/DDA-3379/SA2/H/NGO/21215,1/13/2023 7:20:50 AM,Overall,10239,14394,9182,9554,43369,45728,49392,4469,7146,106735
53,Ethiopia,2021,ETH-21/DDA-3379/SA2/H/NGO/21220,1/16/2023 6:18:33 AM,Host Communities,5000,5000,5000,5000,20000,11283,11456,8030,9415,40184
53,Ethiopia,2021,ETH-21/DDA-3379/SA2/H/NGO/21220,1/16/2023 6:18:33 AM,Internally Displaced People,15000,15500,10000,1000,41500,14894,15409,9867,6392,46562
53,Ethiopia,2021,ETH-21/DDA-3379/SA2/H/NGO/21220,1/16/2023 6:18:33 AM,Overall,20000,20500,15000,6000,61500,26177,26865,17897,15807,86746
53,Ethiopia,2021,ETH-21/DDA-3379/SA2/H/UN/21085,2/7/2023 4:23:52 AM,Host Communities,132437,137843,143473,149330,563083,141708,147492,153516,159783,602499
53,Ethiopia,2021,ETH-21/DDA-3379/SA2/H/UN/21085,2/7/2023 4:23:52 AM,Internally Displaced People,10907,11352,11816,12298,46373,11670,12147,12643,13159,49619
53,Ethiopia,2021,ETH-21/DDA-3379/SA2/H/UN/21085,2/7/2023 4:23:52 AM,Overall,158924,165411,172169,179196,675700,170048,176991,184221,191740,723000
53,Ethiopia,2021,ETH-21/DDA-3379/SA2/H/UN/21085,2/7/2023 4:23:52 AM,Refugees,7790,8108,8440,8784,33122,8335,8676,9031,9399,35441
53,Ethiopia,2021,ETH-21/DDA-3379/SA2/H/UN/21085,2/7/2023 4:23:52 AM,Returnees,7790,8108,8440,8784,33122,8335,8676,9031,9399,35441
53,Ethiopia,2021,ETH-21/DDA-3379/SA2/H-N/NGO/21246,11/30/2022 9:17:11 AM,Host Communities,9633,10091,13303,12844,45871,10615,12290,14912,14859,52676
53,Ethiopia,2021,ETH-21/DDA-3379/SA2/H-N/NGO/21246,11/30/2022 9:17:11 AM,Internally Displaced People,4128,4326,5701,5506,19661,5891,5869,7258,7573,26591
53,Ethiopia,2021,ETH-21/DDA-3379/SA2/H-N/NGO/21246,11/30/2022 9:17:11 AM,Overall,13761,14417,19004,18350,65532,16506,18159,22170,22432,79267
53,Ethiopia,2021,ETH-21/DDA-3379/SA2/H-N-P/INGO/21264,7/5/2023 12:45:32 PM,Host Communities,2804,9715,5275,4986,22780,4781,12003,4859,5543,27186
53,Ethiopia,2021,ETH-21/DDA-3379/SA2/H-N-P/INGO/21264,7/5/2023 12:45:32 PM,Internally Displaced People,1045,7294,6891,5951,21181,4318,11485,5057,5376,26236
53,Ethiopia,2021,ETH-21/DDA-3379/SA2/H-N-P/INGO/21264,7/5/2023 12:45:32 PM,Overall,3849,17009,12166,10937,43961,9099,23488,9916,10919,53422
53,Ethiopia,2021,ETH-21/DDA-3379/SA2/H-N-WASH-P-E/INGO/21205,8/2/2023 8:07:50 AM,Host Communities,19650,20515,19614,22142,81921,20165,20746,20581,23343,84835
53,Ethiopia,2021,ETH-21/DDA-3379/SA2/H-N-WASH-P-E/INGO/21205,8/2/2023 8:07:50 AM,Internally Displaced People,36944,45534,29422,33212,145112,38352,47217,33521,35204,154294
53,Ethiopia,2021,ETH-21/DDA-3379/SA2/H-N-WASH-P-E/INGO/21205,8/2/2023 8:07:50 AM,Overall,56594,66049,49036,55354,227033,58517,67963,54102,58547,239129
53,Ethiopia,2021,ETH-21/DDA-3379/SA2/H-P/INGO/21207,12/22/2022 4:46:37 AM,Host Communities,8126,16612,555,1330,26623,8353,18820,834,1393,29400
53,Ethiopia,2021,ETH-21/DDA-3379/SA2/H-P/INGO/21207,12/22/2022 4:46:37 AM,Internally Displaced People,2031,4734,139,914,7818,2098,4867,239,1285,8489
53,Ethiopia,2021,ETH-21/DDA-3379/SA2/H-P/INGO/21207,12/22/2022 4:46:37 AM,Overall,10157,21346,694,2244,34441,10451,23687,1073,2678,37889
53,Ethiopia,2021,ETH-21/DDA-3379/SA2/L/UN/21082,4/4/2023 7:04:32 AM,Other,4379025,3931000,0,0,8310025,0,0,0,0,0
53,Ethiopia,2021,ETH-21/DDA-3379/SA2/L/UN/21082,4/4/2023 7:04:32 AM,Overall,4379025,3931000,0,0,8310025,0,0,0,0,0
53,Ethiopia,2021,ETH-21/DDA-3379/SA2/N/INGO/21096,7/5/2023 11:37:11 AM,Host Communities,155,75386,19792,33489,128822,63914,79211,111609,112302,367036
53,Ethiopia,2021,ETH-21/DDA-3379/SA2/N/INGO/21096,7/5/2023 11:37:11 AM,Internally Displaced People,8653,9865,22341,12614,53473,36775,38819,63335,62653,201582
53,Ethiopia,2021,ETH-21/DDA-3379/SA2/N/INGO/21096,7/5/2023 11:37:11 AM,Overall,8808,85251,42133,46103,182295,100689,118030,174944,174955,568618
53,Ethiopia,2021,ETH-21/DDA-3379/SA2/N/INGO/21141,2/5/2023 8:38:54 AM,Host Communities,10714,79608,49050,51061,190433,69911,85050,1183,1538,157682
53,Ethiopia,2021,ETH-21/DDA-3379/SA2/N/INGO/21141,2/5/2023 8:38:54 AM,Overall,10714,79608,49050,51061,190433,69911,85050,1183,1538,157682
53,Ethiopia,2021,ETH-21/DDA-3379/SA2/N/INGO/21165,1/30/2023 11:40:43 AM,Host Communities,4116,14951,5376,6254,30697,4788,15464,5381,6270,31903
53,Ethiopia,2021,ETH-21/DDA-3379/SA2/N/INGO/21165,1/30/2023 11:40:43 AM,Internally Displaced People,784,2848,1024,1191,5847,700,2477,1345,1442,5964
53,Ethiopia,2021,ETH-21/DDA-3379/SA2/N/INGO/21165,1/30/2023 11:40:43 AM,Overall,4900,17799,6400,7445,36544,5488,17941,6726,7712,37867
53,Ethiopia,2021,ETH-21/DDA-3379/SA2/N/INGO/21195,4/4/2023 6:44:01 AM,Host Communities,0,778,4327,4503,9608,0,3017,4230,3890,11137
53,Ethiopia,2021,ETH-21/DDA-3379/SA2/N/INGO/21195,4/4/2023 6:44:01 AM,Internally Displaced People,0,194,1082,1126,2402,0,4356,4432,4910,13698
53,Ethiopia,2021,ETH-21/DDA-3379/SA2/N/INGO/21195,4/4/2023 6:44:01 AM,Overall,0,972,5409,5629,12010,0,7373,8662,8800,24835
53,Ethiopia,2021,ETH-21/DDA-3379/SA2/N/NGO/21228,1/13/2023 6:27:48 AM,Host Communities,0,2000,3250,3800,9050,322,1266,2243,2678,6509
53,Ethiopia,2021,ETH-21/DDA-3379/SA2/N/NGO/21228,1/13/2023 6:27:48 AM,Internally Displaced People,0,5365,5000,8800,19165,256,3455,4942,14321,22974
53,Ethiopia,2021,ETH-21/DDA-3379/SA2/N/NGO/21228,1/13/2023 6:27:48 AM,Overall,0,7365,8250,12600,28215,578,4721,7185,16999,29483
53,Ethiopia,2021,ETH-21/DDA-3379/SA2/N/NGO/21302,7/5/2023 8:22:40 AM,Host Communities,25,12934,4012,3987,20958,377,5615,2590,2388,10970
53,Ethiopia,2021,ETH-21/DDA-3379/SA2/N/NGO/21302,7/5/2023 8:22:40 AM,Internally Displaced People,40,6467,2006,1993,10506,186,2766,1276,1176,5404
53,Ethiopia,2021,ETH-21/DDA-3379/SA2/N/NGO/21302,7/5/2023 8:22:40 AM,Overall,65,19401,6018,5980,31464,563,8381,3866,3564,16374
53,Ethiopia,2021,ETH-21/DDA-3379/SA2/N/UN/21224,12/29/2022 9:46:06 AM,Host Communities,0,0,350,310,660,0,0,379,349,728
53,Ethiopia,2021,ETH-21/DDA-3379/SA2/N/UN/21224,12/29/2022 9:46:06 AM,Internally Displaced People,0,0,780,760,1540,0,0,803,822,1625
53,Ethiopia,2021,ETH-21/DDA-3379/SA2/N/UN/21224,12/29/2022 9:46:06 AM,Overall,0,0,1130,1070,2200,0,0,1182,1171,2353
53,Ethiopia,2021,ETH-21/DDA-3379/SA2/NFI/ES/INGO/21098,1/30/2023 11:43:24 AM,Host Communities,193,207,122,122,644,112,176,168,264,720
53,Ethiopia,2021,ETH-21/DDA-3379/SA2/NFI/ES/INGO/21098,1/30/2023 11:43:24 AM,Internally Displaced People,1737,1854,1100,1100,5791,1001,1593,1511,2382,6487
53,Ethiopia,2021,ETH-21/DDA-3379/SA2/NFI/ES/INGO/21098,1/30/2023 11:43:24 AM,Overall,1930,2061,1222,1222,6435,1113,1769,1679,2646,7207
53,Ethiopia,2021,ETH-21/DDA-3379/SA2/NFI/ES/INGO/21110,2/3/2023 9:21:27 AM,Host Communities,139,115,75,67,396,129,125,79,83,416
53,Ethiopia,2021,ETH-21/DDA-3379/SA2/NFI/ES/INGO/21110,2/3/2023 9:21:27 AM,Internally Displaced People,1716,1421,930,832,4899,1556,1496,954,1003,5009
53,Ethiopia,2021,ETH-21/DDA-3379/SA2/NFI/ES/INGO/21110,2/3/2023 9:21:27 AM,Overall,1855,1536,1005,899,5295,1685,1621,1033,1086,5425
53,Ethiopia,2021,ETH-21/DDA-3379/SA2/NFI/ES/INGO/21176,2/3/2023 9:31:52 AM,Host Communities,356,317,396,356,1425,449,363,484,414,1710
53,Ethiopia,2021,ETH-21/DDA-3379/SA2/NFI/ES/INGO/21176,2/3/2023 9:31:52 AM,Internally Displaced People,4960,4363,5562,4963,19848,6291,3949,4674,5953,20867
53,Ethiopia,2021,ETH-21/DDA-3379/SA2/NFI/ES/INGO/21176,2/3/2023 9:31:52 AM,Overall,5316,4680,5958,5319,21273,6740,4312,5158,6367,22577
53,Ethiopia,2021,ETH-21/DDA-3379/SA2/NFI/ES/INGO/21262,3/6/2023 5:59:20 AM,Host Communities,786,811,847,821,3265,0,0,0,0,0
53,Ethiopia,2021,ETH-21/DDA-3379/SA2/NFI/ES/INGO/21262,3/6/2023 5:59:20 AM,Internally Displaced People,4680,4823,5030,4882,19415,6398,6587,8945,10332,32262
53,Ethiopia,2021,ETH-21/DDA-3379/SA2/NFI/ES/INGO/21262,3/6/2023 5:59:20 AM,Overall,5466,5634,5877,5703,22680,6398,6587,8945,10332,32262
53,Ethiopia,2021,ETH-21/DDA-3379/SA2/NFI/ES/NGO/21164,10/3/2022 11:44:40 AM,Host Communities,185,332,117,119,753,144,213,114,126,597
53,Ethiopia,2021,ETH-21/DDA-3379/SA2/NFI/ES/NGO/21164,10/3/2022 11:44:40 AM,Internally Displaced People,1234,2211,781,796,5022,1738,1714,801,938,5191
53,Ethiopia,2021,ETH-21/DDA-3379/SA2/NFI/ES/NGO/21164,10/3/2022 11:44:40 AM,Overall,1419,2543,898,915,5775,1882,1927,915,1064,5788
53,Ethiopia,2021,ETH-21/DDA-3379/SA2/NFI/ES/NGO/21206,4/20/2023 7:53:56 AM,Host Communities,552,590,349,349,1840,479,440,787,672,2378
53,Ethiopia,2021,ETH-21/DDA-3379/SA2/NFI/ES/NGO/21206,4/20/2023 7:53:56 AM,Internally Displaced People,4969,5300,3147,3147,16563,5054,5079,6937,6038,23108
53,Ethiopia,2021,ETH-21/DDA-3379/SA2/NFI/ES/NGO/21206,4/20/2023 7:53:56 AM,Overall,5521,5890,3496,3496,18403,5533,5519,7724,6710,25486
53,Ethiopia,2021,ETH-21/DDA-3379/SA2/NFI/ES/NGO/21273,10/18/2022 10:18:04 AM,Host Communities,258,334,75,75,742,251,324,69,71,715
53,Ethiopia,2021,ETH-21/DDA-3379/SA2/NFI/ES/NGO/21273,10/18/2022 10:18:04 AM,Internally Displaced People,1473,1895,420,420,4208,1467,1871,413,415,4166
53,Ethiopia,2021,ETH-21/DDA-3379/SA2/NFI/ES/NGO/21273,10/18/2022 10:18:04 AM,Overall,1731,2229,495,495,4950,1718,2195,482,486,4881
53,Ethiopia,2021,ETH-21/DDA-3379/SA2/NFI/ES/UN/21148,2/10/2023 9:21:05 AM,Host Communities,398,415,415,431,1659,244,244,251,294,1033
53,Ethiopia,2021,ETH-21/DDA-3379/SA2/NFI/ES/UN/21148,2/10/2023 9:21:05 AM,Internally Displaced People,2255,2349,2349,2443,9396,3129,3142,2699,3253,12223
53,Ethiopia,2021,ETH-21/DDA-3379/SA2/NFI/ES/UN/21148,2/10/2023 9:21:05 AM,Overall,2653,2764,2764,2874,11055,3373,3386,2950,3547,13256
53,Ethiopia,2021,ETH-21/DDA-3379/SA2/NFI/ES-P/UN/21166,7/5/2023 12:12:05 PM,Internally Displaced People,41763,36599,0,0,78362,41763,36599,0,0,78362
53,Ethiopia,2021,ETH-21/DDA-3379/SA2/NFI/ES-P/UN/21166,7/5/2023 12:12:05 PM,Overall,41763,36599,0,0,78362,41763,36599,0,0,78362
53,Ethiopia,2021,ETH-21/DDA-3379/SA2/N-H/INGO/21241,4/20/2023 7:56:47 AM,Host Communities,5889,17421,28626,34988,86924,9764,47082,9172,10630,76648
53,Ethiopia,2021,ETH-21/DDA-3379/SA2/N-H/INGO/21241,4/20/2023 7:56:47 AM,Internally Displaced People,2735,3364,4745,5799,16643,0,0,0,0,0
53,Ethiopia,2021,ETH-21/DDA-3379/SA2/N-H/INGO/21241,4/20/2023 7:56:47 AM,Overall,8624,20785,33371,40787,103567,9764,47082,9172,10630,76648
53,Ethiopia,2021,ETH-21/DDA-3379/SA2/P/INGO/21100,4/17/2023 4:49:54 AM,Host Communities,2320,2580,3600,3800,12300,2250,2250,3590,3600,11690
53,Ethiopia,2021,ETH-21/DDA-3379/SA2/P/INGO/21100,4/17/2023 4:49:54 AM,Internally Displaced People,5670,10140,13140,13640,42590,5560,9987,12980,13589,42116
53,Ethiopia,2021,ETH-21/DDA-3379/SA2/P/INGO/21100,4/17/2023 4:49:54 AM,Overall,10090,16220,21420,22700,70430,9790,15557,21059,22419,68825
53,Ethiopia,2021,ETH-21/DDA-3379/SA2/P/INGO/21100,4/17/2023 4:49:54 AM,Returnees,2100,3500,4680,5260,15540,1980,3320,4489,5230,15019
53,Ethiopia,2021,ETH-21/DDA-3379/SA2/P/INGO/21199,7/5/2023 7:14:16 AM,Host Communities,16328,11255,5180,5138,37901,11798,10642,5451,5575,33466
53,Ethiopia,2021,ETH-21/DDA-3379/SA2/P/INGO/21199,7/5/2023 7:14:16 AM,Internally Displaced People,18870,20359,7033,7420,53682,16524,19730,10053,11753,58060
53,Ethiopia,2021,ETH-21/DDA-3379/SA2/P/INGO/21199,7/5/2023 7:14:16 AM,Overall,35198,31614,12213,12558,91583,28322,30372,15504,17328,91526
53,Ethiopia,2021,ETH-21/DDA-3379/SA2/P/INGO/21211,1/9/2023 12:29:07 PM,Host Communities,10673,12668,11371,12080,46792,9002,11049,10009,11010,41070
53,Ethiopia,2021,ETH-21/DDA-3379/SA2/P/INGO/21211,1/9/2023 12:29:07 PM,Internally Displaced People,8080,9207,9406,8933,35626,6909,9150,8904,8902,33865
53,Ethiopia,2021,ETH-21/DDA-3379/SA2/P/INGO/21211,1/9/2023 12:29:07 PM,Overall,18753,21875,20777,21013,82418,15911,20199,18913,19912,74935
53,Ethiopia,2021,ETH-21/DDA-3379/SA2/P/INGO/21251,10/7/2023 12:57:34 PM,Host Communities,5009,5086,1809,1902,13806,6789,13671,1724,2188,24372
53,Ethiopia,2021,ETH-21/DDA-3379/SA2/P/INGO/21251,10/7/2023 12:57:34 PM,Internally Displaced People,15114,17507,7781,8382,48784,20578,28508,6520,11265,66871
53,Ethiopia,2021,ETH-21/DDA-3379/SA2/P/INGO/21251,10/7/2023 12:57:34 PM,Overall,20123,22593,9590,10284,62590,27367,42179,8244,13453,91243
53,Ethiopia,2021,ETH-21/DDA-3379/SA2/P/INGO/21305,8/11/2023 4:35:14 AM,Host Communities,22200,17000,7500,8230,54930,22185,19125,7479,10989,59778
53,Ethiopia,2021,ETH-21/DDA-3379/SA2/P/INGO/21305,8/11/2023 4:35:14 AM,Internally Displaced People,12850,9550,5190,4580,32170,14454,9549,5139,4581,33723
53,Ethiopia,2021,ETH-21/DDA-3379/SA2/P/INGO/21305,8/11/2023 4:35:14 AM,Overall,35050,26550,12690,12810,87100,36639,28674,12618,15570,93501
53,Ethiopia,2021,ETH-21/DDA-3379/SA2/P/NGO/21297,7/5/2023 8:12:41 AM,Host Communities,21569,22595,29802,28758,102724,14591,14731,16302,16503,62127
53,Ethiopia,2021,ETH-21/DDA-3379/SA2/P/NGO/21297,7/5/2023 8:12:41 AM,Internally Displaced People,7974,8354,11013,10633,37974,7841,8297,9086,10291,35515
53,Ethiopia,2021,ETH-21/DDA-3379/SA2/P/NGO/21297,7/5/2023 8:12:41 AM,Overall,29543,30949,40815,39391,140698,22432,23028,25388,26794,97642
53,Ethiopia,2021,ETH-21/DDA-3379/SA2/P/UN/21147,10/9/2023 3:54:02 PM,Host Communities,265,330,210,254,1059,403,728,151,179,1461
53,Ethiopia,2021,ETH-21/DDA-3379/SA2/P/UN/21147,10/9/2023 3:54:02 PM,Internally Displaced People,1698,2189,1667,1931,7485,4848,9994,1477,2157,18476
53,Ethiopia,2021,ETH-21/DDA-3379/SA2/P/UN/21147,10/9/2023 3:54:02 PM,Overall,2298,2951,2206,2566,10021,5273,10742,1628,2336,19979
53,Ethiopia,2021,ETH-21/DDA-3379/SA2/P/UN/21147,10/9/2023 3:54:02 PM,Returnees,335,432,329,381,1477,22,20,0,0,42
53,Ethiopia,2021,ETH-21/DDA-3379/SA2/P/UN/21253,8/3/2023 6:35:54 AM,Host Communities,2193,2193,0,0,4386,3700,2800,0,0,6500
53,Ethiopia,2021,ETH-21/DDA-3379/SA2/P/UN/21253,8/3/2023 6:35:54 AM,Internally Displaced People,2193,2193,0,0,4386,2975,2900,0,0,5875
53,Ethiopia,2021,ETH-21/DDA-3379/SA2/P/UN/21253,8/3/2023 6:35:54 AM,Other,234,234,0,0,468,0,0,0,0,0
53,Ethiopia,2021,ETH-21/DDA-3379/SA2/P/UN/21253,8/3/2023 6:35:54 AM,Overall,4620,4620,0,0,9240,6675,5700,0,0,12375
53,Ethiopia,2021,ETH-21/DDA-3379/SA2/P/UN/21261,8/3/2023 6:34:06 AM,Host Communities,2193,2193,0,0,4386,1228,1228,0,0,2456
53,Ethiopia,2021,ETH-21/DDA-3379/SA2/P/UN/21261,8/3/2023 6:34:06 AM,Internally Displaced People,2193,2193,0,0,4386,1228,1228,0,0,2456
53,Ethiopia,2021,ETH-21/DDA-3379/SA2/P/UN/21261,8/3/2023 6:34:06 AM,Other,234,234,0,0,468,22,65,0,0,87
53,Ethiopia,2021,ETH-21/DDA-3379/SA2/P/UN/21261,8/3/2023 6:34:06 AM,Overall,4620,4620,0,0,9240,2478,2521,0,0,4999
53,Ethiopia,2021,ETH-21/DDA-3379/SA2/WASH/INGO/21097,9/20/2023 8:22:42 AM,Host Communities,12645,13975,19300,20630,66550,20166,22289,30780,32902,106137
53,Ethiopia,2021,ETH-21/DDA-3379/SA2/WASH/INGO/21097,9/20/2023 8:22:42 AM,Internally Displaced People,6914,7576,10229,10935,35654,10804,11941,16490,17628,56863
53,Ethiopia,2021,ETH-21/DDA-3379/SA2/WASH/INGO/21097,9/20/2023 8:22:42 AM,Overall,19559,21551,29529,31565,102204,30970,34230,47270,50530,163000
53,Ethiopia,2021,ETH-21/DDA-3379/SA2/WASH/INGO/21125,4/17/2023 4:54:13 AM,Host Communities,37480,39020,15920,16580,109000,33799,33830,22753,22255,112637
53,Ethiopia,2021,ETH-21/DDA-3379/SA2/WASH/INGO/21125,4/17/2023 4:54:13 AM,Internally Displaced People,6810,7090,2890,3010,19800,13555,15089,7871,8010,44525
53,Ethiopia,2021,ETH-21/DDA-3379/SA2/WASH/INGO/21125,4/17/2023 4:54:13 AM,Overall,44290,46110,18810,19590,128800,47354,48919,30624,30265,157162
53,Ethiopia,2021,ETH-21/DDA-3379/SA2/WASH/INGO/21285,9/22/2023 5:04:22 AM,Host Communities,3157,3286,3474,3616,13533,7366,8291,4093,4163,23913
53,Ethiopia,2021,ETH-21/DDA-3379/SA2/WASH/INGO/21285,9/22/2023 5:04:22 AM,Internally Displaced People,9470,9859,10421,10846,40596,11047,12438,6139,6246,35870
53,Ethiopia,2021,ETH-21/DDA-3379/SA2/WASH/INGO/21285,9/22/2023 5:04:22 AM,Overall,12627,13145,13895,14462,54129,18413,20729,10232,10409,59783
53,Ethiopia,2021,ETH-21/DDA-3379/SA2/WASH/UN/21146,3/6/2023 6:20:37 AM,Host Communities,949,987,1027,1069,4032,709,739,769,799,3016
53,Ethiopia,2021,ETH-21/DDA-3379/SA2/WASH/UN/21146,3/6/2023 6:20:37 AM,Internally Displaced People,2637,2745,2857,2974,11213,3079,3654,3494,3706,13933
53,Ethiopia,2021,ETH-21/DDA-3379/SA2/WASH/UN/21146,3/6/2023 6:20:37 AM,Overall,3586,3732,3884,4043,15245,3788,4393,4263,4505,16949
53,Ethiopia,2021,ETH-21/DDA-3379/SA2/WASH-P/INGO/21119,8/2/2023 7:55:39 AM,Host Communities,1169,1174,1676,1677,5696,634,576,822,822,2854
53,Ethiopia,2021,ETH-21/DDA-3379/SA2/WASH-P/INGO/21119,8/2/2023 7:55:39 AM,Internally Displaced People,3417,3460,4996,4999,16872,3162,3434,4079,4169,14844
53,Ethiopia,2021,ETH-21/DDA-3379/SA2/WASH-P/INGO/21119,8/2/2023 7:55:39 AM,Overall,5811,5902,8380,8387,28480,7876,7910,10597,10701,37084
53,Ethiopia,2021,ETH-21/DDA-3379/SA2/WASH-P/INGO/21119,8/2/2023 7:55:39 AM,Returnees,1225,1268,1708,1711,5912,4080,3900,5696,5710,19386
53,Ethiopia,2021,ETH-21/DDA-3379/SA2/WASH-P/NGO/21182,1/30/2023 11:25:51 AM,Host Communities,2009,2232,3125,3794,11160,2009,2232,3125,3794,11160
53,Ethiopia,2021,ETH-21/DDA-3379/SA2/WASH-P/NGO/21182,1/30/2023 11:25:51 AM,Internally Displaced People,3731,4145,5803,7047,20726,3731,4145,5803,7047,20726
53,Ethiopia,2021,ETH-21/DDA-3379/SA2/WASH-P/NGO/21182,1/30/2023 11:25:51 AM,Overall,5740,6377,8928,10841,31886,5740,6377,8928,10841,31886
53,Ethiopia,2022,ETH-22/DDA-3379/RA1/A/INGO/21808,3/6/2023 6:25:20 AM,Host Communities,24021,27023,0,0,51044,24021,27023,0,0,51044
53,Ethiopia,2022,ETH-22/DDA-3379/RA1/A/INGO/21808,3/6/2023 6:25:20 AM,Internally Displaced People,8007,9008,0,0,17015,8007,9008,0,0,17015
53,Ethiopia,2022,ETH-22/DDA-3379/RA1/A/INGO/21808,3/6/2023 6:25:20 AM,Overall,32028,36031,0,0,68059,32028,36031,0,0,68059
53,Ethiopia,2022,ETH-22/DDA-3379/RA1/A/INGO/21833,1/9/2023 5:24:50 AM,Host Communities,24000,30000,33000,36000,123000,34654,43316,47650,51979,177599
53,Ethiopia,2022,ETH-22/DDA-3379/RA1/A/INGO/21833,1/9/2023 5:24:50 AM,Internally Displaced People,468,586,642,704,2400,469,586,642,704,2401
53,Ethiopia,2022,ETH-22/DDA-3379/RA1/A/INGO/21833,1/9/2023 5:24:50 AM,Overall,24468,30586,33642,36704,125400,35123,43902,48292,52683,180000
53,Ethiopia,2022,ETH-22/DDA-3379/RA1/A/NGO/21790,1/13/2023 10:39:56 AM,Host Communities,33000,28543,1457,2100,65100,31350,27460,1650,1540,62000
53,Ethiopia,2022,ETH-22/DDA-3379/RA1/A/NGO/21790,1/13/2023 10:39:56 AM,Overall,33000,28543,1457,2100,65100,31350,27460,1650,1540,62000
53,Ethiopia,2022,ETH-22/DDA-3379/RA1/A/NGO/21848,12/22/2022 6:05:40 AM,Host Communities,2000,3000,0,0,5000,2000,3000,9900,10100,25000
53,Ethiopia,2022,ETH-22/DDA-3379/RA1/A/NGO/21848,12/22/2022 6:05:40 AM,Overall,2000,3000,0,0,5000,2000,3000,9900,10100,25000
53,Ethiopia,2022,ETH-22/DDA-3379/RA1/H/NGO/21793,1/13/2023 6:36:35 AM,Host Communities,14927,20983,13384,13928,63222,13905,33115,13353,13221,73594
53,Ethiopia,2022,ETH-22/DDA-3379/RA1/H/NGO/21793,1/13/2023 6:36:35 AM,Internally Displaced People,10229,14380,9172,9545,43326,6868,13528,7298,6745,34439
53,Ethiopia,2022,ETH-22/DDA-3379/RA1/H/NGO/21793,1/13/2023 6:36:35 AM,Overall,25156,35363,22556,23473,106548,20773,46643,20651,19966,108033
53,Ethiopia,2022,ETH-22/DDA-3379/RA1/NFI/ES/NGO/21811,12/22/2022 4:32:38 AM,Internally Displaced People,3268,3401,3685,3836,14190,4270,4460,4817,5029,18576
53,Ethiopia,2022,ETH-22/DDA-3379/RA1/NFI/ES/NGO/21811,12/22/2022 4:32:38 AM,Overall,3268,3401,3685,3836,14190,4270,4460,4817,5029,18576
53,Ethiopia,2022,ETH-22/DDA-3379/RA1/WASH/INGO/21792,4/4/2023 6:06:24 AM,Other,27557,29720,15457,15266,88000,29041,31705,16312,16284,93342
53,Ethiopia,2022,ETH-22/DDA-3379/RA1/WASH/INGO/21792,4/4/2023 6:06:24 AM,Overall,27557,29720,15457,15266,88000,29041,31705,16312,16284,93342
53,Ethiopia,2022,ETH-22/DDA-3379/RA1/WASH/INGO/21797,3/6/2023 6:31:08 AM,Host Communities,12060,13770,13014,16506,55350,12150,13870,13106,16684,55810
53,Ethiopia,2022,ETH-22/DDA-3379/RA1/WASH/INGO/21797,3/6/2023 6:31:08 AM,Internally Displaced People,1340,1530,1446,1834,6150,1380,1570,1480,1860,6290
53,Ethiopia,2022,ETH-22/DDA-3379/RA1/WASH/INGO/21797,3/6/2023 6:31:08 AM,Overall,13400,15300,14460,18340,61500,13530,15440,14586,18544,62100
53,Ethiopia,2022,ETH-22/DDA-3379/RA1/WASH/INGO/21877,4/17/2023 5:06:44 AM,Internally Displaced People,4736,5016,9190,8915,27857,9736,10367,6340,6043,32486
53,Ethiopia,2022,ETH-22/DDA-3379/RA1/WASH/INGO/21877,4/17/2023 5:06:44 AM,Overall,4736,5016,9190,8915,27857,9736,10367,6340,6043,32486
53,Ethiopia,2022,ETH-22/DDA-3379/RA1/WASH/NGO/21809,4/17/2023 4:51:58 AM,Host Communities,2100,2200,1400,1500,7200,2100,2200,1400,1500,7200
53,Ethiopia,2022,ETH-22/DDA-3379/RA1/WASH/NGO/21809,4/17/2023 4:51:58 AM,Internally Displaced People,2000,2000,2600,2500,9100,2000,2000,2600,2500,9100
53,Ethiopia,2022,ETH-22/DDA-3379/RA1/WASH/NGO/21809,4/17/2023 4:51:58 AM,Overall,4900,5100,4900,5100,20000,4900,5100,4900,5100,20000
53,Ethiopia,2022,ETH-22/DDA-3379/RA1/WASH/NGO/21809,4/17/2023 4:51:58 AM,Returnees,800,900,900,1100,3700,800,900,900,1100,3700
53,Ethiopia,2022,ETH-22/DDA-3379/RA2/CCCM/UN/22020,4/4/2023 6:57:51 AM,Host Communities,673,672,967,970,3282,504,527,730,754,2515
53,Ethiopia,2022,ETH-22/DDA-3379/RA2/CCCM/UN/22020,4/4/2023 6:57:51 AM,Internally Displaced People,4820,4819,6939,6939,23517,4487,4690,6500,6707,22384
53,Ethiopia,2022,ETH-22/DDA-3379/RA2/CCCM/UN/22020,4/4/2023 6:57:51 AM,Overall,5493,5491,7906,7909,26799,4991,5217,7230,7461,24899
53,Ethiopia,2022,ETH-22/DDA-3379/RA2/CCCM/UN/22086,7/5/2023 7:58:45 AM,Internally Displaced People,27993,29007,0,0,57000,15681,18184,5571,5276,44712
53,Ethiopia,2022,ETH-22/DDA-3379/RA2/CCCM/UN/22086,7/5/2023 7:58:45 AM,Overall,27993,29007,0,0,57000,15681,18184,5571,5276,44712
53,Ethiopia,2022,ETH-22/DDA-3379/RA2/NFI/ES/INGO/22036,8/7/2023 6:31:28 AM,Internally Displaced People,2425,2576,5001,5153,15155,5623,6683,3235,3155,18696
53,Ethiopia,2022,ETH-22/DDA-3379/RA2/NFI/ES/INGO/22036,8/7/2023 6:31:28 AM,Overall,2425,2576,5001,5153,15155,5623,6683,3235,3155,18696
53,Ethiopia,2022,ETH-22/DDA-3379/RA2/NFI/ES/NGO/22035,8/10/2023 6:58:48 AM,Internally Displaced People,1130,1300,850,783,4063,1130,1300,850,783,4063
53,Ethiopia,2022,ETH-22/DDA-3379/RA2/NFI/ES/NGO/22035,8/10/2023 6:58:48 AM,Overall,1130,1300,850,783,4063,1130,1300,850,783,4063
53,Ethiopia,2022,ETH-22/DDA-3379/RA2/NFI/ES/UN/22040,4/4/2023 7:02:09 AM,Internally Displaced People,6300,6834,2813,3003,18950,5091,5576,6546,6987,24200
53,Ethiopia,2022,ETH-22/DDA-3379/RA2/NFI/ES/UN/22040,4/4/2023 7:02:09 AM,Overall,6300,6834,2813,3003,18950,5091,5576,6546,6987,24200
53,Ethiopia,2022,ETH-22/DDA-3379/RA2/WASH/INGO/22081,8/8/2023 7:37:00 AM,Host Communities,1200,1300,1150,1350,5000,12448,13179,3099,3051,31777
53,Ethiopia,2022,ETH-22/DDA-3379/RA2/WASH/INGO/22081,8/8/2023 7:37:00 AM,Internally Displaced People,1200,1300,1150,1750,5400,2309,2444,1902,2051,8706
53,Ethiopia,2022,ETH-22/DDA-3379/RA2/WASH/INGO/22081,8/8/2023 7:37:00 AM,Overall,2400,2600,2300,3100,10400,14757,15623,5001,5102,40483
53,Ethiopia,2022,ETH-22/DDA-3379/RA2/WASH/INGO/22096,7/6/2023 9:18:08 AM,Internally Displaced People,5940,7260,9570,10230,33000,7210,8812,11615,12417,40054
53,Ethiopia,2022,ETH-22/DDA-3379/RA2/WASH/INGO/22096,7/6/2023 9:18:08 AM,Overall,5940,7260,9570,10230,33000,7210,8812,11615,12417,40054
53,Ethiopia,2022,ETH-22/DDA-3379/RA2/WASH/INGO/22257,4/4/2023 5:59:30 AM,Host Communities,2609,1127,3116,1648,8500,7899,8221,4841,5039,26000
53,Ethiopia,2022,ETH-22/DDA-3379/RA2/WASH/INGO/22257,4/4/2023 5:59:30 AM,Internally Displaced People,1037,1107,678,678,3500,2110,2066,1241,1546,6963
53,Ethiopia,2022,ETH-22/DDA-3379/RA2/WASH/INGO/22257,4/4/2023 5:59:30 AM,Overall,3646,2234,3794,2326,12000,10009,10287,6082,6585,32963
53,Ethiopia,2022,ETH-22/DDA-3379/RA2/WASH/NGO/22057,5/5/2023 4:35:28 AM,Host Communities,356,356,267,267,1246,300,295,211,240,1046
53,Ethiopia,2022,ETH-22/DDA-3379/RA2/WASH/NGO/22057,5/5/2023 4:35:28 AM,Internally Displaced People,7889,9173,9662,13026,39750,8889,9582,9607,13113,41191
53,Ethiopia,2022,ETH-22/DDA-3379/RA2/WASH/NGO/22057,5/5/2023 4:35:28 AM,Overall,8245,9529,9929,13293,40996,9189,9877,9818,13353,42237
72,Iraq,2015,IRQ-15/3884/SA/CCCM/INGO/1759,2/17/2017 11:30:00 AM,Internally Displaced People,3047,3186,3809,3810,13852,6623,6925,8280,8281,30109
72,Iraq,2015,IRQ-15/3884/SA/CCCM/INGO/1759,2/17/2017 11:30:00 AM,Other,20,20,0,0,40,0,0,0,0,0
72,Iraq,2015,IRQ-15/3884/SA/CCCM/INGO/1759,2/17/2017 11:30:00 AM,Overall,0,0,0,0,0,6623,6925,8280,8281,30109
72,Iraq,2015,IRQ-15/3884/SA/E/INGO/1785,11/5/2016 3:36:29 PM,Host Communities,57,85,333,499,974,74,75,425,467,1041
72,Iraq,2015,IRQ-15/3884/SA/E/INGO/1785,11/5/2016 3:36:29 PM,Internally Displaced People,227,341,1331,1997,3896,537,286,1485,1528,3836
72,Iraq,2015,IRQ-15/3884/SA/E/INGO/1785,11/5/2016 3:36:29 PM,Overall,284,426,1664,2496,4870,611,361,1910,1995,4877
72,Iraq,2015,IRQ-15/3884/SA/E/NGO/1776,4/9/2020 9:12:21 AM,Internally Displaced People,30,30,2000,2000,4060,60,60,2000,2000,4120
72,Iraq,2015,IRQ-15/3884/SA/E/NGO/1776,4/9/2020 9:12:21 AM,Overall,30,30,2000,2000,4060,60,60,2000,2000,4120
72,Iraq,2015,IRQ-15/3884/SA/E/UN/1872,7/15/2019 1:45:50 PM,Host Communities,0,0,3750,3750,7500,84,100,6028,4841,11053
72,Iraq,2015,IRQ-15/3884/SA/E/UN/1872,7/15/2019 1:45:50 PM,Internally Displaced People,0,0,1155,1155,2310,43,60,5791,5317,11211
72,Iraq,2015,IRQ-15/3884/SA/E/UN/1872,7/15/2019 1:45:50 PM,Overall,0,0,4905,4905,9810,160,127,11819,10158,22264
72,Iraq,2015,IRQ-15/3884/SA/ELSC/INGO/1786,6/25/2016 8:03:47 AM,Host Communities,100,300,150,300,850,199,354,960,2806,4319
72,Iraq,2015,IRQ-15/3884/SA/ELSC/INGO/1786,6/25/2016 8:03:47 AM,Internally Displaced People,100,700,400,700,1900,238,416,710,1357,2721
72,Iraq,2015,IRQ-15/3884/SA/ELSC/INGO/1786,6/25/2016 8:03:47 AM,Other,40,40,0,0,80,47,53,0,0,100
72,Iraq,2015,IRQ-15/3884/SA/ELSC/INGO/1786,6/25/2016 8:03:47 AM,Overall,240,1040,550,1000,2830,484,823,1670,4163,7140
72,Iraq,2015,IRQ-15/3884/SA/ELSC/INGO/1788,6/13/2016 1:11:11 PM,Host Communities,158,178,114,129,579,163,182,132,151,628
72,Iraq,2015,IRQ-15/3884/SA/ELSC/INGO/1788,6/13/2016 1:11:11 PM,Internally Displaced People,368,415,266,300,1349,381,425,308,352,1466
72,Iraq,2015,IRQ-15/3884/SA/ELSC/INGO/1788,6/13/2016 1:11:11 PM,Overall,526,593,380,429,1928,544,607,440,503,2094
72,Iraq,2015,IRQ-15/3884/SA/ELSC/NGO/1778,7/21/2019 6:37:08 AM,Host Communities,149,168,108,122,547,202,205,299,263,969
72,Iraq,2015,IRQ-15/3884/SA/ELSC/NGO/1778,7/21/2019 6:37:08 AM,Internally Displaced People,348,393,252,284,1277,411,462,408,420,1701
72,Iraq,2015,IRQ-15/3884/SA/ELSC/NGO/1778,7/21/2019 6:37:08 AM,Overall,497,561,360,406,1824,613,667,707,683,2670
72,Iraq,2015,IRQ-15/3884/SA/F/NGO/1756,9/4/2016 8:43:16 AM,Host Communities,290,290,220,200,1000,0,0,0,0,0
72,Iraq,2015,IRQ-15/3884/SA/F/NGO/1756,9/4/2016 8:43:16 AM,Internally Displaced People,1679,2190,1387,2044,7300,2550,2497,1665,2335,9047
72,Iraq,2015,IRQ-15/3884/SA/F/NGO/1756,9/4/2016 8:43:16 AM,Overall,1969,2480,1607,2244,8300,2550,2497,1665,2335,9047
72,Iraq,2015,IRQ-15/3884/SA/F/NGO/1761,4/7/2016 11:38:07 AM,Internally Displaced People,5000,6000,2500,3000,16500,5661,6794,2830,3400,18685
72,Iraq,2015,IRQ-15/3884/SA/F/NGO/1761,4/7/2016 11:38:07 AM,Overall,5000,6000,2500,3000,16500,5661,6794,2830,3400,18685
72,Iraq,2015,IRQ-15/3884/SA/F/UN/1870,8/8/2016 12:31:41 PM,Other,12348,12852,0,0,25200,12348,12852,0,0,25200
72,Iraq,2015,IRQ-15/3884/SA/F/UN/1870,8/8/2016 12:31:41 PM,Overall,12348,12852,0,0,25200,12348,12852,0,0,25200
72,Iraq,2015,IRQ-15/3884/SA/H/INGO/1746,6/15/2016 1:15:09 PM,Host Communities,3001,2884,2359,2456,10700,1619,2363,1663,1508,7153
72,Iraq,2015,IRQ-15/3884/SA/H/INGO/1746,6/15/2016 1:15:09 PM,Internally Displaced People,11024,10591,8666,9019,39300,3780,5516,3881,3520,16697
72,Iraq,2015,IRQ-15/3884/SA/H/INGO/1746,6/15/2016 1:15:09 PM,Overall,14025,13475,11025,11475,50000,5399,7879,5544,5028,23850
72,Iraq,2015,IRQ-15/3884/SA/H/INGO/1795,5/15/2019 12:37:59 PM,Internally Displaced People,4043,4208,3307,3442,15000,1968,3089,2104,1762,8923
72,Iraq,2015,IRQ-15/3884/SA/H/INGO/1795,5/15/2019 12:37:59 PM,Overall,4043,4208,3307,3442,15000,1968,3089,2104,1762,8923
72,Iraq,2015,IRQ-15/3884/SA/H/INGO/1815,2/17/2017 11:10:09 AM,Host Communities,2990,3510,3250,3250,13000,2200,2311,1400,1110,7021
72,Iraq,2015,IRQ-15/3884/SA/H/INGO/1815,2/17/2017 11:10:09 AM,Internally Displaced People,11960,14040,13000,13000,52000,8469,7757,8532,7250,32008
72,Iraq,2015,IRQ-15/3884/SA/H/INGO/1815,2/17/2017 11:10:09 AM,Overall,14950,17550,16250,16250,65000,10669,10068,9932,8360,39029
72,Iraq,2015,IRQ-15/3884/SA/H/INGO/1816,7/22/2016 1:36:41 PM,Internally Displaced People,4940,8320,6760,5980,26000,4072,6816,4701,4811,20400
72,Iraq,2015,IRQ-15/3884/SA/H/INGO/1816,7/22/2016 1:36:41 PM,Overall,4940,8320,6760,5980,26000,4072,6816,4701,4811,20400
72,Iraq,2015,IRQ-15/3884/SA/H/NGO/1745,8/7/2016 7:55:33 AM,Internally Displaced People,3000,5000,1000,2000,11000,6823,5388,1870,1789,15870
72,Iraq,2015,IRQ-15/3884/SA/H/NGO/1745,8/7/2016 7:55:33 AM,Other,8000,8000,1000,1000,18000,4549,3592,1247,1192,10580
72,Iraq,2015,IRQ-15/3884/SA/H/NGO/1745,8/7/2016 7:55:33 AM,Overall,11000,14000,2000,3000,30000,11372,8980,3117,2981,26450
72,Iraq,2015,IRQ-15/3884/SA/H/UN/1803,1/22/2019 7:41:53 AM,Host Communities,60907,63393,49940,51867,226107,52886,50772,55002,52886,211546
72,Iraq,2015,IRQ-15/3884/SA/H/UN/1803,1/22/2019 7:41:53 AM,Internally Displaced People,91360,95090,74912,77801,339163,79330,76156,82502,79330,317318
72,Iraq,2015,IRQ-15/3884/SA/H/UN/1803,1/22/2019 7:41:53 AM,Overall,152267,158483,124852,129668,565270,132216,126927,137505,132216,528864
72,Iraq,2015,IRQ-15/3884/SA/H/UN/1871,6/13/2016 6:52:58 AM,Host Communities,2160,3240,900,900,7200,2043,2409,1023,1169,6644
72,Iraq,2015,IRQ-15/3884/SA/H/UN/1871,6/13/2016 6:52:58 AM,Internally Displaced People,19500,29200,8100,8100,64900,28812,31111,21851,26645,108419
72,Iraq,2015,IRQ-15/3884/SA/H/UN/1871,6/13/2016 6:52:58 AM,Overall,21600,32400,9000,9000,72000,30855,33520,22874,27814,115063
72,Iraq,2015,IRQ-15/3884/SA/H/UN/1970,8/8/2016 2:34:39 PM,Host Communities,0,0,3054794,2935000,5989794,0,0,1713192,1783119,3496311
72,Iraq,2015,IRQ-15/3884/SA/H/UN/1970,8/8/2016 2:34:39 PM,Internally Displaced People,0,0,229353,220355,449708,0,0,176914,184135,361049
72,Iraq,2015,IRQ-15/3884/SA/H/UN/1970,8/8/2016 2:34:39 PM,Overall,0,0,2449878,2353807,4803685,0,0,1890106,1967254,3857360
72,Iraq,2015,IRQ-15/3884/SA/NFIs/INGO/1822,8/4/2016 12:58:15 PM,Internally Displaced People,2889,3006,983,983,7861,1789,1947,2210,2134,8080
72,Iraq,2015,IRQ-15/3884/SA/NFIs/INGO/1822,8/4/2016 12:58:15 PM,Overall,2888,3006,983,983,7860,1789,1947,2210,2134,8080
72,Iraq,2015,IRQ-15/3884/SA/NFIs/INGO/1823,2/21/2017 6:33:18 PM,Internally Displaced People,1874,1951,637,638,5100,1546,1631,1604,1615,6396
72,Iraq,2015,IRQ-15/3884/SA/NFIs/INGO/1823,2/21/2017 6:33:18 PM,Overall,1874,1951,637,638,5100,1546,1631,1604,1615,6396
72,Iraq,2015,IRQ-15/3884/SA/NFIs/INGO/1965,6/16/2016 1:52:20 PM,Internally Displaced People,1637,1577,882,882,4978,1418,1369,1327,1236,5350
72,Iraq,2015,IRQ-15/3884/SA/NFIs/INGO/1965,6/16/2016 1:52:20 PM,Overall,1637,1577,882,882,4978,1418,1369,1327,1236,5350
72,Iraq,2015,IRQ-15/3884/SA/NFIs/NGO/1779,10/31/2016 11:07:20 AM,Internally Displaced People,943,1230,779,1148,4100,1478,1647,1154,1031,5310
72,Iraq,2015,IRQ-15/3884/SA/NFIs/NGO/1779,10/31/2016 11:07:20 AM,Overall,943,1230,779,1148,4100,1478,1647,1154,1031,5310
72,Iraq,2015,IRQ-15/3884/SA/NFIs/NGO/1818,4/12/2016 5:18:59 PM,Internally Displaced People,200,380,820,600,2000,200,380,820,600,2000
72,Iraq,2015,IRQ-15/3884/SA/NFIs/NGO/1818,4/12/2016 5:18:59 PM,Overall,200,380,820,600,2000,200,380,820,600,2000
72,Iraq,2015,IRQ-15/3884/SA/P/INGO/1760,8/9/2016 1:24:17 PM,Internally Displaced People,200,50,50,100,400,181,708,65,74,1028
72,Iraq,2015,IRQ-15/3884/SA/P/INGO/1760,8/9/2016 1:24:17 PM,Overall,200,50,50,100,400,181,708,65,74,1028
72,Iraq,2015,IRQ-15/3884/SA/P/INGO/1808,9/4/2016 10:05:32 AM,Internally Displaced People,100,100,400,400,1000,245,262,1917,1527,3951
72,Iraq,2015,IRQ-15/3884/SA/P/INGO/1808,9/4/2016 10:05:32 AM,Overall,100,100,400,400,1000,245,262,1917,1527,3951
72,Iraq,2015,IRQ-15/3884/SA/P/INGO/1972,11/5/2016 3:30:11 PM,Host Communities,160,240,400,600,1400,221,153,341,411,1126
72,Iraq,2015,IRQ-15/3884/SA/P/INGO/1972,11/5/2016 3:30:11 PM,Internally Displaced People,240,360,600,900,2100,445,280,2534,2280,5539
72,Iraq,2015,IRQ-15/3884/SA/P/INGO/1972,11/5/2016 3:30:11 PM,Overall,400,600,1000,1500,3500,666,433,2875,2691,6665
72,Iraq,2015,IRQ-15/3884/SA/P/NGO/1758,6/14/2016 7:27:28 AM,Host Communities,0,25,0,0,25,4,21,0,0,25
72,Iraq,2015,IRQ-15/3884/SA/P/NGO/1758,6/14/2016 7:27:28 AM,Internally Displaced People,1970,1830,0,0,3800,1976,1876,0,0,3852
72,Iraq,2015,IRQ-15/3884/SA/P/NGO/1758,6/14/2016 7:27:28 AM,Overall,1970,1855,0,0,3825,1980,1897,0,0,3877
72,Iraq,2015,IRQ-15/3884/SA/P/NGO/1807,11/25/2016 5:28:45 PM,Internally Displaced People,0,45000,0,19700,64700,0,36264,0,27165,63429
72,Iraq,2015,IRQ-15/3884/SA/P/NGO/1807,11/25/2016 5:28:45 PM,Overall,0,45000,0,19700,64700,0,36264,0,27165,63429
72,Iraq,2015,IRQ-15/3884/SA/WASH/INGO/1770,6/13/2016 2:38:57 PM,Host Communities,1656,1656,1800,2088,7200,649,650,826,803,2928
72,Iraq,2015,IRQ-15/3884/SA/WASH/INGO/1770,6/13/2016 2:38:57 PM,Internally Displaced People,2760,2760,3000,3480,12000,631,631,803,0,2065
72,Iraq,2015,IRQ-15/3884/SA/WASH/INGO/1770,6/13/2016 2:38:57 PM,Other,1104,1104,1200,1392,4800,6930,6930,8820,8820,31500
72,Iraq,2015,IRQ-15/3884/SA/WASH/INGO/1770,6/13/2016 2:38:57 PM,Overall,5520,5520,6000,6960,24000,8210,8210,10450,10450,37320
72,Iraq,2015,IRQ-15/3884/SA/WASH/INGO/1787,7/23/2016 9:37:36 AM,Internally Displaced People,1384,1362,1490,1456,5692,1974,1864,1393,1392,6623
72,Iraq,2015,IRQ-15/3884/SA/WASH/INGO/1787,7/23/2016 9:37:36 AM,Other,2353,2260,2493,2394,9500,6625,6255,4675,4671,22226
72,Iraq,2015,IRQ-15/3884/SA/WASH/INGO/1787,7/23/2016 9:37:36 AM,Overall,3737,3622,3983,3850,15192,8599,8119,6068,6063,28849
72,Iraq,2015,IRQ-15/3884/SA/WASH/INGO/1791,10/31/2016 10:29:22 AM,Internally Displaced People,2609,2609,3044,2610,10872,2752,2871,2985,2688,11296
72,Iraq,2015,IRQ-15/3884/SA/WASH/INGO/1791,10/31/2016 10:29:22 AM,Overall,2609,2609,3044,2610,10872,2752,2871,2985,2688,11296
72,Iraq,2015,IRQ-15/3884/SA/WASH/INGO/1793,2/21/2017 6:34:58 PM,Internally Displaced People,84486,84486,56325,56325,281622,61957,64773,78854,76038,281622
72,Iraq,2015,IRQ-15/3884/SA/WASH/INGO/1793,2/21/2017 6:34:58 PM,Overall,84486,84486,56325,56325,281622,248957,260273,316854,305538,1131622
72,Iraq,2015,IRQ-15/3884/SA/WASH/INGO/1794,9/4/2016 10:57:11 AM,Host Communities,490,509,167,167,1333,658,703,219,235,1815
72,Iraq,2015,IRQ-15/3884/SA/WASH/INGO/1794,9/4/2016 10:57:11 AM,Internally Displaced People,3920,4081,1334,1334,10669,3331,3563,1111,1187,9192
72,Iraq,2015,IRQ-15/3884/SA/WASH/INGO/1794,9/4/2016 10:57:11 AM,Overall,4410,4590,1500,1500,12000,3989,4266,1330,1422,11007
72,Iraq,2015,IRQ-15/3884/SA/WASH/INGO/1814,6/15/2016 1:44:53 PM,Host Communities,1268,1310,1211,1211,5000,1017,1297,1086,1447,4847
72,Iraq,2015,IRQ-15/3884/SA/WASH/INGO/1814,6/15/2016 1:44:53 PM,Internally Displaced People,5070,5242,4844,4844,20000,11055,12498,3397,2691,29641
72,Iraq,2015,IRQ-15/3884/SA/WASH/INGO/1814,6/15/2016 1:44:53 PM,Overall,6338,6552,6055,6055,25000,12072,13795,4483,4138,34488
72,Iraq,2015,IRQ-15/3884/SA/WASH/INGO/1819,1/18/2017 8:37:21 AM,Internally Displaced People,9438,13325,8493,8494,39750,12064,14527,10833,10834,48258
72,Iraq,2015,IRQ-15/3884/SA/WASH/INGO/1819,1/18/2017 8:37:21 AM,Other,2438,2925,2193,2194,9750,0,0,0,0,0
72,Iraq,2015,IRQ-15/3884/SA/WASH/INGO/1819,1/18/2017 8:37:21 AM,Overall,11875,14250,10687,10688,47500,12064,14527,10833,10834,48258
72,Iraq,2015,IRQ-15/3884/SA/WASH/NGO/1780,8/4/2016 8:50:11 AM,Host Communities,1240,1260,1235,1265,5000,213,204,170,163,750
72,Iraq,2015,IRQ-15/3884/SA/WASH/NGO/1780,8/4/2016 8:50:11 AM,Internally Displaced People,15229,15754,13754,15263,60000,13343,12799,10695,10303,47140
72,Iraq,2015,IRQ-15/3884/SA/WASH/NGO/1780,8/4/2016 8:50:11 AM,Overall,24843,25685,22551,24921,98000,13556,13003,10865,10466,47890
72,Iraq,2015,IRQ-15/3884/SA/WASH/NGO/1817,6/30/2016 8:34:14 AM,Host Communities,180000,190000,340000,290000,1000000,0,0,0,0,0
72,Iraq,2015,IRQ-15/3884/SA/WASH/NGO/1817,6/30/2016 8:34:14 AM,Internally Displaced People,163042,133146,362794,353018,1012000,5092,6530,4336,5564,21522
72,Iraq,2015,IRQ-15/3884/SA/WASH/NGO/1817,6/30/2016 8:34:14 AM,Overall,261521,256573,521397,466509,1506000,2546,3265,2168,2782,10761
72,Iraq,2015,IRQ-15/3884/SA/WASH/UN/1966,10/23/2016 10:01:22 AM,Internally Displaced People,33163,31862,31862,30613,127500,45019,43254,43254,41557,173084
72,Iraq,2015,IRQ-15/3884/SA/WASH/UN/1966,10/23/2016 10:01:22 AM,Other,5852,5623,5623,5402,22500,7945,7632,7633,7334,30544
72,Iraq,2015,IRQ-15/3884/SA/WASH/UN/1966,10/23/2016 10:01:22 AM,Overall,39015,37485,37485,36015,150000,52964,50887,50886,48891,203628
72,Iraq,2016,IRQ-16/3884/R/CCCM/INGO/3154,7/12/2017 2:11:47 PM,Internally Displaced People,4600,6500,5200,5300,21600,4831,4873,3496,3703,16903
72,Iraq,2016,IRQ-16/3884/R/CCCM/INGO/3154,7/12/2017 2:11:47 PM,Overall,4600,6500,5200,5300,21600,4831,4873,3496,3703,16903
72,Iraq,2016,IRQ-16/3884/R/CCCM/UN/3158,6/20/2017 2:05:24 PM,Internally Displaced People,1380,1620,1440,1560,6000,930,1209,1355,1690,5184
72,Iraq,2016,IRQ-16/3884/R/CCCM/UN/3158,6/20/2017 2:05:24 PM,Overall,1380,1620,1440,1560,6000,930,1209,1355,1690,5184
72,Iraq,2016,IRQ-16/3884/R/H/UN/3394,7/21/2019 6:44:42 AM,Internally Displaced People,15000,25000,30000,30000,100000,20000,30000,30000,30000,110000
72,Iraq,2016,IRQ-16/3884/R/H/UN/3394,7/21/2019 6:44:42 AM,Overall,15000,25000,30000,30000,100000,20000,30000,30000,30000,110000
72,Iraq,2016,IRQ-16/3884/R/H/UN/3404,3/28/2017 2:28:24 PM,Internally Displaced People,0,60000,86700,83300,230000,0,52940,78540,75460,206940
72,Iraq,2016,IRQ-16/3884/R/H/UN/3404,3/28/2017 2:28:24 PM,Overall,0,60000,86700,83300,230000,0,52940,78540,75460,206940
72,Iraq,2016,IRQ-16/3884/R/H-RRM/UN/3361,4/27/2017 9:50:58 AM,Internally Displaced People,0,169000,0,18500,187500,0,141400,0,15540,156940
72,Iraq,2016,IRQ-16/3884/R/H-RRM/UN/3361,4/27/2017 9:50:58 AM,Overall,0,169000,0,18500,187500,0,141400,0,15540,156940
72,Iraq,2016,IRQ-16/3884/R/RRM/UN/3403,5/9/2018 8:30:16 AM,Internally Displaced People,49410,49410,43920,40260,183000,47367,47367,42105,38596,175435
72,Iraq,2016,IRQ-16/3884/R/RRM/UN/3403,5/9/2018 8:30:16 AM,Overall,49410,49410,43920,40260,183000,47367,47367,42105,38596,175435
72,Iraq,2016,IRQ-16/3884/R/WASH/UN/3366,3/28/2017 2:29:25 PM,Internally Displaced People,22500,27500,22500,27500,100000,22391,27370,22391,27370,99522
72,Iraq,2016,IRQ-16/3884/R/WASH/UN/3366,3/28/2017 2:29:25 PM,Overall,22500,27500,22500,27500,100000,22391,27370,22391,27370,99522
72,Iraq,2016,IRQ-16/3884/RA/CASH/INGO/2401,11/16/2016 11:02:40 AM,Host Communities,48,36,0,0,84,31,132,0,0,163
72,Iraq,2016,IRQ-16/3884/RA/CASH/INGO/2401,11/16/2016 11:02:40 AM,Internally Displaced People,70,98,0,0,168,44,201,0,0,245
72,Iraq,2016,IRQ-16/3884/RA/CASH/INGO/2401,11/16/2016 11:02:40 AM,Other,98,70,0,0,168,0,0,0,0,0
72,Iraq,2016,IRQ-16/3884/RA/CASH/INGO/2401,11/16/2016 11:02:40 AM,Overall,176,244,0,0,420,333,75,0,0,408
72,Iraq,2016,IRQ-16/3884/RA/CASH/INGO/2402,1/13/2017 4:55:26 PM,Internally Displaced People,747,801,561,561,2670,1284,1252,0,0,2536
72,Iraq,2016,IRQ-16/3884/RA/CASH/INGO/2402,1/13/2017 4:55:26 PM,Overall,747,801,561,561,2670,1284,1252,0,0,2536
72,Iraq,2016,IRQ-16/3884/RA/CASH/INGO/2430,10/24/2016 1:32:41 PM,Internally Displaced People,200,840,510,850,2400,471,323,749,855,2398
72,Iraq,2016,IRQ-16/3884/RA/CASH/INGO/2430,10/24/2016 1:32:41 PM,Overall,200,840,510,850,2400,471,323,749,855,2398
72,Iraq,2016,IRQ-16/3884/S/CASH/INGO/3551,5/17/2017 12:28:12 PM,Internally Displaced People,1005,1121,1091,1023,4240,958,1108,1127,1075,4268
72,Iraq,2016,IRQ-16/3884/S/CASH/INGO/3551,5/17/2017 12:28:12 PM,Other,488,606,617,604,2315,586,678,691,658,2613
72,Iraq,2016,IRQ-16/3884/S/CASH/INGO/3551,5/17/2017 12:28:12 PM,Overall,1493,1727,1708,1627,6555,1544,1786,1818,1733,6881
72,Iraq,2016,IRQ-16/3884/S/CASH/INGO/3683,7/24/2017 11:20:20 AM,Host Communities,134,134,118,109,495,415,381,576,568,1940
72,Iraq,2016,IRQ-16/3884/S/CASH/INGO/3683,7/24/2017 11:20:20 AM,Internally Displaced People,401,401,356,327,1485,92,89,124,93,398
72,Iraq,2016,IRQ-16/3884/S/CASH/INGO/3683,7/24/2017 11:20:20 AM,Other,801,801,714,654,2970,490,546,634,571,2241
72,Iraq,2016,IRQ-16/3884/S/CASH/INGO/3683,7/24/2017 11:20:20 AM,Overall,1336,1336,1188,1090,4950,997,1016,1334,1232,4579
72,Iraq,2016,IRQ-16/3884/S/CASH/INGO/3956,9/18/2017 10:56:36 AM,Internally Displaced People,720,884,1598,1598,4800,1293,1326,1435,1474,5528
72,Iraq,2016,IRQ-16/3884/S/CASH/INGO/3956,9/18/2017 10:56:36 AM,Overall,720,884,1598,1598,4800,1293,1326,1435,1474,5528
72,Iraq,2016,IRQ-16/3884/S/CCCM/INGO/3710,10/18/2017 2:43:46 PM,Internally Displaced People,16324,16110,22896,24670,80000,20889,20615,29299,31569,102372
72,Iraq,2016,IRQ-16/3884/S/CCCM/INGO/3710,10/18/2017 2:43:46 PM,Overall,16324,16110,22896,24670,80000,20889,20615,29299,31569,102372
72,Iraq,2016,IRQ-16/3884/S/CCCM/INGO/3733,1/17/2019 8:10:20 AM,Other,200,200,0,0,400,200,200,0,0,400
72,Iraq,2016,IRQ-16/3884/S/CCCM/INGO/3733,1/17/2019 8:10:20 AM,Overall,200,200,0,0,400,200,200,0,0,400
72,Iraq,2016,IRQ-16/3884/S/CCS/INGO/4207,9/19/2017 5:38:40 PM,Overall,50,50,26,26,152,50,50,26,26,152
72,Iraq,2016,IRQ-16/3884/S/E/INGO/3536,5/8/2018 2:34:03 PM,Host Communities,127,127,100,100,454,65,0,545,537,1147
72,Iraq,2016,IRQ-16/3884/S/E/INGO/3536,5/8/2018 2:34:03 PM,Internally Displaced People,507,507,2400,2400,5814,1400,1105,6311,5607,14423
72,Iraq,2016,IRQ-16/3884/S/E/INGO/3536,5/8/2018 2:34:03 PM,Overall,634,634,2500,2500,6268,1465,1105,6856,6144,15570
72,Iraq,2016,IRQ-16/3884/S/E/INGO/3746,4/15/2017 2:45:51 PM,Internally Displaced People,0,0,1700,1700,3400,0,0,1700,1700,3400
72,Iraq,2016,IRQ-16/3884/S/E/INGO/3746,4/15/2017 2:45:51 PM,Other,40,40,0,0,80,92,79,0,0,171
72,Iraq,2016,IRQ-16/3884/S/E/INGO/3746,4/15/2017 2:45:51 PM,Overall,40,40,1700,1700,3480,92,79,1700,1700,3571
72,Iraq,2016,IRQ-16/3884/S/E/INGO/3944,1/29/2018 7:21:33 AM,Host Communities,20,20,0,0,40,70,50,0,0,120
72,Iraq,2016,IRQ-16/3884/S/E/INGO/3944,1/29/2018 7:21:33 AM,Internally Displaced People,40,40,2685,1790,4555,0,0,4222,4018,8240
72,Iraq,2016,IRQ-16/3884/S/E/INGO/3944,1/29/2018 7:21:33 AM,Overall,60,60,2685,1790,4595,70,50,4222,4018,8360
72,Iraq,2016,IRQ-16/3884/S/E/INGO/3965,8/7/2018 12:52:51 PM,Internally Displaced People,517,713,2100,2100,5430,198,47,7325,6280,13850
72,Iraq,2016,IRQ-16/3884/S/E/INGO/3965,8/7/2018 12:52:51 PM,Overall,517,713,2100,2100,5430,198,47,7325,6280,13850
72,Iraq,2016,IRQ-16/3884/S/E/INGO/3971,11/7/2018 8:59:04 AM,Internally Displaced People,26,26,6784,4856,11692,126,95,7603,6683,14507
72,Iraq,2016,IRQ-16/3884/S/E/INGO/3971,11/7/2018 8:59:04 AM,Overall,26,26,6784,4856,11692,126,95,7603,6683,14507
72,Iraq,2016,IRQ-16/3884/S/E/NGO/3673,10/18/2017 12:25:33 PM,Host Communities,30,30,0,0,60,20,28,0,0,48
72,Iraq,2016,IRQ-16/3884/S/E/NGO/3673,10/18/2017 12:25:33 PM,Internally Displaced People,40,40,1000,1000,2080,64,7,1186,974,2231
72,Iraq,2016,IRQ-16/3884/S/E/NGO/3673,10/18/2017 12:25:33 PM,Overall,70,70,1000,1000,2140,84,35,1186,974,2279
72,Iraq,2016,IRQ-16/3884/S/F/INGO/3646,7/12/2017 11:51:40 AM,Host Communities,187,195,166,172,720,156,162,138,144,600
72,Iraq,2016,IRQ-16/3884/S/F/INGO/3646,7/12/2017 11:51:40 AM,Internally Displaced People,10549,11145,9306,9680,40680,10684,11083,9443,9828,41038
72,Iraq,2016,IRQ-16/3884/S/F/INGO/3646,7/12/2017 11:51:40 AM,Overall,10736,11340,9472,9852,41400,10804,11245,9581,9972,41602
72,Iraq,2016,IRQ-16/3884/S/F/NGO/3486,11/8/2017 6:44:44 AM,Internally Displaced People,3048,3173,2597,2702,11520,3404,3225,3665,4340,14634
72,Iraq,2016,IRQ-16/3884/S/F/NGO/3486,11/8/2017 6:44:44 AM,Other,762,793,649,676,2880,0,0,0,0,0
72,Iraq,2016,IRQ-16/3884/S/F/NGO/3486,11/8/2017 6:44:44 AM,Overall,3810,3966,3246,3378,14400,3404,3225,3665,4340,14634
72,Iraq,2016,IRQ-16/3884/S/F/NGO/3503,3/28/2017 2:23:38 PM,Internally Displaced People,11000,14500,20250,20250,66000,19567,13666,17735,17737,68705
72,Iraq,2016,IRQ-16/3884/S/F/NGO/3503,3/28/2017 2:23:38 PM,Overall,11000,14500,20250,20250,66000,19567,13666,17735,17737,68705
72,Iraq,2016,IRQ-16/3884/S/F/NGO/3566,5/9/2018 6:55:37 AM,Host Communities,289,277,300,460,1326,226,166,348,362,1102
72,Iraq,2016,IRQ-16/3884/S/F/NGO/3566,5/9/2018 6:55:37 AM,Internally Displaced People,1155,1110,1200,1840,5305,1100,1100,1650,1700,5550
72,Iraq,2016,IRQ-16/3884/S/F/NGO/3566,5/9/2018 6:55:37 AM,Overall,1444,1387,1500,2300,6631,1326,1266,1898,2062,6552
72,Iraq,2016,IRQ-16/3884/S/F/NGO/3702,6/7/2018 2:05:52 PM,Host Communities,621,999,540,540,2700,669,1076,581,581,2907
72,Iraq,2016,IRQ-16/3884/S/F/NGO/3702,6/7/2018 2:05:52 PM,Internally Displaced People,6693,10767,5820,5820,29100,6513,10428,5696,5729,28366
72,Iraq,2016,IRQ-16/3884/S/F/NGO/3702,6/7/2018 2:05:52 PM,Overall,7314,11766,6360,6360,31800,7182,11504,6277,6310,31273
72,Iraq,2016,IRQ-16/3884/S/F/NGO/3740,9/18/2017 10:17:02 AM,Host Communities,2205,2415,2730,3150,10500,2682,2876,3634,3401,12593
72,Iraq,2016,IRQ-16/3884/S/F/NGO/3740,9/18/2017 10:17:02 AM,Internally Displaced People,8820,9660,10920,12600,42000,11097,11100,12217,11267,45681
72,Iraq,2016,IRQ-16/3884/S/F/NGO/3740,9/18/2017 10:17:02 AM,Overall,11025,12075,13650,15750,52500,13779,13976,15851,14668,58274
72,Iraq,2016,IRQ-16/3884/S/F/NGO/3907,5/17/2017 12:21:09 PM,Internally Displaced People,1159,1390,1201,1250,5000,4353,4440,4370,4237,17400
72,Iraq,2016,IRQ-16/3884/S/F/NGO/3907,5/17/2017 12:21:09 PM,Overall,1159,1390,1201,1250,5000,4353,4440,4370,4237,17400
72,Iraq,2016,IRQ-16/3884/S/F/UN/3619,10/2/2019 6:34:36 AM,Internally Displaced People,11364,11497,10203,9656,42720,24855,24855,22093,20252,92055
72,Iraq,2016,IRQ-16/3884/S/F/UN/3619,10/2/2019 6:34:36 AM,Overall,11364,11497,10203,9656,42720,24855,24855,22093,20252,92055
72,Iraq,2016,IRQ-16/3884/S/F-NFIs/INGO/3720,3/15/2017 11:14:42 AM,Internally Displaced People,1240,1240,2480,2480,7440,1210,1210,2420,2420,7260
72,Iraq,2016,IRQ-16/3884/S/F-NFIs/INGO/3720,3/15/2017 11:14:42 AM,Overall,1240,1240,2480,2480,7440,2185,2185,4370,4370,13110
72,Iraq,2016,IRQ-16/3884/S/F-NFIs/NGO/3699,9/13/2017 7:44:38 AM,Internally Displaced People,2624,2654,2378,2244,9900,2624,2654,2378,2244,9900
72,Iraq,2016,IRQ-16/3884/S/F-NFIs/NGO/3699,9/13/2017 7:44:38 AM,Overall,2624,2654,2378,2244,9900,2624,2654,2378,2244,9900
72,Iraq,2016,IRQ-16/3884/S/H/INGO/3509,4/11/2017 6:59:24 PM,Overall,1570,1203,460,462,3695,8,6,3,3,20
72,Iraq,2016,IRQ-16/3884/S/H/INGO/3528,9/12/2017 7:24:53 AM,Host Communities,1296,1566,1269,1269,5400,1296,1350,1950,2100,6696
72,Iraq,2016,IRQ-16/3884/S/H/INGO/3528,9/12/2017 7:24:53 AM,Internally Displaced People,6048,7308,5922,5922,25200,6048,8432,5122,5600,25202
72,Iraq,2016,IRQ-16/3884/S/H/INGO/3528,9/12/2017 7:24:53 AM,Other,1296,1566,1269,1269,5400,416,136,542,506,1600
72,Iraq,2016,IRQ-16/3884/S/H/INGO/3528,9/12/2017 7:24:53 AM,Overall,8640,10440,8460,8460,36000,7760,9918,7614,8206,33498
72,Iraq,2016,IRQ-16/3884/S/H/INGO/3776,3/28/2017 11:26:35 AM,Host Communities,1608,1742,792,858,5000,1495,1620,737,798,4650
72,Iraq,2016,IRQ-16/3884/S/H/INGO/3776,3/28/2017 11:26:35 AM,Internally Displaced People,6432,6968,3168,3432,20000,5982,6480,2946,3192,18600
72,Iraq,2016,IRQ-16/3884/S/H/INGO/3776,3/28/2017 11:26:35 AM,Overall,8040,8710,3960,4290,25000,7477,8100,3683,3990,23250
72,Iraq,2016,IRQ-16/3884/S/H/INGO/3892,1/29/2018 8:26:39 AM,Internally Displaced People,1393,1333,1352,1969,6047,1013,969,983,1432,4397
72,Iraq,2016,IRQ-16/3884/S/H/INGO/3892,1/29/2018 8:26:39 AM,Overall,1393,1333,1352,1969,6047,1013,969,983,1432,4397
72,Iraq,2016,IRQ-16/3884/S/H/NGO/3494,1/29/2018 7:57:58 AM,Host Communities,3909,3870,2646,2575,13000,4081,4040,2762,2687,13570
72,Iraq,2016,IRQ-16/3884/S/H/NGO/3494,1/29/2018 7:57:58 AM,Internally Displaced People,2707,2680,1832,1781,9000,3624,3587,2453,2386,12050
72,Iraq,2016,IRQ-16/3884/S/H/NGO/3494,1/29/2018 7:57:58 AM,Other,8811,8723,5964,5802,29300,13088,12957,8860,8617,43522
72,Iraq,2016,IRQ-16/3884/S/H/NGO/3494,1/29/2018 7:57:58 AM,Overall,18043,17863,12214,11880,60000,20791,20587,14073,13690,69141
72,Iraq,2016,IRQ-16/3884/S/H/NGO/3545,8/17/2017 8:00:22 AM,Internally Displaced People,1528,1638,1092,1200,5458,3102,3077,979,891,8049
72,Iraq,2016,IRQ-16/3884/S/H/NGO/3545,8/17/2017 8:00:22 AM,Other,656,702,468,516,2342,1332,1321,431,383,3467
72,Iraq,2016,IRQ-16/3884/S/H/NGO/3545,8/17/2017 8:00:22 AM,Overall,2184,2340,1560,1716,7800,4434,4398,1400,1274,11506
72,Iraq,2016,IRQ-16/3884/S/H/NGO/3932,5/17/2017 12:25:27 PM,Internally Displaced People,7219,7143,4932,4706,24000,3249,3213,2220,2118,10800
72,Iraq,2016,IRQ-16/3884/S/H/NGO/3932,5/17/2017 12:25:27 PM,Overall,7219,7143,4932,4706,24000,3249,3213,2220,2118,10800
72,Iraq,2016,IRQ-16/3884/S/H/UN/3680,7/16/2017 7:45:48 AM,Internally Displaced People,0,84000,3150,21000,108150,0,96861,3214,24215,124290
72,Iraq,2016,IRQ-16/3884/S/H/UN/3680,7/16/2017 7:45:48 AM,Overall,0,84000,3150,21000,108150,0,96861,3214,24215,124290
72,Iraq,2016,IRQ-16/3884/S/H/UN/3714,7/16/2019 8:01:39 AM,Internally Displaced People,50000,100000,100000,100000,350000,94922,83883,74363,71766,324934
72,Iraq,2016,IRQ-16/3884/S/H/UN/3714,7/16/2019 8:01:39 AM,Overall,50000,100000,100000,100000,350000,94922,83846,74353,71763,324884
72,Iraq,2016,IRQ-16/3884/S/H-P/INGO/3650,1/29/2018 9:07:17 AM,Internally Displaced People,7584,12696,1896,3024,25200,5703,11195,5723,9315,31936
72,Iraq,2016,IRQ-16/3884/S/H-P/INGO/3650,1/29/2018 9:07:17 AM,Overall,7584,12696,1896,3024,25200,5703,11195,5723,9315,31936
72,Iraq,2016,IRQ-16/3884/S/NFIs/INGO/3656,8/8/2018 1:36:26 PM,Internally Displaced People,3863,3736,3625,3506,14730,6679,6460,6269,6062,25470
72,Iraq,2016,IRQ-16/3884/S/NFIs/INGO/3656,8/8/2018 1:36:26 PM,Other,1652,1598,1551,1499,6300,2149,2079,2017,1951,8196
72,Iraq,2016,IRQ-16/3884/S/NFIs/INGO/3656,8/8/2018 1:36:26 PM,Overall,5515,5334,5176,5005,21030,8829,8539,8286,8012,33666
72,Iraq,2016,IRQ-16/3884/S/NFIs/INGO/3689,2/4/2019 7:04:37 AM,Internally Displaced People,1765,1765,3530,3530,10590,728,747,1504,1269,4248
72,Iraq,2016,IRQ-16/3884/S/NFIs/INGO/3689,2/4/2019 7:04:37 AM,Other,880,880,1760,1760,5280,1517,1558,3134,2645,8854
72,Iraq,2016,IRQ-16/3884/S/NFIs/INGO/3689,2/4/2019 7:04:37 AM,Overall,2645,2645,5290,5290,15870,2245,2305,4638,3914,13102
72,Iraq,2016,IRQ-16/3884/S/NFIs/INGO/3695,9/11/2017 12:50:20 PM,Internally Displaced People,2294,3441,2693,4040,12468,815,1194,958,1413,4380
72,Iraq,2016,IRQ-16/3884/S/NFIs/INGO/3695,9/11/2017 12:50:20 PM,Overall,2294,3441,2693,4040,12468,815,1194,958,1413,4380
72,Iraq,2016,IRQ-16/3884/S/NFIs/INGO/3707,11/21/2017 12:30:48 PM,Host Communities,0,0,0,0,0,2335,2132,2944,2741,10152
72,Iraq,2016,IRQ-16/3884/S/NFIs/INGO/3707,11/21/2017 12:30:48 PM,Internally Displaced People,2000,2000,4000,4000,12000,4301,3927,5423,5049,18700
72,Iraq,2016,IRQ-16/3884/S/NFIs/INGO/3707,11/21/2017 12:30:48 PM,Overall,2000,2000,4000,4000,12000,8418,7666,6708,6061,28853
72,Iraq,2016,IRQ-16/3884/S/NFIs/INGO/3708,7/12/2017 7:54:39 AM,Internally Displaced People,2925,3038,2587,2700,11250,5048,5016,4480,4453,18997
72,Iraq,2016,IRQ-16/3884/S/NFIs/INGO/3708,7/12/2017 7:54:39 AM,Overall,2925,3038,2587,2700,11250,5048,5016,4480,4453,18997
72,Iraq,2016,IRQ-16/3884/S/NFIs/INGO/3727,3/28/2017 1:10:34 PM,Internally Displaced People,450,450,450,450,1800,150,165,150,160,625
72,Iraq,2016,IRQ-16/3884/S/NFIs/INGO/3727,3/28/2017 1:10:34 PM,Overall,450,450,450,450,1800,150,165,150,160,625
72,Iraq,2016,IRQ-16/3884/S/NFIs/INGO/3953,4/16/2017 10:27:02 AM,Overall,2498,3529,4164,4167,14358,4421,4542,7134,5362,21459
72,Iraq,2016,IRQ-16/3884/S/NFIs/NGO/3550,3/28/2017 11:19:03 AM,Internally Displaced People,610,715,1850,2020,5195,1348,1463,1762,2068,6641
72,Iraq,2016,IRQ-16/3884/S/NFIs/NGO/3550,3/28/2017 11:19:03 AM,Overall,610,715,1850,2020,5195,1348,1463,1762,2068,6641
72,Iraq,2016,IRQ-16/3884/S/NFIs/NGO/3888,11/28/2017 12:28:48 PM,Internally Displaced People,4034,4651,1512,1776,11973,943,1081,366,396,2786
72,Iraq,2016,IRQ-16/3884/S/NFIs/NGO/3888,11/28/2017 12:28:48 PM,Other,346,399,130,152,1027,3551,4097,1328,1567,10543
72,Iraq,2016,IRQ-16/3884/S/NFIs/NGO/3888,11/28/2017 12:28:48 PM,Overall,4380,5050,1642,1928,13000,4494,5178,1694,1963,13329
72,Iraq,2016,IRQ-16/3884/S/NFIs/UN/3936,5/28/2018 6:01:03 AM,Overall,23364,31150,46726,54514,155754,30995,41327,61990,72322,206634
72,Iraq,2016,IRQ-16/3884/S/NFIs/UN/3967,5/9/2018 7:20:39 AM,Internally Displaced People,25000,30000,33000,32000,120000,25000,30000,33000,32000,120000
72,Iraq,2016,IRQ-16/3884/S/NFIs/UN/3967,5/9/2018 7:20:39 AM,Overall,25000,30000,33000,32000,120000,25000,30000,33000,32000,120000
72,Iraq,2016,IRQ-16/3884/S/NFIs-H-F/INGO/3671,9/11/2017 11:37:08 AM,Internally Displaced People,11906,12899,9355,10135,44295,9840,10644,7718,8377,36579
72,Iraq,2016,IRQ-16/3884/S/NFIs-H-F/INGO/3671,9/11/2017 11:37:08 AM,Overall,11906,12899,9355,10135,44295,9840,10644,7718,8377,36579
72,Iraq,2016,IRQ-16/3884/S/NFIs-WASH/INGO/3709,9/11/2017 11:00:04 AM,Internally Displaced People,1000,1000,2000,2000,6000,1000,1000,2000,2000,6000
72,Iraq,2016,IRQ-16/3884/S/NFIs-WASH/INGO/3709,9/11/2017 11:00:04 AM,Overall,1000,1000,2000,2000,6000,1000,1000,2000,2000,6000
72,Iraq,2016,IRQ-16/3884/S/P/INGO/3579,9/7/2017 9:45:10 AM,Host Communities,520,870,580,820,2790,0,2983,0,0,2983
72,Iraq,2016,IRQ-16/3884/S/P/INGO/3579,9/7/2017 9:45:10 AM,Internally Displaced People,1580,2630,1820,2080,8110,2100,3500,2400,2900,10900
72,Iraq,2016,IRQ-16/3884/S/P/INGO/3579,9/7/2017 9:45:10 AM,Overall,2100,3500,2400,2900,10900,2572,2144,2060,1899,8675
72,Iraq,2016,IRQ-16/3884/S/P/INGO/3664,11/15/2017 12:18:10 PM,Other,0,0,0,0,0,87500,87500,87500,87500,350000
72,Iraq,2016,IRQ-16/3884/S/P/INGO/3664,11/15/2017 12:18:10 PM,Overall,87500,87500,87500,87500,350000,87500,87500,87500,87500,350000
72,Iraq,2016,IRQ-16/3884/S/P/INGO/3959,1/29/2018 7:42:21 AM,Internally Displaced People,3430,3570,5159,5369,17528,11012,11007,31612,29740,83371
72,Iraq,2016,IRQ-16/3884/S/P/INGO/3959,1/29/2018 7:42:21 AM,Overall,3430,3570,5159,5369,17528,11012,11007,31612,29740,83371
72,Iraq,2016,IRQ-16/3884/S/P/NGO/3722,9/11/2017 11:56:32 AM,Internally Displaced People,12500,12500,12500,12500,50000,13630,12200,13235,12645,51710
72,Iraq,2016,IRQ-16/3884/S/P/NGO/3722,9/11/2017 11:56:32 AM,Overall,37550,37550,37500,37500,150100,130000,120000,128000,122000,500000
72,Iraq,2016,IRQ-16/3884/S/P/UN/3660,7/18/2019 7:05:53 AM,Internally Displaced People,7000,7000,11500,11500,37000,769,1243,24248,21370,47630
72,Iraq,2016,IRQ-16/3884/S/P/UN/3660,7/18/2019 7:05:53 AM,Overall,7000,7000,11500,11500,37000,769,1243,18161,15229,35402
72,Iraq,2016,IRQ-16/3884/S/P/UN/3665,10/23/2018 9:19:00 AM,Host Communities,0,10000,0,2000,12000,0,7582,0,6473,14055
72,Iraq,2016,IRQ-16/3884/S/P/UN/3665,10/23/2018 9:19:00 AM,Internally Displaced People,0,85000,0,11000,96000,0,42971,0,36680,79651
72,Iraq,2016,IRQ-16/3884/S/P/UN/3665,10/23/2018 9:19:00 AM,Overall,0,95000,0,13000,108000,0,50553,0,43153,93706
72,Iraq,2016,IRQ-16/3884/S/P/UN/3950,1/29/2018 12:00:18 PM,Internally Displaced People,3150,6975,3150,6975,20250,40368,50813,42708,50684,184573
72,Iraq,2016,IRQ-16/3884/S/P/UN/3950,1/29/2018 12:00:18 PM,Other,15,15,0,0,30,15,15,0,0,30
72,Iraq,2016,IRQ-16/3884/S/P/UN/3950,1/29/2018 12:00:18 PM,Overall,3165,6990,3150,6975,20280,40383,50828,42708,50684,184603
72,Iraq,2016,IRQ-16/3884/S/P-E/INGO/3693,5/10/2018 12:33:39 PM,Host Communities,275,470,0,0,745,1030,1121,1281,1126,4558
72,Iraq,2016,IRQ-16/3884/S/P-E/INGO/3693,5/10/2018 12:33:39 PM,Internally Displaced People,2845,6610,8000,8000,25455,10857,12037,32872,29903,85669
72,Iraq,2016,IRQ-16/3884/S/P-E/INGO/3693,5/10/2018 12:33:39 PM,Overall,3120,7080,8000,8000,26200,11887,13158,34153,31029,90227
72,Iraq,2016,IRQ-16/3884/S/RRM/UN/3668,7/12/2017 8:51:26 AM,Internally Displaced People,0,86400,0,21600,108000,0,89856,0,22464,112320
72,Iraq,2016,IRQ-16/3884/S/RRM/UN/3668,7/12/2017 8:51:26 AM,Overall,0,86400,0,21600,108000,0,89856,0,22464,112320
72,Iraq,2016,IRQ-16/3884/S/WASH/INGO/3694,8/15/2017 12:41:56 PM,Internally Displaced People,2493,2595,2211,2301,9600,5066,5498,4256,4478,19298
72,Iraq,2016,IRQ-16/3884/S/WASH/INGO/3694,8/15/2017 12:41:56 PM,Overall,2493,2595,2211,2301,9600,5066,5498,4256,4478,19298
72,Iraq,2016,IRQ-16/3884/S/WASH/INGO/3717,1/29/2018 9:13:45 AM,Internally Displaced People,3577,3577,3048,3048,13250,1674,2347,2950,2997,9968
72,Iraq,2016,IRQ-16/3884/S/WASH/INGO/3717,1/29/2018 9:13:45 AM,Overall,3577,3577,3048,3048,13250,1674,2347,2950,2997,9968
72,Iraq,2016,IRQ-16/3884/S/WASH/INGO/3718,11/28/2017 12:59:23 PM,Internally Displaced People,2500,2500,5000,5000,15000,12957,12957,10644,9718,46276
72,Iraq,2016,IRQ-16/3884/S/WASH/INGO/3718,11/28/2017 12:59:23 PM,Overall,2500,2500,5000,5000,15000,28794,28794,23652,21596,102836
72,Iraq,2016,IRQ-16/3884/S/WASH/INGO/3729,10/16/2017 12:57:09 PM,Internally Displaced People,5616,5832,5184,4968,21600,3551,4090,4865,4803,17309
72,Iraq,2016,IRQ-16/3884/S/WASH/INGO/3729,10/16/2017 12:57:09 PM,Overall,5616,5832,5184,4968,21600,3551,4090,4865,4803,17309
72,Iraq,2016,IRQ-16/3884/S/WASH/INGO/3731,5/21/2018 6:18:56 AM,Internally Displaced People,6125,7350,5512,5513,24500,7050,8460,6344,6346,28200
72,Iraq,2016,IRQ-16/3884/S/WASH/INGO/3731,5/21/2018 6:18:56 AM,Overall,6125,7350,5512,5513,24500,7050,8460,6344,6346,28200
72,Iraq,2016,IRQ-16/3884/S/WASH/INGO/3735,5/20/2018 1:33:29 PM,Internally Displaced People,17547,17547,16197,16197,67488,18860,18860,17409,17409,72538
72,Iraq,2016,IRQ-16/3884/S/WASH/INGO/3735,5/20/2018 1:33:29 PM,Overall,17547,17547,16197,16197,67488,18860,18860,17409,17409,72538
72,Iraq,2016,IRQ-16/3884/S/WASH/INGO/3951,1/29/2018 8:22:49 AM,Internally Displaced People,2000,2500,2500,3000,10000,2100,2700,3500,3700,12000
72,Iraq,2016,IRQ-16/3884/S/WASH/INGO/3951,1/29/2018 8:22:49 AM,Overall,2000,2500,2500,3000,10000,2100,2700,3500,3700,12000
72,Iraq,2016,IRQ-16/3884/S/WASH/INGO/3954,10/25/2017 11:26:33 AM,Internally Displaced People,1294,1346,2020,1940,6600,2098,2378,3018,2863,10357
72,Iraq,2016,IRQ-16/3884/S/WASH/INGO/3954,10/25/2017 11:26:33 AM,Overall,1294,1346,2020,1940,6600,2098,2378,3018,2863,10357
72,Iraq,2016,IRQ-16/3884/S/WASH/INGO/3977,7/3/2017 8:26:17 AM,Host Communities,1297,1348,1430,1324,5399,1607,1625,1563,1497,6292
72,Iraq,2016,IRQ-16/3884/S/WASH/INGO/3977,7/3/2017 8:26:17 AM,Internally Displaced People,324,337,358,331,1350,603,605,530,531,2269
72,Iraq,2016,IRQ-16/3884/S/WASH/INGO/3977,7/3/2017 8:26:17 AM,Other,541,562,596,552,2251,667,677,684,645,2673
72,Iraq,2016,IRQ-16/3884/S/WASH/INGO/3977,7/3/2017 8:26:17 AM,Overall,2162,2247,2384,2207,9000,2877,2907,2777,2673,11234
72,Iraq,2016,IRQ-16/3884/S/WASH/NGO/3674,7/24/2017 10:42:16 AM,Internally Displaced People,150,600,300,450,1500,150,600,300,450,1500
72,Iraq,2016,IRQ-16/3884/S/WASH/NGO/3674,7/24/2017 10:42:16 AM,Overall,150,600,300,450,1500,150,600,300,450,1500
72,Iraq,2016,IRQ-16/3884/S/WASH/NGO/3931,5/17/2017 12:21:02 PM,Internally Displaced People,936,936,1014,1014,3900,813,860,1123,1191,3987
72,Iraq,2016,IRQ-16/3884/S/WASH/NGO/3931,5/17/2017 12:21:02 PM,Overall,936,936,1014,1014,3900,813,860,1123,1191,3987
72,Iraq,2016,IRQ-16/3884/S/WASH/NGO/3966,7/3/2017 7:01:44 AM,Internally Displaced People,550,650,550,650,2400,422,459,525,484,1890
72,Iraq,2016,IRQ-16/3884/S/WASH/NGO/3966,7/3/2017 7:01:44 AM,Overall,550,650,550,650,2400,422,459,525,484,1890
72,Iraq,2016,IRQ-16/3884/S/WASH/NGO/3984,5/16/2018 5:59:59 AM,Internally Displaced People,2000,2000,3000,3000,10000,1854,2146,2850,3150,10000
72,Iraq,2016,IRQ-16/3884/S/WASH/NGO/3984,5/16/2018 5:59:59 AM,Overall,2000,2000,3000,3000,10000,1854,2146,2850,3150,10000
72,Iraq,2016,IRQ-16/3884/S/WASH/UN/3581,6/20/2017 11:24:57 AM,Internally Displaced People,56250,68750,56250,68750,250000,57166,59500,50695,52764,220125
72,Iraq,2016,IRQ-16/3884/S/WASH/UN/3581,6/20/2017 11:24:57 AM,Overall,56250,68750,56250,68750,250000,57166,59500,50695,52764,220125
72,Iraq,2016,IRQ-16/3884/S/WASH/UN/3975,5/28/2018 5:56:34 AM,Internally Displaced People,2570,3430,2570,3430,12000,894,984,1489,1433,4800
72,Iraq,2016,IRQ-16/3884/S/WASH/UN/3975,5/28/2018 5:56:34 AM,Overall,2570,3430,2570,3430,12000,894,984,1489,1433,4800
72,Iraq,2016,IRQ-16/3884/S/WASH/UN/4419,9/11/2017 2:33:03 PM,Internally Displaced People,12150,14850,12150,14850,54000,24750,24750,20250,30250,100000
72,Iraq,2016,IRQ-16/3884/S/WASH/UN/4419,9/11/2017 2:33:03 PM,Overall,12150,14850,12150,14850,54000,24750,24750,20250,30250,100000
72,Iraq,2016,IRQ-16/3884/S/WASH-H-NFIs-F/INGO/3549,1/27/2019 7:58:35 PM,Internally Displaced People,1320,1260,1782,1638,6000,15380,14681,20764,19086,69911
72,Iraq,2016,IRQ-16/3884/S/WASH-H-NFIs-F/INGO/3549,1/27/2019 7:58:35 PM,Overall,1320,1260,1782,1638,6000,15380,14681,20764,19086,69911
72,Iraq,2016,IRQ-16/3884/ST/CASH/INGO/2655,3/28/2017 12:20:59 PM,Host Communities,45,45,45,45,180,48,50,43,41,182
72,Iraq,2016,IRQ-16/3884/ST/CASH/INGO/2655,3/28/2017 12:20:59 PM,Internally Displaced People,405,405,405,405,1620,444,466,391,378,1679
72,Iraq,2016,IRQ-16/3884/ST/CASH/INGO/2655,3/28/2017 12:20:59 PM,Overall,450,450,450,450,1800,492,516,434,419,1861
72,Iraq,2016,IRQ-16/3884/ST/CASH/INGO/2666,3/11/2017 9:34:41 AM,Host Communities,97,102,71,73,343,41,38,40,29,148
72,Iraq,2016,IRQ-16/3884/ST/CASH/INGO/2666,3/11/2017 9:34:41 AM,Internally Displaced People,1659,1727,1201,1250,5837,1481,1806,1481,1441,6209
72,Iraq,2016,IRQ-16/3884/ST/CASH/INGO/2666,3/11/2017 9:34:41 AM,Overall,1756,1829,1272,1323,6180,1522,1844,1521,1470,6357
72,Iraq,2016,IRQ-16/3884/ST/CCCM/INGO/2675,8/3/2017 1:30:02 PM,Other,200,200,0,0,400,200,200,0,0,400
72,Iraq,2016,IRQ-16/3884/ST/CCCM/INGO/2675,8/3/2017 1:30:02 PM,Overall,200,200,0,0,400,200,200,0,0,400
72,Iraq,2016,IRQ-16/3884/ST/CCCM/INGO/2685,5/18/2017 10:53:09 AM,Host Communities,10,10,0,0,20,8051,8359,7120,7430,30960
72,Iraq,2016,IRQ-16/3884/ST/CCCM/INGO/2685,5/18/2017 10:53:09 AM,Internally Displaced People,1560,1620,1380,1440,6000,78,82,69,72,301
72,Iraq,2016,IRQ-16/3884/ST/CCCM/INGO/2685,5/18/2017 10:53:09 AM,Overall,1570,1630,1380,1440,6020,8128,8440,7190,7503,31261
72,Iraq,2016,IRQ-16/3884/ST/CCCM/UN/2594,5/16/2017 11:53:12 AM,Host Communities,20,20,20,20,80,20,20,20,20,80
72,Iraq,2016,IRQ-16/3884/ST/CCCM/UN/2594,5/16/2017 11:53:12 AM,Internally Displaced People,180,180,180,180,720,564,564,462,452,2042
72,Iraq,2016,IRQ-16/3884/ST/CCCM/UN/2594,5/16/2017 11:53:12 AM,Overall,200,200,200,200,800,584,584,482,472,2122
72,Iraq,2016,IRQ-16/3884/ST/CCS/INGO/2695,5/8/2018 11:31:46 AM,Other,200,200,0,0,400,200,200,0,0,400
72,Iraq,2016,IRQ-16/3884/ST/CCS/INGO/2695,5/8/2018 11:31:46 AM,Overall,200,200,0,0,400,200,200,0,0,400
72,Iraq,2016,IRQ-16/3884/ST/CCS/UN/2543,9/11/2017 1:37:59 PM,Internally Displaced People,24000,6000,900,300,31200,37454,9416,629,179,47678
72,Iraq,2016,IRQ-16/3884/ST/CCS/UN/2543,9/11/2017 1:37:59 PM,Other,3000,750,200,50,4000,5429,1386,100,26,6941
72,Iraq,2016,IRQ-16/3884/ST/CCS/UN/2543,9/11/2017 1:37:59 PM,Overall,27000,6750,1100,350,35200,42883,10802,729,205,54619
72,Iraq,2016,IRQ-16/3884/ST/CCS/UN/2630,3/28/2017 8:51:35 AM,Other,188,0,0,0,188,188,0,0,0,188
72,Iraq,2016,IRQ-16/3884/ST/CCS/UN/2630,3/28/2017 8:51:35 AM,Overall,188,0,0,0,188,188,0,0,0,188
72,Iraq,2016,IRQ-16/3884/ST/E/UN/2869,7/15/2019 12:57:31 PM,Internally Displaced People,320,330,15000,15000,30650,389,403,22680,17320,40792
72,Iraq,2016,IRQ-16/3884/ST/E/UN/2869,7/15/2019 12:57:31 PM,Overall,320,330,15000,15000,30650,389,403,22680,17320,40792
72,Iraq,2016,IRQ-16/3884/ST/ELSC/INGO/2568,2/1/2017 9:56:28 AM,Host Communities,90,90,180,180,540,187,213,69,64,533
72,Iraq,2016,IRQ-16/3884/ST/ELSC/INGO/2568,2/1/2017 9:56:28 AM,Internally Displaced People,810,810,1620,1620,4860,1678,1919,623,575,4795
72,Iraq,2016,IRQ-16/3884/ST/ELSC/INGO/2568,2/1/2017 9:56:28 AM,Overall,900,900,1800,1800,5400,1864,2132,693,639,5328
72,Iraq,2016,IRQ-16/3884/ST/ELSC/INGO/2795,5/17/2017 1:08:03 PM,Host Communities,190,197,168,175,730,8,9,13,12,42
72,Iraq,2016,IRQ-16/3884/ST/ELSC/INGO/2795,5/17/2017 1:08:03 PM,Internally Displaced People,570,592,504,526,2192,596,597,924,865,2982
72,Iraq,2016,IRQ-16/3884/ST/ELSC/INGO/2795,5/17/2017 1:08:03 PM,Overall,760,789,672,701,2922,609,617,933,865,3024
72,Iraq,2016,IRQ-16/3884/ST/ELSC/INGO/2798,7/15/2019 11:44:06 AM,Host Communities,125,146,115,136,522,67,53,181,225,526
72,Iraq,2016,IRQ-16/3884/ST/ELSC/INGO/2798,7/15/2019 11:44:06 AM,Internally Displaced People,1124,1312,1031,1218,4685,698,112,281,322,1413
72,Iraq,2016,IRQ-16/3884/ST/ELSC/INGO/2798,7/15/2019 11:44:06 AM,Overall,1249,1458,1146,1354,5207,765,165,462,547,1939
72,Iraq,2016,IRQ-16/3884/ST/F/INGO/2690,7/15/2019 12:24:59 PM,Internally Displaced People,11385,17710,15813,18342,63250,10250,18685,17432,21776,68143
72,Iraq,2016,IRQ-16/3884/ST/F/INGO/2690,7/15/2019 12:24:59 PM,Overall,11385,17710,15813,18342,63250,10250,18685,17432,21776,68143
72,Iraq,2016,IRQ-16/3884/ST/F/NGO/2541,3/15/2017 9:05:45 AM,Internally Displaced People,1335,3360,1065,2240,8000,1486,3739,1186,2493,8904
72,Iraq,2016,IRQ-16/3884/ST/F/NGO/2541,3/15/2017 9:05:45 AM,Overall,1335,3360,1065,2240,8000,1486,3739,1186,2493,8904
72,Iraq,2016,IRQ-16/3884/ST/F/NGO/2570,3/15/2017 9:13:26 AM,Internally Displaced People,3175,3305,2705,2815,12000,3194,3137,3701,3501,13533
72,Iraq,2016,IRQ-16/3884/ST/F/NGO/2570,3/15/2017 9:13:26 AM,Other,794,826,676,704,3000,355,349,411,389,1504
72,Iraq,2016,IRQ-16/3884/ST/F/NGO/2570,3/15/2017 9:13:26 AM,Overall,3969,4131,3381,3519,15000,3549,3485,4112,3891,15037
72,Iraq,2016,IRQ-16/3884/ST/F/NGO/2619,2/7/2017 8:25:39 AM,Internally Displaced People,1800,1690,1400,1420,6310,2031,2465,1874,3236,9606
72,Iraq,2016,IRQ-16/3884/ST/F/NGO/2619,2/7/2017 8:25:39 AM,Other,500,500,475,380,1855,0,0,0,0,0
72,Iraq,2016,IRQ-16/3884/ST/F/NGO/2619,2/7/2017 8:25:39 AM,Overall,2300,2190,1875,1800,8165,2031,2465,1874,3236,9606
72,Iraq,2016,IRQ-16/3884/ST/F/UN/2582,3/12/2017 9:05:36 AM,Other,1305,1080,1125,990,4500,1193,988,1029,906,4116
72,Iraq,2016,IRQ-16/3884/ST/F/UN/2582,3/12/2017 9:05:36 AM,Overall,1305,1080,1125,990,4500,1193,988,1029,906,4116
72,Iraq,2016,IRQ-16/3884/ST/H/INGO/2569,1/27/2017 6:05:43 PM,Internally Displaced People,11500,13500,12500,12500,50000,13847,15640,13250,13298,56035
72,Iraq,2016,IRQ-16/3884/ST/H/INGO/2569,1/27/2017 6:05:43 PM,Overall,11500,13500,12500,12500,50000,13847,15640,13250,13298,56035
72,Iraq,2016,IRQ-16/3884/ST/H/INGO/2575,1/29/2018 7:35:48 AM,Overall,9876,10699,8417,8417,37409,15066,38968,11585,12141,77760
72,Iraq,2016,IRQ-16/3884/ST/H/INGO/2578,1/15/2017 2:41:05 PM,Internally Displaced People,3873,6482,4575,4471,19401,3914,6549,4622,4517,19602
72,Iraq,2016,IRQ-16/3884/ST/H/INGO/2578,1/15/2017 2:41:05 PM,Overall,3873,6482,4575,4471,19401,3914,6549,4622,4517,19602
72,Iraq,2016,IRQ-16/3884/ST/H/INGO/3132,4/11/2017 6:55:05 PM,Host Communities,4170,7147,1667,1787,14771,0,0,0,0,0
72,Iraq,2016,IRQ-16/3884/ST/H/INGO/3132,4/11/2017 6:55:05 PM,Internally Displaced People,25298,45486,238,263,71285,40352,50971,11711,12586,115620
72,Iraq,2016,IRQ-16/3884/ST/H/INGO/3132,4/11/2017 6:55:05 PM,Overall,29468,52633,1905,2050,86056,40352,50971,11711,12586,115620
72,Iraq,2016,IRQ-16/3884/ST/H/NGO/2540,3/14/2017 7:40:59 PM,Internally Displaced People,3960,3120,2640,2280,12000,6192,5187,1680,1656,14715
72,Iraq,2016,IRQ-16/3884/ST/H/NGO/2540,3/14/2017 7:40:59 PM,Other,5940,4680,3960,3420,18000,9286,7779,2520,2483,22068
72,Iraq,2016,IRQ-16/3884/ST/H/NGO/2540,3/14/2017 7:40:59 PM,Overall,9900,7800,6600,5700,30000,15478,12966,4200,4139,36783
72,Iraq,2016,IRQ-16/3884/ST/H/NGO/2609,6/12/2017 12:03:16 PM,Internally Displaced People,1203,1191,814,792,4000,1504,1489,1017,990,5000
72,Iraq,2016,IRQ-16/3884/ST/H/NGO/2609,6/12/2017 12:03:16 PM,Overall,1203,1191,814,792,4000,1504,1489,1017,990,5000
72,Iraq,2016,IRQ-16/3884/ST/H/UN/2588,7/16/2017 9:23:27 AM,Host Communities,0,50000,0,5400,55400,0,51265,0,6113,57378
72,Iraq,2016,IRQ-16/3884/ST/H/UN/2588,7/16/2017 9:23:27 AM,Internally Displaced People,0,166459,0,16000,182459,0,170953,0,19252,190205
72,Iraq,2016,IRQ-16/3884/ST/H/UN/2588,7/16/2017 9:23:27 AM,Overall,0,216459,0,21400,237859,0,222218,0,25365,247583
72,Iraq,2016,IRQ-16/3884/ST/H/UN/2590,7/3/2017 11:49:57 AM,Host Communities,3213,5450,1970,1970,12603,7886,9515,11615,12280,41296
72,Iraq,2016,IRQ-16/3884/ST/H/UN/2590,7/3/2017 11:49:57 AM,Internally Displaced People,12852,21798,7875,7875,50400,17195,22006,9851,10214,59266
72,Iraq,2016,IRQ-16/3884/ST/H/UN/2590,7/3/2017 11:49:57 AM,Overall,16065,27247,9844,9844,63000,25081,31521,21466,22494,100562
72,Iraq,2016,IRQ-16/3884/ST/H/UN/2669,1/22/2019 8:30:59 AM,Host Communities,34790,36210,23193,24140,118333,27967,29109,18644,19405,95125
72,Iraq,2016,IRQ-16/3884/ST/H/UN/2669,1/22/2019 8:30:59 AM,Internally Displaced People,69580,72420,46387,48280,236667,111867,116433,74578,77621,380499
72,Iraq,2016,IRQ-16/3884/ST/H/UN/2669,1/22/2019 8:30:59 AM,Overall,104370,108630,69580,72420,355000,139834,145541,93222,97028,475625
72,Iraq,2016,IRQ-16/3884/ST/H/UN/2691,3/28/2017 2:36:50 PM,Internally Displaced People,0,111360,151175,148381,410916,0,76064,137773,132595,346432
72,Iraq,2016,IRQ-16/3884/ST/H/UN/2691,3/28/2017 2:36:50 PM,Overall,0,111360,151175,148381,410916,0,76064,137773,132595,346432
72,Iraq,2016,IRQ-16/3884/ST/NFIs/INGO/2649,6/4/2018 10:32:45 AM,Internally Displaced People,2242,2073,2242,1904,8461,2206,2802,2292,2792,10092
72,Iraq,2016,IRQ-16/3884/ST/NFIs/INGO/2649,6/4/2018 10:32:45 AM,Overall,2242,2073,2242,1904,8461,2206,2802,2292,2792,10092
72,Iraq,2016,IRQ-16/3884/ST/NFIs/INGO/2661,5/12/2017 1:31:55 PM,Internally Displaced People,1011,1050,894,933,3888,1052,1159,807,902,3920
72,Iraq,2016,IRQ-16/3884/ST/NFIs/INGO/2661,5/12/2017 1:31:55 PM,Overall,1011,1050,894,933,3888,1052,1159,807,902,3920
72,Iraq,2016,IRQ-16/3884/ST/NFIs/INGO/2672,4/17/2017 1:35:56 PM,Host Communities,403,421,293,305,1422,1274,1384,1404,1320,5382
72,Iraq,2016,IRQ-16/3884/ST/NFIs/INGO/2672,4/17/2017 1:35:56 PM,Internally Displaced People,2287,2385,1659,1727,8058,1426,1445,1626,1514,6011
72,Iraq,2016,IRQ-16/3884/ST/NFIs/INGO/2672,4/17/2017 1:35:56 PM,Overall,2690,2806,1952,2032,9480,2700,2829,3030,2834,11393
72,Iraq,2016,IRQ-16/3884/ST/NFIs/NGO/2611,9/2/2016 9:46:08 AM,Internally Displaced People,936,897,1024,1060,3917,936,897,1024,1060,3917
72,Iraq,2016,IRQ-16/3884/ST/NFIs/NGO/2611,9/2/2016 9:46:08 AM,Overall,936,897,1024,1060,3917,936,897,1024,1060,3917
72,Iraq,2016,IRQ-16/3884/ST/NFIs/O/2681,9/18/2017 9:26:52 AM,Host Communities,283,272,227,218,1000,0,0,0,0,0
72,Iraq,2016,IRQ-16/3884/ST/NFIs/O/2681,9/18/2017 9:26:52 AM,Internally Displaced People,1602,1540,1284,1234,5660,1865,1798,1532,1465,6660
72,Iraq,2016,IRQ-16/3884/ST/NFIs/O/2681,9/18/2017 9:26:52 AM,Overall,1885,1811,1512,1452,6660,1865,1798,1532,1465,6660
72,Iraq,2016,IRQ-16/3884/ST/NFIs/UN/2589,3/28/2017 12:26:47 PM,Internally Displaced People,5065,5945,5505,5505,22020,6857,7759,5437,5299,25352
72,Iraq,2016,IRQ-16/3884/ST/NFIs/UN/2589,3/28/2017 12:26:47 PM,Overall,5066,5946,5505,5505,22022,6857,7759,5437,5299,25352
72,Iraq,2016,IRQ-16/3884/ST/NFIs/UN/2639,7/26/2017 11:56:40 AM,Host Communities,51,82,78,125,336,51,82,78,125,336
72,Iraq,2016,IRQ-16/3884/ST/NFIs/UN/2639,7/26/2017 11:56:40 AM,Internally Displaced People,485,727,727,1090,3029,485,727,727,1090,3029
72,Iraq,2016,IRQ-16/3884/ST/NFIs/UN/2639,7/26/2017 11:56:40 AM,Overall,404,606,942,1413,3365,404,606,942,1413,3365
72,Iraq,2016,IRQ-16/3884/ST/P/INGO/2610,6/3/2018 11:56:17 AM,Host Communities,3,3,216,216,438,10,10,250,230,500
72,Iraq,2016,IRQ-16/3884/ST/P/INGO/2610,6/3/2018 11:56:17 AM,Internally Displaced People,47,47,4096,4097,8287,86,142,5361,4429,10018
72,Iraq,2016,IRQ-16/3884/ST/P/INGO/2610,6/3/2018 11:56:17 AM,Overall,50,50,4312,4313,8725,96,152,5611,4659,10518
72,Iraq,2016,IRQ-16/3884/ST/P/INGO/2633,5/24/2017 8:34:35 AM,Host Communities,661,739,272,272,1944,0,0,0,0,0
72,Iraq,2016,IRQ-16/3884/ST/P/INGO/2633,5/24/2017 8:34:35 AM,Internally Displaced People,5290,5911,2178,2178,15557,5250,3118,7152,10172,25692
72,Iraq,2016,IRQ-16/3884/ST/P/INGO/2633,5/24/2017 8:34:35 AM,Other,661,739,272,272,1944,0,0,0,0,0
72,Iraq,2016,IRQ-16/3884/ST/P/INGO/2633,5/24/2017 8:34:35 AM,Overall,6612,7389,2722,2722,19445,5250,3118,7152,10172,25692
72,Iraq,2016,IRQ-16/3884/ST/P/INGO/2634,3/1/2017 10:42:53 AM,Host Communities,204,336,204,316,1060,96,102,81,68,347
72,Iraq,2016,IRQ-16/3884/ST/P/INGO/2634,3/1/2017 10:42:53 AM,Internally Displaced People,1224,2016,1224,1896,6360,1026,1022,1011,984,4043
72,Iraq,2016,IRQ-16/3884/ST/P/INGO/2634,3/1/2017 10:42:53 AM,Other,612,1008,612,948,3180,515,568,599,598,2280
72,Iraq,2016,IRQ-16/3884/ST/P/INGO/2634,3/1/2017 10:42:53 AM,Overall,2040,3360,2040,3160,10600,1637,1692,1691,1650,6670
72,Iraq,2016,IRQ-16/3884/ST/P/INGO/2657,10/19/2017 7:25:32 AM,Host Communities,265,265,660,660,1850,670,610,1540,1391,4211
72,Iraq,2016,IRQ-16/3884/ST/P/INGO/2657,10/19/2017 7:25:32 AM,Internally Displaced People,610,610,1540,1540,4300,421,285,877,724,2307
72,Iraq,2016,IRQ-16/3884/ST/P/INGO/2657,10/19/2017 7:25:32 AM,Overall,875,875,2200,2200,6150,1091,895,2417,2115,6518
72,Iraq,2016,IRQ-16/3884/ST/P/INGO/3131,7/3/2017 10:58:38 AM,Host Communities,919,2142,918,2142,6121,7713,2577,1249,10056,21595
72,Iraq,2016,IRQ-16/3884/ST/P/INGO/3131,7/3/2017 10:58:38 AM,Internally Displaced People,3672,8570,3673,8569,24484,10560,17560,8469,12236,48825
72,Iraq,2016,IRQ-16/3884/ST/P/INGO/3131,7/3/2017 10:58:38 AM,Overall,4591,10712,4591,10711,30605,18273,20004,9718,22292,70287
72,Iraq,2016,IRQ-16/3884/ST/P/UN/2576,3/11/2017 12:19:14 PM,Host Communities,0,2000,0,800,2800,0,3071,0,4723,7794
72,Iraq,2016,IRQ-16/3884/ST/P/UN/2576,3/11/2017 12:19:14 PM,Internally Displaced People,0,22000,0,6100,28100,0,33776,0,35425,69201
72,Iraq,2016,IRQ-16/3884/ST/P/UN/2576,3/11/2017 12:19:14 PM,Overall,0,24000,0,6900,30900,0,36846,0,40148,76994
72,Iraq,2016,IRQ-16/3884/ST/P/UN/2673,1/23/2017 9:06:49 AM,Host Communities,75,75,0,0,150,62,70,0,0,132
72,Iraq,2016,IRQ-16/3884/ST/P/UN/2673,1/23/2017 9:06:49 AM,Overall,75,75,0,0,150,62,70,0,0,132
72,Iraq,2016,IRQ-16/3884/ST/WASH/INGO/2556,9/11/2017 12:56:51 PM,Internally Displaced People,31056,28308,10510,10971,80845,31182,28720,10667,11488,82057
72,Iraq,2016,IRQ-16/3884/ST/WASH/INGO/2556,9/11/2017 12:56:51 PM,Overall,31056,28308,10510,10971,80845,31182,28720,10667,11488,82057
72,Iraq,2016,IRQ-16/3884/ST/WASH/INGO/2593,2/17/2017 11:20:54 AM,Host Communities,3058,3182,2822,2938,12000,14831,15439,16069,16727,63066
72,Iraq,2016,IRQ-16/3884/ST/WASH/INGO/2593,2/17/2017 11:20:54 AM,Internally Displaced People,7644,7956,7056,7344,30000,3025,3149,3278,3412,12864
72,Iraq,2016,IRQ-16/3884/ST/WASH/INGO/2593,2/17/2017 11:20:54 AM,Overall,10702,11138,9878,10282,42000,17856,18588,19347,20139,75930
72,Iraq,2016,IRQ-16/3884/ST/WASH/INGO/2632,3/28/2017 12:29:58 PM,Host Communities,4695,5086,1030,1116,11927,6380,10888,4498,5465,27231
72,Iraq,2016,IRQ-16/3884/ST/WASH/INGO/2632,3/28/2017 12:29:58 PM,Internally Displaced People,2528,2739,554,602,6423,2390,3728,1746,1909,9773
72,Iraq,2016,IRQ-16/3884/ST/WASH/INGO/2632,3/28/2017 12:29:58 PM,Overall,7223,7825,1584,1718,18350,8770,14616,6244,7373,37003
72,Iraq,2016,IRQ-16/3884/ST/WASH/INGO/2647,1/17/2017 8:38:05 AM,Host Communities,1403,1460,1243,1294,5400,1415,1477,1259,1310,5461
72,Iraq,2016,IRQ-16/3884/ST/WASH/INGO/2647,1/17/2017 8:38:05 AM,Internally Displaced People,467,486,415,432,1800,472,492,419,437,1820
72,Iraq,2016,IRQ-16/3884/ST/WASH/INGO/2647,1/17/2017 8:38:05 AM,Overall,1870,1946,1658,1726,7200,1887,1969,1678,1747,7281
72,Iraq,2016,IRQ-16/3884/ST/WASH/INGO/2656,2/2/2017 1:04:15 PM,Host Communities,1911,1911,1628,1628,7078,914,914,778,778,3384
72,Iraq,2016,IRQ-16/3884/ST/WASH/INGO/2656,2/2/2017 1:04:15 PM,Internally Displaced People,5466,5466,4657,4657,20246,2043,2043,1740,1740,7566
72,Iraq,2016,IRQ-16/3884/ST/WASH/INGO/2656,2/2/2017 1:04:15 PM,Overall,7377,7377,6285,6285,27324,2957,2957,2518,2518,10950
72,Iraq,2016,IRQ-16/3884/ST/WASH/INGO/2662,4/17/2017 1:36:17 PM,Internally Displaced People,6423,6722,5729,5926,24800,8755,9092,7745,8081,33673
72,Iraq,2016,IRQ-16/3884/ST/WASH/INGO/2662,4/17/2017 1:36:17 PM,Overall,6423,6722,5729,5926,24800,10055,10442,8894,9282,38673
72,Iraq,2016,IRQ-16/3884/ST/WASH/INGO/2668,3/14/2017 6:12:27 PM,Internally Displaced People,3176,2816,3580,3175,12747,20622,48044,20622,25274,114562
72,Iraq,2016,IRQ-16/3884/ST/WASH/INGO/2668,3/14/2017 6:12:27 PM,Overall,3176,2816,3580,3175,12747,0,0,0,0,0
72,Iraq,2016,IRQ-16/3884/ST/WASH/INGO/2670,7/8/2018 1:11:45 PM,Host Communities,2300,2572,1800,2028,8700,3250,3750,2625,2875,12500
72,Iraq,2016,IRQ-16/3884/ST/WASH/INGO/2670,7/8/2018 1:11:45 PM,Internally Displaced People,2000,2266,1600,1754,7620,2103,2426,1698,1861,8088
72,Iraq,2016,IRQ-16/3884/ST/WASH/INGO/2670,7/8/2018 1:11:45 PM,Overall,4300,4838,3400,3782,16320,11840,12071,10025,10202,44138
72,Iraq,2016,IRQ-16/3884/ST/WASH/INGO/2674,2/6/2017 10:03:25 AM,Internally Displaced People,26500,31800,23850,23850,106000,27650,32900,24250,24800,109600
72,Iraq,2016,IRQ-16/3884/ST/WASH/INGO/2674,2/6/2017 10:03:25 AM,Overall,26500,31800,23850,23850,106000,27650,32900,24250,24800,109600
72,Iraq,2016,IRQ-16/3884/ST/WASH/NGO/2542,2/17/2017 11:22:30 AM,Internally Displaced People,3600,14400,7200,10800,36000,4973,19898,9950,14925,49746
72,Iraq,2016,IRQ-16/3884/ST/WASH/NGO/2542,2/17/2017 11:22:30 AM,Overall,3600,14400,7200,10800,36000,4973,19898,9950,14925,49746
72,Iraq,2016,IRQ-16/3884/ST/WASH/NGO/2573,3/15/2017 9:03:11 AM,Host Communities,2123,2039,1702,1636,7500,1943,1319,982,1411,5655
72,Iraq,2016,IRQ-16/3884/ST/WASH/NGO/2573,3/15/2017 9:03:11 AM,Internally Displaced People,10269,9863,8324,7907,36363,10065,9632,8093,7646,35436
72,Iraq,2016,IRQ-16/3884/ST/WASH/NGO/2573,3/15/2017 9:03:11 AM,Overall,12392,11902,9936,9543,43773,12003,11513,9547,9135,42198
72,Iraq,2016,IRQ-16/3884/ST/WASH/O/2682,11/7/2017 11:46:01 AM,Host Communities,1029,988,825,793,3635,226,219,179,175,799
72,Iraq,2016,IRQ-16/3884/ST/WASH/O/2682,11/7/2017 11:46:01 AM,Internally Displaced People,2507,2408,2010,1931,8856,2600,2500,2085,2007,9192
72,Iraq,2016,IRQ-16/3884/ST/WASH/O/2682,11/7/2017 11:46:01 AM,Overall,3536,3396,2835,2724,12491,2854,2714,2270,2153,9991
72,Iraq,2016,IRQ-16/3884/ST/WASH/UN/2703,2/14/2017 7:07:52 PM,Internally Displaced People,46958,57393,46956,57393,208700,57150,69850,57150,69850,254000
72,Iraq,2016,IRQ-16/3884/ST/WASH/UN/2703,2/14/2017 7:07:52 PM,Overall,46958,57393,46956,57393,208700,57150,69850,57150,69850,254000
72,Iraq,2017,IRQ-17/3884/IHPF 2017 RA/WASH/INGO/5069,5/20/2018 1:52:22 PM,Internally Displaced People,11250,13500,10125,10125,45000,8815,13223,15536,17519,55093
72,Iraq,2017,IRQ-17/3884/IHPF 2017 RA/WASH/INGO/5069,5/20/2018 1:52:22 PM,Overall,11250,13500,10125,10125,45000,8815,13223,15536,17519,55093
72,Iraq,2017,IRQ-17/3884/R/CASH/INGO/7200,10/10/2018 1:49:43 PM,Host Communities,628,603,535,514,2280,39,46,43,40,168
72,Iraq,2017,IRQ-17/3884/R/CASH/INGO/7200,10/10/2018 1:49:43 PM,Internally Displaced People,892,858,760,730,3240,2020,2366,2145,2103,8634
72,Iraq,2017,IRQ-17/3884/R/CASH/INGO/7200,10/10/2018 1:49:43 PM,Overall,1520,1461,1295,1244,5520,1414,1656,1502,1471,6043
72,Iraq,2017,IRQ-17/3884/R/CASH/INGO/7229,7/19/2019 10:54:22 PM,Host Communities,0,0,0,0,0,412,473,292,300,1477
72,Iraq,2017,IRQ-17/3884/R/CASH/INGO/7229,7/19/2019 10:54:22 PM,Internally Displaced People,0,0,0,0,0,64,66,60,63,253
72,Iraq,2017,IRQ-17/3884/R/CASH/INGO/7229,7/19/2019 10:54:22 PM,Other,765,978,1275,1232,4250,900,996,833,835,3564
72,Iraq,2017,IRQ-17/3884/R/CASH/INGO/7229,7/19/2019 10:54:22 PM,Overall,765,978,1275,1232,4250,1377,1537,1189,1201,5304
72,Iraq,2017,IRQ-17/3884/R/CASH/INGO/7229,7/19/2019 10:54:22 PM,Refugees,0,0,0,0,0,1,2,4,3,10
72,Iraq,2017,IRQ-17/3884/R/E/INGO/7300,10/31/2018 11:40:27 AM,Host Communities,32,32,1620,1620,3304,0,0,0,0,0
72,Iraq,2017,IRQ-17/3884/R/E/INGO/7300,10/31/2018 11:40:27 AM,Internally Displaced People,22,22,1080,1080,2204,93,15,3740,2312,6160
72,Iraq,2017,IRQ-17/3884/R/E/INGO/7300,10/31/2018 11:40:27 AM,Overall,54,54,2700,2700,5508,105,15,3740,2312,6172
72,Iraq,2017,IRQ-17/3884/R/E/NGO/4951,6/5/2018 10:46:48 AM,Internally Displaced People,13,13,3593,4192,7811,13,13,3593,4192,7811
72,Iraq,2017,IRQ-17/3884/R/E/NGO/4951,6/5/2018 10:46:48 AM,Overall,13,13,3593,4192,7811,13,13,3593,4192,7811
72,Iraq,2017,IRQ-17/3884/R/E/NGO/7154,6/6/2018 11:47:54 AM,Host Communities,70,70,0,0,140,118,37,3325,2189,5669
72,Iraq,2017,IRQ-17/3884/R/E/NGO/7154,6/6/2018 11:47:54 AM,Internally Displaced People,37,37,1785,1786,3645,25,4,603,479,1111
72,Iraq,2017,IRQ-17/3884/R/E/NGO/7154,6/6/2018 11:47:54 AM,Overall,107,107,1785,1786,3785,143,41,3928,2668,6780
72,Iraq,2017,IRQ-17/3884/R/ELSC/NGO/4943,10/23/2018 9:57:03 AM,Host Communities,10,35,10,8,63,8,12,0,0,20
72,Iraq,2017,IRQ-17/3884/R/ELSC/NGO/4943,10/23/2018 9:57:03 AM,Internally Displaced People,80,15,35,7,137,126,54,0,0,180
72,Iraq,2017,IRQ-17/3884/R/ELSC/NGO/4943,10/23/2018 9:57:03 AM,Overall,90,50,45,15,200,134,66,0,0,200
72,Iraq,2017,IRQ-17/3884/R/ELSC/NGO/4957,5/15/2018 11:04:16 AM,Host Communities,50,35,10,5,100,36,36,0,0,72
72,Iraq,2017,IRQ-17/3884/R/ELSC/NGO/4957,5/15/2018 11:04:16 AM,Internally Displaced People,75,50,15,10,150,120,100,0,0,220
72,Iraq,2017,IRQ-17/3884/R/ELSC/NGO/4957,5/15/2018 11:04:16 AM,Other,25,15,5,5,50,6,2,0,0,8
72,Iraq,2017,IRQ-17/3884/R/ELSC/NGO/4957,5/15/2018 11:04:16 AM,Overall,150,100,30,20,300,162,138,0,0,300
72,Iraq,2017,IRQ-17/3884/R/F/NGO/4719,5/11/2018 8:50:11 AM,Host Communities,85,35,10,5,135,40,20,0,0,60
72,Iraq,2017,IRQ-17/3884/R/F/NGO/4719,5/11/2018 8:50:11 AM,Internally Displaced People,550,230,30,10,820,565,330,0,0,895
72,Iraq,2017,IRQ-17/3884/R/F/NGO/4719,5/11/2018 8:50:11 AM,Other,15,15,10,5,45,20,25,0,0,45
72,Iraq,2017,IRQ-17/3884/R/F/NGO/4719,5/11/2018 8:50:11 AM,Overall,650,280,50,20,1000,625,375,0,0,1000
72,Iraq,2017,IRQ-17/3884/R/H/INGO/7174,11/15/2018 1:15:02 PM,Host Communities,500,300,300,300,1400,24,25,10,5,64
72,Iraq,2017,IRQ-17/3884/R/H/INGO/7174,11/15/2018 1:15:02 PM,Internally Displaced People,1000,1700,1700,1700,6100,1454,3464,2020,2385,9323
72,Iraq,2017,IRQ-17/3884/R/H/INGO/7174,11/15/2018 1:15:02 PM,Overall,1500,2000,2000,2000,7500,1478,3508,2030,2390,9406
72,Iraq,2017,IRQ-17/3884/R/H/NGO/4974,5/15/2018 6:31:46 AM,Host Communities,6765,7862,725,750,16102,10150,9760,2845,2990,25745
72,Iraq,2017,IRQ-17/3884/R/H/NGO/4974,5/15/2018 6:31:46 AM,Internally Displaced People,6076,5505,545,572,12698,2530,2440,715,750,6435
72,Iraq,2017,IRQ-17/3884/R/H/NGO/4974,5/15/2018 6:31:46 AM,Overall,12841,13367,1270,1322,28800,12680,12200,3560,3740,32180
72,Iraq,2017,IRQ-17/3884/R/H/UN/6872,6/4/2018 8:25:11 AM,Internally Displaced People,4860,5040,3960,4140,18000,17611,21401,11000,11530,61542
72,Iraq,2017,IRQ-17/3884/R/H/UN/6872,6/4/2018 8:25:11 AM,Overall,4860,5040,3960,4140,18000,17611,21401,11000,11530,61542
72,Iraq,2017,IRQ-17/3884/R/H/UN/7141,1/16/2019 12:47:34 PM,Host Communities,2795,12591,2795,7009,25190,0,19216,0,10412,29628
72,Iraq,2017,IRQ-17/3884/R/H/UN/7141,1/16/2019 12:47:34 PM,Internally Displaced People,9000,30000,9000,22000,70000,6792,39253,5999,10817,62861
72,Iraq,2017,IRQ-17/3884/R/H/UN/7141,1/16/2019 12:47:34 PM,Overall,11795,42591,11795,29009,95190,6792,58469,5999,21229,92489
72,Iraq,2017,IRQ-17/3884/R/H/UN/7172,11/8/2018 1:20:58 PM,Internally Displaced People,3430,4252,2880,3157,13719,0,0,0,0,0
72,Iraq,2017,IRQ-17/3884/R/H/UN/7172,11/8/2018 1:20:58 PM,Overall,3430,4252,2880,3157,13719,3972,4923,4587,4726,18208
72,Iraq,2017,IRQ-17/3884/R/H/UN/7184,7/18/2019 7:08:23 AM,Internally Displaced People,0,0,0,0,0,47,3207,9342,8978,21574
72,Iraq,2017,IRQ-17/3884/R/H/UN/7184,7/18/2019 7:08:23 AM,Overall,0,4800,6120,5880,16800,47,3207,9342,8978,21574
72,Iraq,2017,IRQ-17/3884/R/H/UN/7191,11/8/2018 1:59:02 PM,Host Communities,5000,4800,5200,5000,20000,13519,12978,14060,13519,54076
72,Iraq,2017,IRQ-17/3884/R/H/UN/7191,11/8/2018 1:59:02 PM,Internally Displaced People,10000,9600,10400,10000,40000,27038,25956,28119,27038,108151
72,Iraq,2017,IRQ-17/3884/R/H/UN/7191,11/8/2018 1:59:02 PM,Other,5000,4800,5200,5000,20000,13519,12978,14060,13519,54076
72,Iraq,2017,IRQ-17/3884/R/H/UN/7191,11/8/2018 1:59:02 PM,Overall,20000,19200,20800,20000,80000,54075,51912,56238,54075,216300
72,Iraq,2017,IRQ-17/3884/R/NFIs/INGO/7221,3/5/2019 8:54:42 AM,Host Communities,792,792,731,731,3046,4519,4872,6023,5899,21313
72,Iraq,2017,IRQ-17/3884/R/NFIs/INGO/7221,3/5/2019 8:54:42 AM,Internally Displaced People,1584,1584,1461,1461,6090,70,86,116,102,374
72,Iraq,2017,IRQ-17/3884/R/NFIs/INGO/7221,3/5/2019 8:54:42 AM,Other,791,791,731,731,3044,0,0,0,0,0
72,Iraq,2017,IRQ-17/3884/R/NFIs/INGO/7221,3/5/2019 8:54:42 AM,Overall,3167,3167,2923,2923,12180,4589,4958,6139,6001,21687
72,Iraq,2017,IRQ-17/3884/R/NFIs/INGO/7230,11/8/2018 7:54:12 AM,Internally Displaced People,2753,3394,4103,4099,14349,3101,3796,3649,4183,14729
72,Iraq,2017,IRQ-17/3884/R/NFIs/INGO/7230,11/8/2018 7:54:12 AM,Overall,2753,3394,4103,4099,14349,3101,3796,3649,4183,14729
72,Iraq,2017,IRQ-17/3884/R/NFIs/NGO/4953,5/22/2018 6:02:41 AM,Internally Displaced People,105,165,390,440,1100,204,250,280,374,1108
72,Iraq,2017,IRQ-17/3884/R/NFIs/NGO/4953,5/22/2018 6:02:41 AM,Overall,105,165,390,440,1100,204,250,280,374,1108
72,Iraq,2017,IRQ-17/3884/R/NFIs/UN/6417,4/3/2019 12:54:42 PM,Internally Displaced People,3039,3666,4484,4924,16113,3000,3500,4500,5200,16200
72,Iraq,2017,IRQ-17/3884/R/NFIs/UN/6417,4/3/2019 12:54:42 PM,Overall,3039,3666,4484,4924,16113,3000,3500,4500,5000,16000
72,Iraq,2017,IRQ-17/3884/R/NFIs/UN/7283,6/5/2018 10:57:14 AM,Internally Displaced People,1000,1000,2000,2000,6000,500,500,1000,1000,3000
72,Iraq,2017,IRQ-17/3884/R/NFIs/UN/7283,6/5/2018 10:57:14 AM,Overall,1000,1000,2000,2000,6000,500,500,1000,1000,3000
72,Iraq,2017,IRQ-17/3884/R/NFIs-P/UN/6876,5/12/2019 10:55:50 AM,Internally Displaced People,3729,5923,7829,7799,25280,5392,6256,7328,7012,25988
72,Iraq,2017,IRQ-17/3884/R/NFIs-P/UN/6876,5/12/2019 10:55:50 AM,Overall,3729,5923,7829,7799,25280,5392,6256,7328,7012,25988
72,Iraq,2017,IRQ-17/3884/R/P/INGO/6864,11/10/2018 7:38:18 AM,Host Communities,25,25,0,0,50,0,0,0,0,0
72,Iraq,2017,IRQ-17/3884/R/P/INGO/6864,11/10/2018 7:38:18 AM,Internally Displaced People,601,699,1621,1566,4487,2036,2457,3734,4144,12371
72,Iraq,2017,IRQ-17/3884/R/P/INGO/6864,11/10/2018 7:38:18 AM,Overall,626,724,1621,1566,4537,2036,2457,3734,4144,12371
72,Iraq,2017,IRQ-17/3884/R/P/INGO/7107,10/31/2018 12:36:15 PM,Host Communities,462,462,300,300,1524,289,266,933,990,2478
72,Iraq,2017,IRQ-17/3884/R/P/INGO/7107,10/31/2018 12:36:15 PM,Internally Displaced People,550,550,400,400,1900,547,804,728,685,2764
72,Iraq,2017,IRQ-17/3884/R/P/INGO/7107,10/31/2018 12:36:15 PM,Overall,1012,1012,700,700,3424,793,1113,1054,1007,3967
72,Iraq,2017,IRQ-17/3884/R/P/INGO/7225,1/8/2019 10:25:30 AM,Internally Displaced People,7000,7000,7000,7000,28000,207,399,1124,1056,2786
72,Iraq,2017,IRQ-17/3884/R/P/INGO/7225,1/8/2019 10:25:30 AM,Other,10000,10000,10000,10000,40000,11807,12254,13943,13791,51795
72,Iraq,2017,IRQ-17/3884/R/P/INGO/7225,1/8/2019 10:25:30 AM,Overall,17000,17000,17000,17000,68000,12014,12653,15067,14847,54581
72,Iraq,2017,IRQ-17/3884/R/P/INGO/7267,7/18/2019 7:13:57 AM,Host Communities,400,400,800,800,2400,1808,1337,521,476,4142
72,Iraq,2017,IRQ-17/3884/R/P/INGO/7267,7/18/2019 7:13:57 AM,Internally Displaced People,1600,1600,3200,3200,9600,1,1,5,4,11
72,Iraq,2017,IRQ-17/3884/R/P/INGO/7267,7/18/2019 7:13:57 AM,Overall,3000,3000,6000,6000,18000,4095,3591,2013,1934,11633
72,Iraq,2017,IRQ-17/3884/R/P/INGO/7268,2/26/2019 7:50:08 AM,Internally Displaced People,640,565,340,340,1885,352,1107,1475,1327,4261
72,Iraq,2017,IRQ-17/3884/R/P/INGO/7268,2/26/2019 7:50:08 AM,Overall,640,565,340,340,1885,352,1107,1475,1327,4261
72,Iraq,2017,IRQ-17/3884/R/P/INGO/7316,3/27/2019 2:41:02 PM,Host Communities,13,13,0,0,26,0,0,0,0,0
72,Iraq,2017,IRQ-17/3884/R/P/INGO/7316,3/27/2019 2:41:02 PM,Internally Displaced People,0,0,60,60,120,13,16,36,69,134
72,Iraq,2017,IRQ-17/3884/R/P/INGO/7316,3/27/2019 2:41:02 PM,Overall,13,13,60,60,146,13,16,36,69,134
72,Iraq,2017,IRQ-17/3884/R/P/NGO/4757,11/3/2018 6:14:58 PM,Internally Displaced People,600,600,0,850,2050,633,679,0,2076,3388
72,Iraq,2017,IRQ-17/3884/R/P/NGO/4757,11/3/2018 6:14:58 PM,Overall,600,600,0,850,2050,633,679,0,2076,3388
72,Iraq,2017,IRQ-17/3884/R/P/NGO/4967,1/17/2019 2:05:23 PM,Internally Displaced People,300,1700,200,500,2700,0,0,0,0,0
72,Iraq,2017,IRQ-17/3884/R/P/NGO/4967,1/17/2019 2:05:23 PM,Other,400,4200,400,1100,6100,1104,2091,590,1146,4931
72,Iraq,2017,IRQ-17/3884/R/P/NGO/4967,1/17/2019 2:05:23 PM,Overall,700,5900,600,1600,8800,1104,2091,590,1146,4931
72,Iraq,2017,IRQ-17/3884/R/P/NGO/4971,9/27/2018 12:09:09 PM,Internally Displaced People,600,2500,2200,2200,7500,4224,4463,5636,5905,20228
72,Iraq,2017,IRQ-17/3884/R/P/NGO/4971,9/27/2018 12:09:09 PM,Overall,600,2500,2200,2200,7500,4224,4463,5636,5905,20228
72,Iraq,2017,IRQ-17/3884/R/P/NGO/4972,10/1/2018 10:53:47 AM,Host Communities,1500,1500,1500,1500,6000,4189,3901,6035,5417,19542
72,Iraq,2017,IRQ-17/3884/R/P/NGO/4972,10/1/2018 10:53:47 AM,Internally Displaced People,4000,4000,6000,6000,20000,3743,3420,5236,4443,16842
72,Iraq,2017,IRQ-17/3884/R/P/NGO/4972,10/1/2018 10:53:47 AM,Other,500,500,500,500,2000,2657,1521,14963,17648,36789
72,Iraq,2017,IRQ-17/3884/R/P/NGO/4972,10/1/2018 10:53:47 AM,Overall,6000,6000,8000,8000,28000,10589,8842,26234,27508,73173
72,Iraq,2017,IRQ-17/3884/R/P/NGO/4976,7/21/2019 6:30:21 AM,Host Communities,300,50,50,50,450,1228,80,367,300,1975
72,Iraq,2017,IRQ-17/3884/R/P/NGO/4976,7/21/2019 6:30:21 AM,Internally Displaced People,3000,400,300,300,4000,2056,736,1994,2001,6787
72,Iraq,2017,IRQ-17/3884/R/P/NGO/4976,7/21/2019 6:30:21 AM,Other,700,50,50,50,850,750,60,320,300,1430
72,Iraq,2017,IRQ-17/3884/R/P/NGO/4976,7/21/2019 6:30:21 AM,Overall,4000,500,400,400,5300,4034,876,2681,2601,10192
72,Iraq,2017,IRQ-17/3884/R/P/UN/6862,11/8/2018 12:16:19 PM,Internally Displaced People,330,2100,250,1095,3775,1852,4171,2431,2711,11165
72,Iraq,2017,IRQ-17/3884/R/P/UN/6862,11/8/2018 12:16:19 PM,Overall,330,2100,250,1095,3775,1852,4171,2431,2711,11165
72,Iraq,2017,IRQ-17/3884/R/P/UN/7183,1/15/2019 7:46:50 AM,Internally Displaced People,1225,14156,875,9330,25586,2556,30683,17808,8292,59339
72,Iraq,2017,IRQ-17/3884/R/P/UN/7183,1/15/2019 7:46:50 AM,Overall,1225,14156,875,9330,25586,2556,30682,2661,23439,59338
72,Iraq,2017,IRQ-17/3884/R/P-E/INGO/7299,7/18/2019 7:17:50 AM,Internally Displaced People,28,28,845,845,1746,115,51,1180,931,2277
72,Iraq,2017,IRQ-17/3884/R/P-E/INGO/7299,7/18/2019 7:17:50 AM,Overall,28,28,845,845,1746,115,51,1180,931,2277
72,Iraq,2017,IRQ-17/3884/R/WASH/INGO/7100,4/14/2019 12:42:11 PM,Internally Displaced People,4586,4774,4234,4406,18000,4586,4774,4234,4406,18000
72,Iraq,2017,IRQ-17/3884/R/WASH/INGO/7100,4/14/2019 12:42:11 PM,Overall,4586,4774,4234,4406,18000,3854,4233,3920,4256,16263
72,Iraq,2017,IRQ-17/3884/R/WASH/INGO/7232,11/2/2018 8:54:12 AM,Internally Displaced People,1147,1455,1871,1827,6300,2484,3194,4226,3900,13804
72,Iraq,2017,IRQ-17/3884/R/WASH/INGO/7232,11/2/2018 8:54:12 AM,Other,764,970,1248,1218,4200,981,1170,1282,1292,4725
72,Iraq,2017,IRQ-17/3884/R/WASH/INGO/7232,11/2/2018 8:54:12 AM,Overall,1911,2425,3119,3045,10500,3465,4364,5508,5192,18529
72,Iraq,2017,IRQ-17/3884/R/WASH/INGO/7293,1/23/2019 7:55:21 AM,Internally Displaced People,21440,25728,19295,19295,85758,16773,23385,23834,23834,87826
72,Iraq,2017,IRQ-17/3884/R/WASH/INGO/7293,1/23/2019 7:55:21 AM,Overall,21440,25728,19295,19295,85758,15810,22834,24591,24591,87826
72,Iraq,2017,IRQ-17/3884/R/WASH/NGO/4851,1/29/2018 9:42:58 AM,Host Communities,552,457,630,620,2259,524,433,564,601,2122
72,Iraq,2017,IRQ-17/3884/R/WASH/NGO/4851,1/29/2018 9:42:58 AM,Internally Displaced People,2208,1828,2520,2480,9036,2457,1864,2741,2775,9837
72,Iraq,2017,IRQ-17/3884/R/WASH/NGO/4851,1/29/2018 9:42:58 AM,Overall,2760,2285,3150,3100,11295,2981,2297,3305,3376,11959
72,Iraq,2017,IRQ-17/3884/R/WASH/NGO/4949,1/16/2019 2:02:29 PM,Host Communities,355,213,2000,1370,3938,500,300,2500,1450,4750
72,Iraq,2017,IRQ-17/3884/R/WASH/NGO/4949,1/16/2019 2:02:29 PM,Internally Displaced People,45,87,405,225,762,100,200,500,250,1050
72,Iraq,2017,IRQ-17/3884/R/WASH/NGO/4949,1/16/2019 2:02:29 PM,Overall,400,300,2405,1595,4700,600,500,3000,1700,5800
72,Iraq,2017,IRQ-17/3884/R/WASH/NGO/7134,11/6/2018 7:18:35 AM,Host Communities,975,975,525,525,3000,0,0,0,0,0
72,Iraq,2017,IRQ-17/3884/R/WASH/NGO/7134,11/6/2018 7:18:35 AM,Internally Displaced People,2340,2340,1260,1260,7200,4801,6080,2321,3076,16278
72,Iraq,2017,IRQ-17/3884/R/WASH/NGO/7134,11/6/2018 7:18:35 AM,Other,16185,16185,8715,8715,49800,0,0,0,0,0
72,Iraq,2017,IRQ-17/3884/R/WASH/NGO/7134,11/6/2018 7:18:35 AM,Overall,19500,19500,10500,10500,60000,4801,6080,2321,3076,16278
72,Iraq,2017,IRQ-17/3884/R/WASH/O/6875,4/16/2019 10:03:15 AM,Internally Displaced People,1782,2673,2675,4012,11142,1047,1278,1383,1412,5120
72,Iraq,2017,IRQ-17/3884/R/WASH/O/6875,4/16/2019 10:03:15 AM,Overall,1782,2673,2675,4012,11142,1047,1278,1383,1412,5120
72,Iraq,2017,IRQ-17/3884/R7/CCCM/UN/7683,3/19/2019 11:06:50 AM,Overall,13422,17471,17902,17328,66123,12370,16108,17631,17412,63521
72,Iraq,2017,IRQ-17/3884/R7/CCS/INGO/7720,7/18/2019 7:02:37 AM,Overall,43,43,42,42,170,43,43,42,42,170
72,Iraq,2017,IRQ-17/3884/R7/NFIs/INGO/7695,11/10/2018 5:16:58 AM,Internally Displaced People,1092,1134,945,1029,4200,665,869,827,872,3233
72,Iraq,2017,IRQ-17/3884/R7/NFIs/INGO/7695,11/10/2018 5:16:58 AM,Overall,1092,1134,945,1029,4200,665,869,827,872,3233
72,Iraq,2017,IRQ-17/3884/R7/NFIs/INGO/7699,11/9/2018 7:20:55 AM,Internally Displaced People,2822,2938,3058,3182,12000,2276,2639,5150,5575,15640
72,Iraq,2017,IRQ-17/3884/R7/NFIs/INGO/7699,11/9/2018 7:20:55 AM,Overall,2822,2938,3058,3182,12000,2275,2640,5150,5575,15640
72,Iraq,2017,IRQ-17/3884/R7/NFIs/NGO/7697,3/5/2019 10:02:43 AM,Other,6000,6000,6000,6000,24000,4322,5102,6960,7038,23422
72,Iraq,2017,IRQ-17/3884/R7/NFIs/NGO/7697,3/5/2019 10:02:43 AM,Overall,6000,6000,6000,6000,24000,4322,5102,6960,7038,23422
72,Iraq,2017,IRQ-17/3884/R7/NFIs/UN/7689,11/4/2018 7:42:06 AM,Overall,1800,2235,1510,1655,7200,1679,1952,2128,1971,7730
72,Iraq,2017,IRQ-17/3884/RA/LOGs/UN/5502,9/29/2019 8:09:53 AM,Overall,5,4,0,0,9,0,0,0,0,0
72,Iraq,2017,IRQ-17/3884/RA/P/UN/6206,6/10/2018 12:36:46 PM,Host Communities,0,23040,0,5760,28800,0,6400,0,1600,8000
72,Iraq,2017,IRQ-17/3884/RA/P/UN/6206,6/10/2018 12:36:46 PM,Internally Displaced People,0,92160,0,23040,115200,0,25600,0,6400,32000
72,Iraq,2017,IRQ-17/3884/RA/P/UN/6206,6/10/2018 12:36:46 PM,Overall,0,115200,0,28800,144000,0,32000,0,8000,40000
72,Iraq,2017,IRQ-17/3884/ST/CASH/INGO/5636,5/8/2018 7:51:11 AM,Overall,918,882,1323,1377,4500,1120,1075,1603,1669,5467
72,Iraq,2017,IRQ-17/3884/ST/CASH/INGO/5658,11/8/2018 9:49:09 PM,Host Communities,61,61,62,62,246,0,0,0,0,0
72,Iraq,2017,IRQ-17/3884/ST/CASH/INGO/5658,11/8/2018 9:49:09 PM,Internally Displaced People,543,543,543,543,2172,9,8,12,12,41
72,Iraq,2017,IRQ-17/3884/ST/CASH/INGO/5658,11/8/2018 9:49:09 PM,Other,325,325,326,326,1302,1140,1242,962,904,4248
72,Iraq,2017,IRQ-17/3884/ST/CASH/INGO/5658,11/8/2018 9:49:09 PM,Overall,929,929,931,931,3720,1149,1250,974,916,4289
72,Iraq,2017,IRQ-17/3884/ST/CASH/INGO/5709,9/27/2018 1:30:23 PM,Internally Displaced People,6225,5980,5303,5094,22602,5563,5694,5245,5230,21732
72,Iraq,2017,IRQ-17/3884/ST/CASH/INGO/5709,9/27/2018 1:30:23 PM,Overall,6225,5980,5303,5094,22602,5563,5694,5245,5230,21732
72,Iraq,2017,IRQ-17/3884/ST/CCCM/INGO/5493,11/5/2018 12:58:07 PM,Host Communities,260,270,230,240,1000,0,0,0,0,0
72,Iraq,2017,IRQ-17/3884/ST/CCCM/INGO/5493,11/5/2018 12:58:07 PM,Internally Displaced People,33930,35235,30015,31320,130500,46808,49972,50842,50089,197711
72,Iraq,2017,IRQ-17/3884/ST/CCCM/INGO/5493,11/5/2018 12:58:07 PM,Overall,34190,35505,30245,31560,131500,46808,49972,50842,50089,197711
72,Iraq,2017,IRQ-17/3884/ST/CCCM/INGO/5596,11/4/2018 12:48:40 PM,Internally Displaced People,2250,3000,4500,5250,15000,400,431,648,576,2055
72,Iraq,2017,IRQ-17/3884/ST/CCCM/INGO/5596,11/4/2018 12:48:40 PM,Overall,2250,3000,4500,5250,15000,400,431,648,576,2055
72,Iraq,2017,IRQ-17/3884/ST/CCCM/NGO/5483,5/27/2018 9:32:30 AM,Internally Displaced People,15840,14400,20160,21600,72000,15840,14400,20160,21600,72000
72,Iraq,2017,IRQ-17/3884/ST/CCCM/NGO/5483,5/27/2018 9:32:30 AM,Overall,15840,14400,20160,21600,72000,15840,14400,20160,21600,72000
72,Iraq,2017,IRQ-17/3884/ST/CCS/INGO/5543,5/23/2018 7:29:44 AM,Overall,125000,125000,125000,125000,500000,125000,125000,125000,125000,500000
72,Iraq,2017,IRQ-17/3884/ST/CCS/UN/5541,7/18/2019 7:11:01 AM,Host Communities,774,206,8,2,990,1748,1224,14,9,2995
72,Iraq,2017,IRQ-17/3884/ST/CCS/UN/5541,7/18/2019 7:11:01 AM,Internally Displaced People,37940,10085,383,102,48510,35488,13093,395,110,49086
72,Iraq,2017,IRQ-17/3884/ST/CCS/UN/5541,7/18/2019 7:11:01 AM,Overall,38714,10291,391,104,49500,51730,22075,498,163,74466
72,Iraq,2017,IRQ-17/3884/ST/E/INGO/5545,2/26/2019 7:23:53 AM,Internally Displaced People,18,30,1200,1200,2448,10,19,1609,1512,3150
72,Iraq,2017,IRQ-17/3884/ST/E/INGO/5545,2/26/2019 7:23:53 AM,Overall,18,30,1200,1200,2448,10,19,1609,1512,3150
72,Iraq,2017,IRQ-17/3884/ST/E/INGO/5653,11/3/2018 6:20:02 PM,Host Communities,2,3,0,0,5,0,0,0,0,0
72,Iraq,2017,IRQ-17/3884/ST/E/INGO/5653,11/3/2018 6:20:02 PM,Internally Displaced People,104,207,1670,1930,3911,65,101,3862,4285,8313
72,Iraq,2017,IRQ-17/3884/ST/E/INGO/5653,11/3/2018 6:20:02 PM,Overall,106,210,1670,1930,3916,65,101,3862,4285,8313
72,Iraq,2017,IRQ-17/3884/ST/E/INGO/5686,1/16/2019 12:38:34 PM,Host Communities,1106,1162,2800,2800,7868,0,0,0,0,0
72,Iraq,2017,IRQ-17/3884/ST/E/INGO/5686,1/16/2019 12:38:34 PM,Internally Displaced People,474,498,1200,1200,3372,0,0,0,0,0
72,Iraq,2017,IRQ-17/3884/ST/E/INGO/5686,1/16/2019 12:38:34 PM,Overall,1580,1660,4000,4000,11240,431,376,5044,3322,9173
72,Iraq,2017,IRQ-17/3884/ST/E/INGO/5703,1/16/2019 1:02:53 PM,Internally Displaced People,851,851,13005,11245,25952,111,109,9833,11092,21145
72,Iraq,2017,IRQ-17/3884/ST/E/INGO/5703,1/16/2019 1:02:53 PM,Other,0,0,2595,2595,5190,0,0,0,0,0
72,Iraq,2017,IRQ-17/3884/ST/E/INGO/5703,1/16/2019 1:02:53 PM,Overall,851,851,15600,13840,31142,111,109,9833,11092,21145
72,Iraq,2017,IRQ-17/3884/ST/E/INGO/5775,10/1/2018 2:12:19 PM,Other,0,0,8000,8000,16000,0,0,8066,7950,16016
72,Iraq,2017,IRQ-17/3884/ST/E/INGO/5775,10/1/2018 2:12:19 PM,Overall,0,0,8000,8000,16000,0,0,8066,7950,16016
72,Iraq,2017,IRQ-17/3884/ST/E/NGO/5435,10/1/2018 11:31:43 AM,Host Communities,30,28,100,100,258,50,20,0,0,70
72,Iraq,2017,IRQ-17/3884/ST/E/NGO/5435,10/1/2018 11:31:43 AM,Internally Displaced People,30,30,1000,1000,2060,31,17,1748,1657,3453
72,Iraq,2017,IRQ-17/3884/ST/E/NGO/5435,10/1/2018 11:31:43 AM,Overall,60,58,1110,1110,2338,81,37,1748,1657,3523
72,Iraq,2017,IRQ-17/3884/ST/E/NGO/5571,2/18/2019 9:37:19 AM,Host Communities,156,173,3881,3265,7475,156,173,3881,3265,7475
72,Iraq,2017,IRQ-17/3884/ST/E/NGO/5571,2/18/2019 9:37:19 AM,Internally Displaced People,17,18,431,363,829,17,18,431,363,829
72,Iraq,2017,IRQ-17/3884/ST/E/NGO/5571,2/18/2019 9:37:19 AM,Overall,173,191,4312,3628,8304,173,191,4312,3628,8304
72,Iraq,2017,IRQ-17/3884/ST/EL/INGO/5577,1/27/2019 7:53:29 AM,Host Communities,33,11,0,0,44,22,6,0,0,28
72,Iraq,2017,IRQ-17/3884/ST/EL/INGO/5577,1/27/2019 7:53:29 AM,Internally Displaced People,61,21,0,0,82,30,17,0,0,47
72,Iraq,2017,IRQ-17/3884/ST/EL/INGO/5577,1/27/2019 7:53:29 AM,Other,256,68,0,0,324,312,66,0,0,378
72,Iraq,2017,IRQ-17/3884/ST/EL/INGO/5577,1/27/2019 7:53:29 AM,Overall,350,100,0,0,450,364,89,0,0,453
72,Iraq,2017,IRQ-17/3884/ST/EL/INGO/5720,9/26/2018 10:51:15 AM,Host Communities,85,85,79,95,344,140,184,92,106,522
72,Iraq,2017,IRQ-17/3884/ST/EL/INGO/5720,9/26/2018 10:51:15 AM,Internally Displaced People,759,759,691,783,2992,1260,1654,836,953,4703
72,Iraq,2017,IRQ-17/3884/ST/EL/INGO/5720,9/26/2018 10:51:15 AM,Overall,844,844,770,878,3336,1400,1838,928,1059,5225
72,Iraq,2017,IRQ-17/3884/ST/EL/INGO/5735,5/24/2018 1:25:37 PM,Host Communities,150,150,300,300,900,663,624,387,392,2066
72,Iraq,2017,IRQ-17/3884/ST/EL/INGO/5735,5/24/2018 1:25:37 PM,Internally Displaced People,370,370,740,740,2220,227,246,193,206,872
72,Iraq,2017,IRQ-17/3884/ST/EL/INGO/5735,5/24/2018 1:25:37 PM,Overall,520,520,1040,1040,3120,860,870,580,598,2908
72,Iraq,2017,IRQ-17/3884/ST/EL/NGO/5728,9/30/2019 8:30:41 AM,Host Communities,250,250,275,275,1050,582,541,355,368,1846
72,Iraq,2017,IRQ-17/3884/ST/EL/NGO/5728,9/30/2019 8:30:41 AM,Internally Displaced People,250,250,275,275,1050,202,204,126,120,652
72,Iraq,2017,IRQ-17/3884/ST/EL/NGO/5728,9/30/2019 8:30:41 AM,Overall,500,500,550,550,2100,784,745,481,488,2498
72,Iraq,2017,IRQ-17/3884/ST/E-P/INGO/5744,10/7/2018 12:28:09 PM,Host Communities,610,610,400,400,2020,0,0,0,0,0
72,Iraq,2017,IRQ-17/3884/ST/E-P/INGO/5744,10/7/2018 12:28:09 PM,Internally Displaced People,640,640,3400,3400,8080,0,0,0,0,0
72,Iraq,2017,IRQ-17/3884/ST/E-P/INGO/5744,10/7/2018 12:28:09 PM,Overall,1250,1250,3800,3800,10100,1854,1651,6900,6794,17199
72,Iraq,2017,IRQ-17/3884/ST/ETC/UN/5632,3/20/2019 11:53:43 AM,Other,60,0,0,0,60,0,0,0,0,0
72,Iraq,2017,IRQ-17/3884/ST/ETC/UN/5632,3/20/2019 11:53:43 AM,Overall,60,0,0,0,60,60,0,0,0,60
72,Iraq,2017,IRQ-17/3884/ST/E-WASH-P/INGO/5757,11/14/2018 10:47:34 AM,Host Communities,4000,4000,20700,27300,56000,4000,4000,20700,27300,56000
72,Iraq,2017,IRQ-17/3884/ST/E-WASH-P/INGO/5757,11/14/2018 10:47:34 AM,Overall,4000,4000,20700,27300,56000,4000,4000,20700,27300,56000
72,Iraq,2017,IRQ-17/3884/ST/F/INGO/5453,5/15/2018 3:12:08 PM,Host Communities,1063,1063,2126,2126,6378,1172,1172,2344,2344,7032
72,Iraq,2017,IRQ-17/3884/ST/F/INGO/5453,5/15/2018 3:12:08 PM,Internally Displaced People,1063,1063,2126,2126,6378,966,966,1932,1932,5796
72,Iraq,2017,IRQ-17/3884/ST/F/INGO/5453,5/15/2018 3:12:08 PM,Overall,2126,2126,4252,4252,12756,2138,2138,4276,4276,12828
72,Iraq,2017,IRQ-17/3884/ST/F/INGO/5487,10/2/2018 7:29:35 AM,Host Communities,6661,6399,5674,5451,24185,7578,7302,6476,6200,27556
72,Iraq,2017,IRQ-17/3884/ST/F/INGO/5487,10/2/2018 7:29:35 AM,Internally Displaced People,3329,3200,2836,2727,12092,3789,3651,3238,3100,13778
72,Iraq,2017,IRQ-17/3884/ST/F/INGO/5487,10/2/2018 7:29:35 AM,Other,6661,6399,5674,5451,24185,7579,7304,6475,6200,27558
72,Iraq,2017,IRQ-17/3884/ST/F/INGO/5487,10/2/2018 7:29:35 AM,Overall,16651,15998,14184,13629,60462,18946,18257,16189,15500,68892
72,Iraq,2017,IRQ-17/3884/ST/F/INGO/5675,5/30/2018 1:26:42 PM,Internally Displaced People,3068,3054,3051,2827,12000,3260,3265,3242,3023,12790
72,Iraq,2017,IRQ-17/3884/ST/F/INGO/5675,5/30/2018 1:26:42 PM,Other,6138,6106,6101,5655,24000,6562,6496,6402,6120,25580
72,Iraq,2017,IRQ-17/3884/ST/F/INGO/5675,5/30/2018 1:26:42 PM,Overall,9206,9160,9152,8482,36000,9814,9762,9754,9040,38370
72,Iraq,2017,IRQ-17/3884/ST/F/UN/5693,1/24/2019 9:40:48 AM,Host Communities,21402,17712,18450,16236,73800,0,0,0,0,0
72,Iraq,2017,IRQ-17/3884/ST/F/UN/5693,1/24/2019 9:40:48 AM,Internally Displaced People,49938,41328,43050,37884,172200,0,0,0,0,0
72,Iraq,2017,IRQ-17/3884/ST/F/UN/5693,1/24/2019 9:40:48 AM,Overall,71340,59040,61500,54120,246000,71340,59040,61500,54120,246000
72,Iraq,2017,IRQ-17/3884/ST/H/INGO/5393,5/13/2018 10:29:55 AM,Internally Displaced People,11760,12322,9296,8871,42249,30037,48196,18367,19916,116516
72,Iraq,2017,IRQ-17/3884/ST/H/INGO/5393,5/13/2018 10:29:55 AM,Overall,11760,12322,9296,8871,42249,30037,48196,18367,19916,116516
72,Iraq,2017,IRQ-17/3884/ST/H/INGO/5423,6/4/2018 1:27:50 PM,Internally Displaced People,10267,12053,11160,11160,44640,8651,10425,9415,7612,36103
72,Iraq,2017,IRQ-17/3884/ST/H/INGO/5423,6/4/2018 1:27:50 PM,Overall,10267,12053,11160,11160,44640,10496,11707,10646,8464,41313
72,Iraq,2017,IRQ-17/3884/ST/H/INGO/5644,5/10/2018 12:47:52 PM,Internally Displaced People,4891,4668,5780,6891,22230,4925,4701,5820,6940,22386
72,Iraq,2017,IRQ-17/3884/ST/H/INGO/5644,5/10/2018 12:47:52 PM,Overall,4891,4668,5780,6891,22230,4925,4701,5820,6940,22386
72,Iraq,2017,IRQ-17/3884/ST/H/INGO/5648,1/20/2019 6:38:49 AM,Internally Displaced People,3900,3900,3600,3600,15000,9100,9100,8400,8400,35000
72,Iraq,2017,IRQ-17/3884/ST/H/INGO/5648,1/20/2019 6:38:49 AM,Overall,3900,3900,3600,3600,15000,9100,9100,8400,8400,35000
72,Iraq,2017,IRQ-17/3884/ST/H/INGO/5668,5/17/2018 1:43:23 PM,Overall,16880,17570,14970,15580,65000,9243,11030,8654,11821,40748
72,Iraq,2017,IRQ-17/3884/ST/H/INGO/5671,9/25/2018 10:01:04 AM,Host Communities,450,450,300,300,1500,389,0,0,0,389
72,Iraq,2017,IRQ-17/3884/ST/H/INGO/5671,9/25/2018 10:01:04 AM,Internally Displaced People,9000,9000,6000,6000,30000,10250,9500,4805,3114,27669
72,Iraq,2017,IRQ-17/3884/ST/H/INGO/5671,9/25/2018 10:01:04 AM,Overall,9450,9450,6300,6300,31500,10250,9500,4805,3114,27669
72,Iraq,2017,IRQ-17/3884/ST/H/INGO/5694,11/2/2018 5:27:08 PM,Host Communities,1057,1100,1240,1192,4589,1750,1800,3600,3827,10977
72,Iraq,2017,IRQ-17/3884/ST/H/INGO/5694,11/2/2018 5:27:08 PM,Internally Displaced People,1057,1100,1241,1192,4590,1750,1800,3600,3827,10977
72,Iraq,2017,IRQ-17/3884/ST/H/INGO/5694,11/2/2018 5:27:08 PM,Overall,2114,2200,2481,2384,9179,3500,3600,7200,7654,21954
72,Iraq,2017,IRQ-17/3884/ST/H/INGO/5754,11/6/2018 11:58:18 AM,Host Communities,3936,4756,3854,3854,16400,4252,5341,1663,1748,13004
72,Iraq,2017,IRQ-17/3884/ST/H/INGO/5754,11/6/2018 11:58:18 AM,Internally Displaced People,4920,5945,4818,4818,20501,5316,6676,2079,2186,16257
72,Iraq,2017,IRQ-17/3884/ST/H/INGO/5754,11/6/2018 11:58:18 AM,Other,984,1189,963,963,4099,1063,1335,415,437,3250
72,Iraq,2017,IRQ-17/3884/ST/H/INGO/5754,11/6/2018 11:58:18 AM,Overall,9840,11890,9635,9635,41000,10631,13352,4157,4371,32511
72,Iraq,2017,IRQ-17/3884/ST/H/NGO/5411,5/20/2018 2:54:22 PM,Internally Displaced People,6068,6508,4336,4770,21682,15162,19880,5573,5872,46487
72,Iraq,2017,IRQ-17/3884/ST/H/NGO/5411,5/20/2018 2:54:22 PM,Other,2840,3042,2028,2232,10142,10108,13254,3716,3841,30919
72,Iraq,2017,IRQ-17/3884/ST/H/NGO/5411,5/20/2018 2:54:22 PM,Overall,8908,9550,6364,7002,31824,25270,33134,9289,9713,77406
72,Iraq,2017,IRQ-17/3884/ST/H/NGO/5440,6/6/2018 11:10:04 AM,Internally Displaced People,3474,3437,2374,2265,11550,1955,1934,1336,1275,6500
72,Iraq,2017,IRQ-17/3884/ST/H/NGO/5440,6/6/2018 11:10:04 AM,Overall,3474,3437,2374,2265,11550,1955,1934,1336,1275,6500
72,Iraq,2017,IRQ-17/3884/ST/H/NGO/5631,1/27/2019 7:44:07 AM,Host Communities,5867,5803,4373,3457,19500,1967,2470,2195,1672,8304
72,Iraq,2017,IRQ-17/3884/ST/H/NGO/5631,1/27/2019 7:44:07 AM,Internally Displaced People,1083,1071,808,638,3600,2862,3597,3209,2478,12146
72,Iraq,2017,IRQ-17/3884/ST/H/NGO/5631,1/27/2019 7:44:07 AM,Overall,6950,6874,5181,4095,23100,6153,6085,4587,3625,20450
72,Iraq,2017,IRQ-17/3884/ST/H/NGO/5663,5/13/2018 1:14:19 PM,Internally Displaced People,0,0,0,0,0,13130,21190,6773,5553,46646
72,Iraq,2017,IRQ-17/3884/ST/H/NGO/5663,5/13/2018 1:14:19 PM,Overall,12932,13458,1279,1331,29000,13130,21190,6773,5553,46646
72,Iraq,2017,IRQ-17/3884/ST/H/UN/5490,6/1/2018 9:10:03 AM,Host Communities,1455,1828,1246,1306,5835,2926,5354,3733,3955,15968
72,Iraq,2017,IRQ-17/3884/ST/H/UN/5490,6/1/2018 9:10:03 AM,Internally Displaced People,9718,12212,8319,8713,38962,6547,9648,7111,7371,30677
72,Iraq,2017,IRQ-17/3884/ST/H/UN/5490,6/1/2018 9:10:03 AM,Overall,11173,14040,9565,10022,44800,9473,15002,10844,11326,46645
72,Iraq,2017,IRQ-17/3884/ST/H/UN/5579,5/22/2018 7:12:55 AM,Host Communities,0,12250,490,3062,15802,0,15780,673,4281,20734
72,Iraq,2017,IRQ-17/3884/ST/H/UN/5579,5/22/2018 7:12:55 AM,Internally Displaced People,0,12250,490,3063,15803,0,10532,350,2431,13313
72,Iraq,2017,IRQ-17/3884/ST/H/UN/5579,5/22/2018 7:12:55 AM,Overall,0,24500,980,6125,31605,0,26312,1023,6712,34047
72,Iraq,2017,IRQ-17/3884/ST/H/UN/5640,8/19/2019 1:47:00 PM,Host Communities,55000,65000,50000,59000,229000,69406,66630,72260,69366,277662
72,Iraq,2017,IRQ-17/3884/ST/H/UN/5640,8/19/2019 1:47:00 PM,Internally Displaced People,75000,80000,56000,60000,271000,73699,70751,76646,73659,294755
72,Iraq,2017,IRQ-17/3884/ST/H/UN/5640,8/19/2019 1:47:00 PM,Overall,130000,145000,106000,119000,500000,148837,166001,121348,136231,572417
72,Iraq,2017,IRQ-17/3884/ST/LOGs/UN/5627,11/18/2018 8:37:34 AM,Overall,0,0,0,30,30,0,0,0,30,30
72,Iraq,2017,IRQ-17/3884/ST/NFIs/INGO/5434,11/21/2018 12:02:19 PM,Host Communities,1063,1063,2126,2126,6378,966,966,1932,1932,5796
72,Iraq,2017,IRQ-17/3884/ST/NFIs/INGO/5434,11/21/2018 12:02:19 PM,Internally Displaced People,1063,1063,2126,2126,6378,1160,1160,2320,2320,6960
72,Iraq,2017,IRQ-17/3884/ST/NFIs/INGO/5434,11/21/2018 12:02:19 PM,Overall,2126,2126,4252,4252,12756,2126,2126,4252,4252,12756
72,Iraq,2017,IRQ-17/3884/ST/NFIs/INGO/5505,6/10/2018 12:22:48 PM,Internally Displaced People,1016,1200,1194,1208,4618,807,797,793,847,3244
72,Iraq,2017,IRQ-17/3884/ST/NFIs/INGO/5505,6/10/2018 12:22:48 PM,Other,436,515,513,518,1982,378,488,445,379,1690
72,Iraq,2017,IRQ-17/3884/ST/NFIs/INGO/5505,6/10/2018 12:22:48 PM,Overall,1452,1715,1707,1726,6600,1185,1285,1238,1226,4934
72,Iraq,2017,IRQ-17/3884/ST/NFIs/INGO/5582,11/15/2018 7:53:34 AM,Internally Displaced People,2730,2835,2415,2520,10500,3448,3536,3706,3957,14647
72,Iraq,2017,IRQ-17/3884/ST/NFIs/INGO/5582,11/15/2018 7:53:34 AM,Overall,2730,2835,2415,2520,10500,3448,3536,3706,3957,14647
72,Iraq,2017,IRQ-17/3884/ST/NFIs/INGO/5645,9/26/2018 12:07:57 PM,Host Communities,520,520,480,480,2000,2000,2133,2554,2293,8980
72,Iraq,2017,IRQ-17/3884/ST/NFIs/INGO/5645,9/26/2018 12:07:57 PM,Internally Displaced People,520,520,480,480,2000,0,0,0,0,0
72,Iraq,2017,IRQ-17/3884/ST/NFIs/INGO/5645,9/26/2018 12:07:57 PM,Other,520,520,480,480,2000,0,0,0,0,0
72,Iraq,2017,IRQ-17/3884/ST/NFIs/INGO/5645,9/26/2018 12:07:57 PM,Overall,1560,1560,1440,1440,6000,2000,2133,2554,2293,8980
72,Iraq,2017,IRQ-17/3884/ST/NFIs/INGO/5721,5/10/2018 3:02:42 PM,Internally Displaced People,2401,2974,3293,3220,11888,2002,2931,3688,3629,12250
72,Iraq,2017,IRQ-17/3884/ST/NFIs/INGO/5721,5/10/2018 3:02:42 PM,Overall,2401,2974,3293,3220,11888,2002,2931,3688,3629,12250
72,Iraq,2017,IRQ-17/3884/ST/NFIs/NGO/5723,11/18/2018 8:28:51 PM,Host Communities,621,666,541,586,2414,1890,1873,1676,1580,7019
72,Iraq,2017,IRQ-17/3884/ST/NFIs/NGO/5723,11/18/2018 8:28:51 PM,Internally Displaced People,933,1000,813,880,3626,521,514,460,433,1928
72,Iraq,2017,IRQ-17/3884/ST/NFIs/NGO/5723,11/18/2018 8:28:51 PM,Overall,1554,1666,1354,1466,6040,2421,2387,2136,2013,8957
72,Iraq,2017,IRQ-17/3884/ST/NFIs/O/5683,5/29/2018 1:03:48 PM,Internally Displaced People,3056,2938,2452,2354,10800,3024,2916,2484,2376,10800
72,Iraq,2017,IRQ-17/3884/ST/NFIs/O/5683,5/29/2018 1:03:48 PM,Overall,3056,2938,2452,2354,10800,3024,2916,2484,2376,10800
72,Iraq,2017,IRQ-17/3884/ST/NFIs/UN/5717,7/15/2019 12:39:03 PM,Host Communities,1900,2400,1150,1150,6600,3146,3777,3699,4231,14853
72,Iraq,2017,IRQ-17/3884/ST/NFIs/UN/5717,7/15/2019 12:39:03 PM,Internally Displaced People,6900,7500,6000,6000,26400,5306,6630,6970,6687,25593
72,Iraq,2017,IRQ-17/3884/ST/NFIs/UN/5717,7/15/2019 12:39:03 PM,Overall,8800,9900,7150,7150,33000,8452,10407,10669,10918,40446
72,Iraq,2017,IRQ-17/3884/ST/NFIs/UN/5760,11/18/2018 8:37:30 PM,Overall,1980,2160,1440,1620,7200,2448,2590,1656,2116,8810
72,Iraq,2017,IRQ-17/3884/ST/P/INGO/5377,9/25/2018 1:04:04 PM,Host Communities,2000,2000,3000,3000,10000,2227,2041,3320,3089,10677
72,Iraq,2017,IRQ-17/3884/ST/P/INGO/5377,9/25/2018 1:04:04 PM,Internally Displaced People,4000,4000,6000,6000,20000,4458,4071,6648,6186,21363
72,Iraq,2017,IRQ-17/3884/ST/P/INGO/5377,9/25/2018 1:04:04 PM,Overall,6000,6000,9000,9000,30000,6685,6112,9968,9275,32040
72,Iraq,2017,IRQ-17/3884/ST/P/INGO/5466,11/11/2018 5:17:36 AM,Host Communities,1432,1954,980,980,5346,4240,4240,4240,4240,16960
72,Iraq,2017,IRQ-17/3884/ST/P/INGO/5466,11/11/2018 5:17:36 AM,Internally Displaced People,5728,7816,3920,3920,21384,16963,16963,16963,16963,67852
72,Iraq,2017,IRQ-17/3884/ST/P/INGO/5466,11/11/2018 5:17:36 AM,Overall,7160,9770,4900,4900,26730,8573,8108,2387,2135,21203
72,Iraq,2017,IRQ-17/3884/ST/P/INGO/5470,11/15/2018 7:10:18 AM,Host Communities,386,386,242,242,1256,310,171,324,388,1193
72,Iraq,2017,IRQ-17/3884/ST/P/INGO/5470,11/15/2018 7:10:18 AM,Internally Displaced People,901,901,565,565,2932,592,507,477,452,2028
72,Iraq,2017,IRQ-17/3884/ST/P/INGO/5470,11/15/2018 7:10:18 AM,Other,1287,1287,808,808,4190,2295,2924,3392,3996,12607
72,Iraq,2017,IRQ-17/3884/ST/P/INGO/5470,11/15/2018 7:10:18 AM,Overall,2574,2574,1615,1615,8378,3197,3602,4193,4836,15828
72,Iraq,2017,IRQ-17/3884/ST/P/INGO/5573,9/26/2018 9:41:51 AM,Internally Displaced People,4195,4017,8856,8984,26052,6078,7298,15704,14516,43596
72,Iraq,2017,IRQ-17/3884/ST/P/INGO/5573,9/26/2018 9:41:51 AM,Other,740,708,1564,1586,4598,2783,2904,5779,6087,17553
72,Iraq,2017,IRQ-17/3884/ST/P/INGO/5573,9/26/2018 9:41:51 AM,Overall,4935,4725,10420,10570,30650,8861,10202,21483,20603,61149
72,Iraq,2017,IRQ-17/3884/ST/P/INGO/5654,5/17/2018 6:21:43 AM,Host Communities,429,429,600,600,2058,637,877,1006,1085,3605
72,Iraq,2017,IRQ-17/3884/ST/P/INGO/5654,5/17/2018 6:21:43 AM,Internally Displaced People,644,642,900,900,3086,194,313,628,551,1686
72,Iraq,2017,IRQ-17/3884/ST/P/INGO/5654,5/17/2018 6:21:43 AM,Overall,1073,1071,1500,1500,5144,831,1190,1634,1636,5291
72,Iraq,2017,IRQ-17/3884/ST/P/INGO/5656,11/6/2018 7:36:20 AM,Host Communities,92,79,406,310,887,68,82,404,389,943
72,Iraq,2017,IRQ-17/3884/ST/P/INGO/5656,11/6/2018 7:36:20 AM,Internally Displaced People,93,79,407,311,890,167,173,386,71,797
72,Iraq,2017,IRQ-17/3884/ST/P/INGO/5656,11/6/2018 7:36:20 AM,Other,92,79,406,310,887,71,46,421,589,1127
72,Iraq,2017,IRQ-17/3884/ST/P/INGO/5656,11/6/2018 7:36:20 AM,Overall,277,237,1219,931,2664,306,301,1211,1049,2867
72,Iraq,2017,IRQ-17/3884/ST/P/INGO/5736,5/27/2018 1:22:03 PM,Host Communities,3,7,4,12,26,10,11,3,7,31
72,Iraq,2017,IRQ-17/3884/ST/P/INGO/5736,5/27/2018 1:22:03 PM,Internally Displaced People,2365,2934,3140,2844,11283,6203,6854,2119,1850,17026
72,Iraq,2017,IRQ-17/3884/ST/P/INGO/5736,5/27/2018 1:22:03 PM,Other,22,26,20,31,99,53,55,16,20,144
72,Iraq,2017,IRQ-17/3884/ST/P/INGO/5736,5/27/2018 1:22:03 PM,Overall,2390,2967,3164,2887,11408,6266,6920,2138,1877,17201
72,Iraq,2017,IRQ-17/3884/ST/P/INGO/5752,11/9/2018 6:19:29 AM,Internally Displaced People,1115,1110,1624,1512,5361,0,0,0,0,0
72,Iraq,2017,IRQ-17/3884/ST/P/INGO/5752,11/9/2018 6:19:29 AM,Other,279,278,406,378,1341,0,0,0,0,0
72,Iraq,2017,IRQ-17/3884/ST/P/INGO/5752,11/9/2018 6:19:29 AM,Overall,1394,1388,2030,1890,6702,1174,1132,5485,4258,12049
72,Iraq,2017,IRQ-17/3884/ST/P/INGO/5753,5/8/2018 2:59:09 PM,Internally Displaced People,3015,3015,2655,2655,11340,5584,5706,2056,2144,15490
72,Iraq,2017,IRQ-17/3884/ST/P/INGO/5753,5/8/2018 2:59:09 PM,Overall,3015,3015,2655,2655,11340,5584,5706,2056,2144,15490
72,Iraq,2017,IRQ-17/3884/ST/P/INGO/5755,1/9/2019 2:23:27 PM,Overall,1160,1160,4280,4280,10880,12717,13309,19429,20483,65938
72,Iraq,2017,IRQ-17/3884/ST/P/NGO/5673,11/5/2018 11:24:09 AM,Internally Displaced People,150,541,0,225,916,172,3825,0,2333,6330
72,Iraq,2017,IRQ-17/3884/ST/P/NGO/5673,11/5/2018 11:24:09 AM,Overall,150,541,0,225,916,172,3825,0,2333,6330
72,Iraq,2017,IRQ-17/3884/ST/P/UN/5535,11/7/2018 8:50:31 AM,Host Communities,1752,9795,1740,3438,16725,2192,8066,2612,5460,18330
72,Iraq,2017,IRQ-17/3884/ST/P/UN/5535,11/7/2018 8:50:31 AM,Internally Displaced People,4088,22855,4060,8022,39025,5117,18822,6097,12743,42779
72,Iraq,2017,IRQ-17/3884/ST/P/UN/5535,11/7/2018 8:50:31 AM,Overall,5840,32650,5800,11460,55750,7309,26888,8709,18203,61109
72,Iraq,2017,IRQ-17/3884/ST/P/UN/5770,8/1/2019 12:23:18 PM,Internally Displaced People,1500,2000,1000,1500,6000,1611,1527,1649,1879,6666
72,Iraq,2017,IRQ-17/3884/ST/P/UN/5770,8/1/2019 12:23:18 PM,Overall,1500,2000,1000,1500,6000,1611,1527,1649,1879,6666
72,Iraq,2017,IRQ-17/3884/ST/P-E/INGO/5546,5/11/2018 10:41:34 AM,Internally Displaced People,6000,6000,3750,3750,19500,7143,6480,5083,4482,23188
72,Iraq,2017,IRQ-17/3884/ST/P-E/INGO/5546,5/11/2018 10:41:34 AM,Overall,6000,6000,3750,3750,19500,7143,6480,5083,4482,23188
72,Iraq,2017,IRQ-17/3884/ST/RRM/UN/5767,6/10/2018 9:29:35 AM,Internally Displaced People,25970,27030,23030,23970,100000,23048,24160,26059,26733,100000
72,Iraq,2017,IRQ-17/3884/ST/RRM/UN/5767,6/10/2018 9:29:35 AM,Overall,25970,27030,23030,23970,100000,23048,24160,26059,26733,100000
72,Iraq,2017,IRQ-17/3884/ST/WASH/INGO/5364,5/15/2018 3:23:35 PM,Host Communities,2597,2703,2303,2397,10000,18910,19682,16769,17454,72815
72,Iraq,2017,IRQ-17/3884/ST/WASH/INGO/5364,5/15/2018 3:23:35 PM,Internally Displaced People,10388,10812,9212,9588,40000,18514,19694,17396,17909,73513
72,Iraq,2017,IRQ-17/3884/ST/WASH/INGO/5364,5/15/2018 3:23:35 PM,Overall,12985,13515,11515,11985,50000,37424,39376,34165,35363,146328
72,Iraq,2017,IRQ-17/3884/ST/WASH/INGO/5456,5/20/2018 2:29:47 PM,Other,0,0,1802,1598,3400,0,0,3095,4155,7250
72,Iraq,2017,IRQ-17/3884/ST/WASH/INGO/5456,5/20/2018 2:29:47 PM,Overall,0,0,1802,1598,3400,0,0,3095,4155,7250
72,Iraq,2017,IRQ-17/3884/ST/WASH/INGO/5486,10/16/2019 7:40:37 AM,Host Communities,4606,4607,3924,3925,17062,11992,11992,11991,11992,47967
72,Iraq,2017,IRQ-17/3884/ST/WASH/INGO/5486,10/16/2019 7:40:37 AM,Internally Displaced People,10494,10566,8784,8844,38688,12790,12906,10973,11181,47850
72,Iraq,2017,IRQ-17/3884/ST/WASH/INGO/5486,10/16/2019 7:40:37 AM,Overall,15100,15173,12708,12769,55750,24782,24898,22964,23173,95817
72,Iraq,2017,IRQ-17/3884/ST/WASH/INGO/5491,5/30/2018 9:44:26 AM,Internally Displaced People,20986,22736,8162,8842,60726,13233,15124,4915,4537,37809
72,Iraq,2017,IRQ-17/3884/ST/WASH/INGO/5491,5/30/2018 9:44:26 AM,Overall,20986,22736,8162,8842,60726,13233,15124,4915,4537,37809
72,Iraq,2017,IRQ-17/3884/ST/WASH/INGO/5509,5/9/2018 6:26:35 AM,Other,8884,8480,10903,12114,40381,20498,19566,25157,27951,93172
72,Iraq,2017,IRQ-17/3884/ST/WASH/INGO/5509,5/9/2018 6:26:35 AM,Overall,8884,8480,10903,12114,40381,11100,10595,13623,15136,50454
72,Iraq,2017,IRQ-17/3884/ST/WASH/INGO/5538,11/18/2018 6:31:31 AM,Host Communities,2200,2100,3000,2700,10000,0,0,0,0,0
72,Iraq,2017,IRQ-17/3884/ST/WASH/INGO/5538,11/18/2018 6:31:31 AM,Internally Displaced People,1320,1260,1800,1620,6000,0,0,0,0,0
72,Iraq,2017,IRQ-17/3884/ST/WASH/INGO/5538,11/18/2018 6:31:31 AM,Other,880,840,1200,1080,4000,0,0,0,0,0
72,Iraq,2017,IRQ-17/3884/ST/WASH/INGO/5538,11/18/2018 6:31:31 AM,Overall,4400,4200,6000,5400,20000,19810,18910,26744,24583,90047
72,Iraq,2017,IRQ-17/3884/ST/WASH/INGO/5558,9/27/2018 12:49:44 PM,Internally Displaced People,6000,8500,7000,8500,30000,6720,10080,10080,15120,42000
72,Iraq,2017,IRQ-17/3884/ST/WASH/INGO/5558,9/27/2018 12:49:44 PM,Overall,6000,8500,7000,8500,30000,6720,10080,10080,15120,42000
72,Iraq,2017,IRQ-17/3884/ST/WASH/INGO/5626,11/11/2018 7:19:53 AM,Internally Displaced People,1365,1733,2227,2175,7500,4076,5346,6824,6592,22838
72,Iraq,2017,IRQ-17/3884/ST/WASH/INGO/5626,11/11/2018 7:19:53 AM,Overall,1365,1733,2227,2175,7500,4076,5346,6824,6592,22838
72,Iraq,2017,IRQ-17/3884/ST/WASH/INGO/5628,5/31/2018 7:30:58 AM,Internally Displaced People,2626,2727,2424,2323,10100,1750,2181,3071,3092,10094
72,Iraq,2017,IRQ-17/3884/ST/WASH/INGO/5628,5/31/2018 7:30:58 AM,Overall,2626,2727,2424,2323,10100,1750,2181,3071,3092,10094
72,Iraq,2017,IRQ-17/3884/ST/WASH/INGO/5650,2/3/2019 10:09:10 AM,Internally Displaced People,1370,1508,2754,2868,8500,4148,4700,5250,5962,20060
72,Iraq,2017,IRQ-17/3884/ST/WASH/INGO/5650,2/3/2019 10:09:10 AM,Overall,1370,1508,2754,2868,8500,2074,2350,2625,2981,10030
72,Iraq,2017,IRQ-17/3884/ST/WASH/INGO/5678,11/8/2018 1:08:44 PM,Host Communities,1250,1250,1585,1585,5670,3320,2793,5644,3937,15694
72,Iraq,2017,IRQ-17/3884/ST/WASH/INGO/5678,11/8/2018 1:08:44 PM,Internally Displaced People,1250,1250,1580,1580,5660,10,10,10,10,40
72,Iraq,2017,IRQ-17/3884/ST/WASH/INGO/5678,11/8/2018 1:08:44 PM,Other,1250,1250,1585,1585,5670,212,212,213,213,850
72,Iraq,2017,IRQ-17/3884/ST/WASH/INGO/5678,11/8/2018 1:08:44 PM,Overall,3750,3750,4750,4750,17000,3542,3015,5867,4160,16584
72,Iraq,2017,IRQ-17/3884/ST/WASH/INGO/5706,5/29/2018 6:43:03 AM,Host Communities,305,368,158,221,1052,383,446,191,225,1245
72,Iraq,2017,IRQ-17/3884/ST/WASH/INGO/5706,5/29/2018 6:43:03 AM,Internally Displaced People,913,1102,472,661,3148,1147,1339,574,765,3825
72,Iraq,2017,IRQ-17/3884/ST/WASH/INGO/5706,5/29/2018 6:43:03 AM,Overall,1218,1470,630,882,4200,1530,1785,765,1020,5100
72,Iraq,2017,IRQ-17/3884/ST/WASH/INGO/5739,5/27/2018 6:04:43 AM,Internally Displaced People,4802,4998,7203,7497,24500,4802,4998,7203,7497,24500
72,Iraq,2017,IRQ-17/3884/ST/WASH/INGO/5739,5/27/2018 6:04:43 AM,Overall,4802,4998,7203,7497,24500,4802,4998,7203,7497,24500
72,Iraq,2017,IRQ-17/3884/ST/WASH/NGO/5504,5/10/2018 2:00:51 PM,Internally Displaced People,7920,7200,10180,10700,36000,7920,7200,10180,10700,36000
72,Iraq,2017,IRQ-17/3884/ST/WASH/NGO/5504,5/10/2018 2:00:51 PM,Overall,7920,7200,10180,10700,36000,7920,7200,10180,10700,36000
72,Iraq,2017,IRQ-17/3884/ST/WASH/UN/5724,1/29/2019 2:34:04 PM,Host Communities,14000,16000,14000,16000,60000,0,0,0,0,0
72,Iraq,2017,IRQ-17/3884/ST/WASH/UN/5724,1/29/2019 2:34:04 PM,Internally Displaced People,0,1750,0,1750,3500,20575,20875,20648,20724,82822
72,Iraq,2017,IRQ-17/3884/ST/WASH/UN/5724,1/29/2019 2:34:04 PM,Other,350,100,25,25,500,0,0,0,0,0
72,Iraq,2017,IRQ-17/3884/ST/WASH/UN/5724,1/29/2019 2:34:04 PM,Overall,14350,17850,14025,17775,64000,20575,20875,20648,20724,82822
72,Iraq,2017,IRQ-17/3884/ST/WASH/UN/5751,5/31/2018 6:17:37 AM,Internally Displaced People,52939,64879,55729,66453,240000,111291,122160,72907,81642,388000
72,Iraq,2017,IRQ-17/3884/ST/WASH/UN/5751,5/31/2018 6:17:37 AM,Overall,52939,64879,55729,66453,240000,111291,122160,72907,81642,388000
72,Iraq,2018,IRQ-18/3884/RA1/H/UN/10494,9/9/2021 12:48:08 PM,Internally Displaced People,0,0,94001,90313,184314,0,0,1196182,1225239,2421421
72,Iraq,2018,IRQ-18/3884/RA1/H/UN/10494,9/9/2021 12:48:08 PM,Overall,0,0,1322360,1270502,2592862,0,0,1196182,1225239,2421421
72,Iraq,2018,IRQ-18/3884/RA1/H/UN/10499,10/10/2019 11:28:42 AM,Host Communities,1474029,2408547,1228359,1180189,6291124,1186733,1235171,1186733,1235171,4843808
72,Iraq,2018,IRQ-18/3884/RA1/H/UN/10499,10/10/2019 11:28:42 AM,Internally Displaced People,112802,184315,94001,90313,481431,0,0,0,0,0
72,Iraq,2018,IRQ-18/3884/RA1/H/UN/10499,10/10/2019 11:28:42 AM,Overall,1586831,2592862,1322360,1270502,6772555,1186733,1235171,1186733,1235171,4843808
72,Iraq,2018,IRQ-18/3884/SA1/CASH/INGO/8308,11/12/2018 8:05:33 AM,Host Communities,194,173,187,166,720,0,0,0,0,0
72,Iraq,2018,IRQ-18/3884/SA1/CASH/INGO/8308,11/12/2018 8:05:33 AM,Other,778,691,749,662,2880,0,0,0,0,0
72,Iraq,2018,IRQ-18/3884/SA1/CASH/INGO/8308,11/12/2018 8:05:33 AM,Overall,972,864,936,828,3600,988,878,952,842,3660
72,Iraq,2018,IRQ-18/3884/SA1/CASH/INGO/8397,2/18/2019 10:37:01 AM,Host Communities,1702,1635,1450,1393,6180,1182,1437,1149,1201,4969
72,Iraq,2018,IRQ-18/3884/SA1/CASH/INGO/8397,2/18/2019 10:37:01 AM,Internally Displaced People,562,540,478,460,2040,423,473,385,342,1623
72,Iraq,2018,IRQ-18/3884/SA1/CASH/INGO/8397,2/18/2019 10:37:01 AM,Overall,2264,2175,1928,1853,8220,1605,1910,1534,1543,6592
72,Iraq,2018,IRQ-18/3884/SA1/CASH/INGO/8513,7/19/2019 9:39:02 PM,Internally Displaced People,48,79,95,95,317,288,282,222,241,1033
72,Iraq,2018,IRQ-18/3884/SA1/CASH/INGO/8513,7/19/2019 9:39:02 PM,Other,906,1509,1813,1813,6041,3264,3614,2996,2995,12869
72,Iraq,2018,IRQ-18/3884/SA1/CASH/INGO/8513,7/19/2019 9:39:02 PM,Overall,954,1588,1908,1908,6358,3552,3896,3218,3236,13902
72,Iraq,2018,IRQ-18/3884/SA1/CASH/NGO/8235,7/17/2019 11:57:00 AM,Other,220,265,325,390,1200,0,0,0,0,0
72,Iraq,2018,IRQ-18/3884/SA1/CASH/NGO/8235,7/17/2019 11:57:00 AM,Overall,220,265,325,390,1200,0,0,0,0,0
72,Iraq,2018,IRQ-18/3884/SA1/CCCM/INGO/8011,6/24/2019 7:15:45 AM,Internally Displaced People,950,950,2050,2050,6000,286,333,493,387,1499
72,Iraq,2018,IRQ-18/3884/SA1/CCCM/INGO/8011,6/24/2019 7:15:45 AM,Overall,950,950,2050,2050,6000,286,333,493,387,1499
72,Iraq,2018,IRQ-18/3884/SA1/CCCM/INGO/8442,7/19/2019 9:17:11 PM,Internally Displaced People,3225,3099,6450,6198,18972,0,0,0,0,0
72,Iraq,2018,IRQ-18/3884/SA1/CCCM/INGO/8442,7/19/2019 9:17:11 PM,Other,10851,10425,21702,20850,63828,0,0,0,0,0
72,Iraq,2018,IRQ-18/3884/SA1/CCCM/INGO/8442,7/19/2019 9:17:11 PM,Overall,14076,13524,28152,27048,82800,15824,15203,31648,30407,93082
72,Iraq,2018,IRQ-18/3884/SA1/CCCM/UN/8429,1/9/2019 12:44:20 PM,Internally Displaced People,818,856,839,1061,3574,7925,7554,8439,7992,31910
72,Iraq,2018,IRQ-18/3884/SA1/CCCM/UN/8429,1/9/2019 12:44:20 PM,Other,12,0,0,0,12,0,0,0,0,0
72,Iraq,2018,IRQ-18/3884/SA1/CCCM/UN/8429,1/9/2019 12:44:20 PM,Overall,830,856,839,1061,3586,7925,7554,8439,7992,31910
72,Iraq,2018,IRQ-18/3884/SA1/CCS/INGO/8543,7/4/2019 1:42:51 PM,Other,125000,125000,125000,125000,500000,125000,125000,125000,125000,500000
72,Iraq,2018,IRQ-18/3884/SA1/CCS/INGO/8543,7/4/2019 1:42:51 PM,Overall,125000,125000,125000,125000,500000,125000,125000,125000,125000,500000
72,Iraq,2018,IRQ-18/3884/SA1/CCS/UN/8277,3/10/2021 2:45:27 PM,Host Communities,1990,836,43,15,2884,2011,777,22,7,2817
72,Iraq,2018,IRQ-18/3884/SA1/CCS/UN/8277,3/10/2021 2:45:27 PM,Internally Displaced People,37018,13749,1586,529,52882,81798,31617,904,301,114620
72,Iraq,2018,IRQ-18/3884/SA1/CCS/UN/8277,3/10/2021 2:45:27 PM,Other,1990,836,43,15,2884,0,0,0,0,0
72,Iraq,2018,IRQ-18/3884/SA1/CCS/UN/8277,3/10/2021 2:45:27 PM,Overall,66497,26670,2234,747,96148,83809,32394,926,308,117437
72,Iraq,2018,IRQ-18/3884/SA1/CCS/UN/8277,3/10/2021 2:45:27 PM,Returnees,25499,11249,562,188,37498,0,0,0,0,0
72,Iraq,2018,IRQ-18/3884/SA1/CCS-CCCM/INGO/8413,10/31/2019 8:23:24 AM,Internally Displaced People,200,200,0,0,400,1378,1378,0,0,2756
72,Iraq,2018,IRQ-18/3884/SA1/CCS-CCCM/INGO/8413,10/31/2019 8:23:24 AM,Overall,200,200,0,0,400,1378,1378,0,0,2756
72,Iraq,2018,IRQ-18/3884/SA1/E/INGO/8183,3/6/2019 7:57:02 AM,Host Communities,37,47,786,754,1624,46,48,786,754,1634
72,Iraq,2018,IRQ-18/3884/SA1/E/INGO/8183,3/6/2019 7:57:02 AM,Internally Displaced People,88,53,5312,5429,10882,74,51,2997,2756,5878
72,Iraq,2018,IRQ-18/3884/SA1/E/INGO/8183,3/6/2019 7:57:02 AM,Overall,125,100,6098,6183,12506,314,289,5694,5766,12063
72,Iraq,2018,IRQ-18/3884/SA1/E/INGO/8431,2/20/2019 12:53:44 PM,Internally Displaced People,1671,1673,3125,3125,9594,1150,1146,9254,6132,17682
72,Iraq,2018,IRQ-18/3884/SA1/E/INGO/8431,2/20/2019 12:53:44 PM,Overall,1671,1673,3125,3125,9594,1150,1146,9254,6132,17682
72,Iraq,2018,IRQ-18/3884/SA1/E/INGO/8500,7/16/2019 12:31:18 PM,Host Communities,50,30,500,500,1080,0,0,0,0,0
72,Iraq,2018,IRQ-18/3884/SA1/E/INGO/8500,7/16/2019 12:31:18 PM,Other,40,30,2000,2000,4070,10,20,2412,2533,4975
72,Iraq,2018,IRQ-18/3884/SA1/E/INGO/8500,7/16/2019 12:31:18 PM,Overall,90,60,2500,2500,5150,113,87,2432,2592,5224
72,Iraq,2018,IRQ-18/3884/SA1/E/INGO/8516,4/28/2019 1:15:17 PM,Other,127,43,1700,1700,3570,0,0,0,0,0
72,Iraq,2018,IRQ-18/3884/SA1/E/INGO/8516,4/28/2019 1:15:17 PM,Overall,127,43,1700,1700,3570,47,47,1602,1602,3298
72,Iraq,2018,IRQ-18/3884/SA1/E/NGO/8098,2/24/2019 1:23:58 PM,Other,100,60,1539,1272,2971,105,40,1580,1370,3095
72,Iraq,2018,IRQ-18/3884/SA1/E/NGO/8098,2/24/2019 1:23:58 PM,Overall,100,60,1539,1272,2971,105,40,1849,1101,3095
72,Iraq,2018,IRQ-18/3884/SA1/E/NGO/8486,1/28/2019 7:18:41 AM,Host Communities,600,220,150,150,1120,647,439,1034,635,2755
72,Iraq,2018,IRQ-18/3884/SA1/E/NGO/8486,1/28/2019 7:18:41 AM,Internally Displaced People,600,400,250,250,1500,254,152,323,195,924
72,Iraq,2018,IRQ-18/3884/SA1/E/NGO/8486,1/28/2019 7:18:41 AM,Other,550,300,200,200,1250,278,195,432,262,1167
72,Iraq,2018,IRQ-18/3884/SA1/E/NGO/8486,1/28/2019 7:18:41 AM,Overall,1750,920,600,600,3870,1179,786,1789,1092,4846
72,Iraq,2018,IRQ-18/3884/SA1/EL/INGO/8200,6/24/2019 7:39:40 AM,Other,162,104,0,0,266,168,108,0,0,276
72,Iraq,2018,IRQ-18/3884/SA1/EL/INGO/8200,6/24/2019 7:39:40 AM,Overall,162,104,0,0,266,168,108,0,0,276
72,Iraq,2018,IRQ-18/3884/SA1/EL/INGO/8554,6/24/2019 7:27:43 AM,Other,151,100,0,0,251,0,0,0,0,0
72,Iraq,2018,IRQ-18/3884/SA1/EL/INGO/8554,6/24/2019 7:27:43 AM,Overall,151,100,0,0,251,205,57,0,0,262
72,Iraq,2018,IRQ-18/3884/SA1/EL/NGO/8447,10/10/2019 12:47:21 PM,Other,175,165,160,160,660,0,0,3235,2840,6075
72,Iraq,2018,IRQ-18/3884/SA1/EL/NGO/8447,10/10/2019 12:47:21 PM,Overall,175,165,160,160,660,237,191,208,281,917
72,Iraq,2018,IRQ-18/3884/SA1/F/INGO/8430,7/19/2019 11:27:03 PM,Internally Displaced People,0,0,0,0,0,1309,1582,1028,983,4902
72,Iraq,2018,IRQ-18/3884/SA1/F/INGO/8430,7/19/2019 11:27:03 PM,Other,970,1450,965,1445,4830,0,0,0,0,0
72,Iraq,2018,IRQ-18/3884/SA1/F/INGO/8430,7/19/2019 11:27:03 PM,Overall,970,1450,965,1445,4830,1309,1582,1028,983,4902
72,Iraq,2018,IRQ-18/3884/SA1/F/INGO/8466,5/1/2019 12:20:28 PM,Host Communities,921,914,916,849,3600,1232,1194,515,571,3512
72,Iraq,2018,IRQ-18/3884/SA1/F/INGO/8466,5/1/2019 12:20:28 PM,Other,3683,3665,3660,3392,14400,4928,4776,2061,2283,14048
72,Iraq,2018,IRQ-18/3884/SA1/F/INGO/8466,5/1/2019 12:20:28 PM,Overall,4604,4579,4576,4241,18000,6160,5970,2576,2854,17560
72,Iraq,2018,IRQ-18/3884/SA1/F-EL/INGO/8582,7/29/2019 2:39:56 PM,Host Communities,560,450,510,610,2130,0,0,0,0,0
72,Iraq,2018,IRQ-18/3884/SA1/F-EL/INGO/8582,7/29/2019 2:39:56 PM,Internally Displaced People,870,850,820,870,3410,0,0,0,0,0
72,Iraq,2018,IRQ-18/3884/SA1/F-EL/INGO/8582,7/29/2019 2:39:56 PM,Other,1600,1750,1570,1540,6460,0,0,0,0,0
72,Iraq,2018,IRQ-18/3884/SA1/F-EL/INGO/8582,7/29/2019 2:39:56 PM,Overall,3030,3050,2900,3020,12000,6390,6390,6389,6389,25558
72,Iraq,2018,IRQ-18/3884/SA1/H/INGO/7986,3/27/2019 8:24:08 AM,Host Communities,634,1269,223,223,2349,923,1717,741,717,4098
72,Iraq,2018,IRQ-18/3884/SA1/H/INGO/7986,3/27/2019 8:24:08 AM,Internally Displaced People,423,846,149,149,1567,616,1145,494,478,2733
72,Iraq,2018,IRQ-18/3884/SA1/H/INGO/7986,3/27/2019 8:24:08 AM,Other,1057,2115,372,372,3916,1540,2863,1234,1196,6833
72,Iraq,2018,IRQ-18/3884/SA1/H/INGO/7986,3/27/2019 8:24:08 AM,Overall,2114,4230,744,744,7832,3079,5724,2469,2392,13664
72,Iraq,2018,IRQ-18/3884/SA1/H/INGO/8180,5/15/2019 12:25:41 PM,Host Communities,1403,1647,1525,1525,6100,751,944,733,689,3117
72,Iraq,2018,IRQ-18/3884/SA1/H/INGO/8180,5/15/2019 12:25:41 PM,Internally Displaced People,2806,3294,3050,3050,12200,214,208,194,189,805
72,Iraq,2018,IRQ-18/3884/SA1/H/INGO/8180,5/15/2019 12:25:41 PM,Other,1403,1647,1525,1525,6100,6354,7039,5975,5723,25091
72,Iraq,2018,IRQ-18/3884/SA1/H/INGO/8180,5/15/2019 12:25:41 PM,Overall,5612,6588,6100,6100,24400,5620,8098,1123,1618,16459
72,Iraq,2018,IRQ-18/3884/SA1/H/INGO/8251,1/30/2019 10:49:42 AM,Internally Displaced People,582,683,422,422,2109,4399,5001,1289,1155,11844
72,Iraq,2018,IRQ-18/3884/SA1/H/INGO/8251,1/30/2019 10:49:42 AM,Other,627,736,454,454,2271,3966,4915,1444,1408,11733
72,Iraq,2018,IRQ-18/3884/SA1/H/INGO/8251,1/30/2019 10:49:42 AM,Overall,1209,1419,876,876,4380,8365,9916,2733,2563,23577
72,Iraq,2018,IRQ-18/3884/SA1/H/INGO/8421,11/19/2018 6:10:33 AM,Internally Displaced People,2621,4247,2747,2500,12115,3575,5774,3730,3394,16473
72,Iraq,2018,IRQ-18/3884/SA1/H/INGO/8421,11/19/2018 6:10:33 AM,Other,12,6,0,0,18,9,6,0,0,15
72,Iraq,2018,IRQ-18/3884/SA1/H/INGO/8421,11/19/2018 6:10:33 AM,Overall,2633,4253,2747,2500,12133,3584,5780,3730,3394,16488
72,Iraq,2018,IRQ-18/3884/SA1/H/INGO/8436,11/21/2018 12:20:08 PM,Other,1292,1428,1240,1160,5120,5242,5274,1357,1265,13138
72,Iraq,2018,IRQ-18/3884/SA1/H/INGO/8436,11/21/2018 12:20:08 PM,Overall,1712,3088,1240,1160,7200,3054,4057,1548,1298,9957
72,Iraq,2018,IRQ-18/3884/SA1/H/INGO/8532,2/26/2019 12:32:58 PM,Internally Displaced People,100,100,150,150,500,100,100,150,150,500
72,Iraq,2018,IRQ-18/3884/SA1/H/INGO/8532,2/26/2019 12:32:58 PM,Other,900,923,1820,1828,5471,900,923,1820,1828,5471
72,Iraq,2018,IRQ-18/3884/SA1/H/INGO/8532,2/26/2019 12:32:58 PM,Overall,1000,1023,1970,1978,5971,900,923,1820,1828,5471
72,Iraq,2018,IRQ-18/3884/SA1/H/INGO/8570,1/23/2019 6:44:20 AM,Internally Displaced People,200,5724,3612,3612,13148,4395,4395,8733,8732,26255
72,Iraq,2018,IRQ-18/3884/SA1/H/INGO/8570,1/23/2019 6:44:20 AM,Overall,200,5724,3612,3612,13148,199,4395,3313,3166,11073
72,Iraq,2018,IRQ-18/3884/SA1/H/NGO/8482,2/19/2019 12:56:57 PM,Internally Displaced People,1805,1786,1233,1176,6000,1691,1673,1156,1103,5623
72,Iraq,2018,IRQ-18/3884/SA1/H/NGO/8482,2/19/2019 12:56:57 PM,Overall,1805,1786,1233,1176,6000,1691,1673,1156,1103,5623
72,Iraq,2018,IRQ-18/3884/SA1/H/NGO/8508,1/16/2019 8:47:41 AM,Internally Displaced People,15615,15444,11640,9201,51900,15857,15683,11819,9343,52702
72,Iraq,2018,IRQ-18/3884/SA1/H/NGO/8508,1/16/2019 8:47:41 AM,Overall,15615,15444,11640,9201,51900,15856,15683,11820,9343,52702
72,Iraq,2018,IRQ-18/3884/SA1/H/NGO/8567,10/30/2018 10:44:23 AM,Other,0,1200,0,0,1200,0,2093,0,0,2093
72,Iraq,2018,IRQ-18/3884/SA1/H/NGO/8567,10/30/2018 10:44:23 AM,Overall,0,1200,0,0,1200,0,2093,0,0,2093
72,Iraq,2018,IRQ-18/3884/SA1/H/O/8213,5/2/2019 9:48:50 AM,Other,0,0,0,0,0,2900,4275,1850,2850,11875
72,Iraq,2018,IRQ-18/3884/SA1/H/O/8213,5/2/2019 9:48:50 AM,Overall,6000,10000,4000,6000,26000,2900,4275,1850,2850,11875
72,Iraq,2018,IRQ-18/3884/SA1/H/UN/8007,2/25/2019 12:54:41 PM,Host Communities,0,11400,342,2622,14364,0,0,0,0,0
72,Iraq,2018,IRQ-18/3884/SA1/H/UN/8007,2/25/2019 12:54:41 PM,Internally Displaced People,0,11400,342,2622,14364,0,29623,0,7566,37189
72,Iraq,2018,IRQ-18/3884/SA1/H/UN/8007,2/25/2019 12:54:41 PM,Overall,0,22800,684,5244,28728,0,0,0,0,0
72,Iraq,2018,IRQ-18/3884/SA1/H/UN/8419,3/12/2019 12:45:22 PM,Internally Displaced People,24145,22327,13612,14641,74725,11229,18176,10609,12183,52197
72,Iraq,2018,IRQ-18/3884/SA1/H/UN/8419,3/12/2019 12:45:22 PM,Other,440,406,248,266,1360,2808,4543,2416,2797,12564
72,Iraq,2018,IRQ-18/3884/SA1/H/UN/8419,3/12/2019 12:45:22 PM,Overall,24594,22733,13860,14908,76095,14037,22719,13025,14980,64761
72,Iraq,2018,IRQ-18/3884/SA1/H/UN/8553,1/7/2019 11:52:12 AM,Host Communities,18680,17933,19427,18680,74720,0,0,0,0,0
72,Iraq,2018,IRQ-18/3884/SA1/H/UN/8553,1/7/2019 11:52:12 AM,Internally Displaced People,74720,71731,77709,74720,298880,0,0,0,0,0
72,Iraq,2018,IRQ-18/3884/SA1/H/UN/8553,1/7/2019 11:52:12 AM,Other,93400,89664,97136,93400,373600,0,0,0,0,0
72,Iraq,2018,IRQ-18/3884/SA1/H/UN/8553,1/7/2019 11:52:12 AM,Overall,186800,179328,194272,186800,747200,188035,179504,194516,186085,748140
72,Iraq,2018,IRQ-18/3884/SA1/H/UN/8581,1/24/2019 2:16:45 PM,Other,0,700,0,0,700,84,7356,282203,271996,561639
72,Iraq,2018,IRQ-18/3884/SA1/H/UN/8581,1/24/2019 2:16:45 PM,Overall,0,20000,250000,250000,520000,84,7356,282203,254777,544420
72,Iraq,2018,IRQ-18/3884/SA1/H-P/INGO/8334,2/26/2019 10:49:32 AM,Internally Displaced People,62,1948,1288,1650,4948,33,1203,2226,2088,5550
72,Iraq,2018,IRQ-18/3884/SA1/H-P/INGO/8334,2/26/2019 10:49:32 AM,Overall,62,1948,1288,1650,4948,33,1203,2226,2088,5550
72,Iraq,2018,IRQ-18/3884/SA1/LOGs/UN/8468,4/6/2020 12:09:46 PM,Other,0,0,0,5,5,0,0,0,5,5
72,Iraq,2018,IRQ-18/3884/SA1/LOGs/UN/8468,4/6/2020 12:09:46 PM,Overall,0,0,0,5,5,0,0,0,5,5
72,Iraq,2018,IRQ-18/3884/SA1/NFIs/INGO/8268,5/15/2019 12:10:21 PM,Host Communities,384,405,353,370,1512,19,25,4,5,53
72,Iraq,2018,IRQ-18/3884/SA1/NFIs/INGO/8268,5/15/2019 12:10:21 PM,Internally Displaced People,51,53,51,53,208,0,0,0,0,0
72,Iraq,2018,IRQ-18/3884/SA1/NFIs/INGO/8268,5/15/2019 12:10:21 PM,Other,476,500,441,463,1880,1627,1731,552,579,4489
72,Iraq,2018,IRQ-18/3884/SA1/NFIs/INGO/8268,5/15/2019 12:10:21 PM,Overall,911,958,845,886,3600,1643,1759,556,584,4542
72,Iraq,2018,IRQ-18/3884/SA1/NFIs/INGO/8325,4/8/2019 9:46:19 AM,Other,580,1000,1580,1580,4740,1450,1450,2900,2900,8700
72,Iraq,2018,IRQ-18/3884/SA1/NFIs/INGO/8325,4/8/2019 9:46:19 AM,Overall,580,1000,1580,1580,4740,1450,1450,2900,2900,8700
72,Iraq,2018,IRQ-18/3884/SA1/NFIs/INGO/8364,7/18/2019 7:45:34 AM,Internally Displaced People,1500,3000,1500,3000,9000,1639,2110,2431,2646,8826
72,Iraq,2018,IRQ-18/3884/SA1/NFIs/INGO/8364,7/18/2019 7:45:34 AM,Overall,1500,3000,1500,3000,9000,1639,2110,2431,2646,8826
72,Iraq,2018,IRQ-18/3884/SA1/NFIs/INGO/8380,4/28/2019 1:13:38 PM,Other,1275,1275,1275,1275,5100,0,0,0,0,0
72,Iraq,2018,IRQ-18/3884/SA1/NFIs/INGO/8380,4/28/2019 1:13:38 PM,Overall,1275,1275,1275,1275,5100,0,0,0,0,0
72,Iraq,2018,IRQ-18/3884/SA1/NFIs/INGO/8437,4/28/2019 11:45:06 AM,Internally Displaced People,1294,1302,1148,1194,4938,1186,1194,1011,1293,4684
72,Iraq,2018,IRQ-18/3884/SA1/NFIs/INGO/8437,4/28/2019 11:45:06 AM,Overall,1294,1302,1148,1194,4938,1186,1194,1011,1293,4684
72,Iraq,2018,IRQ-18/3884/SA1/NFIs/O/8377,3/18/2019 6:33:01 AM,Internally Displaced People,8911,8735,8259,8095,34000,9051,8872,8389,8222,34534
72,Iraq,2018,IRQ-18/3884/SA1/NFIs/O/8377,3/18/2019 6:33:01 AM,Overall,8911,8735,8259,8095,34000,9051,8872,8389,8222,34534
72,Iraq,2018,IRQ-18/3884/SA1/NFIs/UN/8416,1/7/2019 9:59:32 AM,Overall,6699,8720,8934,8647,33000,8418,7915,8469,8391,33193
72,Iraq,2018,IRQ-18/3884/SA1/NFIs/UN/8576,7/30/2019 2:32:37 PM,Other,200,200,250,250,900,202,202,260,260,924
72,Iraq,2018,IRQ-18/3884/SA1/NFIs/UN/8576,7/30/2019 2:32:37 PM,Overall,200,200,250,250,900,202,202,260,260,924
72,Iraq,2018,IRQ-18/3884/SA1/NFIs-CCCM/INGO/8250,4/15/2019 12:07:50 PM,Host Communities,3957,4121,4121,4286,16485,0,0,0,0,0
72,Iraq,2018,IRQ-18/3884/SA1/NFIs-CCCM/INGO/8250,4/15/2019 12:07:50 PM,Internally Displaced People,35607,37091,37091,38574,148363,83375,93761,81746,81902,340784
72,Iraq,2018,IRQ-18/3884/SA1/NFIs-CCCM/INGO/8250,4/15/2019 12:07:50 PM,Overall,39564,41212,41212,42860,164848,83375,93761,81746,81902,340784
72,Iraq,2018,IRQ-18/3884/SA1/P/INGO/7992,7/15/2019 10:10:44 AM,Internally Displaced People,2410,2410,3925,3925,12670,4177,4155,7426,7609,23367
72,Iraq,2018,IRQ-18/3884/SA1/P/INGO/7992,7/15/2019 10:10:44 AM,Overall,2410,2410,3925,3925,12670,4177,4155,7426,7609,23367
72,Iraq,2018,IRQ-18/3884/SA1/P/INGO/8281,2/19/2019 4:02:52 PM,Host Communities,337,435,297,347,1416,15,15,20,15,65
72,Iraq,2018,IRQ-18/3884/SA1/P/INGO/8281,2/19/2019 4:02:52 PM,Internally Displaced People,880,1015,692,809,3396,2746,2716,2541,2400,10403
72,Iraq,2018,IRQ-18/3884/SA1/P/INGO/8281,2/19/2019 4:02:52 PM,Overall,1257,1450,989,1156,4852,2761,2731,2561,2415,10468
72,Iraq,2018,IRQ-18/3884/SA1/P/INGO/8358,5/15/2019 11:17:20 AM,Host Communities,393,590,492,492,1967,2519,2378,1650,1608,8155
72,Iraq,2018,IRQ-18/3884/SA1/P/INGO/8358,5/15/2019 11:17:20 AM,Internally Displaced People,1574,2361,1967,1967,7869,1241,1172,812,792,4017
72,Iraq,2018,IRQ-18/3884/SA1/P/INGO/8358,5/15/2019 11:17:20 AM,Overall,1967,2951,2459,2459,9836,3760,3550,2462,2400,12172
72,Iraq,2018,IRQ-18/3884/SA1/P/INGO/8400,12/8/2019 8:18:36 AM,Internally Displaced People,6000,4750,8500,9000,28250,64,24,9,7,104
72,Iraq,2018,IRQ-18/3884/SA1/P/INGO/8400,12/8/2019 8:18:36 AM,Other,6000,4750,8500,9000,28250,6902,5504,16395,17672,46473
72,Iraq,2018,IRQ-18/3884/SA1/P/INGO/8400,12/8/2019 8:18:36 AM,Overall,12000,9500,17000,18000,56500,6966,5528,16404,17679,46577
72,Iraq,2018,IRQ-18/3884/SA1/P/INGO/8402,4/28/2019 7:41:33 AM,Internally Displaced People,1321,2379,1322,1586,6608,6424,8442,0,0,14866
72,Iraq,2018,IRQ-18/3884/SA1/P/INGO/8402,4/28/2019 7:41:33 AM,Overall,2670,3200,3970,5396,15236,3418,4766,3006,3676,14866
72,Iraq,2018,IRQ-18/3884/SA1/P/INGO/8440,3/17/2019 8:56:12 AM,Host Communities,26,26,118,118,288,0,0,0,0,0
72,Iraq,2018,IRQ-18/3884/SA1/P/INGO/8440,3/17/2019 8:56:12 AM,Other,148,148,667,667,1630,481,368,588,704,2141
72,Iraq,2018,IRQ-18/3884/SA1/P/INGO/8440,3/17/2019 8:56:12 AM,Overall,174,174,785,785,1918,490,359,588,704,2141
72,Iraq,2018,IRQ-18/3884/SA1/P/INGO/8441,2/20/2019 2:00:41 PM,Internally Displaced People,0,0,0,0,0,3303,4394,4253,4020,15970
72,Iraq,2018,IRQ-18/3884/SA1/P/INGO/8441,2/20/2019 2:00:41 PM,Overall,3000,3000,2000,2000,10000,3303,4394,4253,4020,15970
72,Iraq,2018,IRQ-18/3884/SA1/P/INGO/8446,5/15/2019 11:38:22 AM,Host Communities,100,1800,0,875,2775,342,3944,465,546,5297
72,Iraq,2018,IRQ-18/3884/SA1/P/INGO/8446,5/15/2019 11:38:22 AM,Internally Displaced People,100,1650,0,475,2225,38,438,52,61,589
72,Iraq,2018,IRQ-18/3884/SA1/P/INGO/8446,5/15/2019 11:38:22 AM,Other,7,42,0,0,49,0,0,0,0,0
72,Iraq,2018,IRQ-18/3884/SA1/P/INGO/8446,5/15/2019 11:38:22 AM,Overall,207,3493,0,1350,5050,380,4382,517,607,5886
72,Iraq,2018,IRQ-18/3884/SA1/P/INGO/8584,10/9/2019 6:55:21 AM,Host Communities,5738,8325,5112,5825,25000,0,0,0,0,0
72,Iraq,2018,IRQ-18/3884/SA1/P/INGO/8584,10/9/2019 6:55:21 AM,Internally Displaced People,5737,8325,5113,5825,25000,0,0,0,0,0
72,Iraq,2018,IRQ-18/3884/SA1/P/INGO/8584,10/9/2019 6:55:21 AM,Overall,11475,16650,10225,11650,50000,1982,2150,777,931,5840
72,Iraq,2018,IRQ-18/3884/SA1/P/NGO/8024,3/19/2019 12:32:42 PM,Host Communities,0,0,0,0,0,56,16,728,318,1118
72,Iraq,2018,IRQ-18/3884/SA1/P/NGO/8024,3/19/2019 12:32:42 PM,Internally Displaced People,1000,500,500,500,2500,653,1174,896,590,3313
72,Iraq,2018,IRQ-18/3884/SA1/P/NGO/8024,3/19/2019 12:32:42 PM,Overall,1000,1500,500,500,3500,709,1190,1625,907,4431
72,Iraq,2018,IRQ-18/3884/SA1/P/NGO/8420,7/15/2019 1:58:14 PM,Internally Displaced People,3930,3480,0,0,7410,0,0,0,0,0
72,Iraq,2018,IRQ-18/3884/SA1/P/NGO/8420,7/15/2019 1:58:14 PM,Overall,4023,3587,0,0,7610,4238,3804,0,0,8042
72,Iraq,2018,IRQ-18/3884/SA1/P/NGO/8427,1/7/2019 8:24:18 AM,Internally Displaced People,81,1140,40,620,1881,82,5259,43,2210,7594
72,Iraq,2018,IRQ-18/3884/SA1/P/NGO/8427,1/7/2019 8:24:18 AM,Other,41,616,20,355,1032,73,2809,20,1020,3922
72,Iraq,2018,IRQ-18/3884/SA1/P/NGO/8427,1/7/2019 8:24:18 AM,Overall,122,1756,60,975,2913,155,8068,63,3230,11516
72,Iraq,2018,IRQ-18/3884/SA1/P/NGO/8578,7/3/2019 9:43:24 AM,Internally Displaced People,600,2000,400,600,3600,1143,4783,892,3088,9906
72,Iraq,2018,IRQ-18/3884/SA1/P/NGO/8578,7/3/2019 9:43:24 AM,Overall,600,2000,400,600,3600,1143,4783,892,3088,9906
72,Iraq,2018,IRQ-18/3884/SA1/P/NGO/8585,7/23/2019 7:19:09 AM,Other,520,3450,150,1200,5320,3161,5354,2682,3298,14495
72,Iraq,2018,IRQ-18/3884/SA1/P/NGO/8585,7/23/2019 7:19:09 AM,Overall,520,3450,150,1200,5320,3161,5354,2682,3298,14495
72,Iraq,2018,IRQ-18/3884/SA1/P-E/INGO/8382,4/3/2019 12:48:30 PM,Internally Displaced People,2000,2000,2000,2000,8000,916,1524,2534,2406,7380
72,Iraq,2018,IRQ-18/3884/SA1/P-E/INGO/8382,4/3/2019 12:48:30 PM,Other,685,685,250,250,1870,456,940,305,244,1945
72,Iraq,2018,IRQ-18/3884/SA1/P-E/INGO/8382,4/3/2019 12:48:30 PM,Overall,2685,2685,2250,2250,9870,1372,2464,2839,2650,9325
72,Iraq,2018,IRQ-18/3884/SA1/P-E/INGO/8483,7/25/2019 8:13:38 AM,Internally Displaced People,654,652,1228,1228,3762,831,1899,1703,1808,6241
72,Iraq,2018,IRQ-18/3884/SA1/P-E/INGO/8483,7/25/2019 8:13:38 AM,Overall,654,652,1228,1228,3762,831,1899,1703,1808,6241
72,Iraq,2018,IRQ-18/3884/SA1/RRM/UN/8248,3/3/2019 8:16:45 AM,Internally Displaced People,0,9000,0,9000,18000,0,18662,0,18662,37324
72,Iraq,2018,IRQ-18/3884/SA1/RRM/UN/8248,3/3/2019 8:16:45 AM,Other,0,9000,0,9000,18000,0,0,0,0,0
72,Iraq,2018,IRQ-18/3884/SA1/RRM/UN/8248,3/3/2019 8:16:45 AM,Overall,0,18000,0,18000,36000,0,18662,0,18662,37324
72,Iraq,2018,IRQ-18/3884/SA1/RRM/UN/8575,5/13/2019 10:12:55 AM,Internally Displaced People,13536,14664,15264,16536,60000,11868,13775,14565,14926,55134
72,Iraq,2018,IRQ-18/3884/SA1/RRM/UN/8575,5/13/2019 10:12:55 AM,Overall,13536,14664,15264,16536,60000,11868,13775,14565,14926,55134
72,Iraq,2018,IRQ-18/3884/SA1/WASH/INGO/8341,7/22/2019 1:15:25 PM,Other,6071,6050,5646,6233,24000,17723,17655,18204,16469,70051
72,Iraq,2018,IRQ-18/3884/SA1/WASH/INGO/8341,7/22/2019 1:15:25 PM,Overall,6071,6050,5646,6233,24000,17723,17655,18204,16469,70051
72,Iraq,2018,IRQ-18/3884/SA1/WASH/INGO/8363,11/6/2019 9:32:09 AM,Host Communities,817,882,751,817,3267,920,884,939,938,3681
72,Iraq,2018,IRQ-18/3884/SA1/WASH/INGO/8363,11/6/2019 9:32:09 AM,Internally Displaced People,7690,8306,7075,7690,30761,8610,8266,9213,9211,35300
72,Iraq,2018,IRQ-18/3884/SA1/WASH/INGO/8363,11/6/2019 9:32:09 AM,Overall,11773,12715,10831,11773,47092,10451,10034,11037,10999,42521
72,Iraq,2018,IRQ-18/3884/SA1/WASH/INGO/8363,11/6/2019 9:32:09 AM,Returnees,3266,3527,3005,3266,13064,921,884,885,850,3540
72,Iraq,2018,IRQ-18/3884/SA1/WASH/INGO/8412,7/11/2019 8:03:05 AM,Overall,32430,33390,1524,1656,69000,18630,19320,15180,15870,69000
72,Iraq,2018,IRQ-18/3884/SA1/WASH/INGO/8424,3/12/2019 12:25:36 PM,Internally Displaced People,1578,2127,2925,2845,9475,1492,2039,2650,2526,8707
72,Iraq,2018,IRQ-18/3884/SA1/WASH/INGO/8424,3/12/2019 12:25:36 PM,Overall,1578,2127,2925,2845,9475,1492,2039,2650,2526,8707
72,Iraq,2018,IRQ-18/3884/SA1/WASH/INGO/8450,3/4/2019 8:17:07 AM,Other,3744,3744,4448,4196,16132,0,0,0,0,0
72,Iraq,2018,IRQ-18/3884/SA1/WASH/INGO/8450,3/4/2019 8:17:07 AM,Overall,3744,3744,4448,4196,16132,3801,4083,6231,5441,19556
72,Iraq,2018,IRQ-18/3884/SA1/WASH/INGO/8464,4/17/2019 12:12:37 PM,Other,3116,3244,2764,2876,12000,3551,3721,2950,3278,13500
72,Iraq,2018,IRQ-18/3884/SA1/WASH/INGO/8464,4/17/2019 12:12:37 PM,Overall,3116,3244,2764,2876,12000,3551,3721,2950,3278,13500
72,Iraq,2018,IRQ-18/3884/SA1/WASH/INGO/8471,2/25/2019 1:13:58 PM,Internally Displaced People,2727,2603,3347,3719,12396,3587,3423,4402,4891,16303
72,Iraq,2018,IRQ-18/3884/SA1/WASH/INGO/8471,2/25/2019 1:13:58 PM,Overall,2727,2603,3347,3719,12396,3587,3423,4402,4891,16303
72,Iraq,2018,IRQ-18/3884/SA1/WASH/INGO/8597,11/21/2018 9:04:46 AM,Internally Displaced People,6500,7800,5850,5850,26000,4658,6730,7247,7247,25882
72,Iraq,2018,IRQ-18/3884/SA1/WASH/INGO/8597,11/21/2018 9:04:46 AM,Overall,6500,7800,5850,5850,26000,4658,6730,7247,7247,25882
72,Iraq,2018,IRQ-18/3884/SA1/WASH/NGO/8066,11/25/2018 10:41:50 AM,Other,239,340,8205,11345,20129,270,198,8077,11091,19636
72,Iraq,2018,IRQ-18/3884/SA1/WASH/NGO/8066,11/25/2018 10:41:50 AM,Overall,239,340,8205,11345,20129,270,198,8095,11091,19654
72,Iraq,2018,IRQ-18/3884/SA1/WASH/NGO/8439,3/20/2019 6:28:47 AM,Internally Displaced People,3774,4064,5750,5518,19106,3779,4065,5750,5518,19112
72,Iraq,2018,IRQ-18/3884/SA1/WASH/NGO/8439,3/20/2019 6:28:47 AM,Overall,3774,4064,5750,5518,19106,3779,4065,5750,5518,19112
72,Iraq,2018,IRQ-18/3884/SA1/WASH/O/8379,1/16/2020 1:21:31 PM,Internally Displaced People,744,1164,1517,1525,4950,632,948,1145,1225,3950
72,Iraq,2018,IRQ-18/3884/SA1/WASH/O/8379,1/16/2020 1:21:31 PM,Overall,744,1164,1517,1525,4950,632,948,1145,1225,3950
72,Iraq,2018,IRQ-18/3884/SA1/WASH/UN/8574,7/18/2019 9:12:55 AM,Internally Displaced People,19200,20800,19200,20800,80000,25451,26841,35123,37082,124497
72,Iraq,2018,IRQ-18/3884/SA1/WASH/UN/8574,7/18/2019 9:12:55 AM,Overall,19200,20800,19200,20800,80000,25451,26841,35123,36182,123597
72,Iraq,2018,IRQ-18/3884/SA1/WASH/UN/8586,4/10/2019 7:01:19 AM,Internally Displaced People,3230,4450,6460,6460,20600,2947,4788,6578,6525,20838
72,Iraq,2018,IRQ-18/3884/SA1/WASH/UN/8586,4/10/2019 7:01:19 AM,Overall,3230,4850,6460,6460,21000,2947,4788,6578,6525,20838
72,Iraq,2019,IRQ-19/3884/RA1/NFIs/INGO/12367,10/5/2021 2:27:16 PM,Host Communities,5,6,11,11,33,0,0,0,0,0
72,Iraq,2019,IRQ-19/3884/RA1/NFIs/INGO/12367,10/5/2021 2:27:16 PM,Internally Displaced People,12778,13842,12778,13842,53240,5704,5704,11408,11408,34224
72,Iraq,2019,IRQ-19/3884/RA1/NFIs/INGO/12367,10/5/2021 2:27:16 PM,Overall,12890,13956,13004,14068,53918,6275,5835,11408,11408,34926
72,Iraq,2019,IRQ-19/3884/RA1/NFIs/INGO/12367,10/5/2021 2:27:16 PM,Returnees,107,108,215,215,645,571,131,0,0,702
72,Iraq,2019,IRQ-19/3884/RA1/NFIs/UN/12344,12/8/2021 8:10:22 AM,Internally Displaced People,5874,6650,7744,7364,27632,14356,16121,18709,17786,66972
72,Iraq,2019,IRQ-19/3884/RA1/NFIs/UN/12344,12/8/2021 8:10:22 AM,Overall,5874,6650,7744,7364,27632,14356,16121,18709,17786,66972
72,Iraq,2019,IRQ-19/3884/RA2/CCS/INGO/13288,10/12/2020 10:02:06 AM,Other,91,92,0,0,183,91,92,0,0,183
72,Iraq,2019,IRQ-19/3884/RA2/CCS/INGO/13288,10/12/2020 10:02:06 AM,Overall,91,92,0,0,183,91,92,0,0,183
72,Iraq,2019,IRQ-19/3884/SA1/CASH/INGO/11247,11/20/2019 6:55:06 AM,Host Communities,1652,1588,1408,1352,6000,1090,1440,1147,1056,4733
72,Iraq,2019,IRQ-19/3884/SA1/CASH/INGO/11247,11/20/2019 6:55:06 AM,Internally Displaced People,397,381,337,325,1440,517,546,448,432,1943
72,Iraq,2019,IRQ-19/3884/SA1/CASH/INGO/11247,11/20/2019 6:55:06 AM,Overall,2049,1969,1745,1677,7440,1607,1986,1595,1488,6676
72,Iraq,2019,IRQ-19/3884/SA1/CASH/INGO/11386,4/2/2020 7:45:18 AM,Host Communities,383,368,383,368,1502,0,0,0,0,0
72,Iraq,2019,IRQ-19/3884/SA1/CASH/INGO/11386,4/2/2020 7:45:18 AM,Internally Displaced People,149,144,149,143,585,14,21,14,15,64
72,Iraq,2019,IRQ-19/3884/SA1/CASH/INGO/11386,4/2/2020 7:45:18 AM,Other,0,0,0,0,0,82,83,90,86,341
72,Iraq,2019,IRQ-19/3884/SA1/CASH/INGO/11386,4/2/2020 7:45:18 AM,Overall,2129,2047,2129,2047,8352,1686,2006,1745,1759,7196
72,Iraq,2019,IRQ-19/3884/SA1/CASH/INGO/11386,4/2/2020 7:45:18 AM,Returnees,1597,1535,1597,1536,6265,1590,1902,1641,1658,6791
72,Iraq,2019,IRQ-19/3884/SA1/CCCM/INGO/11295,10/1/2019 9:51:28 AM,Host Communities,1039,1039,959,959,3996,1563,1517,1608,1399,6087
72,Iraq,2019,IRQ-19/3884/SA1/CCCM/INGO/11295,10/1/2019 9:51:28 AM,Internally Displaced People,5196,5196,4797,4797,19986,4293,4643,5754,4529,19219
72,Iraq,2019,IRQ-19/3884/SA1/CCCM/INGO/11295,10/1/2019 9:51:28 AM,Overall,6235,6235,5756,5756,23982,5856,6160,7362,5928,25306
72,Iraq,2019,IRQ-19/3884/SA1/CCCM/INGO/11358,3/29/2020 11:55:32 AM,Internally Displaced People,325,290,485,400,1500,439,510,753,597,2299
72,Iraq,2019,IRQ-19/3884/SA1/CCCM/INGO/11358,3/29/2020 11:55:32 AM,Overall,325,290,485,400,1500,439,510,753,597,2299
72,Iraq,2019,IRQ-19/3884/SA1/CCCM/INGO/11369,12/13/2019 7:25:46 AM,Host Communities,269,142,262,253,926,0,0,0,0,0
72,Iraq,2019,IRQ-19/3884/SA1/CCCM/INGO/11369,12/13/2019 7:25:46 AM,Internally Displaced People,1346,710,1311,1264,4631,748,760,750,420,2678
72,Iraq,2019,IRQ-19/3884/SA1/CCCM/INGO/11369,12/13/2019 7:25:46 AM,Overall,1615,852,1574,1517,5558,748,760,750,420,2678
72,Iraq,2019,IRQ-19/3884/SA1/CCCM/UN/11389,9/9/2019 10:05:41 AM,Overall,3562,5033,3708,5033,17336,1537,2696,3919,3735,11887
72,Iraq,2019,IRQ-19/3884/SA1/CCCM-NFIs/INGO/11265,1/5/2021 8:30:18 AM,Internally Displaced People,47845,49982,42153,43017,182997,121817,128830,60744,62279,373670
72,Iraq,2019,IRQ-19/3884/SA1/CCCM-NFIs/INGO/11265,1/5/2021 8:30:18 AM,Other,350,350,0,0,700,3235,3383,2158,2153,10929
72,Iraq,2019,IRQ-19/3884/SA1/CCCM-NFIs/INGO/11265,1/5/2021 8:30:18 AM,Overall,48195,50332,42153,43017,183697,125052,132213,62902,64432,384599
72,Iraq,2019,IRQ-19/3884/SA1/E/INGO/11371,12/8/2019 9:37:50 AM,Host Communities,108,108,720,720,1656,16,23,226,563,828
72,Iraq,2019,IRQ-19/3884/SA1/E/INGO/11371,12/8/2019 9:37:50 AM,Internally Displaced People,119,111,4750,4750,9730,1556,1051,3689,3206,9502
72,Iraq,2019,IRQ-19/3884/SA1/E/INGO/11371,12/8/2019 9:37:50 AM,Other,162,162,1080,1080,2484,208,346,927,1562,3043
72,Iraq,2019,IRQ-19/3884/SA1/E/INGO/11371,12/8/2019 9:37:50 AM,Overall,389,381,6550,6550,13870,1780,1420,4842,5331,13373
72,Iraq,2019,IRQ-19/3884/SA1/EL/INGO/11372,3/26/2020 9:02:36 AM,Host Communities,96,144,0,0,240,60,73,0,0,133
72,Iraq,2019,IRQ-19/3884/SA1/EL/INGO/11372,3/26/2020 9:02:36 AM,Overall,480,720,0,0,1200,459,763,0,0,1222
72,Iraq,2019,IRQ-19/3884/SA1/EL/INGO/11372,3/26/2020 9:02:36 AM,Returnees,384,576,0,0,960,399,690,0,0,1089
72,Iraq,2019,IRQ-19/3884/SA1/EL/UN/11379,2/4/2021 8:24:37 AM,Host Communities,108,162,0,0,270,26,32,0,0,58
72,Iraq,2019,IRQ-19/3884/SA1/EL/UN/11379,2/4/2021 8:24:37 AM,Overall,540,810,0,0,1350,624,726,0,0,1350
72,Iraq,2019,IRQ-19/3884/SA1/EL/UN/11379,2/4/2021 8:24:37 AM,Returnees,432,648,0,0,1080,598,694,0,0,1292
72,Iraq,2019,IRQ-19/3884/SA1/E-P/INGO/11333,8/31/2020 8:08:37 AM,Internally Displaced People,953,943,3012,3012,7920,1046,1078,4404,4113,10641
72,Iraq,2019,IRQ-19/3884/SA1/E-P/INGO/11333,8/31/2020 8:08:37 AM,Overall,953,943,3012,3012,7920,1046,1078,4404,4113,10641
72,Iraq,2019,IRQ-19/3884/SA1/E-P/INGO/11351,4/26/2020 7:52:15 AM,Host Communities,32,26,134,110,302,9,9,26,26,70
72,Iraq,2019,IRQ-19/3884/SA1/E-P/INGO/11351,4/26/2020 7:52:15 AM,Internally Displaced People,995,864,7965,7965,17789,1055,798,8022,6596,16471
72,Iraq,2019,IRQ-19/3884/SA1/E-P/INGO/11351,4/26/2020 7:52:15 AM,Other,128,106,533,443,1210,294,276,845,848,2263
72,Iraq,2019,IRQ-19/3884/SA1/E-P/INGO/11351,4/26/2020 7:52:15 AM,Overall,1155,996,8632,8518,19301,1358,1083,8893,7470,18804
72,Iraq,2019,IRQ-19/3884/SA1/ETC/UN/11396,8/5/2019 3:57:38 PM,Overall,1,0,0,0,1,1,0,0,0,1
72,Iraq,2019,IRQ-19/3884/SA1/F/INGO/11409,8/23/2020 8:17:17 PM,Host Communities,248,255,250,211,964,236,247,233,200,916
72,Iraq,2019,IRQ-19/3884/SA1/F/INGO/11409,8/23/2020 8:17:17 PM,Internally Displaced People,694,818,798,814,3124,677,823,817,839,3156
72,Iraq,2019,IRQ-19/3884/SA1/F/INGO/11409,8/23/2020 8:17:17 PM,Other,3184,3602,2831,2714,12331,3333,3713,2981,2885,12912
72,Iraq,2019,IRQ-19/3884/SA1/F/INGO/11409,8/23/2020 8:17:17 PM,Overall,4126,4675,3879,3739,16419,4246,4783,4031,3924,16984
72,Iraq,2019,IRQ-19/3884/SA1/F/UN/11332,2/13/2022 6:38:53 AM,Host Communities,1555,1498,1440,1267,5760,8295,3226,5530,2150,19201
72,Iraq,2019,IRQ-19/3884/SA1/F/UN/11332,2/13/2022 6:38:53 AM,Other,2852,2735,1497,1556,8640,0,0,0,0,0
72,Iraq,2019,IRQ-19/3884/SA1/F/UN/11332,2/13/2022 6:38:53 AM,Overall,4407,4233,2937,2823,14400,8295,3226,5530,2150,19201
72,Iraq,2019,IRQ-19/3884/SA1/H/UN/11234,12/8/2019 9:27:30 AM,Host Communities,0,20000,0,1800,21800,0,14441,0,1316,15757
72,Iraq,2019,IRQ-19/3884/SA1/H/UN/11234,12/8/2019 9:27:30 AM,Internally Displaced People,0,25000,0,2000,27000,0,72084,0,2935,75019
72,Iraq,2019,IRQ-19/3884/SA1/H/UN/11234,12/8/2019 9:27:30 AM,Overall,0,45000,0,3800,48800,0,86525,0,4251,90776
72,Iraq,2019,IRQ-19/3884/SA1/H/UN/11317,7/23/2020 8:44:51 AM,Host Communities,127264,122173,132354,127264,509055,0,0,0,0,0
72,Iraq,2019,IRQ-19/3884/SA1/H/UN/11317,7/23/2020 8:44:51 AM,Internally Displaced People,117474,112775,122173,117474,469896,342538,357011,248461,258110,1206120
72,Iraq,2019,IRQ-19/3884/SA1/H/UN/11317,7/23/2020 8:44:51 AM,Overall,244738,234948,254527,244738,978951,342538,357011,248461,258110,1206120
72,Iraq,2019,IRQ-19/3884/SA1/H/UN/11387,11/14/2019 11:38:18 AM,Internally Displaced People,13945,13144,4378,4653,36120,8267,17204,7734,9393,42598
72,Iraq,2019,IRQ-19/3884/SA1/H/UN/11387,11/14/2019 11:38:18 AM,Overall,13945,13144,4378,4653,36120,8267,17204,7734,9393,42598
72,Iraq,2019,IRQ-19/3884/SA1/H/UN/11410,10/10/2019 1:52:27 PM,Overall,0,44076,42152,40491,126719,0,37190,36746,35970,109906
72,Iraq,2019,IRQ-19/3884/SA1/NFIs-CCCM-WASH/INGO/11245,12/21/2020 12:01:19 PM,Internally Displaced People,10709,15794,16507,16916,59926,7265,12279,13891,13733,47168
72,Iraq,2019,IRQ-19/3884/SA1/NFIs-CCCM-WASH/INGO/11245,12/21/2020 12:01:19 PM,Overall,12543,17617,17860,18186,66206,7265,12279,13891,13733,47168
72,Iraq,2019,IRQ-19/3884/SA1/NFIs-CCCM-WASH/INGO/11245,12/21/2020 12:01:19 PM,Returnees,1834,1823,1353,1270,6280,0,0,0,0,0
72,Iraq,2019,IRQ-19/3884/SA1/P/INGO/11222,3/25/2020 9:11:35 AM,Host Communities,219,215,73,73,580,620,1398,1138,815,3971
72,Iraq,2019,IRQ-19/3884/SA1/P/INGO/11222,3/25/2020 9:11:35 AM,Internally Displaced People,876,864,290,290,2320,23,135,8,1,167
72,Iraq,2019,IRQ-19/3884/SA1/P/INGO/11222,3/25/2020 9:11:35 AM,Other,3284,3242,1087,1087,8700,1911,2155,1900,1380,7346
72,Iraq,2019,IRQ-19/3884/SA1/P/INGO/11222,3/25/2020 9:11:35 AM,Overall,4379,4321,1450,1450,11600,2554,3688,3046,2196,11484
72,Iraq,2019,IRQ-19/3884/SA1/P/INGO/11263,4/7/2020 1:30:04 PM,Host Communities,107,107,445,445,1104,62,76,323,298,759
72,Iraq,2019,IRQ-19/3884/SA1/P/INGO/11263,4/7/2020 1:30:04 PM,Internally Displaced People,356,356,1469,1469,3650,2470,3331,3868,3734,13403
72,Iraq,2019,IRQ-19/3884/SA1/P/INGO/11263,4/7/2020 1:30:04 PM,Other,163,163,645,645,1616,837,791,1784,2597,6009
72,Iraq,2019,IRQ-19/3884/SA1/P/INGO/11263,4/7/2020 1:30:04 PM,Overall,626,626,2559,2559,6370,3369,4198,5975,6629,20171
72,Iraq,2019,IRQ-19/3884/SA1/P/INGO/11322,8/10/2020 3:41:10 PM,Host Communities,13698,14839,12453,13490,54480,13585,14757,13158,13799,55299
72,Iraq,2019,IRQ-19/3884/SA1/P/INGO/11322,8/10/2020 3:41:10 PM,Internally Displaced People,514,556,467,506,2043,509,553,493,518,2073
72,Iraq,2019,IRQ-19/3884/SA1/P/INGO/11322,8/10/2020 3:41:10 PM,Other,2910,3153,2646,2867,11576,2887,3136,2796,2931,11750
72,Iraq,2019,IRQ-19/3884/SA1/P/INGO/11322,8/10/2020 3:41:10 PM,Overall,17122,18549,15566,16863,68100,16981,18446,16447,17248,69122
72,Iraq,2019,IRQ-19/3884/SA1/P/INGO/11345,4/13/2020 5:16:21 AM,Internally Displaced People,1372,2012,2058,2058,7500,3948,3968,3796,3790,15502
72,Iraq,2019,IRQ-19/3884/SA1/P/INGO/11345,4/13/2020 5:16:21 AM,Other,2058,3018,3087,3087,11250,2806,3753,2751,2718,12028
72,Iraq,2019,IRQ-19/3884/SA1/P/INGO/11345,4/13/2020 5:16:21 AM,Overall,3430,5030,5146,5146,18752,6754,7721,6547,6508,27530
72,Iraq,2019,IRQ-19/3884/SA1/P/INGO/11346,3/30/2020 11:15:51 AM,Overall,21100,21100,45000,45000,132200,17352,23136,8676,8676,57840
72,Iraq,2019,IRQ-19/3884/SA1/P/INGO/11347,4/6/2020 1:00:45 PM,Host Communities,196,241,249,205,891,772,698,1065,1155,3690
72,Iraq,2019,IRQ-19/3884/SA1/P/INGO/11347,4/6/2020 1:00:45 PM,Internally Displaced People,588,722,748,615,2673,406,366,561,610,1943
72,Iraq,2019,IRQ-19/3884/SA1/P/INGO/11347,4/6/2020 1:00:45 PM,Other,1176,1443,1497,1229,5345,853,771,1179,1277,4080
72,Iraq,2019,IRQ-19/3884/SA1/P/INGO/11347,4/6/2020 1:00:45 PM,Overall,1960,2406,2494,2049,8909,2031,1835,2805,3042,9713
72,Iraq,2019,IRQ-19/3884/SA1/P/INGO/11357,3/29/2020 12:14:30 PM,Host Communities,1181,4037,570,1700,7488,1126,6440,283,1082,8931
72,Iraq,2019,IRQ-19/3884/SA1/P/INGO/11357,3/29/2020 12:14:30 PM,Internally Displaced People,800,2250,400,700,4150,1091,3137,298,1091,5617
72,Iraq,2019,IRQ-19/3884/SA1/P/INGO/11357,3/29/2020 12:14:30 PM,Overall,1981,6287,970,2400,11638,2217,9577,581,2173,14548
72,Iraq,2019,IRQ-19/3884/SA1/P/INGO/11370,3/16/2020 10:19:34 AM,Host Communities,766,901,38,47,1752,1382,981,17,25,2405
72,Iraq,2019,IRQ-19/3884/SA1/P/INGO/11370,3/16/2020 10:19:34 AM,Internally Displaced People,847,996,42,50,1935,498,659,22,25,1204
72,Iraq,2019,IRQ-19/3884/SA1/P/INGO/11370,3/16/2020 10:19:34 AM,Other,2420,2846,121,143,5530,5690,2361,161,150,8362
72,Iraq,2019,IRQ-19/3884/SA1/P/INGO/11370,3/16/2020 10:19:34 AM,Overall,4034,4744,201,240,9219,7570,4001,200,200,11971
72,Iraq,2019,IRQ-19/3884/SA1/P/INGO/11373,6/7/2020 1:57:34 PM,Host Communities,1526,2884,1000,1640,7050,1199,2705,853,2078,6835
72,Iraq,2019,IRQ-19/3884/SA1/P/INGO/11373,6/7/2020 1:57:34 PM,Internally Displaced People,2289,4326,1500,2460,10575,3050,4644,3056,3507,14257
72,Iraq,2019,IRQ-19/3884/SA1/P/INGO/11373,6/7/2020 1:57:34 PM,Overall,3815,7210,2500,4100,17625,4249,7349,3909,5585,21092
72,Iraq,2019,IRQ-19/3884/SA1/P/INGO/11400,11/3/2019 11:23:40 AM,Host Communities,565,265,714,714,2258,545,430,206,194,1375
72,Iraq,2019,IRQ-19/3884/SA1/P/INGO/11400,11/3/2019 11:23:40 AM,Internally Displaced People,7414,7705,6978,6978,29075,10568,10500,7812,6554,35434
72,Iraq,2019,IRQ-19/3884/SA1/P/INGO/11400,11/3/2019 11:23:40 AM,Other,4765,4954,4765,4765,19249,4682,3698,1767,1665,11812
72,Iraq,2019,IRQ-19/3884/SA1/P/INGO/11400,11/3/2019 11:23:40 AM,Overall,12754,13298,12478,12478,51008,15795,14628,9785,8413,48621
72,Iraq,2019,IRQ-19/3884/SA1/WASH/INGO/11270,1/6/2020 8:22:33 AM,Internally Displaced People,9426,10211,9555,9552,38744,7275,8767,10985,10827,37854
72,Iraq,2019,IRQ-19/3884/SA1/WASH/INGO/11270,1/6/2020 8:22:33 AM,Overall,9426,10211,9555,9552,38744,7275,8767,10985,10827,37854
72,Iraq,2019,IRQ-19/3884/SA1/WASH/INGO/11431,12/5/2019 1:03:42 PM,Host Communities,6686,6315,6138,6110,25249,6772,7179,5936,5899,25786
72,Iraq,2019,IRQ-19/3884/SA1/WASH/INGO/11431,12/5/2019 1:03:42 PM,Internally Displaced People,2821,3089,3141,3083,12134,1503,1774,1280,1279,5836
72,Iraq,2019,IRQ-19/3884/SA1/WASH/INGO/11431,12/5/2019 1:03:42 PM,Other,25078,25772,31728,33883,116461,39707,41319,38663,38424,158113
72,Iraq,2019,IRQ-19/3884/SA1/WASH/INGO/11431,12/5/2019 1:03:42 PM,Overall,34585,35176,41007,43076,153844,47982,50272,45879,45602,189735
72,Iraq,2019,IRQ-19/3884/SA2/CASH/INGO/13837,2/14/2021 3:32:03 PM,Other,3796,3653,3258,3148,13855,4482,3494,3586,3526,15088
72,Iraq,2019,IRQ-19/3884/SA2/CASH/INGO/13837,2/14/2021 3:32:03 PM,Overall,3796,3653,3258,3148,13855,4482,3494,3586,3526,15088
72,Iraq,2019,IRQ-19/3884/SA2/CASH/INGO/13900,10/15/2020 7:43:39 AM,Host Communities,94,107,105,107,413,457,454,477,458,1846
72,Iraq,2019,IRQ-19/3884/SA2/CASH/INGO/13900,10/15/2020 7:43:39 AM,Internally Displaced People,470,505,503,498,1976,377,425,418,456,1676
72,Iraq,2019,IRQ-19/3884/SA2/CASH/INGO/13900,10/15/2020 7:43:39 AM,Other,555,636,622,636,2449,316,331,321,337,1305
72,Iraq,2019,IRQ-19/3884/SA2/CASH/INGO/13900,10/15/2020 7:43:39 AM,Overall,3687,3895,3885,3821,15288,4091,4167,4346,4209,16813
72,Iraq,2019,IRQ-19/3884/SA2/CASH/INGO/13900,10/15/2020 7:43:39 AM,Returnees,2568,2647,2655,2580,10450,2941,2957,3130,2958,11986
72,Iraq,2019,IRQ-19/3884/SA2/CCCM/INGO/13825,11/9/2021 10:40:58 AM,Host Communities,132,138,0,0,270,474,330,2,6,812
72,Iraq,2019,IRQ-19/3884/SA2/CCCM/INGO/13825,11/9/2021 10:40:58 AM,Internally Displaced People,50235,55064,46904,47257,199460,46985,49553,37396,39371,173305
72,Iraq,2019,IRQ-19/3884/SA2/CCCM/INGO/13825,11/9/2021 10:40:58 AM,Other,279,291,0,0,570,0,0,0,0,0
72,Iraq,2019,IRQ-19/3884/SA2/CCCM/INGO/13825,11/9/2021 10:40:58 AM,Overall,51322,56197,46904,47257,201680,47678,50005,37399,39377,174459
72,Iraq,2019,IRQ-19/3884/SA2/CCCM/INGO/13825,11/9/2021 10:40:58 AM,Returnees,676,704,0,0,1380,219,122,1,0,342
72,Iraq,2019,IRQ-19/3884/SA2/CCCM/INGO/13899,1/11/2021 11:07:06 AM,Internally Displaced People,15840,15840,15840,15840,63360,11591,15000,21818,19773,68182
72,Iraq,2019,IRQ-19/3884/SA2/CCCM/INGO/13899,1/11/2021 11:07:06 AM,Overall,15840,15840,15840,15840,63360,11591,15000,21818,19773,68182
72,Iraq,2019,IRQ-19/3884/SA2/CCS/INGO/13779,8/18/2021 11:13:17 PM,Other,500,500,0,0,1000,960,561,0,0,1521
72,Iraq,2019,IRQ-19/3884/SA2/CCS/INGO/13779,8/18/2021 11:13:17 PM,Overall,500,500,0,0,1000,960,561,0,0,1521
72,Iraq,2019,IRQ-19/3884/SA2/CCS/UN/13875,3/17/2022 12:18:21 PM,Host Communities,1460,490,40,10,2000,5188,2739,97,57,8081
72,Iraq,2019,IRQ-19/3884/SA2/CCS/UN/13875,3/17/2022 12:18:21 PM,Internally Displaced People,35770,12005,980,245,49000,43443,18869,310,126,62748
72,Iraq,2019,IRQ-19/3884/SA2/CCS/UN/13875,3/17/2022 12:18:21 PM,Overall,73000,24500,2000,500,100000,194624,57334,845,277,253080
72,Iraq,2019,IRQ-19/3884/SA2/CCS/UN/13875,3/17/2022 12:18:21 PM,Refugees,2190,735,60,15,3000,113606,21731,122,32,135491
72,Iraq,2019,IRQ-19/3884/SA2/CCS/UN/13875,3/17/2022 12:18:21 PM,Returnees,33580,11270,920,230,46000,32387,13995,316,62,46760
72,Iraq,2019,IRQ-19/3884/SA2/E/INGO/13828,1/21/2021 9:12:08 AM,Internally Displaced People,400,301,2140,2100,4941,505,586,5582,3264,9937
72,Iraq,2019,IRQ-19/3884/SA2/E/INGO/13828,1/21/2021 9:12:08 AM,Other,155,121,1440,1330,3046,70,90,590,355,1105
72,Iraq,2019,IRQ-19/3884/SA2/E/INGO/13828,1/21/2021 9:12:08 AM,Overall,998,773,5620,5380,12771,1334,1374,12992,8410,24110
72,Iraq,2019,IRQ-19/3884/SA2/E/INGO/13828,1/21/2021 9:12:08 AM,Returnees,443,351,2040,1950,4784,759,698,6820,4791,13068
72,Iraq,2019,IRQ-19/3884/SA2/E/INGO/13867,12/29/2020 1:45:38 PM,Internally Displaced People,2619,2433,3235,3566,11853,2451,2349,5071,4471,14342
72,Iraq,2019,IRQ-19/3884/SA2/E/INGO/13867,12/29/2020 1:45:38 PM,Overall,2765,2535,4905,4385,14590,2705,2734,7898,5209,18546
72,Iraq,2019,IRQ-19/3884/SA2/E/INGO/13867,12/29/2020 1:45:38 PM,Returnees,146,102,1670,819,2737,254,385,2827,738,4204
72,Iraq,2019,IRQ-19/3884/SA2/E/INGO/13892,1/17/2021 8:23:36 AM,Host Communities,410,410,500,500,1820,215,245,280,877,1617
72,Iraq,2019,IRQ-19/3884/SA2/E/INGO/13892,1/17/2021 8:23:36 AM,Internally Displaced People,52,52,650,650,1404,57,294,284,350,985
72,Iraq,2019,IRQ-19/3884/SA2/E/INGO/13892,1/17/2021 8:23:36 AM,Overall,5263,5263,4650,4650,19826,3825,3620,5890,7858,21193
72,Iraq,2019,IRQ-19/3884/SA2/E/INGO/13892,1/17/2021 8:23:36 AM,Returnees,4801,4801,3500,3500,16602,3553,3081,5326,6631,18591
72,Iraq,2019,IRQ-19/3884/SA2/E/INGO/13918,2/10/2021 5:41:51 AM,Internally Displaced People,1010,1010,1850,1850,5720,2530,2198,3109,2724,10561
72,Iraq,2019,IRQ-19/3884/SA2/E/INGO/13918,2/10/2021 5:41:51 AM,Overall,2575,2575,4600,4600,14350,3762,3436,7019,6644,20861
72,Iraq,2019,IRQ-19/3884/SA2/E/INGO/13918,2/10/2021 5:41:51 AM,Returnees,1565,1565,2750,2750,8630,1232,1238,3910,3920,10300
72,Iraq,2019,IRQ-19/3884/SA2/EL/INGO/13901,10/14/2020 12:37:58 PM,Overall,133,57,0,0,190,127,63,0,0,190
72,Iraq,2019,IRQ-19/3884/SA2/EL/INGO/13901,10/14/2020 12:37:58 PM,Returnees,133,57,0,0,190,127,63,0,0,190
72,Iraq,2019,IRQ-19/3884/SA2/EL/NGO/13895,1/14/2021 12:19:30 PM,Host Communities,24,40,0,0,64,12,5,0,0,17
72,Iraq,2019,IRQ-19/3884/SA2/EL/NGO/13895,1/14/2021 12:19:30 PM,Internally Displaced People,100,100,0,0,200,44,176,0,0,220
72,Iraq,2019,IRQ-19/3884/SA2/EL/NGO/13895,1/14/2021 12:19:30 PM,Overall,225,293,0,0,518,159,359,0,0,518
72,Iraq,2019,IRQ-19/3884/SA2/EL/NGO/13895,1/14/2021 12:19:30 PM,Returnees,101,153,0,0,254,103,178,0,0,281
72,Iraq,2019,IRQ-19/3884/SA2/F/INGO/13894,10/11/2021 9:56:43 AM,Host Communities,550,525,525,500,2100,0,0,0,0,0
72,Iraq,2019,IRQ-19/3884/SA2/F/INGO/13894,10/11/2021 9:56:43 AM,Overall,2200,2100,2100,2000,8400,180,174,188,160,702
72,Iraq,2019,IRQ-19/3884/SA2/F/INGO/13894,10/11/2021 9:56:43 AM,Refugees,1650,1575,1575,1500,6300,180,174,188,160,702
72,Iraq,2019,IRQ-19/3884/SA2/H/INGO/13860,11/14/2021 12:06:47 PM,Internally Displaced People,6682,7597,9191,9883,33353,7697,23277,8083,10340,49397
72,Iraq,2019,IRQ-19/3884/SA2/H/INGO/13860,11/14/2021 12:06:47 PM,Overall,14521,16918,12639,13929,58007,17947,37685,14140,18693,88465
72,Iraq,2019,IRQ-19/3884/SA2/H/INGO/13860,11/14/2021 12:06:47 PM,Returnees,7839,9321,3448,4046,24654,10250,14408,6057,8353,39068
72,Iraq,2019,IRQ-19/3884/SA2/H/INGO/14654,11/25/2021 9:22:44 AM,Host Communities,22043,22281,14522,15224,74070,28362,35179,12846,12912,89299
72,Iraq,2019,IRQ-19/3884/SA2/H/INGO/14654,11/25/2021 9:22:44 AM,Internally Displaced People,4950,5149,3058,3206,16363,17650,42425,6069,5426,71570
72,Iraq,2019,IRQ-19/3884/SA2/H/INGO/14654,11/25/2021 9:22:44 AM,Overall,51992,52697,34050,35694,174433,68809,143098,25411,25240,262558
72,Iraq,2019,IRQ-19/3884/SA2/H/INGO/14654,11/25/2021 9:22:44 AM,Returnees,24999,25267,16470,17264,84000,22797,65494,6496,6902,101689
72,Iraq,2019,IRQ-19/3884/SA2/H/NGO/13833,11/14/2021 1:54:09 PM,Host Communities,507,12949,95,73,13624,507,12949,95,73,13624
72,Iraq,2019,IRQ-19/3884/SA2/H/NGO/13833,11/14/2021 1:54:09 PM,Internally Displaced People,7328,39023,1648,1590,49589,7328,40116,1648,1590,50682
72,Iraq,2019,IRQ-19/3884/SA2/H/NGO/13833,11/14/2021 1:54:09 PM,Overall,85515,153313,27031,27633,293492,79832,147604,26906,27797,282139
72,Iraq,2019,IRQ-19/3884/SA2/H/NGO/13833,11/14/2021 1:54:09 PM,Refugees,0,2841,0,0,2841,0,2841,0,0,2841
72,Iraq,2019,IRQ-19/3884/SA2/H/NGO/13833,11/14/2021 1:54:09 PM,Returnees,77680,98500,25288,25970,227438,71997,91698,25163,26134,214992
72,Iraq,2019,IRQ-19/3884/SA2/NFIs/INGO/13807,1/3/2022 8:36:30 AM,Internally Displaced People,2393,2393,4786,4786,14358,2931,3181,4780,4631,15523
72,Iraq,2019,IRQ-19/3884/SA2/NFIs/INGO/13807,1/3/2022 8:36:30 AM,Overall,2393,2393,4786,4786,14358,2931,3181,4780,4631,15523
72,Iraq,2019,IRQ-19/3884/SA2/NFIs/INGO/13878,2/1/2022 1:30:54 PM,Host Communities,437,437,874,874,2622,302,302,604,604,1812
72,Iraq,2019,IRQ-19/3884/SA2/NFIs/INGO/13878,2/1/2022 1:30:54 PM,Internally Displaced People,2104,2104,4218,4218,12644,1899,1899,3798,3798,11394
72,Iraq,2019,IRQ-19/3884/SA2/NFIs/INGO/13878,2/1/2022 1:30:54 PM,Overall,2541,2541,5092,5092,15266,2201,2201,4402,4402,13206
72,Iraq,2019,IRQ-19/3884/SA2/NFIs/INGO/13879,5/18/2023 10:39:21 AM,Internally Displaced People,5438,5438,5440,5440,21756,5047,5805,5352,5339,21543
72,Iraq,2019,IRQ-19/3884/SA2/NFIs/INGO/13879,5/18/2023 10:39:21 AM,Overall,6652,6652,6656,6656,26616,6776,7564,6902,6915,28157
72,Iraq,2019,IRQ-19/3884/SA2/NFIs/INGO/13879,5/18/2023 10:39:21 AM,Returnees,1214,1214,1216,1216,4860,1729,1759,1550,1576,6614
72,Iraq,2019,IRQ-19/3884/SA2/NFIs/UN/13888,2/18/2021 11:13:03 AM,Internally Displaced People,1440,2160,960,1440,6000,3347,4472,3229,3420,14468
72,Iraq,2019,IRQ-19/3884/SA2/NFIs/UN/13888,2/18/2021 11:13:03 AM,Overall,1440,2160,960,1440,6000,3347,4472,3229,3420,14468
72,Iraq,2019,IRQ-19/3884/SA2/P/INGO/13820,6/21/2021 10:06:01 AM,Host Communities,2884,6278,965,3184,13311,1365,6037,648,1720,9770
72,Iraq,2019,IRQ-19/3884/SA2/P/INGO/13820,6/21/2021 10:06:01 AM,Internally Displaced People,660,2714,385,1681,5440,1069,4349,869,2793,9080
72,Iraq,2019,IRQ-19/3884/SA2/P/INGO/13820,6/21/2021 10:06:01 AM,Overall,3544,8992,1350,4865,18751,2434,10386,1517,4513,18850
72,Iraq,2019,IRQ-19/3884/SA2/P/INGO/13822,1/10/2021 6:31:55 AM,Host Communities,1796,1651,556,545,4548,686,627,376,306,1995
72,Iraq,2019,IRQ-19/3884/SA2/P/INGO/13822,1/10/2021 6:31:55 AM,Internally Displaced People,1762,2877,467,471,5577,1436,3629,716,546,6327
72,Iraq,2019,IRQ-19/3884/SA2/P/INGO/13822,1/10/2021 6:31:55 AM,Overall,5875,6623,1898,1873,16269,3837,5807,1785,1349,12778
72,Iraq,2019,IRQ-19/3884/SA2/P/INGO/13822,1/10/2021 6:31:55 AM,Returnees,2317,2095,875,857,6144,1715,1551,693,497,4456
72,Iraq,2019,IRQ-19/3884/SA2/P/INGO/13829,2/10/2021 6:52:53 PM,Host Communities,58,74,115,115,362,0,6,0,0,6
72,Iraq,2019,IRQ-19/3884/SA2/P/INGO/13829,2/10/2021 6:52:53 PM,Internally Displaced People,46,58,92,92,288,0,0,0,0,0
72,Iraq,2019,IRQ-19/3884/SA2/P/INGO/13829,2/10/2021 6:52:53 PM,Overall,289,368,574,574,1805,723,556,358,349,1986
72,Iraq,2019,IRQ-19/3884/SA2/P/INGO/13829,2/10/2021 6:52:53 PM,Returnees,185,236,367,367,1155,723,550,358,349,1980
72,Iraq,2019,IRQ-19/3884/SA2/P/INGO/13836,1/7/2021 1:06:18 PM,Host Communities,723,1570,500,896,3689,816,1077,414,440,2747
72,Iraq,2019,IRQ-19/3884/SA2/P/INGO/13836,1/7/2021 1:06:18 PM,Internally Displaced People,1807,3914,1250,2244,9215,234,325,179,325,1063
72,Iraq,2019,IRQ-19/3884/SA2/P/INGO/13836,1/7/2021 1:06:18 PM,Overall,3614,7843,2500,4488,18445,2305,3737,1302,1807,9151
72,Iraq,2019,IRQ-19/3884/SA2/P/INGO/13836,1/7/2021 1:06:18 PM,Returnees,1084,2359,750,1348,5541,1255,2335,709,1042,5341
72,Iraq,2019,IRQ-19/3884/SA2/P/INGO/13856,1/17/2021 1:57:46 PM,Host Communities,192,191,174,164,721,2118,1963,1467,1401,6949
72,Iraq,2019,IRQ-19/3884/SA2/P/INGO/13856,1/17/2021 1:57:46 PM,Internally Displaced People,441,438,400,377,1656,265,190,395,376,1226
72,Iraq,2019,IRQ-19/3884/SA2/P/INGO/13856,1/17/2021 1:57:46 PM,Overall,1917,1905,1738,1638,7198,2642,2339,2328,2125,9434
72,Iraq,2019,IRQ-19/3884/SA2/P/INGO/13856,1/17/2021 1:57:46 PM,Returnees,1284,1276,1164,1097,4821,259,186,466,348,1259
72,Iraq,2019,IRQ-19/3884/SA2/P/INGO/13874,1/19/2022 1:12:46 PM,Internally Displaced People,632,777,1644,1644,4697,242,252,421,424,1339
72,Iraq,2019,IRQ-19/3884/SA2/P/INGO/13874,1/19/2022 1:12:46 PM,Overall,1265,1556,3288,3288,9397,1777,1770,3396,3373,10316
72,Iraq,2019,IRQ-19/3884/SA2/P/INGO/13874,1/19/2022 1:12:46 PM,Returnees,633,779,1644,1644,4700,1535,1518,2975,2949,8977
72,Iraq,2019,IRQ-19/3884/SA2/P/INGO/13882,1/12/2021 8:49:06 AM,Host Communities,455,1111,124,173,1863,658,380,102,93,1233
72,Iraq,2019,IRQ-19/3884/SA2/P/INGO/13882,1/12/2021 8:49:06 AM,Internally Displaced People,2227,5441,608,849,9125,4605,2848,703,700,8856
72,Iraq,2019,IRQ-19/3884/SA2/P/INGO/13882,1/12/2021 8:49:06 AM,Overall,3882,9480,1059,1479,15900,7511,4396,1117,1085,14109
72,Iraq,2019,IRQ-19/3884/SA2/P/INGO/13882,1/12/2021 8:49:06 AM,Returnees,1200,2928,327,457,4912,2248,1168,312,292,4020
72,Iraq,2019,IRQ-19/3884/SA2/P/INGO/13886,8/29/2021 2:21:24 PM,Host Communities,150,1020,105,425,1700,343,2333,240,972,3888
72,Iraq,2019,IRQ-19/3884/SA2/P/INGO/13886,8/29/2021 2:21:24 PM,Internally Displaced People,180,1200,120,500,2000,412,2745,274,1145,4576
72,Iraq,2019,IRQ-19/3884/SA2/P/INGO/13886,8/29/2021 2:21:24 PM,Overall,780,5255,525,2190,8750,1784,12020,1200,5010,20014
72,Iraq,2019,IRQ-19/3884/SA2/P/INGO/13886,8/29/2021 2:21:24 PM,Returnees,450,3035,300,1265,5050,1029,6942,686,2893,11550
72,Iraq,2019,IRQ-19/3884/SA2/P-F/INGO/13812,8/26/2021 6:58:41 AM,Host Communities,8,12,23,23,66,42,47,67,93,249
72,Iraq,2019,IRQ-19/3884/SA2/P-F/INGO/13812,8/26/2021 6:58:41 AM,Overall,1241,1313,2980,2980,8514,1902,2040,2615,2474,9031
72,Iraq,2019,IRQ-19/3884/SA2/P-F/INGO/13812,8/26/2021 6:58:41 AM,Returnees,1233,1301,2957,2957,8448,1860,1993,2548,2381,8782
72,Iraq,2019,IRQ-19/3884/SA2/WASH/INGO/13903,11/9/2021 10:46:36 AM,Host Communities,12667,13778,19619,18526,64590,13304,13655,23927,18724,69610
72,Iraq,2019,IRQ-19/3884/SA2/WASH/INGO/13903,11/9/2021 10:46:36 AM,Internally Displaced People,1582,1567,1947,2110,7206,506,508,1183,1224,3421
72,Iraq,2019,IRQ-19/3884/SA2/WASH/INGO/13903,11/9/2021 10:46:36 AM,Overall,34970,36607,47859,45890,165326,33186,34202,45685,41405,154478
72,Iraq,2019,IRQ-19/3884/SA2/WASH/INGO/13903,11/9/2021 10:46:36 AM,Returnees,20721,21262,26293,25254,93530,19376,20039,20575,21457,81447
72,Iraq,2019,IRQ-19/3884/SA2/WASH-CCCM/INGO/13805,1/7/2021 7:39:15 AM,Host Communities,1363,1349,1859,1699,6270,2060,1886,2907,2930,9783
72,Iraq,2019,IRQ-19/3884/SA2/WASH-CCCM/INGO/13805,1/7/2021 7:39:15 AM,Internally Displaced People,6279,6389,7020,6993,26681,8337,7706,11979,14073,42095
72,Iraq,2019,IRQ-19/3884/SA2/WASH-CCCM/INGO/13805,1/7/2021 7:39:15 AM,Overall,16219,17424,20706,19817,74166,33201,35726,47636,44855,161418
72,Iraq,2019,IRQ-19/3884/SA2/WASH-CCCM/INGO/13805,1/7/2021 7:39:15 AM,Returnees,8577,9686,11827,11125,41215,22804,26134,32750,27852,109540
72,Iraq,2020,IRQ-20/3884/RA1/H/INGO/17784,8/18/2022 12:57:30 PM,Internally Displaced People,5098,5675,4050,3971,18794,8886,12104,6148,6472,33610
72,Iraq,2020,IRQ-20/3884/RA1/H/INGO/17784,8/18/2022 12:57:30 PM,Overall,8162,8807,6658,6380,30007,23660,20581,13267,13180,70688
72,Iraq,2020,IRQ-20/3884/RA1/H/INGO/17784,8/18/2022 12:57:30 PM,Returnees,3064,3132,2608,2409,11213,14774,8477,7119,6708,37078
72,Iraq,2020,IRQ-20/3884/RA1/H/NGO/17838,6/23/2022 10:49:51 AM,Internally Displaced People,800,555,290,245,1890,388,440,113,119,1060
72,Iraq,2020,IRQ-20/3884/RA1/H/NGO/17838,6/23/2022 10:49:51 AM,Overall,2425,1705,715,545,5390,2342,1578,656,786,5362
72,Iraq,2020,IRQ-20/3884/RA1/H/NGO/17838,6/23/2022 10:49:51 AM,Returnees,1625,1150,425,300,3500,1954,1138,543,667,4302
72,Iraq,2020,IRQ-20/3884/RA1/WASH/INGO/17794,9/5/2022 6:54:49 AM,Internally Displaced People,1843,1997,1229,1331,6400,0,0,0,0,0
72,Iraq,2020,IRQ-20/3884/RA1/WASH/INGO/17794,9/5/2022 6:54:49 AM,Overall,1843,1997,1229,1331,6400,0,0,0,0,0
72,Iraq,2020,IRQ-20/3884/RA1/WASH/INGO/17816,3/9/2022 7:40:42 AM,Internally Displaced People,2322,2349,2816,2787,10274,2356,2356,2765,2765,10242
72,Iraq,2020,IRQ-20/3884/RA1/WASH/INGO/17816,3/9/2022 7:40:42 AM,Overall,2322,2349,2816,2787,10274,2356,2356,2765,2765,10242
72,Iraq,2020,IRQ-20/3884/RA2/NFIs/INGO/17974,2/10/2022 1:40:32 PM,Host Communities,109,109,219,219,656,108,141,138,152,539
72,Iraq,2020,IRQ-20/3884/RA2/NFIs/INGO/17974,2/10/2022 1:40:32 PM,Internally Displaced People,554,554,1109,1109,3326,241,309,311,380,1241
72,Iraq,2020,IRQ-20/3884/RA2/NFIs/INGO/17974,2/10/2022 1:40:32 PM,Overall,2184,2184,4371,4371,13110,2808,3342,3778,3703,13631
72,Iraq,2020,IRQ-20/3884/RA2/NFIs/INGO/17974,2/10/2022 1:40:32 PM,Returnees,1521,1521,3043,3043,9128,2459,2892,3329,3171,11851
72,Iraq,2020,IRQ-20/3884/RA2/NFIs/INGO/17979,12/22/2021 9:03:15 AM,Host Communities,20,20,40,40,120,43,61,71,74,249
72,Iraq,2020,IRQ-20/3884/RA2/NFIs/INGO/17979,12/22/2021 9:03:15 AM,Internally Displaced People,223,223,446,446,1338,315,410,716,653,2094
72,Iraq,2020,IRQ-20/3884/RA2/NFIs/INGO/17979,12/22/2021 9:03:15 AM,Overall,655,655,1310,1310,3930,905,1098,1862,1819,5684
72,Iraq,2020,IRQ-20/3884/RA2/NFIs/INGO/17979,12/22/2021 9:03:15 AM,Returnees,412,412,824,824,2472,547,627,1075,1092,3341
72,Iraq,2020,IRQ-20/3884/RA2/NFIs/INGO/17983,2/25/2022 7:57:31 AM,Host Communities,16,16,32,32,96,16,16,32,32,96
72,Iraq,2020,IRQ-20/3884/RA2/NFIs/INGO/17983,2/25/2022 7:57:31 AM,Internally Displaced People,102,102,204,204,612,82,82,164,164,492
72,Iraq,2020,IRQ-20/3884/RA2/NFIs/INGO/17983,2/25/2022 7:57:31 AM,Overall,323,323,646,646,1938,323,323,646,646,1938
72,Iraq,2020,IRQ-20/3884/RA2/NFIs/INGO/17983,2/25/2022 7:57:31 AM,Returnees,205,205,410,410,1230,225,225,450,450,1350
72,Iraq,2020,IRQ-20/3884/RA2/NFIs/INGO/18004,11/10/2021 10:52:15 AM,Host Communities,151,157,123,129,560,139,144,113,117,513
72,Iraq,2020,IRQ-20/3884/RA2/NFIs/INGO/18004,11/10/2021 10:52:15 AM,Internally Displaced People,302,313,246,257,1118,293,304,240,249,1086
72,Iraq,2020,IRQ-20/3884/RA2/NFIs/INGO/18004,11/10/2021 10:52:15 AM,Overall,3021,3133,2462,2574,11190,2926,3034,2385,2491,10836
72,Iraq,2020,IRQ-20/3884/RA2/NFIs/INGO/18004,11/10/2021 10:52:15 AM,Returnees,2568,2663,2093,2188,9512,2494,2586,2032,2125,9237
72,Iraq,2020,IRQ-20/3884/RA2/P/INGO/17993,1/19/2022 11:34:58 AM,Host Communities,98,1545,53,216,1912,160,416,32,50,658
72,Iraq,2020,IRQ-20/3884/RA2/P/INGO/17993,1/19/2022 11:34:58 AM,Internally Displaced People,71,728,46,175,1020,217,506,21,26,770
72,Iraq,2020,IRQ-20/3884/RA2/P/INGO/17993,1/19/2022 11:34:58 AM,Overall,245,3001,141,611,3998,766,3092,133,371,4362
72,Iraq,2020,IRQ-20/3884/RA2/P/INGO/17993,1/19/2022 11:34:58 AM,Returnees,76,728,42,220,1066,389,2170,80,295,2934
72,Iraq,2020,IRQ-20/3884/RA2/P/INGO/17998,2/2/2022 2:56:15 PM,Host Communities,25,25,50,50,150,25,27,43,47,142
72,Iraq,2020,IRQ-20/3884/RA2/P/INGO/17998,2/2/2022 2:56:15 PM,Internally Displaced People,50,50,50,50,200,62,74,196,188,520
72,Iraq,2020,IRQ-20/3884/RA2/P/INGO/17998,2/2/2022 2:56:15 PM,Overall,175,175,300,300,950,324,253,522,508,1607
72,Iraq,2020,IRQ-20/3884/RA2/P/INGO/17998,2/2/2022 2:56:15 PM,Returnees,100,100,200,200,600,237,152,283,273,945
72,Iraq,2020,IRQ-20/3884/RA2/P/INGO/18001,2/2/2022 2:48:17 PM,Internally Displaced People,142,142,0,0,284,686,670,45,44,1445
72,Iraq,2020,IRQ-20/3884/RA2/P/INGO/18001,2/2/2022 2:48:17 PM,Overall,981,981,0,0,1962,1827,2057,109,94,4087
72,Iraq,2020,IRQ-20/3884/RA2/P/INGO/18001,2/2/2022 2:48:17 PM,Returnees,839,839,0,0,1678,1141,1387,64,50,2642
72,Iraq,2020,IRQ-20/3884/RA2/P/INGO/18007,2/14/2022 7:55:58 AM,Host Communities,302,603,151,452,1508,151,970,139,477,1737
72,Iraq,2020,IRQ-20/3884/RA2/P/INGO/18007,2/14/2022 7:55:58 AM,Internally Displaced People,603,1206,302,904,3015,303,1932,276,954,3465
72,Iraq,2020,IRQ-20/3884/RA2/P/INGO/18007,2/14/2022 7:55:58 AM,Overall,2865,6331,1659,4220,15075,1514,9674,1382,4772,17342
72,Iraq,2020,IRQ-20/3884/RA2/P/INGO/18007,2/14/2022 7:55:58 AM,Returnees,1960,4522,1206,2864,10552,1060,6772,967,3341,12140
72,Iraq,2020,IRQ-20/3884/RA2/P/INGO/18009,2/27/2023 2:15:04 PM,Host Communities,84,84,51,51,270,0,0,0,0,0
72,Iraq,2020,IRQ-20/3884/RA2/P/INGO/18009,2/27/2023 2:15:04 PM,Internally Displaced People,168,168,102,102,540,377,388,211,176,1152
72,Iraq,2020,IRQ-20/3884/RA2/P/INGO/18009,2/27/2023 2:15:04 PM,Overall,840,840,510,510,2700,815,810,687,544,2856
72,Iraq,2020,IRQ-20/3884/RA2/P/INGO/18009,2/27/2023 2:15:04 PM,Returnees,588,588,357,357,1890,438,422,476,368,1704
72,Iraq,2020,IRQ-20/3884/RA2/WASH/INGO/17996,2/3/2022 1:16:14 PM,Internally Displaced People,1683,1681,1743,1742,6849,1885,1985,2544,2447,8861
72,Iraq,2020,IRQ-20/3884/RA2/WASH/INGO/17996,2/3/2022 1:16:14 PM,Overall,5013,5009,5224,5221,20467,5183,5632,7062,6830,24707
72,Iraq,2020,IRQ-20/3884/RA2/WASH/INGO/17996,2/3/2022 1:16:14 PM,Returnees,3330,3328,3481,3479,13618,3298,3647,4518,4383,15846
72,Iraq,2020,IRQ-20/3884/SA1/CASH/INGO/16416,10/10/2021 10:26:35 AM,Internally Displaced People,361,375,332,318,1386,38,28,33,27,126
72,Iraq,2020,IRQ-20/3884/SA1/CASH/INGO/16416,10/10/2021 10:26:35 AM,Overall,1802,1872,1663,1593,6930,2050,2295,2157,2078,8580
72,Iraq,2020,IRQ-20/3884/SA1/CASH/INGO/16416,10/10/2021 10:26:35 AM,Returnees,1441,1497,1331,1275,5544,2012,2267,2124,2051,8454
72,Iraq,2020,IRQ-20/3884/SA1/CASH/INGO/16650,10/10/2021 9:58:16 AM,Host Communities,61,61,122,122,366,92,130,88,79,389
72,Iraq,2020,IRQ-20/3884/SA1/CASH/INGO/16650,10/10/2021 9:58:16 AM,Internally Displaced People,555,555,1110,1110,3330,1114,1475,1106,1063,4758
72,Iraq,2020,IRQ-20/3884/SA1/CASH/INGO/16650,10/10/2021 9:58:16 AM,Overall,616,616,1232,1232,3696,1206,1605,1194,1142,5147
72,Iraq,2020,IRQ-20/3884/SA1/CASH/NGO/16307,4/4/2022 7:05:02 AM,Host Communities,192,268,138,168,766,17,13,18,17,65
72,Iraq,2020,IRQ-20/3884/SA1/CASH/NGO/16307,4/4/2022 7:05:02 AM,Internally Displaced People,268,374,192,236,1070,6,8,6,8,28
72,Iraq,2020,IRQ-20/3884/SA1/CASH/NGO/16307,4/4/2022 7:05:02 AM,Overall,766,1070,550,674,3060,708,808,859,751,3126
72,Iraq,2020,IRQ-20/3884/SA1/CASH/NGO/16307,4/4/2022 7:05:02 AM,Returnees,306,428,220,270,1224,685,787,835,726,3033
72,Iraq,2020,IRQ-20/3884/SA1/CCCM/INGO/16400,3/31/2022 6:43:46 AM,Host Communities,150,150,150,150,600,201,374,259,153,987
72,Iraq,2020,IRQ-20/3884/SA1/CCCM/INGO/16400,3/31/2022 6:43:46 AM,Internally Displaced People,881,827,916,1586,4210,1027,1252,1387,1570,5236
72,Iraq,2020,IRQ-20/3884/SA1/CCCM/INGO/16400,3/31/2022 6:43:46 AM,Overall,1031,977,1066,1736,4810,1228,1626,1646,1723,6223
72,Iraq,2020,IRQ-20/3884/SA1/CCCM/INGO/16449,10/11/2022 6:46:08 AM,Host Communities,178,197,208,260,843,61,100,104,100,365
72,Iraq,2020,IRQ-20/3884/SA1/CCCM/INGO/16449,10/11/2022 6:46:08 AM,Internally Displaced People,2247,3806,4516,5143,15712,1000,1271,1891,1718,5880
72,Iraq,2020,IRQ-20/3884/SA1/CCCM/INGO/16449,10/11/2022 6:46:08 AM,Overall,2425,4003,4724,5403,16555,1061,1371,1995,1818,6245
72,Iraq,2020,IRQ-20/3884/SA1/CCCM/INGO/16458,9/5/2022 6:51:17 AM,Internally Displaced People,1355,1408,1655,1720,6138,2154,2153,1871,1758,7936
72,Iraq,2020,IRQ-20/3884/SA1/CCCM/INGO/16458,9/5/2022 6:51:17 AM,Overall,1355,1408,1655,1720,6138,2154,2153,1871,1758,7936
72,Iraq,2020,IRQ-20/3884/SA1/CCS/UN/16463,3/30/2022 5:51:08 AM,Host Communities,520,174,14,4,712,2195,1181,31,23,3430
72,Iraq,2020,IRQ-20/3884/SA1/CCS/UN/16463,3/30/2022 5:51:08 AM,Internally Displaced People,17932,6018,491,123,24564,15722,7933,81,27,23763
72,Iraq,2020,IRQ-20/3884/SA1/CCS/UN/16463,3/30/2022 5:51:08 AM,Overall,25209,8460,690,173,34532,31294,15283,188,69,46834
72,Iraq,2020,IRQ-20/3884/SA1/CCS/UN/16463,3/30/2022 5:51:08 AM,Returnees,6757,2268,185,46,9256,13377,6169,76,19,19641
72,Iraq,2020,IRQ-20/3884/SA1/E/UN/16444,11/14/2021 2:21:05 PM,Host Communities,0,0,4992,4608,9600,0,0,9873,11831,21704
72,Iraq,2020,IRQ-20/3884/SA1/E/UN/16444,11/14/2021 2:21:05 PM,Other,140,60,0,0,200,140,60,0,0,200
72,Iraq,2020,IRQ-20/3884/SA1/E/UN/16444,11/14/2021 2:21:05 PM,Overall,140,60,31200,28800,60200,140,60,32358,28091,60649
72,Iraq,2020,IRQ-20/3884/SA1/E/UN/16444,11/14/2021 2:21:05 PM,Returnees,0,0,26208,24192,50400,0,0,22485,16260,38745
72,Iraq,2020,IRQ-20/3884/SA1/E-P/INGO/16439,11/11/2021 8:18:01 AM,Host Communities,268,216,1348,895,2727,1004,514,2008,1826,5352
72,Iraq,2020,IRQ-20/3884/SA1/E-P/INGO/16439,11/11/2021 8:18:01 AM,Internally Displaced People,40,40,162,155,397,76,165,124,183,548
72,Iraq,2020,IRQ-20/3884/SA1/E-P/INGO/16439,11/11/2021 8:18:01 AM,Overall,2379,2317,10063,9276,24035,3201,2627,9429,8495,23752
72,Iraq,2020,IRQ-20/3884/SA1/E-P/INGO/16439,11/11/2021 8:18:01 AM,Returnees,2071,2061,8553,8226,20911,2121,1948,7297,6486,17852
72,Iraq,2020,IRQ-20/3884/SA1/F/INGO/16428,2/13/2022 8:58:26 AM,Host Communities,249,171,118,108,646,322,214,207,203,946
72,Iraq,2020,IRQ-20/3884/SA1/F/INGO/16428,2/13/2022 8:58:26 AM,Internally Displaced People,791,576,442,405,2214,765,557,626,609,2557
72,Iraq,2020,IRQ-20/3884/SA1/F/INGO/16428,2/13/2022 8:58:26 AM,Overall,4213,3044,2301,2106,11664,4125,2850,3337,3360,13672
72,Iraq,2020,IRQ-20/3884/SA1/F/INGO/16428,2/13/2022 8:58:26 AM,Returnees,3173,2297,1741,1593,8804,3038,2079,2504,2548,10169
72,Iraq,2020,IRQ-20/3884/SA1/H/INGO/16330,1/19/2022 11:40:17 AM,Host Communities,15492,18683,16478,15818,66471,33826,37464,8750,9444,89484
72,Iraq,2020,IRQ-20/3884/SA1/H/INGO/16330,1/19/2022 11:40:17 AM,Internally Displaced People,4764,5784,5143,4937,20628,4268,5363,3161,3322,16114
72,Iraq,2020,IRQ-20/3884/SA1/H/INGO/16330,1/19/2022 11:40:17 AM,Overall,26428,31967,28299,27166,113860,44402,50876,17307,18105,130690
72,Iraq,2020,IRQ-20/3884/SA1/H/INGO/16330,1/19/2022 11:40:17 AM,Returnees,6172,7500,6678,6411,26761,6308,8049,5396,5339,25092
72,Iraq,2020,IRQ-20/3884/SA1/H/UN/16295,2/8/2023 4:29:37 PM,Host Communities,0,18316,15282,14998,48596,1786299,1707177,16642,15898,3526016
72,Iraq,2020,IRQ-20/3884/SA1/H/UN/16295,2/8/2023 4:29:37 PM,Internally Displaced People,47680,96370,80452,79917,304419,52482,102787,84371,84369,324009
72,Iraq,2020,IRQ-20/3884/SA1/H/UN/16295,2/8/2023 4:29:37 PM,Other,0,178408,361848,347739,887995,0,181093,364694,350807,896594
72,Iraq,2020,IRQ-20/3884/SA1/H/UN/16295,2/8/2023 4:29:37 PM,Overall,47680,293094,457582,442654,1241010,1838781,1991057,465707,451074,4746619
72,Iraq,2020,IRQ-20/3884/SA1/P/INGO/16409,2/14/2022 7:43:44 AM,Host Communities,979,1254,138,138,2509,2958,876,0,8,3842
72,Iraq,2020,IRQ-20/3884/SA1/P/INGO/16409,2/14/2022 7:43:44 AM,Internally Displaced People,4792,6141,674,674,12281,2576,1669,10,72,4327
72,Iraq,2020,IRQ-20/3884/SA1/P/INGO/16409,2/14/2022 7:43:44 AM,Overall,8350,10700,1175,1175,21400,11222,5039,71,144,16476
72,Iraq,2020,IRQ-20/3884/SA1/P/INGO/16409,2/14/2022 7:43:44 AM,Returnees,2579,3305,363,363,6610,5688,2494,61,64,8307
72,Iraq,2020,IRQ-20/3884/SA1/P/INGO/16411,11/14/2021 10:33:02 AM,Internally Displaced People,491,706,368,670,2235,887,1593,784,856,4120
72,Iraq,2020,IRQ-20/3884/SA1/P/INGO/16411,11/14/2021 10:33:02 AM,Overall,1502,1867,1076,1527,5972,1199,2922,1042,1135,6298
72,Iraq,2020,IRQ-20/3884/SA1/P/INGO/16411,11/14/2021 10:33:02 AM,Returnees,1011,1161,708,857,3737,312,1329,258,279,2178
72,Iraq,2020,IRQ-20/3884/SA1/P/INGO/16422,1/19/2022 1:03:18 PM,Host Communities,5171,5979,2586,2424,16160,7349,20194,3794,6783,38120
72,Iraq,2020,IRQ-20/3884/SA1/P/INGO/16422,1/19/2022 1:03:18 PM,Internally Displaced People,431,499,216,202,1348,605,1659,425,557,3246
72,Iraq,2020,IRQ-20/3884/SA1/P/INGO/16422,1/19/2022 1:03:18 PM,Overall,7359,8510,3681,3450,23000,10068,27661,5311,9290,52330
72,Iraq,2020,IRQ-20/3884/SA1/P/INGO/16422,1/19/2022 1:03:18 PM,Returnees,1757,2032,879,824,5492,2114,5808,1092,1950,10964
72,Iraq,2020,IRQ-20/3884/SA1/P/INGO/16429,1/19/2022 1:19:07 PM,Host Communities,5530,7100,3555,3555,19740,9175,9308,9455,8465,36403
72,Iraq,2020,IRQ-20/3884/SA1/P/INGO/16429,1/19/2022 1:19:07 PM,Internally Displaced People,2212,2844,1422,1422,7900,510,327,798,776,2411
72,Iraq,2020,IRQ-20/3884/SA1/P/INGO/16429,1/19/2022 1:19:07 PM,Overall,11060,14211,7110,7110,39491,12976,13636,14820,13690,55122
72,Iraq,2020,IRQ-20/3884/SA1/P/INGO/16429,1/19/2022 1:19:07 PM,Returnees,3318,4267,2133,2133,11851,3291,4001,4567,4449,16308
72,Iraq,2020,IRQ-20/3884/SA1/P/INGO/16452,10/24/2021 8:39:44 AM,Internally Displaced People,1440,1440,2160,2160,7200,2953,3109,3216,3087,12365
72,Iraq,2020,IRQ-20/3884/SA1/P/INGO/16452,10/24/2021 8:39:44 AM,Overall,3081,2357,2160,2160,9758,3936,4113,4033,3908,15990
72,Iraq,2020,IRQ-20/3884/SA1/P/INGO/16452,10/24/2021 8:39:44 AM,Returnees,1641,917,0,0,2558,983,1004,817,821,3625
72,Iraq,2020,IRQ-20/3884/SA1/P/INGO/16461,11/28/2021 2:24:55 PM,Internally Displaced People,800,800,1242,1209,4051,465,698,1757,1511,4431
72,Iraq,2020,IRQ-20/3884/SA1/P/INGO/16461,11/28/2021 2:24:55 PM,Overall,3200,3200,4970,4835,16205,3010,2936,6886,5981,18813
72,Iraq,2020,IRQ-20/3884/SA1/P/INGO/16461,11/28/2021 2:24:55 PM,Returnees,2400,2400,3728,3626,12154,2545,2238,5129,4470,14382
72,Iraq,2020,IRQ-20/3884/SA1/WASH/INGO/16290,3/10/2022 6:19:34 AM,Host Communities,13067,18509,14410,14857,60843,18965,29027,25188,23757,96937
72,Iraq,2020,IRQ-20/3884/SA1/WASH/INGO/16290,3/10/2022 6:19:34 AM,Internally Displaced People,14985,17851,17379,17864,68079,19780,21725,23507,22334,87346
72,Iraq,2020,IRQ-20/3884/SA1/WASH/INGO/16290,3/10/2022 6:19:34 AM,Overall,42029,50825,44704,46875,184433,59406,73006,75431,70965,278808
72,Iraq,2020,IRQ-20/3884/SA1/WASH/INGO/16290,3/10/2022 6:19:34 AM,Returnees,13977,14465,12915,14154,55511,20661,22254,26736,24874,94525
72,Iraq,2021,IRQ-21/3884/RA1/CASH/INGO/20924,1/15/2023 11:01:48 AM,Host Communities,31,31,62,62,186,226,439,185,216,1066
72,Iraq,2021,IRQ-21/3884/RA1/CASH/INGO/20924,1/15/2023 11:01:48 AM,Internally Displaced People,312,312,624,624,1872,140,277,132,131,680
72,Iraq,2021,IRQ-21/3884/RA1/CASH/INGO/20924,1/15/2023 11:01:48 AM,Overall,630,630,1260,1260,3780,1021,1475,752,849,4097
72,Iraq,2021,IRQ-21/3884/RA1/CASH/INGO/20924,1/15/2023 11:01:48 AM,Returnees,287,287,574,574,1722,655,759,435,502,2351
72,Iraq,2021,IRQ-21/3884/RA1/CASH/INGO/21006,2/7/2023 2:18:26 PM,Internally Displaced People,874,496,44,44,1458,15,15,23,14,67
72,Iraq,2021,IRQ-21/3884/RA1/CASH/INGO/21006,2/7/2023 2:18:26 PM,Overall,2498,1416,125,125,4164,985,1110,1521,1437,5053
72,Iraq,2021,IRQ-21/3884/RA1/CASH/INGO/21006,2/7/2023 2:18:26 PM,Returnees,1624,920,81,81,2706,970,1095,1498,1423,4986
72,Iraq,2021,IRQ-21/3884/RA1/CASH-H/INGO/20914,1/15/2023 11:25:06 AM,Host Communities,75,79,36,36,226,1114,1155,1081,1089,4439
72,Iraq,2021,IRQ-21/3884/RA1/CASH-H/INGO/20914,1/15/2023 11:25:06 AM,Internally Displaced People,1405,1497,683,683,4268,334,344,335,318,1331
72,Iraq,2021,IRQ-21/3884/RA1/CASH-H/INGO/20914,1/15/2023 11:25:06 AM,Other,22,10,0,0,32,184,172,188,177,721
72,Iraq,2021,IRQ-21/3884/RA1/CASH-H/INGO/20914,1/15/2023 11:25:06 AM,Overall,1502,1586,719,719,4526,1632,1671,1604,1584,6491
72,Iraq,2021,IRQ-21/3884/RA1/H/INGO/20880,2/8/2023 9:06:47 AM,Host Communities,10704,14409,8234,7820,41167,8599,11589,6615,6271,33074
72,Iraq,2021,IRQ-21/3884/RA1/H/INGO/20880,2/8/2023 9:06:47 AM,Internally Displaced People,1469,1977,1135,1077,5658,1525,2006,1158,1100,5789
72,Iraq,2021,IRQ-21/3884/RA1/H/INGO/20880,2/8/2023 9:06:47 AM,Overall,16924,22782,13024,12370,65100,14644,19673,11234,10661,56212
72,Iraq,2021,IRQ-21/3884/RA1/H/INGO/20880,2/8/2023 9:06:47 AM,Returnees,4751,6396,3655,3473,18275,4520,6078,3461,3290,17349
72,Iraq,2021,IRQ-21/3884/RA1/H/NGO/20961,1/31/2023 10:03:49 AM,Host Communities,23129,27219,10126,10510,70984,27208,28810,15091,16209,87318
72,Iraq,2021,IRQ-21/3884/RA1/H/NGO/20961,1/31/2023 10:03:49 AM,Internally Displaced People,10999,12099,8033,6770,37901,5820,7737,3647,3989,21193
72,Iraq,2021,IRQ-21/3884/RA1/H/NGO/20961,1/31/2023 10:03:49 AM,Overall,62818,70226,28085,28461,189590,68469,84603,32724,34748,220544
72,Iraq,2021,IRQ-21/3884/RA1/H/NGO/20961,1/31/2023 10:03:49 AM,Returnees,28690,30908,9926,11181,80705,35441,48056,13986,14550,112033
72,Iraq,2021,IRQ-21/3884/RA1/P/INGO/20872,4/20/2023 12:21:13 PM,Host Communities,462,405,227,219,1313,95,177,29,82,383
72,Iraq,2021,IRQ-21/3884/RA1/P/INGO/20872,4/20/2023 12:21:13 PM,Internally Displaced People,2298,1648,1250,1000,6196,2230,2377,1536,580,6723
72,Iraq,2021,IRQ-21/3884/RA1/P/INGO/20872,4/20/2023 12:21:13 PM,Overall,6915,5700,3515,3190,19320,5254,8038,3909,2755,19956
72,Iraq,2021,IRQ-21/3884/RA1/P/INGO/20872,4/20/2023 12:21:13 PM,Returnees,4155,3647,2038,1971,11811,2929,5484,2344,2093,12850
72,Iraq,2021,IRQ-21/3884/RA1/P/INGO/20887,3/10/2023 2:57:52 PM,Internally Displaced People,383,573,888,1346,3190,952,1024,825,888,3689
72,Iraq,2021,IRQ-21/3884/RA1/P/INGO/20887,3/10/2023 2:57:52 PM,Overall,1505,2256,3506,5273,12540,3202,3149,4201,4210,14762
72,Iraq,2021,IRQ-21/3884/RA1/P/INGO/20887,3/10/2023 2:57:52 PM,Returnees,1122,1683,2618,3927,9350,2250,2125,3376,3322,11073
72,Iraq,2021,IRQ-21/3884/RA1/P/INGO/20897,1/9/2023 5:16:18 AM,Internally Displaced People,360,540,360,540,1800,571,586,485,511,2153
72,Iraq,2021,IRQ-21/3884/RA1/P/INGO/20897,1/9/2023 5:16:18 AM,Overall,1800,2700,1800,2700,9000,4313,4306,3691,3705,16015
72,Iraq,2021,IRQ-21/3884/RA1/P/INGO/20897,1/9/2023 5:16:18 AM,Returnees,1440,2160,1440,2160,7200,3742,3720,3206,3194,13862
72,Iraq,2021,IRQ-21/3884/RA1/P/INGO/20929,2/27/2023 2:08:43 PM,Host Communities,240,250,70,85,645,147,126,21,37,331
72,Iraq,2021,IRQ-21/3884/RA1/P/INGO/20929,2/27/2023 2:08:43 PM,Internally Displaced People,1250,1550,265,298,3363,1422,1576,208,219,3425
72,Iraq,2021,IRQ-21/3884/RA1/P/INGO/20929,2/27/2023 2:08:43 PM,Overall,3315,3845,725,815,8700,3462,3028,476,528,7494
72,Iraq,2021,IRQ-21/3884/RA1/P/INGO/20929,2/27/2023 2:08:43 PM,Returnees,1825,2045,390,432,4692,1893,1326,247,272,3738
72,Iraq,2021,IRQ-21/3884/RA1/P-WASH/INGO/21005,3/1/2023 8:47:48 AM,Internally Displaced People,1050,1350,1700,1900,6000,1050,1350,1700,1900,6000
72,Iraq,2021,IRQ-21/3884/RA1/P-WASH/INGO/21005,3/1/2023 8:47:48 AM,Overall,1150,1450,1740,1940,6280,1150,1450,1740,1940,6280
72,Iraq,2021,IRQ-21/3884/RA1/P-WASH/INGO/21005,3/1/2023 8:47:48 AM,Returnees,100,100,40,40,280,100,100,40,40,280
72,Iraq,2021,IRQ-21/3884/RA1/WASH/INGO/20881,1/11/2023 1:15:16 PM,Internally Displaced People,1094,1093,1591,1567,5345,2989,3426,3098,3110,12623
72,Iraq,2021,IRQ-21/3884/RA1/WASH/INGO/20881,1/11/2023 1:15:16 PM,Overall,9544,10144,10992,11151,41831,20282,22380,18043,18345,79050
72,Iraq,2021,IRQ-21/3884/RA1/WASH/INGO/20881,1/11/2023 1:15:16 PM,Returnees,8450,9051,9401,9584,36486,17293,18954,14945,15235,66427
72,Iraq,2021,IRQ-21/3884/RA1/WASH/INGO/20895,2/17/2023 10:30:53 PM,Internally Displaced People,692,718,564,590,2564,563,770,626,706,2665
72,Iraq,2021,IRQ-21/3884/RA1/WASH/INGO/20895,2/17/2023 10:30:53 PM,Other,25,5,0,0,30,11,1,0,0,12
72,Iraq,2021,IRQ-21/3884/RA1/WASH/INGO/20895,2/17/2023 10:30:53 PM,Overall,4143,4275,3355,3508,15281,4701,6420,5216,5885,22222
72,Iraq,2021,IRQ-21/3884/RA1/WASH/INGO/20895,2/17/2023 10:30:53 PM,Returnees,3426,3552,2791,2918,12687,4127,5649,4590,5179,19545
72,Iraq,2021,IRQ-21/3884/RA1/WASH/INGO/20960,1/6/2023 11:29:39 AM,Internally Displaced People,1495,1495,1755,1755,6500,1717,1764,2041,2130,7652
72,Iraq,2021,IRQ-21/3884/RA1/WASH/INGO/20960,1/6/2023 11:29:39 AM,Overall,4163,4163,4887,4887,18100,4559,4603,5370,5396,19928
72,Iraq,2021,IRQ-21/3884/RA1/WASH/INGO/20960,1/6/2023 11:29:39 AM,Returnees,2668,2668,3132,3132,11600,2842,2839,3329,3266,12276
72,Iraq,2021,IRQ-21/3884/SA1/EL/INGO/18537,1/3/2023 10:16:23 AM,Host Communities,29,23,104,104,260,24,15,54,54,147
72,Iraq,2021,IRQ-21/3884/SA1/EL/INGO/18537,1/3/2023 10:16:23 AM,Internally Displaced People,51,37,176,176,440,29,27,70,70,196
72,Iraq,2021,IRQ-21/3884/SA1/EL/INGO/18537,1/3/2023 10:16:23 AM,Overall,209,152,722,722,1805,218,144,598,598,1558
72,Iraq,2021,IRQ-21/3884/SA1/EL/INGO/18537,1/3/2023 10:16:23 AM,Returnees,129,92,442,442,1105,165,102,474,474,1215
72,Iraq,2021,IRQ-21/3884/SA1/EL/INGO/18554,1/18/2023 1:01:07 PM,Internally Displaced People,175,170,121,114,580,274,262,286,271,1093
72,Iraq,2021,IRQ-21/3884/SA1/EL/INGO/18554,1/18/2023 1:01:07 PM,Overall,860,1095,580,735,3270,1263,1418,1199,1194,5074
72,Iraq,2021,IRQ-21/3884/SA1/EL/INGO/18554,1/18/2023 1:01:07 PM,Returnees,685,925,459,621,2690,989,1156,913,923,3981
72,Iraq,2021,IRQ-21/3884/SA1/F/INGO/18544,12/27/2022 11:59:15 AM,Internally Displaced People,325,200,1050,1050,2625,73,48,242,242,605
72,Iraq,2021,IRQ-21/3884/SA1/F/INGO/18544,12/27/2022 11:59:15 AM,Overall,650,400,2100,2100,5250,638,426,2128,2128,5320
72,Iraq,2021,IRQ-21/3884/SA1/F/INGO/18544,12/27/2022 11:59:15 AM,Returnees,325,200,1050,1050,2625,565,378,1886,1886,4715
72,Iraq,2021,IRQ-21/3884/SA1/F/INGO/18651,3/1/2023 8:34:05 AM,Internally Displaced People,183,187,172,170,712,6,6,7,7,26
72,Iraq,2021,IRQ-21/3884/SA1/F/INGO/18651,3/1/2023 8:34:05 AM,Overall,1178,1195,1092,1075,4540,865,799,738,801,3203
72,Iraq,2021,IRQ-21/3884/SA1/F/INGO/18651,3/1/2023 8:34:05 AM,Returnees,995,1008,920,905,3828,859,793,731,794,3177
72,Iraq,2021,IRQ-21/3884/SA1/H/INGO/18518,9/6/2022 8:23:36 AM,Host Communities,7293,7894,3669,3700,22556,28108,46195,63555,75252,213110
72,Iraq,2021,IRQ-21/3884/SA1/H/INGO/18518,9/6/2022 8:23:36 AM,Internally Displaced People,22979,28373,22578,24716,98646,11108,15125,27475,33276,86984
72,Iraq,2021,IRQ-21/3884/SA1/H/INGO/18518,9/6/2022 8:23:36 AM,Other,704,727,0,0,1431,672,799,0,0,1471
72,Iraq,2021,IRQ-21/3884/SA1/H/INGO/18518,9/6/2022 8:23:36 AM,Overall,59537,71548,53591,59297,243973,103371,137703,140953,167180,549207
72,Iraq,2021,IRQ-21/3884/SA1/H/INGO/18518,9/6/2022 8:23:36 AM,Returnees,28561,34554,27344,30881,121340,63483,75584,49923,58652,247642
72,Iraq,2021,IRQ-21/3884/SA1/P/INGO/18551,2/13/2023 2:59:19 PM,Host Communities,359,330,470,463,1622,488,442,689,567,2186
72,Iraq,2021,IRQ-21/3884/SA1/P/INGO/18551,2/13/2023 2:59:19 PM,Internally Displaced People,886,812,1145,1126,3969,1211,1558,2571,2657,7997
72,Iraq,2021,IRQ-21/3884/SA1/P/INGO/18551,2/13/2023 2:59:19 PM,Overall,2905,2605,3400,3325,12235,3295,3745,5060,4876,16976
72,Iraq,2021,IRQ-21/3884/SA1/P/INGO/18551,2/13/2023 2:59:19 PM,Returnees,1660,1463,1785,1736,6644,1596,1745,1800,1652,6793
72,Iraq,2021,IRQ-21/3884/SA1/P/INGO/18552,2/8/2023 9:11:27 AM,Host Communities,753,771,736,754,3014,3552,2918,1983,1606,10059
72,Iraq,2021,IRQ-21/3884/SA1/P/INGO/18552,2/8/2023 9:11:27 AM,Internally Displaced People,2260,2315,2178,2233,8986,6998,5116,1373,1069,14556
72,Iraq,2021,IRQ-21/3884/SA1/P/INGO/18552,2/8/2023 9:11:27 AM,Overall,7536,7720,7260,7444,29960,19381,15174,4882,4135,43572
72,Iraq,2021,IRQ-21/3884/SA1/P/INGO/18552,2/8/2023 9:11:27 AM,Returnees,4523,4634,4346,4457,17960,8831,7140,1526,1460,18957
72,Iraq,2021,IRQ-21/3884/SA1/P/INGO/18586,2/28/2023 11:44:37 AM,Host Communities,4,6,0,0,10,1,0,0,1,2
72,Iraq,2021,IRQ-21/3884/SA1/P/INGO/18586,2/28/2023 11:44:37 AM,Internally Displaced People,287,282,78,78,725,171,173,130,128,602
72,Iraq,2021,IRQ-21/3884/SA1/P/INGO/18586,2/28/2023 11:44:37 AM,Overall,1065,1025,240,240,2570,1156,1695,247,233,3331
72,Iraq,2021,IRQ-21/3884/SA1/P/INGO/18586,2/28/2023 11:44:37 AM,Returnees,774,737,162,162,1835,984,1522,117,104,2727
72,Iraq,2021,IRQ-21/3884/SA1/P/INGO/18778,10/27/2022 11:45:14 AM,Host Communities,439,1295,395,727,2856,709,2296,564,1220,4789
72,Iraq,2021,IRQ-21/3884/SA1/P/INGO/18778,10/27/2022 11:45:14 AM,Internally Displaced People,1547,5110,1338,3482,11477,1057,3792,757,1397,7003
72,Iraq,2021,IRQ-21/3884/SA1/P/INGO/18778,10/27/2022 11:45:14 AM,Overall,4360,13457,3595,8988,30400,5759,21141,5487,9141,41528
72,Iraq,2021,IRQ-21/3884/SA1/P/INGO/18778,10/27/2022 11:45:14 AM,Returnees,2374,7052,1862,4779,16067,3993,15053,4166,6524,29736
72,Iraq,2021,IRQ-21/3884/SA1/P-H/INGO/18791,6/23/2022 10:55:09 AM,Host Communities,43,33,20,13,109,82,187,30,23,322
72,Iraq,2021,IRQ-21/3884/SA1/P-H/INGO/18791,6/23/2022 10:55:09 AM,Internally Displaced People,62,49,31,20,162,14,46,9,8,77
72,Iraq,2021,IRQ-21/3884/SA1/P-H/INGO/18791,6/23/2022 10:55:09 AM,Other,20,10,0,0,30,20,11,0,0,31
72,Iraq,2021,IRQ-21/3884/SA1/P-H/INGO/18791,6/23/2022 10:55:09 AM,Overall,212,159,93,59,523,140,301,46,36,523
72,Iraq,2021,IRQ-21/3884/SA1/P-H/INGO/18791,6/23/2022 10:55:09 AM,Returnees,87,67,42,26,222,24,57,7,5,93
72,Iraq,2021,IRQ-21/3884/SA1/WASH/INGO/18523,9/25/2022 9:14:04 AM,Host Communities,444,425,756,727,2352,705,791,788,709,2993
72,Iraq,2021,IRQ-21/3884/SA1/WASH/INGO/18523,9/25/2022 9:14:04 AM,Internally Displaced People,14768,16581,14960,16791,63100,12961,14324,9898,10399,47582
72,Iraq,2021,IRQ-21/3884/SA1/WASH/INGO/18523,9/25/2022 9:14:04 AM,Overall,23718,25743,25274,28376,103111,32157,45224,39416,43221,160018
72,Iraq,2021,IRQ-21/3884/SA1/WASH/INGO/18523,9/25/2022 9:14:04 AM,Returnees,8506,8737,9558,10858,37659,18491,30109,28730,32113,109443
72,Iraq,2022,IRQ-22/3884/SA1/CASH/INGO/22386,7/28/2023 4:55:44 PM,Internally Displaced People,828,862,564,576,2830,580,715,588,584,2467
72,Iraq,2022,IRQ-22/3884/SA1/CASH/INGO/22386,7/28/2023 4:55:44 PM,Overall,1829,1905,1243,1278,6255,1433,1977,1713,1729,6852
72,Iraq,2022,IRQ-22/3884/SA1/CASH/INGO/22386,7/28/2023 4:55:44 PM,Returnees,1001,1043,679,702,3425,853,1262,1125,1145,4385
72,Iraq,2022,IRQ-22/3884/SA1/CASH/INGO/22457,8/7/2023 10:08:01 PM,Host Communities,71,71,104,104,350,229,276,195,183,883
72,Iraq,2022,IRQ-22/3884/SA1/CASH/INGO/22457,8/7/2023 10:08:01 PM,Internally Displaced People,384,384,768,768,2304,126,149,138,138,551
72,Iraq,2022,IRQ-22/3884/SA1/CASH/INGO/22457,8/7/2023 10:08:01 PM,Overall,955,955,1872,1872,5654,1140,1385,1299,1310,5134
72,Iraq,2022,IRQ-22/3884/SA1/CASH/INGO/22457,8/7/2023 10:08:01 PM,Returnees,500,500,1000,1000,3000,785,960,966,989,3700
72,Iraq,2022,IRQ-22/3884/SA1/P/INGO/22383,5/11/2023 9:09:57 AM,Internally Displaced People,580,552,800,828,2760,842,937,654,612,3045
72,Iraq,2022,IRQ-22/3884/SA1/P/INGO/22383,5/11/2023 9:09:57 AM,Overall,1525,1452,2105,2178,7260,2600,2814,2297,2220,9931
72,Iraq,2022,IRQ-22/3884/SA1/P/INGO/22383,5/11/2023 9:09:57 AM,Returnees,945,900,1305,1350,4500,1758,1877,1643,1608,6886
72,Iraq,2022,IRQ-22/3884/SA1/P/INGO/22456,8/1/2023 9:19:32 AM,Internally Displaced People,1433,2179,359,406,4377,1938,2136,81,93,4248
72,Iraq,2022,IRQ-22/3884/SA1/P/INGO/22456,8/1/2023 9:19:32 AM,Other,21,15,0,0,36,24,14,0,0,38
72,Iraq,2022,IRQ-22/3884/SA1/P/INGO/22456,8/1/2023 9:19:32 AM,Overall,4335,6225,1157,1267,12984,6483,7278,1248,1323,16332
72,Iraq,2022,IRQ-22/3884/SA1/P/INGO/22456,8/1/2023 9:19:32 AM,Returnees,2881,4031,798,861,8571,4521,5128,1167,1230,12046
72,Iraq,2022,IRQ-22/3884/SA1/P/INGO/22461,7/31/2023 8:21:52 AM,Internally Displaced People,290,290,495,495,1570,486,512,758,785,2541
72,Iraq,2022,IRQ-22/3884/SA1/P/INGO/22461,7/31/2023 8:21:52 AM,Overall,3263,3201,6178,6178,18820,3383,3594,6697,6597,20271
72,Iraq,2022,IRQ-22/3884/SA1/P/INGO/22461,7/31/2023 8:21:52 AM,Returnees,2973,2911,5683,5683,17250,2897,3082,5939,5812,17730
72,Iraq,2022,IRQ-22/3884/SA1/P/NGO/22727,7/30/2023 9:16:39 AM,Host Communities,100,67,50,50,267,119,51,11,26,207
72,Iraq,2022,IRQ-22/3884/SA1/P/NGO/22727,7/30/2023 9:16:39 AM,Internally Displaced People,400,315,100,100,915,462,236,45,51,794
72,Iraq,2022,IRQ-22/3884/SA1/P/NGO/22727,7/30/2023 9:16:39 AM,Overall,1150,900,350,350,2750,2244,1378,348,365,4335
72,Iraq,2022,IRQ-22/3884/SA1/P/NGO/22727,7/30/2023 9:16:39 AM,Returnees,650,518,200,200,1568,1663,1091,292,288,3334
72,Iraq,2022,IRQ-22/3884/SA1/WASH/INGO/22425,8/1/2023 9:25:00 AM,Internally Displaced People,1960,1960,1540,1540,7000,3992,3952,2362,2322,12628
72,Iraq,2022,IRQ-22/3884/SA1/WASH/INGO/22425,8/1/2023 9:25:00 AM,Other,32,8,0,0,40,38,7,0,0,45
72,Iraq,2022,IRQ-22/3884/SA1/WASH/INGO/22425,8/1/2023 9:25:00 AM,Overall,6006,5982,4693,4693,21374,8736,9088,7933,8535,34292
72,Iraq,2022,IRQ-22/3884/SA1/WASH/INGO/22425,8/1/2023 9:25:00 AM,Returnees,4014,4014,3153,3153,14334,4706,5129,5571,6213,21619
72,Iraq,2022,IRQ-22/3884/SA1/WASH/INGO/22454,8/1/2023 8:49:03 AM,Internally Displaced People,4688,4852,4645,4535,18720,5843,6607,6622,6249,25321
72,Iraq,2022,IRQ-22/3884/SA1/WASH/INGO/22454,8/1/2023 8:49:03 AM,Overall,12663,12734,13152,12951,51500,18385,20956,21716,20227,81284
72,Iraq,2022,IRQ-22/3884/SA1/WASH/INGO/22454,8/1/2023 8:49:03 AM,Returnees,7975,7882,8507,8416,32780,12542,14349,15094,13978,55963
72,Iraq,2022,IRQ-22/3884/SA1/WASH-P/INGO/22529,8/21/2023 1:40:20 PM,Internally Displaced People,2310,2520,2940,2730,10500,5549,7400,6591,7782,27322
72,Iraq,2022,IRQ-22/3884/SA1/WASH-P/INGO/22529,8/21/2023 1:40:20 PM,Overall,5566,6072,7084,6578,25300,9331,11247,11936,12872,45386
72,Iraq,2022,IRQ-22/3884/SA1/WASH-P/INGO/22529,8/21/2023 1:40:20 PM,Returnees,3256,3552,4144,3848,14800,3782,3847,5345,5090,18064
73,Jordan,2015,JOR-14/DDA-3560/CP/NFI/INGO/1131,3/6/2016 9:49:46 AM,Host Communities,351,474,474,457,1756,390,680,0,0,1070
73,Jordan,2015,JOR-14/DDA-3560/CP/NFI/INGO/1131,3/6/2016 9:49:46 AM,Overall,1170,1579,1579,1522,5850,954,1079,891,960,3884
73,Jordan,2015,JOR-14/DDA-3560/CP/NFI/INGO/1131,3/6/2016 9:49:46 AM,Refugees,819,1105,1105,1065,4094,564,399,891,960,2814
73,Jordan,2015,JOR-14/DDA-3560/CP/NFI/INGO/1134,11/10/2015 12:15:01 PM,Overall,471,575,47,57,1150,158,477,472,431,1538
73,Jordan,2015,JOR-14/DDA-3560/CP/NFI/INGO/1135,4/20/2016 1:18:36 PM,Host Communities,39,43,0,0,82,55,76,65,41,237
73,Jordan,2015,JOR-14/DDA-3560/CP/NFI/INGO/1135,4/20/2016 1:18:36 PM,Overall,390,424,0,0,814,345,583,488,437,1853
73,Jordan,2015,JOR-14/DDA-3560/CP/NFI/INGO/1135,4/20/2016 1:18:36 PM,Refugees,351,381,0,0,732,290,507,423,396,1616
73,Jordan,2015,JOR-15/DDA-3560/CBTF CFP 112015/SRP ERL/INGO/2243,9/19/2017 9:20:08 AM,Host Communities,1589,1590,2023,2023,7225,3227,3094,2618,2707,11646
73,Jordan,2015,JOR-15/DDA-3560/CBTF CFP 112015/SRP ERL/INGO/2243,9/19/2017 9:20:08 AM,Internally Displaced People,280,281,357,357,1275,248,248,250,244,990
73,Jordan,2015,JOR-15/DDA-3560/CBTF CFP 112015/SRP ERL/INGO/2243,9/19/2017 9:20:08 AM,Overall,1479,170,51,0,1700,1001,967,0,0,1968
73,Jordan,2015,JOR-15/DDA-3560/CBTF CFP 112015/SRP ERL/UN/2247,2/7/2017 10:35:33 AM,Host Communities,1589,1590,2023,2023,7225,0,0,0,1546,1546
73,Jordan,2015,JOR-15/DDA-3560/CBTF CFP 112015/SRP ERL/UN/2247,2/7/2017 10:35:33 AM,Internally Displaced People,281,280,357,357,1275,0,0,0,154,154
73,Jordan,2015,JOR-15/DDA-3560/CBTF CFP 112015/SRP ERL/UN/2247,2/7/2017 10:35:33 AM,Overall,1479,170,51,0,1700,1530,170,0,0,1700
73,Jordan,2015,JOR-15/DDA-3560/CBTF CFP 112015/SRP NFI /INGO/2229,9/29/2016 6:36:47 AM,Internally Displaced People,1167,1227,823,864,4081,960,887,1448,1480,4775
73,Jordan,2015,JOR-15/DDA-3560/CBTF CFP 112015/SRP NFI /INGO/2229,9/29/2016 6:36:47 AM,Overall,1167,1227,823,864,4081,960,887,1448,1480,4775
73,Jordan,2015,JOR-15/DDA-3560/CBTF CFP 112015/SRP NFI /UN/2287,4/2/2017 8:47:05 AM,Host Communities,417,417,833,833,2500,2881,2900,1072,1044,7897
73,Jordan,2015,JOR-15/DDA-3560/CBTF CFP 112015/SRP NFI /UN/2287,4/2/2017 8:47:05 AM,Internally Displaced People,417,417,833,833,2500,529,501,199,168,1397
73,Jordan,2015,JOR-15/DDA-3560/CBTF CFP 112015/SRP NFI /UN/2287,4/2/2017 8:47:05 AM,Overall,834,834,1666,1666,5000,2139,2189,1271,1212,6811
73,Jordan,2015,JOR-15/DDA-3560/CBTF CFP 112015/SRP-H/NGO/2238,2/7/2017 10:36:11 AM,Overall,55,25,0,0,80,60,13,0,0,73
73,Jordan,2015,JOR-15/DDA-3560/CBTF CFP 112015/SRP-H/NGO/2246,7/8/2018 12:58:06 PM,Host Communities,1125,2050,1150,1150,5475,1196,1984,414,562,4156
73,Jordan,2015,JOR-15/DDA-3560/CBTF CFP 112015/SRP-H/NGO/2246,7/8/2018 12:58:06 PM,Internally Displaced People,365,725,325,325,1740,599,993,207,281,2080
73,Jordan,2015,JOR-15/DDA-3560/CBTF CFP 112015/SRP-H/NGO/2246,7/8/2018 12:58:06 PM,Overall,1490,2775,1475,1475,7215,1795,2977,621,843,6236
73,Jordan,2015,JOR-15/DDA-3560/CFP Nov 2015/BN/INGO/2197,12/21/2016 1:06:00 PM,Host Communities,111,120,125,125,481,92,158,115,113,478
73,Jordan,2015,JOR-15/DDA-3560/CFP Nov 2015/BN/INGO/2197,12/21/2016 1:06:00 PM,Overall,369,402,416,418,1605,361,489,488,456,1794
73,Jordan,2015,JOR-15/DDA-3560/CFP Nov 2015/BN/INGO/2197,12/21/2016 1:06:00 PM,Refugees,258,282,291,293,1124,269,331,373,343,1316
73,Jordan,2015,JOR-15/DDA-3560/CFP Nov 2015/BN/INGO/2222,12/21/2016 10:30:38 AM,Host Communities,219,273,284,274,1050,239,315,355,325,1234
73,Jordan,2015,JOR-15/DDA-3560/CFP Nov 2015/BN/INGO/2222,12/21/2016 10:30:38 AM,Overall,730,910,946,914,3500,789,924,1202,1131,4046
73,Jordan,2015,JOR-15/DDA-3560/CFP Nov 2015/BN/INGO/2222,12/21/2016 10:30:38 AM,Refugees,511,637,662,640,2450,550,609,847,806,2812
73,Jordan,2015,JOR-15/DDA-3560/CFP Nov 2015/BN/INGO/2251,9/21/2016 12:14:06 PM,Host Communities,459,460,460,460,1839,480,510,482,482,1954
73,Jordan,2015,JOR-15/DDA-3560/CFP Nov 2015/BN/INGO/2251,9/21/2016 12:14:06 PM,Overall,1530,1531,1531,1531,6123,1600,1873,1665,1631,6769
73,Jordan,2015,JOR-15/DDA-3560/CFP Nov 2015/BN/INGO/2251,9/21/2016 12:14:06 PM,Refugees,1071,1071,1071,1071,4284,1120,1363,1183,1149,4815
73,Jordan,2015,JOR-15/DDA-3560/CFP Nov 2015/EDU/INGO/2220,1/3/2017 12:16:02 PM,Overall,185,186,3369,3465,7205,185,186,3201,3164,6736
73,Jordan,2015,JOR-15/DDA-3560/CFP Nov 2015/EDU/INGO/2220,1/3/2017 12:16:02 PM,Refugees,185,186,3369,3465,7205,185,186,3201,3164,6736
73,Jordan,2015,JOR-15/DDA-3560/CFP Nov 2015/EDU/INGO/2250,1/3/2017 12:14:36 PM,Host Communities,0,0,1250,1250,2500,0,0,1131,1206,2337
73,Jordan,2015,JOR-15/DDA-3560/CFP Nov 2015/EDU/INGO/2250,1/3/2017 12:14:36 PM,Overall,0,0,2500,2500,5000,0,0,2510,2499,5009
73,Jordan,2015,JOR-15/DDA-3560/CFP Nov 2015/EDU/INGO/2250,1/3/2017 12:14:36 PM,Refugees,0,0,1250,1250,2500,0,0,1379,1293,2672
73,Jordan,2015,JOR-15/DDA-3560/CFP Nov 2015/H/INGO/2131,9/27/2016 1:08:06 PM,Host Communities,4613,7703,5853,5990,24159,1313,2621,916,972,5822
73,Jordan,2015,JOR-15/DDA-3560/CFP Nov 2015/H/INGO/2131,9/27/2016 1:08:06 PM,Overall,15375,25678,19510,19967,80530,12330,20763,17342,17210,67645
73,Jordan,2015,JOR-15/DDA-3560/CFP Nov 2015/H/INGO/2131,9/27/2016 1:08:06 PM,Refugees,10763,17975,13657,13976,56371,11017,18142,16426,16238,61823
73,Jordan,2015,JOR-15/DDA-3560/CFP Nov 2015/H/INGO/2149,2/2/2017 9:53:00 AM,Host Communities,502,1685,535,518,3240,270,2645,135,207,3257
73,Jordan,2015,JOR-15/DDA-3560/CFP Nov 2015/H/INGO/2149,2/2/2017 9:53:00 AM,Overall,1674,5616,1782,1728,10800,1352,8818,647,941,11758
73,Jordan,2015,JOR-15/DDA-3560/CFP Nov 2015/H/INGO/2149,2/2/2017 9:53:00 AM,Refugees,1172,3931,1247,1210,7560,1082,6173,512,734,8501
73,Jordan,2015,JOR-15/DDA-3560/CFP Nov 2015/H/NGO/2186,4/3/2017 7:32:13 AM,Host Communities,70,250,0,0,320,93,221,0,0,314
73,Jordan,2015,JOR-15/DDA-3560/CFP Nov 2015/H/NGO/2186,4/3/2017 7:32:13 AM,Overall,200,600,0,0,800,236,564,0,0,800
73,Jordan,2015,JOR-15/DDA-3560/CFP Nov 2015/H/NGO/2186,4/3/2017 7:32:13 AM,Refugees,130,350,0,0,480,142,344,0,0,486
73,Jordan,2015,JOR-15/DDA-3560/CFP Nov 2015/H/NGO/2244,10/6/2016 12:25:40 PM,Host Communities,0,100,5,5,110,0,42,1,1,44
73,Jordan,2015,JOR-15/DDA-3560/CFP Nov 2015/H/NGO/2244,10/6/2016 12:25:40 PM,Overall,0,800,15,30,845,0,886,12,34,932
73,Jordan,2015,JOR-15/DDA-3560/CFP Nov 2015/H/NGO/2244,10/6/2016 12:25:40 PM,Refugees,0,700,10,25,735,0,844,11,33,888
73,Jordan,2015,JOR-15/DDA-3560/CFP Nov 2015/Sh./INGO/2211,9/21/2016 1:05:48 PM,Host Communities,135,161,152,152,600,158,184,215,198,755
73,Jordan,2015,JOR-15/DDA-3560/CFP Nov 2015/Sh./INGO/2211,9/21/2016 1:05:48 PM,Overall,450,536,508,506,2000,540,680,787,765,2772
73,Jordan,2015,JOR-15/DDA-3560/CFP Nov 2015/Sh./INGO/2211,9/21/2016 1:05:48 PM,Refugees,315,375,356,354,1400,382,496,572,567,2017
73,Jordan,2015,JOR-15/DDA-3560/CFP Nov 2015/WASH/INGO/2204,2/2/2017 9:26:44 AM,Overall,16541,17886,23029,21684,79140,16541,17886,23029,21684,79140
73,Jordan,2015,JOR-15/DDA-3560/CFP Nov 2015/WASH/INGO/2204,2/2/2017 9:26:44 AM,Refugees,16541,17886,23029,21684,79140,16541,17886,23029,21684,79140
73,Jordan,2015,JOR-15/DDA-3560/CFP615/H/INGO/1675,8/1/2016 8:04:56 AM,Host Communities,365,1363,423,420,2571,412,2187,40,38,2677
73,Jordan,2015,JOR-15/DDA-3560/CFP615/H/INGO/1675,8/1/2016 8:04:56 AM,Overall,1241,4569,1437,1428,8675,1570,7653,380,367,9970
73,Jordan,2015,JOR-15/DDA-3560/CFP615/H/INGO/1675,8/1/2016 8:04:56 AM,Refugees,876,3206,1015,1009,6106,1158,5466,340,329,7293
73,Jordan,2015,JOR-15/DDA-3560/CFP615/H/INGO/1698,7/18/2016 12:01:05 PM,Host Communities,270,270,230,230,1000,353,165,137,109,764
73,Jordan,2015,JOR-15/DDA-3560/CFP615/H/INGO/1698,7/18/2016 12:01:05 PM,Overall,1350,1350,1150,1150,5000,1657,1305,634,426,4022
73,Jordan,2015,JOR-15/DDA-3560/CFP615/H/INGO/1698,7/18/2016 12:01:05 PM,Refugees,1080,1080,920,920,4000,1304,1140,497,317,3258
73,Jordan,2015,JOR-15/DDA-3560/CFP615/P/INGO/1687,7/18/2016 12:14:20 PM,Overall,24380,26105,33120,31395,115000,66409,51338,25825,19964,163536
73,Jordan,2015,JOR-15/DDA-3560/CFP615/P/INGO/1687,7/18/2016 12:14:20 PM,Refugees,24380,26105,33120,31395,115000,66409,51338,25825,19964,163536
73,Jordan,2015,JOR-15/DDA-3560/CFP615/WASH/INGO/1700,11/21/2016 1:49:58 PM,Host Communities,270,270,1800,1800,4140,116,553,2203,6521,9393
73,Jordan,2015,JOR-15/DDA-3560/CFP615/WASH/INGO/1700,11/21/2016 1:49:58 PM,Overall,275,275,2000,2000,4550,116,560,2324,6680,9680
73,Jordan,2015,JOR-15/DDA-3560/CFP615/WASH/INGO/1700,11/21/2016 1:49:58 PM,Refugees,5,5,200,200,410,0,7,121,159,287
73,Jordan,2015,JOR-15/DDA-3560/CFPO2015/BN/INGO/2050,7/19/2016 11:59:15 AM,Host Communities,157,161,169,173,660,173,219,206,191,789
73,Jordan,2015,JOR-15/DDA-3560/CFPO2015/BN/INGO/2050,7/19/2016 11:59:15 AM,Overall,523,537,562,578,2200,454,586,770,761,2571
73,Jordan,2015,JOR-15/DDA-3560/CFPO2015/BN/INGO/2050,7/19/2016 11:59:15 AM,Refugees,366,376,393,405,1540,281,367,564,570,1782
73,Jordan,2015,JOR-15/DDA-3560/CFPO2015/BN/INGO/2051,7/20/2016 8:49:19 AM,Host Communities,204,377,194,245,1020,264,311,282,260,1117
73,Jordan,2015,JOR-15/DDA-3560/CFPO2015/BN/INGO/2051,7/20/2016 8:49:19 AM,Overall,680,1258,646,816,3400,1084,1275,1050,1044,4453
73,Jordan,2015,JOR-15/DDA-3560/CFPO2015/BN/INGO/2051,7/20/2016 8:49:19 AM,Refugees,476,881,452,571,2380,820,964,768,784,3336
73,Jordan,2015,JOR-15/DDA-3560/CFPO2015/BN/INGO/2053,7/20/2016 12:28:24 PM,Host Communities,170,192,200,188,750,207,273,181,164,825
73,Jordan,2015,JOR-15/DDA-3560/CFPO2015/BN/INGO/2053,7/20/2016 12:28:24 PM,Overall,567,640,666,627,2500,626,819,699,668,2812
73,Jordan,2015,JOR-15/DDA-3560/CFPO2015/BN/INGO/2053,7/20/2016 12:28:24 PM,Refugees,397,448,466,439,1750,419,546,518,504,1987
73,Jordan,2015,JOR-15/DDA-3560/CFPO2015/BN/INGO/2057,7/18/2016 1:07:08 PM,Host Communities,218,246,255,241,960,223,300,217,220,960
73,Jordan,2015,JOR-15/DDA-3560/CFPO2015/BN/INGO/2057,7/18/2016 1:07:08 PM,Overall,727,819,851,803,3200,667,902,801,830,3200
73,Jordan,2015,JOR-15/DDA-3560/CFPO2015/BN/INGO/2057,7/18/2016 1:07:08 PM,Refugees,509,573,596,562,2240,444,602,584,610,2240
73,Jordan,2015,JOR-15/DDA-3560/CFPO2015/BN/INGO/2058,10/5/2016 8:42:30 AM,Host Communities,282,308,332,308,1230,451,506,737,696,2390
73,Jordan,2015,JOR-15/DDA-3560/CFPO2015/BN/INGO/2058,10/5/2016 8:42:30 AM,Overall,943,1025,1107,1025,4100,1073,1231,1842,1706,5852
73,Jordan,2015,JOR-15/DDA-3560/CFPO2015/BN/INGO/2058,10/5/2016 8:42:30 AM,Refugees,661,717,775,717,2870,622,725,1105,1010,3462
73,Jordan,2015,JOR-15/DDA-3560/CFPO2015/BN/INGO/2061,7/20/2016 12:38:32 PM,Host Communities,186,220,272,251,929,263,368,229,214,1074
73,Jordan,2015,JOR-15/DDA-3560/CFPO2015/BN/INGO/2061,7/20/2016 12:38:32 PM,Overall,619,735,906,836,3096,766,961,963,828,3518
73,Jordan,2015,JOR-15/DDA-3560/CFPO2015/BN/INGO/2061,7/20/2016 12:38:32 PM,Refugees,433,515,634,585,2167,503,593,734,614,2444
73,Jordan,2015,JOR-15/DDA-3560/CFPO2015/BN/INGO/2064,7/24/2016 9:53:11 AM,Host Communities,230,228,227,215,900,279,426,366,379,1450
73,Jordan,2015,JOR-15/DDA-3560/CFPO2015/BN/INGO/2064,7/24/2016 9:53:11 AM,Overall,765,760,758,717,3000,808,1014,1032,991,3845
73,Jordan,2015,JOR-15/DDA-3560/CFPO2015/BN/INGO/2064,7/24/2016 9:53:11 AM,Refugees,535,532,531,502,2100,529,588,666,612,2395
73,Jordan,2015,JOR-15/DDA-3560/RB/CBTF/INGO/1731,3/17/2019 7:57:14 AM,Other,25,25,0,0,50,25,25,0,0,50
73,Jordan,2015,JOR-15/DDA-3560/RB/CBTF/INGO/1731,3/17/2019 7:57:14 AM,Overall,25,25,0,0,50,25,25,0,0,50
73,Jordan,2015,JOR-15/DDA-3560/RB/H/NGO/1481,9/21/2016 9:20:47 AM,Host Communities,0,75,0,0,75,20,106,50,50,226
73,Jordan,2015,JOR-15/DDA-3560/RB/H/NGO/1481,9/21/2016 9:20:47 AM,Overall,250,4050,150,327,4777,260,9244,200,400,10104
73,Jordan,2015,JOR-15/DDA-3560/RB/H/NGO/1481,9/21/2016 9:20:47 AM,Refugees,250,3975,150,327,4702,240,9138,150,350,9878
73,Jordan,2015,JOR-15/DDA-3560/RB/H/NGO/2110,9/21/2016 9:43:48 AM,Overall,60,25,2,3,90,80,26,6,3,115
73,Jordan,2015,JOR-15/DDA-3560/RB/H/NGO/2110,9/21/2016 9:43:48 AM,Refugees,60,25,2,3,90,0,0,0,0,0
73,Jordan,2015,JOR-15/DDA-3560/RB/P/INGO/2070,9/21/2016 11:54:13 AM,Overall,226,222,95,97,640,285,299,158,141,883
73,Jordan,2015,JOR-15/DDA-3560/RB/P/INGO/2070,9/21/2016 11:54:13 AM,Refugees,226,222,95,97,640,285,299,158,141,883
73,Jordan,2016,JOR-16/DDA-3560/CFP416/BN/INGO/2790,8/24/2017 8:52:47 AM,Host Communities,167,174,230,222,793,324,438,609,573,1944
73,Jordan,2016,JOR-16/DDA-3560/CFP416/BN/INGO/2790,8/24/2017 8:52:47 AM,Overall,555,581,766,738,2640,498,676,806,756,2736
73,Jordan,2016,JOR-16/DDA-3560/CFP416/BN/INGO/2790,8/24/2017 8:52:47 AM,Refugees,388,407,536,516,1847,174,238,197,183,792
73,Jordan,2016,JOR-16/DDA-3560/CFP416/BN/INGO/2806,7/4/2017 8:33:26 AM,Host Communities,143,179,156,147,625,107,171,178,153,609
73,Jordan,2016,JOR-16/DDA-3560/CFP416/BN/INGO/2806,7/4/2017 8:33:26 AM,Overall,405,461,618,591,2075,333,486,558,539,1916
73,Jordan,2016,JOR-16/DDA-3560/CFP416/BN/INGO/2806,7/4/2017 8:33:26 AM,Refugees,262,282,462,444,1450,226,315,380,386,1307
73,Jordan,2016,JOR-16/DDA-3560/CFP416/BN/INGO/2853,8/24/2017 11:10:30 AM,Host Communities,147,163,169,159,638,125,165,137,132,559
73,Jordan,2016,JOR-16/DDA-3560/CFP416/BN/INGO/2853,8/24/2017 11:10:30 AM,Overall,489,544,560,531,2124,353,461,489,429,1732
73,Jordan,2016,JOR-16/DDA-3560/CFP416/BN/INGO/2853,8/24/2017 11:10:30 AM,Refugees,342,381,391,372,1486,228,296,352,297,1173
73,Jordan,2016,JOR-16/DDA-3560/CFP416/BN/INGO/2896,2/5/2017 12:14:44 PM,Host Communities,278,316,309,291,1194,210,329,350,354,1243
73,Jordan,2016,JOR-16/DDA-3560/CFP416/BN/INGO/2896,2/5/2017 12:14:44 PM,Overall,927,1051,1031,971,3980,719,920,1290,1213,4142
73,Jordan,2016,JOR-16/DDA-3560/CFP416/BN/INGO/2896,2/5/2017 12:14:44 PM,Refugees,649,735,722,680,2786,509,591,940,859,2899
73,Jordan,2016,JOR-16/DDA-3560/CFP416/H/INGO/2833,8/30/2017 12:10:25 PM,Host Communities,930,730,344,270,2274,858,639,396,344,2237
73,Jordan,2016,JOR-16/DDA-3560/CFP416/H/INGO/2833,8/30/2017 12:10:25 PM,Overall,3100,2435,1147,901,7583,3043,2756,1367,1114,8280
73,Jordan,2016,JOR-16/DDA-3560/CFP416/H/INGO/2833,8/30/2017 12:10:25 PM,Refugees,2170,1705,803,631,5309,2185,2117,971,770,6043
73,Jordan,2016,JOR-16/DDA-3560/CFP416/H/NGO/2836,8/24/2017 11:32:55 AM,Host Communities,82,82,35,35,234,457,781,548,494,2280
73,Jordan,2016,JOR-16/DDA-3560/CFP416/H/NGO/2836,8/24/2017 11:32:55 AM,Overall,391,414,177,177,1159,457,781,548,494,2280
73,Jordan,2016,JOR-16/DDA-3560/CFP416/H/NGO/2836,8/24/2017 11:32:55 AM,Refugees,309,332,142,142,925,0,0,0,0,0
73,Jordan,2016,JOR-16/DDA-3560/CFP416/H/NGO/2884,8/30/2017 1:13:10 PM,Overall,100,21,24,5,150,74,11,25,10,120
73,Jordan,2016,JOR-16/DDA-3560/CFP416/P-H/INGO/2897,8/31/2017 9:56:13 AM,Host Communities,139,130,33,40,342,61,77,42,32,212
73,Jordan,2016,JOR-16/DDA-3560/CFP416/P-H/INGO/2897,8/31/2017 9:56:13 AM,Overall,760,775,323,331,2189,1025,1316,691,807,3839
73,Jordan,2016,JOR-16/DDA-3560/CFP416/P-H/INGO/2897,8/31/2017 9:56:13 AM,Refugees,621,645,290,291,1847,964,1239,649,775,3627
73,Jordan,2016,JOR-16/DDA-3560/CFP416/Sh./INGO/2791,8/24/2017 7:31:26 AM,Host Communities,140,167,173,168,648,91,112,111,107,421
73,Jordan,2016,JOR-16/DDA-3560/CFP416/Sh./INGO/2791,8/24/2017 7:31:26 AM,Overall,451,561,584,564,2160,320,418,490,438,1666
73,Jordan,2016,JOR-16/DDA-3560/CFP416/Sh./INGO/2791,8/24/2017 7:31:26 AM,Refugees,311,394,411,396,1512,229,306,379,331,1245
73,Jordan,2016,JOR-16/DDA-3560/CFP416/Sh./INGO/2815,8/30/2017 10:10:03 AM,Host Communities,130,146,152,145,573,100,166,153,112,531
73,Jordan,2016,JOR-16/DDA-3560/CFP416/Sh./INGO/2815,8/30/2017 10:10:03 AM,Overall,432,485,510,483,1910,402,580,605,508,2095
73,Jordan,2016,JOR-16/DDA-3560/CFP416/Sh./INGO/2815,8/30/2017 10:10:03 AM,Refugees,302,339,358,338,1337,302,414,452,396,1564
73,Jordan,2016,JOR-16/DDA-3560/CFP416/Sh./INGO/2875,7/17/2017 1:50:39 PM,Host Communities,179,201,208,197,785,149,200,211,201,761
73,Jordan,2016,JOR-16/DDA-3560/CFP416/Sh./INGO/2875,7/17/2017 1:50:39 PM,Overall,596,670,694,656,2616,528,640,791,754,2713
73,Jordan,2016,JOR-16/DDA-3560/CFP416/Sh./INGO/2875,7/17/2017 1:50:39 PM,Refugees,417,469,486,459,1831,379,440,580,553,1952
73,Jordan,2016,JOR-16/DDA-3560/CFP416/SRP-Food/INGO/2838,8/30/2017 10:48:24 AM,Host Communities,43257,62065,37615,45138,188075,39083,56075,33985,40782,169925
73,Jordan,2016,JOR-16/DDA-3560/CFP416/SRP-Food/INGO/2838,8/30/2017 10:48:24 AM,Internally Displaced People,13668,19610,11885,14262,59425,13047,18719,11345,13614,56725
73,Jordan,2016,JOR-16/DDA-3560/CFP416/SRP-Food/INGO/2838,8/30/2017 10:48:24 AM,Overall,56925,81675,49500,59400,247500,52129,74795,45330,54396,226650
73,Jordan,2016,JOR-16/DDA-3560/CFP416/SRP-H/NGO/2854,7/8/2018 12:37:35 PM,Overall,8,4,0,0,12,0,0,0,0,0
73,Jordan,2016,JOR-16/DDA-3560/CFP416/SRP-H/NGO/2901,7/1/2018 11:31:38 AM,Host Communities,949,1720,285,332,3286,1457,2834,421,470,5182
73,Jordan,2016,JOR-16/DDA-3560/CFP416/SRP-H/NGO/2901,7/1/2018 11:31:38 AM,Internally Displaced People,633,737,122,142,1634,882,1214,238,202,2536
73,Jordan,2016,JOR-16/DDA-3560/CFP416/SRP-H/NGO/2901,7/1/2018 11:31:38 AM,Overall,1582,2457,407,474,4920,2339,4048,659,672,7718
73,Jordan,2016,JOR-16/DDA-3560/CFP416/SRP-N/NGO/2861,7/11/2017 9:29:25 AM,Host Communities,330,1134,0,300,1764,446,1264,0,483,2193
73,Jordan,2016,JOR-16/DDA-3560/CFP416/SRP-N/NGO/2861,7/11/2017 9:29:25 AM,Internally Displaced People,170,466,0,200,836,133,496,0,170,799
73,Jordan,2016,JOR-16/DDA-3560/CFP416/SRP-N/NGO/2861,7/11/2017 9:29:25 AM,Overall,500,1600,0,500,2600,579,1760,0,653,2992
73,Jordan,2016,JOR-16/DDA-3560/CFP916/BN/INGO/3978,1/11/2018 1:05:42 PM,Host Communities,222,250,258,245,975,246,326,310,274,1156
73,Jordan,2016,JOR-16/DDA-3560/CFP916/BN/INGO/3978,1/11/2018 1:05:42 PM,Overall,741,832,861,816,3250,873,961,875,794,3503
73,Jordan,2016,JOR-16/DDA-3560/CFP916/BN/INGO/3978,1/11/2018 1:05:42 PM,Refugees,519,582,603,571,2275,627,635,565,520,2347
73,Jordan,2016,JOR-16/DDA-3560/CFP916/BN/INGO/4008,8/31/2017 9:09:42 AM,Host Communities,223,203,305,284,1015,251,274,473,442,1440
73,Jordan,2016,JOR-16/DDA-3560/CFP916/BN/INGO/4008,8/31/2017 9:09:42 AM,Overall,709,782,953,886,3330,667,743,879,881,3170
73,Jordan,2016,JOR-16/DDA-3560/CFP916/BN/INGO/4008,8/31/2017 9:09:42 AM,Refugees,486,579,648,602,2315,416,469,406,439,1730
73,Jordan,2016,JOR-16/DDA-3560/CFP916/BN/INGO/4010,8/31/2017 8:56:28 AM,Host Communities,352,365,366,382,1465,589,656,725,708,2678
73,Jordan,2016,JOR-16/DDA-3560/CFP916/BN/INGO/4010,8/31/2017 8:56:28 AM,Overall,1173,1220,1221,1271,4885,1256,1570,1557,1450,5833
73,Jordan,2016,JOR-16/DDA-3560/CFP916/BN/INGO/4010,8/31/2017 8:56:28 AM,Refugees,821,855,855,889,3420,667,914,832,742,3155
73,Jordan,2016,JOR-16/DDA-3560/CFP916/BN/INGO/4130,8/30/2017 8:39:39 AM,Host Communities,225,350,363,312,1250,206,290,302,279,1077
73,Jordan,2016,JOR-16/DDA-3560/CFP916/BN/INGO/4130,8/30/2017 8:39:39 AM,Overall,886,1092,1132,1040,4150,646,814,1052,990,3502
73,Jordan,2016,JOR-16/DDA-3560/CFP916/BN/INGO/4130,8/30/2017 8:39:39 AM,Refugees,661,742,769,728,2900,440,524,750,711,2425
73,Jordan,2016,JOR-16/DDA-3560/CFP916/BN-P/INGO/3970,8/31/2017 9:38:59 AM,Overall,3793,3947,5027,5233,18000,4365,4521,5908,6149,20943
73,Jordan,2016,JOR-16/DDA-3560/CFP916/BN-P/INGO/3970,8/31/2017 9:38:59 AM,Refugees,3793,3947,5027,5233,18000,4365,4521,5908,6149,20943
73,Jordan,2016,JOR-16/DDA-3560/CFP916/BN-Sh./INGO/3981,8/31/2017 10:23:37 AM,Host Communities,161,328,291,291,1071,386,404,325,284,1399
73,Jordan,2016,JOR-16/DDA-3560/CFP916/BN-Sh./INGO/3981,8/31/2017 10:23:37 AM,Overall,536,1092,971,971,3570,927,1076,1133,1071,4207
73,Jordan,2016,JOR-16/DDA-3560/CFP916/BN-Sh./INGO/3981,8/31/2017 10:23:37 AM,Refugees,375,764,680,680,2499,541,672,808,787,2808
73,Jordan,2016,JOR-16/DDA-3560/CFP916/H/NGO/4059,8/19/2018 7:04:17 AM,Overall,57,226,59,112,454,344,536,368,285,1533
73,Jordan,2016,JOR-16/DDA-3560/CFP916/H/NGO/4059,8/19/2018 7:04:17 AM,Refugees,57,226,59,112,454,344,536,368,285,1533
73,Jordan,2016,JOR-16/DDA-3560/CFP916/H/NGO/4136,1/3/2018 1:03:07 PM,Host Communities,12,60,32,24,128,10,69,13,0,92
73,Jordan,2016,JOR-16/DDA-3560/CFP916/H/NGO/4136,1/3/2018 1:03:07 PM,Overall,40,200,107,80,427,41,236,113,68,458
73,Jordan,2016,JOR-16/DDA-3560/CFP916/H/NGO/4136,1/3/2018 1:03:07 PM,Refugees,28,140,75,56,299,31,167,100,68,366
73,Jordan,2016,JOR-16/DDA-3560/CFP916/P/NGO/4044,2/4/2018 10:14:46 AM,Host Communities,312,1000,312,375,1999,76,2449,0,349,2874
73,Jordan,2016,JOR-16/DDA-3560/CFP916/P/NGO/4044,2/4/2018 10:14:46 AM,Overall,625,2000,625,750,4000,85,5391,0,794,6270
73,Jordan,2016,JOR-16/DDA-3560/CFP916/P/NGO/4044,2/4/2018 10:14:46 AM,Refugees,312,1000,312,375,1999,9,2939,0,445,3393
73,Jordan,2016,JOR-16/DDA-3560/CFP916/P-BN/INGO/4039,8/31/2017 10:04:52 AM,Overall,4513,4701,6050,6336,21600,4445,4678,5981,6262,21366
73,Jordan,2016,JOR-16/DDA-3560/CFP916/P-BN/INGO/4039,8/31/2017 10:04:52 AM,Refugees,4513,4701,6050,6336,21600,4445,4678,5981,6262,21366
73,Jordan,2016,JOR-16/DDA-3560/CFP916/SRP NFI /INGO/4054,8/31/2017 9:33:08 AM,Internally Displaced People,825,784,1237,1279,4125,1453,1463,2092,1939,6947
73,Jordan,2016,JOR-16/DDA-3560/CFP916/SRP NFI /INGO/4054,8/31/2017 9:33:08 AM,Overall,825,784,1237,1279,4125,1453,1463,2092,1939,6947
73,Jordan,2016,JOR-16/DDA-3560/CFP916/SRP NFI /INGO/4134,10/16/2017 11:22:56 AM,Internally Displaced People,2470,2470,1940,1940,8820,1612,1417,1957,2156,7142
73,Jordan,2016,JOR-16/DDA-3560/CFP916/SRP NFI /INGO/4134,10/16/2017 11:22:56 AM,Overall,2470,2470,1940,1940,8820,2161,2060,2701,3033,9955
73,Jordan,2016,JOR-16/DDA-3560/CFP916/SRP NFI /NGO/4185,7/8/2018 12:41:39 PM,Overall,0,0,4570,3046,7616,0,0,4570,3046,7616
73,Jordan,2016,JOR-16/DDA-3560/CFP916/SRP Pro/INGO/4124,5/24/2018 12:21:42 PM,Host Communities,1706,1833,2643,2645,8827,1123,1326,5514,5727,13690
73,Jordan,2016,JOR-16/DDA-3560/CFP916/SRP Pro/INGO/4124,5/24/2018 12:21:42 PM,Internally Displaced People,1069,1212,1432,1491,5204,401,407,1669,1619,4096
73,Jordan,2016,JOR-16/DDA-3560/CFP916/SRP Pro/INGO/4124,5/24/2018 12:21:42 PM,Other,198,183,0,0,381,192,147,0,0,339
73,Jordan,2016,JOR-16/DDA-3560/CFP916/SRP Pro/INGO/4124,5/24/2018 12:21:42 PM,Overall,2973,3228,4075,4136,14412,1635,1841,7396,7133,18005
73,Jordan,2016,JOR-16/DDA-3560/CFP916/SRP-H/INGO/4175,7/15/2018 11:01:25 AM,Host Communities,4,2,0,0,6,8,7,1,0,16
73,Jordan,2016,JOR-16/DDA-3560/CFP916/SRP-H/INGO/4175,7/15/2018 11:01:25 AM,Internally Displaced People,14,13,2,0,29,12,12,0,0,24
73,Jordan,2016,JOR-16/DDA-3560/CFP916/SRP-H/INGO/4175,7/15/2018 11:01:25 AM,Overall,18,15,2,0,35,19,19,2,0,40
73,Jordan,2016,JOR-16/DDA-3560/CFP916/SRP-N/NGO/4123,1/2/2018 1:47:53 PM,Host Communities,360,2067,2883,2770,8080,9,2470,1062,970,4511
73,Jordan,2016,JOR-16/DDA-3560/CFP916/SRP-N/NGO/4123,1/2/2018 1:47:53 PM,Internally Displaced People,140,803,1121,1076,3140,4,1388,590,556,2538
73,Jordan,2016,JOR-16/DDA-3560/CFP916/SRP-N/NGO/4123,1/2/2018 1:47:53 PM,Overall,500,2870,4004,3846,11220,13,3858,1652,1526,7049
73,Jordan,2016,JOR-16/DDA-3560/CFP916/WASH/INGO/4009,5/28/2018 12:14:44 PM,Overall,2036,2422,3090,2871,10419,2059,2460,3125,2913,10557
73,Jordan,2016,JOR-16/DDA-3560/CFP916/WASH/INGO/4009,5/28/2018 12:14:44 PM,Refugees,2036,2422,3090,2871,10419,2059,2460,3125,2913,10557
73,Jordan,2016,JOR-16/DDA-3560/Reserve16/SRP-H/NGO/2555,2/7/2017 10:35:48 AM,Host Communities,0,0,53760,53761,107521,0,0,61849,60375,122224
73,Jordan,2016,JOR-16/DDA-3560/Reserve16/SRP-H/NGO/2555,2/7/2017 10:35:48 AM,Overall,0,0,53760,53761,107521,0,0,61849,60375,122224
73,Jordan,2017,JOR-17/DDA-3560/J-CfPAug17/BN/INGO/6882,7/11/2018 1:50:16 PM,Host Communities,330,366,373,353,1422,204,288,266,198,956
73,Jordan,2017,JOR-17/DDA-3560/J-CfPAug17/BN/INGO/6882,7/11/2018 1:50:16 PM,Overall,1100,1220,1244,1178,4742,850,1027,1426,1352,4655
73,Jordan,2017,JOR-17/DDA-3560/J-CfPAug17/BN/INGO/6882,7/11/2018 1:50:16 PM,Refugees,770,854,871,825,3320,646,739,1160,1154,3699
73,Jordan,2017,JOR-17/DDA-3560/J-CfPAug17/BN/INGO/6899,7/10/2018 7:12:33 AM,Host Communities,164,181,232,218,795,128,167,323,247,865
73,Jordan,2017,JOR-17/DDA-3560/J-CfPAug17/BN/INGO/6899,7/10/2018 7:12:33 AM,Overall,548,602,774,726,2650,438,595,1163,1003,3199
73,Jordan,2017,JOR-17/DDA-3560/J-CfPAug17/BN/INGO/6899,7/10/2018 7:12:33 AM,Refugees,384,421,542,508,1855,310,428,840,756,2334
73,Jordan,2017,JOR-17/DDA-3560/J-CfPAug17/BN/INGO/6912,7/11/2018 1:32:51 PM,Host Communities,256,282,360,339,1237,280,354,327,334,1295
73,Jordan,2017,JOR-17/DDA-3560/J-CfPAug17/BN/INGO/6912,7/11/2018 1:32:51 PM,Overall,855,941,1201,1131,4128,856,1057,1346,1331,4590
73,Jordan,2017,JOR-17/DDA-3560/J-CfPAug17/BN/INGO/6912,7/11/2018 1:32:51 PM,Refugees,598,659,841,792,2890,576,703,1019,997,3295
73,Jordan,2017,JOR-17/DDA-3560/J-CfPAug17/H/NGO/6958,7/11/2018 1:39:26 PM,Host Communities,1,29,7,10,47,2,10,0,0,12
73,Jordan,2017,JOR-17/DDA-3560/J-CfPAug17/H/NGO/6958,7/11/2018 1:39:26 PM,Overall,3,96,22,35,156,5,137,29,28,199
73,Jordan,2017,JOR-17/DDA-3560/J-CfPAug17/H/NGO/6958,7/11/2018 1:39:26 PM,Refugees,2,67,15,25,109,3,127,29,28,187
73,Jordan,2017,JOR-17/DDA-3560/J-CfPAug17/Sh./INGO/6870,2/26/2019 9:47:04 AM,Overall,309,322,382,372,1385,314,327,412,387,1440
73,Jordan,2017,JOR-17/DDA-3560/J-CfPAug17/Sh./INGO/6870,2/26/2019 9:47:04 AM,Refugees,309,322,382,372,1385,314,327,412,387,1440
73,Jordan,2017,JOR-17/DDA-3560/J-CfPMar17/BN/INGO/5422,7/8/2018 12:25:29 PM,Overall,2805,3029,2356,3029,11219,6788,8117,11652,10449,37006
73,Jordan,2017,JOR-17/DDA-3560/J-CfPMar17/BN/INGO/5422,7/8/2018 12:25:29 PM,Refugees,2805,3029,2356,3029,11219,6788,8117,11652,10449,37006
73,Jordan,2017,JOR-17/DDA-3560/J-CfPMar17/H/INGO/5415,5/29/2018 7:54:12 AM,Host Communities,20,117,11,22,170,0,174,0,4,178
73,Jordan,2017,JOR-17/DDA-3560/J-CfPMar17/H/INGO/5415,5/29/2018 7:54:12 AM,Overall,72,392,40,73,577,10,577,39,45,671
73,Jordan,2017,JOR-17/DDA-3560/J-CfPMar17/H/INGO/5415,5/29/2018 7:54:12 AM,Refugees,52,275,29,51,407,10,403,39,41,493
73,Jordan,2017,JOR-17/DDA-3560/J-CfPMar17/H/INGO/5681,7/8/2018 9:59:11 AM,Host Communities,80,79,28,28,215,125,170,34,16,345
73,Jordan,2017,JOR-17/DDA-3560/J-CfPMar17/H/INGO/5681,7/8/2018 9:59:11 AM,Overall,178,177,65,65,485,250,274,51,29,604
73,Jordan,2017,JOR-17/DDA-3560/J-CfPMar17/H/INGO/5681,7/8/2018 9:59:11 AM,Refugees,98,98,37,37,270,123,101,19,16,259
73,Jordan,2017,JOR-17/DDA-3560/J-CfPMar17/H/INGO/5788,5/29/2018 12:37:39 PM,Host Communities,98,141,46,36,321,16,5,8,4,33
73,Jordan,2017,JOR-17/DDA-3560/J-CfPMar17/H/INGO/5788,5/29/2018 12:37:39 PM,Overall,245,352,114,89,800,343,425,212,209,1189
73,Jordan,2017,JOR-17/DDA-3560/J-CfPMar17/H/INGO/5788,5/29/2018 12:37:39 PM,Refugees,147,211,68,53,479,327,420,204,205,1156
73,Jordan,2017,JOR-17/DDA-3560/J-CfPMar17/H/NGO/5812,7/23/2018 12:24:11 PM,Overall,36,6,8,2,52,46,2,10,0,58
73,Jordan,2017,JOR-17/DDA-3560/J-CfPMar17/H/NGO/5812,7/23/2018 12:24:11 PM,Refugees,36,6,8,2,52,46,2,10,0,58
73,Jordan,2017,JOR-17/DDA-3560/J-CfPMar17/P/INGO/5363,12/17/2018 12:27:04 PM,Host Communities,105,120,191,99,515,119,150,209,106,584
73,Jordan,2017,JOR-17/DDA-3560/J-CfPMar17/P/INGO/5363,12/17/2018 12:27:04 PM,Overall,350,400,644,306,1700,465,518,657,330,1970
73,Jordan,2017,JOR-17/DDA-3560/J-CfPMar17/P/INGO/5363,12/17/2018 12:27:04 PM,Refugees,245,280,450,207,1182,346,368,448,224,1386
73,Jordan,2017,JOR-17/DDA-3560/J-CfPMar17/P/NGO/5475,7/19/2018 8:49:53 AM,Host Communities,3,650,200,300,1153,444,1133,795,1019,3391
73,Jordan,2017,JOR-17/DDA-3560/J-CfPMar17/P/NGO/5475,7/19/2018 8:49:53 AM,Overall,9,1110,700,900,2719,704,1754,2390,2453,7301
73,Jordan,2017,JOR-17/DDA-3560/J-CfPMar17/P/NGO/5475,7/19/2018 8:49:53 AM,Refugees,6,460,500,600,1566,241,620,1595,1575,4031
73,Jordan,2017,JOR-17/DDA-3560/J-CfPMar17/P/NGO/5500,9/26/2018 9:51:14 AM,Host Communities,44,607,580,578,1809,16,621,664,765,2066
73,Jordan,2017,JOR-17/DDA-3560/J-CfPMar17/P/NGO/5500,9/26/2018 9:51:14 AM,Overall,74,1011,967,963,3015,32,1496,1375,1472,4375
73,Jordan,2017,JOR-17/DDA-3560/J-CfPMar17/P/NGO/5500,9/26/2018 9:51:14 AM,Refugees,30,404,387,385,1206,16,875,711,707,2309
73,Jordan,2017,JOR-17/DDA-3560/J-CfPMar17/Sh./INGO/5800,5/28/2018 12:51:19 PM,Host Communities,133,164,162,156,615,118,126,135,117,496
73,Jordan,2017,JOR-17/DDA-3560/J-CfPMar17/Sh./INGO/5800,5/28/2018 12:51:19 PM,Overall,444,545,542,520,2051,406,450,609,575,2040
73,Jordan,2017,JOR-17/DDA-3560/J-CfPMar17/Sh./INGO/5800,5/28/2018 12:51:19 PM,Refugees,311,381,380,364,1436,288,324,474,458,1544
73,Jordan,2017,JOR-17/DDA-3560/J-CfPMar17/Sh.-P/INGO/5620,5/28/2018 9:02:46 AM,Host Communities,136,158,154,152,600,157,178,148,151,634
73,Jordan,2017,JOR-17/DDA-3560/J-CfPMar17/Sh.-P/INGO/5620,5/28/2018 9:02:46 AM,Overall,452,528,512,508,2000,489,570,638,613,2310
73,Jordan,2017,JOR-17/DDA-3560/J-CfPMar17/Sh.-P/INGO/5620,5/28/2018 9:02:46 AM,Refugees,316,370,358,356,1400,332,392,490,462,1676
73,Jordan,2017,JOR-17/DDA-3560/J-CfPMar17/WASH/INGO/5771,7/15/2018 10:56:54 AM,Host Communities,190,190,135,135,650,288,378,383,386,1435
73,Jordan,2017,JOR-17/DDA-3560/J-CfPMar17/WASH/INGO/5771,7/15/2018 10:56:54 AM,Overall,540,577,527,506,2150,1167,1168,735,794,3864
73,Jordan,2017,JOR-17/DDA-3560/J-CfPMar17/WASH/INGO/5771,7/15/2018 10:56:54 AM,Refugees,350,387,392,371,1500,879,790,352,408,2429
73,Jordan,2017,JOR-17/DDA-3560/J-CfPMar17/WASH/INGO/5824,7/8/2018 12:34:05 PM,Host Communities,195,212,188,190,785,287,236,261,208,992
73,Jordan,2017,JOR-17/DDA-3560/J-CfPMar17/WASH/INGO/5824,7/8/2018 12:34:05 PM,Overall,602,657,582,587,2428,593,563,622,589,2367
73,Jordan,2017,JOR-17/DDA-3560/J-CfPMar17/WASH/INGO/5824,7/8/2018 12:34:05 PM,Refugees,407,445,394,397,1643,306,327,361,381,1375
73,Jordan,2017,JOR-17/DDA-3560/RANOV2017/H/O/7620,5/28/2018 12:45:52 PM,Overall,147,165,6,12,330,140,184,3,7,334
73,Jordan,2017,JOR-17/DDA-3560/RANOV2017/H/O/7620,5/28/2018 12:45:52 PM,Refugees,147,165,6,12,330,140,184,3,7,334
73,Jordan,2017,JOR-17/DDA-3560/SS-CfPAug17/SRP NFI /INGO/6890,8/5/2018 10:03:01 AM,Internally Displaced People,1338,1271,2006,2073,6688,1878,1953,2088,1858,7777
73,Jordan,2017,JOR-17/DDA-3560/SS-CfPAug17/SRP NFI /INGO/6890,8/5/2018 10:03:01 AM,Overall,1338,1271,2006,2073,6688,1878,1953,2088,1858,7777
73,Jordan,2017,JOR-17/DDA-3560/SS-CfPMar17/SRP NFI /INGO/5747,5/28/2018 12:35:48 PM,Internally Displaced People,1210,1150,1815,1875,6050,2072,2166,1802,1537,7577
73,Jordan,2017,JOR-17/DDA-3560/SS-CfPMar17/SRP NFI /INGO/5747,5/28/2018 12:35:48 PM,Overall,1210,1150,1815,1875,6050,2072,2166,1802,1537,7577
73,Jordan,2017,JOR-17/DDA-3560/SS-CfPMar17/SRP NFI /NGO/5806,7/1/2018 11:25:41 AM,Internally Displaced People,833,745,822,760,3160,833,745,822,760,3160
73,Jordan,2017,JOR-17/DDA-3560/SS-CfPMar17/SRP NFI /NGO/5806,7/1/2018 11:25:41 AM,Overall,833,745,822,760,3160,833,745,822,760,3160
73,Jordan,2017,JOR-17/DDA-3560/SS-CfPMar17/SRP-Edu/NGO/5811,10/9/2018 1:34:34 PM,Host Communities,0,6,0,0,6,0,0,1578,2315,3893
73,Jordan,2017,JOR-17/DDA-3560/SS-CfPMar17/SRP-Edu/NGO/5811,10/9/2018 1:34:34 PM,Overall,0,6,97,146,249,0,0,12,21,33
73,Jordan,2017,JOR-17/DDA-3560/SS-CfPMar17/SRP-Food/INGO/5815,7/8/2018 1:29:13 PM,Host Communities,5267,5496,5954,6183,22900,4049,4224,4494,4671,17438
73,Jordan,2017,JOR-17/DDA-3560/SS-CfPMar17/SRP-Food/INGO/5815,7/8/2018 1:29:13 PM,Internally Displaced People,1173,1224,1326,1377,5100,2429,2530,2733,2870,10562
73,Jordan,2017,JOR-17/DDA-3560/SS-CfPMar17/SRP-Food/INGO/5815,7/8/2018 1:29:13 PM,Overall,6440,6720,7280,7560,28000,6440,6720,7280,7560,28000
73,Jordan,2017,JOR-17/DDA-3560/SS-CfPMar17/SRP-Food/NGO/5634,7/24/2018 8:45:26 AM,Host Communities,285,15,0,0,300,277,23,0,0,300
73,Jordan,2017,JOR-17/DDA-3560/SS-CfPMar17/SRP-Food/NGO/5634,7/24/2018 8:45:26 AM,Overall,285,15,0,0,300,277,23,0,0,300
73,Jordan,2017,JOR-17/DDA-3560/SS-CfPMar17/SRP-Food/UN/5816,2/12/2019 12:02:13 PM,Host Communities,750,750,0,0,1500,855,71,0,0,926
73,Jordan,2017,JOR-17/DDA-3560/SS-CfPMar17/SRP-Food/UN/5816,2/12/2019 12:02:13 PM,Internally Displaced People,750,750,0,0,1500,1657,219,0,0,1876
73,Jordan,2017,JOR-17/DDA-3560/SS-CfPMar17/SRP-Food/UN/5816,2/12/2019 12:02:13 PM,Overall,1500,1500,0,0,3000,2710,290,0,0,3000
73,Jordan,2017,JOR-17/DDA-3560/SS-CfPMar17/SRP-H/INGO/5700,11/4/2018 2:48:06 PM,Host Communities,2,3,1,0,6,30,28,0,0,58
73,Jordan,2017,JOR-17/DDA-3560/SS-CfPMar17/SRP-H/INGO/5700,11/4/2018 2:48:06 PM,Internally Displaced People,13,11,1,1,26,3,4,0,0,7
73,Jordan,2017,JOR-17/DDA-3560/SS-CfPMar17/SRP-H/INGO/5700,11/4/2018 2:48:06 PM,Overall,15,14,2,1,32,33,32,0,0,65
73,Jordan,2017,JOR-17/DDA-3560/SS-CfPMar17/SRP-H/INGO/5794,8/28/2018 8:38:01 AM,Internally Displaced People,2062,2063,1980,2145,8250,1105,1232,892,1020,4249
73,Jordan,2017,JOR-17/DDA-3560/SS-CfPMar17/SRP-H/INGO/5794,8/28/2018 8:38:01 AM,Overall,2062,2063,1980,2145,8250,2200,2420,1780,2000,8400
73,Jordan,2018,JOR-18/DDA-3560/J-CfPApr18/H/INGO/8970,4/30/2019 7:50:30 AM,Host Communities,0,178,0,12,190,0,190,0,0,190
73,Jordan,2018,JOR-18/DDA-3560/J-CfPApr18/H/INGO/8970,4/30/2019 7:50:30 AM,Overall,39,556,6,34,635,14,700,15,53,782
73,Jordan,2018,JOR-18/DDA-3560/J-CfPApr18/H/INGO/8970,4/30/2019 7:50:30 AM,Refugees,39,378,6,22,445,14,510,15,53,592
73,Jordan,2018,JOR-18/DDA-3560/J-CfPApr18/H/NGO/9036,4/9/2019 12:37:01 PM,Host Communities,6,46,6,7,65,9,0,0,0,9
73,Jordan,2018,JOR-18/DDA-3560/J-CfPApr18/H/NGO/9036,4/9/2019 12:37:01 PM,Overall,10,107,38,65,220,26,154,44,39,263
73,Jordan,2018,JOR-18/DDA-3560/J-CfPApr18/H/NGO/9036,4/9/2019 12:37:01 PM,Refugees,4,61,32,58,155,3,7,0,0,10
73,Jordan,2018,JOR-18/DDA-3560/J-CfPApr18/H/O/9102,3/27/2019 2:35:19 PM,Overall,159,180,3,12,354,171,187,5,10,373
73,Jordan,2018,JOR-18/DDA-3560/J-CfPApr18/H/O/9102,3/27/2019 2:35:19 PM,Refugees,159,180,3,12,354,171,187,5,10,373
73,Jordan,2018,JOR-18/DDA-3560/J-CfPApr18/P/INGO/8976,9/15/2019 12:00:05 PM,Overall,75,665,75,135,950,160,838,46,138,1182
73,Jordan,2018,JOR-18/DDA-3560/J-CfPApr18/P/INGO/8976,9/15/2019 12:00:05 PM,Refugees,75,665,75,135,950,160,838,46,138,1182
73,Jordan,2018,JOR-18/DDA-3560/J-CfPApr18/P/INGO/8986,11/6/2019 9:42:52 AM,Host Communities,364,417,25,30,836,108,415,13,17,553
73,Jordan,2018,JOR-18/DDA-3560/J-CfPApr18/P/INGO/8986,11/6/2019 9:42:52 AM,Overall,844,987,70,80,1981,757,1231,22,26,2036
73,Jordan,2018,JOR-18/DDA-3560/J-CfPApr18/P/INGO/8986,11/6/2019 9:42:52 AM,Refugees,480,570,45,50,1145,649,816,9,9,1483
73,Jordan,2018,JOR-18/DDA-3560/J-CfPApr18/P/INGO/9138,2/2/2020 11:52:21 AM,Overall,124,158,568,875,1725,176,656,905,1021,2758
73,Jordan,2018,JOR-18/DDA-3560/J-CfPApr18/P/INGO/9138,2/2/2020 11:52:21 AM,Refugees,124,158,568,875,1725,176,656,905,1021,2758
73,Jordan,2018,JOR-18/DDA-3560/J-CfPApr18/P/NGO/8971,9/15/2019 9:38:31 AM,Host Communities,7,2312,1114,1157,4590,45,3154,1729,1689,6617
73,Jordan,2018,JOR-18/DDA-3560/J-CfPApr18/P/NGO/8971,9/15/2019 9:38:31 AM,Overall,9,3948,1905,1990,7852,53,4274,2036,2093,8456
73,Jordan,2018,JOR-18/DDA-3560/J-CfPApr18/P/NGO/8971,9/15/2019 9:38:31 AM,Refugees,2,1636,791,833,3262,8,1120,307,404,1839
73,Jordan,2018,JOR-18/DDA-3560/J-CfPApr18/P-Sh./INGO/8967,1/26/2020 8:48:38 AM,Host Communities,124,134,147,130,535,230,25,3,3,261
73,Jordan,2018,JOR-18/DDA-3560/J-CfPApr18/P-Sh./INGO/8967,1/26/2020 8:48:38 AM,Overall,429,458,503,449,1839,558,318,213,251,1340
73,Jordan,2018,JOR-18/DDA-3560/J-CfPApr18/P-Sh./INGO/8967,1/26/2020 8:48:38 AM,Refugees,305,324,356,319,1304,328,293,210,248,1079
73,Jordan,2018,JOR-18/DDA-3560/J-CfPApr18/WASH/INGO/9110,9/16/2019 7:51:42 AM,Overall,1467,1634,2258,2120,7479,7358,7249,10588,10412,35607
73,Jordan,2018,JOR-18/DDA-3560/J-CfPApr18/WASH/INGO/9110,9/16/2019 7:51:42 AM,Refugees,1467,1634,2258,2120,7479,7358,7249,10588,10412,35607
73,Jordan,2018,JOR-18/DDA-3560/J-CfPApr18/WASH/INGO/9152,11/6/2019 10:46:22 AM,Overall,1818,2028,2730,2557,9133,1855,1744,2913,9267,15779
73,Jordan,2018,JOR-18/DDA-3560/J-CfPApr18/WASH/INGO/9152,11/6/2019 10:46:22 AM,Refugees,1818,2028,2730,2557,9133,1855,1744,2913,9267,15779
73,Jordan,2018,JOR-18/DDA-3560/RADEC2018/EDU/INGO/11435,4/26/2020 8:30:37 AM,Overall,1430,1430,100,100,3060,2254,1571,158,196,4179
73,Jordan,2018,JOR-18/DDA-3560/RADEC2018/EDU/INGO/11435,4/26/2020 8:30:37 AM,Refugees,1430,1430,100,100,3060,2254,1571,158,196,4179
73,Jordan,2018,JOR-18/DDA-3560/RAFEB2018/BN/UN/8361,1/10/2019 8:39:36 AM,Overall,2049,2843,2264,2179,9335,1409,1710,1525,1533,6177
73,Jordan,2018,JOR-18/DDA-3560/RAFEB2018/BN/UN/8361,1/10/2019 8:39:36 AM,Refugees,2049,2843,2264,2179,9335,1409,1710,1525,1533,6177
73,Jordan,2018,JOR-18/DDA-3560/SA2/BN/INGO/10646,9/1/2019 11:54:37 AM,Host Communities,320,346,351,333,1350,274,390,282,257,1203
73,Jordan,2018,JOR-18/DDA-3560/SA2/BN/INGO/10646,9/1/2019 11:54:37 AM,Overall,1066,1152,1170,1112,4500,977,1103,1119,1096,4295
73,Jordan,2018,JOR-18/DDA-3560/SA2/BN/INGO/10646,9/1/2019 11:54:37 AM,Refugees,746,806,819,779,3150,703,713,837,839,3092
73,Jordan,2018,JOR-18/DDA-3560/SA2/BN/INGO/10658,6/17/2019 6:39:25 AM,Host Communities,256,383,409,230,1278,277,303,499,517,1596
73,Jordan,2018,JOR-18/DDA-3560/SA2/BN/INGO/10658,6/17/2019 6:39:25 AM,Overall,853,1276,1363,768,4260,916,942,1234,1230,4322
73,Jordan,2018,JOR-18/DDA-3560/SA2/BN/INGO/10658,6/17/2019 6:39:25 AM,Refugees,597,893,954,538,2982,639,639,735,713,2726
73,Jordan,2018,JOR-18/DDA-3560/SA2/BN/INGO/10662,8/19/2019 8:00:28 AM,Host Communities,234,259,401,401,1295,284,335,399,343,1361
73,Jordan,2018,JOR-18/DDA-3560/SA2/BN/INGO/10662,8/19/2019 8:00:28 AM,Overall,780,862,1334,1334,4310,835,1026,1018,894,3773
73,Jordan,2018,JOR-18/DDA-3560/SA2/BN/INGO/10662,8/19/2019 8:00:28 AM,Refugees,546,603,933,933,3015,551,691,619,551,2412
73,Jordan,2018,JOR-18/DDA-3560/SA2/BN/INGO/10758,9/15/2019 7:44:56 AM,Host Communities,367,385,391,394,1537,219,350,220,271,1060
73,Jordan,2018,JOR-18/DDA-3560/SA2/BN/INGO/10758,9/15/2019 7:44:56 AM,Overall,1222,1282,1302,1314,5120,1091,1245,1406,1379,5121
73,Jordan,2018,JOR-18/DDA-3560/SA2/BN/INGO/10758,9/15/2019 7:44:56 AM,Refugees,855,897,911,920,3583,872,895,1186,1108,4061
73,Jordan,2018,JOR-18/DDA-3560/SA2/BN/INGO/10774,9/23/2019 1:07:28 PM,Host Communities,339,368,353,354,1414,256,259,359,361,1235
73,Jordan,2018,JOR-18/DDA-3560/SA2/BN/INGO/10774,9/23/2019 1:07:28 PM,Overall,950,1031,984,997,3962,745,727,1138,1083,3693
73,Jordan,2018,JOR-18/DDA-3560/SA2/BN/INGO/10774,9/23/2019 1:07:28 PM,Refugees,611,663,631,643,2548,489,468,779,722,2458
73,Jordan,2018,JOR-18/DDA-3560/SA2/BN/NGO/10720,9/1/2019 11:57:28 AM,Host Communities,135,135,101,101,472,163,173,244,313,893
73,Jordan,2018,JOR-18/DDA-3560/SA2/BN/NGO/10720,9/1/2019 11:57:28 AM,Overall,450,450,337,338,1575,540,559,636,651,2386
73,Jordan,2018,JOR-18/DDA-3560/SA2/BN/NGO/10720,9/1/2019 11:57:28 AM,Refugees,315,315,236,237,1103,377,386,392,338,1493
73,Jordan,2018,JOR-18/DDA-3560/SA2/H/INGO/10671,10/24/2019 11:05:22 AM,Host Communities,83,87,26,24,220,715,980,325,253,2273
73,Jordan,2018,JOR-18/DDA-3560/SA2/H/INGO/10671,10/24/2019 11:05:22 AM,Overall,268,249,86,79,682,1595,2398,748,622,5363
73,Jordan,2018,JOR-18/DDA-3560/SA2/H/INGO/10671,10/24/2019 11:05:22 AM,Refugees,185,162,60,55,462,880,1418,423,369,3090
73,Jordan,2018,JOR-18/DDA-3560/SA2/H/INGO/10675,10/22/2019 11:11:31 AM,Host Communities,0,182,0,12,194,143,66,0,0,209
73,Jordan,2018,JOR-18/DDA-3560/SA2/H/INGO/10675,10/22/2019 11:11:31 AM,Overall,40,564,7,35,646,163,583,32,66,844
73,Jordan,2018,JOR-18/DDA-3560/SA2/H/INGO/10675,10/22/2019 11:11:31 AM,Refugees,40,382,7,23,452,20,517,32,66,635
73,Jordan,2018,JOR-18/DDA-3560/SA2/H/NGO/10768,9/15/2019 8:56:46 AM,Host Communities,15,50,10,10,85,2,11,0,1,14
73,Jordan,2018,JOR-18/DDA-3560/SA2/H/NGO/10768,9/15/2019 8:56:46 AM,Overall,27,270,40,40,377,10,314,38,33,395
73,Jordan,2018,JOR-18/DDA-3560/SA2/H/NGO/10768,9/15/2019 8:56:46 AM,Refugees,12,220,30,30,292,8,303,38,32,381
73,Jordan,2018,JOR-18/DDA-3560/SA2/P/NGO/10748,4/23/2020 10:11:16 AM,Host Communities,35,220,35,120,410,232,743,68,268,1311
73,Jordan,2018,JOR-18/DDA-3560/SA2/P/NGO/10748,4/23/2020 10:11:16 AM,Overall,100,650,100,350,1200,270,964,108,369,1711
73,Jordan,2018,JOR-18/DDA-3560/SA2/P/NGO/10748,4/23/2020 10:11:16 AM,Refugees,65,430,65,230,790,38,221,40,101,400
73,Jordan,2018,JOR-18/DDA-3560/SA2/Sh./INGO/10660,10/22/2019 10:13:44 AM,Host Communities,154,167,169,160,650,176,172,80,74,502
73,Jordan,2018,JOR-18/DDA-3560/SA2/Sh./INGO/10660,10/22/2019 10:13:44 AM,Overall,516,559,564,536,2175,498,554,637,575,2264
73,Jordan,2018,JOR-18/DDA-3560/SA2/Sh./INGO/10660,10/22/2019 10:13:44 AM,Refugees,362,392,395,376,1525,322,382,557,501,1762
73,Jordan,2018,JOR-18/DDA-3560/SA2/Sh./NGO/10814,2/4/2020 2:25:21 PM,Host Communities,144,144,96,96,480,166,163,148,136,613
73,Jordan,2018,JOR-18/DDA-3560/SA2/Sh./NGO/10814,2/4/2020 2:25:21 PM,Overall,480,480,320,320,1600,488,487,399,363,1737
73,Jordan,2018,JOR-18/DDA-3560/SA2/Sh./NGO/10814,2/4/2020 2:25:21 PM,Refugees,336,336,224,224,1120,322,324,251,227,1124
73,Jordan,2018,JOR-18/DDA-3560/SS-CfPApr18/SRP NFI -SRP-Food-SRP-WASH/NGO/9005,2/3/2019 9:09:21 AM,Host Communities,5002,7503,9378,9378,31261,10750,16125,21095,21094,69064
73,Jordan,2018,JOR-18/DDA-3560/SS-CfPApr18/SRP NFI -SRP-Food-SRP-WASH/NGO/9005,2/3/2019 9:09:21 AM,Internally Displaced People,7502,11253,14067,14067,46889,2850,4275,5344,5343,17812
73,Jordan,2018,JOR-18/DDA-3560/SS-CfPApr18/SRP NFI -SRP-Food-SRP-WASH/NGO/9005,2/3/2019 9:09:21 AM,Overall,12504,18756,23445,23445,78150,23100,34650,43312,43313,144375
73,Jordan,2018,JOR-18/DDA-3560/SS-CfPApr18/SRP-H/INGO/9088,12/17/2018 12:11:35 PM,Host Communities,283,272,112,63,730,0,0,0,0,0
73,Jordan,2018,JOR-18/DDA-3560/SS-CfPApr18/SRP-H/INGO/9088,12/17/2018 12:11:35 PM,Internally Displaced People,487,400,155,94,1136,0,0,0,0,0
73,Jordan,2018,JOR-18/DDA-3560/SS-CfPApr18/SRP-H/INGO/9088,12/17/2018 12:11:35 PM,Overall,770,726,267,157,1920,0,0,0,0,0
73,Jordan,2018,JOR-18/DDA-3560/SS-RAJul18/SRP-H/NGO/9615,8/25/2019 7:35:01 AM,Host Communities,10,11,5,3,29,5,7,3,1,16
73,Jordan,2018,JOR-18/DDA-3560/SS-RAJul18/SRP-H/NGO/9615,8/25/2019 7:35:01 AM,Overall,22,44,19,14,99,30,85,26,22,163
73,Jordan,2018,JOR-18/DDA-3560/SS-RAJul18/SRP-H/NGO/9615,8/25/2019 7:35:01 AM,Refugees,12,33,14,11,70,25,78,23,21,147
73,Jordan,2019,JOR-19/DDA-3560/RADEC2019/BN/UN/14918,10/21/2020 1:44:22 PM,Overall,877,1193,926,876,3872,889,1205,915,863,3872
73,Jordan,2019,JOR-19/DDA-3560/RADEC2019/BN/UN/14918,10/21/2020 1:44:22 PM,Refugees,877,1193,926,876,3872,889,1205,915,863,3872
73,Jordan,2019,JOR-19/DDA-3560/RAMAR2019/BN/UN/12261,10/21/2020 1:36:05 PM,Overall,51,49,25,31,156,52,49,24,31,156
73,Jordan,2019,JOR-19/DDA-3560/RAMAR2019/BN/UN/12261,10/21/2020 1:36:05 PM,Refugees,51,49,25,31,156,52,49,24,31,156
73,Jordan,2019,JOR-19/DDA-3560/RAOCT2019/P/INGO/14394,3/4/2020 12:36:05 PM,Overall,30,45,100,125,300,34,74,208,231,547
73,Jordan,2019,JOR-19/DDA-3560/RAOCT2019/P/INGO/14394,3/4/2020 12:36:05 PM,Refugees,30,45,100,125,300,34,74,208,231,547
73,Jordan,2019,JOR-19/DDA-3560/SA1/H/INGO/12663,2/2/2021 7:39:11 AM,Overall,555,567,209,207,1538,699,685,122,104,1610
73,Jordan,2019,JOR-19/DDA-3560/SA1/H/INGO/12663,2/2/2021 7:39:11 AM,Refugees,555,567,209,207,1538,699,685,122,104,1610
73,Jordan,2019,JOR-19/DDA-3560/SA1/H/INGO/12878,4/7/2020 12:20:34 PM,Host Communities,0,205,0,0,205,140,55,0,0,195
73,Jordan,2019,JOR-19/DDA-3560/SA1/H/INGO/12878,4/7/2020 12:20:34 PM,Overall,42,595,7,37,681,151,699,24,69,943
73,Jordan,2019,JOR-19/DDA-3560/SA1/H/INGO/12878,4/7/2020 12:20:34 PM,Refugees,42,390,7,37,476,11,644,24,69,748
73,Jordan,2019,JOR-19/DDA-3560/SA1/H/NGO/12700,3/4/2020 1:37:46 PM,Host Communities,28,27,0,1,56,6,59,8,3,76
73,Jordan,2019,JOR-19/DDA-3560/SA1/H/NGO/12700,3/4/2020 1:37:46 PM,Overall,29,163,13,26,231,9,210,47,19,285
73,Jordan,2019,JOR-19/DDA-3560/SA1/H/NGO/12700,3/4/2020 1:37:46 PM,Refugees,1,136,13,25,175,3,151,39,16,209
73,Jordan,2019,JOR-19/DDA-3560/SA1/H-P/INGO/12775,3/9/2021 11:01:33 AM,Host Communities,99,106,86,83,374,159,162,148,152,621
73,Jordan,2019,JOR-19/DDA-3560/SA1/H-P/INGO/12775,3/9/2021 11:01:33 AM,Overall,326,331,292,294,1243,407,489,402,395,1693
73,Jordan,2019,JOR-19/DDA-3560/SA1/H-P/INGO/12775,3/9/2021 11:01:33 AM,Refugees,227,225,206,211,869,248,327,254,243,1072
73,Jordan,2019,JOR-19/DDA-3560/SA1/H-P/NGO/12894,9/14/2020 12:42:15 PM,Host Communities,127,224,172,140,663,107,277,175,169,728
73,Jordan,2019,JOR-19/DDA-3560/SA1/H-P/NGO/12894,9/14/2020 12:42:15 PM,Overall,196,343,222,182,943,187,409,225,212,1033
73,Jordan,2019,JOR-19/DDA-3560/SA1/H-P/NGO/12894,9/14/2020 12:42:15 PM,Refugees,69,119,50,42,280,80,132,50,43,305
73,Jordan,2019,JOR-19/DDA-3560/SA1/P/INGO/12661,3/9/2021 10:02:13 AM,Overall,386,2130,2231,2358,7105,1529,2018,1680,1705,6932
73,Jordan,2019,JOR-19/DDA-3560/SA1/P/INGO/12661,3/9/2021 10:02:13 AM,Refugees,386,2130,2231,2358,7105,1529,2018,1680,1705,6932
73,Jordan,2019,JOR-19/DDA-3560/SA1/P/INGO/12782,2/1/2021 12:19:31 PM,Host Communities,100,500,384,256,1240,85,474,752,404,1715
73,Jordan,2019,JOR-19/DDA-3560/SA1/P/INGO/12782,2/1/2021 12:19:31 PM,Overall,130,600,468,312,1510,107,626,875,501,2109
73,Jordan,2019,JOR-19/DDA-3560/SA1/P/INGO/12782,2/1/2021 12:19:31 PM,Refugees,30,100,84,56,270,22,152,123,97,394
73,Jordan,2019,JOR-19/DDA-3560/SA1/P/INGO/12950,1/4/2021 11:44:41 AM,Host Communities,183,178,359,132,852,264,389,1107,411,2171
73,Jordan,2019,JOR-19/DDA-3560/SA1/P/INGO/12950,1/4/2021 11:44:41 AM,Overall,615,596,1167,437,2815,494,692,1529,687,3402
73,Jordan,2019,JOR-19/DDA-3560/SA1/P/INGO/12950,1/4/2021 11:44:41 AM,Refugees,432,418,808,305,1963,230,303,422,276,1231
73,Jordan,2019,JOR-19/DDA-3560/SA1/P/NGO/12721,11/23/2020 12:55:44 PM,Host Communities,9,1289,263,1005,2566,14,1206,322,1011,2553
73,Jordan,2019,JOR-19/DDA-3560/SA1/P/NGO/12721,11/23/2020 12:55:44 PM,Overall,9,2228,298,1312,3847,14,2289,366,1385,4054
73,Jordan,2019,JOR-19/DDA-3560/SA1/P/NGO/12721,11/23/2020 12:55:44 PM,Refugees,0,939,35,307,1281,0,1083,44,374,1501
73,Jordan,2019,JOR-19/DDA-3560/SA1/P/NGO/12880,10/19/2020 12:10:02 PM,Host Communities,240,414,502,404,1560,1078,1078,1765,1757,5678
73,Jordan,2019,JOR-19/DDA-3560/SA1/P/NGO/12880,10/19/2020 12:10:02 PM,Overall,795,1248,1198,1100,4341,1366,1366,2533,2393,7658
73,Jordan,2019,JOR-19/DDA-3560/SA1/P/NGO/12880,10/19/2020 12:10:02 PM,Refugees,555,834,696,696,2781,288,288,768,636,1980
73,Jordan,2019,JOR-19/DDA-3560/SA1/P/NGO/12955,1/26/2021 11:58:57 AM,Host Communities,15,15,40,36,106,16,14,38,40,108
73,Jordan,2019,JOR-19/DDA-3560/SA1/P/NGO/12955,1/26/2021 11:58:57 AM,Overall,45,45,85,81,256,47,44,85,79,255
73,Jordan,2019,JOR-19/DDA-3560/SA1/P/NGO/12955,1/26/2021 11:58:57 AM,Refugees,30,30,45,45,150,31,30,47,39,147
73,Jordan,2019,JOR-19/DDA-3560/SA1/Sh./INGO/12742,6/22/2020 3:03:26 PM,Host Communities,130,144,136,127,537,133,141,131,118,523
73,Jordan,2019,JOR-19/DDA-3560/SA1/Sh./INGO/12742,6/22/2020 3:03:26 PM,Overall,441,479,454,426,1800,346,429,603,613,1991
73,Jordan,2019,JOR-19/DDA-3560/SA1/Sh./INGO/12742,6/22/2020 3:03:26 PM,Refugees,311,335,318,299,1263,213,288,472,495,1468
73,Jordan,2019,JOR-19/DDA-3560/SA1/Sh./INGO/12968,9/24/2020 8:32:13 AM,Host Communities,44,54,62,60,220,69,72,67,62,270
73,Jordan,2019,JOR-19/DDA-3560/SA1/Sh./INGO/12968,9/24/2020 8:32:13 AM,Overall,147,182,206,200,735,214,245,239,229,927
73,Jordan,2019,JOR-19/DDA-3560/SA1/Sh./INGO/12968,9/24/2020 8:32:13 AM,Refugees,103,128,144,140,515,145,173,172,167,657
73,Jordan,2019,JOR-19/DDA-3560/SA1/WASH/INGO/12699,11/11/2020 10:49:36 AM,Overall,291,222,68,63,644,383,299,68,63,813
73,Jordan,2019,JOR-19/DDA-3560/SA1/WASH/INGO/12699,11/11/2020 10:49:36 AM,Refugees,291,222,68,63,644,383,299,68,63,813
73,Jordan,2019,JOR-19/DDA-3560/SA1/WASH/INGO/12907,3/9/2021 10:11:49 AM,Host Communities,215,225,228,232,900,361,425,239,293,1318
73,Jordan,2019,JOR-19/DDA-3560/SA1/WASH/INGO/12907,3/9/2021 10:11:49 AM,Overall,716,750,763,771,3000,1033,1199,1243,1199,4674
73,Jordan,2019,JOR-19/DDA-3560/SA1/WASH/INGO/12907,3/9/2021 10:11:49 AM,Refugees,501,525,535,539,2100,672,774,1004,906,3356
73,Jordan,2019,JOR-19/DDA-3560/SA1/WASH/INGO/12952,9/24/2020 8:35:06 AM,Overall,392,436,642,600,2070,546,583,470,483,2082
73,Jordan,2019,JOR-19/DDA-3560/SA1/WASH/INGO/12952,9/24/2020 8:35:06 AM,Refugees,392,436,642,600,2070,546,583,470,483,2082
73,Jordan,2019,JOR-19/DDA-3560/SA2/BN/INGO/14826,9/2/2020 2:22:09 PM,Host Communities,127,131,171,171,600,141,191,183,203,718
73,Jordan,2019,JOR-19/DDA-3560/SA2/BN/INGO/14826,9/2/2020 2:22:09 PM,Overall,424,436,571,569,2000,436,513,562,542,2053
73,Jordan,2019,JOR-19/DDA-3560/SA2/BN/INGO/14826,9/2/2020 2:22:09 PM,Refugees,297,305,400,398,1400,295,322,379,339,1335
73,Jordan,2019,JOR-19/DDA-3560/SA2/BN/INGO/14839,8/24/2020 12:01:32 PM,Host Communities,171,214,341,341,1067,226,298,217,208,949
73,Jordan,2019,JOR-19/DDA-3560/SA2/BN/INGO/14839,8/24/2020 12:01:32 PM,Overall,570,712,1139,1139,3560,801,820,758,693,3072
73,Jordan,2019,JOR-19/DDA-3560/SA2/BN/INGO/14839,8/24/2020 12:01:32 PM,Refugees,399,498,798,798,2493,575,522,541,485,2123
73,Jordan,2019,JOR-19/DDA-3560/SA2/BN/INGO/14845,1/10/2021 11:54:15 AM,Host Communities,129,87,86,58,360,168,189,196,186,739
73,Jordan,2019,JOR-19/DDA-3560/SA2/BN/INGO/14845,1/10/2021 11:54:15 AM,Overall,431,289,261,219,1200,737,829,859,813,3238
73,Jordan,2019,JOR-19/DDA-3560/SA2/BN/INGO/14845,1/10/2021 11:54:15 AM,Refugees,302,202,175,161,840,569,640,663,627,2499
73,Jordan,2019,JOR-19/DDA-3560/SA2/BN/INGO/14881,11/11/2020 11:05:36 AM,Host Communities,223,241,232,232,928,215,250,278,273,1016
73,Jordan,2019,JOR-19/DDA-3560/SA2/BN/INGO/14881,11/11/2020 11:05:36 AM,Overall,742,805,773,774,3094,791,742,896,849,3278
73,Jordan,2019,JOR-19/DDA-3560/SA2/BN/INGO/14881,11/11/2020 11:05:36 AM,Refugees,519,564,541,542,2166,576,492,618,576,2262
73,Jordan,2019,JOR-19/DDA-3560/SA2/BN/NGO/14882,10/15/2020 10:15:40 AM,Host Communities,1952,2191,2268,2149,8560,1952,2191,2268,2149,8560
73,Jordan,2019,JOR-19/DDA-3560/SA2/BN/NGO/14882,10/15/2020 10:15:40 AM,Overall,2315,2588,2946,2663,10512,2315,2588,2946,2663,10512
73,Jordan,2019,JOR-19/DDA-3560/SA2/BN/NGO/14882,10/15/2020 10:15:40 AM,Refugees,363,397,678,514,1952,363,397,678,514,1952
73,Jordan,2019,JOR-19/DDA-3560/SA2/H/INGO/14878,3/23/2021 8:44:42 AM,Host Communities,40,68,40,40,188,41,157,57,50,305
73,Jordan,2019,JOR-19/DDA-3560/SA2/H/INGO/14878,3/23/2021 8:44:42 AM,Overall,193,485,182,186,1046,229,588,237,206,1260
73,Jordan,2019,JOR-19/DDA-3560/SA2/H/INGO/14878,3/23/2021 8:44:42 AM,Refugees,153,417,142,146,858,188,431,180,156,955
73,Jordan,2019,JOR-19/DDA-3560/SA2/H/NGO/14869,10/21/2020 1:59:29 PM,Host Communities,56,47,0,3,106,9,167,7,4,187
73,Jordan,2019,JOR-19/DDA-3560/SA2/H/NGO/14869,10/21/2020 1:59:29 PM,Overall,61,235,17,38,351,23,327,46,33,429
73,Jordan,2019,JOR-19/DDA-3560/SA2/H/NGO/14869,10/21/2020 1:59:29 PM,Refugees,5,188,17,35,245,14,160,39,29,242
73,Jordan,2019,JOR-19/DDA-3560/SA2/H/O/14868,11/23/2020 12:27:38 PM,Overall,145,215,10,5,375,167,235,9,22,433
73,Jordan,2019,JOR-19/DDA-3560/SA2/H/O/14868,11/23/2020 12:27:38 PM,Refugees,145,215,10,5,375,167,235,9,22,433
73,Jordan,2019,JOR-19/DDA-3560/SA2/P/INGO/14884,6/3/2021 8:07:05 AM,Host Communities,22,23,15,15,75,11,18,8,5,42
73,Jordan,2019,JOR-19/DDA-3560/SA2/P/INGO/14884,6/3/2021 8:07:05 AM,Other,12,13,0,0,25,9,45,0,0,54
73,Jordan,2019,JOR-19/DDA-3560/SA2/P/INGO/14884,6/3/2021 8:07:05 AM,Overall,44,46,20,20,130,37,90,21,18,166
73,Jordan,2019,JOR-19/DDA-3560/SA2/P/INGO/14884,6/3/2021 8:07:05 AM,Refugees,10,10,5,5,30,17,27,13,13,70
73,Jordan,2019,JOR-19/DDA-3560/SA2/Sh./INGO/14816,3/9/2021 10:44:05 AM,Overall,251,332,363,426,1372,250,365,488,461,1564
73,Jordan,2019,JOR-19/DDA-3560/SA2/Sh./INGO/14816,3/9/2021 10:44:05 AM,Refugees,251,332,363,426,1372,250,365,488,461,1564
73,Jordan,2019,JOR-19/DDA-3560/SA2/Sh./INGO/14827,2/18/2021 8:54:18 AM,Host Communities,78,83,78,76,315,123,115,74,72,384
73,Jordan,2019,JOR-19/DDA-3560/SA2/Sh./INGO/14827,2/18/2021 8:54:18 AM,Overall,273,269,255,249,1046,327,309,271,304,1211
73,Jordan,2019,JOR-19/DDA-3560/SA2/Sh./INGO/14827,2/18/2021 8:54:18 AM,Refugees,195,186,177,173,731,204,194,197,232,827
73,Jordan,2019,JOR-19/DDA-3560/SA2/Sh./INGO/14856,1/4/2021 10:56:25 AM,Host Communities,189,205,195,183,772,136,191,139,156,622
73,Jordan,2019,JOR-19/DDA-3560/SA2/Sh./INGO/14856,1/4/2021 10:56:25 AM,Overall,631,684,649,611,2575,539,584,469,469,2061
73,Jordan,2019,JOR-19/DDA-3560/SA2/Sh./INGO/14856,1/4/2021 10:56:25 AM,Refugees,442,479,454,428,1803,403,393,330,313,1439
73,Jordan,2020,JOR-20/DDA-3560/RA1/BN/NGO/15714,9/21/2020 1:56:30 PM,Host Communities,2750,2750,4125,4125,13750,2978,2978,4466,4468,14890
73,Jordan,2020,JOR-20/DDA-3560/RA1/BN/NGO/15714,9/21/2020 1:56:30 PM,Other,1445,1445,620,615,4125,602,602,903,903,3010
73,Jordan,2020,JOR-20/DDA-3560/RA1/BN/NGO/15714,9/21/2020 1:56:30 PM,Overall,6120,6120,7630,7630,27500,5510,5510,8263,8267,27550
73,Jordan,2020,JOR-20/DDA-3560/RA1/BN/NGO/15714,9/21/2020 1:56:30 PM,Refugees,1925,1925,2885,2890,9625,1930,1930,2894,2896,9650
73,Jordan,2020,JOR-20/DDA-3560/RA1/BN-P/INGO/15742,9/23/2020 1:56:45 PM,Host Communities,391,909,0,0,1300,571,1153,0,0,1724
73,Jordan,2020,JOR-20/DDA-3560/RA1/BN-P/INGO/15742,9/23/2020 1:56:45 PM,Overall,782,1818,0,0,2600,978,2047,0,0,3025
73,Jordan,2020,JOR-20/DDA-3560/RA1/BN-P/INGO/15742,9/23/2020 1:56:45 PM,Refugees,391,909,0,0,1300,407,894,0,0,1301
73,Jordan,2020,JOR-20/DDA-3560/RA1/H/NGO/15681,1/4/2021 1:35:12 PM,Host Communities,180000,180000,45000,45000,450000,16380,16380,4095,4095,40950
73,Jordan,2020,JOR-20/DDA-3560/RA1/H/NGO/15681,1/4/2021 1:35:12 PM,Overall,200000,200000,50000,50000,500000,18240,18240,4510,4510,45500
73,Jordan,2020,JOR-20/DDA-3560/RA1/H/NGO/15681,1/4/2021 1:35:12 PM,Refugees,20000,20000,5000,5000,50000,1860,1860,415,415,4550
73,Jordan,2020,JOR-20/DDA-3560/RA1/WASH/UN/15530,3/9/2021 12:49:11 PM,Host Communities,2279,2738,8597,13683,27297,2279,2738,8597,13683,27297
73,Jordan,2020,JOR-20/DDA-3560/RA1/WASH/UN/15530,3/9/2021 12:49:11 PM,Overall,33937,43754,96856,98005,272552,33909,44100,96186,96404,270599
73,Jordan,2020,JOR-20/DDA-3560/RA1/WASH/UN/15530,3/9/2021 12:49:11 PM,Refugees,31658,41016,88259,84322,245255,31630,41362,87589,82721,243302
73,Jordan,2020,JOR-20/DDA-3560/RA2/H/INGO/17062,4/14/2021 7:35:27 AM,Overall,0,1094,227,217,1538,47,1669,414,433,2563
73,Jordan,2020,JOR-20/DDA-3560/RA2/H/INGO/17062,4/14/2021 7:35:27 AM,Refugees,0,1094,227,217,1538,47,1669,414,433,2563
73,Jordan,2020,JOR-20/DDA-3560/SA1/BN/INGO/16284,3/9/2021 11:18:49 AM,Host Communities,263,276,363,351,1253,368,448,541,478,1835
73,Jordan,2020,JOR-20/DDA-3560/SA1/BN/INGO/16284,3/9/2021 11:18:49 AM,Overall,877,919,1211,1168,4175,1089,1158,1268,1219,4734
73,Jordan,2020,JOR-20/DDA-3560/SA1/BN/INGO/16284,3/9/2021 11:18:49 AM,Refugees,614,643,848,817,2922,721,710,727,741,2899
73,Jordan,2020,JOR-20/DDA-3560/SA1/BN/INGO/16326,1/25/2021 10:27:36 AM,Host Communities,570,570,1424,1424,3988,542,729,553,524,2348
73,Jordan,2020,JOR-20/DDA-3560/SA1/BN/INGO/16326,1/25/2021 10:27:36 AM,Overall,1312,1496,2906,2906,8620,1862,1987,1675,1562,7086
73,Jordan,2020,JOR-20/DDA-3560/SA1/BN/INGO/16326,1/25/2021 10:27:36 AM,Refugees,742,926,1482,1482,4632,1320,1258,1122,1038,4738
73,Jordan,2020,JOR-20/DDA-3560/SA1/BN/INGO/16341,4/21/2021 11:33:37 AM,Host Communities,279,302,286,270,1137,286,305,153,131,875
73,Jordan,2020,JOR-20/DDA-3560/SA1/BN/INGO/16341,4/21/2021 11:33:37 AM,Overall,929,1006,954,901,3790,838,805,720,627,2990
73,Jordan,2020,JOR-20/DDA-3560/SA1/BN/INGO/16341,4/21/2021 11:33:37 AM,Refugees,650,704,668,631,2653,552,500,567,496,2115
73,Jordan,2020,JOR-20/DDA-3560/SA1/BN/NGO/16434,2/9/2021 9:11:15 AM,Host Communities,385,641,427,684,2137,387,651,512,712,2262
73,Jordan,2020,JOR-20/DDA-3560/SA1/BN/NGO/16434,2/9/2021 9:11:15 AM,Overall,1282,2137,1425,2281,7125,1306,2303,2532,2409,8550
73,Jordan,2020,JOR-20/DDA-3560/SA1/BN/NGO/16434,2/9/2021 9:11:15 AM,Refugees,897,1496,998,1597,4988,919,1652,2020,1697,6288
73,Jordan,2020,JOR-20/DDA-3560/SA1/BN-WASH/UN/16420,7/26/2021 11:30:46 AM,Overall,850,983,789,738,3360,908,1047,793,769,3517
73,Jordan,2020,JOR-20/DDA-3560/SA1/BN-WASH/UN/16420,7/26/2021 11:30:46 AM,Refugees,850,983,789,738,3360,908,1047,793,769,3517
73,Jordan,2020,JOR-20/DDA-3560/SA1/H/INGO/16392,4/6/2021 8:44:11 AM,Host Communities,160,55,0,0,215,173,40,0,0,213
73,Jordan,2020,JOR-20/DDA-3560/SA1/H/INGO/16392,4/6/2021 8:44:11 AM,Overall,184,471,25,36,716,223,565,48,70,906
73,Jordan,2020,JOR-20/DDA-3560/SA1/H/INGO/16392,4/6/2021 8:44:11 AM,Refugees,24,416,25,36,501,50,525,48,70,693
73,Jordan,2020,JOR-20/DDA-3560/SA1/H/NGO/16317,2/17/2022 8:27:29 AM,Host Communities,7750,8075,25,25,15875,9690,14585,41,49,24365
73,Jordan,2020,JOR-20/DDA-3560/SA1/H/NGO/16317,2/17/2022 8:27:29 AM,Overall,15500,16150,50,50,31750,18142,26559,76,88,44865
73,Jordan,2020,JOR-20/DDA-3560/SA1/H/NGO/16317,2/17/2022 8:27:29 AM,Refugees,7750,8075,25,25,15875,8452,11974,35,39,20500
73,Jordan,2020,JOR-20/DDA-3560/SA1/H/NGO/16362,2/18/2021 8:09:44 AM,Host Communities,6,82,10,14,112,3,109,7,9,128
73,Jordan,2020,JOR-20/DDA-3560/SA1/H/NGO/16362,2/18/2021 8:09:44 AM,Overall,15,273,35,46,369,9,349,44,47,449
73,Jordan,2020,JOR-20/DDA-3560/SA1/H/NGO/16362,2/18/2021 8:09:44 AM,Refugees,9,191,25,32,257,6,240,37,38,321
73,Jordan,2020,JOR-20/DDA-3560/SA1/H/O/16423,5/3/2021 11:20:10 AM,Overall,29,43,2,1,75,41,46,2,1,90
73,Jordan,2020,JOR-20/DDA-3560/SA1/H/O/16423,5/3/2021 11:20:10 AM,Refugees,29,43,2,1,75,41,46,2,1,90
73,Jordan,2020,JOR-20/DDA-3560/SA1/P/INGO/16304,7/11/2021 12:25:33 PM,Host Communities,0,202,0,0,202,0,598,0,3,601
73,Jordan,2020,JOR-20/DDA-3560/SA1/P/INGO/16304,7/11/2021 12:25:33 PM,Overall,0,380,0,0,380,0,842,0,8,850
73,Jordan,2020,JOR-20/DDA-3560/SA1/P/INGO/16304,7/11/2021 12:25:33 PM,Refugees,0,178,0,0,178,0,244,0,5,249
73,Jordan,2020,JOR-20/DDA-3560/SA1/P/INGO/16309,12/8/2021 9:46:36 AM,Host Communities,500,10625,125,1250,12500,1536,43518,1024,5120,51198
73,Jordan,2020,JOR-20/DDA-3560/SA1/P/INGO/16309,12/8/2021 9:46:36 AM,Overall,1000,21250,250,2500,25000,3071,87036,2048,10240,102395
73,Jordan,2020,JOR-20/DDA-3560/SA1/P/INGO/16309,12/8/2021 9:46:36 AM,Refugees,500,10625,125,1250,12500,1535,43518,1024,5120,51197
73,Jordan,2020,JOR-20/DDA-3560/SA1/P/NGO/16352,8/5/2021 12:54:06 PM,Host Communities,2393,53998,642,8342,65375,2546,70037,705,15036,88324
73,Jordan,2020,JOR-20/DDA-3560/SA1/P/NGO/16352,8/5/2021 12:54:06 PM,Overall,2736,95160,798,13358,112052,2665,96099,714,19180,118658
73,Jordan,2020,JOR-20/DDA-3560/SA1/P/NGO/16352,8/5/2021 12:54:06 PM,Refugees,343,41162,156,5016,46677,119,26062,9,4144,30334
73,Jordan,2020,JOR-20/DDA-3560/SA1/WASH/INGO/16303,7/27/2021 8:05:34 AM,Overall,8492,8778,12970,12260,42500,6477,7091,11101,10664,35333
73,Jordan,2020,JOR-20/DDA-3560/SA1/WASH/INGO/16303,7/27/2021 8:05:34 AM,Refugees,8492,8778,12970,12260,42500,6477,7091,11101,10664,35333
73,Jordan,2020,JOR-20/DDA-3560/SA1/WASH/INGO/16410,5/3/2021 10:50:18 AM,Host Communities,3666,3451,1941,1725,10783,2501,2452,1917,2233,9103
73,Jordan,2020,JOR-20/DDA-3560/SA1/WASH/INGO/16410,5/3/2021 10:50:18 AM,Overall,5237,4930,2773,2464,15404,3573,3503,2739,3190,13005
73,Jordan,2020,JOR-20/DDA-3560/SA1/WASH/INGO/16410,5/3/2021 10:50:18 AM,Refugees,1571,1479,832,739,4621,1072,1051,822,957,3902
73,Jordan,2020,JOR-20/DDA-3560/SA1/WASH/NGO/16405,5/9/2021 12:50:14 PM,Host Communities,600,638,800,662,2700,733,782,1119,979,3613
73,Jordan,2020,JOR-20/DDA-3560/SA1/WASH/NGO/16405,5/9/2021 12:50:14 PM,Overall,2513,2719,3354,3171,11757,2859,3075,3948,3717,13599
73,Jordan,2020,JOR-20/DDA-3560/SA1/WASH/NGO/16405,5/9/2021 12:50:14 PM,Refugees,1913,2081,2554,2509,9057,2126,2293,2829,2738,9986
73,Jordan,2020,JOR-20/DDA-3560/SA2/BN/INGO/17528,7/29/2021 12:06:46 PM,Host Communities,244,291,314,314,1163,247,320,276,318,1161
73,Jordan,2020,JOR-20/DDA-3560/SA2/BN/INGO/17528,7/29/2021 12:06:46 PM,Overall,814,969,1046,1046,3875,845,929,993,1041,3808
73,Jordan,2020,JOR-20/DDA-3560/SA2/BN/INGO/17528,7/29/2021 12:06:46 PM,Refugees,570,678,732,732,2712,598,609,717,723,2647
73,Jordan,2020,JOR-20/DDA-3560/SA2/BN/INGO/17547,7/11/2021 12:28:47 PM,Host Communities,169,266,280,280,995,243,298,318,279,1138
73,Jordan,2020,JOR-20/DDA-3560/SA2/BN/INGO/17547,7/11/2021 12:28:47 PM,Overall,560,878,931,931,3300,767,864,964,909,3504
73,Jordan,2020,JOR-20/DDA-3560/SA2/BN/INGO/17547,7/11/2021 12:28:47 PM,Refugees,391,612,651,651,2305,524,566,646,630,2366
73,Jordan,2020,JOR-20/DDA-3560/SA2/BN/INGO/17552,9/7/2021 9:00:32 AM,Host Communities,326,353,340,340,1359,345,375,360,359,1439
73,Jordan,2020,JOR-20/DDA-3560/SA2/BN/INGO/17552,9/7/2021 9:00:32 AM,Overall,1087,1177,1132,1132,4528,1040,1192,1401,1171,4804
73,Jordan,2020,JOR-20/DDA-3560/SA2/BN/INGO/17552,9/7/2021 9:00:32 AM,Refugees,761,824,792,792,3169,695,817,1041,812,3365
73,Jordan,2020,JOR-20/DDA-3560/SA2/BN/NGO/17610,6/17/2021 11:19:45 AM,Host Communities,234,268,300,323,1125,235,267,300,323,1125
73,Jordan,2020,JOR-20/DDA-3560/SA2/BN/NGO/17610,6/17/2021 11:19:45 AM,Overall,782,897,1003,1078,3760,785,897,1004,1084,3770
73,Jordan,2020,JOR-20/DDA-3560/SA2/BN/NGO/17610,6/17/2021 11:19:45 AM,Refugees,548,629,703,755,2635,550,630,704,761,2645
73,Jordan,2020,JOR-20/DDA-3560/SA2/BN-P/INGO/17591,10/4/2021 11:14:01 AM,Host Communities,376,550,0,0,926,380,561,0,0,941
73,Jordan,2020,JOR-20/DDA-3560/SA2/BN-P/INGO/17591,10/4/2021 11:14:01 AM,Overall,657,1106,0,0,1763,685,1133,0,0,1818
73,Jordan,2020,JOR-20/DDA-3560/SA2/BN-P/INGO/17591,10/4/2021 11:14:01 AM,Refugees,281,556,0,0,837,305,572,0,0,877
73,Jordan,2020,JOR-20/DDA-3560/SA2/P/INGO/17620,7/5/2022 6:10:14 AM,Host Communities,625,7500,625,1250,10000,2377,28530,2377,4755,38039
73,Jordan,2020,JOR-20/DDA-3560/SA2/P/INGO/17620,7/5/2022 6:10:14 AM,Overall,1250,15000,1250,2500,20000,4754,57061,4754,9510,76079
73,Jordan,2020,JOR-20/DDA-3560/SA2/P/INGO/17620,7/5/2022 6:10:14 AM,Refugees,625,7500,625,1250,10000,2377,28531,2377,4755,38040
73,Jordan,2020,JOR-20/DDA-3560/SA2/P/NGO/17526,1/2/2022 8:24:59 AM,Host Communities,259,295,125,77,756,229,570,73,116,988
73,Jordan,2020,JOR-20/DDA-3560/SA2/P/NGO/17526,1/2/2022 8:24:59 AM,Overall,862,983,417,258,2520,793,1616,199,298,2906
73,Jordan,2020,JOR-20/DDA-3560/SA2/P/NGO/17526,1/2/2022 8:24:59 AM,Refugees,603,688,292,181,1764,564,1046,126,182,1918
73,Jordan,2020,JOR-20/DDA-3560/SA2/P-Sh./NGO/17598,3/3/2022 11:03:19 AM,Host Communities,135,355,170,170,830,57,230,115,127,529
73,Jordan,2020,JOR-20/DDA-3560/SA2/P-Sh./NGO/17598,3/3/2022 11:03:19 AM,Overall,225,775,425,425,1850,289,662,383,391,1725
73,Jordan,2020,JOR-20/DDA-3560/SA2/P-Sh./NGO/17598,3/3/2022 11:03:19 AM,Refugees,90,420,255,255,1020,232,432,268,264,1196
73,Jordan,2020,JOR-20/DDA-3560/SA2/Sh./INGO/17533,8/17/2021 11:20:02 AM,Host Communities,112,119,110,108,449,105,104,111,113,433
73,Jordan,2020,JOR-20/DDA-3560/SA2/Sh./INGO/17533,8/17/2021 11:20:02 AM,Overall,375,397,367,361,1500,316,337,460,450,1563
73,Jordan,2020,JOR-20/DDA-3560/SA2/Sh./INGO/17533,8/17/2021 11:20:02 AM,Refugees,263,278,257,253,1051,211,233,349,337,1130
73,Jordan,2021,JOR-21/DDA-3560/RA1/H/INGO/19974,3/13/2022 9:57:26 AM,Overall,503,2345,698,729,4275,652,2418,1173,1218,5461
73,Jordan,2021,JOR-21/DDA-3560/RA1/H/INGO/19974,3/13/2022 9:57:26 AM,Refugees,503,2345,698,729,4275,652,2418,1173,1218,5461
73,Jordan,2021,JOR-21/DDA-3560/SA1/H/INGO/18742,1/23/2022 10:46:26 AM,Host Communities,0,48,24,24,96,0,14,8,6,28
73,Jordan,2021,JOR-21/DDA-3560/SA1/H/INGO/18742,1/23/2022 10:46:26 AM,Overall,20,1224,281,288,1813,28,539,222,238,1027
73,Jordan,2021,JOR-21/DDA-3560/SA1/H/INGO/18742,1/23/2022 10:46:26 AM,Refugees,20,1176,257,264,1717,28,525,214,232,999
73,Jordan,2021,JOR-21/DDA-3560/SA1/H/INGO/18780,4/7/2022 6:57:13 AM,Host Communities,176,49,0,0,225,186,39,0,0,225
73,Jordan,2021,JOR-21/DDA-3560/SA1/H/INGO/18780,4/7/2022 6:57:13 AM,Overall,214,462,19,43,738,213,456,49,58,776
73,Jordan,2021,JOR-21/DDA-3560/SA1/H/INGO/18780,4/7/2022 6:57:13 AM,Refugees,38,413,19,43,513,27,417,49,58,551
73,Jordan,2021,JOR-21/DDA-3560/SA1/H/O/18930,5/30/2022 3:04:01 PM,Overall,29,43,2,1,75,56,53,2,1,112
73,Jordan,2021,JOR-21/DDA-3560/SA1/H/O/18930,5/30/2022 3:04:01 PM,Refugees,29,43,2,1,75,56,53,2,1,112
73,Jordan,2021,JOR-21/DDA-3560/SA1/P/INGO/18775,12/19/2022 12:17:15 PM,Host Communities,57,59,169,169,454,30,94,242,216,582
73,Jordan,2021,JOR-21/DDA-3560/SA1/P/INGO/18775,12/19/2022 12:17:15 PM,Overall,189,197,565,565,1516,126,268,640,634,1668
73,Jordan,2021,JOR-21/DDA-3560/SA1/P/INGO/18775,12/19/2022 12:17:15 PM,Refugees,132,138,396,396,1062,96,174,398,418,1086
73,Jordan,2021,JOR-21/DDA-3560/SA1/P/INGO/18804,12/5/2022 6:50:53 AM,Host Communities,63,93,188,189,533,222,415,363,299,1299
73,Jordan,2021,JOR-21/DDA-3560/SA1/P/INGO/18804,12/5/2022 6:50:53 AM,Overall,208,310,626,629,1773,414,758,689,657,2518
73,Jordan,2021,JOR-21/DDA-3560/SA1/P/INGO/18804,12/5/2022 6:50:53 AM,Refugees,145,217,438,440,1240,192,343,326,358,1219
73,Jordan,2021,JOR-21/DDA-3560/SA1/P/NGO/18752,2/2/2023 12:14:00 PM,Host Communities,2432,9834,7082,7779,27127,2098,12228,8873,14190,37389
73,Jordan,2021,JOR-21/DDA-3560/SA1/P/NGO/18752,2/2/2023 12:14:00 PM,Overall,4300,17266,13260,14223,49049,3318,17579,12274,18274,51445
73,Jordan,2021,JOR-21/DDA-3560/SA1/P/NGO/18752,2/2/2023 12:14:00 PM,Refugees,1868,7432,6178,6444,21922,1220,5351,3401,4084,14056
73,Jordan,2022,JOR-22/DDA-3560/RA1/H/O/21881,1/11/2023 7:19:42 AM,Overall,54,53,2,3,112,59,61,2,4,126
73,Jordan,2022,JOR-22/DDA-3560/RA1/H/O/21881,1/11/2023 7:19:42 AM,Refugees,54,53,2,3,112,59,61,2,4,126
71,Lebanon,2015,LEB-15/DDA-3604/Call for Proposals/BA/INGO/1662,11/4/2016 2:43:43 PM,Other,3,0,0,0,3,3,0,0,0,3
71,Lebanon,2015,LEB-15/DDA-3604/Call for Proposals/BA/INGO/1662,11/4/2016 2:43:43 PM,Overall,3142,3019,2516,2323,11000,4122,3838,3270,2985,14215
71,Lebanon,2015,LEB-15/DDA-3604/Call for Proposals/BA/INGO/1662,11/4/2016 2:43:43 PM,Refugees,3142,3019,2516,2323,11000,4122,3838,3270,2985,14215
71,Lebanon,2015,LEB-15/DDA-3604/Call for Proposals/BA-LH-P/NGO/1643,2/21/2017 11:04:05 AM,Host Communities,0,200,0,0,200,0,45,28,26,99
71,Lebanon,2015,LEB-15/DDA-3604/Call for Proposals/BA-LH-P/NGO/1643,2/21/2017 11:04:05 AM,Overall,0,1220,125,125,1470,156,1080,455,524,2215
71,Lebanon,2015,LEB-15/DDA-3604/Call for Proposals/BA-LH-P/NGO/1643,2/21/2017 11:04:05 AM,Refugees,0,1020,125,125,1270,156,1035,427,498,2116
71,Lebanon,2015,LEB-15/DDA-3604/Call for Proposals/E/NGO/1604,12/5/2016 2:11:27 PM,Host Communities,3,7,175,240,425,0,0,970,1127,2097
71,Lebanon,2015,LEB-15/DDA-3604/Call for Proposals/E/NGO/1604,12/5/2016 2:11:27 PM,Overall,3,7,505,640,1155,0,0,3806,4376,8182
71,Lebanon,2015,LEB-15/DDA-3604/Call for Proposals/E/NGO/1604,12/5/2016 2:11:27 PM,Refugees,2,2,330,400,734,0,0,2836,3249,6085
71,Lebanon,2015,LEB-15/DDA-3604/Call for Proposals/FS/UN/1541,2/21/2017 11:46:33 AM,Host Communities,5,25,0,0,30,0,76,0,0,76
71,Lebanon,2015,LEB-15/DDA-3604/Call for Proposals/FS/UN/1541,2/21/2017 11:46:33 AM,Overall,25,125,0,0,150,0,170,0,0,170
71,Lebanon,2015,LEB-15/DDA-3604/Call for Proposals/FS/UN/1541,2/21/2017 11:46:33 AM,Refugees,20,100,0,0,120,0,94,0,0,94
71,Lebanon,2015,LEB-15/DDA-3604/Call for Proposals/H/INGO/1574,11/7/2016 10:07:17 AM,Host Communities,10,42,30,22,104,15,54,31,22,122
71,Lebanon,2015,LEB-15/DDA-3604/Call for Proposals/H/INGO/1574,11/7/2016 10:07:17 AM,Other,10,40,0,0,50,0,0,0,0,0
71,Lebanon,2015,LEB-15/DDA-3604/Call for Proposals/H/INGO/1574,11/7/2016 10:07:17 AM,Overall,80,320,206,149,755,98,346,210,156,810
71,Lebanon,2015,LEB-15/DDA-3604/Call for Proposals/H/INGO/1574,11/7/2016 10:07:17 AM,Refugees,60,238,176,127,601,83,292,179,134,688
71,Lebanon,2015,LEB-15/DDA-3604/Call for Proposals/H/NGO/1609,5/23/2016 9:45:17 AM,Overall,0,21,21,21,63,0,27,19,23,69
71,Lebanon,2015,LEB-15/DDA-3604/Call for Proposals/H/NGO/1617,12/5/2016 12:21:01 PM,Host Communities,1566,1134,75,75,2850,7802,9616,29,14,17461
71,Lebanon,2015,LEB-15/DDA-3604/Call for Proposals/H/NGO/1617,12/5/2016 12:21:01 PM,Overall,5220,3780,250,250,9500,12696,15407,51,23,28177
71,Lebanon,2015,LEB-15/DDA-3604/Call for Proposals/H/NGO/1617,12/5/2016 12:21:01 PM,Refugees,3650,2646,175,175,6646,4894,5791,22,9,10716
71,Lebanon,2015,LEB-15/DDA-3604/Call for Proposals/P/INGO/1575,12/16/2016 8:29:51 AM,Host Communities,300,300,150,150,900,0,0,7,11,18
71,Lebanon,2015,LEB-15/DDA-3604/Call for Proposals/P/INGO/1575,12/16/2016 8:29:51 AM,Overall,1000,1000,750,750,3500,419,842,2025,1941,5227
71,Lebanon,2015,LEB-15/DDA-3604/Call for Proposals/P/INGO/1575,12/16/2016 8:29:51 AM,Refugees,700,700,600,600,2600,419,842,2018,1930,5209
71,Lebanon,2015,LEB-15/DDA-3604/Call for Proposals/P/INGO/1576,6/12/2017 3:52:46 PM,Host Communities,0,80,3,20,103,0,71,2,18,91
71,Lebanon,2015,LEB-15/DDA-3604/Call for Proposals/P/INGO/1576,6/12/2017 3:52:46 PM,Other,0,0,2,0,2,0,0,2,0,2
71,Lebanon,2015,LEB-15/DDA-3604/Call for Proposals/P/INGO/1576,6/12/2017 3:52:46 PM,Overall,30,1780,33,733,2576,51,710,31,186,978
71,Lebanon,2015,LEB-15/DDA-3604/Call for Proposals/P/INGO/1576,6/12/2017 3:52:46 PM,Refugees,30,1700,28,713,2471,51,639,27,174,891
71,Lebanon,2015,LEB-15/DDA-3604/Call for Proposals/P/INGO/1594,4/21/2017 11:20:12 AM,Overall,498,656,632,644,2430,436,568,528,538,2070
71,Lebanon,2015,LEB-15/DDA-3604/Call for Proposals/P/INGO/1594,4/21/2017 11:20:12 AM,Refugees,498,656,632,644,2430,436,568,528,538,2070
71,Lebanon,2015,LEB-15/DDA-3604/Call for Proposals/P/INGO/1626,11/4/2016 2:45:41 PM,Host Communities,40,170,5,41,256,0,0,0,0,0
71,Lebanon,2015,LEB-15/DDA-3604/Call for Proposals/P/INGO/1626,11/4/2016 2:45:41 PM,Overall,200,950,25,205,1380,107,1267,0,110,1484
71,Lebanon,2015,LEB-15/DDA-3604/Call for Proposals/P/INGO/1626,11/4/2016 2:45:41 PM,Refugees,160,780,20,164,1124,107,1267,0,110,1484
71,Lebanon,2015,LEB-15/DDA-3604/Call for Proposals/P/INGO/1635,8/18/2016 7:38:40 PM,Host Communities,43,255,21,121,440,0,105,0,0,105
71,Lebanon,2015,LEB-15/DDA-3604/Call for Proposals/P/INGO/1635,8/18/2016 7:38:40 PM,Overall,120,850,70,402,1442,132,1598,15,158,1903
71,Lebanon,2015,LEB-15/DDA-3604/Call for Proposals/P/INGO/1635,8/18/2016 7:38:40 PM,Refugees,77,595,49,281,1002,132,1493,15,158,1798
71,Lebanon,2015,LEB-15/DDA-3604/Call for Proposals/P/INGO/1657,1/9/2017 4:19:16 PM,Overall,3162,2566,0,0,5728,2393,3693,0,0,6086
71,Lebanon,2015,LEB-15/DDA-3604/Call for Proposals/P/INGO/1657,1/9/2017 4:19:16 PM,Refugees,3162,2566,0,0,5728,2393,3693,0,0,6086
71,Lebanon,2015,LEB-15/DDA-3604/Call for Proposals/P/INGO/1659,12/16/2016 9:57:17 AM,Host Communities,105,0,0,0,105,127,0,0,0,127
71,Lebanon,2015,LEB-15/DDA-3604/Call for Proposals/P/INGO/1659,12/16/2016 9:57:17 AM,Overall,350,0,0,0,350,582,0,0,0,582
71,Lebanon,2015,LEB-15/DDA-3604/Call for Proposals/P/INGO/1659,12/16/2016 9:57:17 AM,Refugees,245,0,0,0,245,455,0,0,0,455
71,Lebanon,2015,LEB-15/DDA-3604/Call for Proposals/P/NGO/1555,11/4/2016 2:34:39 PM,Host Communities,0,0,54,54,108,0,0,55,54,109
71,Lebanon,2015,LEB-15/DDA-3604/Call for Proposals/P/NGO/1555,11/4/2016 2:34:39 PM,Overall,0,0,90,90,180,0,0,109,71,180
71,Lebanon,2015,LEB-15/DDA-3604/Call for Proposals/P/NGO/1555,11/4/2016 2:34:39 PM,Refugees,0,0,36,36,72,0,0,54,17,71
71,Lebanon,2015,LEB-15/DDA-3604/Call for Proposals/P/NGO/1577,3/20/2017 1:04:26 PM,Host Communities,100,60,0,0,160,283,95,4,2,384
71,Lebanon,2015,LEB-15/DDA-3604/Call for Proposals/P/NGO/1577,3/20/2017 1:04:26 PM,Other,50,50,10,10,120,29,7,0,0,36
71,Lebanon,2015,LEB-15/DDA-3604/Call for Proposals/P/NGO/1577,3/20/2017 1:04:26 PM,Overall,400,210,50,40,700,553,298,54,33,938
71,Lebanon,2015,LEB-15/DDA-3604/Call for Proposals/P/NGO/1577,3/20/2017 1:04:26 PM,Refugees,250,100,40,30,420,241,196,50,31,518
71,Lebanon,2015,LEB-15/DDA-3604/Call for Proposals/P/NGO/1580,8/18/2016 7:36:16 PM,Overall,0,0,30,30,60,0,0,31,46,77
71,Lebanon,2015,LEB-15/DDA-3604/Call for Proposals/P/NGO/1647,3/8/2017 8:52:00 AM,Host Communities,32,32,49,49,162,0,40,32,34,106
71,Lebanon,2015,LEB-15/DDA-3604/Call for Proposals/P/NGO/1647,3/8/2017 8:52:00 AM,Overall,160,160,225,225,770,11,403,335,312,1061
71,Lebanon,2015,LEB-15/DDA-3604/Call for Proposals/P/NGO/1647,3/8/2017 8:52:00 AM,Refugees,128,128,196,196,648,11,323,303,278,915
71,Lebanon,2015,LEB-15/DDA-3604/Call for Proposals/P/NGO/1655,1/5/2017 6:50:18 AM,Overall,300,300,0,0,600,236,78,0,0,314
71,Lebanon,2015,LEB-15/DDA-3604/Call for Proposals/P/NGO/1655,1/5/2017 6:50:18 AM,Refugees,300,300,0,0,600,236,78,0,0,314
71,Lebanon,2015,LEB-15/DDA-3604/Call for Proposals/P/UN/1637,11/16/2016 9:54:01 AM,Host Communities,64484,72716,67116,75684,280000,64484,72716,67116,75684,280000
71,Lebanon,2015,LEB-15/DDA-3604/Call for Proposals/P/UN/1637,11/16/2016 9:54:01 AM,Overall,1950,1708,0,0,3658,4625,3346,0,0,7971
71,Lebanon,2015,LEB-15/DDA-3604/Call for Proposals/P/UN/1637,11/16/2016 9:54:01 AM,Refugees,13026,13406,8808,9065,44305,13026,13406,8808,9065,44305
71,Lebanon,2015,LEB-15/DDA-3604/Call for Proposals/P-H/NGO/1642,6/21/2016 6:07:59 AM,Host Communities,150,150,25,25,350,110,117,0,0,227
71,Lebanon,2015,LEB-15/DDA-3604/Call for Proposals/P-H/NGO/1642,6/21/2016 6:07:59 AM,Overall,300,300,50,50,700,252,268,0,0,520
71,Lebanon,2015,LEB-15/DDA-3604/Call for Proposals/P-H/NGO/1642,6/21/2016 6:07:59 AM,Refugees,150,150,25,25,350,162,126,0,0,288
71,Lebanon,2015,LEB-15/DDA-3604/Call for Proposals/SS-P/NGO/1624,1/19/2017 12:21:28 PM,Host Communities,20472,10528,6845,6343,44188,0,0,0,0,0
71,Lebanon,2015,LEB-15/DDA-3604/Call for Proposals/SS-P/NGO/1624,1/19/2017 12:21:28 PM,Overall,10,40,0,20,70,13,42,0,20,75
71,Lebanon,2015,LEB-15/DDA-3604/Call for Proposals/SS-P/NGO/1624,1/19/2017 12:21:28 PM,Refugees,8500,10340,3600,2700,25140,0,0,0,0,0
71,Lebanon,2015,LEB-15/DDA-3604/Call for Proposals/W/NGO/1606,6/20/2016 10:39:21 AM,Overall,6566,7373,4493,4608,23040,6566,7373,4493,18432,36864
71,Lebanon,2015,LEB-15/DDA-3604/Win/S/INGO/1138,9/28/2015 6:45:25 AM,Host Communities,182,297,126,113,718,167,192,192,181,732
71,Lebanon,2015,LEB-15/DDA-3604/Win/S/INGO/1138,9/28/2015 6:45:25 AM,Overall,1164,1342,1341,1265,5112,1200,1383,1382,1303,5268
71,Lebanon,2015,LEB-15/DDA-3604/Win/S/INGO/1138,9/28/2015 6:45:25 AM,Refugees,982,1135,1215,1152,4484,1033,1191,1190,1122,4536
71,Lebanon,2015,LEB-15/DDA-3604/Win/S/INGO/1139,9/21/2015 6:57:05 AM,Overall,505,731,980,1109,3325,470,645,926,1046,3087
71,Lebanon,2015,LEB-15/DDA-3604/Win/S/INGO/1139,9/21/2015 6:57:05 AM,Refugees,505,731,980,1109,3325,470,645,926,1046,3087
71,Lebanon,2015,LEB-15/DDA-3604/Win/S/INGO/1141,9/16/2015 8:29:31 AM,Host Communities,326,336,206,217,1085,431,532,708,743,2414
71,Lebanon,2015,LEB-15/DDA-3604/Win/S/INGO/1141,9/16/2015 8:29:31 AM,Overall,1901,1964,1204,1267,6336,2334,2510,2135,2249,9228
71,Lebanon,2015,LEB-15/DDA-3604/Win/S/INGO/1141,9/16/2015 8:29:31 AM,Refugees,1575,1628,998,1050,5251,1903,1978,1427,1506,6814
71,Lebanon,2015,LEB-15/DDA-3604/Win/S/INGO/1144,9/21/2015 6:58:52 AM,Overall,1473,1137,1455,1510,5575,1199,1403,1506,1451,5559
71,Lebanon,2015,LEB-15/DDA-3604/Win/S/INGO/1144,9/21/2015 6:58:52 AM,Refugees,1473,1137,1455,1510,5575,1199,1403,1506,1451,5559
71,Lebanon,2015,LEB-15/DDA-3604/Win/S/INGO/1145,9/21/2015 7:00:43 AM,Overall,819,632,811,836,3098,814,1056,1224,1693,4787
71,Lebanon,2015,LEB-15/DDA-3604/Win/S/INGO/1145,9/21/2015 7:00:43 AM,Refugees,819,632,811,836,3098,814,1056,1224,1693,4787
71,Lebanon,2015,LEB-15/DDA-3604/Win/S/NGO/1142,9/21/2015 10:50:07 AM,Host Communities,1538,515,1605,532,4190,1538,515,1605,532,4190
71,Lebanon,2015,LEB-15/DDA-3604/Win/S/NGO/1142,9/21/2015 10:50:07 AM,Overall,1909,2085,1009,1007,6010,1909,2085,1009,1007,6010
71,Lebanon,2015,LEB-15/DDA-3604/Win/S/NGO/1142,9/21/2015 10:50:07 AM,Refugees,371,494,480,475,1820,371,494,480,475,1820
71,Lebanon,2015,LEB-15/DDA-3604/Win/S/NGO/1146,6/20/2016 10:52:22 AM,Overall,4870,5520,9750,11163,31303,4870,5520,9750,11163,31303
71,Lebanon,2015,LEB-15/DDA-3604/Win/WASH/INGO/1147,6/20/2016 10:34:47 AM,Overall,475,368,469,488,1800,705,700,775,780,2960
71,Lebanon,2015,LEB-15/DDA-3604/Win/WASH/INGO/1147,6/20/2016 10:34:47 AM,Refugees,475,368,469,488,1800,705,700,775,780,2960
71,Lebanon,2016,LEB-16/DDA-3604/Call for proposals/BA/INGO/2351,4/18/2017 7:39:38 AM,Host Communities,76,52,108,137,373,92,96,52,56,296
71,Lebanon,2016,LEB-16/DDA-3604/Call for proposals/BA/INGO/2351,4/18/2017 7:39:38 AM,Overall,522,572,720,686,2500,517,599,669,628,2413
71,Lebanon,2016,LEB-16/DDA-3604/Call for proposals/BA/INGO/2351,4/18/2017 7:39:38 AM,Refugees,446,520,612,549,2127,425,503,617,572,2117
71,Lebanon,2016,LEB-16/DDA-3604/Call for proposals/BA/INGO/2352,7/14/2017 12:01:32 PM,Host Communities,98,128,205,222,653,98,128,205,222,653
71,Lebanon,2016,LEB-16/DDA-3604/Call for proposals/BA/INGO/2352,7/14/2017 12:01:32 PM,Overall,490,640,1026,1109,3265,490,640,1026,1109,3265
71,Lebanon,2016,LEB-16/DDA-3604/Call for proposals/BA/INGO/2352,7/14/2017 12:01:32 PM,Refugees,392,512,821,887,2612,392,512,821,887,2612
71,Lebanon,2016,LEB-16/DDA-3604/Call for proposals/BA/INGO/2480,5/23/2017 8:46:17 AM,Host Communities,103,121,127,117,468,103,131,127,117,478
71,Lebanon,2016,LEB-16/DDA-3604/Call for proposals/BA/INGO/2480,5/23/2017 8:46:17 AM,Overall,687,807,850,781,3125,687,807,850,781,3125
71,Lebanon,2016,LEB-16/DDA-3604/Call for proposals/BA/INGO/2480,5/23/2017 8:46:17 AM,Refugees,584,686,723,664,2657,584,686,723,664,2657
71,Lebanon,2016,LEB-16/DDA-3604/Call for proposals/BA/INGO/2493,7/17/2017 12:08:08 PM,Host Communities,1056,1035,544,533,3168,1056,1035,544,533,3168
71,Lebanon,2016,LEB-16/DDA-3604/Call for proposals/BA/INGO/2493,7/17/2017 12:08:08 PM,Overall,1056,1035,544,533,3168,1056,1035,544,533,3168
71,Lebanon,2016,LEB-16/DDA-3604/Call for proposals/BA/INGO/2498,6/7/2017 3:58:19 PM,Host Communities,86,106,110,105,407,86,106,110,105,407
71,Lebanon,2016,LEB-16/DDA-3604/Call for proposals/BA/INGO/2498,6/7/2017 3:58:19 PM,Overall,496,613,637,611,2357,432,582,491,524,2029
71,Lebanon,2016,LEB-16/DDA-3604/Call for proposals/BA/INGO/2498,6/7/2017 3:58:19 PM,Refugees,410,507,527,506,1950,346,476,381,419,1622
71,Lebanon,2016,LEB-16/DDA-3604/Call for proposals/BA/NGO/2364,7/26/2017 4:06:41 PM,Host Communities,337,506,1348,2024,4215,751,101,0,0,852
71,Lebanon,2016,LEB-16/DDA-3604/Call for proposals/BA/NGO/2364,7/26/2017 4:06:41 PM,Overall,337,506,1348,2024,4215,751,101,0,0,852
71,Lebanon,2016,LEB-16/DDA-3604/Call for proposals/FS/INGO/2353,4/24/2017 7:50:18 AM,Host Communities,130,485,117,117,849,68,218,34,38,358
71,Lebanon,2016,LEB-16/DDA-3604/Call for proposals/FS/INGO/2353,4/24/2017 7:50:18 AM,Overall,340,1414,467,483,2704,736,2054,132,143,3065
71,Lebanon,2016,LEB-16/DDA-3604/Call for proposals/FS/INGO/2353,4/24/2017 7:50:18 AM,Refugees,210,929,350,366,1855,668,1836,98,105,2707
71,Lebanon,2016,LEB-16/DDA-3604/Call for proposals/FS-P/INGO/2395,8/22/2017 10:38:18 AM,Overall,1135,1165,1375,1375,5050,1094,1889,1436,1535,5954
71,Lebanon,2016,LEB-16/DDA-3604/Call for proposals/FS-P/INGO/2395,8/22/2017 10:38:18 AM,Refugees,1135,1165,1375,1375,5050,1094,1889,1436,1535,5954
71,Lebanon,2016,LEB-16/DDA-3604/Call for proposals/H/INGO/2380,11/6/2017 9:53:13 AM,Overall,81,49,9,15,154,91,86,16,7,200
71,Lebanon,2016,LEB-16/DDA-3604/Call for proposals/H/INGO/2380,11/6/2017 9:53:13 AM,Refugees,81,49,9,15,154,91,86,16,7,200
71,Lebanon,2016,LEB-16/DDA-3604/Call for Proposals/H/INGO/3226,1/8/2018 10:53:20 AM,Host Communities,2689,3329,3457,3329,12804,5285,9748,4271,4265,23569
71,Lebanon,2016,LEB-16/DDA-3604/Call for Proposals/H/INGO/3226,1/8/2018 10:53:20 AM,Overall,8963,11097,11524,11097,42681,6442,14839,7789,7785,36855
71,Lebanon,2016,LEB-16/DDA-3604/Call for Proposals/H/INGO/3226,1/8/2018 10:53:20 AM,Refugees,6274,7768,8067,7768,29877,1157,5091,3518,3520,13286
71,Lebanon,2016,LEB-16/DDA-3604/Call for Proposals/H/INGO/3280,3/30/2018 9:37:22 AM,Host Communities,3232,7023,3276,3269,16800,1816,5357,4187,4300,15660
71,Lebanon,2016,LEB-16/DDA-3604/Call for Proposals/H/INGO/3280,3/30/2018 9:37:22 AM,Overall,6647,14564,10622,10167,42000,4655,13735,10733,11025,40148
71,Lebanon,2016,LEB-16/DDA-3604/Call for Proposals/H/INGO/3280,3/30/2018 9:37:22 AM,Refugees,3415,7541,7346,6898,25200,2839,8378,6546,6725,24488
71,Lebanon,2016,LEB-16/DDA-3604/Call for Proposals/H/UN/3317,4/5/2018 4:41:34 PM,Host Communities,440,660,2050,2050,5200,396,474,495,394,1759
71,Lebanon,2016,LEB-16/DDA-3604/Call for Proposals/H/UN/3317,4/5/2018 4:41:34 PM,Other,0,0,950,950,1900,0,0,27100,30149,57249
71,Lebanon,2016,LEB-16/DDA-3604/Call for Proposals/H/UN/3317,4/5/2018 4:41:34 PM,Overall,4400,6600,14000,14000,39000,2958,6956,32220,34943,77077
71,Lebanon,2016,LEB-16/DDA-3604/Call for Proposals/H/UN/3317,4/5/2018 4:41:34 PM,Refugees,3960,5940,11000,11000,31900,2562,6482,4625,4400,18069
71,Lebanon,2016,LEB-16/DDA-3604/Call for proposals/LH/NGO/2502,11/13/2017 4:08:18 PM,Host Communities,40,50,0,0,90,35,20,0,0,55
71,Lebanon,2016,LEB-16/DDA-3604/Call for proposals/LH/NGO/2502,11/13/2017 4:08:18 PM,Internally Displaced People,30,30,0,0,60,0,0,0,0,0
71,Lebanon,2016,LEB-16/DDA-3604/Call for proposals/LH/NGO/2502,11/13/2017 4:08:18 PM,Overall,70,80,0,0,150,35,20,0,0,55
71,Lebanon,2016,LEB-16/DDA-3604/Call for proposals/P/INGO/2362,7/14/2017 11:30:17 AM,Host Communities,8,165,0,103,276,0,150,0,105,255
71,Lebanon,2016,LEB-16/DDA-3604/Call for proposals/P/INGO/2362,7/14/2017 11:30:17 AM,Overall,50,1100,0,690,1840,50,1105,0,695,1850
71,Lebanon,2016,LEB-16/DDA-3604/Call for proposals/P/INGO/2362,7/14/2017 11:30:17 AM,Refugees,42,935,0,587,1564,50,935,0,590,1575
71,Lebanon,2016,LEB-16/DDA-3604/Call for proposals/P/INGO/2488,4/13/2017 9:37:59 AM,Host Communities,29,172,25,50,276,24,160,0,0,184
71,Lebanon,2016,LEB-16/DDA-3604/Call for proposals/P/INGO/2488,4/13/2017 9:37:59 AM,Overall,146,860,125,250,1381,258,1120,12,271,1661
71,Lebanon,2016,LEB-16/DDA-3604/Call for proposals/P/INGO/2488,4/13/2017 9:37:59 AM,Refugees,117,688,100,200,1105,234,960,12,271,1477
71,Lebanon,2016,LEB-16/DDA-3604/Call for Proposals/P/INGO/3225,1/9/2018 9:07:50 AM,Host Communities,90,3145,180,929,4344,101,5620,210,1144,7075
71,Lebanon,2016,LEB-16/DDA-3604/Call for Proposals/P/INGO/3225,1/9/2018 9:07:50 AM,Overall,225,7862,450,2323,10860,331,15214,292,2716,18553
71,Lebanon,2016,LEB-16/DDA-3604/Call for Proposals/P/INGO/3225,1/9/2018 9:07:50 AM,Refugees,135,4717,270,1394,6516,230,9594,82,1572,11478
71,Lebanon,2016,LEB-16/DDA-3604/Call for Proposals/P/INGO/3239,2/14/2018 1:21:43 PM,Host Communities,40,41,42,60,183,20,59,1,100,180
71,Lebanon,2016,LEB-16/DDA-3604/Call for Proposals/P/INGO/3239,2/14/2018 1:21:43 PM,Overall,405,417,425,598,1845,170,473,200,590,1433
71,Lebanon,2016,LEB-16/DDA-3604/Call for Proposals/P/INGO/3239,2/14/2018 1:21:43 PM,Refugees,365,376,383,538,1662,150,414,199,490,1253
71,Lebanon,2016,LEB-16/DDA-3604/Call for Proposals/P/INGO/3297,3/30/2018 10:41:28 AM,Host Communities,40,60,0,0,100,13,64,0,0,77
71,Lebanon,2016,LEB-16/DDA-3604/Call for Proposals/P/INGO/3297,3/30/2018 10:41:28 AM,Overall,80,120,0,0,200,72,128,0,0,200
71,Lebanon,2016,LEB-16/DDA-3604/Call for Proposals/P/INGO/3297,3/30/2018 10:41:28 AM,Refugees,40,60,0,0,100,57,66,0,0,123
71,Lebanon,2016,LEB-16/DDA-3604/Call for Proposals/P/INGO/3311,8/6/2018 3:31:25 AM,Host Communities,50,169,0,140,359,131,661,0,502,1294
71,Lebanon,2016,LEB-16/DDA-3604/Call for Proposals/P/INGO/3311,8/6/2018 3:31:25 AM,Overall,250,655,0,660,1565,171,881,0,671,1723
71,Lebanon,2016,LEB-16/DDA-3604/Call for Proposals/P/INGO/3311,8/6/2018 3:31:25 AM,Refugees,200,486,0,520,1206,40,220,0,169,429
71,Lebanon,2016,LEB-16/DDA-3604/Call for Proposals/P/INGO/3316,11/17/2017 1:05:27 PM,Host Communities,127,398,128,1079,1732,130,520,137,850,1637
71,Lebanon,2016,LEB-16/DDA-3604/Call for Proposals/P/INGO/3316,11/17/2017 1:05:27 PM,Overall,632,1988,640,5394,8654,691,2289,682,5237,8899
71,Lebanon,2016,LEB-16/DDA-3604/Call for Proposals/P/INGO/3316,11/17/2017 1:05:27 PM,Refugees,505,1590,512,4315,6922,561,1769,545,4387,7262
71,Lebanon,2016,LEB-16/DDA-3604/Call for proposals/P/NGO/2389,5/23/2017 8:57:59 AM,Host Communities,45,112,0,0,157,238,293,0,1,532
71,Lebanon,2016,LEB-16/DDA-3604/Call for proposals/P/NGO/2389,5/23/2017 8:57:59 AM,Overall,425,305,0,0,730,655,591,0,1,1247
71,Lebanon,2016,LEB-16/DDA-3604/Call for proposals/P/NGO/2389,5/23/2017 8:57:59 AM,Refugees,380,193,0,0,573,417,298,0,0,715
71,Lebanon,2016,LEB-16/DDA-3604/Call for proposals/P/NGO/2436,4/18/2017 8:50:13 AM,Host Communities,0,0,24,24,48,0,0,72,43,115
71,Lebanon,2016,LEB-16/DDA-3604/Call for proposals/P/NGO/2436,4/18/2017 8:50:13 AM,Overall,0,0,60,60,120,0,0,141,79,220
71,Lebanon,2016,LEB-16/DDA-3604/Call for proposals/P/NGO/2436,4/18/2017 8:50:13 AM,Refugees,0,0,36,36,72,0,0,69,36,105
71,Lebanon,2016,LEB-16/DDA-3604/Call for proposals/P/NGO/2504,6/12/2017 4:13:32 PM,Host Communities,0,30,10,0,40,0,41,12,26,79
71,Lebanon,2016,LEB-16/DDA-3604/Call for proposals/P/NGO/2504,6/12/2017 4:13:32 PM,Other,0,0,0,0,0,0,5,1,0,6
71,Lebanon,2016,LEB-16/DDA-3604/Call for proposals/P/NGO/2504,6/12/2017 4:13:32 PM,Overall,0,100,35,0,135,0,108,38,54,200
71,Lebanon,2016,LEB-16/DDA-3604/Call for proposals/P/NGO/2504,6/12/2017 4:13:32 PM,Refugees,0,70,25,0,95,0,64,25,26,115
71,Lebanon,2016,LEB-16/DDA-3604/Call for Proposals/P/NGO/3279,9/8/2017 1:13:15 PM,Host Communities,174,120,11,8,313,299,389,0,0,688
71,Lebanon,2016,LEB-16/DDA-3604/Call for Proposals/P/NGO/3279,9/8/2017 1:13:15 PM,Overall,349,240,11,8,608,610,781,2,0,1393
71,Lebanon,2016,LEB-16/DDA-3604/Call for Proposals/P/NGO/3279,9/8/2017 1:13:15 PM,Refugees,175,120,0,0,295,311,392,2,0,705
71,Lebanon,2016,LEB-16/DDA-3604/Call for Proposals/P/NGO/3287,1/8/2018 1:04:07 PM,Overall,25,25,108,82,240,19,40,120,76,255
71,Lebanon,2016,LEB-16/DDA-3604/Call for Proposals/P/UN/3288,7/2/2018 7:17:04 PM,Other,14976,16224,13824,14976,60000,14976,16224,13824,14976,60000
71,Lebanon,2016,LEB-16/DDA-3604/Call for Proposals/P/UN/3288,7/2/2018 7:17:04 PM,Overall,15096,16399,13934,15071,60500,15410,16544,13917,15077,60948
71,Lebanon,2016,LEB-16/DDA-3604/Call for Proposals/P/UN/3288,7/2/2018 7:17:04 PM,Refugees,120,175,110,95,500,434,320,93,101,948
71,Lebanon,2016,LEB-16/DDA-3604/Call for Proposals/P-H/NGO/3222,11/17/2017 12:35:49 PM,Overall,0,100,50,60,210,0,407,24,36,467
71,Lebanon,2016,LEB-16/DDA-3604/Call for Proposals/P-H/NGO/3222,11/17/2017 12:35:49 PM,Refugees,0,100,50,60,210,0,407,24,36,467
71,Lebanon,2016,LEB-16/DDA-3604/Call for Proposals/SS/INGO/3250,10/4/2018 7:52:41 AM,Host Communities,1237,1237,530,530,3534,40,48,0,0,88
71,Lebanon,2016,LEB-16/DDA-3604/Call for Proposals/SS/INGO/3250,10/4/2018 7:52:41 AM,Overall,2474,2474,1060,1060,7068,3213,3082,1323,1247,8865
71,Lebanon,2016,LEB-16/DDA-3604/Call for Proposals/SS/INGO/3250,10/4/2018 7:52:41 AM,Refugees,1237,1237,530,530,3534,26,31,0,0,57
71,Lebanon,2016,LEB-16/DDA-3604/Call for Proposals/SS/NGO/3180,1/5/2018 11:54:31 AM,Host Communities,43,30,22,15,110,61,52,75,111,299
71,Lebanon,2016,LEB-16/DDA-3604/Call for Proposals/SS/NGO/3180,1/5/2018 11:54:31 AM,Other,6,3,4,2,15,2,1,0,0,3
71,Lebanon,2016,LEB-16/DDA-3604/Call for Proposals/SS/NGO/3180,1/5/2018 11:54:31 AM,Overall,87,58,48,32,225,68,53,80,120,321
71,Lebanon,2016,LEB-16/DDA-3604/Call for Proposals/SS/NGO/3180,1/5/2018 11:54:31 AM,Refugees,38,25,22,15,100,5,0,5,9,19
71,Lebanon,2016,LEB-16/DDA-3604/Call for Proposals/SS/NGO/3230,3/1/2018 2:10:17 PM,Host Communities,40,20,155,130,345,26,38,146,197,407
71,Lebanon,2016,LEB-16/DDA-3604/Call for Proposals/SS/NGO/3230,3/1/2018 2:10:17 PM,Overall,60,30,155,130,375,39,45,251,347,682
71,Lebanon,2016,LEB-16/DDA-3604/Call for Proposals/SS/NGO/3230,3/1/2018 2:10:17 PM,Refugees,20,10,0,0,30,13,7,105,150,275
71,Lebanon,2016,LEB-16/DDA-3604/Call for Proposals/SS/NGO/3256,1/5/2018 11:39:19 AM,Host Communities,106,48,0,0,154,106,48,0,0,154
71,Lebanon,2016,LEB-16/DDA-3604/Call for Proposals/SS/NGO/3256,1/5/2018 11:39:19 AM,Overall,106,48,0,0,154,106,48,0,0,154
71,Lebanon,2016,LEB-16/DDA-3604/Call for Proposals/S-W-SS/INGO/3333,4/3/2018 1:25:21 PM,Host Communities,1671,1700,925,941,5237,1486,1515,882,901,4784
71,Lebanon,2016,LEB-16/DDA-3604/Call for Proposals/S-W-SS/INGO/3333,4/3/2018 1:25:21 PM,Overall,1797,1832,1067,1090,5786,1728,1761,1026,1048,5563
71,Lebanon,2016,LEB-16/DDA-3604/Call for Proposals/S-W-SS/INGO/3333,4/3/2018 1:25:21 PM,Refugees,126,132,142,149,549,242,247,144,146,779
71,Lebanon,2016,LEB-16/DDA-3604/Call for Proposals/W/INGO/3252,7/26/2018 6:14:55 PM,Host Communities,3777,4215,1569,1739,11300,3777,4215,1569,1739,11300
71,Lebanon,2016,LEB-16/DDA-3604/Call for Proposals/W/INGO/3252,7/26/2018 6:14:55 PM,Overall,4056,4550,1873,2043,12522,4100,4610,1968,2133,12811
71,Lebanon,2016,LEB-16/DDA-3604/Call for Proposals/W/INGO/3252,7/26/2018 6:14:55 PM,Refugees,279,335,304,304,1222,291,352,332,330,1305
71,Lebanon,2016,LEB-16/DDA-3604/Call for Proposals/W/INGO/3258,2/21/2018 7:49:45 AM,Host Communities,2736,2761,4395,4608,14500,2614,2696,4310,4515,14135
71,Lebanon,2016,LEB-16/DDA-3604/Call for Proposals/W/INGO/3258,2/21/2018 7:49:45 AM,Overall,3460,3581,5246,5413,17700,3334,3492,5142,5314,17282
71,Lebanon,2016,LEB-16/DDA-3604/Call for Proposals/W/INGO/3258,2/21/2018 7:49:45 AM,Refugees,724,820,851,805,3200,720,796,832,799,3147
71,Lebanon,2016,LEB-16/DDA-3604/Call for Proposals/W/INGO/3325,12/12/2018 9:57:48 AM,Host Communities,18134,17075,26817,25613,87639,17187,16190,25360,24226,82963
71,Lebanon,2016,LEB-16/DDA-3604/Call for Proposals/W/INGO/3325,12/12/2018 9:57:48 AM,Overall,21334,20088,31550,30133,103105,21484,20238,31700,30283,103705
71,Lebanon,2016,LEB-16/DDA-3604/Call for Proposals/W/INGO/3325,12/12/2018 9:57:48 AM,Refugees,3200,3013,4733,4520,15466,4297,4048,6340,6057,20742
71,Lebanon,2016,LEB-16/DDA-3604/Call for Proposals/W/INGO/3339,3/30/2018 9:01:42 AM,Host Communities,4485,4485,5265,5265,19500,10553,10553,12387,12387,45880
71,Lebanon,2016,LEB-16/DDA-3604/Call for Proposals/W/INGO/3339,3/30/2018 9:01:42 AM,Overall,5980,5980,7020,7020,26000,14070,14070,16517,16517,61174
71,Lebanon,2016,LEB-16/DDA-3604/Call for Proposals/W/INGO/3339,3/30/2018 9:01:42 AM,Refugees,1495,1495,1755,1755,6500,3517,3517,4130,4130,15294
71,Lebanon,2016,LEB-16/DDA-3604/Call for Proposals/W/UN/3249,8/2/2018 3:15:55 PM,Host Communities,12493,11493,883,883,25752,12493,11493,883,883,25752
71,Lebanon,2016,LEB-16/DDA-3604/Call for Proposals/W/UN/3249,8/2/2018 3:15:55 PM,Overall,14809,13809,1145,1145,30908,14809,13809,1145,1145,30908
71,Lebanon,2016,LEB-16/DDA-3604/Call for Proposals/W/UN/3249,8/2/2018 3:15:55 PM,Refugees,2316,2316,262,262,5156,2316,2316,262,262,5156
71,Lebanon,2016,LEB-16/DDA-3604/Call for Proposals/W-H/INGO/3231,1/5/2018 12:14:39 PM,Host Communities,2700,6240,3005,3405,15350,2432,19102,3563,4961,30058
71,Lebanon,2016,LEB-16/DDA-3604/Call for Proposals/W-H/INGO/3231,1/5/2018 12:14:39 PM,Overall,6500,28400,6550,11550,53000,6129,52351,11808,16377,86665
71,Lebanon,2016,LEB-16/DDA-3604/Call for Proposals/W-H/INGO/3231,1/5/2018 12:14:39 PM,Refugees,3800,22160,3545,8145,37650,3697,33249,8245,11416,56607
71,Lebanon,2016,LEB-16/DDA-3604/Call for proposals/W-SS/NGO/2453,7/17/2017 9:58:50 AM,Overall,690,910,950,890,3440,690,910,950,890,3440
71,Lebanon,2016,LEB-16/DDA-3604/Res16/BA/INGO/4435,9/28/2017 3:04:53 PM,Host Communities,98,128,205,222,653,98,128,205,222,653
71,Lebanon,2016,LEB-16/DDA-3604/Res16/BA/INGO/4435,9/28/2017 3:04:53 PM,Overall,490,640,1026,1109,3265,490,640,1026,1109,3265
71,Lebanon,2016,LEB-16/DDA-3604/Res16/BA/INGO/4435,9/28/2017 3:04:53 PM,Refugees,392,512,821,887,2612,392,512,821,887,2612
71,Lebanon,2016,LEB-16/DDA-3604/Res16/BA/INGO/4486,7/14/2017 9:18:15 AM,Overall,421,62,0,0,483,422,62,0,0,484
71,Lebanon,2016,LEB-16/DDA-3604/Res16/BA/INGO/4486,7/14/2017 9:18:15 AM,Refugees,421,62,0,0,483,422,62,0,0,484
71,Lebanon,2016,LEB-16/DDA-3604/Res16/BA/INGO/4495,11/17/2017 12:44:30 PM,Host Communities,76,93,97,94,360,86,106,110,105,407
71,Lebanon,2016,LEB-16/DDA-3604/Res16/BA/INGO/4495,11/17/2017 12:44:30 PM,Overall,488,601,628,605,2322,432,582,491,524,2029
71,Lebanon,2016,LEB-16/DDA-3604/Res16/BA/INGO/4495,11/17/2017 12:44:30 PM,Refugees,412,508,531,511,1962,346,476,381,419,1622
71,Lebanon,2016,LEB-16/DDA-3604/Res16/BA/INGO/4496,7/14/2017 9:38:16 AM,Overall,584,690,717,664,2655,584,690,717,664,2655
71,Lebanon,2016,LEB-16/DDA-3604/Res16/BA/INGO/4496,7/14/2017 9:38:16 AM,Refugees,584,690,717,664,2655,584,690,717,664,2655
71,Lebanon,2016,LEB-16/DDA-3604/Res16/BA-LH/INGO/2518,9/8/2017 12:49:22 PM,Host Communities,305,305,1200,1200,3010,638,703,1143,1142,3626
71,Lebanon,2016,LEB-16/DDA-3604/Res16/BA-LH/INGO/2518,9/8/2017 12:49:22 PM,Overall,1015,1015,4000,4000,10030,2018,2017,3450,3444,10929
71,Lebanon,2016,LEB-16/DDA-3604/Res16/BA-LH/INGO/2518,9/8/2017 12:49:22 PM,Refugees,710,710,2800,2800,7020,1380,1314,2307,2302,7303
71,Lebanon,2016,LEB-16/DDA-3604/Res16/FS/INGO/2514,11/3/2017 1:32:21 PM,Host Communities,783,757,0,0,1540,559,364,88,145,1156
71,Lebanon,2016,LEB-16/DDA-3604/Res16/FS/INGO/2514,11/3/2017 1:32:21 PM,Overall,1118,1082,0,0,2200,1144,635,182,239,2200
71,Lebanon,2016,LEB-16/DDA-3604/Res16/FS/INGO/2514,11/3/2017 1:32:21 PM,Refugees,335,325,0,0,660,585,271,94,94,1044
71,Lebanon,2016,LEB-16/DDA-3604/Res16/P/INGO/2509,3/8/2017 9:37:36 AM,Host Communities,33,15,86,82,216,32,24,52,44,152
71,Lebanon,2016,LEB-16/DDA-3604/Res16/P/INGO/2509,3/8/2017 9:37:36 AM,Other,5,2,15,14,36,6,0,0,1,7
71,Lebanon,2016,LEB-16/DDA-3604/Res16/P/INGO/2509,3/8/2017 9:37:36 AM,Overall,108,50,288,274,720,101,63,326,279,769
71,Lebanon,2016,LEB-16/DDA-3604/Res16/P/INGO/2509,3/8/2017 9:37:36 AM,Refugees,70,33,187,178,468,63,40,274,233,610
71,Lebanon,2016,LEB-16/DDA-3604/Res16/P/INGO/2528,2/9/2018 10:11:10 AM,Host Communities,0,1100,0,250,1350,406,975,330,424,2135
71,Lebanon,2016,LEB-16/DDA-3604/Res16/P/INGO/2528,2/9/2018 10:11:10 AM,Other,0,570,0,50,620,0,0,0,0,0
71,Lebanon,2016,LEB-16/DDA-3604/Res16/P/INGO/2528,2/9/2018 10:11:10 AM,Overall,2300,7170,500,1100,11070,3356,7431,1472,1845,14104
71,Lebanon,2016,LEB-16/DDA-3604/Res16/P/INGO/2528,2/9/2018 10:11:10 AM,Refugees,2300,5500,500,800,9100,2950,6456,1142,1421,11969
71,Lebanon,2016,LEB-16/DDA-3604/Res16/P/INGO/2534,2/21/2017 1:09:56 PM,Host Communities,300,225,375,450,1350,250,195,425,485,1355
71,Lebanon,2016,LEB-16/DDA-3604/Res16/P/INGO/2534,2/21/2017 1:09:56 PM,Overall,1000,750,1250,1500,4500,931,806,1325,1213,4275
71,Lebanon,2016,LEB-16/DDA-3604/Res16/P/INGO/2534,2/21/2017 1:09:56 PM,Refugees,700,525,875,1050,3150,681,611,900,728,2920
71,Lebanon,2016,LEB-16/DDA-3604/Res16/P/NGO/2511,8/22/2017 7:21:09 PM,Overall,75,75,325,325,800,0,0,0,0,0
71,Lebanon,2016,LEB-16/DDA-3604/Res16/S/NGO/3200,7/17/2017 9:23:39 AM,Overall,389,471,565,590,2015,482,488,503,550,2023
71,Lebanon,2016,LEB-16/DDA-3604/Res16/S/NGO/3200,7/17/2017 9:23:39 AM,Refugees,389,471,565,590,2015,482,488,503,550,2023
71,Lebanon,2016,LEB-16/DDA-3604/Res16/W/INGO/2539,9/8/2017 12:44:32 PM,Overall,562,625,180,264,1631,358,388,414,448,1608
71,Lebanon,2016,LEB-16/DDA-3604/Res16/W/INGO/2539,9/8/2017 12:44:32 PM,Refugees,562,625,180,264,1631,358,388,414,448,1608
71,Lebanon,2016,LEB-16/DDA-3604/Res16/W/INGO/2545,4/24/2017 7:55:27 AM,Overall,1026,1265,1324,1265,4880,953,1145,1463,1506,5067
71,Lebanon,2016,LEB-16/DDA-3604/Res16/W/INGO/2545,4/24/2017 7:55:27 AM,Refugees,1026,1265,1324,1265,4880,953,1145,1463,1506,5067
71,Lebanon,2016,LEB-16/DDA-3604/Res16/W/INGO/3134,11/3/2017 1:48:29 PM,Overall,914,1387,1473,1436,5210,1811,2172,2302,2282,8567
71,Lebanon,2016,LEB-16/DDA-3604/Res16/W/INGO/3134,11/3/2017 1:48:29 PM,Refugees,914,1387,1473,1436,5210,1811,2172,2302,2282,8567
71,Lebanon,2016,LEB-16/DDA-3604/Res16/W/NGO/2513,9/8/2017 12:54:49 PM,Host Communities,0,0,0,0,0,37162,0,0,0,37162
71,Lebanon,2016,LEB-16/DDA-3604/Res16/W/NGO/2513,9/8/2017 12:54:49 PM,Overall,6915,11198,7169,11198,36480,0,0,0,0,0
71,Lebanon,2016,LEB-16/DDA-3604/Res16/W/NGO/2513,9/8/2017 12:54:49 PM,Refugees,0,0,0,0,0,3278,0,0,0,3278
71,Lebanon,2016,LEB-16/DDA-3604/Res16/W/NGO/2547,2/21/2017 11:41:48 AM,Host Communities,2118,2888,2519,2475,10000,2118,2888,2519,2475,10000
71,Lebanon,2016,LEB-16/DDA-3604/Res16/W/NGO/2547,2/21/2017 11:41:48 AM,Overall,3536,5307,6159,5625,20627,3361,5087,5770,5344,19562
71,Lebanon,2016,LEB-16/DDA-3604/Res16/W/NGO/2547,2/21/2017 11:41:48 AM,Refugees,1418,2419,3640,3150,10627,1243,2199,3251,2869,9562
71,Lebanon,2017,LEB-17/DDA-3604/2017 RA_LEB/BA/INGO/5439,1/5/2018 10:22:41 AM,Overall,210,40,0,0,250,179,71,0,0,250
71,Lebanon,2017,LEB-17/DDA-3604/2017 RA_LEB/BA/INGO/5439,1/5/2018 10:22:41 AM,Refugees,210,40,0,0,250,179,71,0,0,250
71,Lebanon,2017,LEB-17/DDA-3604/2017 RA_LEB/BA/INGO/5521,11/17/2017 1:00:17 PM,Host Communities,98,128,205,222,653,98,128,205,222,653
71,Lebanon,2017,LEB-17/DDA-3604/2017 RA_LEB/BA/INGO/5521,11/17/2017 1:00:17 PM,Overall,490,640,1026,1109,3265,490,640,1026,1109,3265
71,Lebanon,2017,LEB-17/DDA-3604/2017 RA_LEB/BA/INGO/5521,11/17/2017 1:00:17 PM,Refugees,392,512,821,887,2612,392,512,821,887,2612
71,Lebanon,2017,LEB-17/DDA-3604/2017 RA_LEB/H/INGO/5485,4/5/2018 4:18:18 PM,Overall,17,12,0,0,29,0,14,0,0,14
71,Lebanon,2017,LEB-17/DDA-3604/2017 RA_LEB/H/INGO/5485,4/5/2018 4:18:18 PM,Refugees,17,12,0,0,29,18,14,0,0,32
71,Lebanon,2017,LEB-17/DDA-3604/2017 RA_LEB/H/INGO/5594,3/30/2018 9:12:35 AM,Overall,18,11,3,0,32,17,10,3,0,30
71,Lebanon,2017,LEB-17/DDA-3604/2017 RA_LEB/H/INGO/5594,3/30/2018 9:12:35 AM,Refugees,18,11,3,0,32,17,10,3,0,30
71,Lebanon,2017,LEB-17/DDA-3604/2017 RA_LEB/H/NGO/5547,11/17/2017 1:17:42 PM,Host Communities,67,45,0,0,112,59,49,0,0,108
71,Lebanon,2017,LEB-17/DDA-3604/2017 RA_LEB/H/NGO/5547,11/17/2017 1:17:42 PM,Overall,73,49,0,0,122,68,54,0,0,122
71,Lebanon,2017,LEB-17/DDA-3604/2017 RA_LEB/H/NGO/5547,11/17/2017 1:17:42 PM,Refugees,6,4,0,0,10,9,5,0,0,14
71,Lebanon,2017,LEB-17/DDA-3604/2017 RA_LEB/P/NGO/5492,2/1/2019 10:03:28 AM,Host Communities,0,465,0,0,465,0,561,0,0,561
71,Lebanon,2017,LEB-17/DDA-3604/2017 RA_LEB/P/NGO/5492,2/1/2019 10:03:28 AM,Other,0,37,0,0,37,0,56,0,0,56
71,Lebanon,2017,LEB-17/DDA-3604/2017 RA_LEB/P/NGO/5492,2/1/2019 10:03:28 AM,Overall,0,540,0,0,540,0,671,1,1,673
71,Lebanon,2017,LEB-17/DDA-3604/2017 RA_LEB/P/NGO/5492,2/1/2019 10:03:28 AM,Refugees,0,38,0,0,38,0,54,1,1,56
71,Lebanon,2017,LEB-17/DDA-3604/2017 RA_LEB/P/NGO/5563,1/22/2019 1:52:24 PM,Host Communities,0,90,0,30,120,0,70,0,23,93
71,Lebanon,2017,LEB-17/DDA-3604/2017 RA_LEB/P/NGO/5563,1/22/2019 1:52:24 PM,Other,0,30,0,10,40,0,28,0,5,33
71,Lebanon,2017,LEB-17/DDA-3604/2017 RA_LEB/P/NGO/5563,1/22/2019 1:52:24 PM,Overall,0,300,0,100,400,0,268,0,94,362
71,Lebanon,2017,LEB-17/DDA-3604/2017 RA_LEB/P/NGO/5563,1/22/2019 1:52:24 PM,Refugees,0,180,0,60,240,0,171,0,65,236
71,Lebanon,2017,LEB-17/DDA-3604/2017 RA_LEB/P/UN/5444,8/28/2019 11:55:31 AM,Overall,14976,16224,13824,14976,60000,14976,16224,13824,14976,60000
71,Lebanon,2017,LEB-17/DDA-3604/2017 RA_LEB/P/UN/5444,8/28/2019 11:55:31 AM,Refugees,14976,16224,13824,14976,60000,14976,16224,13824,14976,60000
71,Lebanon,2017,LEB-17/DDA-3604/20171stSA/E/INGO/6341,1/22/2019 2:10:52 PM,Host Communities,180,180,90,91,541,24,24,24,24,96
71,Lebanon,2017,LEB-17/DDA-3604/20171stSA/E/INGO/6341,1/22/2019 2:10:52 PM,Overall,180,180,165,166,691,83,50,195,137,465
71,Lebanon,2017,LEB-17/DDA-3604/20171stSA/E/INGO/6341,1/22/2019 2:10:52 PM,Refugees,0,0,75,75,150,24,24,24,24,96
71,Lebanon,2017,LEB-17/DDA-3604/20171stSA/E/NGO/6332,1/30/2019 12:51:32 PM,Host Communities,0,0,60,100,160,0,0,92,101,193
71,Lebanon,2017,LEB-17/DDA-3604/20171stSA/E/NGO/6332,1/30/2019 12:51:32 PM,Overall,0,0,100,150,250,0,0,112,141,253
71,Lebanon,2017,LEB-17/DDA-3604/20171stSA/E/NGO/6332,1/30/2019 12:51:32 PM,Refugees,0,0,40,50,90,0,0,20,40,60
71,Lebanon,2017,LEB-17/DDA-3604/20171stSA/H/INGO/6317,7/10/2018 4:22:35 PM,Host Communities,61,88,7,16,172,0,0,0,0,0
71,Lebanon,2017,LEB-17/DDA-3604/20171stSA/H/INGO/6317,7/10/2018 4:22:35 PM,Overall,204,292,24,55,575,216,265,67,57,605
71,Lebanon,2017,LEB-17/DDA-3604/20171stSA/H/INGO/6317,7/10/2018 4:22:35 PM,Refugees,143,204,16,39,402,0,0,0,0,0
71,Lebanon,2017,LEB-17/DDA-3604/20171stSA/H/NGO/6301,1/30/2019 12:56:10 PM,Overall,0,0,220,80,300,0,0,285,38,323
71,Lebanon,2017,LEB-17/DDA-3604/20171stSA/H/NGO/6342,7/5/2018 3:15:24 PM,Host Communities,1250,1250,0,0,2500,4604,5978,0,0,10582
71,Lebanon,2017,LEB-17/DDA-3604/20171stSA/H/NGO/6342,7/5/2018 3:15:24 PM,Overall,2500,2500,0,0,5000,6068,8183,0,0,14251
71,Lebanon,2017,LEB-17/DDA-3604/20171stSA/H/NGO/6342,7/5/2018 3:15:24 PM,Refugees,1250,1250,0,0,2500,1464,2205,0,0,3669
71,Lebanon,2017,LEB-17/DDA-3604/20171stSA/P/INGO/6319,2/1/2019 10:28:26 AM,Host Communities,100,75,0,70,245,42,213,0,124,379
71,Lebanon,2017,LEB-17/DDA-3604/20171stSA/P/INGO/6319,2/1/2019 10:28:26 AM,Overall,250,595,0,370,1215,253,1109,0,553,1915
71,Lebanon,2017,LEB-17/DDA-3604/20171stSA/P/INGO/6319,2/1/2019 10:28:26 AM,Refugees,150,520,0,300,970,211,896,0,429,1536
71,Lebanon,2017,LEB-17/DDA-3604/20171stSA/P/NGO/6310,8/2/2018 3:03:37 PM,Overall,0,0,50,50,100,0,0,54,46,100
71,Lebanon,2017,LEB-17/DDA-3604/20171stSA/P/NGO/6310,8/2/2018 3:03:37 PM,Refugees,0,0,50,50,100,0,0,63,46,109
71,Lebanon,2017,LEB-17/DDA-3604/20171stSA/P/NGO/6346,1/7/2019 7:57:07 AM,Overall,750,840,85,125,1800,846,2387,65,104,3402
71,Lebanon,2017,LEB-17/DDA-3604/20171stSA/P/NGO/6346,1/7/2019 7:57:07 AM,Refugees,750,840,85,125,1800,981,2252,65,104,3402
71,Lebanon,2017,LEB-17/DDA-3604/20171stSA/P/NGO/6385,1/30/2019 11:57:45 AM,Host Communities,594,726,0,0,1320,621,1070,0,0,1691
71,Lebanon,2017,LEB-17/DDA-3604/20171stSA/P/NGO/6385,1/30/2019 11:57:45 AM,Overall,1188,1452,0,0,2640,1506,2393,0,0,3899
71,Lebanon,2017,LEB-17/DDA-3604/20171stSA/P/NGO/6385,1/30/2019 11:57:45 AM,Refugees,594,726,0,0,1320,879,1238,0,0,2117
71,Lebanon,2017,LEB-17/DDA-3604/20171stSA/P-S/INGO/6333,1/30/2019 12:05:10 PM,Host Communities,60,15,10,10,95,79,78,17,17,191
71,Lebanon,2017,LEB-17/DDA-3604/20171stSA/P-S/INGO/6333,1/30/2019 12:05:10 PM,Overall,1187,1137,590,561,3475,988,1603,680,509,3780
71,Lebanon,2017,LEB-17/DDA-3604/20171stSA/P-S/INGO/6333,1/30/2019 12:05:10 PM,Refugees,1127,1122,580,551,3380,909,1525,663,492,3589
71,Lebanon,2017,LEB-17/DDA-3604/20171stSA/P-S/INGO/6363,1/3/2019 1:35:31 PM,Overall,705,825,299,300,2129,454,741,258,304,1757
71,Lebanon,2017,LEB-17/DDA-3604/20171stSA/S/INGO/6354,2/21/2018 7:21:19 AM,Host Communities,10,0,0,0,10,12,0,0,0,12
71,Lebanon,2017,LEB-17/DDA-3604/20171stSA/S/INGO/6354,2/21/2018 7:21:19 AM,Overall,67,75,80,82,304,6,48,32,28,114
71,Lebanon,2017,LEB-17/DDA-3604/20171stSA/S/INGO/6354,2/21/2018 7:21:19 AM,Refugees,57,75,80,82,294,6,48,32,28,114
71,Lebanon,2017,LEB-17/DDA-3604/20171stSA/SS/NGO/6371,8/2/2018 3:11:25 PM,Host Communities,30,30,0,0,60,20,40,0,0,60
71,Lebanon,2017,LEB-17/DDA-3604/20171stSA/SS/NGO/6371,8/2/2018 3:11:25 PM,Overall,60,60,0,0,120,60,60,0,0,120
71,Lebanon,2017,LEB-17/DDA-3604/20171stSA/SS/NGO/6371,8/2/2018 3:11:25 PM,Refugees,30,30,0,0,60,23,37,0,0,60
71,Lebanon,2017,LEB-17/DDA-3604/20171stSA/S-W/INGO/6359,7/23/2018 1:26:50 PM,Overall,1814,2839,3109,3033,10795,2468,2989,3232,3209,11898
71,Lebanon,2017,LEB-17/DDA-3604/20171stSA/S-W/INGO/6359,7/23/2018 1:26:50 PM,Refugees,1814,2839,3109,3033,10795,2989,3246,3212,2480,11927
71,Lebanon,2017,LEB-17/DDA-3604/20171stSA/W/NGO/6348,2/16/2018 10:49:39 AM,Host Communities,525,525,175,175,1400,525,525,175,175,1400
71,Lebanon,2017,LEB-17/DDA-3604/20171stSA/W/NGO/6348,2/16/2018 10:49:39 AM,Overall,750,750,250,250,2000,750,750,250,250,2000
71,Lebanon,2017,LEB-17/DDA-3604/20171stSA/W/NGO/6348,2/16/2018 10:49:39 AM,Refugees,225,225,75,75,600,225,225,75,75,600
71,Lebanon,2017,LEB-17/DDA-3604/LBN-17-2ND-RES/P/INGO/7623,7/18/2018 4:32:39 PM,Host Communities,17,48,35,32,132,0,0,0,0,0
71,Lebanon,2017,LEB-17/DDA-3604/LBN-17-2ND-RES/P/INGO/7623,7/18/2018 4:32:39 PM,Overall,278,802,591,533,2204,40,958,662,663,2323
71,Lebanon,2017,LEB-17/DDA-3604/LBN-17-2ND-RES/P/INGO/7623,7/18/2018 4:32:39 PM,Refugees,261,754,556,501,2072,40,958,662,623,2283
71,Lebanon,2017,LEB-17/DDA-3604/LBN-17-2ND-RES/P/INGO/7648,7/17/2018 12:35:44 PM,Overall,0,30,0,15,45,2,13,4,9,28
71,Lebanon,2017,LEB-17/DDA-3604/LBN-17-2ND-RES/P/INGO/7648,7/17/2018 12:35:44 PM,Refugees,0,0,0,0,0,15,52,11,19,97
71,Lebanon,2017,LEB-17/DDA-3604/LBN-17-2ND-RES/P/NGO/7386,4/5/2018 2:08:59 PM,Host Communities,0,0,39,38,77,0,0,61,49,110
71,Lebanon,2017,LEB-17/DDA-3604/LBN-17-2ND-RES/P/NGO/7386,4/5/2018 2:08:59 PM,Overall,0,0,96,96,192,0,0,129,90,219
71,Lebanon,2017,LEB-17/DDA-3604/LBN-17-2ND-RES/P/NGO/7386,4/5/2018 2:08:59 PM,Refugees,0,0,57,58,115,0,0,68,41,109
71,Lebanon,2018,LEB-18/DDA-3604/2ndSA/H/INGO/10845,4/21/2021 11:24:31 AM,Overall,320,263,41,33,657,167,197,42,25,431
71,Lebanon,2018,LEB-18/DDA-3604/2ndSA/H/INGO/10845,4/21/2021 11:24:31 AM,Refugees,320,263,41,33,657,167,197,42,25,431
71,Lebanon,2018,LEB-18/DDA-3604/2ndSA/H/INGO/10897,9/21/2020 4:32:03 PM,Host Communities,409,409,0,0,818,243,292,0,0,535
71,Lebanon,2018,LEB-18/DDA-3604/2ndSA/H/INGO/10897,9/21/2020 4:32:03 PM,Overall,690,690,0,0,1380,630,685,0,0,1315
71,Lebanon,2018,LEB-18/DDA-3604/2ndSA/H/INGO/10897,9/21/2020 4:32:03 PM,Refugees,281,281,0,0,562,387,393,0,0,780
71,Lebanon,2018,LEB-18/DDA-3604/2ndSA/H/NGO/10918,3/30/2020 8:45:17 AM,Overall,56,84,0,0,140,75,73,0,0,148
71,Lebanon,2018,LEB-18/DDA-3604/2ndSA/H/NGO/10918,3/30/2020 8:45:17 AM,Refugees,56,84,0,0,140,75,73,0,0,148
71,Lebanon,2018,LEB-18/DDA-3604/2ndSA/H-P/NGO/10878,1/23/2020 8:14:00 PM,Host Communities,200,300,0,0,500,1068,2002,105,112,3287
71,Lebanon,2018,LEB-18/DDA-3604/2ndSA/H-P/NGO/10878,1/23/2020 8:14:00 PM,Overall,2000,2500,200,200,4900,2092,3702,209,243,6246
71,Lebanon,2018,LEB-18/DDA-3604/2ndSA/H-P/NGO/10878,1/23/2020 8:14:00 PM,Refugees,1800,2200,200,200,4400,1024,1700,104,131,2959
71,Lebanon,2018,LEB-18/DDA-3604/2ndSA/P/INGO/10920,10/31/2019 10:24:18 AM,Host Communities,0,500,0,0,500,18,1270,0,0,1288
71,Lebanon,2018,LEB-18/DDA-3604/2ndSA/P/INGO/10920,10/31/2019 10:24:18 AM,Overall,0,1500,0,0,1500,189,1848,0,0,2037
71,Lebanon,2018,LEB-18/DDA-3604/2ndSA/P/INGO/10920,10/31/2019 10:24:18 AM,Refugees,0,1000,0,0,1000,171,578,0,0,749
71,Lebanon,2018,LEB-18/DDA-3604/2ndSA/P/NGO/10921,3/30/2020 8:39:44 AM,Overall,42,130,0,0,172,59,180,0,0,239
71,Lebanon,2018,LEB-18/DDA-3604/2ndSA/P/NGO/10921,3/30/2020 8:39:44 AM,Refugees,42,130,0,0,172,59,180,0,0,239
71,Lebanon,2018,LEB-18/DDA-3604/2ndSA/P-H/NGO/10923,9/21/2020 4:23:50 PM,Host Communities,248,324,0,0,572,723,775,0,0,1498
71,Lebanon,2018,LEB-18/DDA-3604/2ndSA/P-H/NGO/10923,9/21/2020 4:23:50 PM,Other,0,0,0,0,0,28,9,0,0,37
71,Lebanon,2018,LEB-18/DDA-3604/2ndSA/P-H/NGO/10923,9/21/2020 4:23:50 PM,Overall,441,481,0,0,922,1286,1299,0,0,2585
71,Lebanon,2018,LEB-18/DDA-3604/2ndSA/P-H/NGO/10923,9/21/2020 4:23:50 PM,Refugees,193,157,0,0,350,535,515,0,0,1050
71,Lebanon,2018,LEB-18/DDA-3604/2ndSA/S/INGO/10851,6/17/2020 7:46:26 AM,Host Communities,10,11,0,0,21,15,19,0,0,34
71,Lebanon,2018,LEB-18/DDA-3604/2ndSA/S/INGO/10851,6/17/2020 7:46:26 AM,Overall,101,109,0,0,210,118,98,0,0,216
71,Lebanon,2018,LEB-18/DDA-3604/2ndSA/S/INGO/10851,6/17/2020 7:46:26 AM,Refugees,91,98,0,0,189,103,79,0,0,182
71,Lebanon,2018,LEB-18/DDA-3604/2ndSA/S/INGO/10919,2/12/2021 3:20:00 PM,Overall,136,44,0,0,180,119,62,2,2,185
71,Lebanon,2018,LEB-18/DDA-3604/2ndSA/S/INGO/10919,2/12/2021 3:20:00 PM,Refugees,136,44,0,0,180,119,62,2,2,185
71,Lebanon,2018,LEB-18/DDA-3604/2ndSA/S-P/NGO/10914,1/27/2020 8:57:40 PM,Host Communities,140,141,0,0,281,161,306,0,0,467
71,Lebanon,2018,LEB-18/DDA-3604/2ndSA/S-P/NGO/10914,1/27/2020 8:57:40 PM,Overall,275,275,0,0,550,208,368,0,0,576
71,Lebanon,2018,LEB-18/DDA-3604/2ndSA/S-P/NGO/10914,1/27/2020 8:57:40 PM,Refugees,135,134,0,0,269,47,62,0,0,109
71,Lebanon,2018,LEB-18/DDA-3604/RA1/P/UN/8650,7/31/2019 10:04:39 AM,Overall,5440,13351,253,200,19244,4877,18521,179,208,23785
71,Lebanon,2018,LEB-18/DDA-3604/RA1/P/UN/8650,7/31/2019 10:04:39 AM,Refugees,5440,13351,253,200,19244,4877,18521,179,208,23785
71,Lebanon,2018,LEB-18/DDA-3604/RA3/BA/UN/11388,1/27/2020 8:26:47 PM,Overall,8552,9947,6744,6580,31823,8624,9993,6532,6361,31510
71,Lebanon,2018,LEB-18/DDA-3604/RA3/S/INGO/11420,4/29/2020 12:32:10 PM,Overall,1041,1593,1776,1715,6125,950,1453,1621,1564,5588
71,Lebanon,2018,LEB-18/DDA-3604/RA3/S/INGO/11420,4/29/2020 12:32:10 PM,Refugees,1041,1593,1776,1715,6125,950,1453,1621,1564,5588
71,Lebanon,2018,LEB-18/DDA-3604/RA3/S/INGO/11423,1/22/2020 8:53:08 PM,Overall,4352,5659,6381,6155,22547,6042,7856,8859,8546,31303
71,Lebanon,2018,LEB-18/DDA-3604/RA3/S/INGO/11423,1/22/2020 8:53:08 PM,Refugees,4352,5659,6381,6155,22547,6042,7856,8859,8546,31303
71,Lebanon,2018,LEB-18/DDA-3604/SA2/COO/NGO/10706,5/4/2020 12:07:22 PM,Other,50,50,0,0,100,50,50,0,0,100
71,Lebanon,2018,LEB-18/DDA-3604/SA2/COO/NGO/10706,5/4/2020 12:07:22 PM,Overall,50,50,0,0,100,50,50,0,0,100
71,Lebanon,2018,LEB-18/DDA-3604/SA2/P/NGO/9594,1/28/2020 2:50:26 PM,Host Communities,0,10,0,10,20,0,23,0,3,26
71,Lebanon,2018,LEB-18/DDA-3604/SA2/P/NGO/9594,1/28/2020 2:50:26 PM,Overall,0,50,0,50,100,0,64,0,6,70
71,Lebanon,2018,LEB-18/DDA-3604/SA2/P/NGO/9594,1/28/2020 2:50:26 PM,Refugees,0,40,0,40,80,0,41,0,3,44
71,Lebanon,2018,LEB-18/DDA-3604/SA2/P/NGO/9669,7/30/2019 11:42:04 AM,Host Communities,0,8,3,3,14,0,10,2,4,16
71,Lebanon,2018,LEB-18/DDA-3604/SA2/P/NGO/9669,7/30/2019 11:42:04 AM,Overall,0,80,30,30,140,0,79,43,42,164
71,Lebanon,2018,LEB-18/DDA-3604/SA2/P/NGO/9669,7/30/2019 11:42:04 AM,Refugees,0,72,27,27,126,0,69,41,38,148
71,Lebanon,2018,LEB-18/DDA-3604/SA2/P-H/NGO/9592,1/27/2020 9:05:51 PM,Host Communities,25,500,25,100,650,71,581,20,109,781
71,Lebanon,2018,LEB-18/DDA-3604/SA2/P-H/NGO/9592,1/27/2020 9:05:51 PM,Overall,100,1000,50,200,1350,115,1338,89,230,1772
71,Lebanon,2018,LEB-18/DDA-3604/SA2/P-H/NGO/9592,1/27/2020 9:05:51 PM,Refugees,75,500,25,100,700,44,757,69,121,991
71,Lebanon,2018,LEB-18/DDA-3604/SA2018-1/BA/NGO/8942,3/11/2019 1:06:34 PM,Overall,304,538,239,253,1334,306,539,232,258,1335
71,Lebanon,2018,LEB-18/DDA-3604/SA2018-1/BA/NGO/8942,3/11/2019 1:06:34 PM,Refugees,304,538,239,235,1316,306,539,232,258,1335
71,Lebanon,2018,LEB-18/DDA-3604/SA2018-1/H/INGO/8918,3/31/2020 12:40:28 PM,Host Communities,140,140,160,160,600,191,248,121,117,677
71,Lebanon,2018,LEB-18/DDA-3604/SA2018-1/H/INGO/8918,3/31/2020 12:40:28 PM,Overall,280,280,320,320,1200,603,639,568,553,2363
71,Lebanon,2018,LEB-18/DDA-3604/SA2018-1/H/INGO/8918,3/31/2020 12:40:28 PM,Refugees,140,140,160,160,600,412,391,447,436,1686
71,Lebanon,2018,LEB-18/DDA-3604/SA2018-1/H/NGO/8920,9/18/2019 8:53:11 PM,Overall,0,0,1150,350,1500,0,0,1157,351,1508
71,Lebanon,2018,LEB-18/DDA-3604/SA2018-1/H/NGO/8940,9/18/2019 8:10:35 PM,Overall,68,54,0,0,122,76,59,0,0,135
71,Lebanon,2018,LEB-18/DDA-3604/SA2018-1/H/NGO/8940,9/18/2019 8:10:35 PM,Refugees,68,54,0,0,122,76,59,0,0,135
71,Lebanon,2018,LEB-18/DDA-3604/SA2018-1/P/INGO/8903,7/26/2019 9:44:34 AM,Host Communities,60,49,77,88,274,85,58,69,64,276
71,Lebanon,2018,LEB-18/DDA-3604/SA2018-1/P/INGO/8903,7/26/2019 9:44:34 AM,Other,9,7,13,15,44,16,14,14,9,53
71,Lebanon,2018,LEB-18/DDA-3604/SA2018-1/P/INGO/8903,7/26/2019 9:44:34 AM,Overall,196,161,254,289,900,183,122,378,340,1023
71,Lebanon,2018,LEB-18/DDA-3604/SA2018-1/P/INGO/8903,7/26/2019 9:44:34 AM,Refugees,127,105,164,186,582,82,50,295,267,694
71,Lebanon,2018,LEB-18/DDA-3604/SA2018-1/P/INGO/8930,10/28/2019 12:09:38 PM,Host Communities,30,50,0,0,80,41,97,0,0,138
71,Lebanon,2018,LEB-18/DDA-3604/SA2018-1/P/INGO/8930,10/28/2019 12:09:38 PM,Overall,80,120,0,0,200,83,182,0,0,265
71,Lebanon,2018,LEB-18/DDA-3604/SA2018-1/P/INGO/8930,10/28/2019 12:09:38 PM,Refugees,50,70,0,0,120,42,85,0,0,127
71,Lebanon,2018,LEB-18/DDA-3604/SA2018-1/P/INGO/8938,7/26/2019 9:32:01 AM,Host Communities,54,150,0,100,304,887,3915,0,2435,7237
71,Lebanon,2018,LEB-18/DDA-3604/SA2018-1/P/INGO/8938,7/26/2019 9:32:01 AM,Overall,270,730,0,500,1500,197,870,0,541,1608
71,Lebanon,2018,LEB-18/DDA-3604/SA2018-1/P/INGO/8938,7/26/2019 9:32:01 AM,Refugees,216,580,0,400,1196,98,435,0,804,1337
71,Lebanon,2018,LEB-18/DDA-3604/SA2018-1/P/INGO/8948,10/31/2019 10:16:31 AM,Host Communities,18,18,22,22,80,84,365,4125,3412,7986
71,Lebanon,2018,LEB-18/DDA-3604/SA2018-1/P/INGO/8948,10/31/2019 10:16:31 AM,Other,6,6,7,7,26,4,1,4,5,14
71,Lebanon,2018,LEB-18/DDA-3604/SA2018-1/P/INGO/8948,10/31/2019 10:16:31 AM,Overall,1058,1084,1309,1309,4760,94,406,4639,3794,8933
71,Lebanon,2018,LEB-18/DDA-3604/SA2018-1/P/INGO/8948,10/31/2019 10:16:31 AM,Refugees,1034,1060,1280,1280,4654,6,40,510,377,933
71,Lebanon,2018,LEB-18/DDA-3604/SA2018-1/P/NGO/8841,10/28/2019 1:03:20 PM,Host Communities,105,645,105,645,1500,37,919,204,683,1843
71,Lebanon,2018,LEB-18/DDA-3604/SA2018-1/P/NGO/8841,10/28/2019 1:03:20 PM,Overall,350,2150,350,2150,5000,324,2553,563,2487,5927
71,Lebanon,2018,LEB-18/DDA-3604/SA2018-1/P/NGO/8841,10/28/2019 1:03:20 PM,Refugees,245,1505,245,1505,3500,287,1634,359,1804,4084
71,Lebanon,2018,LEB-18/DDA-3604/SA2018-1/P/NGO/8906,7/31/2019 5:59:25 AM,Overall,0,0,70,70,140,0,0,90,62,152
71,Lebanon,2018,LEB-18/DDA-3604/SA2018-1/P/NGO/8906,7/31/2019 5:59:25 AM,Refugees,0,0,70,70,140,0,0,92,62,154
71,Lebanon,2018,LEB-18/DDA-3604/SA2018-1/P/NGO/8934,10/2/2019 7:19:47 PM,Host Communities,5,213,5,8,231,0,199,0,17,216
71,Lebanon,2018,LEB-18/DDA-3604/SA2018-1/P/NGO/8934,10/2/2019 7:19:47 PM,Other,0,150,0,0,150,0,52,0,0,52
71,Lebanon,2018,LEB-18/DDA-3604/SA2018-1/P/NGO/8934,10/2/2019 7:19:47 PM,Overall,5,453,17,25,500,0,433,0,45,478
71,Lebanon,2018,LEB-18/DDA-3604/SA2018-1/P/NGO/8934,10/2/2019 7:19:47 PM,Refugees,0,90,12,17,119,0,182,0,28,210
71,Lebanon,2018,LEB-18/DDA-3604/SA2018-1/P/NGO/8949,9/18/2019 8:08:47 PM,Host Communities,16,15,25,26,82,2,0,58,23,83
71,Lebanon,2018,LEB-18/DDA-3604/SA2018-1/P/NGO/8949,9/18/2019 8:08:47 PM,Overall,129,131,193,197,650,193,178,531,302,1204
71,Lebanon,2018,LEB-18/DDA-3604/SA2018-1/P/NGO/8949,9/18/2019 8:08:47 PM,Refugees,111,107,168,171,557,191,178,473,279,1121
71,Lebanon,2018,LEB-18/DDA-3604/SA2018-1/P/NGO/8954,1/22/2020 8:50:43 PM,Host Communities,200,661,7,7,875,198,660,4,3,865
71,Lebanon,2018,LEB-18/DDA-3604/SA2018-1/P/NGO/8954,1/22/2020 8:50:43 PM,Overall,411,1321,9,9,1750,404,1233,6,4,1647
71,Lebanon,2018,LEB-18/DDA-3604/SA2018-1/P/NGO/8954,1/22/2020 8:50:43 PM,Refugees,211,660,2,2,875,206,573,2,1,782
71,Lebanon,2018,LEB-18/DDA-3604/SA2018-1/P-H/INGO/8928,1/27/2020 8:23:34 PM,Host Communities,675,825,0,0,1500,876,1495,0,0,2371
71,Lebanon,2018,LEB-18/DDA-3604/SA2018-1/P-H/INGO/8928,1/27/2020 8:23:34 PM,Overall,1350,1650,0,0,3000,1800,3084,0,0,4884
71,Lebanon,2018,LEB-18/DDA-3604/SA2018-1/P-H/INGO/8928,1/27/2020 8:23:34 PM,Refugees,675,825,0,0,1500,924,1589,0,0,2513
71,Lebanon,2018,LEB-18/DDA-3604/SA2018-1/S-H/INGO/8889,9/25/2019 12:05:24 PM,Host Communities,20,27,30,28,105,25,30,25,24,104
71,Lebanon,2018,LEB-18/DDA-3604/SA2018-1/S-H/INGO/8889,9/25/2019 12:05:24 PM,Overall,200,266,297,284,1047,130,176,195,185,686
71,Lebanon,2018,LEB-18/DDA-3604/SA2018-1/S-H/INGO/8889,9/25/2019 12:05:24 PM,Refugees,180,239,267,255,941,105,146,170,161,582
71,Lebanon,2019,LEB-19/DDA-3604/RA/BA/UN/14844,11/26/2020 5:10:06 PM,Other,8929,10267,6965,6713,32874,8936,10274,6994,6741,32945
71,Lebanon,2019,LEB-19/DDA-3604/RA/BA/UN/14844,11/26/2020 5:10:06 PM,Overall,8929,10267,6965,6713,32874,8936,10274,6994,6741,32945
71,Lebanon,2019,LEB-19/DDA-3604/RA/H/UN/13155,4/7/2020 3:15:08 PM,Host Communities,0,0,159250,159250,318500,0,0,80042,75790,155832
71,Lebanon,2019,LEB-19/DDA-3604/RA/H/UN/13155,4/7/2020 3:15:08 PM,Other,0,0,9100,9100,18200,0,0,8339,6559,14898
71,Lebanon,2019,LEB-19/DDA-3604/RA/H/UN/13155,4/7/2020 3:15:08 PM,Overall,0,0,227500,227500,455000,0,0,132214,120999,253213
71,Lebanon,2019,LEB-19/DDA-3604/RA/H/UN/13155,4/7/2020 3:15:08 PM,Refugees,0,0,59150,59150,118300,0,0,43833,38650,82483
71,Lebanon,2019,LEB-19/DDA-3604/SA1/CP/NGO/13227,10/27/2020 1:57:40 PM,Host Communities,10,0,76,77,163,2,14,89,130,235
71,Lebanon,2019,LEB-19/DDA-3604/SA1/CP/NGO/13227,10/27/2020 1:57:40 PM,Other,0,0,18,18,36,1,0,28,29,58
71,Lebanon,2019,LEB-19/DDA-3604/SA1/CP/NGO/13227,10/27/2020 1:57:40 PM,Overall,10,0,150,150,310,3,14,168,217,402
71,Lebanon,2019,LEB-19/DDA-3604/SA1/CP/NGO/13227,10/27/2020 1:57:40 PM,Refugees,0,0,56,55,111,0,0,51,58,109
71,Lebanon,2019,LEB-19/DDA-3604/SA1/CP-GBV/INGO/13207,8/7/2020 12:13:56 PM,Other,0,0,147,180,327,3,6,169,250,428
71,Lebanon,2019,LEB-19/DDA-3604/SA1/CP-GBV/INGO/13207,8/7/2020 12:13:56 PM,Overall,0,0,167,203,370,4,6,243,362,615
71,Lebanon,2019,LEB-19/DDA-3604/SA1/CP-GBV/INGO/13207,8/7/2020 12:13:56 PM,Refugees,0,0,20,23,43,1,0,74,112,187
71,Lebanon,2019,LEB-19/DDA-3604/SA1/E/INGO/13129,4/22/2021 8:58:33 AM,Other,0,0,12,13,25,0,0,3,2,5
71,Lebanon,2019,LEB-19/DDA-3604/SA1/E/INGO/13129,4/22/2021 8:58:33 AM,Overall,0,0,249,251,500,0,0,288,254,542
71,Lebanon,2019,LEB-19/DDA-3604/SA1/E/INGO/13129,4/22/2021 8:58:33 AM,Refugees,0,0,237,238,475,0,0,285,252,537
71,Lebanon,2019,LEB-19/DDA-3604/SA1/E/INGO/13165,2/11/2021 7:03:52 AM,Host Communities,135,135,20,20,310,0,0,30,31,61
71,Lebanon,2019,LEB-19/DDA-3604/SA1/E/INGO/13165,2/11/2021 7:03:52 AM,Other,40,40,80,80,240,0,0,8,16,24
71,Lebanon,2019,LEB-19/DDA-3604/SA1/E/INGO/13165,2/11/2021 7:03:52 AM,Overall,250,350,600,600,1800,0,0,716,678,1394
71,Lebanon,2019,LEB-19/DDA-3604/SA1/E/INGO/13165,2/11/2021 7:03:52 AM,Refugees,75,175,500,500,1250,0,0,678,631,1309
71,Lebanon,2019,LEB-19/DDA-3604/SA1/GBV/INGO/13152,2/3/2021 8:21:33 AM,Host Communities,91,95,143,210,539,17,64,87,49,217
71,Lebanon,2019,LEB-19/DDA-3604/SA1/GBV/INGO/13152,2/3/2021 8:21:33 AM,Overall,306,316,476,700,1798,87,202,192,135,616
71,Lebanon,2019,LEB-19/DDA-3604/SA1/GBV/INGO/13152,2/3/2021 8:21:33 AM,Refugees,215,221,333,490,1259,70,138,105,86,399
71,Lebanon,2019,LEB-19/DDA-3604/SA1/H/INGO/13169,10/30/2020 1:12:06 PM,Other,5489,7900,0,0,13389,23985,33563,0,0,57548
71,Lebanon,2019,LEB-19/DDA-3604/SA1/H/INGO/13169,10/30/2020 1:12:06 PM,Overall,5489,7900,0,0,13389,23985,33563,0,0,57548
71,Lebanon,2019,LEB-19/DDA-3604/SA1/H/INGO/13184,12/23/2020 9:54:33 AM,Host Communities,2404,2649,2135,2136,9324,1240,1461,24,18,2743
71,Lebanon,2019,LEB-19/DDA-3604/SA1/H/INGO/13184,12/23/2020 9:54:33 AM,Overall,6502,6763,7173,7182,27620,3247,3828,3039,3033,13147
71,Lebanon,2019,LEB-19/DDA-3604/SA1/H/INGO/13184,12/23/2020 9:54:33 AM,Refugees,4098,4114,5038,5046,18296,2007,2367,3015,3015,10404
71,Lebanon,2019,LEB-19/DDA-3604/SA1/H/INGO/13211,4/20/2021 10:45:55 AM,Other,52,37,51,34,174,64,23,36,30,153
71,Lebanon,2019,LEB-19/DDA-3604/SA1/H/INGO/13211,4/20/2021 10:45:55 AM,Overall,52,37,51,34,174,64,23,36,30,153
71,Lebanon,2019,LEB-19/DDA-3604/SA1/H/INGO/13214,4/26/2021 10:41:39 AM,Overall,112,113,187,188,600,110,56,328,199,693
71,Lebanon,2019,LEB-19/DDA-3604/SA1/H/INGO/13214,4/26/2021 10:41:39 AM,Refugees,112,113,187,188,600,110,56,328,199,693
71,Lebanon,2019,LEB-19/DDA-3604/SA1/H/NGO/13180,1/18/2021 4:51:01 PM,Host Communities,40,72,75,48,235,120,157,115,77,469
71,Lebanon,2019,LEB-19/DDA-3604/SA1/H/NGO/13180,1/18/2021 4:51:01 PM,Overall,232,286,288,205,1011,581,652,530,363,2126
71,Lebanon,2019,LEB-19/DDA-3604/SA1/H/NGO/13180,1/18/2021 4:51:01 PM,Refugees,192,214,213,157,776,461,495,415,286,1657
71,Lebanon,2019,LEB-19/DDA-3604/SA1/H/UN/13131,5/14/2021 7:50:25 AM,Other,829,1207,263,232,2531,1075,1717,186,238,3216
71,Lebanon,2019,LEB-19/DDA-3604/SA1/H/UN/13131,5/14/2021 7:50:25 AM,Overall,829,1207,263,232,2531,1075,1717,186,238,3216
71,Lebanon,2019,LEB-19/DDA-3604/SA1/P/INGO/13118,3/10/2021 10:09:25 AM,Other,45,55,0,0,100,38,92,0,0,130
71,Lebanon,2019,LEB-19/DDA-3604/SA1/P/INGO/13118,3/10/2021 10:09:25 AM,Overall,2885,3585,1840,1790,10100,6154,6916,421,547,14038
71,Lebanon,2019,LEB-19/DDA-3604/SA1/P/INGO/13118,3/10/2021 10:09:25 AM,Refugees,2840,3530,1840,1790,10000,6116,6824,421,547,13908
71,Lebanon,2019,LEB-19/DDA-3604/SA1/P/NGO/13186,11/19/2020 5:51:33 PM,Overall,27,27,38,41,133,10,25,24,16,75
71,Lebanon,2019,LEB-19/DDA-3604/SA1/P/NGO/13186,11/19/2020 5:51:33 PM,Refugees,27,27,38,41,133,10,25,24,16,75
71,Lebanon,2019,LEB-19/DDA-3604/SA1/P/NGO/13187,9/8/2020 9:17:06 AM,Host Communities,4,16,10,10,40,7,18,15,10,50
71,Lebanon,2019,LEB-19/DDA-3604/SA1/P/NGO/13187,9/8/2020 9:17:06 AM,Other,2,8,5,5,20,4,6,6,4,20
71,Lebanon,2019,LEB-19/DDA-3604/SA1/P/NGO/13187,9/8/2020 9:17:06 AM,Overall,20,80,50,50,200,19,81,64,42,206
71,Lebanon,2019,LEB-19/DDA-3604/SA1/P/NGO/13187,9/8/2020 9:17:06 AM,Refugees,14,56,35,35,140,8,57,43,28,136
71,Lebanon,2019,LEB-19/DDA-3604/SA1/P/UN/13132,9/8/2021 2:39:11 PM,Other,1123,1172,1390,1360,5045,1025,1266,198,195,2684
71,Lebanon,2019,LEB-19/DDA-3604/SA1/P/UN/13132,9/8/2021 2:39:11 PM,Overall,1123,1172,1390,1360,5045,1025,1266,198,195,2684
71,Lebanon,2019,LEB-19/DDA-3604/SA1/P-S/NGO/13183,1/28/2021 2:08:30 PM,Overall,3651,4681,0,0,8332,3650,4679,0,0,8329
71,Lebanon,2019,LEB-19/DDA-3604/SA1/P-S/NGO/13183,1/28/2021 2:08:30 PM,Refugees,3651,4681,0,0,8332,3650,4679,0,0,8329
71,Lebanon,2019,LEB-19/DDA-3604/SA1/P-S/NGO/13191,11/16/2020 4:18:01 PM,Host Communities,95,95,0,0,190,33,64,0,0,97
71,Lebanon,2019,LEB-19/DDA-3604/SA1/P-S/NGO/13191,11/16/2020 4:18:01 PM,Other,16,16,0,0,32,7,13,0,0,20
71,Lebanon,2019,LEB-19/DDA-3604/SA1/P-S/NGO/13191,11/16/2020 4:18:01 PM,Overall,158,158,0,0,316,67,125,0,0,192
71,Lebanon,2019,LEB-19/DDA-3604/SA1/P-S/NGO/13191,11/16/2020 4:18:01 PM,Refugees,47,47,0,0,94,27,48,0,0,75
71,Lebanon,2019,LEB-19/DDA-3604/SA1/S/INGO/13194,4/20/2021 11:32:44 AM,Host Communities,10,10,16,16,52,32,14,4,10,60
71,Lebanon,2019,LEB-19/DDA-3604/SA1/S/INGO/13194,4/20/2021 11:32:44 AM,Overall,130,130,195,195,650,168,186,262,246,862
71,Lebanon,2019,LEB-19/DDA-3604/SA1/S/INGO/13194,4/20/2021 11:32:44 AM,Refugees,120,120,179,179,598,136,172,258,236,802
71,Lebanon,2019,LEB-19/DDA-3604/SA1/S/NGO/13219,3/10/2021 10:03:56 AM,Host Communities,79,83,0,0,162,108,112,0,0,220
71,Lebanon,2019,LEB-19/DDA-3604/SA1/S/NGO/13219,3/10/2021 10:03:56 AM,Overall,159,166,0,0,325,188,195,0,0,383
71,Lebanon,2019,LEB-19/DDA-3604/SA1/S/NGO/13219,3/10/2021 10:03:56 AM,Refugees,80,83,0,0,163,80,83,0,0,163
71,Lebanon,2020,LEB-20/DDA-3604/RA1/S/INGO/15057,9/8/2021 2:33:58 PM,Overall,5044,6401,7221,6939,25605,6708,8514,9428,9060,33710
71,Lebanon,2020,LEB-20/DDA-3604/RA1/S/INGO/15057,9/8/2021 2:33:58 PM,Refugees,5044,6401,7221,6939,25605,6708,8514,9428,9060,33710
71,Lebanon,2020,LEB-20/DDA-3604/RA2/COO/NGO/15762,10/25/2021 2:16:21 PM,Other,50,50,0,0,100,40,40,0,0,80
71,Lebanon,2020,LEB-20/DDA-3604/RA2/COO/NGO/15762,10/25/2021 2:16:21 PM,Overall,50,50,0,0,100,40,40,0,0,80
71,Lebanon,2020,LEB-20/DDA-3604/RA2/COVID-19-GBV/NGO/15759,4/22/2021 10:13:31 AM,Host Communities,0,85,0,0,85,0,130,0,0,130
71,Lebanon,2020,LEB-20/DDA-3604/RA2/COVID-19-GBV/NGO/15759,4/22/2021 10:13:31 AM,Overall,0,170,0,0,170,0,302,0,0,302
71,Lebanon,2020,LEB-20/DDA-3604/RA2/COVID-19-GBV/NGO/15759,4/22/2021 10:13:31 AM,Refugees,0,85,0,0,85,0,172,0,0,172
71,Lebanon,2020,LEB-20/DDA-3604/RA2/GBV-COVID-19/NGO/15760,3/31/2021 1:29:20 PM,Other,0,316,0,0,316,0,422,0,0,422
71,Lebanon,2020,LEB-20/DDA-3604/RA2/GBV-COVID-19/NGO/15760,3/31/2021 1:29:20 PM,Overall,0,324,2,2,328,0,428,6,6,440
71,Lebanon,2020,LEB-20/DDA-3604/RA2/GBV-COVID-19/NGO/15760,3/31/2021 1:29:20 PM,Refugees,0,8,2,2,12,0,6,6,6,18
71,Lebanon,2020,LEB-20/DDA-3604/RA2/GBV-COVID-19/NGO/15761,9/8/2021 2:36:52 PM,Host Communities,0,117,0,3,120,0,99,0,0,99
71,Lebanon,2020,LEB-20/DDA-3604/RA2/GBV-COVID-19/NGO/15761,9/8/2021 2:36:52 PM,Other,0,20,0,0,20,0,51,0,0,51
71,Lebanon,2020,LEB-20/DDA-3604/RA2/GBV-COVID-19/NGO/15761,9/8/2021 2:36:52 PM,Overall,0,147,0,3,150,0,178,0,1,179
71,Lebanon,2020,LEB-20/DDA-3604/RA2/GBV-COVID-19/NGO/15761,9/8/2021 2:36:52 PM,Refugees,0,10,0,0,10,0,28,0,1,29
71,Lebanon,2020,LEB-20/DDA-3604/RA3/H/INGO/17128,8/1/2022 7:10:26 PM,Host Communities,4796,4795,2853,2852,15296,7852,13165,1308,1713,24038
71,Lebanon,2020,LEB-20/DDA-3604/RA3/H/INGO/17128,8/1/2022 7:10:26 PM,Overall,8881,8879,5283,5282,28325,11081,19791,3410,3996,38278
71,Lebanon,2020,LEB-20/DDA-3604/RA3/H/INGO/17128,8/1/2022 7:10:26 PM,Refugees,4085,4084,2430,2430,13029,3229,6626,2102,2283,14240
71,Lebanon,2020,LEB-20/DDA-3604/RA3/H/INGO/17129,3/23/2022 7:44:15 AM,Host Communities,822,1522,9,4,2357,418,837,38,35,1328
71,Lebanon,2020,LEB-20/DDA-3604/RA3/H/INGO/17129,3/23/2022 7:44:15 AM,Other,1733,2166,2601,2166,8666,200,508,62,57,827
71,Lebanon,2020,LEB-20/DDA-3604/RA3/H/INGO/17129,3/23/2022 7:44:15 AM,Overall,2909,4334,2612,2173,12028,654,1446,146,139,2385
71,Lebanon,2020,LEB-20/DDA-3604/RA3/H/INGO/17129,3/23/2022 7:44:15 AM,Refugees,354,646,2,3,1005,36,101,46,47,230
71,Lebanon,2020,LEB-20/DDA-3604/RA3/H/NGO/17131,5/14/2021 7:44:32 AM,Host Communities,3750,3750,0,0,7500,17713,20731,0,0,38444
71,Lebanon,2020,LEB-20/DDA-3604/RA3/H/NGO/17131,5/14/2021 7:44:32 AM,Overall,7500,7500,0,0,15000,21413,25593,0,0,47006
71,Lebanon,2020,LEB-20/DDA-3604/RA3/H/NGO/17131,5/14/2021 7:44:32 AM,Refugees,3750,3750,0,0,7500,3700,4862,0,0,8562
71,Lebanon,2020,LEB-20/DDA-3604/SA1/COO/NGO/16656,11/15/2021 7:57:35 AM,Host Communities,1792,2688,448,672,5600,0,0,0,0,0
71,Lebanon,2020,LEB-20/DDA-3604/SA1/COO/NGO/16656,11/15/2021 7:57:35 AM,Overall,3584,5376,896,1344,11200,0,0,0,0,0
71,Lebanon,2020,LEB-20/DDA-3604/SA1/COO/NGO/16656,11/15/2021 7:57:35 AM,Refugees,1792,2688,448,672,5600,0,0,0,0,0
71,Lebanon,2020,LEB-20/DDA-3604/SA1/COO/UN/16604,10/4/2021 5:33:11 PM,Other,1000,1000,0,0,2000,531,530,0,0,1061
71,Lebanon,2020,LEB-20/DDA-3604/SA1/COO/UN/16604,10/4/2021 5:33:11 PM,Overall,1000,1000,0,0,2000,531,530,0,0,1061
71,Lebanon,2020,LEB-20/DDA-3604/SA1/FS/INGO/16475,10/4/2021 5:35:43 PM,Host Communities,4124,5252,5898,5648,20922,6930,8967,10182,9646,35725
71,Lebanon,2020,LEB-20/DDA-3604/SA1/FS/INGO/16475,10/4/2021 5:35:43 PM,Other,241,307,346,332,1226,169,218,248,235,870
71,Lebanon,2020,LEB-20/DDA-3604/SA1/FS/INGO/16475,10/4/2021 5:35:43 PM,Overall,7890,10053,11293,10814,40050,11155,14432,16388,15525,57500
71,Lebanon,2020,LEB-20/DDA-3604/SA1/FS/INGO/16475,10/4/2021 5:35:43 PM,Refugees,3525,4494,5049,4834,17902,4056,5247,5958,5644,20905
71,Lebanon,2020,LEB-20/DDA-3604/SA1/FS/NGO/16558,4/20/2021 10:58:34 AM,Host Communities,360,600,120,120,1200,684,784,144,198,1810
71,Lebanon,2020,LEB-20/DDA-3604/SA1/FS/NGO/16558,4/20/2021 10:58:34 AM,Overall,600,1000,200,200,2000,795,924,168,238,2125
71,Lebanon,2020,LEB-20/DDA-3604/SA1/FS/NGO/16558,4/20/2021 10:58:34 AM,Refugees,240,400,80,80,800,111,140,24,40,315
71,Lebanon,2020,LEB-20/DDA-3604/SA1/FS/NGO/16658,9/8/2021 2:35:12 PM,Other,3584,3583,2389,2389,11945,5225,4927,3428,3228,16808
71,Lebanon,2020,LEB-20/DDA-3604/SA1/FS/NGO/16658,9/8/2021 2:35:12 PM,Overall,3584,3583,2389,2389,11945,5225,4927,3428,3228,16808
71,Lebanon,2020,LEB-20/DDA-3604/SA1/FS-COO/INGO/16581,11/11/2021 7:17:31 PM,Host Communities,851,851,850,850,3402,1933,2401,1,1,4336
71,Lebanon,2020,LEB-20/DDA-3604/SA1/FS-COO/INGO/16581,11/11/2021 7:17:31 PM,Overall,2127,2127,2125,2126,8505,3547,3821,2,13,7383
71,Lebanon,2020,LEB-20/DDA-3604/SA1/FS-COO/INGO/16581,11/11/2021 7:17:31 PM,Refugees,1276,1276,1275,1276,5103,1614,1420,1,12,3047
71,Lebanon,2020,LEB-20/DDA-3604/SA1/H/INGO/16522,12/2/2021 9:55:57 AM,Host Communities,0,0,125,125,250,111,72,153,99,435
71,Lebanon,2020,LEB-20/DDA-3604/SA1/H/INGO/16522,12/2/2021 9:55:57 AM,Other,38,38,37,37,150,59,35,0,2,96
71,Lebanon,2020,LEB-20/DDA-3604/SA1/H/INGO/16522,12/2/2021 9:55:57 AM,Overall,38,38,412,412,900,170,107,867,560,1704
71,Lebanon,2020,LEB-20/DDA-3604/SA1/H/INGO/16522,12/2/2021 9:55:57 AM,Refugees,0,0,250,250,500,0,0,714,459,1173
71,Lebanon,2020,LEB-20/DDA-3604/SA1/H/INGO/16659,12/7/2021 3:06:44 PM,Other,42,25,33,95,195,79,42,28,87,236
71,Lebanon,2020,LEB-20/DDA-3604/SA1/H/INGO/16659,12/7/2021 3:06:44 PM,Overall,42,25,33,95,195,79,42,28,87,236
71,Lebanon,2020,LEB-20/DDA-3604/SA1/H-P/INGO/16649,8/25/2022 8:29:49 AM,Host Communities,2472,4071,2151,2287,10981,3422,5681,2043,1938,13084
71,Lebanon,2020,LEB-20/DDA-3604/SA1/H-P/INGO/16649,8/25/2022 8:29:49 AM,Other,576,1019,354,371,2320,74,132,27,21,254
71,Lebanon,2020,LEB-20/DDA-3604/SA1/H-P/INGO/16649,8/25/2022 8:29:49 AM,Overall,5691,9519,5169,5442,25821,5523,9382,5260,5002,25167
71,Lebanon,2020,LEB-20/DDA-3604/SA1/H-P/INGO/16649,8/25/2022 8:29:49 AM,Refugees,2643,4429,2664,2784,12520,2027,3569,3190,3043,11829
71,Lebanon,2020,LEB-20/DDA-3604/SA1/P/NGO/16607,6/29/2022 7:38:15 AM,Other,70,680,0,0,750,154,1568,27,34,1783
71,Lebanon,2020,LEB-20/DDA-3604/SA1/P/NGO/16607,6/29/2022 7:38:15 AM,Overall,70,680,0,0,750,154,1568,27,34,1783
71,Lebanon,2020,LEB-20/DDA-3604/SA1/P/NGO/16665,11/8/2021 3:49:25 PM,Host Communities,85,110,0,0,195,94,142,0,0,236
71,Lebanon,2020,LEB-20/DDA-3604/SA1/P/NGO/16665,11/8/2021 3:49:25 PM,Other,25,15,0,0,40,17,27,0,0,44
71,Lebanon,2020,LEB-20/DDA-3604/SA1/P/NGO/16665,11/8/2021 3:49:25 PM,Overall,215,215,0,0,430,197,236,0,0,433
71,Lebanon,2020,LEB-20/DDA-3604/SA1/P/NGO/16665,11/8/2021 3:49:25 PM,Refugees,105,90,0,0,195,86,67,0,0,153
71,Lebanon,2020,LEB-20/DDA-3604/SA1/P-H/NGO/16647,2/4/2022 9:54:09 AM,Host Communities,2845,2830,0,0,5675,2801,4098,0,0,6899
71,Lebanon,2020,LEB-20/DDA-3604/SA1/P-H/NGO/16647,2/4/2022 9:54:09 AM,Other,136,617,0,0,753,152,590,0,0,742
71,Lebanon,2020,LEB-20/DDA-3604/SA1/P-H/NGO/16647,2/4/2022 9:54:09 AM,Overall,3568,4024,0,0,7592,3819,5237,0,0,9056
71,Lebanon,2020,LEB-20/DDA-3604/SA1/P-H/NGO/16647,2/4/2022 9:54:09 AM,Refugees,587,577,0,0,1164,866,549,0,0,1415
71,Lebanon,2020,LEB-20/DDA-3604/SA1/W/INGO/16663,9/8/2021 2:32:30 PM,Overall,20,40,20,20,100,26,59,11,4,100
71,Lebanon,2020,LEB-20/DDA-3604/SA1/W/INGO/16663,9/8/2021 2:32:30 PM,Refugees,20,40,20,20,100,26,59,11,4,100
71,Lebanon,2020,LEB-20/DDA-3604/SA1/W/NGO/16608,10/28/2021 12:10:45 PM,Internally Displaced People,169,215,241,231,856,177,246,238,232,893
71,Lebanon,2020,LEB-20/DDA-3604/SA1/W/NGO/16608,10/28/2021 12:10:45 PM,Overall,169,215,241,231,856,177,246,238,232,893
71,Lebanon,2020,LEB-20/DDA-3604/SA1/W/NGO/16619,6/28/2021 7:29:39 AM,Overall,161,210,491,513,1375,438,560,562,508,2068
71,Lebanon,2020,LEB-20/DDA-3604/SA1/W/NGO/16619,6/28/2021 7:29:39 AM,Refugees,161,210,491,513,1375,438,560,562,508,2068
71,Lebanon,2021,LEB-21/DDA-3604/RA1/COO/INGO/19950,8/5/2022 4:05:29 PM,Other,45,45,0,0,90,25,32,0,0,57
71,Lebanon,2021,LEB-21/DDA-3604/RA1/COO/INGO/19950,8/5/2022 4:05:29 PM,Overall,45,45,0,0,90,25,32,0,0,57
71,Lebanon,2021,LEB-21/DDA-3604/RA1/COO/NGO/19952,3/17/2023 10:05:31 AM,Other,50,50,0,0,100,42,43,0,0,85
71,Lebanon,2021,LEB-21/DDA-3604/RA1/COO/NGO/19952,3/17/2023 10:05:31 AM,Overall,50,50,0,0,100,42,43,0,0,85
71,Lebanon,2021,LEB-21/DDA-3604/RA1/COO/UN/19953,5/20/2022 6:03:21 AM,Other,1717,5150,0,0,6867,312,936,0,0,1248
71,Lebanon,2021,LEB-21/DDA-3604/RA1/COO/UN/19953,5/20/2022 6:03:21 AM,Overall,1717,5150,0,0,6867,312,936,0,0,1248
71,Lebanon,2021,LEB-21/DDA-3604/RA2/L/UN/20160,7/5/2022 11:50:49 AM,Other,8,0,0,0,8,8,0,0,0,8
71,Lebanon,2021,LEB-21/DDA-3604/RA2/L/UN/20160,7/5/2022 11:50:49 AM,Overall,8,0,0,0,8,8,0,0,0,8
71,Lebanon,2021,LEB-21/DDA-3604/SA1/FS/INGO/18750,11/27/2022 1:28:19 AM,Host Communities,609,614,614,615,2452,778,917,738,660,3093
71,Lebanon,2021,LEB-21/DDA-3604/SA1/FS/INGO/18750,11/27/2022 1:28:19 AM,Other,0,0,0,0,0,10,10,11,13,44
71,Lebanon,2021,LEB-21/DDA-3604/SA1/FS/INGO/18750,11/27/2022 1:28:19 AM,Overall,921,901,926,902,3650,1067,1256,1162,1062,4547
71,Lebanon,2021,LEB-21/DDA-3604/SA1/FS/INGO/18750,11/27/2022 1:28:19 AM,Refugees,312,287,312,287,1198,279,329,413,389,1410
71,Lebanon,2021,LEB-21/DDA-3604/SA1/FS/INGO/18758,11/15/2022 11:49:36 PM,Host Communities,990,1142,646,598,3376,1324,1551,984,932,4791
71,Lebanon,2021,LEB-21/DDA-3604/SA1/FS/INGO/18758,11/15/2022 11:49:36 PM,Overall,1048,1209,684,634,3575,1339,1567,994,942,4842
71,Lebanon,2021,LEB-21/DDA-3604/SA1/FS/INGO/18758,11/15/2022 11:49:36 PM,Refugees,58,67,38,36,199,15,16,10,10,51
71,Lebanon,2021,LEB-21/DDA-3604/SA1/FS/INGO/18767,9/9/2022 12:47:12 PM,Host Communities,896,1000,395,377,2668,896,1000,395,377,2668
71,Lebanon,2021,LEB-21/DDA-3604/SA1/FS/INGO/18767,9/9/2022 12:47:12 PM,Overall,1085,1199,608,601,3493,1085,1199,608,601,3493
71,Lebanon,2021,LEB-21/DDA-3604/SA1/FS/INGO/18767,9/9/2022 12:47:12 PM,Refugees,189,199,213,224,825,189,199,213,224,825
71,Lebanon,2021,LEB-21/DDA-3604/SA1/FS/INGO/18872,9/19/2022 6:13:47 PM,Host Communities,340,425,459,477,1701,411,409,194,180,1194
71,Lebanon,2021,LEB-21/DDA-3604/SA1/FS/INGO/18872,9/19/2022 6:13:47 PM,Other,632,790,853,884,3159,1362,1540,696,684,4282
71,Lebanon,2021,LEB-21/DDA-3604/SA1/FS/INGO/18872,9/19/2022 6:13:47 PM,Overall,972,1215,1312,1361,4860,1773,1949,890,864,5476
71,Lebanon,2021,LEB-21/DDA-3604/SA1/FS/INGO/18898,7/7/2022 11:38:32 AM,Host Communities,700,1260,770,770,3500,1123,1465,934,951,4473
71,Lebanon,2021,LEB-21/DDA-3604/SA1/FS/INGO/18898,7/7/2022 11:38:32 AM,Other,60,60,15,15,150,23,25,7,6,61
71,Lebanon,2021,LEB-21/DDA-3604/SA1/FS/INGO/18898,7/7/2022 11:38:32 AM,Overall,760,1320,785,785,3650,1146,1490,941,957,4534
71,Lebanon,2021,LEB-21/DDA-3604/SA1/FS/NGO/18777,7/7/2022 12:02:57 PM,Host Communities,127,170,125,125,547,131,174,42,50,397
71,Lebanon,2021,LEB-21/DDA-3604/SA1/FS/NGO/18777,7/7/2022 12:02:57 PM,Other,76,76,74,74,300,73,106,40,53,272
71,Lebanon,2021,LEB-21/DDA-3604/SA1/FS/NGO/18777,7/7/2022 12:02:57 PM,Overall,339,378,324,324,1365,342,414,182,204,1142
71,Lebanon,2021,LEB-21/DDA-3604/SA1/FS/NGO/18777,7/7/2022 12:02:57 PM,Refugees,136,132,125,125,518,138,134,100,101,473
71,Lebanon,2021,LEB-21/DDA-3604/SA1/FS/NGO/18919,7/4/2022 8:30:34 PM,Host Communities,1300,1530,90,185,3105,1300,1535,85,180,3100
71,Lebanon,2021,LEB-21/DDA-3604/SA1/FS/NGO/18919,7/4/2022 8:30:34 PM,Overall,1460,1805,165,255,3685,1485,1825,150,225,3685
71,Lebanon,2021,LEB-21/DDA-3604/SA1/FS/NGO/18919,7/4/2022 8:30:34 PM,Refugees,160,275,75,70,580,185,290,65,45,585
71,Lebanon,2021,LEB-21/DDA-3604/SA1/FS/NGO/18937,8/5/2022 4:02:07 PM,Host Communities,1330,1480,1845,1935,6590,1765,1931,997,973,5666
71,Lebanon,2021,LEB-21/DDA-3604/SA1/FS/NGO/18937,8/5/2022 4:02:07 PM,Overall,1330,1480,1845,1935,6590,1765,1931,997,973,5666
71,Lebanon,2021,LEB-21/DDA-3604/SA1/FS/NGO/19082,7/14/2022 10:42:21 AM,Host Communities,95,116,196,167,574,154,154,123,118,549
71,Lebanon,2021,LEB-21/DDA-3604/SA1/FS/NGO/19082,7/14/2022 10:42:21 AM,Other,438,519,838,709,2504,757,752,595,565,2669
71,Lebanon,2021,LEB-21/DDA-3604/SA1/FS/NGO/19082,7/14/2022 10:42:21 AM,Overall,533,635,1034,876,3078,911,906,718,683,3218
71,Lebanon,2021,LEB-21/DDA-3604/SA1/FS-NUT/INGO/18749,3/27/2023 11:47:57 AM,Host Communities,763,1828,701,677,3969,1335,1770,1296,1462,5863
71,Lebanon,2021,LEB-21/DDA-3604/SA1/FS-NUT/INGO/18749,3/27/2023 11:47:57 AM,Other,0,65,18,17,100,0,28,8,11,47
71,Lebanon,2021,LEB-21/DDA-3604/SA1/FS-NUT/INGO/18749,3/27/2023 11:47:57 AM,Overall,983,2393,1060,1034,5470,1521,2611,1551,1717,7400
71,Lebanon,2021,LEB-21/DDA-3604/SA1/FS-NUT/INGO/18749,3/27/2023 11:47:57 AM,Refugees,220,500,341,340,1401,186,813,247,244,1490
71,Lebanon,2021,LEB-21/DDA-3604/SA1/FS-NUT/INGO/18915,2/3/2023 12:03:41 PM,Other,586,1397,500,500,2983,282,1398,553,450,2683
71,Lebanon,2021,LEB-21/DDA-3604/SA1/FS-NUT/INGO/18915,2/3/2023 12:03:41 PM,Overall,586,1397,500,500,2983,282,1398,553,450,2683
71,Lebanon,2021,LEB-21/DDA-3604/SA1/H/INGO/18797,4/4/2023 1:13:01 PM,Host Communities,1910,3503,788,801,7002,3525,5206,715,765,10211
71,Lebanon,2021,LEB-21/DDA-3604/SA1/H/INGO/18797,4/4/2023 1:13:01 PM,Other,251,615,81,79,1026,71,185,27,31,314
71,Lebanon,2021,LEB-21/DDA-3604/SA1/H/INGO/18797,4/4/2023 1:13:01 PM,Overall,2715,4956,1015,1028,9714,4015,6605,1694,1813,14127
71,Lebanon,2021,LEB-21/DDA-3604/SA1/H/INGO/18797,4/4/2023 1:13:01 PM,Refugees,554,838,146,148,1686,419,1214,952,1017,3602
71,Lebanon,2021,LEB-21/DDA-3604/SA1/H/INGO/18818,12/14/2022 1:53:00 AM,Host Communities,1243,3388,923,950,6504,4000,10567,1343,1380,17290
71,Lebanon,2021,LEB-21/DDA-3604/SA1/H/INGO/18818,12/14/2022 1:53:00 AM,Other,198,317,117,114,746,52,1173,9,6,1240
71,Lebanon,2021,LEB-21/DDA-3604/SA1/H/INGO/18818,12/14/2022 1:53:00 AM,Overall,2262,6479,1509,1550,11800,4474,13335,1751,1778,21338
71,Lebanon,2021,LEB-21/DDA-3604/SA1/H/INGO/18818,12/14/2022 1:53:00 AM,Refugees,821,2774,469,486,4550,422,1595,399,392,2808
71,Lebanon,2021,LEB-21/DDA-3604/SA1/H/INGO/18918,11/29/2022 1:34:45 AM,Host Communities,225,225,225,225,900,458,433,312,231,1434
71,Lebanon,2021,LEB-21/DDA-3604/SA1/H/INGO/18918,11/29/2022 1:34:45 AM,Other,25,25,25,25,100,29,47,2,7,85
71,Lebanon,2021,LEB-21/DDA-3604/SA1/H/INGO/18918,11/29/2022 1:34:45 AM,Overall,250,250,250,250,1000,487,480,314,238,1519
71,Lebanon,2021,LEB-21/DDA-3604/SA1/H/INGO/19066,5/23/2022 12:55:55 PM,Host Communities,1601,1751,620,661,4633,2709,3321,408,379,6817
71,Lebanon,2021,LEB-21/DDA-3604/SA1/H/INGO/19066,5/23/2022 12:55:55 PM,Other,148,180,32,40,400,494,554,31,33,1112
71,Lebanon,2021,LEB-21/DDA-3604/SA1/H/INGO/19066,5/23/2022 12:55:55 PM,Overall,2854,3110,1103,1182,8249,4831,5629,723,687,11870
71,Lebanon,2021,LEB-21/DDA-3604/SA1/H/INGO/19066,5/23/2022 12:55:55 PM,Refugees,1105,1179,451,481,3216,1628,1754,284,275,3941
71,Lebanon,2021,LEB-21/DDA-3604/SA1/H/NGO/18822,3/27/2023 1:41:42 PM,Host Communities,216,305,277,192,990,302,499,344,211,1356
71,Lebanon,2021,LEB-21/DDA-3604/SA1/H/NGO/18822,3/27/2023 1:41:42 PM,Other,1,22,0,0,23,6,51,2,1,60
71,Lebanon,2021,LEB-21/DDA-3604/SA1/H/NGO/18822,3/27/2023 1:41:42 PM,Overall,317,526,446,311,1600,574,929,652,396,2551
71,Lebanon,2021,LEB-21/DDA-3604/SA1/H/NGO/18822,3/27/2023 1:41:42 PM,Refugees,100,199,169,119,587,266,379,306,184,1135
71,Lebanon,2021,LEB-21/DDA-3604/SA1/H-NUT/INGO/18946,11/25/2022 2:49:46 AM,Host Communities,1982,2974,501,744,6201,3626,6240,2971,5042,17879
71,Lebanon,2021,LEB-21/DDA-3604/SA1/H-NUT/INGO/18946,11/25/2022 2:49:46 AM,Other,81,118,23,29,251,34,96,8,16,154
71,Lebanon,2021,LEB-21/DDA-3604/SA1/H-NUT/INGO/18946,11/25/2022 2:49:46 AM,Overall,3964,5946,1002,1490,12402,4382,7200,3962,6189,21733
71,Lebanon,2021,LEB-21/DDA-3604/SA1/H-NUT/INGO/18946,11/25/2022 2:49:46 AM,Refugees,1901,2854,478,717,5950,722,864,983,1131,3700
71,Lebanon,2021,LEB-21/DDA-3604/SA1/NUT/INGO/18815,1/10/2023 6:05:05 AM,Host Communities,12600,40300,6650,6650,66200,8197,39117,6818,7928,62060
71,Lebanon,2021,LEB-21/DDA-3604/SA1/NUT/INGO/18815,1/10/2023 6:05:05 AM,Other,400,1000,50,50,1500,62,393,24,34,513
71,Lebanon,2021,LEB-21/DDA-3604/SA1/NUT/INGO/18815,1/10/2023 6:05:05 AM,Overall,18000,61000,9500,9500,98000,15009,66934,12341,14219,108503
71,Lebanon,2021,LEB-21/DDA-3604/SA1/NUT/INGO/18815,1/10/2023 6:05:05 AM,Refugees,5000,19700,2800,2800,30300,6750,27424,5499,6257,45930
71,Lebanon,2021,LEB-21/DDA-3604/SA2/CP/INGO/20606,12/20/2022 4:44:41 PM,Host Communities,138,237,138,237,750,0,0,1,1,2
71,Lebanon,2021,LEB-21/DDA-3604/SA2/CP/INGO/20606,12/20/2022 4:44:41 PM,Overall,276,474,276,474,1500,37,157,125,319,638
71,Lebanon,2021,LEB-21/DDA-3604/SA2/CP/INGO/20606,12/20/2022 4:44:41 PM,Refugees,138,237,138,237,750,37,157,124,318,636
71,Lebanon,2021,LEB-21/DDA-3604/SA2/CP/INGO/20756,3/27/2023 1:20:06 PM,Host Communities,240,240,852,852,2184,211,246,1006,1050,2513
71,Lebanon,2021,LEB-21/DDA-3604/SA2/CP/INGO/20756,3/27/2023 1:20:06 PM,Overall,300,300,1065,1065,2730,236,408,1500,1542,3686
71,Lebanon,2021,LEB-21/DDA-3604/SA2/CP/INGO/20756,3/27/2023 1:20:06 PM,Refugees,60,60,213,213,546,25,162,494,492,1173
71,Lebanon,2021,LEB-21/DDA-3604/SA2/CP/INGO/20807,5/2/2023 11:02:06 AM,Host Communities,12,272,402,402,1088,16,388,431,525,1360
71,Lebanon,2021,LEB-21/DDA-3604/SA2/CP/INGO/20807,5/2/2023 11:02:06 AM,Other,0,31,54,54,139,0,35,36,42,113
71,Lebanon,2021,LEB-21/DDA-3604/SA2/CP/INGO/20807,5/2/2023 11:02:06 AM,Overall,14,366,570,570,1520,18,532,631,721,1902
71,Lebanon,2021,LEB-21/DDA-3604/SA2/CP/INGO/20807,5/2/2023 11:02:06 AM,Refugees,2,63,114,114,293,2,109,164,154,429
71,Lebanon,2021,LEB-21/DDA-3604/SA2/CP/NGO/20704,3/27/2023 1:23:38 PM,Host Communities,3,10,100,100,213,4,16,75,85,180
71,Lebanon,2021,LEB-21/DDA-3604/SA2/CP/NGO/20704,3/27/2023 1:23:38 PM,Other,0,0,5,5,10,0,0,9,5,14
71,Lebanon,2021,LEB-21/DDA-3604/SA2/CP/NGO/20704,3/27/2023 1:23:38 PM,Overall,5,15,150,150,320,4,16,226,219,465
71,Lebanon,2021,LEB-21/DDA-3604/SA2/CP/NGO/20704,3/27/2023 1:23:38 PM,Refugees,2,5,45,45,97,0,0,142,129,271
71,Lebanon,2021,LEB-21/DDA-3604/SA2/CP/NGO/20814,3/14/2023 3:03:52 PM,Host Communities,40,200,300,300,840,10,285,217,642,1154
71,Lebanon,2021,LEB-21/DDA-3604/SA2/CP/NGO/20814,3/14/2023 3:03:52 PM,Overall,40,200,300,300,840,10,285,217,642,1154
71,Lebanon,2021,LEB-21/DDA-3604/SA2/E/INGO/20584,8/10/2023 10:02:38 AM,Host Communities,50,90,80,80,300,44,58,33,63,198
71,Lebanon,2021,LEB-21/DDA-3604/SA2/E/INGO/20584,8/10/2023 10:02:38 AM,Other,5,10,5,5,25,1,0,2,2,5
71,Lebanon,2021,LEB-21/DDA-3604/SA2/E/INGO/20584,8/10/2023 10:02:38 AM,Overall,135,220,165,165,685,138,198,128,202,666
71,Lebanon,2021,LEB-21/DDA-3604/SA2/E/INGO/20584,8/10/2023 10:02:38 AM,Refugees,80,120,80,80,360,93,140,93,137,463
71,Lebanon,2021,LEB-21/DDA-3604/SA2/E/INGO/20732,4/7/2023 10:26:04 AM,Host Communities,50,450,250,250,1000,88,338,266,179,871
71,Lebanon,2021,LEB-21/DDA-3604/SA2/E/INGO/20732,4/7/2023 10:26:04 AM,Other,2,28,15,15,60,2,2,2,1,7
71,Lebanon,2021,LEB-21/DDA-3604/SA2/E/INGO/20732,4/7/2023 10:26:04 AM,Overall,69,621,345,345,1380,151,584,430,291,1456
71,Lebanon,2021,LEB-21/DDA-3604/SA2/E/INGO/20732,4/7/2023 10:26:04 AM,Refugees,17,143,80,80,320,61,244,162,111,578
71,Lebanon,2021,LEB-21/DDA-3604/SA2/E/INGO/20812,10/12/2023 1:11:25 PM,Host Communities,0,0,327,327,654,0,0,396,365,761
71,Lebanon,2021,LEB-21/DDA-3604/SA2/E/INGO/20812,10/12/2023 1:11:25 PM,Other,0,0,176,170,346,0,0,156,149,305
71,Lebanon,2021,LEB-21/DDA-3604/SA2/E/INGO/20812,10/12/2023 1:11:25 PM,Overall,0,0,539,533,1072,0,0,562,529,1091
71,Lebanon,2021,LEB-21/DDA-3604/SA2/E/INGO/20812,10/12/2023 1:11:25 PM,Refugees,0,0,36,36,72,0,0,10,15,25
71,Lebanon,2021,LEB-21/DDA-3604/SA2/E/NGO/20726,11/21/2022 10:37:48 PM,Host Communities,0,0,600,600,1200,0,0,623,677,1300
71,Lebanon,2021,LEB-21/DDA-3604/SA2/E/NGO/20726,11/21/2022 10:37:48 PM,Overall,0,0,600,600,1200,0,0,623,677,1300
71,Lebanon,2021,LEB-21/DDA-3604/SA2/GBV/INGO/20568,4/5/2023 5:47:16 AM,Host Communities,38,420,7,180,645,86,1267,17,183,1553
71,Lebanon,2021,LEB-21/DDA-3604/SA2/GBV/INGO/20568,4/5/2023 5:47:16 AM,Other,6,70,1,30,107,0,175,0,2,177
71,Lebanon,2021,LEB-21/DDA-3604/SA2/GBV/INGO/20568,4/5/2023 5:47:16 AM,Overall,126,1400,24,600,2150,185,2398,63,602,3248
71,Lebanon,2021,LEB-21/DDA-3604/SA2/GBV/INGO/20568,4/5/2023 5:47:16 AM,Refugees,82,910,16,390,1398,99,956,46,417,1518
71,Lebanon,2021,LEB-21/DDA-3604/SA2/GBV/NGO/20609,3/28/2023 6:23:26 AM,Host Communities,0,274,0,25,299,0,408,0,9,417
71,Lebanon,2021,LEB-21/DDA-3604/SA2/GBV/NGO/20609,3/28/2023 6:23:26 AM,Other,0,53,0,1,54,0,84,0,3,87
71,Lebanon,2021,LEB-21/DDA-3604/SA2/GBV/NGO/20609,3/28/2023 6:23:26 AM,Overall,0,413,0,37,450,0,608,0,56,664
71,Lebanon,2021,LEB-21/DDA-3604/SA2/GBV/NGO/20609,3/28/2023 6:23:26 AM,Refugees,0,86,0,11,97,0,116,0,44,160
71,Lebanon,2021,LEB-21/DDA-3604/SA2/GBV/NGO/20728,3/27/2023 10:39:13 AM,Host Communities,57,1083,0,0,1140,39,760,0,0,799
71,Lebanon,2021,LEB-21/DDA-3604/SA2/GBV/NGO/20728,3/27/2023 10:39:13 AM,Other,26,515,0,0,541,64,441,0,0,505
71,Lebanon,2021,LEB-21/DDA-3604/SA2/GBV/NGO/20728,3/27/2023 10:39:13 AM,Overall,109,2101,0,0,2210,109,2895,0,0,3004
71,Lebanon,2021,LEB-21/DDA-3604/SA2/GBV/NGO/20728,3/27/2023 10:39:13 AM,Refugees,26,503,0,0,529,6,1694,0,0,1700
71,Lebanon,2021,LEB-21/DDA-3604/SA2/GBV/NGO/20828,3/14/2023 3:12:16 PM,Host Communities,5558,2408,0,0,7966,6720,657,0,0,7377
71,Lebanon,2021,LEB-21/DDA-3604/SA2/GBV/NGO/20828,3/14/2023 3:12:16 PM,Other,250,272,0,0,522,1122,81,0,0,1203
71,Lebanon,2021,LEB-21/DDA-3604/SA2/GBV/NGO/20828,3/14/2023 3:12:16 PM,Overall,8312,3638,0,0,11950,9419,777,0,0,10196
71,Lebanon,2021,LEB-21/DDA-3604/SA2/GBV/NGO/20828,3/14/2023 3:12:16 PM,Refugees,2504,958,0,0,3462,1577,39,0,0,1616
71,Lebanon,2021,LEB-21/DDA-3604/SA2/GBV-COO/INGO/20757,4/7/2023 10:22:25 AM,Host Communities,64,194,30,50,338,45,685,53,122,905
71,Lebanon,2021,LEB-21/DDA-3604/SA2/GBV-COO/INGO/20757,4/7/2023 10:22:25 AM,Other,25,77,5,10,117,40,366,17,53,476
71,Lebanon,2021,LEB-21/DDA-3604/SA2/GBV-COO/INGO/20757,4/7/2023 10:22:25 AM,Overall,154,521,75,125,875,106,1883,111,328,2428
71,Lebanon,2021,LEB-21/DDA-3604/SA2/GBV-COO/INGO/20757,4/7/2023 10:22:25 AM,Refugees,65,250,40,65,420,21,832,41,153,1047
71,Lebanon,2022,LEB-22/DDA-3604/RA1/E/NGO/23293,10/18/2023 12:33:58 PM,Host Communities,0,0,315,315,630,0,0,222,389,611
71,Lebanon,2022,LEB-22/DDA-3604/RA1/E/NGO/23293,10/18/2023 12:33:58 PM,Other,0,0,16,16,32,0,0,0,0,0
71,Lebanon,2022,LEB-22/DDA-3604/RA1/E/NGO/23293,10/18/2023 12:33:58 PM,Overall,0,0,630,630,1260,0,0,663,1115,1778
71,Lebanon,2022,LEB-22/DDA-3604/RA1/E/NGO/23293,10/18/2023 12:33:58 PM,Refugees,0,0,299,299,598,0,0,441,726,1167
71,Lebanon,2022,LEB-22/DDA-3604/RA1/E/NGO/23360,4/27/2023 7:39:45 AM,Host Communities,0,0,85,85,170,0,0,87,60,147
71,Lebanon,2022,LEB-22/DDA-3604/RA1/E/NGO/23360,4/27/2023 7:39:45 AM,Other,0,0,1560,1500,3060,0,0,1423,1594,3017
71,Lebanon,2022,LEB-22/DDA-3604/RA1/E/NGO/23360,4/27/2023 7:39:45 AM,Overall,0,0,1730,1670,3400,0,0,1689,1920,3609
71,Lebanon,2022,LEB-22/DDA-3604/RA1/E/NGO/23360,4/27/2023 7:39:45 AM,Refugees,0,0,85,85,170,0,0,179,266,445
71,Lebanon,2022,LEB-22/DDA-3604/RA1/E-W/INGO/23364,10/19/2023 11:44:53 AM,Host Communities,382,437,131,142,1092,365,142,673,682,1862
71,Lebanon,2022,LEB-22/DDA-3604/RA1/E-W/INGO/23364,10/19/2023 11:44:53 AM,Overall,546,624,187,203,1560,450,180,1027,1034,2691
71,Lebanon,2022,LEB-22/DDA-3604/RA1/E-W/INGO/23364,10/19/2023 11:44:53 AM,Refugees,164,187,56,61,468,85,38,354,352,829
71,Lebanon,2022,LEB-22/DDA-3604/RA1/W/INGO/23391,10/11/2023 8:12:07 AM,Host Communities,11543,12188,11491,12138,47360,11490,12124,11820,12473,47907
71,Lebanon,2022,LEB-22/DDA-3604/RA1/W/INGO/23391,10/11/2023 8:12:07 AM,Overall,13532,14361,13700,14558,56151,13286,14070,14138,14823,56317
71,Lebanon,2022,LEB-22/DDA-3604/RA1/W/INGO/23391,10/11/2023 8:12:07 AM,Refugees,1989,2173,2209,2420,8791,1796,1946,2318,2350,8410
71,Lebanon,2022,LEB-22/DDA-3604/SA1/COO/INGO/22045,10/17/2023 8:28:43 AM,Other,20,20,20,20,80,38,38,38,39,153
71,Lebanon,2022,LEB-22/DDA-3604/SA1/COO/INGO/22045,10/17/2023 8:28:43 AM,Overall,20,20,20,20,80,38,38,38,39,153
71,Lebanon,2022,LEB-22/DDA-3604/SA1/COO-W/INGO/21906,10/12/2023 7:04:24 AM,Host Communities,24234,25861,10981,11459,72535,8425,8727,5765,5798,28715
71,Lebanon,2022,LEB-22/DDA-3604/SA1/COO-W/INGO/21906,10/12/2023 7:04:24 AM,Overall,46340,48302,30251,30142,155035,31023,31669,25503,24878,113073
71,Lebanon,2022,LEB-22/DDA-3604/SA1/COO-W/INGO/21906,10/12/2023 7:04:24 AM,Refugees,22106,22441,19270,18683,82500,22598,22942,19738,19080,84358
71,Lebanon,2022,LEB-22/DDA-3604/SA1/CP/INGO/22136,10/19/2023 10:00:42 AM,Host Communities,100,175,323,323,921,7,228,282,372,889
71,Lebanon,2022,LEB-22/DDA-3604/SA1/CP/INGO/22136,10/19/2023 10:00:42 AM,Overall,200,350,645,645,1840,16,571,627,743,1957
71,Lebanon,2022,LEB-22/DDA-3604/SA1/CP/INGO/22136,10/19/2023 10:00:42 AM,Refugees,100,175,322,322,919,9,343,345,371,1068
71,Lebanon,2022,LEB-22/DDA-3604/SA1/FS-S/NGO/22131,8/16/2023 9:18:18 AM,Host Communities,272,270,212,204,958,273,290,242,244,1049
71,Lebanon,2022,LEB-22/DDA-3604/SA1/FS-S/NGO/22131,8/16/2023 9:18:18 AM,Other,709,704,553,531,2497,612,632,612,539,2395
71,Lebanon,2022,LEB-22/DDA-3604/SA1/FS-S/NGO/22131,8/16/2023 9:18:18 AM,Overall,981,974,765,735,3455,885,922,854,783,3444
71,Lebanon,2022,LEB-22/DDA-3604/SA1/FS-W/INGO/22113,8/14/2023 6:21:14 AM,Host Communities,863,938,709,767,3277,1430,1618,1172,1019,5239
71,Lebanon,2022,LEB-22/DDA-3604/SA1/FS-W/INGO/22113,8/14/2023 6:21:14 AM,Overall,1107,1202,908,983,4200,1468,1665,1211,1056,5400
71,Lebanon,2022,LEB-22/DDA-3604/SA1/FS-W/INGO/22113,8/14/2023 6:21:14 AM,Refugees,244,264,199,216,923,38,47,39,37,161
71,Lebanon,2022,LEB-22/DDA-3604/SA1/FS-W-P/NGO/22072,10/16/2023 7:44:42 AM,Host Communities,365,565,121,242,1293,444,593,153,307,1497
71,Lebanon,2022,LEB-22/DDA-3604/SA1/FS-W-P/NGO/22072,10/16/2023 7:44:42 AM,Overall,457,705,154,304,1620,558,739,194,381,1872
71,Lebanon,2022,LEB-22/DDA-3604/SA1/FS-W-P/NGO/22072,10/16/2023 7:44:42 AM,Refugees,92,140,33,62,327,114,146,41,74,375
71,Lebanon,2022,LEB-22/DDA-3604/SA1/FS-W-S/NGO/22002,8/10/2023 11:00:16 AM,Host Communities,1238,1238,1062,1062,4600,1155,1364,1083,1083,4685
71,Lebanon,2022,LEB-22/DDA-3604/SA1/FS-W-S/NGO/22002,8/10/2023 11:00:16 AM,Overall,1238,1238,1062,1062,4600,1155,1364,1083,1083,4685
71,Lebanon,2022,LEB-22/DDA-3604/SA1/P/NGO/22054,10/17/2023 11:52:48 AM,Host Communities,630,910,0,0,1540,610,839,0,0,1449
71,Lebanon,2022,LEB-22/DDA-3604/SA1/P/NGO/22054,10/17/2023 11:52:48 AM,Other,45,65,0,0,110,32,75,0,0,107
71,Lebanon,2022,LEB-22/DDA-3604/SA1/P/NGO/22054,10/17/2023 11:52:48 AM,Overall,900,1300,0,0,2200,930,1332,2,0,2264
71,Lebanon,2022,LEB-22/DDA-3604/SA1/P/NGO/22054,10/17/2023 11:52:48 AM,Refugees,225,325,0,0,550,288,418,2,0,708
71,Lebanon,2022,LEB-22/DDA-3604/SA1/S/INGO/22023,8/11/2023 12:04:35 PM,Host Communities,186,227,241,231,885,245,310,186,197,938
71,Lebanon,2022,LEB-22/DDA-3604/SA1/S/INGO/22023,8/11/2023 12:04:35 PM,Overall,372,454,483,461,1770,425,516,424,451,1816
71,Lebanon,2022,LEB-22/DDA-3604/SA1/S/INGO/22023,8/11/2023 12:04:35 PM,Refugees,186,227,242,230,885,180,206,238,254,878
71,Lebanon,2022,LEB-22/DDA-3604/SA1/W/INGO/22080,10/18/2023 8:17:51 AM,Host Communities,9627,10019,4294,4126,28066,12074,12566,5386,5174,35200
71,Lebanon,2022,LEB-22/DDA-3604/SA1/W/INGO/22080,10/18/2023 8:17:51 AM,Overall,10726,11163,4784,4598,31271,14221,14801,6344,6094,41460
71,Lebanon,2022,LEB-22/DDA-3604/SA1/W/INGO/22080,10/18/2023 8:17:51 AM,Refugees,1099,1144,490,472,3205,2147,2235,958,920,6260
71,Lebanon,2022,LEB-22/DDA-3604/SA1/W-CP/NGO/22107,10/13/2023 7:22:17 AM,Host Communities,6554,6554,4370,4370,21848,5906,5904,3942,3931,19683
71,Lebanon,2022,LEB-22/DDA-3604/SA1/W-CP/NGO/22107,10/13/2023 7:22:17 AM,Overall,9363,9363,6243,6243,31212,9274,9272,6341,6330,31217
71,Lebanon,2022,LEB-22/DDA-3604/SA1/W-CP/NGO/22107,10/13/2023 7:22:17 AM,Refugees,2809,2809,1873,1873,9364,3368,3368,2399,2399,11534
59,Myanmar,2015,MM-15/DDA-3415/R/FS/INGO/1765,3/11/2016 8:17:34 AM,Overall,3626,4088,2234,3352,13300,3510,5656,0,0,9166
59,Myanmar,2015,MM-15/DDA-3415/R/FS/NGO/1792,11/24/2016 5:00:17 AM,Other,1219,2897,2556,3128,9800,1821,2905,2564,3136,10426
59,Myanmar,2015,MM-15/DDA-3415/R/FS/NGO/1792,11/24/2016 5:00:17 AM,Overall,1219,2897,2556,3128,9800,1821,2905,2564,3136,10426
59,Myanmar,2015,MM-15/DDA-3415/R/FS-WASH/INGO/1755,6/7/2016 10:09:12 AM,Other,20446,20438,0,0,40884,0,0,0,0,0
59,Myanmar,2015,MM-15/DDA-3415/R/FS-WASH/INGO/1755,6/7/2016 10:09:12 AM,Overall,20446,20438,0,0,40884,20279,20260,0,0,40539
59,Myanmar,2015,MM-15/DDA-3415/R/SNFI/INGO/1752,2/17/2016 10:08:39 AM,Host Communities,4783,5120,3797,3766,17466,4845,5389,3849,3599,17682
59,Myanmar,2015,MM-15/DDA-3415/R/SNFI/INGO/1752,2/17/2016 10:08:39 AM,Overall,4783,5120,3797,3766,17466,4845,5389,3849,3599,17682
59,Myanmar,2015,MM-15/DDA-3415/R/SNFI/NGO/1150,3/30/2016 5:18:30 AM,Internally Displaced People,138,142,203,214,697,157,150,221,237,765
59,Myanmar,2015,MM-15/DDA-3415/R/SNFI/NGO/1150,3/30/2016 5:18:30 AM,Overall,138,142,203,214,697,157,150,221,237,765
59,Myanmar,2015,MM-15/DDA-3415/R/WASH/NGO/1769,7/1/2016 9:09:22 AM,Host Communities,2552,3185,1236,1452,8425,2552,3185,1236,1452,8425
59,Myanmar,2015,MM-15/DDA-3415/R/WASH/NGO/1769,7/1/2016 9:09:22 AM,Overall,2552,3185,1236,1452,8425,2552,3185,1236,1452,8425
59,Myanmar,2015,MM-15/DDA-3415/R/WASH-FS/INGO/1767,6/7/2016 10:15:24 AM,Host Communities,2296,2637,1494,1448,7875,4130,4283,1989,2331,12733
59,Myanmar,2015,MM-15/DDA-3415/R/WASH-FS/INGO/1767,6/7/2016 10:15:24 AM,Overall,2296,2637,1494,1448,7875,4130,4283,1989,2331,12733
59,Myanmar,2015,MM-15/DDA-3415/R/WASH-H-P/INGO/2045,9/6/2016 2:21:23 AM,Host Communities,3271,3398,344,693,7706,1145,2129,1893,2129,7296
59,Myanmar,2015,MM-15/DDA-3415/R/WASH-H-P/INGO/2045,9/6/2016 2:21:23 AM,Overall,3271,3398,344,693,7706,1145,2129,1893,2129,7296
59,Myanmar,2015,MM-15/DDA-3415/R/WASH-SNFI/INGO/1754,6/30/2016 7:24:37 AM,Other,4200,4856,1969,2100,13125,0,0,0,0,0
59,Myanmar,2015,MM-15/DDA-3415/R/WASH-SNFI/INGO/1754,6/30/2016 7:24:37 AM,Overall,4200,4856,1969,2100,13125,7115,8389,3463,3562,22529
59,Myanmar,2015,MM-15/DDA-3415/RK-ER/E/INGO/1181,9/9/2016 3:07:42 AM,Host Communities,0,0,0,0,0,791,438,415,462,2106
59,Myanmar,2015,MM-15/DDA-3415/RK-ER/E/INGO/1181,9/9/2016 3:07:42 AM,Internally Displaced People,0,0,0,0,0,222,370,107,251,950
59,Myanmar,2015,MM-15/DDA-3415/RK-ER/E/INGO/1181,9/9/2016 3:07:42 AM,Overall,300,300,630,630,1860,1013,808,522,713,3056
59,Myanmar,2015,MM-15/DDA-3415/RK-ER/H/NGO/1149,9/21/2016 3:04:14 AM,Host Communities,80,88,0,0,168,61,68,9,10,148
59,Myanmar,2015,MM-15/DDA-3415/RK-ER/H/NGO/1149,9/21/2016 3:04:14 AM,Internally Displaced People,8998,9913,0,0,18911,8932,9653,1634,1766,21985
59,Myanmar,2015,MM-15/DDA-3415/RK-ER/H/NGO/1149,9/21/2016 3:04:14 AM,Other,8484,9347,0,0,17831,7048,7563,1149,1358,17118
59,Myanmar,2015,MM-15/DDA-3415/RK-ER/H/NGO/1149,9/21/2016 3:04:14 AM,Overall,17561,19349,0,0,36910,16041,17284,2792,3134,39251
59,Myanmar,2015,MM-15/DDA-3415/RK-ER/WASH-FS/INGO/1422,11/23/2016 3:50:17 AM,Internally Displaced People,1205,3094,884,956,6139,136,172,149,156,613
59,Myanmar,2015,MM-15/DDA-3415/RK-ER/WASH-FS/INGO/1422,11/23/2016 3:50:17 AM,Other,2992,7684,2196,2374,15246,5658,6539,4480,4390,21067
59,Myanmar,2015,MM-15/DDA-3415/RK-ER/WASH-FS/INGO/1422,11/23/2016 3:50:17 AM,Overall,4197,10778,3080,3330,21385,5794,6711,4629,4546,21680
59,Myanmar,2015,MM-15/DDA-3415/SA/E/INGO/1789,2/23/2017 10:22:48 AM,Internally Displaced People,163,271,2768,2995,6197,57,270,2907,2679,5913
59,Myanmar,2015,MM-15/DDA-3415/SA/E/INGO/1789,2/23/2017 10:22:48 AM,Overall,163,271,2995,2768,6197,57,270,2907,2679,5913
59,Myanmar,2015,MM-15/DDA-3415/SA/E/INGO/1902,2/2/2017 4:42:20 AM,Host Communities,25,25,1000,1000,2050,71,28,798,649,1546
59,Myanmar,2015,MM-15/DDA-3415/SA/E/INGO/1902,2/2/2017 4:42:20 AM,Internally Displaced People,94,94,2880,2880,5948,153,96,3471,3096,6816
59,Myanmar,2015,MM-15/DDA-3415/SA/E/INGO/1902,2/2/2017 4:42:20 AM,Other,10,10,0,0,20,8,6,0,0,14
59,Myanmar,2015,MM-15/DDA-3415/SA/E/INGO/1902,2/2/2017 4:42:20 AM,Overall,129,129,3880,3880,8018,232,130,4269,3745,8376
59,Myanmar,2015,MM-15/DDA-3415/SA/H/INGO/1933,3/1/2017 4:59:48 AM,Host Communities,792,729,130,133,1784,20,47,2,8,77
59,Myanmar,2015,MM-15/DDA-3415/SA/H/INGO/1933,3/1/2017 4:59:48 AM,Internally Displaced People,1016,1860,571,578,4025,256,1048,26,97,1427
59,Myanmar,2015,MM-15/DDA-3415/SA/H/INGO/1933,3/1/2017 4:59:48 AM,Overall,1808,2589,701,711,5809,276,1095,28,105,1504
59,Myanmar,2015,MM-15/DDA-3415/SA/H/NGO/1940,8/8/2017 10:40:35 AM,Overall,6584,8047,10243,11705,36579,7731,11820,5930,6155,31636
59,Myanmar,2015,MM-15/DDA-3415/SA/H/NGO/1950,1/17/2017 10:35:46 AM,Host Communities,0,2277,4228,4482,10987,0,3477,4027,3594,11098
59,Myanmar,2015,MM-15/DDA-3415/SA/H/NGO/1950,1/17/2017 10:35:46 AM,Overall,0,2277,4228,4482,10987,0,3477,4027,3594,11098
59,Myanmar,2015,MM-15/DDA-3415/SA/H-WASH/INGO/1936,9/7/2016 7:45:10 AM,Internally Displaced People,3966,3554,578,647,8745,3966,3554,578,647,8745
59,Myanmar,2015,MM-15/DDA-3415/SA/H-WASH/INGO/1936,9/7/2016 7:45:10 AM,Overall,3554,3966,578,647,8745,3554,3966,578,647,8745
59,Myanmar,2015,MM-15/DDA-3415/SA/N/INGO/1873,2/10/2017 2:10:54 AM,Other,0,0,960,1040,2000,0,0,1156,1605,2761
59,Myanmar,2015,MM-15/DDA-3415/SA/N/INGO/1873,2/10/2017 2:10:54 AM,Overall,0,0,960,1040,2000,0,0,1156,1605,2761
59,Myanmar,2015,MM-15/DDA-3415/SA/N/INGO/1937,2/14/2017 11:09:55 AM,Internally Displaced People,106,3661,29,29,3825,878,5278,1406,1328,8890
59,Myanmar,2015,MM-15/DDA-3415/SA/N/INGO/1937,2/14/2017 11:09:55 AM,Overall,106,3661,29,29,3825,0,0,0,0,0
59,Myanmar,2015,MM-15/DDA-3415/SA/P/INGO/1796,11/23/2016 4:02:40 AM,Host Communities,2000,2000,2000,2000,8000,5368,5190,2827,3197,16582
59,Myanmar,2015,MM-15/DDA-3415/SA/P/INGO/1796,11/23/2016 4:02:40 AM,Internally Displaced People,1600,1600,1600,1600,6400,306,437,67,50,860
59,Myanmar,2015,MM-15/DDA-3415/SA/P/INGO/1796,11/23/2016 4:02:40 AM,Overall,3600,3600,3600,3600,14400,5674,5627,2894,3247,17442
59,Myanmar,2015,MM-15/DDA-3415/SA/WASH/INGO/1934,8/3/2017 10:00:07 AM,Host Communities,380,425,523,474,1802,443,509,526,436,1914
59,Myanmar,2015,MM-15/DDA-3415/SA/WASH/INGO/1934,8/3/2017 10:00:07 AM,Internally Displaced People,782,1021,1280,1196,4279,907,1212,1195,1063,4377
59,Myanmar,2015,MM-15/DDA-3415/SA/WASH/INGO/1934,8/3/2017 10:00:07 AM,Overall,1162,1446,1803,1670,6081,1350,1721,1721,1499,6291
59,Myanmar,2015,MM-15/DDA-3415/SA/WASH-SNFI/INGO/1935,12/4/2017 10:47:42 AM,Internally Displaced People,1140,1260,300,300,3000,1932,2442,1731,1738,7843
59,Myanmar,2015,MM-15/DDA-3415/SA/WASH-SNFI/INGO/1935,12/4/2017 10:47:42 AM,Overall,1140,1260,300,300,3000,1932,2442,1843,1861,8078
59,Myanmar,2016,MM-16/DDA-3415/MM-16/DDA-3415/E/INGO/3937,9/22/2017 10:37:19 AM,Host Communities,210,165,1684,1387,3446,25,50,997,937,2009
59,Myanmar,2016,MM-16/DDA-3415/MM-16/DDA-3415/E/INGO/3937,9/22/2017 10:37:19 AM,Internally Displaced People,405,149,2810,2906,6270,403,136,2118,2073,4730
59,Myanmar,2016,MM-16/DDA-3415/MM-16/DDA-3415/E/INGO/3937,9/22/2017 10:37:19 AM,Overall,615,314,4494,4293,9716,428,186,3115,3010,6739
59,Myanmar,2016,MM-16/DDA-3415/MM-16/DDA-3415/E/INGO/4191,2/2/2018 6:58:37 AM,Internally Displaced People,1500,1500,3275,3275,9550,1420,1610,5870,6028,14928
59,Myanmar,2016,MM-16/DDA-3415/MM-16/DDA-3415/E/INGO/4191,2/2/2018 6:58:37 AM,Other,15,15,0,0,30,14,16,0,0,30
59,Myanmar,2016,MM-16/DDA-3415/MM-16/DDA-3415/E/INGO/4191,2/2/2018 6:58:37 AM,Overall,1515,1515,3275,3275,9580,1434,1626,5870,6028,14958
59,Myanmar,2016,MM-16/DDA-3415/MM-16/DDA-3415/E/NGO/4246,1/10/2018 11:17:33 AM,Other,870,787,425,508,2590,870,787,425,508,2590
59,Myanmar,2016,MM-16/DDA-3415/MM-16/DDA-3415/E/NGO/4246,1/10/2018 11:17:33 AM,Overall,870,787,425,508,2590,870,787,425,508,2590
59,Myanmar,2016,MM-16/DDA-3415/MM-16/DDA-3415/FS/NGO/4319,8/15/2017 3:57:23 AM,Internally Displaced People,1940,2929,1992,2072,8933,1894,2090,1906,2100,7990
59,Myanmar,2016,MM-16/DDA-3415/MM-16/DDA-3415/FS/NGO/4319,8/15/2017 3:57:23 AM,Overall,1940,2929,1992,2072,8933,1894,2090,1906,2100,7990
59,Myanmar,2016,MM-16/DDA-3415/MM-16/DDA-3415/FS-SNFI-WASH-N/NGO/4172,3/19/2018 10:14:15 AM,Internally Displaced People,4860,6584,4643,5183,21270,4698,5389,1430,1478,12995
59,Myanmar,2016,MM-16/DDA-3415/MM-16/DDA-3415/FS-SNFI-WASH-N/NGO/4172,3/19/2018 10:14:15 AM,Overall,4860,6584,4643,5183,21270,4698,5389,1430,1488,13005
59,Myanmar,2016,MM-16/DDA-3415/MM-16/DDA-3415/H/INGO/4157,3/23/2018 3:41:10 AM,Internally Displaced People,5292,7938,2268,3402,18900,5292,7938,2268,3402,18900
59,Myanmar,2016,MM-16/DDA-3415/MM-16/DDA-3415/H/INGO/4157,3/23/2018 3:41:10 AM,Overall,5292,7938,2268,3402,18900,1043,2554,754,863,5214
59,Myanmar,2016,MM-16/DDA-3415/MM-16/DDA-3415/H/INGO/4214,3/15/2018 11:23:37 AM,Internally Displaced People,4625,4112,822,719,10278,4716,4193,838,733,10480
59,Myanmar,2016,MM-16/DDA-3415/MM-16/DDA-3415/H/INGO/4214,3/15/2018 11:23:37 AM,Overall,4625,4112,822,719,10278,4716,4193,838,733,10480
59,Myanmar,2016,MM-16/DDA-3415/MM-16/DDA-3415/H/NGO/4024,1/11/2018 11:19:06 AM,Host Communities,0,1941,4234,4488,10663,0,1822,4150,3773,9745
59,Myanmar,2016,MM-16/DDA-3415/MM-16/DDA-3415/H/NGO/4024,1/11/2018 11:19:06 AM,Overall,0,1941,4234,4488,10663,0,1822,4150,3773,9745
59,Myanmar,2016,MM-16/DDA-3415/MM-16/DDA-3415/H/NGO/4027,2/20/2018 2:37:51 AM,Internally Displaced People,2633,3017,2642,2748,11040,2331,2664,2391,1728,9114
59,Myanmar,2016,MM-16/DDA-3415/MM-16/DDA-3415/H/NGO/4027,2/20/2018 2:37:51 AM,Overall,2633,3017,2642,2748,11040,2331,2664,2391,1728,9114
59,Myanmar,2016,MM-16/DDA-3415/MM-16/DDA-3415/P/INGO/4007,1/15/2018 10:58:42 AM,Host Communities,3800,3000,2500,1800,11100,2342,2533,2902,3472,11249
59,Myanmar,2016,MM-16/DDA-3415/MM-16/DDA-3415/P/INGO/4007,1/15/2018 10:58:42 AM,Internally Displaced People,200,400,300,200,1100,34,26,0,0,60
59,Myanmar,2016,MM-16/DDA-3415/MM-16/DDA-3415/P/INGO/4007,1/15/2018 10:58:42 AM,Overall,4000,3400,2800,2000,12200,2376,2559,2902,3472,11309
59,Myanmar,2016,MM-16/DDA-3415/MM-16/DDA-3415/P/INGO/4025,8/16/2017 5:16:57 AM,Host Communities,3600,3600,3600,3600,14400,6965,8386,3586,3926,22863
59,Myanmar,2016,MM-16/DDA-3415/MM-16/DDA-3415/P/INGO/4025,8/16/2017 5:16:57 AM,Internally Displaced People,720,720,720,720,2880,753,1285,594,694,3326
59,Myanmar,2016,MM-16/DDA-3415/MM-16/DDA-3415/P/INGO/4025,8/16/2017 5:16:57 AM,Overall,4320,4320,4320,4320,17280,7718,9671,4180,4620,26189
59,Myanmar,2016,MM-16/DDA-3415/MM-16/DDA-3415/P/INGO/4050,2/19/2018 9:34:21 AM,Host Communities,537,713,664,718,2632,841,1065,767,766,3439
59,Myanmar,2016,MM-16/DDA-3415/MM-16/DDA-3415/P/INGO/4050,2/19/2018 9:34:21 AM,Internally Displaced People,341,451,420,456,1668,416,551,434,470,1871
59,Myanmar,2016,MM-16/DDA-3415/MM-16/DDA-3415/P/INGO/4050,2/19/2018 9:34:21 AM,Overall,878,1164,1084,1174,4300,1257,1616,1201,1236,5310
59,Myanmar,2016,MM-16/DDA-3415/MM-16/DDA-3415/P/INGO/4313,4/3/2018 8:29:56 AM,Internally Displaced People,180,240,180,240,840,142,240,190,224,796
59,Myanmar,2016,MM-16/DDA-3415/MM-16/DDA-3415/P/INGO/4313,4/3/2018 8:29:56 AM,Overall,180,240,180,240,840,142,240,190,224,796
59,Myanmar,2016,MM-16/DDA-3415/MM-16/DDA-3415/P-E/NGO/4190,7/31/2018 11:36:45 AM,Internally Displaced People,249,385,152,249,1035,250,385,150,250,1035
59,Myanmar,2016,MM-16/DDA-3415/MM-16/DDA-3415/P-E/NGO/4190,7/31/2018 11:36:45 AM,Overall,249,385,152,249,1035,250,385,150,250,1035
59,Myanmar,2016,MM-16/DDA-3415/MM-16/DDA-3415/R/SNFI/UN/3120,10/3/2017 10:13:32 AM,Internally Displaced People,4000,5000,5700,5300,20000,4349,5405,6520,6016,22290
59,Myanmar,2016,MM-16/DDA-3415/MM-16/DDA-3415/R/SNFI/UN/3120,10/3/2017 10:13:32 AM,Overall,4000,5000,5700,5300,20000,4349,5405,6520,6016,22290
59,Myanmar,2016,MM-16/DDA-3415/MM-16/DDA-3415/R/WASH/INGO/3136,3/17/2017 8:54:08 AM,Internally Displaced People,1376,1812,178,204,3570,1362,1726,174,194,3456
59,Myanmar,2016,MM-16/DDA-3415/MM-16/DDA-3415/R/WASH/INGO/3136,3/17/2017 8:54:08 AM,Overall,688,906,89,102,1785,681,863,87,97,1728
59,Myanmar,2016,MM-16/DDA-3415/MM-16/DDA-3415/R/WASH/INGO/3138,3/1/2017 4:41:18 AM,Host Communities,72,62,358,454,946,72,62,358,454,946
59,Myanmar,2016,MM-16/DDA-3415/MM-16/DDA-3415/R/WASH/INGO/3138,3/1/2017 4:41:18 AM,Internally Displaced People,694,807,738,802,3041,694,807,738,802,3041
59,Myanmar,2016,MM-16/DDA-3415/MM-16/DDA-3415/R/WASH/INGO/3138,3/1/2017 4:41:18 AM,Overall,766,869,1096,1256,3987,766,869,1096,1256,3987
59,Myanmar,2016,MM-16/DDA-3415/MM-16/DDA-3415/SNFI/NGO/4026,11/29/2017 10:40:39 AM,Internally Displaced People,931,1062,640,757,3390,855,873,877,868,3473
59,Myanmar,2016,MM-16/DDA-3415/MM-16/DDA-3415/SNFI/NGO/4026,11/29/2017 10:40:39 AM,Overall,931,1062,640,757,3390,855,873,877,868,3473
59,Myanmar,2016,MM-16/DDA-3415/MM-16/DDA-3415/SNFI/NGO/4247,4/26/2018 9:34:35 AM,Internally Displaced People,305,714,248,684,1951,305,714,248,684,1951
59,Myanmar,2016,MM-16/DDA-3415/MM-16/DDA-3415/SNFI/NGO/4247,4/26/2018 9:34:35 AM,Overall,305,714,248,684,1951,305,714,248,684,1951
59,Myanmar,2016,MM-16/DDA-3415/MM-16/DDA-3415/SNFI/NGO/4320,10/11/2017 11:30:47 AM,Internally Displaced People,835,1082,851,819,3587,117,167,142,158,584
59,Myanmar,2016,MM-16/DDA-3415/MM-16/DDA-3415/SNFI/NGO/4320,10/11/2017 11:30:47 AM,Overall,835,1082,851,819,3587,117,167,142,158,584
59,Myanmar,2016,MM-16/DDA-3415/MM-16/DDA-3415/WASH-SNFI/INGO/4078,2/2/2018 7:01:32 AM,Internally Displaced People,1840,1600,430,430,4300,2642,2947,1374,1411,8374
59,Myanmar,2016,MM-16/DDA-3415/MM-16/DDA-3415/WASH-SNFI/INGO/4078,2/2/2018 7:01:32 AM,Overall,1840,1600,430,430,4300,3714,3643,1719,1781,10857
59,Myanmar,2016,MM-16/DDA-3415/RA/FS/NGO/4509,8/15/2017 4:11:20 AM,Internally Displaced People,1781,2253,1728,1701,7463,1835,2285,1736,1698,7554
59,Myanmar,2016,MM-16/DDA-3415/RA/FS/NGO/4509,8/15/2017 4:11:20 AM,Overall,1781,2253,1728,1701,7463,1835,2285,1736,1698,7554
59,Myanmar,2017,MM-17/DDA-3415/01-RA/E/INGO/4977,5/16/2018 3:30:13 AM,Host Communities,0,0,0,0,0,1427,582,3429,3128,8566
59,Myanmar,2017,MM-17/DDA-3415/01-RA/E/INGO/4977,5/16/2018 3:30:13 AM,Internally Displaced People,0,0,0,0,0,1974,1284,2109,1702,7069
59,Myanmar,2017,MM-17/DDA-3415/01-RA/E/INGO/4977,5/16/2018 3:30:13 AM,Overall,2046,1589,5781,5375,14791,3401,1866,5536,4830,15633
59,Myanmar,2017,MM-17/DDA-3415/01-RA/N-WASH/INGO/5007,12/12/2018 10:46:57 AM,Overall,2021,4401,2737,4416,13575,4348,5948,3876,5089,19261
59,Myanmar,2017,MM-17/DDA-3415/01-RA/P/INGO/5153,7/10/2018 3:04:04 AM,Internally Displaced People,366,549,476,439,1830,448,823,697,683,2651
59,Myanmar,2017,MM-17/DDA-3415/01-RA/P/INGO/5153,7/10/2018 3:04:04 AM,Overall,366,549,476,439,1830,448,823,697,683,2651
59,Myanmar,2017,MM-17/DDA-3415/01-RA/SNFI/NGO/5165,5/14/2018 9:01:08 AM,Internally Displaced People,456,573,418,422,1869,462,589,428,436,1915
59,Myanmar,2017,MM-17/DDA-3415/01-RA/SNFI/NGO/5165,5/14/2018 9:01:08 AM,Overall,456,573,418,422,1869,462,589,428,436,1915
59,Myanmar,2017,MM-17/DDA-3415/01-RA/SNFI/NGO/5171,3/5/2018 5:32:32 AM,Internally Displaced People,419,411,293,246,1369,165,179,145,137,626
59,Myanmar,2017,MM-17/DDA-3415/01-RA/SNFI/NGO/5171,3/5/2018 5:32:32 AM,Overall,419,411,293,246,1369,165,179,145,137,626
59,Myanmar,2017,MM-17/DDA-3415/01-RA/WASH-P-E/INGO/5161,7/11/2018 6:27:01 AM,Internally Displaced People,1766,2126,1619,1608,7119,1869,2147,1756,1593,7365
59,Myanmar,2017,MM-17/DDA-3415/01-RA/WASH-P-E/INGO/5161,7/11/2018 6:27:01 AM,Overall,1766,2126,1619,1608,7119,1869,2147,1756,1593,7365
59,Myanmar,2017,MM-17/DDA-3415/01-SA/E-H-SNFI-WASH-FS/NGO/6843,1/25/2019 6:31:36 AM,Internally Displaced People,7554,9389,8611,8633,34187,12330,14976,18276,19491,65073
59,Myanmar,2017,MM-17/DDA-3415/01-SA/E-H-SNFI-WASH-FS/NGO/6843,1/25/2019 6:31:36 AM,Overall,7554,9389,8611,8633,34187,6165,7488,9138,9339,32130
59,Myanmar,2017,MM-17/DDA-3415/01-SA/FS-SNFI-WASH-N/NGO/6845,1/23/2019 9:56:53 AM,Internally Displaced People,1275,2349,1620,1754,6998,2684,5653,3146,5763,17246
59,Myanmar,2017,MM-17/DDA-3415/01-SA/FS-SNFI-WASH-N/NGO/6845,1/23/2019 9:56:53 AM,Other,593,768,693,696,2750,0,0,0,0,0
59,Myanmar,2017,MM-17/DDA-3415/01-SA/FS-SNFI-WASH-N/NGO/6845,1/23/2019 9:56:53 AM,Overall,1868,3117,2313,2450,9748,2684,5653,3146,5763,17246
59,Myanmar,2017,MM-17/DDA-3415/01-SA/H/UN/6815,1/31/2019 9:21:28 AM,Host Communities,16070,17410,9850,10670,54000,10110,11631,6370,6347,34458
59,Myanmar,2017,MM-17/DDA-3415/01-SA/H/UN/6815,1/31/2019 9:21:28 AM,Internally Displaced People,4450,4821,2727,2955,14953,6186,6919,4827,4935,22867
59,Myanmar,2017,MM-17/DDA-3415/01-SA/H/UN/6815,1/31/2019 9:21:28 AM,Overall,20520,22231,12577,13625,68953,16296,18550,11197,11282,57325
59,Myanmar,2017,MM-17/DDA-3415/01-SA/N/INGO/6853,1/25/2019 5:09:35 AM,Internally Displaced People,1358,1452,485,427,3722,523,4671,1029,1087,7310
59,Myanmar,2017,MM-17/DDA-3415/01-SA/N/INGO/6853,1/25/2019 5:09:35 AM,Overall,1358,1452,485,427,3722,523,4671,1049,1087,7330
59,Myanmar,2017,MM-17/DDA-3415/01-SA/P/INGO/6847,11/6/2018 9:14:56 AM,Host Communities,5105,5105,5102,5102,20414,10966,12142,6136,7628,36872
59,Myanmar,2017,MM-17/DDA-3415/01-SA/P/INGO/6847,11/6/2018 9:14:56 AM,Internally Displaced People,933,933,930,930,3726,414,576,169,307,1466
59,Myanmar,2017,MM-17/DDA-3415/01-SA/P/INGO/6847,11/6/2018 9:14:56 AM,Overall,6038,6038,6032,6032,24140,11380,12718,6305,7935,38338
59,Myanmar,2017,MM-17/DDA-3415/01-SA/P-SNFI/INGO/6842,1/31/2019 9:23:34 AM,Host Communities,1722,1728,850,850,5150,4066,4078,2125,2252,12521
59,Myanmar,2017,MM-17/DDA-3415/01-SA/P-SNFI/INGO/6842,1/31/2019 9:23:34 AM,Internally Displaced People,701,807,378,416,2302,15287,17649,12835,12705,58476
59,Myanmar,2017,MM-17/DDA-3415/01-SA/P-SNFI/INGO/6842,1/31/2019 9:23:34 AM,Other,852,991,342,342,2527,377,575,20856,21784,43592
59,Myanmar,2017,MM-17/DDA-3415/01-SA/P-SNFI/INGO/6842,1/31/2019 9:23:34 AM,Overall,3375,3526,1570,1608,10079,5220,7513,973,1108,14814
59,Myanmar,2017,MM-17/DDA-3415/01-SA/P-WASH-FS/INGO/6805,1/31/2019 11:30:24 AM,Host Communities,338,339,499,598,1774,1054,1208,728,808,3798
59,Myanmar,2017,MM-17/DDA-3415/01-SA/P-WASH-FS/INGO/6805,1/31/2019 11:30:24 AM,Internally Displaced People,4381,5926,5183,5285,20775,12083,15098,11665,12340,51186
59,Myanmar,2017,MM-17/DDA-3415/01-SA/P-WASH-FS/INGO/6805,1/31/2019 11:30:24 AM,Overall,4719,6265,5682,5883,22549,6630,8276,6222,6615,27743
59,Myanmar,2017,MM-17/DDA-3415/01-SA/SNFI/NGO/6840,10/9/2018 8:49:38 AM,Internally Displaced People,117,168,153,168,606,193,234,168,155,750
59,Myanmar,2017,MM-17/DDA-3415/01-SA/SNFI/NGO/6840,10/9/2018 8:49:38 AM,Overall,117,168,153,168,606,193,234,168,155,750
59,Myanmar,2017,MM-17/DDA-3415/01-SA/WASH-SNFI/INGO/6839,1/31/2019 10:37:43 AM,Internally Displaced People,1682,2056,1006,1006,5750,3867,4348,3330,3243,14788
59,Myanmar,2017,MM-17/DDA-3415/01-SA/WASH-SNFI/INGO/6839,1/31/2019 10:37:43 AM,Overall,1682,2056,1006,1006,5750,3867,4348,3330,3243,14788
59,Myanmar,2017,MM-17/DDA-3415/02-SA/E/INGO/7310,2/26/2019 12:01:18 PM,Other,315,315,392,758,1780,398,456,546,487,1887
59,Myanmar,2017,MM-17/DDA-3415/02-SA/E/INGO/7310,2/26/2019 12:01:18 PM,Overall,315,315,392,758,1780,406,355,644,482,1887
59,Myanmar,2017,MM-17/DDA-3415/02-SA/E/NGO/7180,4/24/2019 6:06:10 AM,Host Communities,1331,1104,666,988,4089,487,468,237,247,1439
59,Myanmar,2017,MM-17/DDA-3415/02-SA/E/NGO/7180,4/24/2019 6:06:10 AM,Overall,1331,1104,666,988,4089,1331,1104,666,988,4089
59,Myanmar,2017,MM-17/DDA-3415/02-SA/FS/INGO/7321,4/9/2019 6:31:42 AM,Host Communities,1819,2330,1558,1572,7279,2045,2123,2098,2143,8409
59,Myanmar,2017,MM-17/DDA-3415/02-SA/FS/INGO/7321,4/9/2019 6:31:42 AM,Internally Displaced People,607,776,519,524,2426,0,0,0,0,0
59,Myanmar,2017,MM-17/DDA-3415/02-SA/FS/INGO/7321,4/9/2019 6:31:42 AM,Overall,2426,3106,2077,2096,9705,2045,2123,2098,2143,8409
59,Myanmar,2017,MM-17/DDA-3415/02-SA/FS/UN/7315,11/23/2018 2:48:25 PM,Overall,4974,5880,1183,1061,13098,3648,4406,2353,2319,12726
59,Myanmar,2017,MM-17/DDA-3415/02-SA/H/UN/7326,2/12/2019 9:40:23 AM,Host Communities,5594,7551,3559,4805,21509,6258,24547,2302,2699,35806
59,Myanmar,2017,MM-17/DDA-3415/02-SA/H/UN/7326,2/12/2019 9:40:23 AM,Internally Displaced People,4616,6232,2938,3966,17752,5121,20084,1884,2208,29297
59,Myanmar,2017,MM-17/DDA-3415/02-SA/H/UN/7326,2/12/2019 9:40:23 AM,Overall,10210,13783,6497,8771,39261,11379,44631,4186,4907,65103
59,Myanmar,2017,MM-17/DDA-3415/02-SA/H-P/INGO/7323,3/18/2019 8:19:24 AM,Host Communities,848,1032,958,848,3686,848,1032,958,848,3686
59,Myanmar,2017,MM-17/DDA-3415/02-SA/H-P/INGO/7323,3/18/2019 8:19:24 AM,Internally Displaced People,3156,3505,3568,3504,13733,3156,3496,3568,3501,13721
59,Myanmar,2017,MM-17/DDA-3415/02-SA/H-P/INGO/7323,3/18/2019 8:19:24 AM,Other,461,561,313,313,1648,461,561,313,313,1648
59,Myanmar,2017,MM-17/DDA-3415/02-SA/H-P/INGO/7323,3/18/2019 8:19:24 AM,Overall,4465,5098,4839,4665,19067,4465,5089,4839,4662,19055
59,Myanmar,2017,MM-17/DDA-3415/02-SA/P-H/INGO/7320,5/16/2019 4:02:45 AM,Host Communities,4936,13082,17790,18925,54733,4936,13082,17790,18925,54733
59,Myanmar,2017,MM-17/DDA-3415/02-SA/P-H/INGO/7320,5/16/2019 4:02:45 AM,Internally Displaced People,591,708,668,734,2701,643,785,740,752,2920
59,Myanmar,2017,MM-17/DDA-3415/02-SA/P-H/INGO/7320,5/16/2019 4:02:45 AM,Other,240,240,50,50,580,90,90,19,19,218
59,Myanmar,2017,MM-17/DDA-3415/02-SA/P-H/INGO/7320,5/16/2019 4:02:45 AM,Overall,5767,14030,18508,19709,58014,5669,13957,18549,19696,57871
59,Myanmar,2017,MM-17/DDA-3415/02-SA/P-WASH/INGO/7086,1/11/2019 11:52:02 AM,Internally Displaced People,7020,6943,7705,7048,28716,3106,3673,10937,10147,27863
59,Myanmar,2017,MM-17/DDA-3415/02-SA/P-WASH/INGO/7086,1/11/2019 11:52:02 AM,Other,4338,5342,4215,4483,18378,4026,4972,2518,2997,14513
59,Myanmar,2017,MM-17/DDA-3415/02-SA/P-WASH/INGO/7086,1/11/2019 11:52:02 AM,Overall,11358,12285,11920,11531,47094,7142,8645,13455,13134,42376
59,Myanmar,2017,MM-17/DDA-3415/RA-02/E/INGO/6407,8/1/2018 6:40:51 AM,Host Communities,0,0,282,268,550,125,95,5810,4650,10680
59,Myanmar,2017,MM-17/DDA-3415/RA-02/E/INGO/6407,8/1/2018 6:40:51 AM,Internally Displaced People,78,105,4895,3990,9068,0,0,0,0,0
59,Myanmar,2017,MM-17/DDA-3415/RA-02/E/INGO/6407,8/1/2018 6:40:51 AM,Overall,78,105,5177,4258,9618,105,78,4895,3990,9068
59,Myanmar,2017,MM-17/DDA-3415/RA-02/WASH/INGO/6435,8/7/2018 5:33:01 AM,Internally Displaced People,4143,4970,5557,5588,20258,4124,5214,5473,5447,20258
59,Myanmar,2017,MM-17/DDA-3415/RA-02/WASH/INGO/6435,8/7/2018 5:33:01 AM,Overall,4143,4970,5557,5588,20258,4124,5214,5473,5447,20258
59,Myanmar,2018,MM-18/DDA-3415/RA1/E/INGO/10370,6/24/2019 7:51:32 AM,Other,0,0,6480,7020,13500,0,0,5138,5760,10898
59,Myanmar,2018,MM-18/DDA-3415/RA1/E/INGO/10370,6/24/2019 7:51:32 AM,Overall,0,0,6480,7020,13500,0,0,5138,5760,10898
59,Myanmar,2018,MM-18/DDA-3415/RA1/FS/INGO/10356,10/7/2019 8:49:51 AM,Host Communities,11000,11000,7000,7000,36000,12839,11698,9459,7094,41090
59,Myanmar,2018,MM-18/DDA-3415/RA1/FS/INGO/10356,10/7/2019 8:49:51 AM,Internally Displaced People,4000,4000,3000,3000,14000,0,0,0,0,0
59,Myanmar,2018,MM-18/DDA-3415/RA1/FS/INGO/10356,10/7/2019 8:49:51 AM,Overall,15000,15000,10000,10000,50000,12839,11698,9459,7094,41090
59,Myanmar,2018,MM-18/DDA-3415/RA1/FS-SNFI-E/INGO/10403,5/28/2019 5:59:29 AM,Host Communities,1400,1500,1600,1700,6200,6426,6855,4557,4580,22418
59,Myanmar,2018,MM-18/DDA-3415/RA1/FS-SNFI-E/INGO/10403,5/28/2019 5:59:29 AM,Internally Displaced People,3365,3469,3664,4002,14500,0,0,0,0,0
59,Myanmar,2018,MM-18/DDA-3415/RA1/FS-SNFI-E/INGO/10403,5/28/2019 5:59:29 AM,Overall,4765,4969,5264,5702,20700,6426,6855,4557,4580,22418
59,Myanmar,2018,MM-18/DDA-3415/RA1/SNFI-E/INGO/10358,5/30/2019 3:20:57 AM,Host Communities,7602,8541,4031,4126,24300,5892,6385,5702,5526,23505
59,Myanmar,2018,MM-18/DDA-3415/RA1/SNFI-E/INGO/10358,5/30/2019 3:20:57 AM,Overall,7602,8541,4031,4126,24300,5874,6376,5676,5550,23476
59,Myanmar,2018,MM-18/DDA-3415/SA1/CCCM-E-FS-H-N-P-SNFI/NGO/9688,11/25/2019 9:09:31 AM,Internally Displaced People,17462,19481,15589,15962,68494,27627,47830,28624,28920,133001
59,Myanmar,2018,MM-18/DDA-3415/SA1/CCCM-E-FS-H-N-P-SNFI/NGO/9688,11/25/2019 9:09:31 AM,Overall,17462,19481,15589,15962,68494,27627,47830,28624,28920,133001
59,Myanmar,2018,MM-18/DDA-3415/SA1/E/INGO/9991,12/20/2019 4:48:59 AM,Host Communities,39,38,215,235,527,121,122,1453,1570,3266
59,Myanmar,2018,MM-18/DDA-3415/SA1/E/INGO/9991,12/20/2019 4:48:59 AM,Internally Displaced People,37,38,6177,3483,9735,54,57,2016,1797,3924
59,Myanmar,2018,MM-18/DDA-3415/SA1/E/INGO/9991,12/20/2019 4:48:59 AM,Overall,76,76,6392,3718,10262,175,179,3469,3367,7190
59,Myanmar,2018,MM-18/DDA-3415/SA1/FS/UN/9762,12/6/2019 5:47:10 AM,Other,7920,8360,2838,2882,22000,15016,16302,14163,14423,59904
59,Myanmar,2018,MM-18/DDA-3415/SA1/FS/UN/9762,12/6/2019 5:47:10 AM,Overall,7920,8360,2838,2882,22000,15016,16302,14163,14423,59904
59,Myanmar,2018,MM-18/DDA-3415/SA1/FS-N-WASH-SNFI-E/NGO/9894,11/29/2019 12:36:32 PM,Host Communities,283,338,303,332,1256,92,205,0,0,297
59,Myanmar,2018,MM-18/DDA-3415/SA1/FS-N-WASH-SNFI-E/NGO/9894,11/29/2019 12:36:32 PM,Internally Displaced People,3831,4869,4884,4893,18477,5204,6531,5452,5776,22963
59,Myanmar,2018,MM-18/DDA-3415/SA1/FS-N-WASH-SNFI-E/NGO/9894,11/29/2019 12:36:32 PM,Overall,4114,5207,5187,5225,19733,5296,6736,5452,5776,23260
59,Myanmar,2018,MM-18/DDA-3415/SA1/H/INGO/9701,11/29/2019 4:03:14 AM,Internally Displaced People,1000,2500,800,800,5100,2114,4492,2644,2303,11553
59,Myanmar,2018,MM-18/DDA-3415/SA1/H/INGO/9701,11/29/2019 4:03:14 AM,Overall,1000,2500,800,800,5100,2114,4492,2644,2303,11553
59,Myanmar,2018,MM-18/DDA-3415/SA1/H/UN/9652,9/23/2019 11:07:02 AM,Host Communities,5463,7327,1025,1425,15240,11457,12173,2098,1735,27463
59,Myanmar,2018,MM-18/DDA-3415/SA1/H/UN/9652,9/23/2019 11:07:02 AM,Overall,5463,7327,1025,1425,15240,11457,12173,2098,1735,27463
59,Myanmar,2018,MM-18/DDA-3415/SA1/H-P/INGO/9775,12/9/2019 11:24:34 AM,Internally Displaced People,3886,5431,680,966,10963,3321,3055,1805,1985,10166
59,Myanmar,2018,MM-18/DDA-3415/SA1/H-P/INGO/9775,12/9/2019 11:24:34 AM,Other,30,29,0,0,59,50,452,0,148,650
59,Myanmar,2018,MM-18/DDA-3415/SA1/H-P/INGO/9775,12/9/2019 11:24:34 AM,Overall,3916,5460,680,966,11022,3371,3507,1805,2133,10816
59,Myanmar,2018,MM-18/DDA-3415/SA1/H-P/UN/9706,7/28/2020 10:53:36 AM,Host Communities,12997,16907,8380,8906,47190,7928,13722,7386,6245,35281
59,Myanmar,2018,MM-18/DDA-3415/SA1/H-P/UN/9706,7/28/2020 10:53:36 AM,Internally Displaced People,8250,9755,10082,9682,37769,7018,10954,4052,4823,26847
59,Myanmar,2018,MM-18/DDA-3415/SA1/H-P/UN/9706,7/28/2020 10:53:36 AM,Overall,21247,26662,18462,18588,84959,14946,24676,11438,11068,62128
59,Myanmar,2018,MM-18/DDA-3415/SA1/N/INGO/9906,2/18/2020 5:02:03 AM,Host Communities,25,140,0,0,165,55,153,38,41,287
59,Myanmar,2018,MM-18/DDA-3415/SA1/N/INGO/9906,2/18/2020 5:02:03 AM,Internally Displaced People,213,1208,475,450,2346,495,1883,439,420,3237
59,Myanmar,2018,MM-18/DDA-3415/SA1/N/INGO/9906,2/18/2020 5:02:03 AM,Overall,238,1348,475,450,2511,550,2036,477,461,3524
59,Myanmar,2018,MM-18/DDA-3415/SA1/P/INGO/10180,1/14/2020 9:26:43 AM,Host Communities,8914,10153,6538,6646,32251,8866,10099,6523,6631,32119
59,Myanmar,2018,MM-18/DDA-3415/SA1/P/INGO/10180,1/14/2020 9:26:43 AM,Internally Displaced People,261,1734,194,1156,3345,843,1218,631,634,3326
59,Myanmar,2018,MM-18/DDA-3415/SA1/P/INGO/10180,1/14/2020 9:26:43 AM,Other,663,651,433,496,2243,663,651,433,496,2243
59,Myanmar,2018,MM-18/DDA-3415/SA1/P/INGO/10180,1/14/2020 9:26:43 AM,Overall,9838,12538,7165,8298,37839,10372,11968,7587,7761,37688
59,Myanmar,2018,MM-18/DDA-3415/SA1/P/INGO/10181,1/6/2020 5:58:40 AM,Host Communities,30,40,5,5,80,2679,4004,669,811,8163
59,Myanmar,2018,MM-18/DDA-3415/SA1/P/INGO/10181,1/6/2020 5:58:40 AM,Internally Displaced People,1108,1107,1255,1255,4725,110,230,91,80,511
59,Myanmar,2018,MM-18/DDA-3415/SA1/P/INGO/10181,1/6/2020 5:58:40 AM,Other,950,950,750,750,3400,67,82,1871,2266,4286
59,Myanmar,2018,MM-18/DDA-3415/SA1/P/INGO/10181,1/6/2020 5:58:40 AM,Overall,2088,2097,2010,2010,8205,2856,4316,2631,3157,12960
59,Myanmar,2018,MM-18/DDA-3415/SA1/P/INGO/9757,1/9/2020 5:49:26 AM,Host Communities,6068,6062,4726,4724,21580,10124,12302,4439,5247,32112
59,Myanmar,2018,MM-18/DDA-3415/SA1/P/INGO/9757,1/9/2020 5:49:26 AM,Internally Displaced People,2600,2598,2025,2025,9248,752,1224,630,697,3303
59,Myanmar,2018,MM-18/DDA-3415/SA1/P/INGO/9757,1/9/2020 5:49:26 AM,Overall,8668,8660,6751,6749,30828,10876,13526,5069,5944,35415
59,Myanmar,2018,MM-18/DDA-3415/SA1/SNFI/INGO/9642,10/18/2019 9:12:01 AM,Internally Displaced People,305,305,352,528,1490,407,493,358,401,1659
59,Myanmar,2018,MM-18/DDA-3415/SA1/SNFI/INGO/9642,10/18/2019 9:12:01 AM,Overall,305,305,352,528,1490,407,493,358,401,1659
59,Myanmar,2018,MM-18/DDA-3415/SA1/SNFI/NGO/9623,4/2/2020 7:46:22 AM,Internally Displaced People,551,651,601,597,2400,671,700,545,542,2458
59,Myanmar,2018,MM-18/DDA-3415/SA1/SNFI/NGO/9623,4/2/2020 7:46:22 AM,Overall,551,651,601,597,2400,671,700,545,542,2458
59,Myanmar,2018,MM-18/DDA-3415/SA1/WASH/INGO/10055,1/6/2020 6:02:17 AM,Host Communities,237,263,343,343,1186,417,463,614,556,2050
59,Myanmar,2018,MM-18/DDA-3415/SA1/WASH/INGO/10055,1/6/2020 6:02:17 AM,Internally Displaced People,2604,2982,4027,3749,13362,2886,3207,4246,3844,14183
59,Myanmar,2018,MM-18/DDA-3415/SA1/WASH/INGO/10055,1/6/2020 6:02:17 AM,Overall,2841,3245,4370,4092,14548,3303,3670,4860,4400,16233
59,Myanmar,2018,MM-18/DDA-3415/SA1/WASH/INGO/10067,10/1/2019 10:22:33 AM,Host Communities,644,710,389,431,2174,174,227,1565,1538,3504
59,Myanmar,2018,MM-18/DDA-3415/SA1/WASH/INGO/10067,10/1/2019 10:22:33 AM,Internally Displaced People,6239,6874,3765,4184,21062,5070,5674,4703,4719,20166
59,Myanmar,2018,MM-18/DDA-3415/SA1/WASH/INGO/10067,10/1/2019 10:22:33 AM,Overall,6883,7584,4154,4615,23236,5244,5901,6268,6257,23670
59,Myanmar,2018,MM-18/DDA-3415/SA1/WASH/INGO/9753,12/19/2019 6:02:37 AM,Other,835,811,607,634,2887,2519,2750,1589,1733,8591
59,Myanmar,2018,MM-18/DDA-3415/SA1/WASH/INGO/9753,12/19/2019 6:02:37 AM,Overall,1757,1916,1198,1326,6197,2519,2750,1589,1733,8591
59,Myanmar,2018,MM-18/DDA-3415/SA2/E/INGO/11217,1/28/2020 9:23:02 AM,Internally Displaced People,133,558,1148,1115,2954,309,754,1159,1109,3331
59,Myanmar,2018,MM-18/DDA-3415/SA2/E/INGO/11217,1/28/2020 9:23:02 AM,Other,9,4,0,0,13,0,0,0,0,0
59,Myanmar,2018,MM-18/DDA-3415/SA2/E/INGO/11217,1/28/2020 9:23:02 AM,Overall,142,562,1148,1115,2967,309,754,1159,1109,3331
59,Myanmar,2018,MM-18/DDA-3415/SA2/E/INGO/11299,12/20/2019 4:51:09 AM,Host Communities,435,162,333,199,1129,0,0,0,0,0
59,Myanmar,2018,MM-18/DDA-3415/SA2/E/INGO/11299,12/20/2019 4:51:09 AM,Internally Displaced People,0,0,4942,3904,8846,435,153,5243,4103,9934
59,Myanmar,2018,MM-18/DDA-3415/SA2/E/INGO/11299,12/20/2019 4:51:09 AM,Overall,435,162,5275,4103,9975,435,153,5243,4103,9934
59,Myanmar,2018,MM-18/DDA-3415/SA2/E-FS-H-N-P-SNFI/INGO/11300,4/27/2020 12:51:28 PM,Host Communities,332,574,618,550,2074,389,526,707,643,2265
59,Myanmar,2018,MM-18/DDA-3415/SA2/E-FS-H-N-P-SNFI/INGO/11300,4/27/2020 12:51:28 PM,Internally Displaced People,792,881,451,409,2533,376,408,385,339,1508
59,Myanmar,2018,MM-18/DDA-3415/SA2/E-FS-H-N-P-SNFI/INGO/11300,4/27/2020 12:51:28 PM,Overall,1124,1455,1069,959,4607,765,934,1092,982,3773
59,Myanmar,2018,MM-18/DDA-3415/SA2/FS-SNFI-N/NGO/11313,1/9/2020 5:50:39 AM,Host Communities,338,411,367,399,1515,226,1288,123,131,1768
59,Myanmar,2018,MM-18/DDA-3415/SA2/FS-SNFI-N/NGO/11313,1/9/2020 5:50:39 AM,Internally Displaced People,2959,3541,3012,3113,12625,4777,6502,3454,3787,18520
59,Myanmar,2018,MM-18/DDA-3415/SA2/FS-SNFI-N/NGO/11313,1/9/2020 5:50:39 AM,Overall,3297,3952,3379,3512,14140,5003,7790,3577,3918,20288
59,Myanmar,2018,MM-18/DDA-3415/SA2/H/INGO/11220,3/13/2020 5:24:11 AM,Internally Displaced People,9000,22000,9300,9300,49600,10485,25301,7293,9540,52619
59,Myanmar,2018,MM-18/DDA-3415/SA2/H/INGO/11220,3/13/2020 5:24:11 AM,Overall,9000,22000,9300,9300,49600,10485,25301,7293,9540,52619
59,Myanmar,2018,MM-18/DDA-3415/SA2/H-N/INGO/11223,4/6/2020 4:43:19 AM,Overall,10876,12431,9967,10342,43616,16881,18823,3683,3393,42780
59,Myanmar,2018,MM-18/DDA-3415/SA2/H-P/UN/11309,3/26/2020 9:13:58 AM,Host Communities,4438,4765,3188,3557,15948,6613,6741,4625,5161,23140
59,Myanmar,2018,MM-18/DDA-3415/SA2/H-P/UN/11309,3/26/2020 9:13:58 AM,Internally Displaced People,10767,11560,7733,8628,38688,10467,10667,7320,8168,36622
59,Myanmar,2018,MM-18/DDA-3415/SA2/H-P/UN/11309,3/26/2020 9:13:58 AM,Overall,15205,16325,10921,12185,54636,17080,17408,11945,13329,59762
59,Myanmar,2018,MM-18/DDA-3415/SA2/N-WASH/INGO/11305,4/20/2020 5:42:48 AM,Other,0,0,0,0,0,170,1944,1466,2496,6076
59,Myanmar,2018,MM-18/DDA-3415/SA2/N-WASH/INGO/11305,4/20/2020 5:42:48 AM,Overall,234,2918,5065,5417,13634,170,1944,1466,2496,6076
59,Myanmar,2018,MM-18/DDA-3415/SA2/P-H/INGO/11236,4/9/2020 4:22:47 AM,Other,5184,6343,3280,4016,18823,7991,9474,3127,3277,23869
59,Myanmar,2018,MM-18/DDA-3415/SA2/P-H/INGO/11236,4/9/2020 4:22:47 AM,Overall,5184,6343,3280,4016,18823,7991,9474,3127,3277,23869
59,Myanmar,2018,MM-18/DDA-3415/SA2/P-N-FS/INGO/11218,6/15/2020 4:19:41 AM,Host Communities,1508,2227,3900,3900,11535,5456,5915,7853,8032,27256
59,Myanmar,2018,MM-18/DDA-3415/SA2/P-N-FS/INGO/11218,6/15/2020 4:19:41 AM,Other,2360,3279,5632,5632,16903,0,0,0,0,0
59,Myanmar,2018,MM-18/DDA-3415/SA2/P-N-FS/INGO/11218,6/15/2020 4:19:41 AM,Overall,3868,5506,9532,9532,28438,5456,5915,7853,8032,27256
59,Myanmar,2018,MM-18/DDA-3415/SA2/P-WASH-FS/INGO/11228,5/28/2020 3:01:53 AM,Host Communities,339,1095,500,705,2639,410,1252,652,874,3188
59,Myanmar,2018,MM-18/DDA-3415/SA2/P-WASH-FS/INGO/11228,5/28/2020 3:01:53 AM,Internally Displaced People,4370,5228,4330,4599,18527,4059,4836,4500,4529,17924
59,Myanmar,2018,MM-18/DDA-3415/SA2/P-WASH-FS/INGO/11228,5/28/2020 3:01:53 AM,Overall,4719,6349,5330,5588,21986,4469,6088,5152,5403,21112
59,Myanmar,2018,MM-18/DDA-3415/SA2/SNFI/INGO/11254,10/2/2019 12:45:10 PM,Internally Displaced People,383,467,468,450,1768,512,572,670,649,2403
59,Myanmar,2018,MM-18/DDA-3415/SA2/SNFI/INGO/11254,10/2/2019 12:45:10 PM,Overall,383,467,468,450,1768,512,572,670,649,2403
59,Myanmar,2018,MM-18/DDA-3415/SA2/SNFI-FS/NGO/11208,4/13/2020 5:18:08 AM,Internally Displaced People,0,0,0,0,0,358,374,265,234,1231
59,Myanmar,2018,MM-18/DDA-3415/SA2/SNFI-FS/NGO/11208,4/13/2020 5:18:08 AM,Overall,253,348,306,356,1263,358,374,265,234,1231
59,Myanmar,2018,MM-18/DDA-3415/SA2/SNFI-WASH/NGO/11249,2/3/2020 12:33:16 PM,Internally Displaced People,814,867,443,469,2593,674,732,640,602,2648
59,Myanmar,2018,MM-18/DDA-3415/SA2/SNFI-WASH/NGO/11249,2/3/2020 12:33:16 PM,Overall,814,867,443,469,2593,674,732,640,602,2648
59,Myanmar,2018,MM-18/DDA-3415/SA2/WASH/INGO/11306,10/11/2019 4:09:33 AM,Internally Displaced People,2678,3457,3901,3529,13565,2668,3447,4015,3642,13772
59,Myanmar,2018,MM-18/DDA-3415/SA2/WASH/INGO/11306,10/11/2019 4:09:33 AM,Overall,2678,3457,3901,3529,13565,2668,3447,4015,3642,13772
59,Myanmar,2018,MM-18/DDA-3415/SA2/WASH-SNFI-FS/INGO/11323,7/6/2020 8:44:20 AM,Internally Displaced People,3723,4603,3708,3738,15772,4197,4729,4624,4497,18047
59,Myanmar,2018,MM-18/DDA-3415/SA2/WASH-SNFI-FS/INGO/11323,7/6/2020 8:44:20 AM,Overall,3723,4603,3708,3738,15772,4197,4729,4624,4497,18047
59,Myanmar,2019,MM-19/DDA-3415/RA1/E-WASH-P-SNFI-N/INGO/13141,7/22/2020 3:08:07 AM,Internally Displaced People,3074,3952,5376,4846,17248,5108,7615,11047,10470,34240
59,Myanmar,2019,MM-19/DDA-3415/RA1/E-WASH-P-SNFI-N/INGO/13141,7/22/2020 3:08:07 AM,Overall,3074,3952,5376,4846,17248,5108,7615,11047,10470,34240
59,Myanmar,2019,MM-19/DDA-3415/RA1/H/INGO/13149,3/13/2020 5:25:06 AM,Internally Displaced People,5000,6000,874,1111,12985,3167,3439,700,653,7959
59,Myanmar,2019,MM-19/DDA-3415/RA1/H/INGO/13149,3/13/2020 5:25:06 AM,Overall,5000,6000,874,1111,12985,3167,3439,700,653,7959
59,Myanmar,2019,MM-19/DDA-3415/RA1/P-E-WASH/INGO/13229,3/13/2020 5:26:13 AM,Host Communities,535,613,1350,1330,3828,573,600,182,183,1538
59,Myanmar,2019,MM-19/DDA-3415/RA1/P-E-WASH/INGO/13229,3/13/2020 5:26:13 AM,Internally Displaced People,4864,5569,3970,6247,20650,4041,6010,2031,2191,14273
59,Myanmar,2019,MM-19/DDA-3415/RA1/P-E-WASH/INGO/13229,3/13/2020 5:26:13 AM,Overall,5399,6182,5320,7577,24478,4614,6610,2213,2374,15811
59,Myanmar,2019,MM-19/DDA-3415/SA1/CCCM-P-SNFI-WASH/NGO/13490,12/4/2020 8:39:07 AM,Host Communities,731,693,315,355,2094,7,3,0,0,10
59,Myanmar,2019,MM-19/DDA-3415/SA1/CCCM-P-SNFI-WASH/NGO/13490,12/4/2020 8:39:07 AM,Internally Displaced People,3133,3516,3180,3251,13080,4917,6167,3980,4241,19305
59,Myanmar,2019,MM-19/DDA-3415/SA1/CCCM-P-SNFI-WASH/NGO/13490,12/4/2020 8:39:07 AM,Overall,3864,4209,3495,3606,15174,4924,6170,3980,4241,19315
59,Myanmar,2019,MM-19/DDA-3415/SA1/E-FS-H-N-P-SNFI-WASH/INGO/13729,3/18/2021 5:27:27 AM,Internally Displaced People,3721,3833,2136,2423,12113,3079,3293,2124,2327,10823
59,Myanmar,2019,MM-19/DDA-3415/SA1/E-FS-H-N-P-SNFI-WASH/INGO/13729,3/18/2021 5:27:27 AM,Overall,3721,3833,2136,2423,12113,3079,3293,2124,2327,10823
59,Myanmar,2019,MM-19/DDA-3415/SA1/E-FS-H-WASH-P/INGO/13682,8/5/2021 4:12:10 PM,Host Communities,664,911,872,856,3303,578,679,653,603,2513
59,Myanmar,2019,MM-19/DDA-3415/SA1/E-FS-H-WASH-P/INGO/13682,8/5/2021 4:12:10 PM,Internally Displaced People,1510,1818,1353,1319,6000,3026,3885,3681,3710,14302
59,Myanmar,2019,MM-19/DDA-3415/SA1/E-FS-H-WASH-P/INGO/13682,8/5/2021 4:12:10 PM,Overall,2174,2729,2225,2175,9303,3604,4564,4334,4313,16815
59,Myanmar,2019,MM-19/DDA-3415/SA1/E-FS-SNFI/NGO/13564,12/16/2020 7:20:20 AM,Internally Displaced People,1577,2043,5354,5625,14599,6657,4573,13075,12254,36559
59,Myanmar,2019,MM-19/DDA-3415/SA1/E-FS-SNFI/NGO/13564,12/16/2020 7:20:20 AM,Overall,1577,2043,5354,5625,14599,6657,4573,13075,12254,36559
59,Myanmar,2019,MM-19/DDA-3415/SA1/E-P-WASH/INGO/13607,12/15/2020 7:05:58 AM,Host Communities,493,494,202,244,1433,723,987,161,214,2085
59,Myanmar,2019,MM-19/DDA-3415/SA1/E-P-WASH/INGO/13607,12/15/2020 7:05:58 AM,Internally Displaced People,615,985,1445,1328,4373,1505,1028,1330,1414,5277
59,Myanmar,2019,MM-19/DDA-3415/SA1/E-P-WASH/INGO/13607,12/15/2020 7:05:58 AM,Other,45,85,0,0,130,61,132,0,0,193
59,Myanmar,2019,MM-19/DDA-3415/SA1/E-P-WASH/INGO/13607,12/15/2020 7:05:58 AM,Overall,1646,2058,1733,1676,7113,3549,3672,1834,1977,11032
59,Myanmar,2019,MM-19/DDA-3415/SA1/E-P-WASH/INGO/13607,12/15/2020 7:05:58 AM,Returnees,493,494,86,104,1177,1260,1525,343,349,3477
59,Myanmar,2019,MM-19/DDA-3415/SA1/FS/INGO/13672,2/9/2021 3:18:56 AM,Internally Displaced People,323,290,215,248,1076,277,376,200,193,1046
59,Myanmar,2019,MM-19/DDA-3415/SA1/FS/INGO/13672,2/9/2021 3:18:56 AM,Other,2881,2592,1920,2209,9602,3396,3851,3471,3647,14365
59,Myanmar,2019,MM-19/DDA-3415/SA1/FS/INGO/13672,2/9/2021 3:18:56 AM,Overall,3204,2882,2135,2457,10678,3673,4227,3671,3840,15411
59,Myanmar,2019,MM-19/DDA-3415/SA1/FS/INGO/13678,10/22/2020 10:38:21 AM,Host Communities,636,724,1249,1421,4030,2968,2982,2081,2195,10226
59,Myanmar,2019,MM-19/DDA-3415/SA1/FS/INGO/13678,10/22/2020 10:38:21 AM,Other,617,703,1212,1379,3911,361,399,299,324,1383
59,Myanmar,2019,MM-19/DDA-3415/SA1/FS/INGO/13678,10/22/2020 10:38:21 AM,Overall,1253,1427,2461,2800,7941,3329,3381,2380,2519,11609
59,Myanmar,2019,MM-19/DDA-3415/SA1/FS/NGO/13679,11/3/2020 9:41:21 AM,Internally Displaced People,1747,2128,1391,1354,6620,1778,2268,1557,1565,7168
59,Myanmar,2019,MM-19/DDA-3415/SA1/FS/NGO/13679,11/3/2020 9:41:21 AM,Overall,1747,2128,1391,1354,6620,1778,2268,1557,1565,7168
59,Myanmar,2019,MM-19/DDA-3415/SA1/H/INGO/13505,12/4/2020 11:36:08 AM,Host Communities,2800,7900,2150,3150,16000,3966,21527,8658,7467,41618
59,Myanmar,2019,MM-19/DDA-3415/SA1/H/INGO/13505,12/4/2020 11:36:08 AM,Overall,2800,7900,2150,3150,16000,3966,21527,8658,7467,41618
59,Myanmar,2019,MM-19/DDA-3415/SA1/H/INGO/13724,4/29/2021 1:47:46 PM,Host Communities,1490,1780,758,711,4739,1902,2472,968,886,6228
59,Myanmar,2019,MM-19/DDA-3415/SA1/H/INGO/13724,4/29/2021 1:47:46 PM,Internally Displaced People,595,721,306,286,1908,730,949,372,340,2391
59,Myanmar,2019,MM-19/DDA-3415/SA1/H/INGO/13724,4/29/2021 1:47:46 PM,Overall,2085,2501,1064,997,6647,2632,3421,1340,1226,8619
59,Myanmar,2019,MM-19/DDA-3415/SA1/H/UN/13704,11/27/2020 2:00:11 AM,Host Communities,16694,18615,5930,6240,47479,8950,11217,3441,3351,26959
59,Myanmar,2019,MM-19/DDA-3415/SA1/H/UN/13704,11/27/2020 2:00:11 AM,Overall,16694,18615,5930,6240,47479,8950,11217,3441,3351,26959
59,Myanmar,2019,MM-19/DDA-3415/SA1/H-N/INGO/13725,1/21/2021 3:39:36 AM,Host Communities,6958,7996,4638,5330,24922,1598,4303,1274,2209,9384
59,Myanmar,2019,MM-19/DDA-3415/SA1/H-N/INGO/13725,1/21/2021 3:39:36 AM,Internally Displaced People,714,837,473,554,2578,216,582,172,299,1269
59,Myanmar,2019,MM-19/DDA-3415/SA1/H-N/INGO/13725,1/21/2021 3:39:36 AM,Overall,7672,8833,5111,5884,27500,1814,4885,1446,2508,10653
59,Myanmar,2019,MM-19/DDA-3415/SA1/H-N/NGO/13667,2/9/2021 3:07:47 AM,Internally Displaced People,12121,13427,10011,10697,46256,9487,10901,8556,9098,38042
59,Myanmar,2019,MM-19/DDA-3415/SA1/H-N/NGO/13667,2/9/2021 3:07:47 AM,Overall,12121,13427,10011,10697,46256,9487,10901,8556,9098,38042
59,Myanmar,2019,MM-19/DDA-3415/SA1/H-P/INGO/13705,3/10/2021 9:12:01 AM,Internally Displaced People,800,1200,800,1200,4000,1057,2411,799,875,5142
59,Myanmar,2019,MM-19/DDA-3415/SA1/H-P/INGO/13705,3/10/2021 9:12:01 AM,Other,40,60,0,0,100,40,49,0,0,89
59,Myanmar,2019,MM-19/DDA-3415/SA1/H-P/INGO/13705,3/10/2021 9:12:01 AM,Overall,840,1260,800,1200,4100,1097,2460,799,875,5231
59,Myanmar,2019,MM-19/DDA-3415/SA1/H-P/UN/13593,12/4/2020 3:40:15 AM,Host Communities,3730,3802,2609,2911,13052,3730,3802,2609,2911,13052
59,Myanmar,2019,MM-19/DDA-3415/SA1/H-P/UN/13593,12/4/2020 3:40:15 AM,Internally Displaced People,10119,10313,7076,7896,35404,10188,10408,7107,7936,35639
59,Myanmar,2019,MM-19/DDA-3415/SA1/H-P/UN/13593,12/4/2020 3:40:15 AM,Overall,13849,14115,9685,10807,48456,13918,14210,9716,10847,48691
59,Myanmar,2019,MM-19/DDA-3415/SA1/P/INGO/13413,12/11/2020 5:28:41 AM,Host Communities,8600,9300,5725,6357,29982,16499,19703,15820,16689,68711
59,Myanmar,2019,MM-19/DDA-3415/SA1/P/INGO/13413,12/11/2020 5:28:41 AM,Internally Displaced People,950,950,450,450,2800,1393,1602,1431,1479,5905
59,Myanmar,2019,MM-19/DDA-3415/SA1/P/INGO/13413,12/11/2020 5:28:41 AM,Overall,9550,10250,6175,6807,32782,17892,21305,17251,18168,74616
59,Myanmar,2019,MM-19/DDA-3415/SA1/P/INGO/13677,1/21/2021 10:47:33 AM,Host Communities,1050,1764,648,674,4136,2025,2311,1091,960,6387
59,Myanmar,2019,MM-19/DDA-3415/SA1/P/INGO/13677,1/21/2021 10:47:33 AM,Internally Displaced People,2579,4148,1530,1589,9846,1760,1886,1571,1534,6751
59,Myanmar,2019,MM-19/DDA-3415/SA1/P/INGO/13677,1/21/2021 10:47:33 AM,Other,50,50,0,0,100,27,48,0,0,75
59,Myanmar,2019,MM-19/DDA-3415/SA1/P/INGO/13677,1/21/2021 10:47:33 AM,Overall,3679,5962,2178,2263,14082,3812,4245,2662,2494,13213
59,Myanmar,2019,MM-19/DDA-3415/SA1/P-H-N/INGO/13424,11/26/2020 5:48:03 AM,Host Communities,3622,4641,4963,5832,19058,4508,5603,4605,5452,20168
59,Myanmar,2019,MM-19/DDA-3415/SA1/P-H-N/INGO/13424,11/26/2020 5:48:03 AM,Internally Displaced People,7782,9199,7116,6653,30750,1731,2141,1677,1704,7253
59,Myanmar,2019,MM-19/DDA-3415/SA1/P-H-N/INGO/13424,11/26/2020 5:48:03 AM,Overall,11404,13840,12079,12485,49808,6239,7744,6282,7156,27421
59,Myanmar,2019,MM-19/DDA-3415/SA1/SNFI/INGO/13603,8/7/2020 6:37:03 AM,Internally Displaced People,315,368,438,409,1530,326,385,360,331,1402
59,Myanmar,2019,MM-19/DDA-3415/SA1/SNFI/INGO/13603,8/7/2020 6:37:03 AM,Overall,315,368,438,409,1530,326,385,360,331,1402
59,Myanmar,2019,MM-19/DDA-3415/SA1/SNFI/INGO/13717,12/16/2020 2:36:07 AM,Internally Displaced People,675,675,800,1200,3350,902,1057,612,627,3198
59,Myanmar,2019,MM-19/DDA-3415/SA1/SNFI/INGO/13717,12/16/2020 2:36:07 AM,Overall,675,675,800,1200,3350,902,1057,612,627,3198
59,Myanmar,2019,MM-19/DDA-3415/SA1/SNFI-WASH-E-CCCM/NGO/13703,3/15/2021 9:42:58 AM,Internally Displaced People,2405,2598,1981,2086,9070,2600,2847,2697,2714,10858
59,Myanmar,2019,MM-19/DDA-3415/SA1/SNFI-WASH-E-CCCM/NGO/13703,3/15/2021 9:42:58 AM,Overall,2405,2598,1981,2086,9070,2600,2847,2697,2714,10858
59,Myanmar,2019,MM-19/DDA-3415/SA2/CCCM/NGO/14858,4/7/2021 3:36:19 AM,Internally Displaced People,2149,2297,1896,1803,8145,2198,2360,1823,1768,8149
59,Myanmar,2019,MM-19/DDA-3415/SA2/CCCM/NGO/14858,4/7/2021 3:36:19 AM,Overall,2149,2297,1896,1803,8145,2198,2360,1823,1768,8149
59,Myanmar,2019,MM-19/DDA-3415/SA2/CCCM-N-P-WASH/INGO/14840,5/26/2021 12:47:32 AM,Host Communities,4098,4549,1238,1238,11123,3826,3833,5416,5379,18454
59,Myanmar,2019,MM-19/DDA-3415/SA2/CCCM-N-P-WASH/INGO/14840,5/26/2021 12:47:32 AM,Internally Displaced People,6946,8749,1633,1816,19144,9268,11437,169,154,21028
59,Myanmar,2019,MM-19/DDA-3415/SA2/CCCM-N-P-WASH/INGO/14840,5/26/2021 12:47:32 AM,Overall,11044,13298,2871,3054,30267,13094,15270,5585,5533,39482
59,Myanmar,2019,MM-19/DDA-3415/SA2/E-P-FS/INGO/14859,3/3/2021 10:30:32 AM,Internally Displaced People,2785,3705,1060,1665,9215,3423,5066,1368,1351,11208
59,Myanmar,2019,MM-19/DDA-3415/SA2/E-P-FS/INGO/14859,3/3/2021 10:30:32 AM,Other,12,18,0,0,30,11,17,0,0,28
59,Myanmar,2019,MM-19/DDA-3415/SA2/E-P-FS/INGO/14859,3/3/2021 10:30:32 AM,Overall,2815,3763,1087,1693,9358,3434,5083,1368,1351,11236
59,Myanmar,2019,MM-19/DDA-3415/SA2/E-P-FS/INGO/14859,3/3/2021 10:30:32 AM,Returnees,18,40,27,28,113,0,0,0,0,0
59,Myanmar,2019,MM-19/DDA-3415/SA2/E-P-WASH/NGO/14829,6/2/2021 4:04:49 AM,Host Communities,72,116,1226,1148,2562,34,56,740,722,1552
59,Myanmar,2019,MM-19/DDA-3415/SA2/E-P-WASH/NGO/14829,6/2/2021 4:04:49 AM,Internally Displaced People,416,416,1426,1340,3598,557,624,722,678,2581
59,Myanmar,2019,MM-19/DDA-3415/SA2/E-P-WASH/NGO/14829,6/2/2021 4:04:49 AM,Overall,488,532,2652,2488,6160,591,680,1462,1400,4133
59,Myanmar,2019,MM-19/DDA-3415/SA2/FS-WASH-SNFI-E/NGO/14857,6/21/2021 3:24:07 AM,Internally Displaced People,4255,5289,8604,9133,27281,4837,5689,7397,7288,25211
59,Myanmar,2019,MM-19/DDA-3415/SA2/FS-WASH-SNFI-E/NGO/14857,6/21/2021 3:24:07 AM,Overall,4255,5289,8604,9133,27281,4837,5689,7397,7288,25211
59,Myanmar,2019,MM-19/DDA-3415/SA2/H/INGO/14803,4/6/2021 3:17:20 AM,Internally Displaced People,11005,11733,2540,2522,27800,6776,14951,3896,4798,30421
59,Myanmar,2019,MM-19/DDA-3415/SA2/H/INGO/14803,4/6/2021 3:17:20 AM,Overall,11005,11733,2540,2522,27800,6776,14951,3896,4798,30421
59,Myanmar,2019,MM-19/DDA-3415/SA2/H-FS/INGO/14894,10/11/2021 9:22:18 AM,Internally Displaced People,281,960,202,203,1646,140,1212,123,110,1585
59,Myanmar,2019,MM-19/DDA-3415/SA2/H-FS/INGO/14894,10/11/2021 9:22:18 AM,Other,820,1615,207,209,2851,1158,1078,127,150,2513
59,Myanmar,2019,MM-19/DDA-3415/SA2/H-FS/INGO/14894,10/11/2021 9:22:18 AM,Overall,1101,2575,409,412,4497,1298,2290,250,260,4098
59,Myanmar,2019,MM-19/DDA-3415/SA2/H-N/INGO/14879,6/4/2021 10:20:04 AM,Internally Displaced People,10404,20447,9482,9809,50142,8602,19741,8509,9293,46145
59,Myanmar,2019,MM-19/DDA-3415/SA2/H-N/INGO/14879,6/4/2021 10:20:04 AM,Overall,10404,20447,9482,9809,50142,8602,19741,8509,9293,46145
59,Myanmar,2019,MM-19/DDA-3415/SA2/N/INGO/14825,11/10/2021 5:02:57 AM,Host Communities,69,382,0,0,451,0,0,0,0,0
59,Myanmar,2019,MM-19/DDA-3415/SA2/N/INGO/14825,11/10/2021 5:02:57 AM,Internally Displaced People,166,1107,399,576,2248,1048,1302,951,942,4243
59,Myanmar,2019,MM-19/DDA-3415/SA2/N/INGO/14825,11/10/2021 5:02:57 AM,Overall,235,1489,399,576,2699,1048,1302,951,942,4243
59,Myanmar,2019,MM-19/DDA-3415/SA2/P/INGO/14860,8/27/2021 4:10:58 AM,Internally Displaced People,225,225,850,855,2155,291,669,865,987,2812
59,Myanmar,2019,MM-19/DDA-3415/SA2/P/INGO/14860,8/27/2021 4:10:58 AM,Overall,225,225,850,855,2155,291,669,865,987,2812
59,Myanmar,2019,MM-19/DDA-3415/SA2/P/INGO/14886,4/13/2021 3:26:41 AM,Host Communities,2980,2938,2856,2836,11610,2087,2415,694,1045,6241
59,Myanmar,2019,MM-19/DDA-3415/SA2/P/INGO/14886,4/13/2021 3:26:41 AM,Internally Displaced People,425,420,460,455,1760,259,602,267,240,1368
59,Myanmar,2019,MM-19/DDA-3415/SA2/P/INGO/14886,4/13/2021 3:26:41 AM,Overall,3405,3358,3316,3291,13370,2346,3017,961,1285,7609
59,Myanmar,2019,MM-19/DDA-3415/SA2/P/INGO/14887,8/23/2021 11:29:30 AM,Host Communities,110,160,0,0,270,223,244,0,0,467
59,Myanmar,2019,MM-19/DDA-3415/SA2/P/INGO/14887,8/23/2021 11:29:30 AM,Internally Displaced People,210,310,0,0,520,145,348,0,0,493
59,Myanmar,2019,MM-19/DDA-3415/SA2/P/INGO/14887,8/23/2021 11:29:30 AM,Overall,320,470,0,0,790,368,592,0,0,960
59,Myanmar,2019,MM-19/DDA-3415/SA2/P-H/INGO/14813,5/25/2021 1:25:19 AM,Other,3622,5780,1663,2161,13226,6615,7072,3527,3899,21113
59,Myanmar,2019,MM-19/DDA-3415/SA2/P-H/INGO/14813,5/25/2021 1:25:19 AM,Overall,3622,5780,1663,2161,13226,6615,7072,3527,3899,21113
59,Myanmar,2019,MM-19/DDA-3415/SA2/SNFI/INGO/14720,3/3/2021 4:33:48 AM,Internally Displaced People,438,504,644,578,2164,291,356,456,395,1498
59,Myanmar,2019,MM-19/DDA-3415/SA2/SNFI/INGO/14720,3/3/2021 4:33:48 AM,Overall,438,504,644,578,2164,291,356,456,395,1498
59,Myanmar,2019,MM-19/DDA-3415/SA2/SNFI/INGO/14891,3/12/2021 3:28:12 AM,Internally Displaced People,329,354,266,234,1183,245,284,149,158,836
59,Myanmar,2019,MM-19/DDA-3415/SA2/SNFI/INGO/14891,3/12/2021 3:28:12 AM,Overall,329,354,266,234,1183,245,284,149,158,836
59,Myanmar,2019,MM-19/DDA-3415/SA2/WASH-FS/INGO/14892,10/28/2021 9:48:50 AM,Host Communities,69,69,39,76,253,110,109,42,42,303
59,Myanmar,2019,MM-19/DDA-3415/SA2/WASH-FS/INGO/14892,10/28/2021 9:48:50 AM,Internally Displaced People,7413,7804,5854,6599,27670,7413,7804,5854,6599,27670
59,Myanmar,2019,MM-19/DDA-3415/SA2/WASH-FS/INGO/14892,10/28/2021 9:48:50 AM,Other,13,22,11,24,70,38,35,12,18,103
59,Myanmar,2019,MM-19/DDA-3415/SA2/WASH-FS/INGO/14892,10/28/2021 9:48:50 AM,Overall,7495,7895,5904,6699,27993,7561,7948,5908,6659,28076
59,Myanmar,2020,MM-20/DDA-3415/RA1/COVID-19/INGO/15754,5/10/2021 12:05:14 PM,Internally Displaced People,3500,7000,3150,3150,16800,7129,17142,5756,6103,36130
59,Myanmar,2020,MM-20/DDA-3415/RA1/COVID-19/INGO/15754,5/10/2021 12:05:14 PM,Overall,3500,7000,3150,3150,16800,7129,17142,5756,6103,36130
59,Myanmar,2020,MM-20/DDA-3415/RA1/COVID-19/INGO/15764,4/9/2021 6:13:05 AM,Host Communities,9650,10061,8729,8787,37227,12598,13598,15229,15676,57101
59,Myanmar,2020,MM-20/DDA-3415/RA1/COVID-19/INGO/15764,4/9/2021 6:13:05 AM,Internally Displaced People,639,670,576,557,2442,786,861,948,929,3524
59,Myanmar,2020,MM-20/DDA-3415/RA1/COVID-19/INGO/15764,4/9/2021 6:13:05 AM,Overall,10289,10731,9305,9344,39669,13384,14459,16177,16605,60625
59,Myanmar,2020,MM-20/DDA-3415/RA1/COVID-19/INGO/15799,3/16/2021 4:35:31 AM,Internally Displaced People,6657,6985,4061,4182,21885,7457,11002,5334,5599,29392
59,Myanmar,2020,MM-20/DDA-3415/RA1/COVID-19/INGO/15799,3/16/2021 4:35:31 AM,Other,21605,24342,15586,15776,77309,5135,6693,2827,3703,18358
59,Myanmar,2020,MM-20/DDA-3415/RA1/COVID-19/INGO/15799,3/16/2021 4:35:31 AM,Overall,28262,31327,19647,19958,99194,12592,17695,8161,9302,47750
59,Myanmar,2020,MM-20/DDA-3415/RA1/COVID-19/INGO/15919,3/18/2021 7:24:00 AM,Host Communities,9558,9596,17751,17820,54725,12663,8162,5797,3814,30436
59,Myanmar,2020,MM-20/DDA-3415/RA1/COVID-19/INGO/15919,3/18/2021 7:24:00 AM,Other,1137,1133,612,610,3492,264,170,121,80,635
59,Myanmar,2020,MM-20/DDA-3415/RA1/COVID-19/INGO/15919,3/18/2021 7:24:00 AM,Overall,10695,10729,18363,18430,58217,12927,8332,5918,3894,31071
59,Myanmar,2020,MM-20/DDA-3415/RA1/COVID-19/INGO/15982,5/12/2021 11:25:23 AM,Overall,29250,15750,1320,880,47200,17390,9761,0,0,27151
59,Myanmar,2020,MM-20/DDA-3415/RA1/COVID-19/INGO/15982,5/12/2021 11:25:23 AM,Returnees,29250,15750,1320,880,47200,17390,9761,0,0,27151
59,Myanmar,2020,MM-20/DDA-3415/RA1/COVID-19/NGO/15772,3/18/2021 7:25:45 AM,Host Communities,1512,1685,1528,1570,6295,822,1199,430,486,2937
59,Myanmar,2020,MM-20/DDA-3415/RA1/COVID-19/NGO/15772,3/18/2021 7:25:45 AM,Internally Displaced People,7121,8013,7139,7337,29610,17509,19777,13686,13437,64409
59,Myanmar,2020,MM-20/DDA-3415/RA1/COVID-19/NGO/15772,3/18/2021 7:25:45 AM,Overall,8633,9698,8667,8907,35905,18331,20976,14116,13923,67346
59,Myanmar,2020,MM-20/DDA-3415/RA1/COVID-19/NGO/15827,7/2/2021 7:53:42 AM,Internally Displaced People,2801,3238,234,225,6498,2219,2678,1772,1745,8414
59,Myanmar,2020,MM-20/DDA-3415/RA1/COVID-19/NGO/15827,7/2/2021 7:53:42 AM,Overall,2801,3238,234,225,6498,2219,2678,1772,1745,8414
59,Myanmar,2020,MM-20/DDA-3415/RA1/COVID-19/NGO/15956,10/14/2020 8:21:10 AM,Host Communities,8915,9732,10320,11385,40352,13340,12808,8248,8073,42469
59,Myanmar,2020,MM-20/DDA-3415/RA1/COVID-19/NGO/15956,10/14/2020 8:21:10 AM,Internally Displaced People,533,581,616,680,2410,809,1099,268,300,2476
59,Myanmar,2020,MM-20/DDA-3415/RA1/COVID-19/NGO/15956,10/14/2020 8:21:10 AM,Overall,9448,10313,10936,12065,42762,14149,13907,8516,8373,44945
59,Myanmar,2020,MM-20/DDA-3415/RA1/COVID-19/UN/15766,3/8/2021 7:19:42 AM,Internally Displaced People,44908,72623,24148,31482,173161,71625,80547,21057,21486,194715
59,Myanmar,2020,MM-20/DDA-3415/RA1/COVID-19/UN/15766,3/8/2021 7:19:42 AM,Other,6514,7853,2822,2755,19944,10484,13684,1709,1737,27614
59,Myanmar,2020,MM-20/DDA-3415/RA1/COVID-19/UN/15766,3/8/2021 7:19:42 AM,Overall,54468,82975,28476,35786,201705,90000,103670,23435,23906,241011
59,Myanmar,2020,MM-20/DDA-3415/RA1/COVID-19/UN/15766,3/8/2021 7:19:42 AM,Returnees,3046,2499,1506,1549,8600,7891,9439,669,683,18682
59,Myanmar,2020,MM-20/DDA-3415/RA1/COVID-19/UN/15936,5/12/2021 11:31:14 AM,Host Communities,37000,43100,19000,21900,121000,47941,55435,22473,23969,149818
59,Myanmar,2020,MM-20/DDA-3415/RA1/COVID-19/UN/15936,5/12/2021 11:31:14 AM,Internally Displaced People,15000,18900,7000,9100,50000,21818,25227,10227,10910,68182
59,Myanmar,2020,MM-20/DDA-3415/RA1/COVID-19/UN/15936,5/12/2021 11:31:14 AM,Overall,52000,62000,26000,31000,171000,69759,80662,32700,34879,218000
59,Myanmar,2020,MM-20/DDA-3415/SA1/CCCM-SNFI-WASH/NGO/16803,1/25/2022 9:26:18 AM,Internally Displaced People,2540,2817,2245,2179,9781,2651,2914,2188,2103,9856
59,Myanmar,2020,MM-20/DDA-3415/SA1/CCCM-SNFI-WASH/NGO/16803,1/25/2022 9:26:18 AM,Overall,2540,2817,2245,2179,9781,2651,2914,2188,2103,9856
59,Myanmar,2020,MM-20/DDA-3415/SA1/E-FS/INGO/16807,1/21/2022 10:27:19 AM,Host Communities,0,0,6376,6377,12753,11,21,4390,4548,8970
59,Myanmar,2020,MM-20/DDA-3415/SA1/E-FS/INGO/16807,1/21/2022 10:27:19 AM,Internally Displaced People,1399,1399,1399,1400,5597,857,2170,1060,1039,5126
59,Myanmar,2020,MM-20/DDA-3415/SA1/E-FS/INGO/16807,1/21/2022 10:27:19 AM,Overall,1970,1970,8346,8349,20635,1984,3827,7793,8092,21696
59,Myanmar,2020,MM-20/DDA-3415/SA1/E-FS/INGO/16807,1/21/2022 10:27:19 AM,Returnees,571,571,571,572,2285,1116,1636,2343,2505,7600
59,Myanmar,2020,MM-20/DDA-3415/SA1/E-H-P/NGO/16972,2/4/2022 9:44:49 AM,Host Communities,0,0,490,528,1018,24,27,1232,1568,2851
59,Myanmar,2020,MM-20/DDA-3415/SA1/E-H-P/NGO/16972,2/4/2022 9:44:49 AM,Internally Displaced People,1827,1973,2091,2336,8227,2091,2266,4555,4968,13880
59,Myanmar,2020,MM-20/DDA-3415/SA1/E-H-P/NGO/16972,2/4/2022 9:44:49 AM,Overall,1827,1973,2581,2864,9245,2115,2293,5787,6536,16731
59,Myanmar,2020,MM-20/DDA-3415/SA1/FS/NGO/16801,2/14/2022 7:20:54 PM,Host Communities,1259,1374,1457,1607,5697,1730,2046,1653,1850,7279
59,Myanmar,2020,MM-20/DDA-3415/SA1/FS/NGO/16801,2/14/2022 7:20:54 PM,Overall,1259,1374,1457,1607,5697,1730,2046,1653,1850,7279
59,Myanmar,2020,MM-20/DDA-3415/SA1/H-P/INGO/16767,6/6/2022 11:02:28 AM,Host Communities,1388,37132,1083,20453,60056,111,35753,110,19487,55461
59,Myanmar,2020,MM-20/DDA-3415/SA1/H-P/INGO/16767,6/6/2022 11:02:28 AM,Internally Displaced People,4832,6722,7289,5816,24659,3280,6056,3306,4922,17564
59,Myanmar,2020,MM-20/DDA-3415/SA1/H-P/INGO/16767,6/6/2022 11:02:28 AM,Overall,6220,43854,8372,26269,84715,3391,41809,3416,24409,73025
59,Myanmar,2020,MM-20/DDA-3415/SA1/H-P/UN/16987,12/23/2021 7:22:48 AM,Host Communities,787,667,827,663,2944,787,667,827,663,2944
59,Myanmar,2020,MM-20/DDA-3415/SA1/H-P/UN/16987,12/23/2021 7:22:48 AM,Internally Displaced People,4574,5016,3743,3738,17071,3936,4279,3366,3364,14945
59,Myanmar,2020,MM-20/DDA-3415/SA1/H-P/UN/16987,12/23/2021 7:22:48 AM,Overall,5361,5683,4570,4401,20015,4723,4946,4193,4027,17889
59,Myanmar,2020,MM-20/DDA-3415/SA1/H-P-E/INGO/16940,2/28/2022 3:54:53 AM,Host Communities,6910,7889,4418,5258,24475,4971,12949,2071,2496,22487
59,Myanmar,2020,MM-20/DDA-3415/SA1/H-P-E/INGO/16940,2/28/2022 3:54:53 AM,Internally Displaced People,639,854,407,555,2455,602,854,307,505,2268
59,Myanmar,2020,MM-20/DDA-3415/SA1/H-P-E/INGO/16940,2/28/2022 3:54:53 AM,Other,0,0,40,50,90,0,0,62,48,110
59,Myanmar,2020,MM-20/DDA-3415/SA1/H-P-E/INGO/16940,2/28/2022 3:54:53 AM,Overall,7549,8743,4865,5863,27020,5573,13803,2440,3049,24865
59,Myanmar,2020,MM-20/DDA-3415/SA1/H-P-WASH/INGO/16799,6/3/2022 2:56:05 AM,Host Communities,4779,5634,4546,4880,19839,1383,1826,1617,1748,6574
59,Myanmar,2020,MM-20/DDA-3415/SA1/H-P-WASH/INGO/16799,6/3/2022 2:56:05 AM,Internally Displaced People,7372,22011,7157,21772,58312,4108,6478,3676,4992,19254
59,Myanmar,2020,MM-20/DDA-3415/SA1/H-P-WASH/INGO/16799,6/3/2022 2:56:05 AM,Overall,12151,27645,11703,26652,78151,5491,8304,5293,6740,25828
59,Myanmar,2020,MM-20/DDA-3415/SA1/P/INGO/16828,2/11/2022 12:02:59 PM,Internally Displaced People,310,625,33,513,1481,368,1322,0,0,1690
59,Myanmar,2020,MM-20/DDA-3415/SA1/P/INGO/16828,2/11/2022 12:02:59 PM,Overall,310,625,33,513,1481,368,1322,0,0,1690
59,Myanmar,2020,MM-20/DDA-3415/SA1/P-H-COVID-19/INGO/16806,11/8/2021 5:54:38 AM,Host Communities,127,256,100,117,600,83,366,139,162,750
59,Myanmar,2020,MM-20/DDA-3415/SA1/P-H-COVID-19/INGO/16806,11/8/2021 5:54:38 AM,Internally Displaced People,87,501,227,271,1086,148,817,256,207,1428
59,Myanmar,2020,MM-20/DDA-3415/SA1/P-H-COVID-19/INGO/16806,11/8/2021 5:54:38 AM,Overall,214,757,327,388,1686,231,1183,395,369,2178
59,Myanmar,2020,MM-20/DDA-3415/SA1/SNFI/INGO/16932,9/13/2021 11:51:29 AM,Internally Displaced People,267,323,372,358,1320,395,400,516,528,1839
59,Myanmar,2020,MM-20/DDA-3415/SA1/SNFI/INGO/16932,9/13/2021 11:51:29 AM,Overall,267,323,372,358,1320,395,400,516,528,1839
59,Myanmar,2020,MM-20/DDA-3415/SA1/SNFI-E-WASH-P/INGO/17058,3/24/2022 2:49:45 PM,Internally Displaced People,13263,15196,15721,15337,59517,11813,13689,16890,16319,58711
59,Myanmar,2020,MM-20/DDA-3415/SA1/SNFI-E-WASH-P/INGO/17058,3/24/2022 2:49:45 PM,Overall,13263,15196,15721,15337,59517,11813,13689,16890,16319,58711
59,Myanmar,2020,MM-20/DDA-3415/SA1/SNFI-FS/NGO/16921,7/6/2022 6:42:19 PM,Internally Displaced People,4101,4386,3709,3847,16043,2171,2852,2048,2092,9163
59,Myanmar,2020,MM-20/DDA-3415/SA1/SNFI-FS/NGO/16921,7/6/2022 6:42:19 PM,Overall,4228,4507,3798,3943,16476,2270,2944,2116,2188,9518
59,Myanmar,2020,MM-20/DDA-3415/SA1/SNFI-FS/NGO/16921,7/6/2022 6:42:19 PM,Returnees,127,121,89,96,433,99,92,68,96,355
59,Myanmar,2020,MM-20/DDA-3415/SA1/WASH-SNFI-P-FS/INGO/16842,3/3/2022 5:17:08 AM,Host Communities,13408,14219,8030,8134,43791,0,0,0,0,0
59,Myanmar,2020,MM-20/DDA-3415/SA1/WASH-SNFI-P-FS/INGO/16842,3/3/2022 5:17:08 AM,Internally Displaced People,9168,12386,8165,8757,38476,8714,11658,6624,7226,34222
59,Myanmar,2020,MM-20/DDA-3415/SA1/WASH-SNFI-P-FS/INGO/16842,3/3/2022 5:17:08 AM,Overall,22576,26605,16195,16891,82267,8714,11658,6624,7226,34222
59,Myanmar,2020,MM-20/DDA-3415/SA2/CSCS/UN/17883,12/8/2021 7:24:30 PM,Internally Displaced People,10100,10100,2418,2418,25036,11394,11473,1841,1599,26307
59,Myanmar,2020,MM-20/DDA-3415/SA2/CSCS/UN/17883,12/8/2021 7:24:30 PM,Other,2000,2000,0,0,4000,442,307,0,0,749
59,Myanmar,2020,MM-20/DDA-3415/SA2/CSCS/UN/17883,12/8/2021 7:24:30 PM,Overall,12100,12100,2418,2418,29036,11836,11780,1841,1599,27056
59,Myanmar,2020,MM-20/DDA-3415/SA2/E/INGO/17832,7/15/2022 5:56:48 PM,Internally Displaced People,122,65,3794,3086,7067,269,104,3794,3086,7253
59,Myanmar,2020,MM-20/DDA-3415/SA2/E/INGO/17832,7/15/2022 5:56:48 PM,Overall,122,65,3794,3086,7067,269,104,3794,3086,7253
59,Myanmar,2020,MM-20/DDA-3415/SA2/E-FS-H-N-P-WASH/INGO/17854,4/20/2022 11:09:02 AM,Internally Displaced People,1986,2146,1456,1390,6978,1822,1688,1619,1618,6747
59,Myanmar,2020,MM-20/DDA-3415/SA2/E-FS-H-N-P-WASH/INGO/17854,4/20/2022 11:09:02 AM,Overall,1986,2146,1456,1390,6978,1822,1688,1619,1618,6747
59,Myanmar,2020,MM-20/DDA-3415/SA2/E-P/NGO/17770,4/28/2022 9:22:01 AM,Host Communities,103,149,739,722,1713,133,419,1209,1108,2869
59,Myanmar,2020,MM-20/DDA-3415/SA2/E-P/NGO/17770,4/28/2022 9:22:01 AM,Internally Displaced People,2043,1231,721,678,4673,2264,2393,852,512,6021
59,Myanmar,2020,MM-20/DDA-3415/SA2/E-P/NGO/17770,4/28/2022 9:22:01 AM,Overall,2146,1380,1460,1400,6386,2397,2812,2061,1620,8890
59,Myanmar,2020,MM-20/DDA-3415/SA2/E-WASH/INGO/17828,7/5/2022 3:52:13 PM,Internally Displaced People,270,903,1082,1057,3312,562,1052,1093,1071,3778
59,Myanmar,2020,MM-20/DDA-3415/SA2/E-WASH/INGO/17828,7/5/2022 3:52:13 PM,Other,34,47,0,0,81,34,47,0,0,81
59,Myanmar,2020,MM-20/DDA-3415/SA2/E-WASH/INGO/17828,7/5/2022 3:52:13 PM,Overall,304,950,1459,1417,4130,596,1099,1366,1307,4368
59,Myanmar,2020,MM-20/DDA-3415/SA2/E-WASH/INGO/17828,7/5/2022 3:52:13 PM,Returnees,0,0,377,360,737,0,0,273,236,509
59,Myanmar,2020,MM-20/DDA-3415/SA2/E-WASH-FS-H-N-P/INGO/17803,3/23/2022 2:46:03 PM,Host Communities,2130,2180,1105,1105,6520,1765,2226,110,92,4193
59,Myanmar,2020,MM-20/DDA-3415/SA2/E-WASH-FS-H-N-P/INGO/17803,3/23/2022 2:46:03 PM,Internally Displaced People,5112,4066,3203,3202,15583,6475,6671,385,410,13941
59,Myanmar,2020,MM-20/DDA-3415/SA2/E-WASH-FS-H-N-P/INGO/17803,3/23/2022 2:46:03 PM,Overall,7242,6246,4308,4307,22103,8240,8897,495,502,18134
59,Myanmar,2020,MM-20/DDA-3415/SA2/FS/UN/17826,7/9/2022 2:04:26 PM,Host Communities,1935,2072,1473,1480,6960,1688,2121,1758,1928,7495
59,Myanmar,2020,MM-20/DDA-3415/SA2/FS/UN/17826,7/9/2022 2:04:26 PM,Overall,1935,2072,1473,1480,6960,1688,2121,1758,1928,7495
59,Myanmar,2020,MM-20/DDA-3415/SA2/H/INGO/17740,4/18/2022 4:11:58 AM,Internally Displaced People,10542,25332,6539,7567,49980,5988,16933,6388,6873,36182
59,Myanmar,2020,MM-20/DDA-3415/SA2/H/INGO/17740,4/18/2022 4:11:58 AM,Overall,10542,25332,6539,7567,49980,5988,16933,6388,6873,36182
59,Myanmar,2020,MM-20/DDA-3415/SA2/H/NGO/17810,6/6/2022 11:01:16 AM,Internally Displaced People,9680,10837,7962,8527,37006,9714,17136,12644,11486,50980
59,Myanmar,2020,MM-20/DDA-3415/SA2/H/NGO/17810,6/6/2022 11:01:16 AM,Overall,9680,10837,7962,8527,37006,9714,17136,12644,11486,50980
59,Myanmar,2020,MM-20/DDA-3415/SA2/H-P-N/INGO/17821,5/9/2022 6:14:16 AM,Other,6564,14657,1365,1511,24097,5950,12126,2446,3593,24115
59,Myanmar,2020,MM-20/DDA-3415/SA2/H-P-N/INGO/17821,5/9/2022 6:14:16 AM,Overall,6564,14657,1365,1511,24097,5950,12126,2446,3593,24115
59,Myanmar,2020,MM-20/DDA-3415/SA2/N-H/INGO/17750,3/23/2022 2:37:00 PM,Host Communities,99,519,207,231,1056,64,513,478,494,1549
59,Myanmar,2020,MM-20/DDA-3415/SA2/N-H/INGO/17750,3/23/2022 2:37:00 PM,Internally Displaced People,41,270,113,126,550,62,290,684,559,1595
59,Myanmar,2020,MM-20/DDA-3415/SA2/N-H/INGO/17750,3/23/2022 2:37:00 PM,Other,22,23,0,0,45,28,38,0,0,66
59,Myanmar,2020,MM-20/DDA-3415/SA2/N-H/INGO/17750,3/23/2022 2:37:00 PM,Overall,162,812,320,357,1651,154,841,1162,1053,3210
59,Myanmar,2020,MM-20/DDA-3415/SA2/P/INGO/17761,7/26/2022 10:07:58 PM,Host Communities,1872,2310,1861,2299,8342,4581,6689,2524,3073,16867
59,Myanmar,2020,MM-20/DDA-3415/SA2/P/INGO/17761,7/26/2022 10:07:58 PM,Internally Displaced People,268,330,266,329,1193,76,185,84,103,448
59,Myanmar,2020,MM-20/DDA-3415/SA2/P/INGO/17761,7/26/2022 10:07:58 PM,Overall,2140,2640,2127,2628,9535,4657,6874,2608,3176,17315
59,Myanmar,2020,MM-20/DDA-3415/SA2/P/UN/17843,12/20/2022 6:48:37 PM,Internally Displaced People,32,117,7,36,192,0,131,0,0,131
59,Myanmar,2020,MM-20/DDA-3415/SA2/P/UN/17843,12/20/2022 6:48:37 PM,Other,80,80,0,0,160,94,107,0,0,201
59,Myanmar,2020,MM-20/DDA-3415/SA2/P/UN/17843,12/20/2022 6:48:37 PM,Overall,112,197,7,36,352,94,238,0,0,332
59,Myanmar,2020,MM-20/DDA-3415/SA2/SNFI-CCCM-WASH-N-P/INGO/17788,7/25/2022 8:33:14 PM,Internally Displaced People,8610,11394,8214,9038,37256,7884,10808,8141,9030,35863
59,Myanmar,2020,MM-20/DDA-3415/SA2/SNFI-CCCM-WASH-N-P/INGO/17788,7/25/2022 8:33:14 PM,Overall,8610,11394,8214,9038,37256,7884,10808,8141,9030,35863
59,Myanmar,2020,MM-20/DDA-3415/SA2/SNFI-E/NGO/17840,4/11/2023 2:58:56 PM,Internally Displaced People,523,528,355,368,1774,705,670,537,494,2406
59,Myanmar,2020,MM-20/DDA-3415/SA2/SNFI-E/NGO/17840,4/11/2023 2:58:56 PM,Other,34,60,409,396,899,184,234,479,509,1406
59,Myanmar,2020,MM-20/DDA-3415/SA2/SNFI-E/NGO/17840,4/11/2023 2:58:56 PM,Overall,557,588,764,764,2673,889,904,1016,1003,3812
59,Myanmar,2020,MM-20/DDA-3415/SA2/WASH/INGO/17751,4/13/2022 10:25:31 AM,Host Communities,816,863,683,663,3025,864,876,826,880,3446
59,Myanmar,2020,MM-20/DDA-3415/SA2/WASH/INGO/17751,4/13/2022 10:25:31 AM,Internally Displaced People,51,55,119,129,354,100,96,89,87,372
59,Myanmar,2020,MM-20/DDA-3415/SA2/WASH/INGO/17751,4/13/2022 10:25:31 AM,Overall,867,918,802,792,3379,964,972,915,967,3818
59,Myanmar,2020,MM-20/DDA-3415/SA2/WASH-E-H-SNFI-P/NGO/17736,7/21/2022 1:45:31 PM,Host Communities,381,552,428,442,1803,184,129,171,174,658
59,Myanmar,2020,MM-20/DDA-3415/SA2/WASH-E-H-SNFI-P/NGO/17736,7/21/2022 1:45:31 PM,Internally Displaced People,3031,3555,1382,1354,9322,3657,4449,3967,3158,15231
59,Myanmar,2020,MM-20/DDA-3415/SA2/WASH-E-H-SNFI-P/NGO/17736,7/21/2022 1:45:31 PM,Overall,3412,4107,1810,1796,11125,3841,4578,4138,3332,15889
59,Myanmar,2021,MM-21/DDA-3415/SA1/E/INGO/18678,10/19/2022 2:15:11 AM,Host Communities,184,111,5372,4159,9826,599,850,6384,4779,12612
59,Myanmar,2021,MM-21/DDA-3415/SA1/E/INGO/18678,10/19/2022 2:15:11 AM,Internally Displaced People,209,80,3119,2829,6237,289,288,3603,3304,7484
59,Myanmar,2021,MM-21/DDA-3415/SA1/E/INGO/18678,10/19/2022 2:15:11 AM,Overall,393,191,8491,6988,16063,888,1138,9987,8083,20096
59,Myanmar,2021,MM-21/DDA-3415/SA1/E/INGO/18693,7/5/2022 11:49:53 AM,Host Communities,25,25,500,500,1050,80,115,1631,1785,3611
59,Myanmar,2021,MM-21/DDA-3415/SA1/E/INGO/18693,7/5/2022 11:49:53 AM,Internally Displaced People,50,50,2100,2100,4300,0,0,1017,1113,2130
59,Myanmar,2021,MM-21/DDA-3415/SA1/E/INGO/18693,7/5/2022 11:49:53 AM,Overall,75,75,2600,2600,5350,80,115,2648,2898,5741
59,Myanmar,2021,MM-21/DDA-3415/SA1/E-P-SNFI-WASH/INGO/19095,12/6/2022 1:34:06 AM,Internally Displaced People,3315,3665,2210,2443,11633,7122,7057,3827,3895,21901
59,Myanmar,2021,MM-21/DDA-3415/SA1/E-P-SNFI-WASH/INGO/19095,12/6/2022 1:34:06 AM,Overall,3315,3665,2210,2443,11633,7122,7057,3827,3895,21901
59,Myanmar,2021,MM-21/DDA-3415/SA1/E-P-WASH/INGO/19102,10/21/2022 12:02:29 PM,Host Communities,3366,5063,3227,3446,15102,2313,3940,1837,1982,10072
59,Myanmar,2021,MM-21/DDA-3415/SA1/E-P-WASH/INGO/19102,10/21/2022 12:02:29 PM,Internally Displaced People,1385,1612,2097,2335,7429,122,244,828,866,2060
59,Myanmar,2021,MM-21/DDA-3415/SA1/E-P-WASH/INGO/19102,10/21/2022 12:02:29 PM,Other,4,0,200,220,424,2,0,0,29,31
59,Myanmar,2021,MM-21/DDA-3415/SA1/E-P-WASH/INGO/19102,10/21/2022 12:02:29 PM,Overall,4755,6675,5524,6001,22955,2437,4184,2665,2877,12163
59,Myanmar,2021,MM-21/DDA-3415/SA1/E-WASH-SNFI/INGO/18720,4/4/2023 8:25:51 AM,Internally Displaced People,9254,10749,7734,7886,35623,10013,11038,7891,8104,37046
59,Myanmar,2021,MM-21/DDA-3415/SA1/E-WASH-SNFI/INGO/18720,4/4/2023 8:25:51 AM,Overall,9254,10749,7734,7886,35623,10013,11038,7891,8104,37046
59,Myanmar,2021,MM-21/DDA-3415/SA1/E-WASH-SNFI-P/INGO/18665,1/17/2023 1:57:26 PM,Host Communities,1132,1298,1085,1119,4634,2753,3294,3022,3017,12086
59,Myanmar,2021,MM-21/DDA-3415/SA1/E-WASH-SNFI-P/INGO/18665,1/17/2023 1:57:26 PM,Internally Displaced People,10575,12187,13441,13009,49212,3829,4486,8637,7892,24844
59,Myanmar,2021,MM-21/DDA-3415/SA1/E-WASH-SNFI-P/INGO/18665,1/17/2023 1:57:26 PM,Overall,11707,13485,14526,14128,53846,6582,7780,11659,10909,36930
59,Myanmar,2021,MM-21/DDA-3415/SA1/FS-H/NGO/19053,7/9/2022 1:19:08 PM,Internally Displaced People,2592,3493,3173,3991,13249,7294,9104,4580,4863,25841
59,Myanmar,2021,MM-21/DDA-3415/SA1/FS-H/NGO/19053,7/9/2022 1:19:08 PM,Overall,2592,3493,3173,3991,13249,7294,9104,4580,4863,25841
59,Myanmar,2021,MM-21/DDA-3415/SA1/FS-P/NGO/18667,10/6/2022 10:32:38 AM,Host Communities,3420,3726,2241,2438,11825,3877,3233,1813,1993,10916
59,Myanmar,2021,MM-21/DDA-3415/SA1/FS-P/NGO/18667,10/6/2022 10:32:38 AM,Overall,3420,3726,2241,2438,11825,3877,3233,1813,1993,10916
59,Myanmar,2021,MM-21/DDA-3415/SA1/FS-SNFI/INGO/18660,11/8/2022 9:02:09 AM,Host Communities,2400,2400,1350,1350,7500,2503,3035,2161,2132,9831
59,Myanmar,2021,MM-21/DDA-3415/SA1/FS-SNFI/INGO/18660,11/8/2022 9:02:09 AM,Internally Displaced People,6320,6320,3555,3555,19750,5959,7958,2632,2371,18920
59,Myanmar,2021,MM-21/DDA-3415/SA1/FS-SNFI/INGO/18660,11/8/2022 9:02:09 AM,Overall,8720,8720,4905,4905,27250,8462,10993,4793,4503,28751
59,Myanmar,2021,MM-21/DDA-3415/SA1/FS-SNFI-WASH/INGO/18682,2/13/2023 3:16:14 AM,Internally Displaced People,4364,5185,2058,3065,14672,5012,6341,1410,1909,14672
59,Myanmar,2021,MM-21/DDA-3415/SA1/FS-SNFI-WASH/INGO/18682,2/13/2023 3:16:14 AM,Overall,4364,5185,2058,3065,14672,5012,6341,1410,1909,14672
59,Myanmar,2021,MM-21/DDA-3415/SA1/FS-WASH-E-SNFI-H-N/INGO/18993,6/10/2022 7:28:57 AM,Internally Displaced People,15000,15000,5000,5000,40000,18840,21469,6304,6708,53321
59,Myanmar,2021,MM-21/DDA-3415/SA1/FS-WASH-E-SNFI-H-N/INGO/18993,6/10/2022 7:28:57 AM,Overall,15000,15000,5000,5000,40000,18840,21469,6304,6708,53321
59,Myanmar,2021,MM-21/DDA-3415/SA1/FS-WASH-SNFI/NGO/18677,8/19/2022 4:01:03 AM,Internally Displaced People,5345,5442,2236,1930,14953,5331,5383,2017,1775,14506
59,Myanmar,2021,MM-21/DDA-3415/SA1/FS-WASH-SNFI/NGO/18677,8/19/2022 4:01:03 AM,Overall,5345,5442,2236,1930,14953,5331,5383,2017,1775,14506
59,Myanmar,2021,MM-21/DDA-3415/SA1/H/INGO/18689,10/4/2022 9:56:57 AM,Internally Displaced People,10829,12570,13470,13148,50017,4558,13858,6484,5702,30602
59,Myanmar,2021,MM-21/DDA-3415/SA1/H/INGO/18689,10/4/2022 9:56:57 AM,Overall,10829,12570,13470,13148,50017,4558,13858,6484,5702,30602
59,Myanmar,2021,MM-21/DDA-3415/SA1/H/NGO/18953,2/27/2023 5:41:43 AM,Host Communities,6500,8300,3600,4600,23000,6031,15020,4091,4295,29437
59,Myanmar,2021,MM-21/DDA-3415/SA1/H/NGO/18953,2/27/2023 5:41:43 AM,Internally Displaced People,4777,5580,3184,3152,16693,4377,10901,2969,3118,21365
59,Myanmar,2021,MM-21/DDA-3415/SA1/H/NGO/18953,2/27/2023 5:41:43 AM,Overall,11277,13880,6784,7752,39693,10408,25921,7060,7413,50802
59,Myanmar,2021,MM-21/DDA-3415/SA1/H-N/INGO/19043,1/22/2023 12:28:41 PM,Host Communities,9438,10177,5321,5658,30594,1325,8040,1804,1325,12494
59,Myanmar,2021,MM-21/DDA-3415/SA1/H-N/INGO/19043,1/22/2023 12:28:41 PM,Internally Displaced People,11503,12950,9999,9965,44417,7636,26192,11050,7636,52514
59,Myanmar,2021,MM-21/DDA-3415/SA1/H-N/INGO/19043,1/22/2023 12:28:41 PM,Overall,20941,23127,15320,15623,75011,8961,34232,12854,8961,65008
59,Myanmar,2021,MM-21/DDA-3415/SA1/H-P-N/INGO/18657,2/9/2023 3:10:53 PM,Host Communities,183,438,31,37,689,238,1395,38,54,1725
59,Myanmar,2021,MM-21/DDA-3415/SA1/H-P-N/INGO/18657,2/9/2023 3:10:53 PM,Internally Displaced People,444,1140,128,159,1871,471,2421,247,229,3368
59,Myanmar,2021,MM-21/DDA-3415/SA1/H-P-N/INGO/18657,2/9/2023 3:10:53 PM,Other,30,20,0,0,50,43,40,0,0,83
59,Myanmar,2021,MM-21/DDA-3415/SA1/H-P-N/INGO/18657,2/9/2023 3:10:53 PM,Overall,657,1598,159,196,2610,752,3856,285,283,5176
59,Myanmar,2021,MM-21/DDA-3415/SA1/H-P-WASH-SNFI/INGO/18663,5/20/2023 1:22:57 PM,Host Communities,3159,3566,2659,2490,11874,2040,2103,1315,1122,6580
59,Myanmar,2021,MM-21/DDA-3415/SA1/H-P-WASH-SNFI/INGO/18663,5/20/2023 1:22:57 PM,Internally Displaced People,4479,5039,3621,3558,16697,9778,12458,6703,6717,35656
59,Myanmar,2021,MM-21/DDA-3415/SA1/H-P-WASH-SNFI/INGO/18663,5/20/2023 1:22:57 PM,Overall,7638,8605,6280,6048,28571,11818,14561,8018,7839,42236
59,Myanmar,2021,MM-21/DDA-3415/SA1/P/INGO/18705,5/1/2023 5:59:12 AM,Host Communities,10222,10946,8675,7977,37820,11025,24958,6462,7741,50186
59,Myanmar,2021,MM-21/DDA-3415/SA1/P/INGO/18705,5/1/2023 5:59:12 AM,Internally Displaced People,381,394,296,329,1400,459,1040,269,312,2080
59,Myanmar,2021,MM-21/DDA-3415/SA1/P/INGO/18705,5/1/2023 5:59:12 AM,Overall,10603,11340,8971,8306,39220,11484,25998,6731,8053,52266
59,Myanmar,2021,MM-21/DDA-3415/SA1/P/INGO/18945,12/29/2022 9:34:45 AM,Host Communities,2000,2400,900,1100,6400,1182,2403,1661,1886,7132
59,Myanmar,2021,MM-21/DDA-3415/SA1/P/INGO/18945,12/29/2022 9:34:45 AM,Overall,2000,2400,900,1100,6400,1182,2403,1661,1886,7132
59,Myanmar,2021,MM-21/DDA-3415/SA1/P-H-FS/INGO/18658,4/28/2023 1:47:02 PM,Host Communities,350,363,253,264,1230,467,483,334,350,1634
59,Myanmar,2021,MM-21/DDA-3415/SA1/P-H-FS/INGO/18658,4/28/2023 1:47:02 PM,Internally Displaced People,3097,3219,2233,2327,10876,2942,3059,2121,2210,10332
59,Myanmar,2021,MM-21/DDA-3415/SA1/P-H-FS/INGO/18658,4/28/2023 1:47:02 PM,Overall,3447,3582,2486,2591,12106,3409,3542,2455,2560,11966
59,Myanmar,2021,MM-21/DDA-3415/SA1/SNFI/NGO/18838,4/18/2023 2:43:34 PM,Internally Displaced People,86,96,71,82,335,71,87,67,71,296
59,Myanmar,2021,MM-21/DDA-3415/SA1/SNFI/NGO/18838,4/18/2023 2:43:34 PM,Overall,86,96,71,82,335,71,87,67,71,296
59,Myanmar,2021,MM-21/DDA-3415/SA1/SNFI-WASH-E-P-H-N/NGO/19080,1/16/2023 2:45:36 PM,Internally Displaced People,467,583,3101,3780,7931,8041,9586,7914,7853,33394
59,Myanmar,2021,MM-21/DDA-3415/SA1/SNFI-WASH-E-P-H-N/NGO/19080,1/16/2023 2:45:36 PM,Overall,467,583,3101,3780,7931,8041,9586,7914,7853,33394
59,Myanmar,2021,MM-21/DDA-3415/SA1/WASH/UN/19048,9/2/2022 7:28:41 AM,Host Communities,4677,5470,3430,3352,16929,4273,4927,2905,2864,14969
59,Myanmar,2021,MM-21/DDA-3415/SA1/WASH/UN/19048,9/2/2022 7:28:41 AM,Internally Displaced People,2583,2692,1950,1938,9163,4216,4185,2703,2683,13787
59,Myanmar,2021,MM-21/DDA-3415/SA1/WASH/UN/19048,9/2/2022 7:28:41 AM,Overall,7260,8162,5380,5290,26092,8489,9112,5608,5547,28756
59,Myanmar,2021,MM-21/DDA-3415/SA1/WASH-SNFI/INGO/18666,11/23/2022 6:31:02 AM,Host Communities,2516,2999,1660,1750,8925,2130,2523,2824,2384,9861
59,Myanmar,2021,MM-21/DDA-3415/SA1/WASH-SNFI/INGO/18666,11/23/2022 6:31:02 AM,Internally Displaced People,444,587,321,374,1726,703,829,512,511,2555
59,Myanmar,2021,MM-21/DDA-3415/SA1/WASH-SNFI/INGO/18666,11/23/2022 6:31:02 AM,Overall,2960,3586,1981,2124,10651,2833,3352,3336,2895,12416
59,Myanmar,2021,MM-21/DDA-3415/SA1/WASH-SNFI-P-N-FS/INGO/18662,5/3/2023 6:15:04 PM,Internally Displaced People,7007,9429,5303,5695,27434,8720,11731,6576,6948,33975
59,Myanmar,2021,MM-21/DDA-3415/SA1/WASH-SNFI-P-N-FS/INGO/18662,5/3/2023 6:15:04 PM,Overall,7007,9429,5303,5695,27434,8720,11731,6576,6948,33975
59,Myanmar,2021,MM-21/DDA-3415/SA2/E-P/INGO/20565,7/4/2023 10:42:59 AM,Host Communities,896,968,1500,1626,4990,3249,3936,2619,3494,13298
59,Myanmar,2021,MM-21/DDA-3415/SA2/E-P/INGO/20565,7/4/2023 10:42:59 AM,Internally Displaced People,1230,1333,2059,2231,6853,3171,3842,3107,3845,13965
59,Myanmar,2021,MM-21/DDA-3415/SA2/E-P/INGO/20565,7/4/2023 10:42:59 AM,Other,0,0,57,63,120,0,0,47,33,80
59,Myanmar,2021,MM-21/DDA-3415/SA2/E-P/INGO/20565,7/4/2023 10:42:59 AM,Overall,2126,2301,3616,3920,11963,6420,7778,5773,7372,27343
59,Myanmar,2021,MM-21/DDA-3415/SA2/E-P-SNFI-WASH/INGO/20764,9/20/2023 4:18:46 PM,Host Communities,220,240,189,204,853,400,439,682,739,2260
59,Myanmar,2021,MM-21/DDA-3415/SA2/E-P-SNFI-WASH/INGO/20764,9/20/2023 4:18:46 PM,Internally Displaced People,443,480,377,409,1709,932,1023,849,762,3566
59,Myanmar,2021,MM-21/DDA-3415/SA2/E-P-SNFI-WASH/INGO/20764,9/20/2023 4:18:46 PM,Other,32,32,0,0,64,44,56,0,0,100
59,Myanmar,2021,MM-21/DDA-3415/SA2/E-P-SNFI-WASH/INGO/20764,9/20/2023 4:18:46 PM,Overall,695,752,566,613,2626,1376,1518,1531,1501,5926
59,Myanmar,2021,MM-21/DDA-3415/SA2/E-WASH/NGO/20708,4/28/2023 1:39:45 PM,Host Communities,1849,2019,1505,1541,6914,1490,1599,2072,1763,6924
59,Myanmar,2021,MM-21/DDA-3415/SA2/E-WASH/NGO/20708,4/28/2023 1:39:45 PM,Internally Displaced People,2419,2947,2008,2009,9383,4011,4191,3000,3016,14218
59,Myanmar,2021,MM-21/DDA-3415/SA2/E-WASH/NGO/20708,4/28/2023 1:39:45 PM,Overall,4268,4966,3513,3550,16297,5501,5790,5072,4779,21142
59,Myanmar,2021,MM-21/DDA-3415/SA2/E-WASH-SNFI/INGO/20561,9/20/2023 4:15:46 PM,Internally Displaced People,930,1143,1748,1904,5725,809,1323,2326,2798,7256
59,Myanmar,2021,MM-21/DDA-3415/SA2/E-WASH-SNFI/INGO/20561,9/20/2023 4:15:46 PM,Other,5,5,0,0,10,4,5,0,0,9
59,Myanmar,2021,MM-21/DDA-3415/SA2/E-WASH-SNFI/INGO/20561,9/20/2023 4:15:46 PM,Overall,935,1148,1748,1904,5735,813,1328,2326,2798,7265
59,Myanmar,2021,MM-21/DDA-3415/SA2/E-WASH-SNFI/INGO/20818,5/1/2023 5:51:35 AM,Internally Displaced People,1214,1269,445,464,3392,1262,1325,753,761,4101
59,Myanmar,2021,MM-21/DDA-3415/SA2/E-WASH-SNFI/INGO/20818,5/1/2023 5:51:35 AM,Overall,1214,1269,445,464,3392,1262,1325,753,761,4101
59,Myanmar,2021,MM-21/DDA-3415/SA2/H/INGO/20627,5/22/2023 7:34:41 AM,Internally Displaced People,22455,25893,27884,27232,103464,2689,12564,8886,8766,32905
59,Myanmar,2021,MM-21/DDA-3415/SA2/H/INGO/20627,5/22/2023 7:34:41 AM,Overall,22455,25893,27884,27232,103464,2689,12564,8886,8766,32905
59,Myanmar,2021,MM-21/DDA-3415/SA2/H-N-P-WASH/INGO/20885,7/3/2023 1:13:55 PM,Internally Displaced People,1372,1337,1346,1375,5430,1310,1404,1412,1339,5465
59,Myanmar,2021,MM-21/DDA-3415/SA2/H-N-P-WASH/INGO/20885,7/3/2023 1:13:55 PM,Overall,1372,1337,1346,1375,5430,1310,1404,1412,1339,5465
59,Myanmar,2021,MM-21/DDA-3415/SA2/H-N-WASH/INGO/20871,7/10/2023 7:47:02 AM,Other,6250,6423,2257,2431,17361,4784,18069,2912,3758,29523
59,Myanmar,2021,MM-21/DDA-3415/SA2/H-N-WASH/INGO/20871,7/10/2023 7:47:02 AM,Overall,6250,6423,2257,2431,17361,4784,18069,2912,3758,29523
59,Myanmar,2021,MM-21/DDA-3415/SA2/H-N-WASH/INGO/20884,8/4/2023 11:24:26 AM,Host Communities,10305,11070,7736,8615,37726,5303,11194,14065,4949,35511
59,Myanmar,2021,MM-21/DDA-3415/SA2/H-N-WASH/INGO/20884,8/4/2023 11:24:26 AM,Internally Displaced People,1976,2624,1499,1781,7880,1303,3237,691,1075,6306
59,Myanmar,2021,MM-21/DDA-3415/SA2/H-N-WASH/INGO/20884,8/4/2023 11:24:26 AM,Overall,12281,13694,9235,10396,45606,6606,14431,14756,6024,41817
59,Myanmar,2021,MM-21/DDA-3415/SA2/H-WASH-N/INGO/20908,5/7/2023 11:09:40 AM,Internally Displaced People,2502,3061,2706,2734,11003,1455,1466,250,220,3391
59,Myanmar,2021,MM-21/DDA-3415/SA2/H-WASH-N/INGO/20908,5/7/2023 11:09:40 AM,Other,574,2868,1211,1196,5849,244,1264,818,810,3136
59,Myanmar,2021,MM-21/DDA-3415/SA2/H-WASH-N/INGO/20908,5/7/2023 11:09:40 AM,Overall,3076,5929,3917,3930,16852,1699,2730,1068,1030,6527
59,Myanmar,2021,MM-21/DDA-3415/SA2/SNFI-P/INGO/20624,6/7/2023 7:26:29 AM,Host Communities,351,351,63,135,900,42,398,0,0,440
59,Myanmar,2021,MM-21/DDA-3415/SA2/SNFI-P/INGO/20624,6/7/2023 7:26:29 AM,Internally Displaced People,3697,3888,699,1686,9970,5343,6115,1934,2008,15400
59,Myanmar,2021,MM-21/DDA-3415/SA2/SNFI-P/INGO/20624,6/7/2023 7:26:29 AM,Overall,4048,4239,762,1821,10870,5385,6513,1934,2008,15840
59,Myanmar,2021,MM-21/DDA-3415/SA2/SNFI-WASH/INGO/20754,5/15/2023 3:52:37 PM,Internally Displaced People,4961,7222,4284,4509,20976,4485,6299,3569,3787,18140
59,Myanmar,2021,MM-21/DDA-3415/SA2/SNFI-WASH/INGO/20754,5/15/2023 3:52:37 PM,Overall,4961,7222,4284,4509,20976,4485,6299,3569,3787,18140
59,Myanmar,2021,MM-21/DDA-3415/SA2/SNFI-WASH/NGO/20598,5/8/2023 5:25:42 PM,Internally Displaced People,2736,2986,2267,2168,10157,2971,3215,2212,2169,10567
59,Myanmar,2021,MM-21/DDA-3415/SA2/SNFI-WASH/NGO/20598,5/8/2023 5:25:42 PM,Overall,2736,2986,2267,2168,10157,2971,3215,2212,2169,10567
59,Myanmar,2021,MM-21/DDA-3415/SA2/SNFI-WASH-P-E/INGO/20588,6/12/2023 9:02:22 AM,Host Communities,1218,1332,781,882,4213,2803,2755,5087,5326,15971
59,Myanmar,2021,MM-21/DDA-3415/SA2/SNFI-WASH-P-E/INGO/20588,6/12/2023 9:02:22 AM,Internally Displaced People,6036,6742,11202,10217,34197,2997,3558,5620,5056,17231
59,Myanmar,2021,MM-21/DDA-3415/SA2/SNFI-WASH-P-E/INGO/20588,6/12/2023 9:02:22 AM,Overall,7254,8074,11983,11099,38410,5800,6313,10707,10382,33202
59,Myanmar,2022,MM-22/DDA-3415/RA1/CSCS/INGO/21569,3/15/2023 12:18:18 PM,Other,56,56,0,0,112,97,97,0,0,194
59,Myanmar,2022,MM-22/DDA-3415/RA1/CSCS/INGO/21569,3/15/2023 12:18:18 PM,Overall,56,56,0,0,112,97,97,0,0,194
59,Myanmar,2022,MM-22/DDA-3415/RA2/H-N/INGO/23142,9/15/2023 9:42:11 AM,Internally Displaced People,4000,14000,6000,6000,30000,1814,4562,2832,2305,11513
59,Myanmar,2022,MM-22/DDA-3415/RA2/H-N/INGO/23142,9/15/2023 9:42:11 AM,Overall,4000,14000,6000,6000,30000,1814,4562,2832,2305,11513
59,Myanmar,2022,MM-22/DDA-3415/RA2/N-P-SNFI-WASH-H/INGO/23085,10/9/2023 5:18:19 PM,Internally Displaced People,5049,6659,3419,3579,18706,7279,9621,5192,4929,27021
59,Myanmar,2022,MM-22/DDA-3415/RA2/N-P-SNFI-WASH-H/INGO/23085,10/9/2023 5:18:19 PM,Overall,5049,6659,3419,3579,18706,7279,9621,5192,4929,27021
59,Myanmar,2022,MM-22/DDA-3415/RA2/SNFI-FS/INGO/23119,9/21/2023 3:39:25 PM,Host Communities,106,118,69,67,360,0,0,0,0,0
59,Myanmar,2022,MM-22/DDA-3415/RA2/SNFI-FS/INGO/23119,9/21/2023 3:39:25 PM,Internally Displaced People,2924,3259,1897,1860,9940,3468,3666,2449,2269,11852
59,Myanmar,2022,MM-22/DDA-3415/RA2/SNFI-FS/INGO/23119,9/21/2023 3:39:25 PM,Overall,3030,3377,1966,1927,10300,3468,3666,2449,2269,11852
84,Niger,2021,NER-21/NI_CBPF_RHPF/SA/CP/INGO/20180,5/11/2023 10:36:54 AM,Host Communities,422,438,457,514,1831,422,438,457,514,1831
84,Niger,2021,NER-21/NI_CBPF_RHPF/SA/CP/INGO/20180,5/11/2023 10:36:54 AM,Internally Displaced People,640,780,456,693,2569,640,780,456,693,2569
84,Niger,2021,NER-21/NI_CBPF_RHPF/SA/CP/INGO/20180,5/11/2023 10:36:54 AM,Overall,1751,2010,1660,1904,7325,1751,2010,1660,1904,7325
84,Niger,2021,NER-21/NI_CBPF_RHPF/SA/CP/INGO/20180,5/11/2023 10:36:54 AM,Refugees,506,549,549,594,2198,506,549,549,594,2198
84,Niger,2021,NER-21/NI_CBPF_RHPF/SA/CP/INGO/20180,5/11/2023 10:36:54 AM,Returnees,183,243,198,103,727,183,243,198,103,727
84,Niger,2021,NER-21/NI_CBPF_RHPF/SA/CP/NGO/20195,12/23/2022 12:51:08 PM,Host Communities,492,581,448,498,2019,317,247,385,203,1152
84,Niger,2021,NER-21/NI_CBPF_RHPF/SA/CP/NGO/20195,12/23/2022 12:51:08 PM,Internally Displaced People,1614,2014,1792,1992,7412,891,951,1922,1977,5741
84,Niger,2021,NER-21/NI_CBPF_RHPF/SA/CP/NGO/20195,12/23/2022 12:51:08 PM,Overall,2106,2595,2240,2490,9431,1208,1198,2307,2180,6893
84,Niger,2021,NER-21/NI_CBPF_RHPF/SA/E/INGO/20169,12/28/2022 3:51:56 PM,Host Communities,130,86,2223,1482,3921,130,86,1640,1323,3179
84,Niger,2021,NER-21/NI_CBPF_RHPF/SA/E/INGO/20169,12/28/2022 3:51:56 PM,Internally Displaced People,92,73,2223,1482,3870,38,94,2463,1984,4579
84,Niger,2021,NER-21/NI_CBPF_RHPF/SA/E/INGO/20169,12/28/2022 3:51:56 PM,Overall,222,159,4446,2964,7791,168,180,4103,3307,7758
84,Niger,2021,NER-21/NI_CBPF_RHPF/SA/E-P/INGO/20177,2/13/2023 12:19:39 PM,Host Communities,178,180,401,417,1176,687,605,2044,2228,5564
84,Niger,2021,NER-21/NI_CBPF_RHPF/SA/E-P/INGO/20177,2/13/2023 12:19:39 PM,Internally Displaced People,1072,1079,2405,2503,7059,1223,1275,2018,1921,6437
84,Niger,2021,NER-21/NI_CBPF_RHPF/SA/E-P/INGO/20177,2/13/2023 12:19:39 PM,Overall,1786,1799,4008,4172,11765,1910,1880,4991,5233,14014
84,Niger,2021,NER-21/NI_CBPF_RHPF/SA/E-P/INGO/20177,2/13/2023 12:19:39 PM,Returnees,536,540,1202,1252,3530,0,0,929,1084,2013
84,Niger,2021,NER-21/NI_CBPF_RHPF/SA/FS/INGO/20184,1/10/2023 9:46:55 AM,Host Communities,320,480,1280,1920,4000,280,175,1120,700,2275
84,Niger,2021,NER-21/NI_CBPF_RHPF/SA/FS/INGO/20184,1/10/2023 9:46:55 AM,Internally Displaced People,40,60,160,240,500,124,76,4,4,208
84,Niger,2021,NER-21/NI_CBPF_RHPF/SA/FS/INGO/20184,1/10/2023 9:46:55 AM,Overall,360,540,1440,2160,4500,404,251,1124,704,2483
84,Niger,2021,NER-21/NI_CBPF_RHPF/SA/FS/INGO/20203,9/29/2022 12:06:15 PM,Host Communities,13432,12777,13187,12544,51940,1831,1984,1798,1947,7560
84,Niger,2021,NER-21/NI_CBPF_RHPF/SA/FS/INGO/20203,9/29/2022 12:06:15 PM,Internally Displaced People,5756,5476,5652,5376,22260,213,232,210,227,882
84,Niger,2021,NER-21/NI_CBPF_RHPF/SA/FS/INGO/20203,9/29/2022 12:06:15 PM,Overall,19188,18253,18839,17920,74200,2044,2216,2008,2174,8442
84,Niger,2021,NER-21/NI_CBPF_RHPF/SA/FS/NGO/20183,6/13/2023 3:28:38 PM,Host Communities,551,585,806,856,2798,663,596,868,1804,3931
84,Niger,2021,NER-21/NI_CBPF_RHPF/SA/FS/NGO/20183,6/13/2023 3:28:38 PM,Internally Displaced People,138,147,202,215,702,149,138,154,355,796
84,Niger,2021,NER-21/NI_CBPF_RHPF/SA/FS/NGO/20183,6/13/2023 3:28:38 PM,Overall,689,732,1008,1071,3500,812,734,1022,2159,4727
84,Niger,2021,NER-21/NI_CBPF_RHPF/SA/FS-W-NUT/INGO/20211,9/21/2022 1:55:49 PM,Host Communities,6966,6790,7001,6504,27261,563,990,11486,9031,22070
84,Niger,2021,NER-21/NI_CBPF_RHPF/SA/FS-W-NUT/INGO/20211,9/21/2022 1:55:49 PM,Internally Displaced People,680,1109,2448,2419,6656,716,980,14775,12927,29398
84,Niger,2021,NER-21/NI_CBPF_RHPF/SA/FS-W-NUT/INGO/20211,9/21/2022 1:55:49 PM,Other,507,494,509,473,1983,66,96,701,1086,1949
84,Niger,2021,NER-21/NI_CBPF_RHPF/SA/FS-W-NUT/INGO/20211,9/21/2022 1:55:49 PM,Overall,8717,9314,11990,11403,41424,1535,2386,27741,25912,57574
84,Niger,2021,NER-21/NI_CBPF_RHPF/SA/FS-W-NUT/INGO/20211,9/21/2022 1:55:49 PM,Returnees,564,921,2032,2007,5524,190,320,779,2868,4157
84,Niger,2021,NER-21/NI_CBPF_RHPF/SA/H/INGO/20188,1/12/2023 9:00:54 AM,Host Communities,14320,14906,3580,4001,36807,6616,13490,20027,24019,64152
84,Niger,2021,NER-21/NI_CBPF_RHPF/SA/H/INGO/20188,1/12/2023 9:00:54 AM,Internally Displaced People,3187,3317,797,892,8193,726,1492,2225,2669,7112
84,Niger,2021,NER-21/NI_CBPF_RHPF/SA/H/INGO/20188,1/12/2023 9:00:54 AM,Overall,17507,18223,4377,4893,45000,7342,14982,22252,26688,71264
84,Niger,2021,NER-21/NI_CBPF_RHPF/SA/H/INGO/20194,2/13/2023 9:22:05 AM,Host Communities,3784,4100,5710,6186,19780,15809,20376,10195,10941,57321
84,Niger,2021,NER-21/NI_CBPF_RHPF/SA/H/INGO/20194,2/13/2023 9:22:05 AM,Internally Displaced People,794,860,1197,1297,4148,9451,12838,6490,6977,35756
84,Niger,2021,NER-21/NI_CBPF_RHPF/SA/H/INGO/20194,2/13/2023 9:22:05 AM,Overall,5216,6794,9549,10345,31904,28665,39561,20382,21873,110481
84,Niger,2021,NER-21/NI_CBPF_RHPF/SA/H/INGO/20194,2/13/2023 9:22:05 AM,Refugees,638,1834,2642,2862,7976,3405,6347,3697,3955,17404
84,Niger,2021,NER-21/NI_CBPF_RHPF/SA/H-NUT-GBV/INGO/20167,1/4/2023 10:29:33 AM,Host Communities,2988,3118,3428,3569,13103,3446,6696,3638,8726,22506
84,Niger,2021,NER-21/NI_CBPF_RHPF/SA/H-NUT-GBV/INGO/20167,1/4/2023 10:29:33 AM,Internally Displaced People,108,113,124,129,474,110,105,152,172,539
84,Niger,2021,NER-21/NI_CBPF_RHPF/SA/H-NUT-GBV/INGO/20167,1/4/2023 10:29:33 AM,Overall,3096,3231,3552,3698,13577,3556,6801,3790,8898,23045
84,Niger,2021,NER-21/NI_CBPF_RHPF/SA/H-S-GBV/NGO/20170,1/9/2023 8:50:53 AM,Host Communities,711,732,630,752,2825,711,732,630,752,2825
84,Niger,2021,NER-21/NI_CBPF_RHPF/SA/H-S-GBV/NGO/20170,1/9/2023 8:50:53 AM,Internally Displaced People,6312,7864,4488,8024,26688,6312,7864,4488,8024,26688
84,Niger,2021,NER-21/NI_CBPF_RHPF/SA/H-S-GBV/NGO/20170,1/9/2023 8:50:53 AM,Overall,7885,10085,6373,10691,35034,7885,10085,6373,10691,35034
84,Niger,2021,NER-21/NI_CBPF_RHPF/SA/H-S-GBV/NGO/20170,1/9/2023 8:50:53 AM,Returnees,862,1489,1255,1915,5521,862,1489,1255,1915,5521
84,Niger,2021,NER-21/NI_CBPF_RHPF/SA/NUT-S/INGO/20192,4/20/2023 2:23:22 PM,Host Communities,844,913,1805,1955,5517,1413,14653,3735,3516,23317
84,Niger,2021,NER-21/NI_CBPF_RHPF/SA/NUT-S/INGO/20192,4/20/2023 2:23:22 PM,Internally Displaced People,201,219,115,125,660,13,2,0,0,15
84,Niger,2021,NER-21/NI_CBPF_RHPF/SA/NUT-S/INGO/20192,4/20/2023 2:23:22 PM,Overall,3360,3640,1920,2080,11000,1426,14655,3735,3516,23332
84,Niger,2021,NER-21/NI_CBPF_RHPF/SA/NUT-S/INGO/20192,4/20/2023 2:23:22 PM,Refugees,2315,2508,0,0,4823,0,0,0,0,0
84,Niger,2021,NER-21/NI_CBPF_RHPF/SA/NUT-S-H/INGO/20185,1/23/2023 10:47:14 AM,Host Communities,5886,5919,2322,2416,16543,6550,7512,2952,3217,20231
84,Niger,2021,NER-21/NI_CBPF_RHPF/SA/NUT-S-H/INGO/20185,1/23/2023 10:47:14 AM,Internally Displaced People,7788,8105,4381,4392,24666,8006,9181,3609,3931,24727
84,Niger,2021,NER-21/NI_CBPF_RHPF/SA/NUT-S-H/INGO/20185,1/23/2023 10:47:14 AM,Overall,13674,14024,6703,6808,41209,14556,16693,6561,7148,44958
84,Niger,2021,NER-21/NI_CBPF_RHPF/SA/P-CP/INGO/20175,10/20/2022 10:36:50 AM,Host Communities,12068,12561,13074,13607,51310,13834,17156,11042,8624,50656
84,Niger,2021,NER-21/NI_CBPF_RHPF/SA/P-CP/INGO/20175,10/20/2022 10:36:50 AM,Internally Displaced People,3448,3589,3735,3888,14660,5027,4678,6294,5740,21739
84,Niger,2021,NER-21/NI_CBPF_RHPF/SA/P-CP/INGO/20175,10/20/2022 10:36:50 AM,Overall,17240,17944,18677,19439,73300,18960,21892,17634,14466,72952
84,Niger,2021,NER-21/NI_CBPF_RHPF/SA/P-CP/INGO/20175,10/20/2022 10:36:50 AM,Refugees,1724,1794,1868,1944,7330,99,58,298,102,557
84,Niger,2021,NER-21/NI_CBPF_RHPF/SA/S-FS/INGO/20189,12/27/2022 11:50:18 AM,Host Communities,658,742,0,0,1400,500,589,0,0,1089
84,Niger,2021,NER-21/NI_CBPF_RHPF/SA/S-FS/INGO/20189,12/27/2022 11:50:18 AM,Internally Displaced People,1026,1156,0,0,2182,1962,2147,0,0,4109
84,Niger,2021,NER-21/NI_CBPF_RHPF/SA/S-FS/INGO/20189,12/27/2022 11:50:18 AM,Overall,3294,3706,0,0,7000,2908,3250,0,0,6158
84,Niger,2021,NER-21/NI_CBPF_RHPF/SA/S-FS/INGO/20189,12/27/2022 11:50:18 AM,Refugees,1264,1424,0,0,2688,303,366,0,0,669
84,Niger,2021,NER-21/NI_CBPF_RHPF/SA/S-FS/INGO/20189,12/27/2022 11:50:18 AM,Returnees,346,384,0,0,730,143,148,0,0,291
84,Niger,2021,NER-21/NI_CBPF_RHPF/SA/W/INGO/20193,10/11/2022 10:02:26 AM,Host Communities,984,1032,1314,1361,4691,1426,1938,1643,1488,6495
84,Niger,2021,NER-21/NI_CBPF_RHPF/SA/W/INGO/20193,10/11/2022 10:02:26 AM,Internally Displaced People,651,684,870,901,3106,649,508,861,897,2915
84,Niger,2021,NER-21/NI_CBPF_RHPF/SA/W/INGO/20193,10/11/2022 10:02:26 AM,Other,25,26,33,34,118,24,28,30,29,111
84,Niger,2021,NER-21/NI_CBPF_RHPF/SA/W/INGO/20193,10/11/2022 10:02:26 AM,Overall,2330,2445,3111,3223,11109,2751,3120,3394,3262,12527
84,Niger,2021,NER-21/NI_CBPF_RHPF/SA/W/INGO/20193,10/11/2022 10:02:26 AM,Refugees,605,635,808,837,2885,591,571,786,768,2716
84,Niger,2021,NER-21/NI_CBPF_RHPF/SA/W/INGO/20193,10/11/2022 10:02:26 AM,Returnees,65,68,86,90,309,61,75,74,80,290
84,Niger,2021,NER-21/NI_CBPF_RHPF/SA/W/INGO/20205,1/3/2023 9:24:42 AM,Host Communities,1000,1500,2300,2203,7003,1131,1301,1089,1232,4753
84,Niger,2021,NER-21/NI_CBPF_RHPF/SA/W/INGO/20205,1/3/2023 9:24:42 AM,Internally Displaced People,500,1000,1000,1150,3650,398,853,492,418,2161
84,Niger,2021,NER-21/NI_CBPF_RHPF/SA/W/INGO/20205,1/3/2023 9:24:42 AM,Overall,2000,2850,4300,4953,14103,1951,2697,2040,2163,8851
84,Niger,2021,NER-21/NI_CBPF_RHPF/SA/W/INGO/20205,1/3/2023 9:24:42 AM,Refugees,300,175,500,1000,1975,249,254,247,262,1012
84,Niger,2021,NER-21/NI_CBPF_RHPF/SA/W/INGO/20205,1/3/2023 9:24:42 AM,Returnees,200,175,500,600,1475,173,289,212,251,925
84,Niger,2021,NER-21/NI_CBPF_RHPF/SA/W/NGO/20168,8/25/2022 2:48:02 PM,Host Communities,1002,1303,532,642,3479,1812,1910,419,425,4566
84,Niger,2021,NER-21/NI_CBPF_RHPF/SA/W/NGO/20168,8/25/2022 2:48:02 PM,Internally Displaced People,1081,1582,507,548,3718,2109,2191,463,487,5250
84,Niger,2021,NER-21/NI_CBPF_RHPF/SA/W/NGO/20168,8/25/2022 2:48:02 PM,Other,186,193,0,0,379,27,26,0,0,53
84,Niger,2021,NER-21/NI_CBPF_RHPF/SA/W/NGO/20168,8/25/2022 2:48:02 PM,Overall,2269,3078,1039,1190,7576,3948,4127,882,912,9869
84,Niger,2021,NER-21/NI_CBPF_RHPF/SA/W-S/INGO/20179,1/9/2023 8:45:52 AM,Host Communities,4741,4874,2007,2107,13729,3365,4812,2715,4170,15062
84,Niger,2021,NER-21/NI_CBPF_RHPF/SA/W-S/INGO/20179,1/9/2023 8:45:52 AM,Internally Displaced People,3729,3126,1287,1658,9800,2055,2160,2949,3672,10836
84,Niger,2021,NER-21/NI_CBPF_RHPF/SA/W-S/INGO/20179,1/9/2023 8:45:52 AM,Overall,8470,8000,3294,3765,23529,5420,6972,5664,7842,25898
84,Niger,2021,NER-21/NI_CBPF_RHPF/SA/W-S/INGO/20208,9/6/2022 4:29:55 PM,Host Communities,443,428,424,410,1705,2301,2343,752,2024,7420
84,Niger,2021,NER-21/NI_CBPF_RHPF/SA/W-S/INGO/20208,9/6/2022 4:29:55 PM,Internally Displaced People,1774,1706,1704,1636,6820,3043,3092,2295,3390,11820
84,Niger,2021,NER-21/NI_CBPF_RHPF/SA/W-S/INGO/20208,9/6/2022 4:29:55 PM,Overall,2217,2134,2128,2046,8525,5344,5435,3047,5414,19240
84,Niger,2022,NER-22/NI_CBPF_RHPF/RA/CP-GBV/NGO/24184,10/19/2023 2:39:50 PM,Host Communities,195,272,229,255,951,436,892,568,656,2552
84,Niger,2022,NER-22/NI_CBPF_RHPF/RA/CP-GBV/NGO/24184,10/19/2023 2:39:50 PM,Internally Displaced People,586,816,686,765,2853,542,1219,547,617,2925
84,Niger,2022,NER-22/NI_CBPF_RHPF/RA/CP-GBV/NGO/24184,10/19/2023 2:39:50 PM,Overall,781,1088,915,1020,3804,978,2111,1115,1273,5477
84,Niger,2022,NER-22/NI_CBPF_RHPF/RA/CP-GBV-FS/INGO/24234,10/19/2023 9:27:39 AM,Host Communities,854,885,828,837,3404,854,885,828,837,3404
84,Niger,2022,NER-22/NI_CBPF_RHPF/RA/CP-GBV-FS/INGO/24234,10/19/2023 9:27:39 AM,Internally Displaced People,520,595,620,683,2418,520,595,620,683,2418
84,Niger,2022,NER-22/NI_CBPF_RHPF/RA/CP-GBV-FS/INGO/24234,10/19/2023 9:27:39 AM,Overall,1676,1745,1720,1810,6951,1676,1745,1720,1810,6951
84,Niger,2022,NER-22/NI_CBPF_RHPF/RA/CP-GBV-FS/INGO/24234,10/19/2023 9:27:39 AM,Refugees,171,178,136,145,630,171,178,136,145,630
84,Niger,2022,NER-22/NI_CBPF_RHPF/RA/CP-GBV-FS/INGO/24234,10/19/2023 9:27:39 AM,Returnees,131,87,136,145,499,131,87,136,145,499
84,Niger,2022,NER-22/NI_CBPF_RHPF/RA/FS/INGO/24185,9/19/2023 4:35:50 PM,Host Communities,188,250,782,1126,2346,376,843,731,1462,3412
84,Niger,2022,NER-22/NI_CBPF_RHPF/RA/FS/INGO/24185,9/19/2023 4:35:50 PM,Internally Displaced People,26,38,104,156,324,38,132,102,204,476
84,Niger,2022,NER-22/NI_CBPF_RHPF/RA/FS/INGO/24185,9/19/2023 4:35:50 PM,Overall,262,400,936,1402,3000,447,1053,899,1799,4198
84,Niger,2022,NER-22/NI_CBPF_RHPF/RA/FS/INGO/24185,9/19/2023 4:35:50 PM,Returnees,48,112,50,120,330,33,78,66,133,310
84,Niger,2022,NER-22/NI_CBPF_RHPF/RA/FS-NUT/NGO/24186,9/13/2023 9:41:11 AM,Host Communities,1190,3130,1981,1799,8100,989,2638,1649,1319,6595
84,Niger,2022,NER-22/NI_CBPF_RHPF/RA/FS-NUT/NGO/24186,9/13/2023 9:41:11 AM,Internally Displaced People,1785,4595,2839,2581,11800,1685,4494,2808,2247,11234
84,Niger,2022,NER-22/NI_CBPF_RHPF/RA/FS-NUT/NGO/24186,9/13/2023 9:41:11 AM,Overall,2975,7725,4820,4380,19900,2674,7132,4457,3566,17829
84,Niger,2022,NER-22/NI_CBPF_RHPF/RA/FS-W/INGO/24249,10/16/2023 9:26:21 AM,Host Communities,1521,1571,2008,1971,7071,1702,1806,2003,2024,7535
84,Niger,2022,NER-22/NI_CBPF_RHPF/RA/FS-W/INGO/24249,10/16/2023 9:26:21 AM,Internally Displaced People,63,66,84,82,295,89,67,91,98,345
84,Niger,2022,NER-22/NI_CBPF_RHPF/RA/FS-W/INGO/24249,10/16/2023 9:26:21 AM,Overall,1584,1637,2092,2053,7366,1791,1873,2094,2122,7880
84,Niger,2022,NER-22/NI_CBPF_RHPF/RA/GBV-H-S/NGO/24173,10/18/2023 9:15:25 AM,Host Communities,446,809,1572,1768,4595,446,809,1572,1768,4595
84,Niger,2022,NER-22/NI_CBPF_RHPF/RA/GBV-H-S/NGO/24173,10/18/2023 9:15:25 AM,Internally Displaced People,1088,1102,1380,1932,5502,1088,1102,1380,1932,5502
84,Niger,2022,NER-22/NI_CBPF_RHPF/RA/GBV-H-S/NGO/24173,10/18/2023 9:15:25 AM,Overall,1534,1911,2952,3700,10097,1534,1911,2952,3700,10097
84,Niger,2022,NER-22/NI_CBPF_RHPF/RA/H/INGO/24254,9/19/2023 4:27:10 PM,Host Communities,727,1033,1033,1402,4195,2898,4574,2398,2207,12077
84,Niger,2022,NER-22/NI_CBPF_RHPF/RA/H/INGO/24254,9/19/2023 4:27:10 PM,Internally Displaced People,770,942,942,1151,3805,2628,4148,2175,2001,10952
84,Niger,2022,NER-22/NI_CBPF_RHPF/RA/H/INGO/24254,9/19/2023 4:27:10 PM,Overall,1497,1975,1975,2553,8000,5526,8722,4573,4208,23029
84,Niger,2022,NER-22/NI_CBPF_RHPF/RA/H-NUT/INGO/24178,9/12/2023 10:27:52 AM,Host Communities,825,2727,2662,2770,8984,8558,11578,7925,8852,36913
84,Niger,2022,NER-22/NI_CBPF_RHPF/RA/H-NUT/INGO/24178,9/12/2023 10:27:52 AM,Internally Displaced People,216,714,697,725,2352,2311,2848,1143,1371,7673
84,Niger,2022,NER-22/NI_CBPF_RHPF/RA/H-NUT/INGO/24178,9/12/2023 10:27:52 AM,Overall,1041,3441,3359,3495,11336,10869,14426,9068,10223,44586
84,Niger,2022,NER-22/NI_CBPF_RHPF/RA/H-NUT/INGO/24214,9/21/2023 3:48:26 PM,Host Communities,2178,2351,573,630,5732,12829,14660,7773,9510,44772
84,Niger,2022,NER-22/NI_CBPF_RHPF/RA/H-NUT/INGO/24214,9/21/2023 3:48:26 PM,Internally Displaced People,27,29,7,8,71,1670,1940,1021,1249,5880
84,Niger,2022,NER-22/NI_CBPF_RHPF/RA/H-NUT/INGO/24214,9/21/2023 3:48:26 PM,Overall,3039,3281,800,879,7999,18341,21067,11143,13633,64184
84,Niger,2022,NER-22/NI_CBPF_RHPF/RA/H-NUT/INGO/24214,9/21/2023 3:48:26 PM,Refugees,834,901,220,241,2196,3842,4467,2349,2874,13532
84,Niger,2022,NER-22/NI_CBPF_RHPF/RA/S/INGO/24199,9/12/2023 10:24:49 AM,Host Communities,1143,1238,1713,1856,5950,1180,1278,1770,1918,6146
84,Niger,2022,NER-22/NI_CBPF_RHPF/RA/S/INGO/24199,9/12/2023 10:24:49 AM,Overall,1143,1238,1713,1856,5950,1180,1278,1770,1918,6146
84,Niger,2022,NER-22/NI_CBPF_RHPF/RA/W/NGO/24174,8/24/2023 11:01:58 AM,Host Communities,1742,2671,606,981,6000,742,1067,2282,2435,6526
84,Niger,2022,NER-22/NI_CBPF_RHPF/RA/W/NGO/24174,8/24/2023 11:01:58 AM,Overall,1742,2671,606,981,6000,742,1067,2282,2435,6526
84,Niger,2022,NER-22/NI_CBPF_RHPF/RA/W/NGO/24189,9/14/2023 3:53:23 PM,Host Communities,500,700,900,1545,3645,981,929,929,1608,4447
84,Niger,2022,NER-22/NI_CBPF_RHPF/RA/W/NGO/24189,9/14/2023 3:53:23 PM,Internally Displaced People,750,1500,980,1125,4355,1111,2435,1018,1840,6404
84,Niger,2022,NER-22/NI_CBPF_RHPF/RA/W/NGO/24189,9/14/2023 3:53:23 PM,Overall,1250,2200,1880,2670,8000,2092,3364,1947,3448,10851
84,Niger,2022,NER-22/NI_CBPF_RHPF/RA/W-S/INGO/24198,10/16/2023 8:59:53 AM,Host Communities,498,524,778,752,2552,810,1064,1371,1588,4833
84,Niger,2022,NER-22/NI_CBPF_RHPF/RA/W-S/INGO/24198,10/16/2023 8:59:53 AM,Internally Displaced People,1990,2092,3114,3012,10208,3243,4255,5482,6356,19336
84,Niger,2022,NER-22/NI_CBPF_RHPF/RA/W-S/INGO/24198,10/16/2023 8:59:53 AM,Overall,2488,2616,3892,3764,12760,4053,5319,6853,7944,24169
75,Nigeria,2017,NGA-17/NIG_ERF/SA/ET/UN/6397,1/31/2019 11:04:44 AM,Other,20,0,0,0,20,0,0,0,0,0
75,Nigeria,2017,NGA-17/NIG_ERF/SA/ET/UN/6397,1/31/2019 11:04:44 AM,Overall,20,0,0,0,20,62,0,0,0,62
75,Nigeria,2017,NGA-17/NIG_ERF/SA/H/NGO/6408,9/28/2018 6:11:24 PM,Host Communities,0,10000,0,10000,20000,2930,19968,1959,13210,38067
75,Nigeria,2017,NGA-17/NIG_ERF/SA/H/NGO/6408,9/28/2018 6:11:24 PM,Internally Displaced People,0,500,0,500,1000,802,5994,386,3880,11062
75,Nigeria,2017,NGA-17/NIG_ERF/SA/H/NGO/6408,9/28/2018 6:11:24 PM,Overall,0,10500,0,10500,21000,3732,25962,2345,17090,49129
75,Nigeria,2017,NGA-17/NIG_ERF/SA/H/UN/6411,3/13/2018 1:16:54 PM,Host Communities,0,0,334815,334815,669630,0,0,476324,453634,929958
75,Nigeria,2017,NGA-17/NIG_ERF/SA/H/UN/6411,3/13/2018 1:16:54 PM,Internally Displaced People,0,0,223211,223211,446422,0,0,152245,146275,298520
75,Nigeria,2017,NGA-17/NIG_ERF/SA/H/UN/6411,3/13/2018 1:16:54 PM,Overall,0,0,558026,558026,1116052,0,0,629221,599257,1228478
75,Nigeria,2017,NGA-17/NIG_ERF/SA/H/UN/6422,1/3/2019 10:45:02 PM,Internally Displaced People,0,0,0,0,0,8941,58385,17880,32154,117360
75,Nigeria,2017,NGA-17/NIG_ERF/SA/H/UN/6422,1/3/2019 10:45:02 PM,Overall,16450,35626,18650,23450,94176,8941,58385,17880,32154,117360
75,Nigeria,2017,NGA-17/NIG_ERF/SA/LOG/UN/6403,8/19/2019 8:55:41 AM,Other,290,92,0,0,382,354,0,0,0,354
75,Nigeria,2017,NGA-17/NIG_ERF/SA/LOG/UN/6403,8/19/2019 8:55:41 AM,Overall,290,92,0,0,382,127,127,0,0,254
75,Nigeria,2017,NGA-17/NIG_ERF/SA/LOG/UN/6405,1/31/2019 10:20:10 AM,Overall,5,0,0,0,5,5,0,0,0,5
75,Nigeria,2017,NGA-17/NIG_ERF/SA/P/UN/6419,9/20/2023 3:31:07 PM,Host Communities,500,700,1000,1000,3200,0,0,0,0,0
75,Nigeria,2017,NGA-17/NIG_ERF/SA/P/UN/6419,9/20/2023 3:31:07 PM,Internally Displaced People,400,1000,1500,2000,4900,800,1700,2400,2800,7700
75,Nigeria,2017,NGA-17/NIG_ERF/SA/P/UN/6419,9/20/2023 3:31:07 PM,Overall,900,1700,2500,3000,8100,800,1700,2400,2800,7700
75,Nigeria,2017,NGA-17/NIG_ERF/SA/P/UN/6423,1/3/2019 11:10:27 AM,Internally Displaced People,4106,44347,32850,8212,89515,5324,73033,45381,75392,199130
75,Nigeria,2017,NGA-17/NIG_ERF/SA/P/UN/6423,1/3/2019 11:10:27 AM,Overall,4106,44347,32850,82120,163423,5324,73033,45381,75392,199130
75,Nigeria,2017,NGA-17/NIG_ERF/SA/S/NFI/INGO/6376,10/18/2018 4:05:13 PM,Internally Displaced People,3814,4026,5932,7415,21187,3136,3950,5218,5407,17711
75,Nigeria,2017,NGA-17/NIG_ERF/SA/S/NFI/INGO/6376,10/18/2018 4:05:13 PM,Other,398,421,619,774,2212,326,395,604,549,1874
75,Nigeria,2017,NGA-17/NIG_ERF/SA/S/NFI/INGO/6376,10/18/2018 4:05:13 PM,Overall,4212,4447,6552,8189,23400,3462,4345,5822,5956,19585
75,Nigeria,2017,NGA-17/NIG_ERF/SA/S/NFI/INGO/6406,9/10/2018 11:04:55 AM,Host Communities,361,388,353,339,1441,214,398,440,336,1388
75,Nigeria,2017,NGA-17/NIG_ERF/SA/S/NFI/INGO/6406,9/10/2018 11:04:55 AM,Internally Displaced People,2380,2328,2299,2357,9364,2420,2746,4042,4358,13566
75,Nigeria,2017,NGA-17/NIG_ERF/SA/S/NFI/INGO/6406,9/10/2018 11:04:55 AM,Other,1077,954,874,690,3595,0,0,0,0,0
75,Nigeria,2017,NGA-17/NIG_ERF/SA/S/NFI/INGO/6406,9/10/2018 11:04:55 AM,Overall,3818,3670,3526,3386,14400,2634,3144,4482,4694,14954
75,Nigeria,2017,NGA-17/NIG_ERF/SA/S/NFI/UN/6427,7/12/2018 4:49:00 PM,Internally Displaced People,12450,14765,15925,19860,63000,17752,18962,15144,16662,68520
75,Nigeria,2017,NGA-17/NIG_ERF/SA/S/NFI/UN/6427,7/12/2018 4:49:00 PM,Overall,12450,14765,15925,19860,63000,17752,18962,15144,16662,68520
75,Nigeria,2017,NGA-17/NIG_ERF/SA/WASH/INGO/6420,10/29/2018 3:35:51 PM,Host Communities,500,1000,800,2000,4300,740,1376,1245,2109,5470
75,Nigeria,2017,NGA-17/NIG_ERF/SA/WASH/INGO/6420,10/29/2018 3:35:51 PM,Internally Displaced People,1320,2060,1100,2300,6780,1875,3079,2605,4211,11770
75,Nigeria,2017,NGA-17/NIG_ERF/SA/WASH/INGO/6420,10/29/2018 3:35:51 PM,Other,500,1000,400,1500,3400,461,973,749,1243,3426
75,Nigeria,2017,NGA-17/NIG_ERF/SA/WASH/INGO/6420,10/29/2018 3:35:51 PM,Overall,2320,4060,2320,5800,14500,3343,6588,3021,7714,20666
75,Nigeria,2017,NGA-17/NIG_ERF/SA/WASH/UN/6429,9/10/2018 1:23:31 PM,Host Communities,3460,3950,4110,4920,16440,1012,1188,1288,1512,5000
75,Nigeria,2017,NGA-17/NIG_ERF/SA/WASH/UN/6429,9/10/2018 1:23:31 PM,Internally Displaced People,15530,17750,18500,22190,73970,31813,37341,40500,47528,157182
75,Nigeria,2017,NGA-17/NIG_ERF/SA/WASH/UN/6429,9/10/2018 1:23:31 PM,Other,15530,17750,18490,22190,73960,0,0,0,0,0
75,Nigeria,2017,NGA-17/NIG_ERF/SA/WASH/UN/6429,9/10/2018 1:23:31 PM,Overall,34520,39450,41100,49300,164370,38370,43850,45670,54814,182704
75,Nigeria,2017,NGA-17/NIG_ERF/SA2/DMS/UN/7314,1/23/2019 7:45:10 AM,Internally Displaced People,20217,37276,27152,44932,129577,25113,30689,31916,39851,127569
75,Nigeria,2017,NGA-17/NIG_ERF/SA2/DMS/UN/7314,1/23/2019 7:45:10 AM,Overall,20217,37276,27152,44932,129577,25113,30689,31916,39851,127569
75,Nigeria,2017,NGA-17/NIG_ERF/SA2/DMS-S/NFI/INGO/6907,10/25/2018 1:06:18 PM,Internally Displaced People,7326,8264,8816,10594,35000,5398,6012,11644,11131,34185
75,Nigeria,2017,NGA-17/NIG_ERF/SA2/DMS-S/NFI/INGO/6907,10/25/2018 1:06:18 PM,Overall,7326,8264,8816,10594,35000,5398,6012,11644,11131,34185
75,Nigeria,2017,NGA-17/NIG_ERF/SA2/E/INGO/7297,1/30/2019 12:35:24 PM,Host Communities,126,166,2144,2144,4580,318,318,9125,9125,18886
75,Nigeria,2017,NGA-17/NIG_ERF/SA2/E/INGO/7297,1/30/2019 12:35:24 PM,Internally Displaced People,126,166,2144,2144,4580,0,0,0,0,0
75,Nigeria,2017,NGA-17/NIG_ERF/SA2/E/INGO/7297,1/30/2019 12:35:24 PM,Other,108,143,1837,1837,3925,0,0,0,0,0
75,Nigeria,2017,NGA-17/NIG_ERF/SA2/E/INGO/7297,1/30/2019 12:35:24 PM,Overall,360,475,6125,6125,13085,0,0,6875,6875,13750
75,Nigeria,2017,NGA-17/NIG_ERF/SA2/E/NGO/7148,1/14/2019 1:32:47 PM,Host Communities,60,20,0,0,80,56,24,2407,3557,6044
75,Nigeria,2017,NGA-17/NIG_ERF/SA2/E/NGO/7148,1/14/2019 1:32:47 PM,Internally Displaced People,0,0,2764,4207,6971,0,0,357,650,1007
75,Nigeria,2017,NGA-17/NIG_ERF/SA2/E/NGO/7148,1/14/2019 1:32:47 PM,Overall,60,20,2764,4207,7051,56,24,2764,4207,7051
75,Nigeria,2017,NGA-17/NIG_ERF/SA2/E/NGO/7307,1/18/2019 8:02:21 AM,Host Communities,30,30,0,0,60,42,18,0,0,60
75,Nigeria,2017,NGA-17/NIG_ERF/SA2/E/NGO/7307,1/18/2019 8:02:21 AM,Internally Displaced People,20,20,1800,2200,4040,26,14,2166,1834,4040
75,Nigeria,2017,NGA-17/NIG_ERF/SA2/E/NGO/7307,1/18/2019 8:02:21 AM,Overall,50,50,1800,2200,4100,68,32,2166,1834,4100
75,Nigeria,2017,NGA-17/NIG_ERF/SA2/E/UN/6925,6/19/2019 1:05:43 PM,Host Communities,151,151,7560,7560,15422,211,45,5326,5072,10654
75,Nigeria,2017,NGA-17/NIG_ERF/SA2/E/UN/6925,6/19/2019 1:05:43 PM,Internally Displaced People,101,101,5040,5040,10282,315,67,7990,7608,15980
75,Nigeria,2017,NGA-17/NIG_ERF/SA2/E/UN/6925,6/19/2019 1:05:43 PM,Overall,252,252,12600,12600,25704,526,112,13316,12680,26634
75,Nigeria,2017,NGA-17/NIG_ERF/SA2/H/UN/7211,5/28/2019 12:40:01 PM,Host Communities,122,134,122,177,555,5252,4993,3618,3364,17227
75,Nigeria,2017,NGA-17/NIG_ERF/SA2/H/UN/7211,5/28/2019 12:40:01 PM,Internally Displaced People,1910,2083,1910,2779,8682,1528,881,640,594,3643
75,Nigeria,2017,NGA-17/NIG_ERF/SA2/H/UN/7211,5/28/2019 12:40:01 PM,Overall,2032,2217,2032,2956,9237,6780,5874,4258,3958,20870
75,Nigeria,2017,NGA-17/NIG_ERF/SA2/H/UN/7243,4/23/2019 3:45:10 PM,Host Communities,9950,31150,15348,16414,72862,8110,11434,21691,22574,63809
75,Nigeria,2017,NGA-17/NIG_ERF/SA2/H/UN/7243,4/23/2019 3:45:10 PM,Internally Displaced People,9077,55839,37334,45630,147880,15468,24880,32298,33616,106262
75,Nigeria,2017,NGA-17/NIG_ERF/SA2/H/UN/7243,4/23/2019 3:45:10 PM,Overall,19027,86989,52682,62044,220742,23578,36315,53989,56190,170072
75,Nigeria,2017,NGA-17/NIG_ERF/SA2/H/UN/7253,5/28/2019 12:17:08 PM,Host Communities,8960,40320,17920,22400,89600,16954,29034,7464,21431,74883
75,Nigeria,2017,NGA-17/NIG_ERF/SA2/H/UN/7253,5/28/2019 12:17:08 PM,Internally Displaced People,3840,17280,7680,9600,38400,31870,32965,10381,27341,102557
75,Nigeria,2017,NGA-17/NIG_ERF/SA2/H/UN/7253,5/28/2019 12:17:08 PM,Overall,12800,57600,25600,32000,128000,20194,45147,29818,32554,127713
75,Nigeria,2017,NGA-17/NIG_ERF/SA2/N/UN/6888,11/13/2019 3:42:08 PM,Host Communities,0,0,413,397,810,0,0,37805,35855,73660
75,Nigeria,2017,NGA-17/NIG_ERF/SA2/N/UN/6888,11/13/2019 3:42:08 PM,Internally Displaced People,0,0,1653,1588,3241,0,0,30930,29335,60265
75,Nigeria,2017,NGA-17/NIG_ERF/SA2/N/UN/6888,11/13/2019 3:42:08 PM,Overall,0,0,2066,1985,4051,0,0,68735,65190,133925
75,Nigeria,2017,NGA-17/NIG_ERF/SA2/N/UN/7277,1/31/2019 4:57:15 PM,Host Communities,0,9413,12001,11531,32945,0,50773,42961,35542,129276
75,Nigeria,2017,NGA-17/NIG_ERF/SA2/N/UN/7277,1/31/2019 4:57:15 PM,Internally Displaced People,0,37651,48004,46122,131777,0,5642,4773,3949,14364
75,Nigeria,2017,NGA-17/NIG_ERF/SA2/N/UN/7277,1/31/2019 4:57:15 PM,Overall,0,47064,60006,57653,164723,0,56415,49682,47734,153831
75,Nigeria,2017,NGA-17/NIG_ERF/SA2/P/INGO/7278,2/8/2019 1:03:10 PM,Host Communities,10000,7500,5000,5000,27500,9276,8549,4418,4572,26815
75,Nigeria,2017,NGA-17/NIG_ERF/SA2/P/INGO/7278,2/8/2019 1:03:10 PM,Internally Displaced People,10000,7500,5000,5000,27500,12574,10751,6201,6241,35767
75,Nigeria,2017,NGA-17/NIG_ERF/SA2/P/INGO/7278,2/8/2019 1:03:10 PM,Other,0,0,0,0,0,2828,2254,1828,1790,8700
75,Nigeria,2017,NGA-17/NIG_ERF/SA2/P/INGO/7278,2/8/2019 1:03:10 PM,Overall,20000,15000,10000,10000,55000,24887,21830,12593,12703,72013
75,Nigeria,2017,NGA-17/NIG_ERF/SA2/P/INGO/7281,1/17/2019 4:05:46 PM,Host Communities,32,122,2250,2250,4654,1360,1660,1489,1427,5936
75,Nigeria,2017,NGA-17/NIG_ERF/SA2/P/INGO/7281,1/17/2019 4:05:46 PM,Internally Displaced People,51,196,3600,3600,7447,1723,1541,2783,2756,8803
75,Nigeria,2017,NGA-17/NIG_ERF/SA2/P/INGO/7281,1/17/2019 4:05:46 PM,Other,45,170,3150,3150,6515,1053,816,1763,1721,5353
75,Nigeria,2017,NGA-17/NIG_ERF/SA2/P/INGO/7281,1/17/2019 4:05:46 PM,Overall,128,488,9000,9000,18616,133,494,5373,5111,11111
75,Nigeria,2017,NGA-17/NIG_ERF/SA2/P/INGO/7306,5/28/2019 12:28:26 PM,Host Communities,352,529,431,646,1958,643,2612,323,1036,4614
75,Nigeria,2017,NGA-17/NIG_ERF/SA2/P/INGO/7306,5/28/2019 12:28:26 PM,Internally Displaced People,470,3133,548,3681,7832,671,3048,317,1260,5296
75,Nigeria,2017,NGA-17/NIG_ERF/SA2/P/INGO/7306,5/28/2019 12:28:26 PM,Overall,822,3662,979,4327,9790,1314,5660,640,2296,9910
75,Nigeria,2017,NGA-17/NIG_ERF/SA2/P/NGO/7140,1/18/2019 2:32:00 PM,Internally Displaced People,234,576,1368,2052,4230,368,502,1915,1600,4385
75,Nigeria,2017,NGA-17/NIG_ERF/SA2/P/NGO/7140,1/18/2019 2:32:00 PM,Overall,234,576,1368,2052,4230,368,502,1915,1600,4385
75,Nigeria,2017,NGA-17/NIG_ERF/SA2/P/NGO/7157,9/18/2018 3:11:35 PM,Host Communities,2060,3470,850,1821,8201,448,1244,552,1002,3246
75,Nigeria,2017,NGA-17/NIG_ERF/SA2/P/NGO/7157,9/18/2018 3:11:35 PM,Internally Displaced People,2000,3530,1300,1743,8573,7606,8331,3553,4255,23745
75,Nigeria,2017,NGA-17/NIG_ERF/SA2/P/NGO/7157,9/18/2018 3:11:35 PM,Overall,4060,7450,2150,3564,17224,8054,9575,4105,5257,26991
75,Nigeria,2017,NGA-17/NIG_ERF/SA2/P/UN/7260,2/24/2019 11:22:41 PM,Host Communities,830,717,990,810,3347,33395,129916,64148,94796,322255
75,Nigeria,2017,NGA-17/NIG_ERF/SA2/P/UN/7260,2/24/2019 11:22:41 PM,Internally Displaced People,2670,6859,2110,5690,17329,4364,17320,8477,14587,44748
75,Nigeria,2017,NGA-17/NIG_ERF/SA2/P/UN/7260,2/24/2019 11:22:41 PM,Overall,3500,7576,3100,6500,20676,36759,147236,72625,109383,366003
75,Nigeria,2017,NGA-17/NIG_ERF/SA2/RR/UN/6905,8/19/2019 9:28:33 AM,Host Communities,2892,3517,2580,4011,13000,8542,3461,3808,3947,19758
75,Nigeria,2017,NGA-17/NIG_ERF/SA2/RR/UN/6905,8/19/2019 9:28:33 AM,Internally Displaced People,0,0,0,0,0,1507,611,672,697,3487
75,Nigeria,2017,NGA-17/NIG_ERF/SA2/RR/UN/6905,8/19/2019 9:28:33 AM,Overall,2892,3517,2580,4011,13000,10049,4072,4480,4644,23245
75,Nigeria,2017,NGA-17/NIG_ERF/SA2/S/NFI/INGO/7249,9/28/2018 2:14:49 PM,Internally Displaced People,2512,2833,3023,3632,12000,2151,2611,3250,3077,11089
75,Nigeria,2017,NGA-17/NIG_ERF/SA2/S/NFI/INGO/7249,9/28/2018 2:14:49 PM,Overall,2512,2833,3023,3632,12000,2151,2611,3250,3077,11089
75,Nigeria,2017,NGA-17/NIG_ERF/SA2/S/NFI/NGO/7270,8/24/2018 10:30:13 AM,Host Communities,700,1750,700,1750,4900,700,1825,800,1960,5285
75,Nigeria,2017,NGA-17/NIG_ERF/SA2/S/NFI/NGO/7270,8/24/2018 10:30:13 AM,Internally Displaced People,300,750,300,750,2100,300,764,330,833,2227
75,Nigeria,2017,NGA-17/NIG_ERF/SA2/S/NFI/NGO/7270,8/24/2018 10:30:13 AM,Overall,1000,2500,1000,2500,7000,1000,2589,1130,2793,7512
75,Nigeria,2017,NGA-17/NIG_ERF/SA2/S/NFI-DMS/INGO/7304,1/16/2019 10:57:58 AM,Internally Displaced People,869,909,1028,1146,3952,1411,3014,2077,3981,10483
75,Nigeria,2017,NGA-17/NIG_ERF/SA2/S/NFI-DMS/INGO/7304,1/16/2019 10:57:58 AM,Other,217,227,256,286,986,375,455,567,694,2091
75,Nigeria,2017,NGA-17/NIG_ERF/SA2/S/NFI-DMS/INGO/7304,1/16/2019 10:57:58 AM,Overall,1087,1136,1284,1433,4940,1786,3469,2644,4675,12574
75,Nigeria,2017,NGA-17/NIG_ERF/SA2/WASH/INGO/7090,1/23/2019 11:27:20 AM,Host Communities,1963,2284,2638,3115,10000,4696,5464,6313,7455,23928
75,Nigeria,2017,NGA-17/NIG_ERF/SA2/WASH/INGO/7090,1/23/2019 11:27:20 AM,Internally Displaced People,5888,6850,7915,9347,30000,7656,8740,9690,11629,37715
75,Nigeria,2017,NGA-17/NIG_ERF/SA2/WASH/INGO/7090,1/23/2019 11:27:20 AM,Overall,7851,9134,10553,12462,40000,12352,14204,16003,19084,61643
75,Nigeria,2017,NGA-17/NIG_ERF/SA2/WASH/INGO/7284,12/27/2018 9:25:29 AM,Internally Displaced People,1636,1818,2732,2514,8700,1340,1324,2798,2420,7882
75,Nigeria,2017,NGA-17/NIG_ERF/SA2/WASH/INGO/7284,12/27/2018 9:25:29 AM,Overall,1636,1818,2732,2514,8700,1914,1892,3997,3457,11260
75,Nigeria,2017,NGA-17/NIG_ERF/SA2/WASH/UN/6910,6/10/2019 11:44:14 AM,Internally Displaced People,25880,30370,31620,37130,125000,88680,112596,113490,140291,455057
75,Nigeria,2017,NGA-17/NIG_ERF/SA2/WASH/UN/6910,6/10/2019 11:44:14 AM,Overall,25880,30370,31620,37130,125000,88711,112590,113481,140275,455057
75,Nigeria,2018,NGA-18/NIG_ERF/RA1/DMS-S/NFI/UN/8233,12/26/2019 10:50:12 PM,Internally Displaced People,4920,5389,7178,5943,23430,16742,19205,20786,23369,80102
75,Nigeria,2018,NGA-18/NIG_ERF/RA1/DMS-S/NFI/UN/8233,12/26/2019 10:50:12 PM,Overall,4920,5389,7178,5943,23430,16742,19205,20786,23369,80102
75,Nigeria,2018,NGA-18/NIG_ERF/RA1/H/INGO/8161,1/30/2019 4:13:36 PM,Host Communities,840,1349,3594,3309,9092,1326,3254,5002,4617,14199
75,Nigeria,2018,NGA-18/NIG_ERF/RA1/H/INGO/8161,1/30/2019 4:13:36 PM,Internally Displaced People,93,149,399,367,1008,147,361,556,513,1577
75,Nigeria,2018,NGA-18/NIG_ERF/RA1/H/INGO/8161,1/30/2019 4:13:36 PM,Overall,933,1498,3993,3676,10100,1473,3615,5558,5130,15776
75,Nigeria,2018,NGA-18/NIG_ERF/RA1/H/UN/8207,1/22/2019 10:32:27 AM,Host Communities,7139,6863,7825,7453,29280,11131,22243,3883,4206,41463
75,Nigeria,2018,NGA-18/NIG_ERF/RA1/H/UN/8207,1/22/2019 10:32:27 AM,Internally Displaced People,6113,5847,6816,6494,25270,4771,9533,1665,1803,17772
75,Nigeria,2018,NGA-18/NIG_ERF/RA1/H/UN/8207,1/22/2019 10:32:27 AM,Overall,13252,12710,14641,13947,54550,15902,31775,5548,6009,59234
75,Nigeria,2018,NGA-18/NIG_ERF/RA1/LOG/UN/8329,1/31/2019 12:21:10 PM,Other,6750,6750,0,0,13500,0,0,0,0,0
75,Nigeria,2018,NGA-18/NIG_ERF/RA1/LOG/UN/8329,1/31/2019 12:21:10 PM,Overall,6750,6750,0,0,13500,7705,7705,0,0,15410
75,Nigeria,2018,NGA-18/NIG_ERF/RA1/N/INGO/8143,1/15/2019 3:24:48 PM,Host Communities,0,4882,12347,10926,28155,0,7010,17727,16491,41228
75,Nigeria,2018,NGA-18/NIG_ERF/RA1/N/INGO/8143,1/15/2019 3:24:48 PM,Internally Displaced People,0,542,1371,1213,3126,0,779,1970,1832,4581
75,Nigeria,2018,NGA-18/NIG_ERF/RA1/N/INGO/8143,1/15/2019 3:24:48 PM,Overall,0,5424,13718,12139,31281,0,7787,19698,18324,45809
75,Nigeria,2018,NGA-18/NIG_ERF/RA1/N-H-WASH/INGO/8279,1/30/2019 3:37:13 PM,Host Communities,2098,8988,3281,3228,17595,11330,23775,8294,9116,52515
75,Nigeria,2018,NGA-18/NIG_ERF/RA1/N-H-WASH/INGO/8279,1/30/2019 3:37:13 PM,Internally Displaced People,3698,9384,2955,4029,20066,18936,40041,13907,15267,88151
75,Nigeria,2018,NGA-18/NIG_ERF/RA1/N-H-WASH/INGO/8279,1/30/2019 3:37:13 PM,Overall,5796,18372,6236,7257,37661,30266,63816,22201,24383,140666
75,Nigeria,2018,NGA-18/NIG_ERF/RA1/P/UN/8296,1/23/2019 10:36:25 AM,Internally Displaced People,3591,3064,5261,4087,16003,3094,3867,4088,4954,16003
75,Nigeria,2018,NGA-18/NIG_ERF/RA1/P/UN/8296,1/23/2019 10:36:25 AM,Overall,3591,3064,5261,4087,16003,3094,3867,4088,4954,16003
75,Nigeria,2018,NGA-18/NIG_ERF/RA1/P/UN/8716,10/19/2018 9:48:18 AM,Internally Displaced People,0,0,0,0,0,1569,2320,1706,2115,7710
75,Nigeria,2018,NGA-18/NIG_ERF/RA1/P/UN/8716,10/19/2018 9:48:18 AM,Overall,1569,2320,1706,2115,7710,1569,2320,1706,2115,7710
75,Nigeria,2018,NGA-18/NIG_ERF/RA1/P/UN/8768,11/6/2018 8:57:17 AM,Overall,1300,2190,3050,3460,10000,1706,2790,3259,3760,11515
75,Nigeria,2018,NGA-18/NIG_ERF/RA1/S/NFI/INGO/8150,1/22/2019 4:47:13 PM,Host Communities,20,0,0,0,20,0,0,0,0,0
75,Nigeria,2018,NGA-18/NIG_ERF/RA1/S/NFI/INGO/8150,1/22/2019 4:47:13 PM,Internally Displaced People,1827,1902,2720,2830,9279,2952,3058,2993,2715,11718
75,Nigeria,2018,NGA-18/NIG_ERF/RA1/S/NFI/INGO/8150,1/22/2019 4:47:13 PM,Overall,1847,1902,2720,2830,9299,2952,3058,2993,2715,11718
75,Nigeria,2018,NGA-18/NIG_ERF/RA1/S/NFI/UN/8307,1/30/2019 4:22:18 PM,Internally Displaced People,627,737,799,937,3100,1815,1749,2087,2449,8100
75,Nigeria,2018,NGA-18/NIG_ERF/RA1/S/NFI/UN/8307,1/30/2019 4:22:18 PM,Other,594,506,644,756,2500,0,0,0,0,0
75,Nigeria,2018,NGA-18/NIG_ERF/RA1/S/NFI/UN/8307,1/30/2019 4:22:18 PM,Overall,1221,1243,1443,1693,5600,1815,1749,2087,2449,8100
75,Nigeria,2018,NGA-18/NIG_ERF/RA1/S/NFI-DMS/INGO/8244,1/18/2019 10:29:26 AM,Internally Displaced People,5250,5750,6250,7750,25000,7219,7869,7203,6884,29175
75,Nigeria,2018,NGA-18/NIG_ERF/RA1/S/NFI-DMS/INGO/8244,1/18/2019 10:29:26 AM,Overall,5250,5750,6250,7750,25000,7219,7869,7203,6883,29174
75,Nigeria,2018,NGA-18/NIG_ERF/RA1/WASH/INGO/8642,1/22/2019 1:11:03 PM,Host Communities,1295,1507,1741,2057,6600,765,885,939,873,3462
75,Nigeria,2018,NGA-18/NIG_ERF/RA1/WASH/INGO/8642,1/22/2019 1:11:03 PM,Internally Displaced People,1060,1233,1424,1683,5400,1249,1443,1532,1425,5649
75,Nigeria,2018,NGA-18/NIG_ERF/RA1/WASH/INGO/8642,1/22/2019 1:11:03 PM,Overall,2355,2740,3165,3740,12000,2014,2328,2471,2298,9111
75,Nigeria,2018,NGA-18/NIG_ERF/RA1/WASH/UN/8175,8/9/2018 4:59:20 PM,Internally Displaced People,2197,2935,4768,5877,15777,2190,2940,4770,5880,15780
75,Nigeria,2018,NGA-18/NIG_ERF/RA1/WASH/UN/8175,8/9/2018 4:59:20 PM,Overall,2197,2935,4768,5877,15777,4858,5702,6182,7258,24000
75,Nigeria,2018,NGA-18/NIG_ERF/RA1/WASH/UN/8652,6/19/2019 7:06:20 PM,Overall,2197,2935,4768,5877,15777,10918,17683,4632,6809,40042
75,Nigeria,2018,NGA-18/NIG_ERF/RA2/H/UN/9212,2/24/2019 8:11:58 PM,Host Communities,1067781,1192665,1175567,1114065,4550078,1281554,1427464,1383291,1313378,5405687
75,Nigeria,2018,NGA-18/NIG_ERF/RA2/H/UN/9212,2/24/2019 8:11:58 PM,Internally Displaced People,283841,317037,312493,296144,1209515,71511,84107,107402,99034,362054
75,Nigeria,2018,NGA-18/NIG_ERF/RA2/H/UN/9212,2/24/2019 8:11:58 PM,Overall,1351622,1509702,1488060,1410209,5759593,1353219,1511577,1490453,1412418,5767667
75,Nigeria,2018,NGA-18/NIG_ERF/RA2/WASH/INGO/9211,1/15/2019 3:10:31 PM,Host Communities,9968,11340,15866,10396,47570,1987,2437,3186,2063,9673
75,Nigeria,2018,NGA-18/NIG_ERF/RA2/WASH/INGO/9211,1/15/2019 3:10:31 PM,Internally Displaced People,2493,2835,3967,2599,11894,1074,1431,1943,1531,5979
75,Nigeria,2018,NGA-18/NIG_ERF/RA2/WASH/INGO/9211,1/15/2019 3:10:31 PM,Overall,12461,14175,19833,12995,59464,33263,22600,30296,21300,107459
75,Nigeria,2018,NGA-18/NIG_ERF/RA2/WASH/UN/9213,6/18/2019 2:06:35 PM,Host Communities,25528,37381,29080,29986,121975,33790,74215,35590,36360,179955
75,Nigeria,2018,NGA-18/NIG_ERF/RA2/WASH/UN/9213,6/18/2019 2:06:35 PM,Internally Displaced People,3032,3419,3560,4014,14025,0,0,0,0,0
75,Nigeria,2018,NGA-18/NIG_ERF/RA2/WASH/UN/9213,6/18/2019 2:06:35 PM,Overall,28560,40800,32640,34000,136000,33790,74215,35590,36360,179955
75,Nigeria,2018,NGA-18/NIG_ERF/RA3/DMS/UN/9430,6/19/2019 12:44:09 PM,Internally Displaced People,839,3355,1677,2516,8387,5122,6309,5216,5543,22190
75,Nigeria,2018,NGA-18/NIG_ERF/RA3/DMS/UN/9430,6/19/2019 12:44:09 PM,Overall,839,3355,1677,2516,8387,5122,6309,5216,5543,22190
75,Nigeria,2018,NGA-18/NIG_ERF/RA3/E/UN/9442,11/13/2019 4:21:40 PM,Host Communities,40,40,2000,2000,4080,67,42,2760,2278,5147
75,Nigeria,2018,NGA-18/NIG_ERF/RA3/E/UN/9442,11/13/2019 4:21:40 PM,Internally Displaced People,75,75,4000,4000,8150,138,55,3826,3113,7132
75,Nigeria,2018,NGA-18/NIG_ERF/RA3/E/UN/9442,11/13/2019 4:21:40 PM,Overall,115,115,6000,6000,12230,205,97,6586,5391,12279
75,Nigeria,2018,NGA-18/NIG_ERF/RA3/H/UN/9424,6/6/2019 11:36:17 AM,Host Communities,670,2100,1390,1100,5260,2002,9016,1809,7379,20206
75,Nigeria,2018,NGA-18/NIG_ERF/RA3/H/UN/9424,6/6/2019 11:36:17 AM,Internally Displaced People,1310,5470,260,4700,11740,0,0,0,0,0
75,Nigeria,2018,NGA-18/NIG_ERF/RA3/H/UN/9424,6/6/2019 11:36:17 AM,Overall,1980,7570,1650,5800,17000,1997,9014,1804,7374,20189
75,Nigeria,2018,NGA-18/NIG_ERF/RA3/H/UN/9441,7/23/2019 10:44:04 AM,Host Communities,5955,6165,1424,1455,14999,0,0,0,0,0
75,Nigeria,2018,NGA-18/NIG_ERF/RA3/H/UN/9441,7/23/2019 10:44:04 AM,Internally Displaced People,51610,53430,12350,12610,130000,23821,24667,5636,5813,59937
75,Nigeria,2018,NGA-18/NIG_ERF/RA3/H/UN/9441,7/23/2019 10:44:04 AM,Overall,57565,59595,13775,14065,145000,26223,27144,6205,6399,65971
75,Nigeria,2018,NGA-18/NIG_ERF/RA3/P/UN/9367,6/19/2019 11:54:50 AM,Host Communities,400,5000,250,2600,8250,0,0,0,0,0
75,Nigeria,2018,NGA-18/NIG_ERF/RA3/P/UN/9367,6/19/2019 11:54:50 AM,Internally Displaced People,900,9750,2200,6400,19250,488,15380,2309,10785,28962
75,Nigeria,2018,NGA-18/NIG_ERF/RA3/P/UN/9367,6/19/2019 11:54:50 AM,Overall,1300,14750,2450,9000,27500,487,15380,2309,10785,28961
75,Nigeria,2018,NGA-18/NIG_ERF/RA3/P/UN/9431,6/2/2023 6:55:18 PM,Host Communities,5000,6000,7200,7500,25700,8377,11208,2170,2729,24484
75,Nigeria,2018,NGA-18/NIG_ERF/RA3/P/UN/9431,6/2/2023 6:55:18 PM,Overall,7411,10649,13890,14353,46303,8377,11208,2170,2729,24484
75,Nigeria,2018,NGA-18/NIG_ERF/RA3/P/UN/9434,11/10/2020 1:18:20 PM,Host Communities,300,480,420,600,1800,600,1000,900,1400,3900
75,Nigeria,2018,NGA-18/NIG_ERF/RA3/P/UN/9434,11/10/2020 1:18:20 PM,Internally Displaced People,1200,1920,1680,2400,7200,900,1400,1200,1600,5100
75,Nigeria,2018,NGA-18/NIG_ERF/RA3/P/UN/9434,11/10/2020 1:18:20 PM,Overall,1500,2400,2100,3000,9000,1500,2400,2100,3000,9000
75,Nigeria,2018,NGA-18/NIG_ERF/RA3/WASH/UN/9440,6/10/2019 12:25:36 PM,Overall,24320,36911,22602,29780,113613,24346,34627,24616,29812,113401
75,Nigeria,2018,NGA-18/NIG_ERF/RA4/DMS/INGO/9608,5/27/2019 12:03:19 PM,Internally Displaced People,2504,2861,2854,3170,11389,2484,5631,3975,4140,16230
75,Nigeria,2018,NGA-18/NIG_ERF/RA4/DMS/INGO/9608,5/27/2019 12:03:19 PM,Other,217,227,256,286,986,0,0,0,0,0
75,Nigeria,2018,NGA-18/NIG_ERF/RA4/DMS/INGO/9608,5/27/2019 12:03:19 PM,Overall,2721,3088,3110,3456,12375,2484,5631,3975,4140,16230
75,Nigeria,2018,NGA-18/NIG_ERF/RA4/DMS-WASH-S/NFI/UN/9600,5/28/2019 9:25:03 AM,Internally Displaced People,14309,27341,24371,27600,93621,20485,26454,27213,33168,107320
75,Nigeria,2018,NGA-18/NIG_ERF/RA4/DMS-WASH-S/NFI/UN/9600,5/28/2019 9:25:03 AM,Overall,14309,27341,24371,27600,93621,20485,26454,27213,33168,107320
75,Nigeria,2018,NGA-18/NIG_ERF/RA4/H/INGO/9597,6/19/2019 1:30:25 PM,Host Communities,2925,4005,22473,20997,50400,4317,9149,23440,32198,69104
75,Nigeria,2018,NGA-18/NIG_ERF/RA4/H/INGO/9597,6/19/2019 1:30:25 PM,Internally Displaced People,325,445,2497,2333,5600,479,1016,23369,28954,53818
75,Nigeria,2018,NGA-18/NIG_ERF/RA4/H/INGO/9597,6/19/2019 1:30:25 PM,Overall,3250,4450,24970,23330,56000,4796,10165,46809,61153,122923
75,Nigeria,2018,NGA-18/NIG_ERF/RA4/H/UN/9598,6/25/2019 2:25:26 PM,Host Communities,0,15012,19396,23270,57678,0,47052,56412,65772,169236
75,Nigeria,2018,NGA-18/NIG_ERF/RA4/H/UN/9598,6/25/2019 2:25:26 PM,Internally Displaced People,0,60393,71009,82135,213537,0,11764,14103,16443,42310
75,Nigeria,2018,NGA-18/NIG_ERF/RA4/H/UN/9598,6/25/2019 2:25:26 PM,Overall,0,75405,90405,105405,271215,0,58816,70516,82216,211548
75,Nigeria,2018,NGA-18/NIG_ERF/RA4/H/UN/9601,6/18/2019 2:45:01 PM,Host Communities,1500,26864,1904,37305,67573,2501,40287,2605,49197,94590
75,Nigeria,2018,NGA-18/NIG_ERF/RA4/H/UN/9601,6/18/2019 2:45:01 PM,Internally Displaced People,700,12200,971,12086,25957,0,0,0,0,0
75,Nigeria,2018,NGA-18/NIG_ERF/RA4/H/UN/9601,6/18/2019 2:45:01 PM,Overall,2200,39064,2875,49391,93530,2501,40287,2605,49197,94590
75,Nigeria,2018,NGA-18/NIG_ERF/RA4/H/UN/9636,6/18/2019 11:11:41 AM,Host Communities,22333,25183,28456,29618,105590,19719,33308,32875,34218,120120
75,Nigeria,2018,NGA-18/NIG_ERF/RA4/H/UN/9636,6/18/2019 11:11:41 AM,Internally Displaced People,11525,12999,14688,15288,54500,8452,14275,14089,14665,51481
75,Nigeria,2018,NGA-18/NIG_ERF/RA4/H/UN/9636,6/18/2019 11:11:41 AM,Overall,33858,38182,43144,44906,160090,28171,47583,46964,48883,171601
75,Nigeria,2018,NGA-18/NIG_ERF/RA4/P/UN/9599,1/22/2020 11:27:42 AM,Host Communities,300,1500,1200,4500,7500,0,0,0,0,0
75,Nigeria,2018,NGA-18/NIG_ERF/RA4/P/UN/9599,1/22/2020 11:27:42 AM,Internally Displaced People,1100,3000,10000,10000,24100,9162,23614,9668,19987,62431
75,Nigeria,2018,NGA-18/NIG_ERF/RA4/P/UN/9599,1/22/2020 11:27:42 AM,Overall,1400,4500,11200,14500,31600,9162,23614,9668,19987,62431
75,Nigeria,2018,NGA-18/NIG_ERF/RA4/P/UN/9610,7/31/2019 9:38:51 AM,Internally Displaced People,7704,9629,10179,12338,39850,8520,10647,11256,13645,44068
75,Nigeria,2018,NGA-18/NIG_ERF/RA4/P/UN/9610,7/31/2019 9:38:51 AM,Overall,7704,9629,10179,12338,39850,8520,10647,11256,13645,44068
75,Nigeria,2018,NGA-18/NIG_ERF/RA4/S/NFI/UN/9612,12/26/2019 11:18:40 PM,Internally Displaced People,594,506,645,757,2502,1188,1012,1288,1512,5000
75,Nigeria,2018,NGA-18/NIG_ERF/RA4/S/NFI/UN/9612,12/26/2019 11:18:40 PM,Other,594,506,643,755,2498,0,0,0,0,0
75,Nigeria,2018,NGA-18/NIG_ERF/RA4/S/NFI/UN/9612,12/26/2019 11:18:40 PM,Overall,1188,1012,1288,1512,5000,1188,1012,1288,1512,5000
75,Nigeria,2018,NGA-18/NIG_ERF/RA4/WASH/INGO/9602,6/18/2019 1:04:37 PM,Overall,1304,1574,1748,2124,6750,1350,1620,1688,2092,6750
75,Nigeria,2018,NGA-18/NIG_ERF/RA4/WASH/UN/9603,6/18/2019 9:04:24 AM,Internally Displaced People,4350,5100,5310,6240,21000,2950,3270,3350,4030,13600
75,Nigeria,2018,NGA-18/NIG_ERF/RA4/WASH/UN/9603,6/18/2019 9:04:24 AM,Overall,4350,5100,5310,6240,21000,5850,10407,8920,10721,35898
75,Nigeria,2018,NGA-18/NIG_ERF/SA1/DMS/INGO/10864,1/8/2020 12:11:31 PM,Internally Displaced People,4130,4590,2814,3089,14623,1443,3251,3586,3836,12116
75,Nigeria,2018,NGA-18/NIG_ERF/SA1/DMS/INGO/10864,1/8/2020 12:11:31 PM,Other,1630,1790,1564,1639,6623,0,0,0,0,0
75,Nigeria,2018,NGA-18/NIG_ERF/SA1/DMS/INGO/10864,1/8/2020 12:11:31 PM,Overall,5760,6380,4378,4728,21246,1443,3251,3586,3836,12116
75,Nigeria,2018,NGA-18/NIG_ERF/SA1/DMS-S/NFI/INGO/10832,11/14/2019 4:48:47 PM,Internally Displaced People,9854,11255,15545,17715,54369,6817,8360,9413,10853,35443
75,Nigeria,2018,NGA-18/NIG_ERF/SA1/DMS-S/NFI/INGO/10832,11/14/2019 4:48:47 PM,Overall,9854,11255,15545,17715,54369,6817,8360,9413,10853,35443
75,Nigeria,2018,NGA-18/NIG_ERF/SA1/DMS-S/NFI/UN/10841,1/7/2020 4:28:14 PM,Internally Displaced People,29849,36482,43115,56381,165827,60356,76849,78247,94485,309937
75,Nigeria,2018,NGA-18/NIG_ERF/SA1/DMS-S/NFI/UN/10841,1/7/2020 4:28:14 PM,Overall,29849,36482,43115,56381,165827,60356,76849,78247,94485,309937
75,Nigeria,2018,NGA-18/NIG_ERF/SA1/E/INGO/10740,9/1/2020 12:45:10 PM,Host Communities,238,262,2000,2500,5000,73,66,872,877,1888
75,Nigeria,2018,NGA-18/NIG_ERF/SA1/E/INGO/10740,9/1/2020 12:45:10 PM,Internally Displaced People,238,262,2000,2500,5000,319,309,3932,4301,8861
75,Nigeria,2018,NGA-18/NIG_ERF/SA1/E/INGO/10740,9/1/2020 12:45:10 PM,Overall,476,524,4000,5000,10000,392,375,4804,5178,10749
75,Nigeria,2018,NGA-18/NIG_ERF/SA1/E/NGO/10709,3/19/2020 6:14:30 PM,Host Communities,30,30,0,0,60,450,700,0,0,1150
75,Nigeria,2018,NGA-18/NIG_ERF/SA1/E/NGO/10709,3/19/2020 6:14:30 PM,Internally Displaced People,0,0,3220,3780,7000,0,0,1650,2000,3650
75,Nigeria,2018,NGA-18/NIG_ERF/SA1/E/NGO/10709,3/19/2020 6:14:30 PM,Overall,30,30,3220,3780,7060,450,700,1650,2000,4800
75,Nigeria,2018,NGA-18/NIG_ERF/SA1/E/NGO/10751,1/8/2020 9:33:18 AM,Host Communities,30,20,0,0,50,41,14,94,80,229
75,Nigeria,2018,NGA-18/NIG_ERF/SA1/E/NGO/10751,1/8/2020 9:33:18 AM,Internally Displaced People,20,30,2300,2700,5050,24,36,2147,2382,4589
75,Nigeria,2018,NGA-18/NIG_ERF/SA1/E/NGO/10751,1/8/2020 9:33:18 AM,Overall,60,50,2300,2700,5110,65,50,2241,2462,4818
75,Nigeria,2018,NGA-18/NIG_ERF/SA1/E/UN/10875,4/2/2020 9:57:29 AM,Host Communities,81,44,8419,7733,16277,22,20,10295,9503,19840
75,Nigeria,2018,NGA-18/NIG_ERF/SA1/E/UN/10875,4/2/2020 9:57:29 AM,Internally Displaced People,57,31,5893,5413,11394,24,20,7198,6646,13888
75,Nigeria,2018,NGA-18/NIG_ERF/SA1/E/UN/10875,4/2/2020 9:57:29 AM,Other,24,13,2526,2320,4883,0,0,3095,2857,5952
75,Nigeria,2018,NGA-18/NIG_ERF/SA1/E/UN/10875,4/2/2020 9:57:29 AM,Overall,163,88,16838,15467,32556,46,40,20588,19006,39680
75,Nigeria,2018,NGA-18/NIG_ERF/SA1/E-P/INGO/10726,3/11/2020 4:26:12 PM,Host Communities,56,84,294,382,816,130,169,254,274,827
75,Nigeria,2018,NGA-18/NIG_ERF/SA1/E-P/INGO/10726,3/11/2020 4:26:12 PM,Internally Displaced People,126,189,662,860,1837,1055,2176,1425,1293,5949
75,Nigeria,2018,NGA-18/NIG_ERF/SA1/E-P/INGO/10726,3/11/2020 4:26:12 PM,Other,98,147,514,668,1427,0,0,0,0,0
75,Nigeria,2018,NGA-18/NIG_ERF/SA1/E-P/INGO/10726,3/11/2020 4:26:12 PM,Overall,280,420,1470,1910,4080,1185,2345,1679,1567,6776
75,Nigeria,2018,NGA-18/NIG_ERF/SA1/F/NGO/10710,12/27/2019 8:59:06 PM,Internally Displaced People,1436,1779,1179,1606,6000,691,1272,1100,1192,4255
75,Nigeria,2018,NGA-18/NIG_ERF/SA1/F/NGO/10710,12/27/2019 8:59:06 PM,Overall,1436,1779,1179,1606,6000,691,1272,1100,1192,4255
75,Nigeria,2018,NGA-18/NIG_ERF/SA1/F/NGO/10867,11/14/2019 8:34:04 AM,Host Communities,100,500,50,150,800,95,645,12,48,800
75,Nigeria,2018,NGA-18/NIG_ERF/SA1/F/NGO/10867,11/14/2019 8:34:04 AM,Internally Displaced People,200,1000,50,150,1400,143,1890,25,142,2200
75,Nigeria,2018,NGA-18/NIG_ERF/SA1/F/NGO/10867,11/14/2019 8:34:04 AM,Overall,300,1500,100,300,2200,238,2535,37,190,3000
75,Nigeria,2018,NGA-18/NIG_ERF/SA1/F-WASH/NGO/10804,7/14/2020 12:51:31 PM,Host Communities,198,402,0,0,600,270,459,0,0,729
75,Nigeria,2018,NGA-18/NIG_ERF/SA1/F-WASH/NGO/10804,7/14/2020 12:51:31 PM,Internally Displaced People,462,938,0,0,1400,390,881,0,0,1271
75,Nigeria,2018,NGA-18/NIG_ERF/SA1/F-WASH/NGO/10804,7/14/2020 12:51:31 PM,Overall,660,1340,0,0,2000,660,1340,0,0,2000
75,Nigeria,2018,NGA-18/NIG_ERF/SA1/H/INGO/10842,2/26/2020 11:30:05 AM,Host Communities,2876,4691,959,1438,9964,6687,4651,2242,2175,15755
75,Nigeria,2018,NGA-18/NIG_ERF/SA1/H/INGO/10842,2/26/2020 11:30:05 AM,Internally Displaced People,8628,14074,2876,4314,29892,9607,6845,4410,5054,25916
75,Nigeria,2018,NGA-18/NIG_ERF/SA1/H/INGO/10842,2/26/2020 11:30:05 AM,Overall,11504,18765,3835,5752,39856,16294,11496,6652,7229,41671
75,Nigeria,2018,NGA-18/NIG_ERF/SA1/H/NGO/10749,3/27/2020 12:44:45 PM,Host Communities,0,1500,500,2500,4500,1505,6048,1436,3126,12115
75,Nigeria,2018,NGA-18/NIG_ERF/SA1/H/NGO/10749,3/27/2020 12:44:45 PM,Internally Displaced People,0,1500,500,1500,3500,1076,3979,1005,2225,8285
75,Nigeria,2018,NGA-18/NIG_ERF/SA1/H/NGO/10749,3/27/2020 12:44:45 PM,Overall,0,3000,1000,4000,8000,2581,10027,2441,5351,20400
75,Nigeria,2018,NGA-18/NIG_ERF/SA1/H/UN/10754,3/12/2020 12:06:10 PM,Host Communities,33403,50585,34666,31912,150566,30149,44904,41441,53275,169769
75,Nigeria,2018,NGA-18/NIG_ERF/SA1/H/UN/10754,3/12/2020 12:06:10 PM,Internally Displaced People,8220,12530,8512,7907,37169,7537,9843,11364,12955,41699
75,Nigeria,2018,NGA-18/NIG_ERF/SA1/H/UN/10754,3/12/2020 12:06:10 PM,Overall,41623,63115,43178,39819,187735,37686,54747,52805,66230,211468
75,Nigeria,2018,NGA-18/NIG_ERF/SA1/H/UN/10872,12/26/2019 9:27:47 PM,Internally Displaced People,20436,23046,26041,27104,96627,18904,30213,32898,34242,116257
75,Nigeria,2018,NGA-18/NIG_ERF/SA1/H/UN/10872,12/26/2019 9:27:47 PM,Overall,20436,23046,26041,27104,96627,18904,30213,32898,34242,116257
75,Nigeria,2018,NGA-18/NIG_ERF/SA1/LOG/UN/10857,10/7/2021 10:59:53 AM,Other,7500,7500,0,0,15000,14878,14877,0,0,29755
75,Nigeria,2018,NGA-18/NIG_ERF/SA1/LOG/UN/10857,10/7/2021 10:59:53 AM,Overall,7500,7500,0,0,15000,14878,14877,0,0,29755
75,Nigeria,2018,NGA-18/NIG_ERF/SA1/N/INGO/10794,4/20/2020 1:26:13 PM,Host Communities,0,0,947,986,1933,0,0,584,716,1300
75,Nigeria,2018,NGA-18/NIG_ERF/SA1/N/INGO/10794,4/20/2020 1:26:13 PM,Internally Displaced People,0,0,1621,1687,3308,0,0,950,1340,2290
75,Nigeria,2018,NGA-18/NIG_ERF/SA1/N/INGO/10794,4/20/2020 1:26:13 PM,Overall,0,0,2568,2673,5241,0,0,1534,2056,3590
75,Nigeria,2018,NGA-18/NIG_ERF/SA1/N/NGO/10844,12/27/2019 7:11:38 PM,Host Communities,25,75,500,500,1100,49,1000,607,1000,2656
75,Nigeria,2018,NGA-18/NIG_ERF/SA1/N/NGO/10844,12/27/2019 7:11:38 PM,Internally Displaced People,25,75,500,500,1100,16,500,1000,1000,2516
75,Nigeria,2018,NGA-18/NIG_ERF/SA1/N/NGO/10844,12/27/2019 7:11:38 PM,Overall,50,150,1000,1000,2200,65,1500,1607,2000,5172
75,Nigeria,2018,NGA-18/NIG_ERF/SA1/N/UN/10786,12/26/2019 9:48:57 PM,Host Communities,0,0,292,304,596,48,28,1948,2044,4068
75,Nigeria,2018,NGA-18/NIG_ERF/SA1/N/UN/10786,12/26/2019 9:48:57 PM,Internally Displaced People,0,0,1357,1412,2769,0,0,0,0,0
75,Nigeria,2018,NGA-18/NIG_ERF/SA1/N/UN/10786,12/26/2019 9:48:57 PM,Other,0,0,438,457,895,0,0,0,0,0
75,Nigeria,2018,NGA-18/NIG_ERF/SA1/N/UN/10786,12/26/2019 9:48:57 PM,Overall,0,0,2087,2173,4260,48,28,1948,2044,4068
75,Nigeria,2018,NGA-18/NIG_ERF/SA1/N/UN/10866,12/27/2019 12:34:27 AM,Host Communities,0,7749,11880,18971,38600,0,6753,26011,27071,59835
75,Nigeria,2018,NGA-18/NIG_ERF/SA1/N/UN/10866,12/27/2019 12:34:27 AM,Internally Displaced People,0,17787,34074,41632,93493,0,26914,104037,108284,239235
75,Nigeria,2018,NGA-18/NIG_ERF/SA1/N/UN/10866,12/27/2019 12:34:27 AM,Other,0,3727,8542,9287,21556,0,0,0,0,0
75,Nigeria,2018,NGA-18/NIG_ERF/SA1/N/UN/10866,12/27/2019 12:34:27 AM,Overall,0,34439,87135,94260,215834,0,33667,130048,135355,299070
75,Nigeria,2018,NGA-18/NIG_ERF/SA1/P/INGO/10741,12/27/2019 8:08:40 PM,Host Communities,7000,7000,3000,3000,20000,2062,3885,3631,3520,13098
75,Nigeria,2018,NGA-18/NIG_ERF/SA1/P/INGO/10741,12/27/2019 8:08:40 PM,Internally Displaced People,7000,7000,3000,3000,20000,4610,8859,3883,4761,22113
75,Nigeria,2018,NGA-18/NIG_ERF/SA1/P/INGO/10741,12/27/2019 8:08:40 PM,Other,0,0,0,0,0,637,2014,1058,935,4644
75,Nigeria,2018,NGA-18/NIG_ERF/SA1/P/INGO/10741,12/27/2019 8:08:40 PM,Overall,14000,14000,6000,6000,40000,7309,14758,8572,9216,39855
75,Nigeria,2018,NGA-18/NIG_ERF/SA1/P/INGO/10799,5/8/2020 9:26:27 AM,Host Communities,677,1129,1129,1580,4515,983,2404,1853,2794,8034
75,Nigeria,2018,NGA-18/NIG_ERF/SA1/P/INGO/10799,5/8/2020 9:26:27 AM,Internally Displaced People,1580,2634,2633,3688,10535,2438,6617,5021,8157,22233
75,Nigeria,2018,NGA-18/NIG_ERF/SA1/P/INGO/10799,5/8/2020 9:26:27 AM,Overall,2257,3763,3762,5268,15050,3421,9021,6874,10951,30267
75,Nigeria,2018,NGA-18/NIG_ERF/SA1/P/NGO/10713,4/1/2020 10:17:11 AM,Overall,4000,6000,6400,7950,24350,2960,6672,4655,9284,23571
75,Nigeria,2018,NGA-18/NIG_ERF/SA1/P/NGO/10763,12/27/2019 8:35:03 PM,Host Communities,200,400,200,300,1100,762,1272,246,585,2865
75,Nigeria,2018,NGA-18/NIG_ERF/SA1/P/NGO/10763,12/27/2019 8:35:03 PM,Internally Displaced People,400,900,400,800,2500,818,2761,593,944,5116
75,Nigeria,2018,NGA-18/NIG_ERF/SA1/P/NGO/10763,12/27/2019 8:35:03 PM,Overall,600,1300,600,1100,3600,1580,4033,839,1529,7981
75,Nigeria,2018,NGA-18/NIG_ERF/SA1/P/UN/10870,6/8/2020 5:22:47 PM,Internally Displaced People,5353,6675,7062,8561,27651,5493,8083,6355,8562,28493
75,Nigeria,2018,NGA-18/NIG_ERF/SA1/P/UN/10870,6/8/2020 5:22:47 PM,Overall,5353,6675,7062,8561,27651,5493,8083,6355,8562,28493
75,Nigeria,2018,NGA-18/NIG_ERF/SA1/P-WASH/INGO/10852,6/1/2023 12:21:20 PM,Host Communities,0,0,0,0,0,11340,13633,4926,7485,37384
75,Nigeria,2018,NGA-18/NIG_ERF/SA1/P-WASH/INGO/10852,6/1/2023 12:21:20 PM,Internally Displaced People,7950,16600,6944,11416,42910,13339,11392,9186,8871,42788
75,Nigeria,2018,NGA-18/NIG_ERF/SA1/P-WASH/INGO/10852,6/1/2023 12:21:20 PM,Overall,7950,16600,6944,11416,42910,24679,25025,14112,16356,80172
75,Nigeria,2018,NGA-18/NIG_ERF/SA1/S/NFI/NGO/10796,12/27/2019 6:54:23 PM,Internally Displaced People,1600,2400,1600,2400,8000,1600,2400,1600,2400,8000
75,Nigeria,2018,NGA-18/NIG_ERF/SA1/S/NFI/NGO/10796,12/27/2019 6:54:23 PM,Overall,1600,2400,1600,2400,8000,1600,2400,1600,2400,8000
75,Nigeria,2018,NGA-18/NIG_ERF/SA1/S/NFI/UN/10865,6/1/2020 12:09:41 PM,Internally Displaced People,1090,1110,1290,1510,5000,3270,3330,3900,4500,15000
75,Nigeria,2018,NGA-18/NIG_ERF/SA1/S/NFI/UN/10865,6/1/2020 12:09:41 PM,Overall,1090,1110,1290,1510,5000,3270,3330,3900,4500,15000
75,Nigeria,2018,NGA-18/NIG_ERF/SA1/WASH/INGO/10729,10/22/2019 9:12:29 PM,Internally Displaced People,0,0,0,0,0,1890,3780,3150,3780,12600
75,Nigeria,2018,NGA-18/NIG_ERF/SA1/WASH/INGO/10729,10/22/2019 9:12:29 PM,Overall,1511,2403,1911,3575,9400,1890,3780,3150,3780,12600
75,Nigeria,2018,NGA-18/NIG_ERF/SA1/WASH/INGO/10840,2/17/2020 7:32:07 AM,Internally Displaced People,4556,5738,6058,7223,23575,7297,12161,6482,12976,38916
75,Nigeria,2018,NGA-18/NIG_ERF/SA1/WASH/INGO/10840,2/17/2020 7:32:07 AM,Overall,4556,5738,6058,7223,23575,7297,12161,6482,12976,38916
75,Nigeria,2018,NGA-18/NIG_ERF/SA1/WASH/NGO/10711,12/26/2019 11:16:37 PM,Internally Displaced People,2500,3000,450,550,6500,5975,7518,674,809,14976
75,Nigeria,2018,NGA-18/NIG_ERF/SA1/WASH/NGO/10711,12/26/2019 11:16:37 PM,Overall,4030,5070,450,550,10100,5975,7518,674,809,14976
75,Nigeria,2018,NGA-18/NIG_ERF/SA1/WASH/NGO/10833,3/23/2020 10:39:08 AM,Internally Displaced People,1006,1334,542,718,3600,2604,3496,1306,1894,9300
75,Nigeria,2018,NGA-18/NIG_ERF/SA1/WASH/NGO/10833,3/23/2020 10:39:08 AM,Overall,3354,4446,1806,2394,12000,4104,5196,2556,3144,15000
75,Nigeria,2018,NGA-18/NIG_ERF/SA1/WASH/NGO/10833,3/23/2020 10:39:08 AM,Returnees,2348,3112,1264,1676,8400,1500,1700,1250,1250,5700
75,Nigeria,2018,NGA-18/NIG_ERF/SA1/WASH/UN/10752,12/26/2019 11:13:11 PM,Internally Displaced People,101515,131065,130680,157585,520845,132986,150731,165584,202025,651326
75,Nigeria,2018,NGA-18/NIG_ERF/SA1/WASH/UN/10752,12/26/2019 11:13:11 PM,Overall,101515,131065,130680,157585,520845,132986,150731,165584,202025,651326
75,Nigeria,2018,NGA-18/NIG_ERF/SA1/WASH/UN/10817,8/19/2019 9:42:23 AM,Internally Displaced People,14602,29205,24338,29205,97350,14585,29170,24309,29170,97234
75,Nigeria,2018,NGA-18/NIG_ERF/SA1/WASH/UN/10817,8/19/2019 9:42:23 AM,Overall,14602,29205,24338,29205,97350,14585,29170,24309,29170,97234
75,Nigeria,2019,NGA-19/NIG_ERF/RA1/DMS/INGO/12257,6/23/2020 3:16:54 PM,Internally Displaced People,11966,15909,13639,17834,59348,14058,18106,17948,18024,68136
75,Nigeria,2019,NGA-19/NIG_ERF/RA1/DMS/INGO/12257,6/23/2020 3:16:54 PM,Overall,11966,15909,13639,17834,59348,14058,18106,17948,18024,68136
75,Nigeria,2019,NGA-19/NIG_ERF/RA1/H/INGO/12256,6/23/2020 1:18:57 PM,Host Communities,1536,2304,384,576,4800,5363,8043,3574,5363,22343
75,Nigeria,2019,NGA-19/NIG_ERF/RA1/H/INGO/12256,6/23/2020 1:18:57 PM,Internally Displaced People,6144,9216,1536,2304,19200,8044,12065,5363,8044,33516
75,Nigeria,2019,NGA-19/NIG_ERF/RA1/H/INGO/12256,6/23/2020 1:18:57 PM,Overall,7680,11520,1920,2880,24000,13407,20108,8937,13407,55859
75,Nigeria,2019,NGA-19/NIG_ERF/RA1/H/INGO/12900,2/25/2021 1:23:49 PM,Host Communities,764,4200,1145,1527,7636,313,339,0,0,652
75,Nigeria,2019,NGA-19/NIG_ERF/RA1/H/INGO/12900,2/25/2021 1:23:49 PM,Internally Displaced People,764,4200,1145,1527,7636,320,1814,0,0,2134
75,Nigeria,2019,NGA-19/NIG_ERF/RA1/H/INGO/12900,2/25/2021 1:23:49 PM,Overall,1528,8400,2290,3054,15272,633,2153,0,0,2786
75,Nigeria,2019,NGA-19/NIG_ERF/RA1/H/INGO/12942,2/24/2020 10:41:19 AM,Host Communities,0,2000,500,500,3000,1759,3521,1200,3068,9548
75,Nigeria,2019,NGA-19/NIG_ERF/RA1/H/INGO/12942,2/24/2020 10:41:19 AM,Internally Displaced People,0,2000,500,500,3000,2221,4461,1777,2967,11426
75,Nigeria,2019,NGA-19/NIG_ERF/RA1/H/INGO/12942,2/24/2020 10:41:19 AM,Overall,0,7000,1500,1500,10000,7481,12788,4368,9142,33779
75,Nigeria,2019,NGA-19/NIG_ERF/RA1/H/INGO/12942,2/24/2020 10:41:19 AM,Returnees,0,3000,500,500,4000,3501,4806,1391,3107,12805
75,Nigeria,2019,NGA-19/NIG_ERF/RA1/H/NGO/12280,1/14/2020 2:36:35 PM,Host Communities,0,350,0,250,600,0,526,0,711,1237
75,Nigeria,2019,NGA-19/NIG_ERF/RA1/H/NGO/12280,1/14/2020 2:36:35 PM,Internally Displaced People,0,500,0,400,900,0,798,0,1394,2192
75,Nigeria,2019,NGA-19/NIG_ERF/RA1/H/NGO/12280,1/14/2020 2:36:35 PM,Overall,0,1250,0,950,2200,0,1654,0,2868,4522
75,Nigeria,2019,NGA-19/NIG_ERF/RA1/H/NGO/12280,1/14/2020 2:36:35 PM,Returnees,0,400,0,300,700,0,330,0,763,1093
75,Nigeria,2019,NGA-19/NIG_ERF/RA1/H/UN/12302,4/14/2020 12:48:56 PM,Internally Displaced People,184,665,477,474,1800,176,655,449,442,1722
75,Nigeria,2019,NGA-19/NIG_ERF/RA1/H/UN/12302,4/14/2020 12:48:56 PM,Overall,184,665,477,474,1800,176,655,449,442,1722
75,Nigeria,2019,NGA-19/NIG_ERF/RA1/N/INGO/12861,4/14/2020 10:37:57 AM,Host Communities,1464,4679,3791,3731,13665,3286,10569,4505,5860,24220
75,Nigeria,2019,NGA-19/NIG_ERF/RA1/N/INGO/12861,4/14/2020 10:37:57 AM,Internally Displaced People,2195,7020,5687,5596,20498,3116,10199,6418,8000,27733
75,Nigeria,2019,NGA-19/NIG_ERF/RA1/N/INGO/12861,4/14/2020 10:37:57 AM,Overall,3659,11699,9478,9327,34163,6402,20768,10923,13860,51953
75,Nigeria,2019,NGA-19/NIG_ERF/RA1/N/INGO/12890,9/10/2020 11:08:19 AM,Host Communities,10,80,40,50,180,2,10,18,31,61
75,Nigeria,2019,NGA-19/NIG_ERF/RA1/N/INGO/12890,9/10/2020 11:08:19 AM,Internally Displaced People,100,150,107,103,460,18,388,198,135,739
75,Nigeria,2019,NGA-19/NIG_ERF/RA1/N/INGO/12890,9/10/2020 11:08:19 AM,Overall,110,230,147,153,640,20,398,216,166,800
75,Nigeria,2019,NGA-19/NIG_ERF/RA1/P/INGO/12255,1/7/2020 2:46:19 PM,Internally Displaced People,3100,14392,3830,8668,29990,1014,12815,2704,5036,21569
75,Nigeria,2019,NGA-19/NIG_ERF/RA1/P/INGO/12255,1/7/2020 2:46:19 PM,Overall,3100,14392,3830,8668,29990,1014,12815,2704,5036,21569
75,Nigeria,2019,NGA-19/NIG_ERF/RA1/P/NGO/12297,3/9/2020 1:53:53 PM,Host Communities,0,10,410,840,1260,35,70,550,540,1195
75,Nigeria,2019,NGA-19/NIG_ERF/RA1/P/NGO/12297,3/9/2020 1:53:53 PM,Internally Displaced People,0,45,1000,955,2000,411,335,3591,3375,7712
75,Nigeria,2019,NGA-19/NIG_ERF/RA1/P/NGO/12297,3/9/2020 1:53:53 PM,Overall,0,55,1410,1795,3260,446,405,4141,3915,8907
75,Nigeria,2019,NGA-19/NIG_ERF/RA1/P/NGO/12309,9/1/2020 10:53:17 AM,Internally Displaced People,900,2500,900,2000,6300,2804,9014,2597,5179,19594
75,Nigeria,2019,NGA-19/NIG_ERF/RA1/P/NGO/12309,9/1/2020 10:53:17 AM,Overall,900,2500,900,2000,6300,2804,9014,2597,5179,19594
75,Nigeria,2019,NGA-19/NIG_ERF/RA1/P/UN/12276,5/29/2020 1:25:57 PM,Internally Displaced People,8700,10873,11496,13931,45000,7050,11531,16127,17846,52554
75,Nigeria,2019,NGA-19/NIG_ERF/RA1/P/UN/12276,5/29/2020 1:25:57 PM,Overall,8700,10873,11496,13931,45000,7050,11531,16127,17846,52554
75,Nigeria,2019,NGA-19/NIG_ERF/RA1/P/UN/12279,8/24/2020 2:04:51 PM,Host Communities,500,2700,500,1200,4900,430,2000,450,1100,3980
75,Nigeria,2019,NGA-19/NIG_ERF/RA1/P/UN/12279,8/24/2020 2:04:51 PM,Internally Displaced People,0,5100,0,2000,7100,2343,5138,1613,1621,10715
75,Nigeria,2019,NGA-19/NIG_ERF/RA1/P/UN/12279,8/24/2020 2:04:51 PM,Overall,500,7800,500,3200,12000,2773,7138,2063,2721,14695
75,Nigeria,2019,NGA-19/NIG_ERF/RA1/S/NFI/INGO/12267,6/23/2020 1:26:44 PM,Internally Displaced People,637,663,780,1170,3250,2981,2912,0,0,5893
75,Nigeria,2019,NGA-19/NIG_ERF/RA1/S/NFI/INGO/12267,6/23/2020 1:26:44 PM,Overall,637,663,780,1170,3250,2981,2912,0,0,5893
75,Nigeria,2019,NGA-19/NIG_ERF/RA1/S/NFI/INGO/13034,2/26/2020 10:36:34 AM,Internally Displaced People,3500,4200,2800,3500,14000,3400,3740,4590,5270,17000
75,Nigeria,2019,NGA-19/NIG_ERF/RA1/S/NFI/INGO/13034,2/26/2020 10:36:34 AM,Overall,3500,4200,2800,3500,14000,3400,3740,4590,5270,17000
75,Nigeria,2019,NGA-19/NIG_ERF/RA1/S/NFI/NGO/12295,3/19/2020 10:15:21 AM,Internally Displaced People,500,1000,500,1000,3000,500,1000,500,1000,3000
75,Nigeria,2019,NGA-19/NIG_ERF/RA1/S/NFI/NGO/12295,3/19/2020 10:15:21 AM,Overall,500,1000,500,1000,3000,500,1000,500,1000,3000
75,Nigeria,2019,NGA-19/NIG_ERF/RA1/S/NFI/NGO/12312,4/2/2020 10:42:54 AM,Host Communities,50,100,10,10,170,5,10,50,50,115
75,Nigeria,2019,NGA-19/NIG_ERF/RA1/S/NFI/NGO/12312,4/2/2020 10:42:54 AM,Internally Displaced People,50,400,40,40,530,500,688,1255,936,3379
75,Nigeria,2019,NGA-19/NIG_ERF/RA1/S/NFI/NGO/12312,4/2/2020 10:42:54 AM,Overall,100,500,50,50,700,505,698,1305,986,3494
75,Nigeria,2019,NGA-19/NIG_ERF/RA1/S/NFI/UN/12311,6/23/2020 3:01:10 PM,Internally Displaced People,654,666,780,900,3000,654,666,780,900,3000
75,Nigeria,2019,NGA-19/NIG_ERF/RA1/S/NFI/UN/12311,6/23/2020 3:01:10 PM,Overall,654,666,780,900,3000,654,666,780,900,3000
75,Nigeria,2019,NGA-19/NIG_ERF/RA1/S/NFI-DMS/INGO/12281,2/13/2020 3:07:12 PM,Internally Displaced People,2918,3568,3431,4196,14113,3165,3771,3695,4366,14997
75,Nigeria,2019,NGA-19/NIG_ERF/RA1/S/NFI-DMS/INGO/12281,2/13/2020 3:07:12 PM,Overall,2918,3568,3431,4196,14113,3165,3771,3695,4366,14997
75,Nigeria,2019,NGA-19/NIG_ERF/RA1/S/NFI-WASH-DMS/UN/12308,1/22/2020 10:47:54 AM,Internally Displaced People,36277,56924,54927,65707,213835,40041,60099,58558,72200,230898
75,Nigeria,2019,NGA-19/NIG_ERF/RA1/S/NFI-WASH-DMS/UN/12308,1/22/2020 10:47:54 AM,Overall,36277,56924,54927,65707,213835,40041,60099,58558,72200,230898
75,Nigeria,2019,NGA-19/NIG_ERF/RA1/WASH/INGO/12258,12/27/2019 12:30:39 PM,Internally Displaced People,4000,6000,6000,9000,25000,5328,7624,7991,11436,32379
75,Nigeria,2019,NGA-19/NIG_ERF/RA1/WASH/INGO/12258,12/27/2019 12:30:39 PM,Overall,4000,6000,6000,9000,25000,5328,7624,7991,11436,32379
75,Nigeria,2019,NGA-19/NIG_ERF/RA1/WASH/INGO/12268,5/26/2020 3:42:46 PM,Internally Displaced People,2642,3103,3650,4285,13680,3060,4220,2730,2410,12420
75,Nigeria,2019,NGA-19/NIG_ERF/RA1/WASH/INGO/12268,5/26/2020 3:42:46 PM,Overall,2642,3103,3650,4285,13680,3060,4220,2730,2410,12420
75,Nigeria,2019,NGA-19/NIG_ERF/RA1/WASH/INGO/12291,3/10/2020 12:03:46 PM,Internally Displaced People,1727,2931,1972,2301,8931,2056,3464,2772,3434,11726
75,Nigeria,2019,NGA-19/NIG_ERF/RA1/WASH/INGO/12291,3/10/2020 12:03:46 PM,Overall,1727,2931,1972,2301,8931,2056,3464,2772,3434,11726
75,Nigeria,2019,NGA-19/NIG_ERF/RA1/WASH/INGO/12304,4/1/2020 9:41:37 AM,Internally Displaced People,1587,3174,2665,3174,10600,1850,3700,1936,2312,9798
75,Nigeria,2019,NGA-19/NIG_ERF/RA1/WASH/INGO/12304,4/1/2020 9:41:37 AM,Overall,1587,3174,2665,3174,10600,1850,3700,1936,2312,9798
75,Nigeria,2019,NGA-19/NIG_ERF/RA1/WASH/INGO/12314,3/11/2020 2:22:10 PM,Internally Displaced People,2713,3253,2169,2713,10848,1909,2289,1525,1909,7632
75,Nigeria,2019,NGA-19/NIG_ERF/RA1/WASH/INGO/12314,3/11/2020 2:22:10 PM,Overall,2713,3253,2169,2713,10848,1909,2289,1525,1909,7632
75,Nigeria,2019,NGA-19/NIG_ERF/RA1/WASH/NGO/12286,6/8/2020 5:25:24 PM,Internally Displaced People,3188,3896,4782,5844,17710,3386,4138,5080,6208,18812
75,Nigeria,2019,NGA-19/NIG_ERF/RA1/WASH/NGO/12286,6/8/2020 5:25:24 PM,Overall,3188,3896,4782,5844,17710,3386,4138,5080,6208,18812
75,Nigeria,2019,NGA-19/NIG_ERF/RA1/WASH/NGO/12294,3/13/2020 10:09:32 AM,Internally Displaced People,3000,4900,1800,2300,12000,4700,7050,1800,2350,15900
75,Nigeria,2019,NGA-19/NIG_ERF/RA1/WASH/NGO/12294,3/13/2020 10:09:32 AM,Overall,3000,4900,1800,2300,12000,4700,7050,1800,2350,15900
75,Nigeria,2019,NGA-19/NIG_ERF/RA1/WASH/NGO/12296,4/7/2020 11:25:50 AM,Internally Displaced People,2000,7000,2800,3500,15300,1656,13061,2287,5048,22052
75,Nigeria,2019,NGA-19/NIG_ERF/RA1/WASH/NGO/12296,4/7/2020 11:25:50 AM,Overall,2000,7000,2800,3500,15300,1656,13061,2287,5048,22052
75,Nigeria,2019,NGA-19/NIG_ERF/RA2/C/UN/14281,12/11/2020 12:28:57 PM,Other,53,34,0,0,87,128,43,0,0,171
75,Nigeria,2019,NGA-19/NIG_ERF/RA2/C/UN/14281,12/11/2020 12:28:57 PM,Overall,53,34,0,0,87,128,43,0,0,171
75,Nigeria,2019,NGA-19/NIG_ERF/RA2/DMS/INGO/14374,10/30/2020 12:37:30 PM,Internally Displaced People,20546,26719,26372,30874,104511,35974,40285,17278,21097,114634
75,Nigeria,2019,NGA-19/NIG_ERF/RA2/DMS/INGO/14374,10/30/2020 12:37:30 PM,Overall,20546,26719,26372,30874,104511,35974,40285,17278,21097,114634
75,Nigeria,2019,NGA-19/NIG_ERF/RA2/DMS-S/NFI/UN/14343,5/28/2021 4:30:07 AM,Internally Displaced People,82517,102266,129658,141905,456346,70218,92565,99885,117629,380297
75,Nigeria,2019,NGA-19/NIG_ERF/RA2/DMS-S/NFI/UN/14343,5/28/2021 4:30:07 AM,Overall,82517,102266,129658,141905,456346,70218,92565,99885,117629,380297
75,Nigeria,2019,NGA-19/NIG_ERF/RA2/DMS-S/NFI-C/INGO/14231,5/10/2021 9:13:53 AM,Internally Displaced People,4785,5443,6009,7190,23427,4676,6730,8831,7590,27827
75,Nigeria,2019,NGA-19/NIG_ERF/RA2/DMS-S/NFI-C/INGO/14231,5/10/2021 9:13:53 AM,Overall,4785,5443,6009,7190,23427,4676,6730,8831,7590,27827
75,Nigeria,2019,NGA-19/NIG_ERF/RA2/H/INGO/14192,5/10/2021 11:12:52 AM,Host Communities,2315,3472,628,628,7043,1675,3105,1133,1613,7526
75,Nigeria,2019,NGA-19/NIG_ERF/RA2/H/INGO/14192,5/10/2021 11:12:52 AM,Internally Displaced People,9260,13890,2512,2512,28174,5298,10012,4540,5448,25298
75,Nigeria,2019,NGA-19/NIG_ERF/RA2/H/INGO/14192,5/10/2021 11:12:52 AM,Overall,11575,17362,3140,3140,35217,6973,13117,5673,7061,32824
75,Nigeria,2019,NGA-19/NIG_ERF/RA2/H/INGO/14379,5/11/2021 11:24:43 AM,Host Communities,4556,2300,6058,1000,13914,4815,6902,3950,5019,20686
75,Nigeria,2019,NGA-19/NIG_ERF/RA2/H/INGO/14379,5/11/2021 11:24:43 AM,Internally Displaced People,4556,5738,6058,7223,23575,5134,8600,4960,9415,28109
75,Nigeria,2019,NGA-19/NIG_ERF/RA2/H/INGO/14379,5/11/2021 11:24:43 AM,Overall,9112,8038,12116,8223,37489,9949,15502,8910,14434,48795
75,Nigeria,2019,NGA-19/NIG_ERF/RA2/H/NGO/14229,5/26/2021 7:41:02 PM,Host Communities,0,450,0,550,1000,0,809,0,1175,1984
75,Nigeria,2019,NGA-19/NIG_ERF/RA2/H/NGO/14229,5/26/2021 7:41:02 PM,Internally Displaced People,0,500,0,700,1200,0,1074,0,1794,2868
75,Nigeria,2019,NGA-19/NIG_ERF/RA2/H/NGO/14229,5/26/2021 7:41:02 PM,Overall,0,1350,0,1650,3000,0,2479,0,3695,6174
75,Nigeria,2019,NGA-19/NIG_ERF/RA2/H/NGO/14229,5/26/2021 7:41:02 PM,Returnees,0,400,0,400,800,0,596,0,726,1322
75,Nigeria,2019,NGA-19/NIG_ERF/RA2/H/UN/14232,5/28/2021 3:52:45 AM,Internally Displaced People,8252,9446,10351,12363,40412,7480,9101,14617,17733,48931
75,Nigeria,2019,NGA-19/NIG_ERF/RA2/H/UN/14232,5/28/2021 3:52:45 AM,Overall,8252,9446,10351,12363,40412,7480,9101,14617,17733,48931
75,Nigeria,2019,NGA-19/NIG_ERF/RA2/H/UN/14340,7/21/2021 9:57:10 AM,Internally Displaced People,60529,81159,40099,105162,286949,35423,56744,23511,76823,192501
75,Nigeria,2019,NGA-19/NIG_ERF/RA2/H/UN/14340,7/21/2021 9:57:10 AM,Overall,60529,81159,40099,105162,286949,35423,56744,23511,76823,192501
75,Nigeria,2019,NGA-19/NIG_ERF/RA2/H-WASH-P/NGO/14352,6/11/2021 1:07:26 AM,Host Communities,5535,7688,8303,9224,30750,5986,8314,8979,9978,33257
75,Nigeria,2019,NGA-19/NIG_ERF/RA2/H-WASH-P/NGO/14352,6/11/2021 1:07:26 AM,Internally Displaced People,1836,2550,2754,3060,10200,1995,2771,2993,3326,11085
75,Nigeria,2019,NGA-19/NIG_ERF/RA2/H-WASH-P/NGO/14352,6/11/2021 1:07:26 AM,Overall,8415,11688,12623,14024,46750,11972,16628,17958,19955,66513
75,Nigeria,2019,NGA-19/NIG_ERF/RA2/H-WASH-P/NGO/14352,6/11/2021 1:07:26 AM,Returnees,1044,1450,1566,1740,5800,3991,5543,5986,6651,22171
75,Nigeria,2019,NGA-19/NIG_ERF/RA2/N/INGO/14171,6/9/2021 9:05:00 AM,Host Communities,0,943,462,481,1886,54,865,533,462,1914
75,Nigeria,2019,NGA-19/NIG_ERF/RA2/N/INGO/14171,6/9/2021 9:05:00 AM,Internally Displaced People,0,538,264,274,1076,0,551,422,327,1300
75,Nigeria,2019,NGA-19/NIG_ERF/RA2/N/INGO/14171,6/9/2021 9:05:00 AM,Overall,0,1945,953,992,3890,89,1696,1019,980,3784
75,Nigeria,2019,NGA-19/NIG_ERF/RA2/N/INGO/14171,6/9/2021 9:05:00 AM,Returnees,0,464,227,237,928,35,280,64,191,570
75,Nigeria,2019,NGA-19/NIG_ERF/RA2/N/INGO/14176,10/9/2020 11:44:49 AM,Host Communities,2025,4725,415,666,7831,1025,1435,2150,2151,6761
75,Nigeria,2019,NGA-19/NIG_ERF/RA2/N/INGO/14176,10/9/2020 11:44:49 AM,Internally Displaced People,225,525,65,108,923,500,1988,2200,2880,7568
75,Nigeria,2019,NGA-19/NIG_ERF/RA2/N/INGO/14176,10/9/2020 11:44:49 AM,Overall,2250,5250,480,774,8754,1525,3423,4350,5031,14329
75,Nigeria,2019,NGA-19/NIG_ERF/RA2/N/NGO/14243,12/29/2020 10:04:40 AM,Host Communities,500,800,1000,1000,3300,220,1230,929,480,2859
75,Nigeria,2019,NGA-19/NIG_ERF/RA2/N/NGO/14243,12/29/2020 10:04:40 AM,Internally Displaced People,100,1000,1000,1000,3100,35,467,203,420,1125
75,Nigeria,2019,NGA-19/NIG_ERF/RA2/N/NGO/14243,12/29/2020 10:04:40 AM,Overall,650,1850,2050,2050,6600,320,1907,1179,1034,4440
75,Nigeria,2019,NGA-19/NIG_ERF/RA2/N/NGO/14243,12/29/2020 10:04:40 AM,Returnees,50,50,50,50,200,65,210,47,134,456
75,Nigeria,2019,NGA-19/NIG_ERF/RA2/N/UN/14353,2/4/2021 3:25:29 PM,Host Communities,30,15,719,844,1608,25,15,1017,1034,2091
75,Nigeria,2019,NGA-19/NIG_ERF/RA2/N/UN/14353,2/4/2021 3:25:29 PM,Internally Displaced People,0,0,155,181,336,0,0,0,0,0
75,Nigeria,2019,NGA-19/NIG_ERF/RA2/N/UN/14353,2/4/2021 3:25:29 PM,Other,0,0,78,92,170,0,0,0,0,0
75,Nigeria,2019,NGA-19/NIG_ERF/RA2/N/UN/14353,2/4/2021 3:25:29 PM,Overall,30,15,1107,1298,2450,25,15,1017,1034,2091
75,Nigeria,2019,NGA-19/NIG_ERF/RA2/N/UN/14353,2/4/2021 3:25:29 PM,Returnees,0,0,155,181,336,0,0,0,0,0
75,Nigeria,2019,NGA-19/NIG_ERF/RA2/N/UN/14385,8/10/2021 9:06:24 AM,Host Communities,0,0,3964,4844,8808,0,0,977,795,1772
75,Nigeria,2019,NGA-19/NIG_ERF/RA2/N/UN/14385,8/10/2021 9:06:24 AM,Internally Displaced People,0,0,1029,1258,2287,0,0,166,211,377
75,Nigeria,2019,NGA-19/NIG_ERF/RA2/N/UN/14385,8/10/2021 9:06:24 AM,Overall,0,0,5752,7030,12782,0,0,1295,1180,2475
75,Nigeria,2019,NGA-19/NIG_ERF/RA2/N/UN/14385,8/10/2021 9:06:24 AM,Returnees,0,0,759,928,1687,0,0,152,174,326
75,Nigeria,2019,NGA-19/NIG_ERF/RA2/P/INGO/14178,5/10/2021 4:35:09 PM,Host Communities,17,17,190,214,438,78,64,429,399,970
75,Nigeria,2019,NGA-19/NIG_ERF/RA2/P/INGO/14178,5/10/2021 4:35:09 PM,Internally Displaced People,67,67,762,858,1754,62,75,595,677,1409
75,Nigeria,2019,NGA-19/NIG_ERF/RA2/P/INGO/14178,5/10/2021 4:35:09 PM,Overall,112,113,1270,1430,2925,140,139,1024,1076,2379
75,Nigeria,2019,NGA-19/NIG_ERF/RA2/P/INGO/14178,5/10/2021 4:35:09 PM,Returnees,28,29,318,358,733,0,0,0,0,0
75,Nigeria,2019,NGA-19/NIG_ERF/RA2/P/INGO/14203,12/11/2020 11:48:43 AM,Other,50,10,0,0,60,43,17,0,0,60
75,Nigeria,2019,NGA-19/NIG_ERF/RA2/P/INGO/14203,12/11/2020 11:48:43 AM,Overall,50,10,0,0,60,43,17,0,0,60
75,Nigeria,2019,NGA-19/NIG_ERF/RA2/P/INGO/14294,1/15/2021 1:29:20 PM,Host Communities,1725,2025,1725,2025,7500,733,1539,1525,1410,5207
75,Nigeria,2019,NGA-19/NIG_ERF/RA2/P/INGO/14294,1/15/2021 1:29:20 PM,Internally Displaced People,1725,2025,1725,2025,7500,1458,3935,2462,2239,10094
75,Nigeria,2019,NGA-19/NIG_ERF/RA2/P/INGO/14294,1/15/2021 1:29:20 PM,Overall,3450,4050,3450,4050,15000,2191,5474,3987,3649,15301
75,Nigeria,2019,NGA-19/NIG_ERF/RA2/P/INGO/14383,2/16/2021 1:40:26 PM,Host Communities,507,507,660,660,2334,542,676,651,583,2452
75,Nigeria,2019,NGA-19/NIG_ERF/RA2/P/INGO/14383,2/16/2021 1:40:26 PM,Internally Displaced People,1183,1183,1540,1540,5446,1286,1863,989,953,5091
75,Nigeria,2019,NGA-19/NIG_ERF/RA2/P/INGO/14383,2/16/2021 1:40:26 PM,Overall,1690,1690,2200,2200,7780,1828,2539,1640,1536,7543
75,Nigeria,2019,NGA-19/NIG_ERF/RA2/P/NGO/14189,6/8/2021 3:17:39 AM,Host Communities,100,510,100,510,1220,56284,54481,33414,33195,177374
75,Nigeria,2019,NGA-19/NIG_ERF/RA2/P/NGO/14189,6/8/2021 3:17:39 AM,Internally Displaced People,500,1500,500,1500,4000,2129,2468,2353,2547,9497
75,Nigeria,2019,NGA-19/NIG_ERF/RA2/P/NGO/14189,6/8/2021 3:17:39 AM,Overall,600,2010,600,2010,5220,58413,56949,35767,35742,186871
75,Nigeria,2019,NGA-19/NIG_ERF/RA2/P/NGO/14236,2/16/2021 1:38:37 PM,Host Communities,300,400,600,800,2100,1265,1427,840,947,4479
75,Nigeria,2019,NGA-19/NIG_ERF/RA2/P/NGO/14236,2/16/2021 1:38:37 PM,Internally Displaced People,1000,1100,1300,1500,4900,2097,5035,2660,3000,12792
75,Nigeria,2019,NGA-19/NIG_ERF/RA2/P/NGO/14236,2/16/2021 1:38:37 PM,Overall,1300,1500,1900,2300,7000,3362,6462,3500,3947,17271
75,Nigeria,2019,NGA-19/NIG_ERF/RA2/P/UN/14389,2/17/2021 10:36:53 AM,Internally Displaced People,8700,10873,11496,13931,45000,4803,6003,6347,7692,24845
75,Nigeria,2019,NGA-19/NIG_ERF/RA2/P/UN/14389,2/17/2021 10:36:53 AM,Overall,8700,10873,11496,13931,45000,4803,6003,6347,7692,24845
75,Nigeria,2019,NGA-19/NIG_ERF/RA2/P-WASH/INGO/14377,12/22/2020 12:18:39 PM,Host Communities,5376,6508,7640,8773,28297,5376,6508,7640,8773,28297
75,Nigeria,2019,NGA-19/NIG_ERF/RA2/P-WASH/INGO/14377,12/22/2020 12:18:39 PM,Internally Displaced People,1266,1533,1800,2067,6666,1266,1533,1800,2067,6666
75,Nigeria,2019,NGA-19/NIG_ERF/RA2/P-WASH/INGO/14377,12/22/2020 12:18:39 PM,Overall,6642,8041,9440,10840,34963,6642,8041,9440,10840,34963
75,Nigeria,2019,NGA-19/NIG_ERF/RA2/S/NFI/INGO/14263,6/29/2021 12:56:37 PM,Internally Displaced People,3559,4025,4924,5552,18060,2542,2875,3517,3966,12900
75,Nigeria,2019,NGA-19/NIG_ERF/RA2/S/NFI/INGO/14263,6/29/2021 12:56:37 PM,Overall,3559,4025,4924,5552,18060,2542,2875,3517,3966,12900
75,Nigeria,2019,NGA-19/NIG_ERF/RA2/S/NFI/NGO/14387,12/14/2020 12:09:20 PM,Host Communities,50,2500,50,700,3300,247,286,544,452,1529
75,Nigeria,2019,NGA-19/NIG_ERF/RA2/S/NFI/NGO/14387,12/14/2020 12:09:20 PM,Internally Displaced People,50,2500,50,800,3400,830,910,1092,1835,4667
75,Nigeria,2019,NGA-19/NIG_ERF/RA2/S/NFI/NGO/14387,12/14/2020 12:09:20 PM,Overall,150,5800,150,1650,7750,1315,1440,2066,2661,7482
75,Nigeria,2019,NGA-19/NIG_ERF/RA2/S/NFI/NGO/14387,12/14/2020 12:09:20 PM,Returnees,50,800,50,150,1050,238,244,430,374,1286
75,Nigeria,2019,NGA-19/NIG_ERF/RA2/S/NFI/UN/14198,6/10/2021 6:11:56 AM,Internally Displaced People,5188,5284,6188,7140,23800,5188,5284,6188,7140,23800
75,Nigeria,2019,NGA-19/NIG_ERF/RA2/S/NFI/UN/14198,6/10/2021 6:11:56 AM,Overall,5188,5284,6188,7140,23800,5188,5284,6188,7140,23800
75,Nigeria,2019,NGA-19/NIG_ERF/RA2/S/NFI-DMS/INGO/14364,9/16/2021 9:12:02 AM,Internally Displaced People,11173,14014,14452,17345,56984,12577,15286,15732,18333,61928
75,Nigeria,2019,NGA-19/NIG_ERF/RA2/S/NFI-DMS/INGO/14364,9/16/2021 9:12:02 AM,Overall,11173,14014,14452,17345,56984,12577,15286,15732,18333,61928
75,Nigeria,2019,NGA-19/NIG_ERF/RA2/S/NFI-DMS/NGO/14200,6/8/2021 3:32:01 AM,Internally Displaced People,3600,3575,3875,3950,15000,7484,8615,13738,13943,43780
75,Nigeria,2019,NGA-19/NIG_ERF/RA2/S/NFI-DMS/NGO/14200,6/8/2021 3:32:01 AM,Overall,3600,3575,3875,3950,15000,7484,8615,13738,13943,43780
75,Nigeria,2019,NGA-19/NIG_ERF/RA2/S/NFI-P/NGO/14370,12/11/2020 1:14:29 PM,Internally Displaced People,2500,5000,2500,5000,15000,5350,5658,4036,5128,20172
75,Nigeria,2019,NGA-19/NIG_ERF/RA2/S/NFI-P/NGO/14370,12/11/2020 1:14:29 PM,Overall,2500,5000,2500,5000,15000,5350,5658,4036,5128,20172
75,Nigeria,2019,NGA-19/NIG_ERF/RA2/WASH/INGO/14182,12/11/2020 1:46:16 PM,Host Communities,900,1150,790,370,3210,1399,1787,1228,575,4989
75,Nigeria,2019,NGA-19/NIG_ERF/RA2/WASH/INGO/14182,12/11/2020 1:46:16 PM,Internally Displaced People,2500,2800,1813,1937,9050,3885,4351,2818,3010,14064
75,Nigeria,2019,NGA-19/NIG_ERF/RA2/WASH/INGO/14182,12/11/2020 1:46:16 PM,Overall,3400,3950,2603,2307,12260,5284,6138,4046,3585,19053
75,Nigeria,2019,NGA-19/NIG_ERF/RA2/WASH/INGO/14246,5/25/2021 10:28:36 AM,Host Communities,35,44,58,63,200,675,932,1795,1704,5106
75,Nigeria,2019,NGA-19/NIG_ERF/RA2/WASH/INGO/14246,5/25/2021 10:28:36 AM,Internally Displaced People,12453,14974,19829,21611,68867,18197,22705,29423,32742,103067
75,Nigeria,2019,NGA-19/NIG_ERF/RA2/WASH/INGO/14246,5/25/2021 10:28:36 AM,Overall,12488,15018,19887,21674,69067,18872,23637,31218,34446,108173
75,Nigeria,2019,NGA-19/NIG_ERF/RA2/WASH/INGO/14368,6/8/2021 2:50:21 AM,Host Communities,2625,2888,3144,4069,12726,5474,6022,7389,8485,27370
75,Nigeria,2019,NGA-19/NIG_ERF/RA2/WASH/INGO/14368,6/8/2021 2:50:21 AM,Internally Displaced People,7875,8663,10631,12206,39375,5250,8138,7088,5775,26251
75,Nigeria,2019,NGA-19/NIG_ERF/RA2/WASH/INGO/14368,6/8/2021 2:50:21 AM,Overall,10500,11551,13775,16275,52101,10724,14160,14477,14260,53621
75,Nigeria,2019,NGA-19/NIG_ERF/RA2/WASH/NGO/14177,8/16/2021 9:33:15 AM,Host Communities,29073,35996,44791,54380,164240,29571,36130,44343,54196,164240
75,Nigeria,2019,NGA-19/NIG_ERF/RA2/WASH/NGO/14177,8/16/2021 9:33:15 AM,Internally Displaced People,9264,11319,13892,16979,51454,9264,11319,13892,16979,51454
75,Nigeria,2019,NGA-19/NIG_ERF/RA2/WASH/NGO/14177,8/16/2021 9:33:15 AM,Overall,38337,47315,58683,71359,215694,38835,47449,58235,71175,215694
75,Nigeria,2019,NGA-19/NIG_ERF/RA2/WASH/UN/14181,5/10/2021 9:46:38 AM,Host Communities,900,1800,1500,1800,6000,900,1800,1500,1800,6000
75,Nigeria,2019,NGA-19/NIG_ERF/RA2/WASH/UN/14181,5/10/2021 9:46:38 AM,Internally Displaced People,8175,16350,13625,16350,54500,8175,16350,13625,16350,54500
75,Nigeria,2019,NGA-19/NIG_ERF/RA2/WASH/UN/14181,5/10/2021 9:46:38 AM,Overall,9075,18150,15125,18150,60500,9075,18150,15125,18150,60500
75,Nigeria,2019,NGA-19/NIG_ERF/RA2/WASH/UN/14381,6/1/2021 6:02:16 AM,Internally Displaced People,136620,160380,166980,196020,660000,129589,165089,168653,196693,660024
75,Nigeria,2019,NGA-19/NIG_ERF/RA2/WASH/UN/14381,6/1/2021 6:02:16 AM,Overall,136620,160380,166980,196020,660000,129589,165089,168653,196693,660024
75,Nigeria,2020,NGA-20/NIG_ERF/RA1/H/UN/16050,6/8/2021 8:45:30 AM,Host Communities,2000,1843,0,0,3843,1900,1750,0,0,3650
75,Nigeria,2020,NGA-20/NIG_ERF/RA1/H/UN/16050,6/8/2021 8:45:30 AM,Overall,2000,1843,0,0,3843,1900,1750,0,0,3650
75,Nigeria,2020,NGA-20/NIG_ERF/SA1/C/UN/16572,8/9/2021 10:43:20 AM,Other,60,20,25,15,120,71,40,0,0,111
75,Nigeria,2020,NGA-20/NIG_ERF/SA1/C/UN/16572,8/9/2021 10:43:20 AM,Overall,60,20,25,15,120,71,40,0,0,111
75,Nigeria,2020,NGA-20/NIG_ERF/SA1/C/UN/16586,1/22/2022 3:26:41 PM,Internally Displaced People,15000,30000,25000,30000,100000,60000,120000,100000,120000,400000
75,Nigeria,2020,NGA-20/NIG_ERF/SA1/C/UN/16586,1/22/2022 3:26:41 PM,Other,70,30,0,0,100,140,60,0,0,200
75,Nigeria,2020,NGA-20/NIG_ERF/SA1/C/UN/16586,1/22/2022 3:26:41 PM,Overall,15070,30030,25000,30000,100100,60140,120060,100000,120000,400200
75,Nigeria,2020,NGA-20/NIG_ERF/SA1/DMS/INGO/17121,7/28/2022 12:15:02 PM,Internally Displaced People,6614,9180,12680,10851,39325,0,0,0,0,0
75,Nigeria,2020,NGA-20/NIG_ERF/SA1/DMS/INGO/17121,7/28/2022 12:15:02 PM,Overall,6614,9180,12680,10851,39325,0,0,0,0,0
75,Nigeria,2020,NGA-20/NIG_ERF/SA1/DMS/UN/16648,6/30/2021 11:00:08 AM,Internally Displaced People,29304,36065,37710,46921,150000,29304,36065,37710,46921,150000
75,Nigeria,2020,NGA-20/NIG_ERF/SA1/DMS/UN/16648,6/30/2021 11:00:08 AM,Overall,29304,36065,37710,46921,150000,29304,36065,37710,46921,150000
75,Nigeria,2020,NGA-20/NIG_ERF/SA1/DMS-P/INGO/16632,1/28/2022 1:01:41 PM,Host Communities,521,504,310,310,1645,3038,3864,1018,1005,8925
75,Nigeria,2020,NGA-20/NIG_ERF/SA1/DMS-P/INGO/16632,1/28/2022 1:01:41 PM,Internally Displaced People,21222,22494,24528,30398,98642,18819,21857,19187,23882,83745
75,Nigeria,2020,NGA-20/NIG_ERF/SA1/DMS-P/INGO/16632,1/28/2022 1:01:41 PM,Overall,22267,23502,25153,31023,101945,22009,25780,20206,24887,92882
75,Nigeria,2020,NGA-20/NIG_ERF/SA1/DMS-P/INGO/16632,1/28/2022 1:01:41 PM,Returnees,524,504,315,315,1658,152,59,1,0,212
75,Nigeria,2020,NGA-20/NIG_ERF/SA1/DMS-S/NFI/UN/16548,1/22/2022 5:59:41 PM,Internally Displaced People,55549,62284,23540,28617,169990,33974,48389,51258,59586,193207
75,Nigeria,2020,NGA-20/NIG_ERF/SA1/DMS-S/NFI/UN/16548,1/22/2022 5:59:41 PM,Overall,55549,62284,23540,28617,169990,33974,48389,51258,59586,193207
75,Nigeria,2020,NGA-20/NIG_ERF/SA1/DMS-S/NFI/UN/17120,3/8/2022 8:44:31 AM,Internally Displaced People,13894,15535,5584,7217,42230,57641,77137,77284,89917,301979
75,Nigeria,2020,NGA-20/NIG_ERF/SA1/DMS-S/NFI/UN/17120,3/8/2022 8:44:31 AM,Overall,13894,15535,5584,7217,42230,57641,77137,77284,89917,301979
75,Nigeria,2020,NGA-20/NIG_ERF/SA1/F/NGO/16491,11/11/2021 10:28:00 AM,Overall,900,1000,1000,1100,4000,604,1016,1245,1339,4204
75,Nigeria,2020,NGA-20/NIG_ERF/SA1/F/NGO/16491,11/11/2021 10:28:00 AM,Refugees,900,1000,1000,1100,4000,604,1016,1245,1339,4204
75,Nigeria,2020,NGA-20/NIG_ERF/SA1/F/NGO/16630,7/19/2021 9:26:56 AM,Overall,100,200,200,300,800,72,752,79,97,1000
75,Nigeria,2020,NGA-20/NIG_ERF/SA1/F/NGO/16630,7/19/2021 9:26:56 AM,Refugees,100,200,200,300,800,72,752,79,97,1000
75,Nigeria,2020,NGA-20/NIG_ERF/SA1/H/INGO/16552,11/11/2021 10:18:16 AM,Host Communities,58411,91264,16428,16428,182531,8568,38151,19308,17714,83741
75,Nigeria,2020,NGA-20/NIG_ERF/SA1/H/INGO/16552,11/11/2021 10:18:16 AM,Internally Displaced People,8387,13108,2359,2359,26213,556,1137,640,651,2984
75,Nigeria,2020,NGA-20/NIG_ERF/SA1/H/INGO/16552,11/11/2021 10:18:16 AM,Overall,66798,104372,18787,18787,208744,9124,39288,19948,18365,86725
75,Nigeria,2020,NGA-20/NIG_ERF/SA1/H/INGO/16571,10/29/2021 11:24:19 AM,Host Communities,10768,20195,17082,18956,67001,12025,14725,11415,11666,49831
75,Nigeria,2020,NGA-20/NIG_ERF/SA1/H/INGO/16571,10/29/2021 11:24:19 AM,Internally Displaced People,10963,10445,6077,7505,34990,14556,16849,10972,14874,57251
75,Nigeria,2020,NGA-20/NIG_ERF/SA1/H/INGO/16571,10/29/2021 11:24:19 AM,Overall,21731,30640,23159,26461,101991,26581,31574,22387,26540,107082
75,Nigeria,2020,NGA-20/NIG_ERF/SA1/H/INGO/16605,7/15/2021 2:01:11 PM,Host Communities,4556,2300,6058,1000,13914,3863,12709,3541,9183,29296
75,Nigeria,2020,NGA-20/NIG_ERF/SA1/H/INGO/16605,7/15/2021 2:01:11 PM,Internally Displaced People,4556,5738,6058,7223,23575,7108,22090,6932,16697,52827
75,Nigeria,2020,NGA-20/NIG_ERF/SA1/H/INGO/16605,7/15/2021 2:01:11 PM,Overall,9112,8038,12116,8223,37489,10971,34799,10473,25880,82123
75,Nigeria,2020,NGA-20/NIG_ERF/SA1/H/NGO/16504,1/17/2022 11:15:44 AM,Host Communities,0,1500,0,1500,3000,0,1534,0,3568,5102
75,Nigeria,2020,NGA-20/NIG_ERF/SA1/H/NGO/16504,1/17/2022 11:15:44 AM,Internally Displaced People,0,1000,0,1200,2200,0,1266,0,2584,3850
75,Nigeria,2020,NGA-20/NIG_ERF/SA1/H/NGO/16504,1/17/2022 11:15:44 AM,Overall,0,2900,0,3100,6000,0,3252,0,7576,10828
75,Nigeria,2020,NGA-20/NIG_ERF/SA1/H/NGO/16504,1/17/2022 11:15:44 AM,Returnees,0,400,0,400,800,0,452,0,1424,1876
75,Nigeria,2020,NGA-20/NIG_ERF/SA1/H/NGO/16515,9/20/2021 11:24:31 AM,Host Communities,30000,45000,30000,30000,135000,23979,37095,28267,30000,119341
75,Nigeria,2020,NGA-20/NIG_ERF/SA1/H/NGO/16515,9/20/2021 11:24:31 AM,Internally Displaced People,8016,10126,10970,13080,42192,7267,10115,9854,12906,40142
75,Nigeria,2020,NGA-20/NIG_ERF/SA1/H/NGO/16515,9/20/2021 11:24:31 AM,Overall,38041,55156,41000,43120,177317,31271,47240,38151,42946,159608
75,Nigeria,2020,NGA-20/NIG_ERF/SA1/H/NGO/16515,9/20/2021 11:24:31 AM,Returnees,25,30,30,40,125,25,30,30,40,125
75,Nigeria,2020,NGA-20/NIG_ERF/SA1/H/NGO/16540,9/21/2021 2:45:56 PM,Host Communities,4860,6750,7290,8100,27000,5711,7932,8566,9518,31727
75,Nigeria,2020,NGA-20/NIG_ERF/SA1/H/NGO/16540,9/21/2021 2:45:56 PM,Internally Displaced People,1620,2250,2430,2700,9000,1904,2644,2855,3172,10575
75,Nigeria,2020,NGA-20/NIG_ERF/SA1/H/NGO/16540,9/21/2021 2:45:56 PM,Overall,9720,13500,14580,16200,54000,11422,15864,17132,19034,63452
75,Nigeria,2020,NGA-20/NIG_ERF/SA1/H/NGO/16540,9/21/2021 2:45:56 PM,Returnees,3240,4500,4860,5400,18000,3807,5288,5711,6344,21150
75,Nigeria,2020,NGA-20/NIG_ERF/SA1/H/NGO/16560,10/29/2021 11:10:49 AM,Host Communities,3500,3500,5000,8000,20000,2770,3661,3831,5623,15885
75,Nigeria,2020,NGA-20/NIG_ERF/SA1/H/NGO/16560,10/29/2021 11:10:49 AM,Internally Displaced People,5000,5000,8000,12000,30000,5260,8755,6547,7952,28514
75,Nigeria,2020,NGA-20/NIG_ERF/SA1/H/NGO/16560,10/29/2021 11:10:49 AM,Overall,8500,8500,13000,20000,50000,8030,12416,10378,13575,44399
75,Nigeria,2020,NGA-20/NIG_ERF/SA1/H/UN/16638,7/23/2021 8:38:59 AM,Host Communities,7000,20000,7000,20000,54000,11200,30240,3958,49365,94763
75,Nigeria,2020,NGA-20/NIG_ERF/SA1/H/UN/16638,7/23/2021 8:38:59 AM,Internally Displaced People,58000,80000,58000,80000,276000,56800,93910,60024,94229,304963
75,Nigeria,2020,NGA-20/NIG_ERF/SA1/H/UN/16638,7/23/2021 8:38:59 AM,Overall,65000,100000,65000,100000,330000,68000,124150,63982,143594,399726
75,Nigeria,2020,NGA-20/NIG_ERF/SA1/H/UN/17531,1/24/2022 10:46:58 AM,Host Communities,25000,30000,11000,15000,81000,22674,27133,9364,13300,72471
75,Nigeria,2020,NGA-20/NIG_ERF/SA1/H/UN/17531,1/24/2022 10:46:58 AM,Internally Displaced People,135000,135000,60000,60000,390000,104446,125275,54147,53338,337206
75,Nigeria,2020,NGA-20/NIG_ERF/SA1/H/UN/17531,1/24/2022 10:46:58 AM,Other,1001,1000,500,500,3001,684,747,382,367,2180
75,Nigeria,2020,NGA-20/NIG_ERF/SA1/H/UN/17531,1/24/2022 10:46:58 AM,Overall,187001,189500,81000,85000,542501,147735,173998,72002,75292,469027
75,Nigeria,2020,NGA-20/NIG_ERF/SA1/H/UN/17531,1/24/2022 10:46:58 AM,Refugees,20000,15000,7000,7000,49000,15171,13713,6092,6339,41315
75,Nigeria,2020,NGA-20/NIG_ERF/SA1/H/UN/17531,1/24/2022 10:46:58 AM,Returnees,6000,8500,2500,2500,19500,4760,7130,2017,1948,15855
75,Nigeria,2020,NGA-20/NIG_ERF/SA1/N/INGO/16479,1/31/2022 2:09:00 PM,Host Communities,145,1303,710,738,2896,36,1869,919,986,3810
75,Nigeria,2020,NGA-20/NIG_ERF/SA1/N/INGO/16479,1/31/2022 2:09:00 PM,Internally Displaced People,59,530,289,300,1178,10,691,360,341,1402
75,Nigeria,2020,NGA-20/NIG_ERF/SA1/N/INGO/16479,1/31/2022 2:09:00 PM,Overall,250,2251,1226,1275,5002,46,2765,1394,1417,5622
75,Nigeria,2020,NGA-20/NIG_ERF/SA1/N/INGO/16479,1/31/2022 2:09:00 PM,Returnees,46,418,227,237,928,0,205,115,90,410
75,Nigeria,2020,NGA-20/NIG_ERF/SA1/N/INGO/16551,10/4/2021 1:31:48 PM,Host Communities,1025,1725,315,366,3431,835,8225,3112,4286,16458
75,Nigeria,2020,NGA-20/NIG_ERF/SA1/N/INGO/16551,10/4/2021 1:31:48 PM,Internally Displaced People,5556,9849,2597,1272,19274,4414,13280,17641,24293,59628
75,Nigeria,2020,NGA-20/NIG_ERF/SA1/N/INGO/16551,10/4/2021 1:31:48 PM,Overall,6581,11574,2912,1638,22705,5249,21505,20753,28579,76086
75,Nigeria,2020,NGA-20/NIG_ERF/SA1/N/INGO/16614,1/22/2022 3:14:14 PM,Host Communities,457,4460,12280,14216,31413,1027,11871,10256,13572,36726
75,Nigeria,2020,NGA-20/NIG_ERF/SA1/N/INGO/16614,1/22/2022 3:14:14 PM,Internally Displaced People,685,6689,18418,21323,47115,1540,17800,15383,20358,55081
75,Nigeria,2020,NGA-20/NIG_ERF/SA1/N/INGO/16614,1/22/2022 3:14:14 PM,Overall,1142,11149,30698,35539,78528,2567,29671,25639,33930,91807
75,Nigeria,2020,NGA-20/NIG_ERF/SA1/N/INGO/16644,1/25/2022 4:38:53 PM,Host Communities,147,4547,5152,5188,15034,67,4957,14862,16878,36764
75,Nigeria,2020,NGA-20/NIG_ERF/SA1/N/INGO/16644,1/25/2022 4:38:53 PM,Internally Displaced People,63,1563,1830,1830,5286,22,68,1323,1613,3026
75,Nigeria,2020,NGA-20/NIG_ERF/SA1/N/INGO/16644,1/25/2022 4:38:53 PM,Overall,210,6110,6982,7018,20320,89,5025,16185,18491,39790
75,Nigeria,2020,NGA-20/NIG_ERF/SA1/N/NGO/16567,8/4/2021 10:51:56 AM,Host Communities,100,800,2200,3300,6400,392,2423,5183,4623,12621
75,Nigeria,2020,NGA-20/NIG_ERF/SA1/N/NGO/16567,8/4/2021 10:51:56 AM,Internally Displaced People,50,2225,2600,2500,7375,243,2167,3943,3633,9986
75,Nigeria,2020,NGA-20/NIG_ERF/SA1/N/NGO/16567,8/4/2021 10:51:56 AM,Overall,175,3325,5400,6100,15000,675,4802,9536,8589,23602
75,Nigeria,2020,NGA-20/NIG_ERF/SA1/N/NGO/16567,8/4/2021 10:51:56 AM,Returnees,25,300,600,300,1225,40,212,410,333,995
75,Nigeria,2020,NGA-20/NIG_ERF/SA1/N/NGO/16579,11/11/2021 10:55:05 AM,Host Communities,1150,6300,590,1390,9430,2555,7533,134,534,10756
75,Nigeria,2020,NGA-20/NIG_ERF/SA1/N/NGO/16579,11/11/2021 10:55:05 AM,Overall,1150,6300,590,1390,9430,2555,7533,134,534,10756
75,Nigeria,2020,NGA-20/NIG_ERF/SA1/N/UN/16566,11/11/2021 10:46:25 AM,Host Communities,0,0,4974,6075,11049,0,0,6201,7575,13776
75,Nigeria,2020,NGA-20/NIG_ERF/SA1/N/UN/16566,11/11/2021 10:46:25 AM,Internally Displaced People,0,0,1718,2102,3820,0,0,2100,2560,4660
75,Nigeria,2020,NGA-20/NIG_ERF/SA1/N/UN/16566,11/11/2021 10:46:25 AM,Overall,0,0,7691,9397,17088,0,0,9547,11651,21198
75,Nigeria,2020,NGA-20/NIG_ERF/SA1/N/UN/16566,11/11/2021 10:46:25 AM,Returnees,0,0,999,1220,2219,0,0,1246,1516,2762
75,Nigeria,2020,NGA-20/NIG_ERF/SA1/N/UN/16609,7/22/2021 12:41:57 PM,Host Communities,43,29,810,792,1674,43,29,721,762,1555
75,Nigeria,2020,NGA-20/NIG_ERF/SA1/N/UN/16609,7/22/2021 12:41:57 PM,Internally Displaced People,0,0,343,332,675,0,0,253,262,515
75,Nigeria,2020,NGA-20/NIG_ERF/SA1/N/UN/16609,7/22/2021 12:41:57 PM,Overall,43,29,1500,1462,3034,43,29,1275,1302,2649
75,Nigeria,2020,NGA-20/NIG_ERF/SA1/N/UN/16609,7/22/2021 12:41:57 PM,Returnees,0,0,347,338,685,0,0,301,278,579
75,Nigeria,2020,NGA-20/NIG_ERF/SA1/P/INGO/16499,3/8/2022 8:48:43 AM,Host Communities,5000,5500,7290,7200,24990,3506,6381,10533,8928,29348
75,Nigeria,2020,NGA-20/NIG_ERF/SA1/P/INGO/16499,3/8/2022 8:48:43 AM,Internally Displaced People,5010,9800,11020,12180,38010,3555,10618,10136,11615,35924
75,Nigeria,2020,NGA-20/NIG_ERF/SA1/P/INGO/16499,3/8/2022 8:48:43 AM,Overall,10010,15300,18310,19380,63000,7061,16999,20669,20543,65272
75,Nigeria,2020,NGA-20/NIG_ERF/SA1/P/INGO/16503,9/3/2021 1:59:15 PM,Host Communities,46,46,385,415,892,161,297,2059,1989,4506
75,Nigeria,2020,NGA-20/NIG_ERF/SA1/P/INGO/16503,9/3/2021 1:59:15 PM,Internally Displaced People,102,102,847,913,1964,102,240,1235,1143,2720
75,Nigeria,2020,NGA-20/NIG_ERF/SA1/P/INGO/16503,9/3/2021 1:59:15 PM,Overall,185,185,1540,1660,3570,303,640,3959,4057,8959
75,Nigeria,2020,NGA-20/NIG_ERF/SA1/P/INGO/16503,9/3/2021 1:59:15 PM,Returnees,37,37,308,332,714,40,103,665,925,1733
75,Nigeria,2020,NGA-20/NIG_ERF/SA1/P/INGO/16637,7/1/2021 1:51:26 PM,Internally Displaced People,1532,1532,728,728,4520,1195,2277,769,785,5026
75,Nigeria,2020,NGA-20/NIG_ERF/SA1/P/INGO/16637,7/1/2021 1:51:26 PM,Overall,1532,1532,728,728,4520,1195,2277,769,785,5026
75,Nigeria,2020,NGA-20/NIG_ERF/SA1/P/INGO/16640,8/9/2021 10:07:22 AM,Host Communities,0,50,0,50,100,0,42,0,33,75
75,Nigeria,2020,NGA-20/NIG_ERF/SA1/P/INGO/16640,8/9/2021 10:07:22 AM,Internally Displaced People,0,200,0,100,300,0,107,0,25,132
75,Nigeria,2020,NGA-20/NIG_ERF/SA1/P/INGO/16640,8/9/2021 10:07:22 AM,Overall,0,250,0,150,400,0,149,0,58,207
75,Nigeria,2020,NGA-20/NIG_ERF/SA1/P/INGO/16641,8/10/2021 8:24:55 AM,Host Communities,365,754,418,922,2459,942,8086,399,3597,13024
75,Nigeria,2020,NGA-20/NIG_ERF/SA1/P/INGO/16641,8/10/2021 8:24:55 AM,Internally Displaced People,852,1761,975,2153,5741,0,0,0,0,0
75,Nigeria,2020,NGA-20/NIG_ERF/SA1/P/INGO/16641,8/10/2021 8:24:55 AM,Overall,1217,2515,1393,3075,8200,942,8086,399,3597,13024
75,Nigeria,2020,NGA-20/NIG_ERF/SA1/P/NGO/16494,11/11/2021 10:59:25 AM,Host Communities,150,200,600,600,1550,2434,2728,3315,3486,11963
75,Nigeria,2020,NGA-20/NIG_ERF/SA1/P/NGO/16494,11/11/2021 10:59:25 AM,Internally Displaced People,250,400,800,1000,2450,3794,4659,6825,7575,22853
75,Nigeria,2020,NGA-20/NIG_ERF/SA1/P/NGO/16494,11/11/2021 10:59:25 AM,Overall,400,600,1400,1600,4000,6228,7387,10140,11061,34816
75,Nigeria,2020,NGA-20/NIG_ERF/SA1/P/NGO/16523,10/4/2021 11:08:46 AM,Host Communities,843,1335,597,894,3669,1560,2747,1520,1598,7425
75,Nigeria,2020,NGA-20/NIG_ERF/SA1/P/NGO/16523,10/4/2021 11:08:46 AM,Internally Displaced People,843,1335,597,894,3669,529,885,356,385,2155
75,Nigeria,2020,NGA-20/NIG_ERF/SA1/P/NGO/16523,10/4/2021 11:08:46 AM,Overall,2810,4450,1990,2980,12230,3017,4737,2775,2705,13234
75,Nigeria,2020,NGA-20/NIG_ERF/SA1/P/NGO/16523,10/4/2021 11:08:46 AM,Returnees,1124,1780,796,1192,4892,928,1105,899,722,3654
75,Nigeria,2020,NGA-20/NIG_ERF/SA1/P/NGO/16613,9/20/2021 11:28:26 AM,Host Communities,65,60,1989,2782,4896,159,259,1824,2043,4285
75,Nigeria,2020,NGA-20/NIG_ERF/SA1/P/NGO/16613,9/20/2021 11:28:26 AM,Internally Displaced People,15,20,811,850,1696,228,472,1702,1532,3934
75,Nigeria,2020,NGA-20/NIG_ERF/SA1/P/NGO/16613,9/20/2021 11:28:26 AM,Overall,80,80,2800,3632,6592,387,731,3526,3575,8219
75,Nigeria,2020,NGA-20/NIG_ERF/SA1/P/UN/16492,7/1/2021 4:00:48 PM,Internally Displaced People,1434,3899,2080,2587,10000,2565,4397,4527,3886,15375
75,Nigeria,2020,NGA-20/NIG_ERF/SA1/P/UN/16492,7/1/2021 4:00:48 PM,Overall,1434,3899,2080,2587,10000,2565,4397,4527,3886,15375
75,Nigeria,2020,NGA-20/NIG_ERF/SA1/P/UN/16501,7/15/2021 9:58:01 AM,Host Communities,0,800,0,1400,2200,0,800,0,1400,2200
75,Nigeria,2020,NGA-20/NIG_ERF/SA1/P/UN/16501,7/15/2021 9:58:01 AM,Internally Displaced People,0,1300,0,1500,2800,0,1300,0,1500,2800
75,Nigeria,2020,NGA-20/NIG_ERF/SA1/P/UN/16501,7/15/2021 9:58:01 AM,Overall,0,2100,0,2900,5000,0,2100,0,2900,5000
75,Nigeria,2020,NGA-20/NIG_ERF/SA1/P/UN/17525,5/19/2023 9:08:42 AM,Host Communities,9862,2966,9478,637,22943,23045,21683,18259,16260,79247
75,Nigeria,2020,NGA-20/NIG_ERF/SA1/P/UN/17525,5/19/2023 9:08:42 AM,Internally Displaced People,21356,11780,16326,7327,56789,34567,32524,27388,24389,118868
75,Nigeria,2020,NGA-20/NIG_ERF/SA1/P/UN/17525,5/19/2023 9:08:42 AM,Overall,35640,23606,37596,13433,110275,57612,54207,45647,40649,198115
75,Nigeria,2020,NGA-20/NIG_ERF/SA1/P/UN/17525,5/19/2023 9:08:42 AM,Returnees,4422,8860,11792,5469,30543,0,0,0,0,0
75,Nigeria,2020,NGA-20/NIG_ERF/SA1/P-DMS/INGO/16624,1/18/2022 1:19:36 PM,Host Communities,26505,32859,28738,32513,120615,27831,32910,28831,32513,122085
75,Nigeria,2020,NGA-20/NIG_ERF/SA1/P-DMS/INGO/16624,1/18/2022 1:19:36 PM,Internally Displaced People,31316,38367,47260,54330,171273,31316,36367,47790,54330,169803
75,Nigeria,2020,NGA-20/NIG_ERF/SA1/P-DMS/INGO/16624,1/18/2022 1:19:36 PM,Overall,82905,99154,103828,114820,400707,59523,69646,77604,87825,294598
75,Nigeria,2020,NGA-20/NIG_ERF/SA1/P-DMS/INGO/16624,1/18/2022 1:19:36 PM,Refugees,220,245,363,274,1102,0,0,0,0,0
75,Nigeria,2020,NGA-20/NIG_ERF/SA1/P-DMS/INGO/16624,1/18/2022 1:19:36 PM,Returnees,24864,27683,27467,27703,107717,376,369,983,982,2710
75,Nigeria,2020,NGA-20/NIG_ERF/SA1/S/NFI/INGO/17124,3/8/2022 11:05:00 AM,Internally Displaced People,714,680,782,1224,3400,602,725,1258,1073,3658
75,Nigeria,2020,NGA-20/NIG_ERF/SA1/S/NFI/INGO/17124,3/8/2022 11:05:00 AM,Overall,714,680,782,1224,3400,602,725,1258,1073,3658
75,Nigeria,2020,NGA-20/NIG_ERF/SA1/S/NFI/NGO/16516,7/19/2021 9:13:19 AM,Internally Displaced People,1000,1500,1000,1500,5000,1000,1500,1000,1500,5000
75,Nigeria,2020,NGA-20/NIG_ERF/SA1/S/NFI/NGO/16516,7/19/2021 9:13:19 AM,Overall,1000,1500,1000,1500,5000,1000,1500,1000,1500,5000
75,Nigeria,2020,NGA-20/NIG_ERF/SA1/S/NFI/NGO/16569,9/16/2021 10:50:00 AM,Host Communities,900,2875,500,600,4875,612,700,1301,1244,3857
75,Nigeria,2020,NGA-20/NIG_ERF/SA1/S/NFI/NGO/16569,9/16/2021 10:50:00 AM,Internally Displaced People,1500,4250,700,1100,7550,1609,1916,3238,2967,9730
75,Nigeria,2020,NGA-20/NIG_ERF/SA1/S/NFI/NGO/16569,9/16/2021 10:50:00 AM,Overall,2900,9000,1500,2000,15400,2290,2680,4661,4333,13964
75,Nigeria,2020,NGA-20/NIG_ERF/SA1/S/NFI/NGO/16569,9/16/2021 10:50:00 AM,Returnees,500,1875,300,300,2975,69,64,122,122,377
75,Nigeria,2020,NGA-20/NIG_ERF/SA1/S/NFI/UN/16493,6/29/2021 2:37:19 PM,Internally Displaced People,1199,1221,1430,1650,5500,1199,1221,1430,1650,5500
75,Nigeria,2020,NGA-20/NIG_ERF/SA1/S/NFI/UN/16493,6/29/2021 2:37:19 PM,Overall,1199,1221,1430,1650,5500,1199,1221,1430,1650,5500
75,Nigeria,2020,NGA-20/NIG_ERF/SA1/S/NFI-DMS/INGO/16587,3/8/2022 11:12:50 AM,Internally Displaced People,1890,2070,2250,2790,9000,3117,3458,6449,6591,19615
75,Nigeria,2020,NGA-20/NIG_ERF/SA1/S/NFI-DMS/INGO/16587,3/8/2022 11:12:50 AM,Overall,1890,2070,2250,2790,9000,3117,3458,6449,6591,19615
75,Nigeria,2020,NGA-20/NIG_ERF/SA1/S/NFI-DMS/NGO/16517,1/17/2022 11:06:02 AM,Host Communities,2800,2900,3100,3200,12000,2917,2089,3973,4069,13048
75,Nigeria,2020,NGA-20/NIG_ERF/SA1/S/NFI-DMS/NGO/16517,1/17/2022 11:06:02 AM,Internally Displaced People,3500,4500,5500,6500,20000,8102,10385,16380,18062,52929
75,Nigeria,2020,NGA-20/NIG_ERF/SA1/S/NFI-DMS/NGO/16517,1/17/2022 11:06:02 AM,Overall,8000,9500,10500,12000,40000,12665,14487,21883,23787,72822
75,Nigeria,2020,NGA-20/NIG_ERF/SA1/S/NFI-DMS/NGO/16517,1/17/2022 11:06:02 AM,Returnees,1700,2100,1900,2300,8000,1646,2013,1530,1656,6845
75,Nigeria,2020,NGA-20/NIG_ERF/SA1/WASH/INGO/16476,1/19/2022 8:19:25 AM,Host Communities,4094,6141,6141,9211,25587,3165,3729,4818,5557,17269
75,Nigeria,2020,NGA-20/NIG_ERF/SA1/WASH/INGO/16476,1/19/2022 8:19:25 AM,Internally Displaced People,9552,14328,14328,21492,59700,10613,12009,17818,16346,56786
75,Nigeria,2020,NGA-20/NIG_ERF/SA1/WASH/INGO/16476,1/19/2022 8:19:25 AM,Overall,13646,20469,20469,30703,85287,13778,15738,22636,21903,74055
75,Nigeria,2020,NGA-20/NIG_ERF/SA1/WASH/INGO/16489,1/31/2022 11:17:00 AM,Host Communities,315,378,251,316,1260,5989,16894,9536,11471,43890
75,Nigeria,2020,NGA-20/NIG_ERF/SA1/WASH/INGO/16489,1/31/2022 11:17:00 AM,Internally Displaced People,18584,22303,14868,18585,74340,2041,11338,3067,4392,20838
75,Nigeria,2020,NGA-20/NIG_ERF/SA1/WASH/INGO/16489,1/31/2022 11:17:00 AM,Overall,18899,22681,15119,18901,75600,8030,28232,12603,15863,64728
75,Nigeria,2020,NGA-20/NIG_ERF/SA1/WASH/INGO/16528,8/3/2021 11:08:11 AM,Host Communities,1050,1700,1850,2000,6600,1960,3175,3454,3734,12323
75,Nigeria,2020,NGA-20/NIG_ERF/SA1/WASH/INGO/16528,8/3/2021 11:08:11 AM,Internally Displaced People,1635,2191,1845,2190,7861,3052,4091,3445,4089,14677
75,Nigeria,2020,NGA-20/NIG_ERF/SA1/WASH/INGO/16528,8/3/2021 11:08:11 AM,Overall,2685,3891,3695,4190,14461,5012,7266,6899,7823,27000
75,Nigeria,2020,NGA-20/NIG_ERF/SA1/WASH/INGO/16547,9/16/2021 8:51:17 AM,Host Communities,1050,1250,1150,1550,5000,5759,7868,4381,5029,23037
75,Nigeria,2020,NGA-20/NIG_ERF/SA1/WASH/INGO/16547,9/16/2021 8:51:17 AM,Internally Displaced People,2100,2500,2300,3100,10000,569,635,1612,1678,4494
75,Nigeria,2020,NGA-20/NIG_ERF/SA1/WASH/INGO/16547,9/16/2021 8:51:17 AM,Overall,3150,3750,3450,4650,15000,6328,8503,5993,6707,27531
75,Nigeria,2020,NGA-20/NIG_ERF/SA1/WASH/INGO/16554,1/18/2022 3:59:33 PM,Host Communities,534,625,691,850,2700,3777,5962,4882,5859,20480
75,Nigeria,2020,NGA-20/NIG_ERF/SA1/WASH/INGO/16554,1/18/2022 3:59:33 PM,Internally Displaced People,2669,3126,3455,4250,13500,2612,5394,2768,4335,15109
75,Nigeria,2020,NGA-20/NIG_ERF/SA1/WASH/INGO/16554,1/18/2022 3:59:33 PM,Overall,3559,4168,4607,5666,18000,6389,11356,7650,10194,35589
75,Nigeria,2020,NGA-20/NIG_ERF/SA1/WASH/INGO/16554,1/18/2022 3:59:33 PM,Returnees,356,417,461,566,1800,0,0,0,0,0
75,Nigeria,2020,NGA-20/NIG_ERF/SA1/WASH/INGO/16627,7/19/2021 11:07:53 AM,Host Communities,1872,2609,2648,3311,10440,6047,11032,4622,6165,27866
75,Nigeria,2020,NGA-20/NIG_ERF/SA1/WASH/INGO/16627,7/19/2021 11:07:53 AM,Internally Displaced People,4601,6388,6576,8352,25917,7585,11041,5058,7363,31047
75,Nigeria,2020,NGA-20/NIG_ERF/SA1/WASH/INGO/16627,7/19/2021 11:07:53 AM,Overall,6473,8997,9224,11663,36357,13632,22073,9680,13528,58913
75,Nigeria,2020,NGA-20/NIG_ERF/SA1/WASH/NGO/16477,1/18/2022 1:05:48 PM,Host Communities,1885,3042,4589,5772,15288,37783,50645,70663,85881,244972
75,Nigeria,2020,NGA-20/NIG_ERF/SA1/WASH/NGO/16477,1/18/2022 1:05:48 PM,Internally Displaced People,580,770,90,504,1944,4211,5947,8053,9861,28072
75,Nigeria,2020,NGA-20/NIG_ERF/SA1/WASH/NGO/16477,1/18/2022 1:05:48 PM,Overall,2465,3812,4679,6276,17232,41994,56592,78716,95742,273044
75,Nigeria,2020,NGA-20/NIG_ERF/SA1/WASH/NGO/16483,9/2/2021 2:27:11 PM,Host Communities,1000,1000,1000,1000,4000,3515,3356,2550,2987,12408
75,Nigeria,2020,NGA-20/NIG_ERF/SA1/WASH/NGO/16483,9/2/2021 2:27:11 PM,Internally Displaced People,4000,5000,1000,1000,11000,1746,2848,1424,1807,7825
75,Nigeria,2020,NGA-20/NIG_ERF/SA1/WASH/NGO/16483,9/2/2021 2:27:11 PM,Overall,5000,6000,2000,2000,15000,5261,6204,3974,4794,20233
75,Nigeria,2020,NGA-20/NIG_ERF/SA1/WASH/NGO/16559,10/29/2021 10:35:07 AM,Host Communities,2400,3600,2400,1600,10000,2240,2737,3360,4106,12443
75,Nigeria,2020,NGA-20/NIG_ERF/SA1/WASH/NGO/16559,10/29/2021 10:35:07 AM,Internally Displaced People,3600,5400,3600,2400,15000,4635,5709,7015,8576,25935
75,Nigeria,2020,NGA-20/NIG_ERF/SA1/WASH/NGO/16559,10/29/2021 10:35:07 AM,Overall,6000,9000,6000,4000,25000,6875,8446,10375,12682,38378
75,Nigeria,2020,NGA-20/NIG_ERF/SA1/WASH/NGO/16596,1/31/2022 4:59:42 PM,Host Communities,1350,2650,1500,1500,7000,3710,2339,4224,3918,14191
75,Nigeria,2020,NGA-20/NIG_ERF/SA1/WASH/NGO/16596,1/31/2022 4:59:42 PM,Internally Displaced People,2500,3560,1450,1450,8960,10930,8563,14305,10847,44645
75,Nigeria,2020,NGA-20/NIG_ERF/SA1/WASH/NGO/16596,1/31/2022 4:59:42 PM,Overall,4150,7010,3450,3550,18160,19140,14734,26442,21208,81524
75,Nigeria,2020,NGA-20/NIG_ERF/SA1/WASH/NGO/16596,1/31/2022 4:59:42 PM,Returnees,300,800,500,600,2200,4500,3832,7913,6443,22688
75,Nigeria,2020,NGA-20/NIG_ERF/SA1/WASH/UN/16542,1/18/2022 3:46:59 PM,Internally Displaced People,27768,55537,46281,55537,185123,27780,55586,47645,55586,186597
75,Nigeria,2020,NGA-20/NIG_ERF/SA1/WASH/UN/16542,1/18/2022 3:46:59 PM,Overall,27768,55537,46281,55537,185123,27780,55586,47645,55586,186597
75,Nigeria,2021,NGA-21/NIG_ERF/RA1/N-P-E/INGO/18454,10/21/2022 8:47:51 AM,Host Communities,771,2905,6489,7219,17384,890,5750,11029,8595,26264
75,Nigeria,2021,NGA-21/NIG_ERF/RA1/N-P-E/INGO/18454,10/21/2022 8:47:51 AM,Internally Displaced People,524,1428,4292,5280,11524,3232,3368,7954,4086,18640
75,Nigeria,2021,NGA-21/NIG_ERF/RA1/N-P-E/INGO/18454,10/21/2022 8:47:51 AM,Overall,1595,7031,14716,16682,40024,8532,17815,41969,26832,95148
75,Nigeria,2021,NGA-21/NIG_ERF/RA1/N-P-E/INGO/18454,10/21/2022 8:47:51 AM,Returnees,300,2698,3935,4183,11116,4410,8697,22986,14151,50244
75,Nigeria,2021,NGA-21/NIG_ERF/RA1/N-P-E/INGO/18482,8/31/2022 12:07:19 PM,Host Communities,300,3322,1922,2418,7962,1165,6344,2768,3360,13637
75,Nigeria,2021,NGA-21/NIG_ERF/RA1/N-P-E/INGO/18482,8/31/2022 12:07:19 PM,Internally Displaced People,1741,2310,6874,6737,17662,2040,2668,7323,7011,19042
75,Nigeria,2021,NGA-21/NIG_ERF/RA1/N-P-E/INGO/18482,8/31/2022 12:07:19 PM,Overall,2041,5632,8796,9155,25624,3205,9012,10091,10371,32679
75,Nigeria,2021,NGA-21/NIG_ERF/RA1/P-N-E/INGO/18479,8/24/2022 11:12:20 AM,Host Communities,1605,6041,6043,8341,22030,3705,9963,6716,8787,29171
75,Nigeria,2021,NGA-21/NIG_ERF/RA1/P-N-E/INGO/18479,8/24/2022 11:12:20 AM,Internally Displaced People,685,2611,2940,3987,10223,304,402,4501,4418,9625
75,Nigeria,2021,NGA-21/NIG_ERF/RA1/P-N-E/INGO/18479,8/24/2022 11:12:20 AM,Other,0,0,210,240,450,0,0,62,48,110
75,Nigeria,2021,NGA-21/NIG_ERF/RA1/P-N-E/INGO/18479,8/24/2022 11:12:20 AM,Overall,2305,8671,9281,12673,32930,4366,10508,12193,14963,42030
75,Nigeria,2021,NGA-21/NIG_ERF/RA1/P-N-E/INGO/18479,8/24/2022 11:12:20 AM,Returnees,15,19,88,105,227,357,143,914,1710,3124
75,Nigeria,2021,NGA-21/NIG_ERF/RA1/P-N-E/INGO/18510,10/13/2022 3:26:17 PM,Host Communities,400,500,1600,2000,4500,831,3184,1342,1538,6895
75,Nigeria,2021,NGA-21/NIG_ERF/RA1/P-N-E/INGO/18510,10/13/2022 3:26:17 PM,Internally Displaced People,430,560,1800,2250,5040,1191,1293,1219,1324,5027
75,Nigeria,2021,NGA-21/NIG_ERF/RA1/P-N-E/INGO/18510,10/13/2022 3:26:17 PM,Overall,830,1060,3400,4250,9540,2022,4477,2561,2862,11922
75,Nigeria,2021,NGA-21/NIG_ERF/RA2/RR/UN/21003,8/17/2023 11:16:16 AM,Internally Displaced People,198,222,84,102,606,112,239,316,292,959
75,Nigeria,2021,NGA-21/NIG_ERF/RA2/RR/UN/21003,8/17/2023 11:16:16 AM,Overall,198,222,84,102,606,112,239,316,292,959
75,Nigeria,2021,NGA-21/NIG_ERF/RA2/RR/UN/21059,8/30/2023 11:59:19 AM,Host Communities,1150,1250,1100,1500,5000,1007,1252,1189,1500,4948
75,Nigeria,2021,NGA-21/NIG_ERF/RA2/RR/UN/21059,8/30/2023 11:59:19 AM,Internally Displaced People,920,1000,880,1200,4000,875,1150,796,1231,4052
75,Nigeria,2021,NGA-21/NIG_ERF/RA2/RR/UN/21059,8/30/2023 11:59:19 AM,Overall,2300,2500,2200,3000,10000,2127,2637,2175,3061,10000
75,Nigeria,2021,NGA-21/NIG_ERF/RA2/RR/UN/21059,8/30/2023 11:59:19 AM,Returnees,230,250,220,300,1000,245,235,190,330,1000
75,Nigeria,2021,NGA-21/NIG_ERF/RA3/N/UN/21324,5/2/2023 7:35:25 PM,Host Communities,0,0,11993,15058,27051,0,0,13827,13003,26830
75,Nigeria,2021,NGA-21/NIG_ERF/RA3/N/UN/21324,5/2/2023 7:35:25 PM,Internally Displaced People,0,0,4375,5351,9726,0,0,4607,4335,8942
75,Nigeria,2021,NGA-21/NIG_ERF/RA3/N/UN/21324,5/2/2023 7:35:25 PM,Overall,0,0,18947,23573,42520,0,0,21947,20642,42589
75,Nigeria,2021,NGA-21/NIG_ERF/RA3/N/UN/21324,5/2/2023 7:35:25 PM,Returnees,0,0,2579,3164,5743,0,0,3513,3304,6817
75,Nigeria,2021,NGA-21/NIG_ERF/SA1/C/UN/20342,5/2/2023 9:36:19 AM,Other,102,68,0,0,170,1381,481,0,0,1862
75,Nigeria,2021,NGA-21/NIG_ERF/SA1/C/UN/20342,5/2/2023 9:36:19 AM,Overall,102,68,0,0,170,1381,481,0,0,1862
75,Nigeria,2021,NGA-21/NIG_ERF/SA1/C/UN/20355,5/3/2023 6:02:41 PM,Internally Displaced People,3480,5220,0,0,8700,4240,4530,3908,4064,16742
75,Nigeria,2021,NGA-21/NIG_ERF/SA1/C/UN/20355,5/3/2023 6:02:41 PM,Overall,3480,5220,0,0,8700,4240,4530,3908,4064,16742
75,Nigeria,2021,NGA-21/NIG_ERF/SA1/C-P/INGO/20499,5/18/2023 11:01:06 AM,Other,0,250,0,0,250,256,227,0,0,483
75,Nigeria,2021,NGA-21/NIG_ERF/SA1/C-P/INGO/20499,5/18/2023 11:01:06 AM,Overall,0,250,0,0,250,256,227,0,0,483
75,Nigeria,2021,NGA-21/NIG_ERF/SA1/DMS/UN/20356,6/1/2023 11:11:34 AM,Internally Displaced People,84000,126000,60000,80000,350000,122174,108027,168304,103815,502320
75,Nigeria,2021,NGA-21/NIG_ERF/SA1/DMS/UN/20356,6/1/2023 11:11:34 AM,Overall,84000,126000,60000,80000,350000,122174,108027,168304,103815,502320
75,Nigeria,2021,NGA-21/NIG_ERF/SA1/DMS/UN/20479,5/2/2023 12:00:01 PM,Host Communities,2357,2964,3177,4213,12711,2357,2094,2976,4169,11596
75,Nigeria,2021,NGA-21/NIG_ERF/SA1/DMS/UN/20479,5/2/2023 12:00:01 PM,Internally Displaced People,11748,12873,21122,31747,77490,9481,9286,17423,24780,60970
75,Nigeria,2021,NGA-21/NIG_ERF/SA1/DMS/UN/20479,5/2/2023 12:00:01 PM,Overall,16783,18819,27888,40067,103557,13830,13292,23407,31922,82451
75,Nigeria,2021,NGA-21/NIG_ERF/SA1/DMS/UN/20479,5/2/2023 12:00:01 PM,Returnees,2678,2982,3589,4107,13356,1992,1912,3008,2973,9885
75,Nigeria,2021,NGA-21/NIG_ERF/SA1/DMS-P/INGO/20387,5/2/2023 6:35:11 AM,Host Communities,3971,4318,7220,8887,24396,10091,15235,13601,20891,59818
75,Nigeria,2021,NGA-21/NIG_ERF/SA1/DMS-P/INGO/20387,5/2/2023 6:35:11 AM,Internally Displaced People,4010,5292,7419,8831,25552,7202,9976,6923,11313,35414
75,Nigeria,2021,NGA-21/NIG_ERF/SA1/DMS-P/INGO/20387,5/2/2023 6:35:11 AM,Overall,7981,9610,14639,17718,49948,17293,25211,20524,32204,95232
75,Nigeria,2021,NGA-21/NIG_ERF/SA1/DMS-S/NFI/NGO/20350,5/12/2023 12:24:18 PM,Host Communities,2250,2450,3180,5342,13222,2627,3135,3453,5736,14951
75,Nigeria,2021,NGA-21/NIG_ERF/SA1/DMS-S/NFI/NGO/20350,5/12/2023 12:24:18 PM,Internally Displaced People,3110,5200,5500,7200,21010,24603,29787,38430,42668,135488
75,Nigeria,2021,NGA-21/NIG_ERF/SA1/DMS-S/NFI/NGO/20350,5/12/2023 12:24:18 PM,Overall,6594,9150,10680,14392,40816,28359,34398,43709,50215,156681
75,Nigeria,2021,NGA-21/NIG_ERF/SA1/DMS-S/NFI/NGO/20350,5/12/2023 12:24:18 PM,Returnees,1234,1500,2000,1850,6584,1129,1476,1826,1811,6242
75,Nigeria,2021,NGA-21/NIG_ERF/SA1/DMS-S/NFI/UN/20364,5/2/2023 11:17:19 AM,Internally Displaced People,33350,45954,45118,53084,177506,52584,64541,68009,74544,259678
75,Nigeria,2021,NGA-21/NIG_ERF/SA1/DMS-S/NFI/UN/20364,5/2/2023 11:17:19 AM,Overall,33350,45954,45118,53084,177506,52584,64541,68009,74544,259678
75,Nigeria,2021,NGA-21/NIG_ERF/SA1/E/INGO/20404,11/17/2022 8:26:06 AM,Host Communities,20,20,1000,1000,2040,20,20,1000,1000,2040
75,Nigeria,2021,NGA-21/NIG_ERF/SA1/E/INGO/20404,11/17/2022 8:26:06 AM,Overall,20,20,1000,1000,2040,20,20,1000,1000,2040
75,Nigeria,2021,NGA-21/NIG_ERF/SA1/E/NGO/20299,5/2/2023 9:26:52 AM,Host Communities,13,13,515,515,1056,30,20,447,571,1068
75,Nigeria,2021,NGA-21/NIG_ERF/SA1/E/NGO/20299,5/2/2023 9:26:52 AM,Internally Displaced People,14,14,990,990,2008,12,3,1576,1720,3311
75,Nigeria,2021,NGA-21/NIG_ERF/SA1/E/NGO/20299,5/2/2023 9:26:52 AM,Overall,40,40,1980,1980,4040,49,31,2443,2711,5234
75,Nigeria,2021,NGA-21/NIG_ERF/SA1/E/NGO/20299,5/2/2023 9:26:52 AM,Returnees,13,13,475,475,976,7,8,420,420,855
75,Nigeria,2021,NGA-21/NIG_ERF/SA1/E/NGO/20455,5/8/2023 10:43:25 AM,Host Communities,50,40,150,170,410,52,21,442,473,988
75,Nigeria,2021,NGA-21/NIG_ERF/SA1/E/NGO/20455,5/8/2023 10:43:25 AM,Internally Displaced People,14,6,740,1169,1929,17,4,2017,2569,4607
75,Nigeria,2021,NGA-21/NIG_ERF/SA1/E/NGO/20455,5/8/2023 10:43:25 AM,Overall,76,50,910,1364,2400,78,27,2514,3109,5728
75,Nigeria,2021,NGA-21/NIG_ERF/SA1/E/NGO/20455,5/8/2023 10:43:25 AM,Returnees,12,4,20,25,61,9,2,55,67,133
75,Nigeria,2021,NGA-21/NIG_ERF/SA1/E-P/NGO/20482,5/12/2023 12:54:37 PM,Host Communities,50,50,243,243,586,50,50,246,240,586
75,Nigeria,2021,NGA-21/NIG_ERF/SA1/E-P/NGO/20482,5/12/2023 12:54:37 PM,Internally Displaced People,50,50,244,244,588,50,50,236,254,590
75,Nigeria,2021,NGA-21/NIG_ERF/SA1/E-P/NGO/20482,5/12/2023 12:54:37 PM,Overall,100,100,487,487,1174,100,100,482,494,1176
75,Nigeria,2021,NGA-21/NIG_ERF/SA1/F/NGO/20351,5/12/2023 12:42:39 PM,Internally Displaced People,1200,1640,2260,2900,8000,1360,6153,6991,6752,21256
75,Nigeria,2021,NGA-21/NIG_ERF/SA1/F/NGO/20351,5/12/2023 12:42:39 PM,Overall,2910,3040,4310,5740,16000,4283,11874,15632,15698,47487
75,Nigeria,2021,NGA-21/NIG_ERF/SA1/F/NGO/20351,5/12/2023 12:42:39 PM,Refugees,1710,1400,2050,2840,8000,2923,5721,8641,8946,26231
75,Nigeria,2021,NGA-21/NIG_ERF/SA1/F/NGO/20454,5/11/2023 10:49:04 AM,Host Communities,1011,1339,544,721,3615,1011,1339,544,721,3615
75,Nigeria,2021,NGA-21/NIG_ERF/SA1/F/NGO/20454,5/11/2023 10:49:04 AM,Internally Displaced People,459,607,247,327,1640,459,607,247,327,1640
75,Nigeria,2021,NGA-21/NIG_ERF/SA1/F/NGO/20454,5/11/2023 10:49:04 AM,Overall,1627,2152,876,1159,5814,1615,2136,869,1150,5770
75,Nigeria,2021,NGA-21/NIG_ERF/SA1/F/NGO/20454,5/11/2023 10:49:04 AM,Returnees,157,206,85,111,559,145,190,78,102,515
75,Nigeria,2021,NGA-21/NIG_ERF/SA1/F/NGO/20505,5/12/2023 12:34:23 PM,Overall,550,1375,550,1375,3850,550,1375,550,1375,3850
75,Nigeria,2021,NGA-21/NIG_ERF/SA1/F/NGO/20505,5/12/2023 12:34:23 PM,Returnees,550,1375,550,1375,3850,550,1375,550,1375,3850
75,Nigeria,2021,NGA-21/NIG_ERF/SA1/F-WASH/INGO/20370,1/25/2023 11:28:05 AM,Host Communities,1100,1650,1100,1650,5500,1517,2276,1517,2275,7585
75,Nigeria,2021,NGA-21/NIG_ERF/SA1/F-WASH/INGO/20370,1/25/2023 11:28:05 AM,Internally Displaced People,4400,6600,4400,6600,22000,6066,9102,6068,9103,30339
75,Nigeria,2021,NGA-21/NIG_ERF/SA1/F-WASH/INGO/20370,1/25/2023 11:28:05 AM,Overall,5500,8250,5500,8250,27500,7583,11378,7585,11378,37924
75,Nigeria,2021,NGA-21/NIG_ERF/SA1/H/INGO/20386,1/18/2023 8:11:42 AM,Host Communities,15578,24164,18235,20966,78943,6150,10297,6308,9802,32557
75,Nigeria,2021,NGA-21/NIG_ERF/SA1/H/INGO/20386,1/18/2023 8:11:42 AM,Internally Displaced People,10963,13785,7395,9468,41611,6119,8603,10851,11121,36694
75,Nigeria,2021,NGA-21/NIG_ERF/SA1/H/INGO/20386,1/18/2023 8:11:42 AM,Overall,26541,37949,25630,30434,120554,12269,18900,17159,20923,69251
75,Nigeria,2021,NGA-21/NIG_ERF/SA1/H/NGO/20345,1/26/2023 12:10:50 PM,Host Communities,450,1300,450,1300,3500,463,1643,493,2441,5040
75,Nigeria,2021,NGA-21/NIG_ERF/SA1/H/NGO/20345,1/26/2023 12:10:50 PM,Internally Displaced People,200,500,200,500,1400,383,998,225,1310,2916
75,Nigeria,2021,NGA-21/NIG_ERF/SA1/H/NGO/20345,1/26/2023 12:10:50 PM,Overall,700,2000,700,2000,5400,901,2955,768,4095,8719
75,Nigeria,2021,NGA-21/NIG_ERF/SA1/H/NGO/20345,1/26/2023 12:10:50 PM,Returnees,50,200,50,200,500,55,314,50,344,763
75,Nigeria,2021,NGA-21/NIG_ERF/SA1/H/NGO/20452,11/29/2022 9:07:41 AM,Host Communities,6030,8374,9046,10050,33500,5918,9289,4212,6039,25458
75,Nigeria,2021,NGA-21/NIG_ERF/SA1/H/NGO/20452,11/29/2022 9:07:41 AM,Internally Displaced People,2970,4126,4454,4950,16500,3945,6193,2809,4026,16973
75,Nigeria,2021,NGA-21/NIG_ERF/SA1/H/NGO/20452,11/29/2022 9:07:41 AM,Overall,9000,12500,13500,15000,50000,9863,15482,7021,10065,42431
75,Nigeria,2021,NGA-21/NIG_ERF/SA1/H/NGO/20470,11/7/2022 9:46:58 AM,Host Communities,5000,9617,2000,3200,19817,5806,8163,6250,9782,30001
75,Nigeria,2021,NGA-21/NIG_ERF/SA1/H/NGO/20470,11/7/2022 9:46:58 AM,Internally Displaced People,4500,9500,3500,4000,21500,6564,9120,8232,8979,32895
75,Nigeria,2021,NGA-21/NIG_ERF/SA1/H/NGO/20470,11/7/2022 9:46:58 AM,Overall,9750,19367,5700,7500,42317,12622,17543,14797,19214,64176
75,Nigeria,2021,NGA-21/NIG_ERF/SA1/H/NGO/20470,11/7/2022 9:46:58 AM,Returnees,250,250,200,300,1000,252,260,315,453,1280
75,Nigeria,2021,NGA-21/NIG_ERF/SA1/H/NGO/20472,1/3/2023 8:31:10 AM,Host Communities,1684,2608,2160,2960,9412,11289,14288,6169,9810,41556
75,Nigeria,2021,NGA-21/NIG_ERF/SA1/H/NGO/20472,1/3/2023 8:31:10 AM,Internally Displaced People,2526,3912,3240,4440,14118,355,1442,116,1301,3214
75,Nigeria,2021,NGA-21/NIG_ERF/SA1/H/NGO/20472,1/3/2023 8:31:10 AM,Overall,4410,6870,5700,7850,24830,12592,17531,7022,11806,48951
75,Nigeria,2021,NGA-21/NIG_ERF/SA1/H/NGO/20472,1/3/2023 8:31:10 AM,Returnees,200,350,300,450,1300,948,1801,737,695,4181
75,Nigeria,2021,NGA-21/NIG_ERF/SA1/H/NGO/20478,1/3/2023 1:31:56 PM,Host Communities,3000,6000,2000,3000,14000,9775,13627,5274,8054,36730
75,Nigeria,2021,NGA-21/NIG_ERF/SA1/H/NGO/20478,1/3/2023 1:31:56 PM,Internally Displaced People,7000,9000,3000,7000,26000,553,1730,804,893,3980
75,Nigeria,2021,NGA-21/NIG_ERF/SA1/H/NGO/20478,1/3/2023 1:31:56 PM,Overall,10000,15000,5000,10000,40000,10328,15357,6078,8947,40710
75,Nigeria,2021,NGA-21/NIG_ERF/SA1/H/NGO/20481,11/21/2022 9:07:18 AM,Host Communities,2000,3500,2500,3500,11500,4859,9243,4093,6875,25070
75,Nigeria,2021,NGA-21/NIG_ERF/SA1/H/NGO/20481,11/21/2022 9:07:18 AM,Internally Displaced People,2500,5000,2500,4000,14000,2705,5041,2311,3850,13907
75,Nigeria,2021,NGA-21/NIG_ERF/SA1/H/NGO/20481,11/21/2022 9:07:18 AM,Overall,5500,9500,6000,9000,30000,8557,16198,7221,12110,44086
75,Nigeria,2021,NGA-21/NIG_ERF/SA1/H/NGO/20481,11/21/2022 9:07:18 AM,Returnees,1000,1000,1000,1500,4500,993,1914,817,1385,5109
75,Nigeria,2021,NGA-21/NIG_ERF/SA1/H/UN/20493,6/7/2023 3:16:20 PM,Host Communities,8000,20000,3200,12800,44000,7886,25301,3299,16769,53255
75,Nigeria,2021,NGA-21/NIG_ERF/SA1/H/UN/20493,6/7/2023 3:16:20 PM,Internally Displaced People,800,4800,800,3200,9600,780,6173,584,5091,12628
75,Nigeria,2021,NGA-21/NIG_ERF/SA1/H/UN/20493,6/7/2023 3:16:20 PM,Overall,40800,96800,12000,32000,181600,46982,97000,18609,45843,208434
75,Nigeria,2021,NGA-21/NIG_ERF/SA1/H/UN/20493,6/7/2023 3:16:20 PM,Returnees,32000,72000,8000,16000,128000,38316,65526,14726,23983,142551
75,Nigeria,2021,NGA-21/NIG_ERF/SA1/H/UN/20524,11/29/2022 9:14:16 AM,Host Communities,5804,11609,8900,12382,38695,5684,11507,8862,11821,37874
75,Nigeria,2021,NGA-21/NIG_ERF/SA1/H/UN/20524,11/29/2022 9:14:16 AM,Internally Displaced People,2371,4742,3635,5058,15806,2327,4661,3668,4822,15478
75,Nigeria,2021,NGA-21/NIG_ERF/SA1/H/UN/20524,11/29/2022 9:14:16 AM,Overall,8175,16351,12535,17440,54501,8011,16168,12530,16643,53352
75,Nigeria,2021,NGA-21/NIG_ERF/SA1/N/INGO/20282,5/26/2023 12:49:19 PM,Host Communities,143,1049,430,550,2172,74,2012,978,1034,4098
75,Nigeria,2021,NGA-21/NIG_ERF/SA1/N/INGO/20282,5/26/2023 12:49:19 PM,Internally Displaced People,40,790,531,529,1890,0,709,312,397,1418
75,Nigeria,2021,NGA-21/NIG_ERF/SA1/N/INGO/20282,5/26/2023 12:49:19 PM,Overall,209,2007,1083,1133,4432,74,3068,1438,1630,6210
75,Nigeria,2021,NGA-21/NIG_ERF/SA1/N/INGO/20282,5/26/2023 12:49:19 PM,Returnees,26,168,122,54,370,0,347,148,199,694
75,Nigeria,2021,NGA-21/NIG_ERF/SA1/N/INGO/20365,1/25/2023 11:05:17 AM,Host Communities,100,1500,1198,1297,4095,0,0,47,42,89
75,Nigeria,2021,NGA-21/NIG_ERF/SA1/N/INGO/20365,1/25/2023 11:05:17 AM,Internally Displaced People,200,2000,960,1040,4200,0,0,89,91,180
75,Nigeria,2021,NGA-21/NIG_ERF/SA1/N/INGO/20365,1/25/2023 11:05:17 AM,Overall,550,4832,3504,3795,12681,0,0,152,156,308
75,Nigeria,2021,NGA-21/NIG_ERF/SA1/N/INGO/20365,1/25/2023 11:05:17 AM,Returnees,250,1332,1346,1458,4386,0,0,16,23,39
75,Nigeria,2021,NGA-21/NIG_ERF/SA1/N/INGO/20385,2/14/2023 4:34:30 PM,Host Communities,1005,8935,3300,3700,16940,612,6641,10203,12003,29459
75,Nigeria,2021,NGA-21/NIG_ERF/SA1/N/INGO/20385,2/14/2023 4:34:30 PM,Internally Displaced People,250,4065,1700,1300,7315,153,1983,1260,2118,5514
75,Nigeria,2021,NGA-21/NIG_ERF/SA1/N/INGO/20385,2/14/2023 4:34:30 PM,Overall,1255,13000,5000,5000,24255,765,8624,11463,14121,34973
75,Nigeria,2021,NGA-21/NIG_ERF/SA1/N/NGO/20311,3/1/2023 9:06:44 AM,Host Communities,6586,21739,3277,5051,36653,24258,45965,3625,6103,79951
75,Nigeria,2021,NGA-21/NIG_ERF/SA1/N/NGO/20311,3/1/2023 9:06:44 AM,Internally Displaced People,131,467,169,264,1031,0,0,0,0,0
75,Nigeria,2021,NGA-21/NIG_ERF/SA1/N/NGO/20311,3/1/2023 9:06:44 AM,Overall,6717,22206,3446,5315,37684,24258,45965,3625,6103,79951
75,Nigeria,2021,NGA-21/NIG_ERF/SA1/N/NGO/20312,3/2/2023 11:02:05 AM,Host Communities,450,1085,800,1000,3335,704,1581,1402,1574,5261
75,Nigeria,2021,NGA-21/NIG_ERF/SA1/N/NGO/20312,3/2/2023 11:02:05 AM,Internally Displaced People,800,1400,1000,1271,4471,831,1364,1256,1298,4749
75,Nigeria,2021,NGA-21/NIG_ERF/SA1/N/NGO/20312,3/2/2023 11:02:05 AM,Overall,1450,3120,2300,2371,9241,1774,3525,3011,3260,11570
75,Nigeria,2021,NGA-21/NIG_ERF/SA1/N/NGO/20312,3/2/2023 11:02:05 AM,Returnees,200,635,500,100,1435,239,580,353,388,1560
75,Nigeria,2021,NGA-21/NIG_ERF/SA1/N/NGO/20344,1/25/2023 11:24:05 AM,Host Communities,17,662,463,513,1655,25,1556,1587,1651,4819
75,Nigeria,2021,NGA-21/NIG_ERF/SA1/N/NGO/20344,1/25/2023 11:24:05 AM,Internally Displaced People,16,648,454,502,1620,10,353,263,251,877
75,Nigeria,2021,NGA-21/NIG_ERF/SA1/N/NGO/20344,1/25/2023 11:24:05 AM,Overall,50,1972,1380,1528,4930,48,2736,2429,2577,7790
75,Nigeria,2021,NGA-21/NIG_ERF/SA1/N/NGO/20344,1/25/2023 11:24:05 AM,Returnees,17,662,463,513,1655,13,827,579,675,2094
75,Nigeria,2021,NGA-21/NIG_ERF/SA1/N/NGO/20390,5/2/2023 6:30:08 AM,Host Communities,2240,4400,1744,2336,10720,4129,7786,2572,3304,17791
75,Nigeria,2021,NGA-21/NIG_ERF/SA1/N/NGO/20390,5/2/2023 6:30:08 AM,Internally Displaced People,560,1100,436,584,2680,0,0,0,0,0
75,Nigeria,2021,NGA-21/NIG_ERF/SA1/N/NGO/20390,5/2/2023 6:30:08 AM,Overall,2800,5500,2180,2920,13400,4129,7786,2572,3304,17791
75,Nigeria,2021,NGA-21/NIG_ERF/SA1/N/NGO/20407,12/29/2022 8:50:37 AM,Host Communities,0,660,223,223,1106,0,1681,246,299,2226
75,Nigeria,2021,NGA-21/NIG_ERF/SA1/N/NGO/20407,12/29/2022 8:50:37 AM,Internally Displaced People,0,670,234,234,1138,0,1754,352,443,2549
75,Nigeria,2021,NGA-21/NIG_ERF/SA1/N/NGO/20407,12/29/2022 8:50:37 AM,Overall,0,1990,690,690,3370,0,5221,890,1039,7150
75,Nigeria,2021,NGA-21/NIG_ERF/SA1/N/NGO/20407,12/29/2022 8:50:37 AM,Returnees,0,660,233,233,1126,0,1786,292,297,2375
75,Nigeria,2021,NGA-21/NIG_ERF/SA1/N/NGO/20463,3/2/2023 10:46:12 AM,Host Communities,236,2023,2546,2650,7455,980,10346,1616,1766,14708
75,Nigeria,2021,NGA-21/NIG_ERF/SA1/N/NGO/20463,3/2/2023 10:46:12 AM,Internally Displaced People,302,1770,2227,2318,6617,858,9052,1414,1546,12870
75,Nigeria,2021,NGA-21/NIG_ERF/SA1/N/NGO/20463,3/2/2023 10:46:12 AM,Overall,754,5057,6364,6624,18799,2451,25864,4040,4416,36771
75,Nigeria,2021,NGA-21/NIG_ERF/SA1/N/NGO/20463,3/2/2023 10:46:12 AM,Returnees,216,1264,1591,1656,4727,613,6466,1010,1104,9193
75,Nigeria,2021,NGA-21/NIG_ERF/SA1/N/NGO/20476,5/9/2023 3:22:23 PM,Host Communities,0,0,550,650,1200,0,0,627,813,1440
75,Nigeria,2021,NGA-21/NIG_ERF/SA1/N/NGO/20476,5/9/2023 3:22:23 PM,Overall,0,0,550,650,1200,0,0,627,813,1440
75,Nigeria,2021,NGA-21/NIG_ERF/SA1/N/NGO/20480,2/7/2023 9:54:01 AM,Host Communities,0,1500,2000,2000,5500,0,2952,3930,4679,11561
75,Nigeria,2021,NGA-21/NIG_ERF/SA1/N/NGO/20480,2/7/2023 9:54:01 AM,Internally Displaced People,0,2500,3000,3000,8500,0,1874,691,602,3167
75,Nigeria,2021,NGA-21/NIG_ERF/SA1/N/NGO/20480,2/7/2023 9:54:01 AM,Overall,0,4000,5000,5000,14000,0,4826,4621,5281,14728
75,Nigeria,2021,NGA-21/NIG_ERF/SA1/N/NGO/20697,5/26/2023 5:47:33 AM,Host Communities,766,2226,4642,1198,8832,696,1629,4358,1160,7843
75,Nigeria,2021,NGA-21/NIG_ERF/SA1/N/NGO/20697,5/26/2023 5:47:33 AM,Internally Displaced People,317,948,3545,4108,8918,275,666,2321,3925,7187
75,Nigeria,2021,NGA-21/NIG_ERF/SA1/N/NGO/20697,5/26/2023 5:47:33 AM,Overall,1094,3236,9277,6154,19761,978,2312,7676,5746,16712
75,Nigeria,2021,NGA-21/NIG_ERF/SA1/N/NGO/20697,5/26/2023 5:47:33 AM,Returnees,11,62,1090,848,2011,7,17,997,661,1682
75,Nigeria,2021,NGA-21/NIG_ERF/SA1/N/UN/20495,5/3/2023 5:41:04 PM,Host Communities,220,314,1462,1788,3784,358,212,1605,1580,3755
75,Nigeria,2021,NGA-21/NIG_ERF/SA1/N/UN/20495,5/3/2023 5:41:04 PM,Internally Displaced People,0,0,495,605,1100,0,0,534,529,1063
75,Nigeria,2021,NGA-21/NIG_ERF/SA1/N/UN/20495,5/3/2023 5:41:04 PM,Overall,220,314,2249,2751,5534,358,212,2546,2510,5626
75,Nigeria,2021,NGA-21/NIG_ERF/SA1/N/UN/20495,5/3/2023 5:41:04 PM,Returnees,0,0,292,358,650,0,0,407,401,808
75,Nigeria,2021,NGA-21/NIG_ERF/SA1/P/INGO/20517,11/3/2022 9:42:57 AM,Host Communities,147,300,900,1000,2347,2480,3291,5368,6233,17372
75,Nigeria,2021,NGA-21/NIG_ERF/SA1/P/INGO/20517,11/3/2022 9:42:57 AM,Internally Displaced People,50,97,415,325,887,1406,1848,2711,3320,9285
75,Nigeria,2021,NGA-21/NIG_ERF/SA1/P/INGO/20517,11/3/2022 9:42:57 AM,Overall,197,397,1315,1325,3234,3886,5139,8079,9553,26657
75,Nigeria,2021,NGA-21/NIG_ERF/SA1/P/NGO/20325,11/17/2022 8:18:18 AM,Host Communities,50,700,50,700,1500,155,814,135,745,1849
75,Nigeria,2021,NGA-21/NIG_ERF/SA1/P/NGO/20325,11/17/2022 8:18:18 AM,Internally Displaced People,30,650,30,650,1360,145,739,127,703,1714
75,Nigeria,2021,NGA-21/NIG_ERF/SA1/P/NGO/20325,11/17/2022 8:18:18 AM,Overall,100,1400,100,1400,3000,326,1617,284,1504,3731
75,Nigeria,2021,NGA-21/NIG_ERF/SA1/P/NGO/20325,11/17/2022 8:18:18 AM,Returnees,20,50,20,50,140,26,64,22,56,168
75,Nigeria,2021,NGA-21/NIG_ERF/SA1/P/NGO/20329,11/29/2022 9:11:45 AM,Host Communities,45,36300,62,51200,87607,6197,45793,3882,44725,100597
75,Nigeria,2021,NGA-21/NIG_ERF/SA1/P/NGO/20329,11/29/2022 9:11:45 AM,Internally Displaced People,45,52900,43,56600,109588,1524,26295,1223,31489,60531
75,Nigeria,2021,NGA-21/NIG_ERF/SA1/P/NGO/20329,11/29/2022 9:11:45 AM,Overall,90,89200,105,107800,197195,7721,72088,5105,76214,161128
75,Nigeria,2021,NGA-21/NIG_ERF/SA1/P/NGO/20360,5/2/2023 7:05:13 AM,Host Communities,525,818,500,793,2636,2968,4380,2899,3579,13826
75,Nigeria,2021,NGA-21/NIG_ERF/SA1/P/NGO/20360,5/2/2023 7:05:13 AM,Internally Displaced People,1000,3000,1000,3000,8000,3991,8073,3666,5497,21227
75,Nigeria,2021,NGA-21/NIG_ERF/SA1/P/NGO/20360,5/2/2023 7:05:13 AM,Overall,1525,3818,1500,3793,10636,6959,12453,6565,9076,35053
75,Nigeria,2021,NGA-21/NIG_ERF/SA1/P/NGO/20443,3/2/2023 11:05:55 AM,Host Communities,10,13,150,250,423,25,59,727,784,1595
75,Nigeria,2021,NGA-21/NIG_ERF/SA1/P/NGO/20443,3/2/2023 11:05:55 AM,Internally Displaced People,65,135,750,850,1800,39,94,1297,1474,2904
75,Nigeria,2021,NGA-21/NIG_ERF/SA1/P/NGO/20443,3/2/2023 11:05:55 AM,Overall,75,148,900,1100,2223,64,153,2024,2258,4499
75,Nigeria,2021,NGA-21/NIG_ERF/SA1/P/NGO/20467,1/23/2023 8:24:51 AM,Host Communities,80,60,2420,3430,5990,129,584,3690,4478,8881
75,Nigeria,2021,NGA-21/NIG_ERF/SA1/P/NGO/20467,1/23/2023 8:24:51 AM,Internally Displaced People,99,180,3500,5000,8779,99,414,2703,2876,6092
75,Nigeria,2021,NGA-21/NIG_ERF/SA1/P/NGO/20467,1/23/2023 8:24:51 AM,Overall,190,260,6520,9230,16200,264,1234,7556,9065,18119
75,Nigeria,2021,NGA-21/NIG_ERF/SA1/P/NGO/20467,1/23/2023 8:24:51 AM,Returnees,11,20,600,800,1431,36,236,1163,1711,3146
75,Nigeria,2021,NGA-21/NIG_ERF/SA1/P/NGO/20522,2/3/2023 8:10:44 AM,Host Communities,631,940,1060,1591,4222,1271,2998,1308,1205,6782
75,Nigeria,2021,NGA-21/NIG_ERF/SA1/P/NGO/20522,2/3/2023 8:10:44 AM,Internally Displaced People,251,375,425,638,1689,615,1441,503,463,3022
75,Nigeria,2021,NGA-21/NIG_ERF/SA1/P/NGO/20522,2/3/2023 8:10:44 AM,Overall,1262,1879,2121,3180,8442,2217,5305,2303,2069,11894
75,Nigeria,2021,NGA-21/NIG_ERF/SA1/P/NGO/20522,2/3/2023 8:10:44 AM,Returnees,380,564,636,951,2531,331,866,492,401,2090
75,Nigeria,2021,NGA-21/NIG_ERF/SA1/P/UN/20462,6/2/2023 12:57:44 PM,Host Communities,62,82,118,115,377,70,87,117,114,388
75,Nigeria,2021,NGA-21/NIG_ERF/SA1/P/UN/20462,6/2/2023 12:57:44 PM,Internally Displaced People,114,105,218,195,632,130,103,211,198,642
75,Nigeria,2021,NGA-21/NIG_ERF/SA1/P/UN/20462,6/2/2023 12:57:44 PM,Overall,214,241,410,385,1250,255,258,415,404,1332
75,Nigeria,2021,NGA-21/NIG_ERF/SA1/P/UN/20462,6/2/2023 12:57:44 PM,Returnees,38,54,74,75,241,55,68,87,92,302
75,Nigeria,2021,NGA-21/NIG_ERF/SA1/P/UN/20510,5/10/2023 8:48:01 AM,Host Communities,2752,2922,3400,4480,13554,2971,2922,3400,4480,13773
75,Nigeria,2021,NGA-21/NIG_ERF/SA1/P/UN/20510,5/10/2023 8:48:01 AM,Internally Displaced People,56036,59492,66405,83686,265619,56036,59492,66405,83686,265619
75,Nigeria,2021,NGA-21/NIG_ERF/SA1/P/UN/20510,5/10/2023 8:48:01 AM,Overall,64045,68319,76006,95607,303977,64264,68319,76006,95607,304196
75,Nigeria,2021,NGA-21/NIG_ERF/SA1/P/UN/20510,5/10/2023 8:48:01 AM,Returnees,5257,5905,6201,7441,24804,5257,5905,6201,7441,24804
75,Nigeria,2021,NGA-21/NIG_ERF/SA1/P/UN/20525,5/15/2023 8:06:36 PM,Host Communities,200,300,350,412,1262,200,300,350,412,1262
75,Nigeria,2021,NGA-21/NIG_ERF/SA1/P/UN/20525,5/15/2023 8:06:36 PM,Internally Displaced People,3850,4000,4150,4350,16350,3850,4000,4150,4350,16350
75,Nigeria,2021,NGA-21/NIG_ERF/SA1/P/UN/20525,5/15/2023 8:06:36 PM,Overall,5200,5600,5900,6412,23112,5200,5600,5900,6412,23112
75,Nigeria,2021,NGA-21/NIG_ERF/SA1/P/UN/20525,5/15/2023 8:06:36 PM,Returnees,1150,1300,1400,1650,5500,1150,1300,1400,1650,5500
75,Nigeria,2021,NGA-21/NIG_ERF/SA1/RR/INGO/20436,2/2/2023 10:24:57 AM,Host Communities,1100,1100,1500,1540,5240,437,410,536,557,1940
75,Nigeria,2021,NGA-21/NIG_ERF/SA1/RR/INGO/20436,2/2/2023 10:24:57 AM,Internally Displaced People,720,720,1050,1080,3570,131,123,161,133,548
75,Nigeria,2021,NGA-21/NIG_ERF/SA1/RR/INGO/20436,2/2/2023 10:24:57 AM,Overall,2130,2130,3010,3100,10370,874,822,1072,1133,3901
75,Nigeria,2021,NGA-21/NIG_ERF/SA1/RR/INGO/20436,2/2/2023 10:24:57 AM,Returnees,310,310,460,480,1560,306,289,375,443,1413
75,Nigeria,2021,NGA-21/NIG_ERF/SA1/S/NFI/INGO/20284,12/30/2022 9:11:49 AM,Internally Displaced People,869,1021,907,983,3780,642,737,642,648,2669
75,Nigeria,2021,NGA-21/NIG_ERF/SA1/S/NFI/INGO/20284,12/30/2022 9:11:49 AM,Overall,869,1021,907,983,3780,642,737,642,648,2669
75,Nigeria,2021,NGA-21/NIG_ERF/SA1/S/NFI/INGO/20519,6/6/2023 9:01:53 AM,Internally Displaced People,1067,1305,1601,1957,5930,1833,1922,2662,2449,8866
75,Nigeria,2021,NGA-21/NIG_ERF/SA1/S/NFI/INGO/20519,6/6/2023 9:01:53 AM,Overall,1067,1305,1601,1957,5930,1833,1922,2662,2449,8866
75,Nigeria,2021,NGA-21/NIG_ERF/SA1/S/NFI/NGO/20466,12/7/2022 8:22:17 AM,Host Communities,800,1000,800,400,3000,800,1000,800,400,3000
75,Nigeria,2021,NGA-21/NIG_ERF/SA1/S/NFI/NGO/20466,12/7/2022 8:22:17 AM,Internally Displaced People,3700,6300,1200,900,12100,3700,6200,1300,900,12100
75,Nigeria,2021,NGA-21/NIG_ERF/SA1/S/NFI/NGO/20466,12/7/2022 8:22:17 AM,Overall,4500,7300,2000,1300,15100,4500,7200,2100,1300,15100
75,Nigeria,2021,NGA-21/NIG_ERF/SA1/S/NFI/UN/20374,5/15/2023 7:50:13 PM,Host Communities,334,350,380,456,1520,250,262,285,340,1137
75,Nigeria,2021,NGA-21/NIG_ERF/SA1/S/NFI/UN/20374,5/15/2023 7:50:13 PM,Internally Displaced People,4519,4773,5710,6208,21210,2632,3143,3678,4178,13631
75,Nigeria,2021,NGA-21/NIG_ERF/SA1/S/NFI/UN/20374,5/15/2023 7:50:13 PM,Overall,5187,5473,6470,7120,24250,3132,3667,4248,4858,15905
75,Nigeria,2021,NGA-21/NIG_ERF/SA1/S/NFI/UN/20374,5/15/2023 7:50:13 PM,Returnees,334,350,380,456,1520,250,262,285,340,1137
75,Nigeria,2021,NGA-21/NIG_ERF/SA1/WASH/INGO/20283,3/2/2023 10:03:53 AM,Host Communities,6621,8093,4659,5150,24523,5266,5708,7247,7499,25720
75,Nigeria,2021,NGA-21/NIG_ERF/SA1/WASH/INGO/20283,3/2/2023 10:03:53 AM,Internally Displaced People,15449,18882,10872,12016,57219,12287,13318,16909,17497,60011
75,Nigeria,2021,NGA-21/NIG_ERF/SA1/WASH/INGO/20283,3/2/2023 10:03:53 AM,Overall,22070,26975,15531,17166,81742,17553,19026,24156,24996,85731
75,Nigeria,2021,NGA-21/NIG_ERF/SA1/WASH/INGO/20396,12/23/2022 8:21:06 AM,Host Communities,1708,2928,3660,3904,12200,2602,4804,6005,6606,20017
75,Nigeria,2021,NGA-21/NIG_ERF/SA1/WASH/INGO/20396,12/23/2022 8:21:06 AM,Internally Displaced People,1092,1872,2340,2496,7800,1663,3072,3839,4223,12797
75,Nigeria,2021,NGA-21/NIG_ERF/SA1/WASH/INGO/20396,12/23/2022 8:21:06 AM,Overall,2800,4800,6000,6400,20000,4265,7876,9844,10829,32814
75,Nigeria,2021,NGA-21/NIG_ERF/SA1/WASH/INGO/20440,11/21/2022 9:03:05 AM,Other,1125,1125,1125,1125,4500,1125,1125,1125,1125,4500
75,Nigeria,2021,NGA-21/NIG_ERF/SA1/WASH/INGO/20440,11/21/2022 9:03:05 AM,Overall,1125,1125,1125,1125,4500,1125,1125,1125,1125,4500
75,Nigeria,2021,NGA-21/NIG_ERF/SA1/WASH/INGO/20494,5/8/2023 1:53:10 PM,Host Communities,3462,4705,4924,6835,19926,3542,4825,5044,7015,20426
75,Nigeria,2021,NGA-21/NIG_ERF/SA1/WASH/INGO/20494,5/8/2023 1:53:10 PM,Internally Displaced People,8982,9350,11199,12132,41663,8994,9365,11219,12162,41740
75,Nigeria,2021,NGA-21/NIG_ERF/SA1/WASH/INGO/20494,5/8/2023 1:53:10 PM,Overall,12444,14055,16123,18967,61589,12536,14190,16263,19177,62166
75,Nigeria,2021,NGA-21/NIG_ERF/SA1/WASH/INGO/20520,5/19/2023 11:58:01 AM,Host Communities,666,773,865,1452,3756,1583,4243,2727,3039,11592
75,Nigeria,2021,NGA-21/NIG_ERF/SA1/WASH/INGO/20520,5/19/2023 11:58:01 AM,Internally Displaced People,2666,3293,3256,4129,13344,2804,2076,2134,2234,9248
75,Nigeria,2021,NGA-21/NIG_ERF/SA1/WASH/INGO/20520,5/19/2023 11:58:01 AM,Overall,3332,4066,4121,5581,17100,4387,6319,4861,5273,20840
75,Nigeria,2021,NGA-21/NIG_ERF/SA1/WASH/NGO/20285,1/20/2023 8:29:36 AM,Host Communities,1500,1500,1000,1000,5000,1834,2414,1279,1780,7307
75,Nigeria,2021,NGA-21/NIG_ERF/SA1/WASH/NGO/20285,1/20/2023 8:29:36 AM,Internally Displaced People,500,1000,500,1000,3000,612,1108,551,942,3213
75,Nigeria,2021,NGA-21/NIG_ERF/SA1/WASH/NGO/20285,1/20/2023 8:29:36 AM,Overall,3500,4000,2500,3000,13000,3867,5247,2793,4024,15931
75,Nigeria,2021,NGA-21/NIG_ERF/SA1/WASH/NGO/20285,1/20/2023 8:29:36 AM,Returnees,1500,1500,1000,1000,5000,1421,1725,963,1302,5411
75,Nigeria,2021,NGA-21/NIG_ERF/SA1/WASH/NGO/20287,2/14/2023 4:48:08 PM,Host Communities,833,1160,833,1160,3986,830,1180,830,1000,3840
75,Nigeria,2021,NGA-21/NIG_ERF/SA1/WASH/NGO/20287,2/14/2023 4:48:08 PM,Internally Displaced People,834,1180,834,1180,4028,800,1200,830,1200,4030
75,Nigeria,2021,NGA-21/NIG_ERF/SA1/WASH/NGO/20287,2/14/2023 4:48:08 PM,Overall,2500,3500,2500,3500,12000,2460,3580,2495,3400,11935
75,Nigeria,2021,NGA-21/NIG_ERF/SA1/WASH/NGO/20287,2/14/2023 4:48:08 PM,Returnees,833,1160,833,1160,3986,830,1200,835,1200,4065
75,Nigeria,2021,NGA-21/NIG_ERF/SA1/WASH/NGO/20290,3/2/2023 10:49:27 AM,Host Communities,16564,19722,17706,17098,71090,12065,18722,15206,15598,61591
75,Nigeria,2021,NGA-21/NIG_ERF/SA1/WASH/NGO/20290,3/2/2023 10:49:27 AM,Internally Displaced People,12950,17095,12175,11815,54035,3917,9575,3908,4802,22202
75,Nigeria,2021,NGA-21/NIG_ERF/SA1/WASH/NGO/20290,3/2/2023 10:49:27 AM,Overall,29514,36817,29881,28913,125125,15982,28297,19114,20400,83793
75,Nigeria,2021,NGA-21/NIG_ERF/SA1/WASH/NGO/20297,3/2/2023 10:59:35 AM,Host Communities,6600,10500,5400,7500,30000,8726,8884,7139,9916,34665
75,Nigeria,2021,NGA-21/NIG_ERF/SA1/WASH/NGO/20297,3/2/2023 10:59:35 AM,Internally Displaced People,3520,5600,2880,4000,16000,4363,6941,3570,4958,19832
75,Nigeria,2021,NGA-21/NIG_ERF/SA1/WASH/NGO/20297,3/2/2023 10:59:35 AM,Overall,10120,16100,8280,11500,46000,13089,15825,10709,14874,54497
75,Nigeria,2021,NGA-21/NIG_ERF/SA1/WASH/NGO/20300,3/2/2023 9:26:33 AM,Host Communities,570,1110,600,720,3000,838,968,1610,1733,5149
75,Nigeria,2021,NGA-21/NIG_ERF/SA1/WASH/NGO/20300,3/2/2023 9:26:33 AM,Internally Displaced People,769,1499,810,972,4050,620,1399,1209,1284,4512
75,Nigeria,2021,NGA-21/NIG_ERF/SA1/WASH/NGO/20300,3/2/2023 9:26:33 AM,Overall,1425,2775,1500,1800,7500,1551,2519,2999,3209,10278
75,Nigeria,2021,NGA-21/NIG_ERF/SA1/WASH/NGO/20300,3/2/2023 9:26:33 AM,Returnees,86,166,90,108,450,93,152,180,192,617
75,Nigeria,2021,NGA-21/NIG_ERF/SA1/WASH/NGO/20511,5/8/2023 2:04:45 PM,Host Communities,1100,1700,700,1600,5100,2043,3755,6328,6201,18327
75,Nigeria,2021,NGA-21/NIG_ERF/SA1/WASH/NGO/20511,5/8/2023 2:04:45 PM,Internally Displaced People,1300,2500,1300,2700,7800,161,276,531,540,1508
75,Nigeria,2021,NGA-21/NIG_ERF/SA1/WASH/NGO/20511,5/8/2023 2:04:45 PM,Overall,2400,4200,2000,4300,12900,2204,4031,6859,6741,19835
75,Nigeria,2021,NGA-21/NIG_ERF/SA1/WASH/UN/20382,3/2/2023 10:37:13 AM,Internally Displaced People,25992,51983,43320,51983,173278,25952,50274,43239,53543,173008
75,Nigeria,2021,NGA-21/NIG_ERF/SA1/WASH/UN/20382,3/2/2023 10:37:13 AM,Overall,25992,51983,43320,51983,173278,25952,50274,43239,53543,173008
75,Nigeria,2021,NGA-21/NIG_ERF/SA1/WASH/UN/20489,5/3/2023 6:07:34 PM,Host Communities,4909,5745,6231,7335,24220,4909,5745,6231,7335,24220
75,Nigeria,2021,NGA-21/NIG_ERF/SA1/WASH/UN/20489,5/3/2023 6:07:34 PM,Internally Displaced People,119844,154569,154034,185319,613766,126822,163411,163223,196537,649993
75,Nigeria,2021,NGA-21/NIG_ERF/SA1/WASH/UN/20489,5/3/2023 6:07:34 PM,Overall,124753,160314,160265,192654,637986,131731,169156,169454,203872,674213
75,Nigeria,2021,NGA-21/NIG_ERF/SA1/WASH-P/INGO/20389,1/5/2023 9:08:15 AM,Host Communities,117,200,105,175,597,15,124,97,72,308
75,Nigeria,2021,NGA-21/NIG_ERF/SA1/WASH-P/INGO/20389,1/5/2023 9:08:15 AM,Internally Displaced People,3159,5583,4290,6230,19262,5295,7759,4297,6230,23581
75,Nigeria,2021,NGA-21/NIG_ERF/SA1/WASH-P/INGO/20389,1/5/2023 9:08:15 AM,Overall,3276,5783,4395,6405,19859,5310,7883,4394,6302,23889
75,Nigeria,2021,NGA-21/NIG_ERF/SA1/WASH-P-E/NGO/20292,5/2/2023 6:42:57 AM,Host Communities,4000,6000,4000,6000,20000,16249,19306,17670,21135,74360
75,Nigeria,2021,NGA-21/NIG_ERF/SA1/WASH-P-E/NGO/20292,5/2/2023 6:42:57 AM,Internally Displaced People,6000,9000,6000,9000,30000,17562,23508,26040,32267,99377
75,Nigeria,2021,NGA-21/NIG_ERF/SA1/WASH-P-E/NGO/20292,5/2/2023 6:42:57 AM,Overall,10000,15000,10000,15000,50000,33811,42814,43710,53402,173737
75,Nigeria,2022,NGA-22/NIG_ERF/RA1/DMS/INGO/23242,6/6/2023 8:55:18 AM,Host Communities,130,185,250,380,945,258,341,249,286,1134
75,Nigeria,2022,NGA-22/NIG_ERF/RA1/DMS/INGO/23242,6/6/2023 8:55:18 AM,Internally Displaced People,5430,7147,7284,8419,28280,5191,6957,7755,9036,28939
75,Nigeria,2022,NGA-22/NIG_ERF/RA1/DMS/INGO/23242,6/6/2023 8:55:18 AM,Overall,5560,7332,7534,8799,29225,5449,7298,8004,9322,30073
75,Nigeria,2022,NGA-22/NIG_ERF/RA1/DMS/NGO/23288,6/14/2023 8:56:12 PM,Host Communities,1175,1225,1190,2621,6211,2074,1741,3076,3110,10001
75,Nigeria,2022,NGA-22/NIG_ERF/RA1/DMS/NGO/23288,6/14/2023 8:56:12 PM,Internally Displaced People,8537,9549,9458,10895,38439,15780,16029,21056,24895,77760
75,Nigeria,2022,NGA-22/NIG_ERF/RA1/DMS/NGO/23288,6/14/2023 8:56:12 PM,Overall,10329,11524,11573,14516,47942,20205,18826,27358,32305,98694
75,Nigeria,2022,NGA-22/NIG_ERF/RA1/DMS/NGO/23288,6/14/2023 8:56:12 PM,Returnees,617,750,925,1000,3292,2351,1056,3226,4300,10933
75,Nigeria,2022,NGA-22/NIG_ERF/RA1/DMS/UN/23300,6/6/2023 1:15:03 PM,Internally Displaced People,40769,57515,65298,73879,237461,55593,70090,85413,97472,308568
75,Nigeria,2022,NGA-22/NIG_ERF/RA1/DMS/UN/23300,6/6/2023 1:15:03 PM,Overall,40769,57515,65298,73879,237461,55593,70090,85413,97472,308568
75,Nigeria,2022,NGA-22/NIG_ERF/RA1/DMS-S/NFI/UN/23285,8/21/2023 4:00:47 PM,Host Communities,3135,4168,4184,5215,16702,3135,4168,4184,5215,16702
75,Nigeria,2022,NGA-22/NIG_ERF/RA1/DMS-S/NFI/UN/23285,8/21/2023 4:00:47 PM,Internally Displaced People,6748,8378,9212,10747,35085,6748,8378,9212,10747,35085
75,Nigeria,2022,NGA-22/NIG_ERF/RA1/DMS-S/NFI/UN/23285,8/21/2023 4:00:47 PM,Overall,10558,13384,14317,17037,55296,10558,13384,14317,17037,55296
75,Nigeria,2022,NGA-22/NIG_ERF/RA1/DMS-S/NFI/UN/23285,8/21/2023 4:00:47 PM,Returnees,675,838,921,1075,3509,675,838,921,1075,3509
75,Nigeria,2022,NGA-22/NIG_ERF/RA1/H/NGO/23253,6/5/2023 9:19:29 AM,Host Communities,7500,12000,4500,6000,30000,14052,21060,11182,13648,59942
75,Nigeria,2022,NGA-22/NIG_ERF/RA1/H/NGO/23253,6/5/2023 9:19:29 AM,Internally Displaced People,2000,2500,1500,1800,7800,3747,5616,2982,3640,15985
75,Nigeria,2022,NGA-22/NIG_ERF/RA1/H/NGO/23253,6/5/2023 9:19:29 AM,Overall,9800,15100,6500,8600,40000,18735,28080,14909,18198,79922
75,Nigeria,2022,NGA-22/NIG_ERF/RA1/H/NGO/23253,6/5/2023 9:19:29 AM,Returnees,300,600,500,800,2200,936,1404,745,910,3995
75,Nigeria,2022,NGA-22/NIG_ERF/RA1/H/NGO/23262,6/15/2023 9:19:32 AM,Host Communities,7315,10235,5265,6435,29250,6676,12480,5102,6495,30753
75,Nigeria,2022,NGA-22/NIG_ERF/RA1/H/NGO/23262,6/15/2023 9:19:32 AM,Internally Displaced People,8935,12515,6435,7865,35750,9696,17024,7417,9357,43494
75,Nigeria,2022,NGA-22/NIG_ERF/RA1/H/NGO/23262,6/15/2023 9:19:32 AM,Overall,16250,22750,11700,14300,65000,16372,29504,12519,15852,74247
75,Nigeria,2022,NGA-22/NIG_ERF/RA1/H/NGO/23274,6/6/2023 9:00:22 AM,Host Communities,2240,4480,6720,8960,22400,5014,7735,6740,8963,28452
75,Nigeria,2022,NGA-22/NIG_ERF/RA1/H/NGO/23274,6/6/2023 9:00:22 AM,Internally Displaced People,960,1920,2880,3840,9600,1050,2010,2923,4015,9998
75,Nigeria,2022,NGA-22/NIG_ERF/RA1/H/NGO/23274,6/6/2023 9:00:22 AM,Overall,3200,6400,9600,12800,32000,6064,9745,9663,12978,38450
75,Nigeria,2022,NGA-22/NIG_ERF/RA1/H/NGO/23289,9/25/2023 10:52:24 AM,Host Communities,5000,9000,4100,9500,27600,5480,12951,5129,11393,34953
75,Nigeria,2022,NGA-22/NIG_ERF/RA1/H/NGO/23289,9/25/2023 10:52:24 AM,Internally Displaced People,5500,11000,6500,12000,35000,5917,16725,7245,18787,48674
75,Nigeria,2022,NGA-22/NIG_ERF/RA1/H/NGO/23289,9/25/2023 10:52:24 AM,Overall,11000,20700,11100,22200,65000,12086,31106,13345,31565,88102
75,Nigeria,2022,NGA-22/NIG_ERF/RA1/H/NGO/23289,9/25/2023 10:52:24 AM,Returnees,500,700,500,700,2400,689,1430,971,1385,4475
75,Nigeria,2022,NGA-22/NIG_ERF/RA1/N/INGO/23244,8/28/2023 6:59:26 AM,Host Communities,76,704,288,282,1350,31,1025,585,471,2112
75,Nigeria,2022,NGA-22/NIG_ERF/RA1/N/INGO/23244,8/28/2023 6:59:26 AM,Internally Displaced People,10,83,83,95,271,26,121,59,88,294
75,Nigeria,2022,NGA-22/NIG_ERF/RA1/N/INGO/23244,8/28/2023 6:59:26 AM,Overall,91,820,446,465,1822,59,1233,683,609,2584
75,Nigeria,2022,NGA-22/NIG_ERF/RA1/N/INGO/23244,8/28/2023 6:59:26 AM,Returnees,5,33,75,88,201,2,87,39,50,178
75,Nigeria,2022,NGA-22/NIG_ERF/RA1/N/INGO/23292,5/26/2023 11:09:11 AM,Host Communities,6,12,5329,5402,10749,1,2,6727,7585,14315
75,Nigeria,2022,NGA-22/NIG_ERF/RA1/N/INGO/23292,5/26/2023 11:09:11 AM,Internally Displaced People,11,6,10654,10804,21475,1,4,10091,11376,21472
75,Nigeria,2022,NGA-22/NIG_ERF/RA1/N/INGO/23292,5/26/2023 11:09:11 AM,Overall,17,18,15983,16206,32224,2,6,16818,18961,35787
75,Nigeria,2022,NGA-22/NIG_ERF/RA1/N/INGO/23303,6/1/2023 2:27:22 PM,Host Communities,20,720,350,430,1520,25,320,184,222,751
75,Nigeria,2022,NGA-22/NIG_ERF/RA1/N/INGO/23303,6/1/2023 2:27:22 PM,Internally Displaced People,0,300,100,120,520,0,373,234,295,902
75,Nigeria,2022,NGA-22/NIG_ERF/RA1/N/INGO/23303,6/1/2023 2:27:22 PM,Overall,20,1020,450,550,2040,25,693,418,517,1653
75,Nigeria,2022,NGA-22/NIG_ERF/RA1/N/NGO/23241,5/19/2023 11:28:54 AM,Host Communities,0,300,600,600,1500,0,431,498,660,1589
75,Nigeria,2022,NGA-22/NIG_ERF/RA1/N/NGO/23241,5/19/2023 11:28:54 AM,Internally Displaced People,0,500,720,720,1940,0,754,1356,1236,3346
75,Nigeria,2022,NGA-22/NIG_ERF/RA1/N/NGO/23241,5/19/2023 11:28:54 AM,Overall,0,1200,1920,1920,5040,0,1800,2176,2208,6184
75,Nigeria,2022,NGA-22/NIG_ERF/RA1/N/NGO/23241,5/19/2023 11:28:54 AM,Returnees,0,400,600,600,1600,0,615,322,312,1249
75,Nigeria,2022,NGA-22/NIG_ERF/RA1/N-H/INGO/23296,7/31/2023 12:17:52 PM,Host Communities,2242,3302,4871,4911,15326,2206,8989,7559,8450,27204
75,Nigeria,2022,NGA-22/NIG_ERF/RA1/N-H/INGO/23296,7/31/2023 12:17:52 PM,Internally Displaced People,4110,6055,8931,9002,28098,1799,12096,4712,5255,23862
75,Nigeria,2022,NGA-22/NIG_ERF/RA1/N-H/INGO/23296,7/31/2023 12:17:52 PM,Overall,7473,11008,16238,16369,51088,4496,24383,13556,15138,57573
75,Nigeria,2022,NGA-22/NIG_ERF/RA1/N-H/INGO/23296,7/31/2023 12:17:52 PM,Returnees,1121,1651,2436,2456,7664,491,3298,1285,1433,6507
75,Nigeria,2022,NGA-22/NIG_ERF/RA1/S/NFI/INGO/23275,9/18/2023 1:08:19 PM,Internally Displaced People,189,231,284,346,1050,210,260,472,464,1406
75,Nigeria,2022,NGA-22/NIG_ERF/RA1/S/NFI/INGO/23275,9/18/2023 1:08:19 PM,Overall,189,231,284,346,1050,210,260,472,464,1406
75,Nigeria,2022,NGA-22/NIG_ERF/RA1/S/NFI/UN/23301,9/21/2023 11:12:39 AM,Internally Displaced People,1815,2101,2579,3055,9550,1843,2055,2523,2915,9336
75,Nigeria,2022,NGA-22/NIG_ERF/RA1/S/NFI/UN/23301,9/21/2023 11:12:39 AM,Overall,1815,2101,2579,3055,9550,1843,2055,2523,2915,9336
75,Nigeria,2022,NGA-22/NIG_ERF/RA1/WASH/INGO/23280,9/21/2023 11:30:29 AM,Host Communities,5000,11000,3000,7000,26000,2007,3306,1800,2582,9695
75,Nigeria,2022,NGA-22/NIG_ERF/RA1/WASH/INGO/23280,9/21/2023 11:30:29 AM,Internally Displaced People,4200,3800,500,1000,9500,1602,1025,1087,1027,4741
75,Nigeria,2022,NGA-22/NIG_ERF/RA1/WASH/INGO/23280,9/21/2023 11:30:29 AM,Overall,9200,14800,3500,8000,35500,3609,4331,2887,3609,14436
75,Nigeria,2022,NGA-22/NIG_ERF/RA1/WASH/NGO/23239,8/28/2023 10:53:14 AM,Host Communities,7000,9000,7000,7000,30000,7608,9813,7227,7510,32158
75,Nigeria,2022,NGA-22/NIG_ERF/RA1/WASH/NGO/23239,8/28/2023 10:53:14 AM,Internally Displaced People,4700,5720,6970,8350,25740,7300,7920,9570,11086,35876
75,Nigeria,2022,NGA-22/NIG_ERF/RA1/WASH/NGO/23239,8/28/2023 10:53:14 AM,Overall,11700,14720,13970,15350,55740,14908,17733,16797,18596,68034
75,Nigeria,2022,NGA-22/NIG_ERF/RA1/WASH/NGO/23245,7/28/2023 10:37:56 AM,Host Communities,2500,3000,2500,3000,11000,4419,5314,5701,6540,21974
75,Nigeria,2022,NGA-22/NIG_ERF/RA1/WASH/NGO/23245,7/28/2023 10:37:56 AM,Internally Displaced People,2000,3000,2000,3000,10000,3496,4604,1030,2233,11363
75,Nigeria,2022,NGA-22/NIG_ERF/RA1/WASH/NGO/23245,7/28/2023 10:37:56 AM,Overall,4500,6000,4500,6000,21000,7915,9918,6731,8773,33337
75,Nigeria,2022,NGA-22/NIG_ERF/RA1/WASH/UN/23250,7/23/2023 6:27:11 PM,Internally Displaced People,17476,21636,19964,24124,83200,25503,47996,38212,44113,155824
75,Nigeria,2022,NGA-22/NIG_ERF/RA1/WASH/UN/23250,7/23/2023 6:27:11 PM,Overall,17476,21636,19964,24124,83200,25503,47996,38212,44113,155824
75,Nigeria,2022,NGA-22/NIG_ERF/RA1/WASH/UN/23287,5/3/2023 6:24:09 PM,Internally Displaced People,111306,146313,150021,176810,584450,116342,155163,161063,186105,618673
75,Nigeria,2022,NGA-22/NIG_ERF/RA1/WASH/UN/23287,5/3/2023 6:24:09 PM,Overall,111306,146313,150021,176810,584450,116342,155163,161063,186105,618673
75,Nigeria,2022,NGA-22/NIG_ERF/RA1/WASH-S/NFI/INGO/23251,8/21/2023 11:45:28 AM,Host Communities,7870,9238,8212,8897,34217,14850,17434,15497,16787,64568
75,Nigeria,2022,NGA-22/NIG_ERF/RA1/WASH-S/NFI/INGO/23251,8/21/2023 11:45:28 AM,Internally Displaced People,18363,21556,19160,20758,79837,34651,40677,36158,39171,150657
75,Nigeria,2022,NGA-22/NIG_ERF/RA1/WASH-S/NFI/INGO/23251,8/21/2023 11:45:28 AM,Overall,28682,33671,29929,32425,124707,54125,63538,56479,61183,235325
75,Nigeria,2022,NGA-22/NIG_ERF/RA1/WASH-S/NFI/INGO/23251,8/21/2023 11:45:28 AM,Returnees,2449,2877,2557,2770,10653,4624,5427,4824,5225,20100
75,Nigeria,2022,NGA-22/NIG_ERF/RA1/WASH-S/NFI/INGO/23295,7/31/2023 12:19:55 PM,Host Communities,5746,6188,4420,5746,22100,11596,14279,11138,12650,49663
75,Nigeria,2022,NGA-22/NIG_ERF/RA1/WASH-S/NFI/INGO/23295,7/31/2023 12:19:55 PM,Overall,5746,6188,4420,5746,22100,11596,14279,11138,12650,49663
75,Nigeria,2022,NGA-22/NIG_ERF/RA2/H/NGO/24152,9/25/2023 6:19:53 AM,Host Communities,7200,7920,9720,11160,36000,5605,11315,5004,9511,31435
75,Nigeria,2022,NGA-22/NIG_ERF/RA2/H/NGO/24152,9/25/2023 6:19:53 AM,Internally Displaced People,3600,3960,4860,5580,18000,2801,5658,2503,4756,15718
75,Nigeria,2022,NGA-22/NIG_ERF/RA2/H/NGO/24152,9/25/2023 6:19:53 AM,Overall,12000,13200,16200,18600,60000,9358,18859,8342,15852,52411
75,Nigeria,2022,NGA-22/NIG_ERF/RA2/H/NGO/24152,9/25/2023 6:19:53 AM,Returnees,1200,1320,1620,1860,6000,952,1886,835,1585,5258
75,Nigeria,2022,NGA-22/NIG_ERF/RA2/S/NFI/INGO/24157,8/21/2023 3:41:58 PM,Host Communities,763,734,572,551,2620,965,927,728,699,3319
75,Nigeria,2022,NGA-22/NIG_ERF/RA2/S/NFI/INGO/24157,8/21/2023 3:41:58 PM,Internally Displaced People,844,808,636,614,2902,1069,1027,806,775,3677
75,Nigeria,2022,NGA-22/NIG_ERF/RA2/S/NFI/INGO/24157,8/21/2023 3:41:58 PM,Overall,2059,1973,1551,1493,7076,2607,2505,1967,1890,8969
75,Nigeria,2022,NGA-22/NIG_ERF/RA2/S/NFI/INGO/24157,8/21/2023 3:41:58 PM,Returnees,452,431,343,328,1554,573,551,433,416,1973
75,Nigeria,2022,NGA-22/NIG_ERF/RA2/S/NFI/NGO/24146,8/16/2023 11:09:24 AM,Internally Displaced People,400,700,300,600,2000,443,576,740,596,2355
75,Nigeria,2022,NGA-22/NIG_ERF/RA2/S/NFI/NGO/24146,8/16/2023 11:09:24 AM,Overall,700,1300,500,1100,3600,466,640,924,832,2862
75,Nigeria,2022,NGA-22/NIG_ERF/RA2/S/NFI/NGO/24146,8/16/2023 11:09:24 AM,Returnees,300,600,200,500,1600,23,64,184,236,507
75,Nigeria,2022,NGA-22/NIG_ERF/RA2/S/NFI/UN/24144,8/17/2023 11:23:26 AM,Internally Displaced People,3221,3611,1359,1649,9840,1610,1842,2524,2582,8558
75,Nigeria,2022,NGA-22/NIG_ERF/RA2/S/NFI/UN/24144,8/17/2023 11:23:26 AM,Overall,3221,3611,1359,1649,9840,1610,1842,2524,2582,8558
75,Nigeria,2022,NGA-22/NIG_ERF/RA2/S/NFI/UN/24160,8/23/2023 11:10:50 AM,Host Communities,179,302,287,432,1200,279,302,0,1,582
75,Nigeria,2022,NGA-22/NIG_ERF/RA2/S/NFI/UN/24160,8/23/2023 11:10:50 AM,Internally Displaced People,1131,2165,1145,1559,6000,1131,2265,11,8,3415
75,Nigeria,2022,NGA-22/NIG_ERF/RA2/S/NFI/UN/24160,8/23/2023 11:10:50 AM,Overall,1511,2782,1728,2479,8500,1623,2882,11,9,4525
75,Nigeria,2022,NGA-22/NIG_ERF/RA2/S/NFI/UN/24160,8/23/2023 11:10:50 AM,Returnees,201,315,296,488,1300,213,315,0,0,528
75,Nigeria,2022,NGA-22/NIG_ERF/RA2/WASH/INGO/24129,8/18/2023 11:21:52 AM,Host Communities,3025,3277,3697,4005,14004,4078,4418,4984,5400,18880
75,Nigeria,2022,NGA-22/NIG_ERF/RA2/WASH/INGO/24129,8/18/2023 11:21:52 AM,Internally Displaced People,7058,7646,8627,9345,32676,9516,10309,11630,12599,44054
75,Nigeria,2022,NGA-22/NIG_ERF/RA2/WASH/INGO/24129,8/18/2023 11:21:52 AM,Overall,10083,10923,12324,13350,46680,13594,14727,16614,17999,62934
75,Nigeria,2022,NGA-22/NIG_ERF/RA2/WASH/NGO/24147,8/28/2023 7:39:38 AM,Host Communities,1500,2000,1500,2000,7000,9797,8773,9951,11123,39644
75,Nigeria,2022,NGA-22/NIG_ERF/RA2/WASH/NGO/24147,8/28/2023 7:39:38 AM,Internally Displaced People,1500,5000,1500,5000,13000,9776,10822,7952,10822,39372
75,Nigeria,2022,NGA-22/NIG_ERF/RA2/WASH/NGO/24147,8/28/2023 7:39:38 AM,Overall,3000,7000,3000,7000,20000,19573,19595,17903,21945,79016
75,Nigeria,2022,NGA-22/NIG_ERF/RA2/WASH/NGO/24148,10/6/2023 11:27:58 AM,Host Communities,2662,4560,1362,1800,10384,16696,35399,555,703,53353
75,Nigeria,2022,NGA-22/NIG_ERF/RA2/WASH/NGO/24148,10/6/2023 11:27:58 AM,Internally Displaced People,2662,7000,2164,3024,14850,6680,15327,820,1100,23927
75,Nigeria,2022,NGA-22/NIG_ERF/RA2/WASH/NGO/24148,10/6/2023 11:27:58 AM,Overall,5324,11560,3526,4824,25234,23376,50726,1375,1803,77280
75,Nigeria,2022,NGA-22/NIG_ERF/RA2/WASH/NGO/24161,8/17/2023 7:39:03 PM,Host Communities,1610,2450,3640,4550,12250,1611,2919,4124,4691,13345
75,Nigeria,2022,NGA-22/NIG_ERF/RA2/WASH/NGO/24161,8/17/2023 7:39:03 PM,Internally Displaced People,690,1050,1560,1950,5250,568,1145,1522,1940,5175
75,Nigeria,2022,NGA-22/NIG_ERF/RA2/WASH/NGO/24161,8/17/2023 7:39:03 PM,Overall,2300,3500,5200,6500,17500,2179,4064,5646,6631,18520
75,Nigeria,2022,NGA-22/NIG_ERF/RA2/WASH/UN/24166,8/18/2023 11:18:36 AM,Host Communities,13894,23446,22578,26919,86837,13894,23446,22578,26919,86837
75,Nigeria,2022,NGA-22/NIG_ERF/RA2/WASH/UN/24166,8/18/2023 11:18:36 AM,Internally Displaced People,4269,7205,6938,8272,26684,4269,7205,6938,8272,26684
75,Nigeria,2022,NGA-22/NIG_ERF/RA2/WASH/UN/24166,8/18/2023 11:18:36 AM,Overall,18163,30651,29516,35191,113521,18163,30651,29516,35191,113521
75,Nigeria,2022,NGA-22/NIG_ERF/RA2/WASH-H/NGO/24131,8/15/2023 9:27:25 AM,Host Communities,9100,9750,11750,13500,44100,21723,26079,18836,21299,87937
75,Nigeria,2022,NGA-22/NIG_ERF/RA2/WASH-H/NGO/24131,8/15/2023 9:27:25 AM,Internally Displaced People,4300,4750,5750,6000,20800,10444,12198,8962,10217,41821
75,Nigeria,2022,NGA-22/NIG_ERF/RA2/WASH-H/NGO/24131,8/15/2023 9:27:25 AM,Overall,14400,15600,18850,21150,70000,34575,41221,29863,33867,139526
75,Nigeria,2022,NGA-22/NIG_ERF/RA2/WASH-H/NGO/24131,8/15/2023 9:27:25 AM,Returnees,1000,1100,1350,1650,5100,2408,2944,2065,2351,9768
75,Nigeria,2022,NGA-22/NIG_ERF/SA1/F/NGO/23402,9/22/2023 9:22:26 AM,Host Communities,366,485,206,273,1330,457,606,245,327,1635
75,Nigeria,2022,NGA-22/NIG_ERF/SA1/F/NGO/23402,9/22/2023 9:22:26 AM,Internally Displaced People,105,138,59,78,380,88,117,47,63,315
75,Nigeria,2022,NGA-22/NIG_ERF/SA1/F/NGO/23402,9/22/2023 9:22:26 AM,Overall,524,691,295,390,1900,552,733,295,395,1975
75,Nigeria,2022,NGA-22/NIG_ERF/SA1/F/NGO/23402,9/22/2023 9:22:26 AM,Returnees,53,68,30,39,190,7,10,3,5,25
75,Nigeria,2022,NGA-22/NIG_ERF/SA1/H/NGO/23372,7/19/2023 3:17:57 PM,Host Communities,3200,3040,3250,3510,13000,6654,6322,6758,7299,27033
75,Nigeria,2022,NGA-22/NIG_ERF/SA1/H/NGO/23372,7/19/2023 3:17:57 PM,Internally Displaced People,2000,2500,2700,3900,11100,5610,5330,5698,6154,22792
75,Nigeria,2022,NGA-22/NIG_ERF/SA1/H/NGO/23372,7/19/2023 3:17:57 PM,Overall,5400,5800,6450,7950,25600,13047,12395,13251,14312,53005
75,Nigeria,2022,NGA-22/NIG_ERF/SA1/H/NGO/23372,7/19/2023 3:17:57 PM,Returnees,200,260,500,540,1500,783,743,795,859,3180
75,Nigeria,2022,NGA-22/NIG_ERF/SA1/H/NGO/23413,9/25/2023 11:02:24 AM,Host Communities,700,1600,750,1700,4750,1620,2940,2111,2325,8996
75,Nigeria,2022,NGA-22/NIG_ERF/SA1/H/NGO/23413,9/25/2023 11:02:24 AM,Internally Displaced People,1400,2600,1600,3250,8850,2025,3990,2972,4213,13200
75,Nigeria,2022,NGA-22/NIG_ERF/SA1/H/NGO/23413,9/25/2023 11:02:24 AM,Overall,2300,4700,2550,5450,15000,4376,7650,5764,7355,25145
75,Nigeria,2022,NGA-22/NIG_ERF/SA1/H/NGO/23413,9/25/2023 11:02:24 AM,Returnees,200,500,200,500,1400,731,720,681,817,2949
75,Nigeria,2022,NGA-22/NIG_ERF/SA1/H/NGO/23423,10/10/2023 6:48:29 PM,Host Communities,4400,5280,5500,6820,22000,6980,12274,7273,10117,36644
75,Nigeria,2022,NGA-22/NIG_ERF/SA1/H/NGO/23423,10/10/2023 6:48:29 PM,Internally Displaced People,2400,2880,3000,3720,12000,3191,6695,3269,4107,17262
75,Nigeria,2022,NGA-22/NIG_ERF/SA1/H/NGO/23423,10/10/2023 6:48:29 PM,Overall,8000,9600,10000,12400,40000,11766,22316,11985,16001,62068
75,Nigeria,2022,NGA-22/NIG_ERF/SA1/H/NGO/23423,10/10/2023 6:48:29 PM,Returnees,1200,1440,1500,1860,6000,1595,3347,1443,1777,8162
75,Nigeria,2022,NGA-22/NIG_ERF/SA1/H/NGO/23452,8/21/2023 4:08:35 PM,Host Communities,270,625,600,875,2370,4088,6880,4370,7691,23029
75,Nigeria,2022,NGA-22/NIG_ERF/SA1/H/NGO/23452,8/21/2023 4:08:35 PM,Internally Displaced People,210,505,290,350,1355,675,1215,1033,1562,4485
75,Nigeria,2022,NGA-22/NIG_ERF/SA1/H/NGO/23452,8/21/2023 4:08:35 PM,Overall,915,1530,1280,1775,5500,6566,10827,7181,12174,36748
75,Nigeria,2022,NGA-22/NIG_ERF/SA1/H/NGO/23452,8/21/2023 4:08:35 PM,Returnees,435,400,390,550,1775,1803,2732,1778,2921,9234
75,Nigeria,2022,NGA-22/NIG_ERF/SA1/H/NGO/23464,8/15/2023 9:46:12 AM,Host Communities,2880,3456,3600,4464,14400,3403,4085,4254,5275,17017
75,Nigeria,2022,NGA-22/NIG_ERF/SA1/H/NGO/23464,8/15/2023 9:46:12 AM,Internally Displaced People,2020,2420,2520,3125,10085,2382,2859,2978,3693,11912
75,Nigeria,2022,NGA-22/NIG_ERF/SA1/H/NGO/23464,8/15/2023 9:46:12 AM,Overall,5765,6911,7200,8929,28805,6806,8169,8508,10551,34034
75,Nigeria,2022,NGA-22/NIG_ERF/SA1/H/NGO/23464,8/15/2023 9:46:12 AM,Returnees,865,1035,1080,1340,4320,1021,1225,1276,1583,5105
75,Nigeria,2022,NGA-22/NIG_ERF/SA1/H/NGO/23466,8/18/2023 8:28:39 AM,Host Communities,3000,4500,3500,4800,15800,5009,9884,6410,8751,30054
75,Nigeria,2022,NGA-22/NIG_ERF/SA1/H/NGO/23466,8/18/2023 8:28:39 AM,Internally Displaced People,1000,1500,1200,1800,5500,0,0,0,0,0
75,Nigeria,2022,NGA-22/NIG_ERF/SA1/H/NGO/23466,8/18/2023 8:28:39 AM,Overall,5500,8500,6800,9200,30000,5010,9951,6430,8787,30178
75,Nigeria,2022,NGA-22/NIG_ERF/SA1/H/NGO/23466,8/18/2023 8:28:39 AM,Returnees,1500,2500,2100,2600,8700,1,67,20,36,124
75,Nigeria,2022,NGA-22/NIG_ERF/SA1/N-H/INGO/23455,8/24/2023 10:29:40 AM,Host Communities,745,2706,961,1128,5540,453,810,111,3488,4862
75,Nigeria,2022,NGA-22/NIG_ERF/SA1/N-H/INGO/23455,8/24/2023 10:29:40 AM,Internally Displaced People,2016,7315,2597,3049,14977,4608,6054,1518,10273,22453
75,Nigeria,2022,NGA-22/NIG_ERF/SA1/N-H/INGO/23455,8/24/2023 10:29:40 AM,Overall,2761,10021,3558,4177,20517,5061,6864,1629,13761,27315
75,Nigeria,2022,NGA-22/NIG_ERF/SA1/P/INGO/23370,7/23/2023 6:24:16 PM,Internally Displaced People,2072,1557,1050,950,5629,1658,3230,883,2619,8390
75,Nigeria,2022,NGA-22/NIG_ERF/SA1/P/INGO/23370,7/23/2023 6:24:16 PM,Overall,2072,1557,1050,950,5629,1658,3230,883,2619,8390
75,Nigeria,2022,NGA-22/NIG_ERF/SA1/P/INGO/23387,10/3/2023 8:41:25 AM,Host Communities,3227,3100,2434,2339,11100,2254,2026,3420,3050,10750
75,Nigeria,2022,NGA-22/NIG_ERF/SA1/P/INGO/23387,10/3/2023 8:41:25 AM,Internally Displaced People,3575,3436,2697,2592,12300,2717,3410,3843,3108,13078
75,Nigeria,2022,NGA-22/NIG_ERF/SA1/P/INGO/23387,10/3/2023 8:41:25 AM,Overall,8721,8379,6578,6322,30000,7418,7969,10283,8771,34441
75,Nigeria,2022,NGA-22/NIG_ERF/SA1/P/INGO/23387,10/3/2023 8:41:25 AM,Returnees,1919,1843,1447,1391,6600,2447,2533,3020,2613,10613
75,Nigeria,2022,NGA-22/NIG_ERF/SA1/P/INGO/23418,9/21/2023 9:30:56 AM,Host Communities,171,753,96,290,1310,568,1849,1230,1330,4977
75,Nigeria,2022,NGA-22/NIG_ERF/SA1/P/INGO/23418,9/21/2023 9:30:56 AM,Internally Displaced People,172,502,96,290,1060,91,406,109,96,702
75,Nigeria,2022,NGA-22/NIG_ERF/SA1/P/INGO/23418,9/21/2023 9:30:56 AM,Overall,343,1255,192,580,2370,659,2255,1339,1426,5679
75,Nigeria,2022,NGA-22/NIG_ERF/SA1/P/NGO/23340,10/12/2023 11:33:44 AM,Host Communities,45,425,55,700,1225,225,911,155,681,1972
75,Nigeria,2022,NGA-22/NIG_ERF/SA1/P/NGO/23340,10/12/2023 11:33:44 AM,Internally Displaced People,18,410,120,434,982,24,536,125,430,1115
75,Nigeria,2022,NGA-22/NIG_ERF/SA1/P/NGO/23340,10/12/2023 11:33:44 AM,Overall,63,835,175,1134,2207,249,1447,280,1111,3087
75,Nigeria,2022,NGA-22/NIG_ERF/SA1/P/NGO/23410,9/18/2023 8:30:25 AM,Host Communities,250,750,250,500,1750,453,573,384,511,1921
75,Nigeria,2022,NGA-22/NIG_ERF/SA1/P/NGO/23410,9/18/2023 8:30:25 AM,Internally Displaced People,250,500,250,750,1750,410,759,420,638,2227
75,Nigeria,2022,NGA-22/NIG_ERF/SA1/P/NGO/23410,9/18/2023 8:30:25 AM,Overall,500,1250,500,1250,3500,863,1332,804,1149,4148
75,Nigeria,2022,NGA-22/NIG_ERF/SA1/S/NFI/INGO/23429,8/11/2023 9:46:39 AM,Internally Displaced People,218,276,299,357,1150,0,0,0,0,0
75,Nigeria,2022,NGA-22/NIG_ERF/SA1/S/NFI/INGO/23429,8/11/2023 9:46:39 AM,Overall,218,276,299,357,1150,0,0,0,0,0
75,Nigeria,2022,NGA-22/NIG_ERF/SA1/S/NFI/NGO/23344,9/29/2023 10:29:57 AM,Host Communities,20,30,15,35,100,293,467,67,126,953
75,Nigeria,2022,NGA-22/NIG_ERF/SA1/S/NFI/NGO/23344,9/29/2023 10:29:57 AM,Internally Displaced People,110,190,60,140,500,991,952,307,587,2837
75,Nigeria,2022,NGA-22/NIG_ERF/SA1/S/NFI/NGO/23344,9/29/2023 10:29:57 AM,Overall,180,320,90,210,800,1558,1704,471,808,4541
75,Nigeria,2022,NGA-22/NIG_ERF/SA1/S/NFI/NGO/23344,9/29/2023 10:29:57 AM,Returnees,50,100,15,35,200,274,285,97,95,751
67,oPt,2015,OPT-15/DDA-3482/oPt/EDU/INGO/1585,4/29/2016 7:06:20 AM,Host Communities,39,137,621,618,1415,5,33,537,476,1051
67,oPt,2015,OPT-15/DDA-3482/oPt/EDU/INGO/1585,4/29/2016 7:06:20 AM,Overall,54,167,1205,1101,2527,20,99,1381,1584,3084
67,oPt,2015,OPT-15/DDA-3482/oPt/EDU/INGO/1585,4/29/2016 7:06:20 AM,Refugees,15,30,584,483,1112,15,66,844,1108,2033
67,oPt,2015,OPT-15/DDA-3482/oPt/EDU/INGO/1664,4/5/2016 12:16:59 PM,Overall,0,0,3997,3987,7984,0,0,3997,3987,7984
67,oPt,2015,OPT-15/DDA-3482/oPt/FSL/INGO/1549,4/22/2016 7:55:53 AM,Internally Displaced People,183,177,403,389,1152,353,355,406,381,1495
67,oPt,2015,OPT-15/DDA-3482/oPt/FSL/INGO/1549,4/22/2016 7:55:53 AM,Overall,183,177,403,389,1152,353,355,406,381,1495
67,oPt,2015,OPT-15/DDA-3482/oPt/FSL/INGO/1549,4/22/2016 7:55:53 AM,Refugees,21,20,46,44,131,5,3,19,16,43
67,oPt,2015,OPT-15/DDA-3482/oPt/FSL/INGO/2124,10/24/2016 6:20:40 AM,Host Communities,273,273,200,200,946,169,143,124,91,527
67,oPt,2015,OPT-15/DDA-3482/oPt/FSL/INGO/2124,10/24/2016 6:20:40 AM,Internally Displaced People,49,49,35,35,168,150,177,134,120,581
67,oPt,2015,OPT-15/DDA-3482/oPt/FSL/INGO/2124,10/24/2016 6:20:40 AM,Overall,803,803,589,589,2784,1069,1088,817,725,3699
67,oPt,2015,OPT-15/DDA-3482/oPt/FSL/INGO/2124,10/24/2016 6:20:40 AM,Refugees,482,482,353,353,1670,750,768,559,514,2591
67,oPt,2015,OPT-15/DDA-3482/oPt/FSL/INGO/2130,7/1/2016 12:58:37 PM,Other,744,750,1420,1420,4334,1065,1090,1078,1091,4324
67,oPt,2015,OPT-15/DDA-3482/oPt/FSL/INGO/2130,7/1/2016 12:58:37 PM,Overall,744,750,1420,1420,4334,832,800,1560,1558,4750
67,oPt,2015,OPT-15/DDA-3482/oPt/FSL/NGO/1559,2/25/2016 11:43:36 AM,Other,55,55,0,0,110,55,55,376,361,847
67,oPt,2015,OPT-15/DDA-3482/oPt/FSL/NGO/1559,2/25/2016 11:43:36 AM,Overall,55,55,0,0,110,55,55,376,361,847
67,oPt,2015,OPT-15/DDA-3482/oPt/FSL/NGO/2138,7/21/2016 8:54:22 AM,Other,572,858,468,702,2600,958,1438,784,1177,4357
67,oPt,2015,OPT-15/DDA-3482/oPt/FSL/NGO/2138,7/21/2016 8:54:22 AM,Overall,572,858,468,702,2600,958,1438,784,1177,4357
67,oPt,2015,OPT-15/DDA-3482/oPt/HNC/INGO/1628,2/2/2016 12:49:20 PM,Host Communities,1400,3000,2000,3600,10000,2829,8208,2639,2803,16479
67,oPt,2015,OPT-15/DDA-3482/oPt/HNC/INGO/1628,2/2/2016 12:49:20 PM,Overall,1400,3000,2000,3600,10000,2829,8208,2639,2803,16479
67,oPt,2015,OPT-15/DDA-3482/oPt/HNC/NGO/1668,3/4/2016 8:48:03 AM,Other,540,660,150,150,1500,673,952,225,257,2107
67,oPt,2015,OPT-15/DDA-3482/oPt/HNC/NGO/1668,3/4/2016 8:48:03 AM,Overall,2700,3300,750,750,7500,3600,4542,1036,1000,10178
67,oPt,2015,OPT-15/DDA-3482/oPt/HNC/NGO/1668,3/4/2016 8:48:03 AM,Refugees,2160,2640,600,600,6000,2927,3590,811,743,8071
67,oPt,2015,OPT-15/DDA-3482/oPt/PROT/INGO/1570,3/22/2016 11:24:26 AM,Host Communities,120,240,544,544,1448,130,449,2333,2310,5222
67,oPt,2015,OPT-15/DDA-3482/oPt/PROT/INGO/1570,3/22/2016 11:24:26 AM,Internally Displaced People,180,300,800,800,2080,141,574,599,1027,2341
67,oPt,2015,OPT-15/DDA-3482/oPt/PROT/INGO/1570,3/22/2016 11:24:26 AM,Overall,300,540,1344,1344,3528,271,1023,2932,3337,7563
67,oPt,2015,OPT-15/DDA-3482/oPt/SNFI/INGO/1547,2/25/2016 11:57:33 AM,Host Communities,68,68,272,272,680,75,79,176,184,514
67,oPt,2015,OPT-15/DDA-3482/oPt/SNFI/INGO/1547,2/25/2016 11:57:33 AM,Overall,61,68,272,272,673,65,69,156,161,451
67,oPt,2015,OPT-15/DDA-3482/oPt/SNFI/INGO/2157,9/5/2016 8:21:35 AM,Internally Displaced People,340,328,500,500,1668,364,367,330,305,1366
67,oPt,2015,OPT-15/DDA-3482/oPt/SNFI/INGO/2157,9/5/2016 8:21:35 AM,Other,230,221,339,338,1128,369,383,336,322,1410
67,oPt,2015,OPT-15/DDA-3482/oPt/SNFI/INGO/2157,9/5/2016 8:21:35 AM,Overall,570,549,839,838,2796,733,750,666,627,2776
67,oPt,2015,OPT-15/DDA-3482/oPt/SNFI/INGO/2224,9/26/2016 8:34:18 AM,Other,3,50,180,167,400,3,47,178,160,388
67,oPt,2015,OPT-15/DDA-3482/oPt/SNFI/INGO/2224,9/26/2016 8:34:18 AM,Overall,3,50,180,167,400,3,47,178,160,388
67,oPt,2015,OPT-15/DDA-3482/oPt/SNFI/INGO/2241,11/7/2016 10:18:37 AM,Overall,374,361,325,319,1379,399,418,363,353,1533
67,oPt,2015,OPT-15/DDA-3482/oPt/SNFI/INGO/2262,2/22/2017 7:59:35 AM,Other,147,149,159,154,609,149,151,161,157,618
67,oPt,2015,OPT-15/DDA-3482/oPt/SNFI/INGO/2262,2/22/2017 7:59:35 AM,Overall,147,149,159,154,609,149,151,161,157,618
67,oPt,2015,OPT-15/DDA-3482/oPt/SNFI/INGO/2273,11/2/2016 7:40:12 AM,Other,12,12,13,13,50,29,21,16,15,81
67,oPt,2015,OPT-15/DDA-3482/oPt/SNFI/INGO/2273,11/2/2016 7:40:12 AM,Overall,12,12,13,13,50,29,21,16,15,81
67,oPt,2015,OPT-15/DDA-3482/oPt/SNFI/NGO/2240,9/14/2016 9:46:54 AM,Host Communities,1,1,0,0,2,1,1,0,0,2
67,oPt,2015,OPT-15/DDA-3482/oPt/SNFI/NGO/2240,9/14/2016 9:46:54 AM,Internally Displaced People,1,1,2,3,7,1,1,2,3,7
67,oPt,2015,OPT-15/DDA-3482/oPt/SNFI/NGO/2240,9/14/2016 9:46:54 AM,Other,35,31,24,31,121,35,33,24,31,123
67,oPt,2015,OPT-15/DDA-3482/oPt/SNFI/NGO/2240,9/14/2016 9:46:54 AM,Overall,40,39,30,42,151,40,39,30,42,151
67,oPt,2015,OPT-15/DDA-3482/oPt/SNFI/NGO/2240,9/14/2016 9:46:54 AM,Refugees,3,4,4,8,19,3,4,4,8,19
67,oPt,2015,OPT-15/DDA-3482/oPt/WASH/INGO/1595,4/7/2016 12:12:52 PM,Internally Displaced People,327,362,346,335,1370,529,509,286,417,1741
67,oPt,2015,OPT-15/DDA-3482/oPt/WASH/INGO/1595,4/7/2016 12:12:52 PM,Other,5627,6226,5958,5777,23588,5627,6226,5958,5777,23588
67,oPt,2015,OPT-15/DDA-3482/oPt/WASH/INGO/1595,4/7/2016 12:12:52 PM,Overall,5954,6588,6302,6112,24956,6156,6736,6242,6195,25329
67,oPt,2015,OPT-15/DDA-3482/oPt/WASH/INGO/1680,3/11/2016 11:44:38 AM,Other,740,710,785,785,3020,713,736,801,792,3042
67,oPt,2015,OPT-15/DDA-3482/oPt/WASH/INGO/1680,3/11/2016 11:44:38 AM,Overall,710,740,785,785,3020,713,736,801,792,3042
67,oPt,2015,OPT-15/DDA-3482/oPt/WASH/INGO/2113,9/5/2016 8:58:27 AM,Internally Displaced People,2001,2083,1923,2001,8008,2016,2099,1938,2016,8069
67,oPt,2015,OPT-15/DDA-3482/oPt/WASH/INGO/2113,9/5/2016 8:58:27 AM,Overall,6004,6249,5768,6004,24025,6568,6599,5381,5659,24207
67,oPt,2015,OPT-15/DDA-3482/oPt/WASH/INGO/2140,6/22/2016 7:10:31 AM,Overall,10185,9815,15000,15000,50000,10185,9815,15000,15000,50000
67,oPt,2015,OPT-15/DDA-3482/R/FSL/NGO/1265,9/23/2015 8:41:38 AM,Other,509,22,893,859,2283,435,20,835,803,2093
67,oPt,2015,OPT-15/DDA-3482/R/FSL/NGO/1265,9/23/2015 8:41:38 AM,Overall,509,22,893,859,2283,435,20,835,803,2093
67,oPt,2015,OPT-15/DDA-3482/R/FSL/NGO/1273,11/19/2015 12:37:14 PM,Overall,332,10,1026,1020,2388,332,10,1026,1030,2398
67,oPt,2015,OPT-15/DDA-3482/R/FSL/UN/1835,8/5/2016 9:54:55 AM,Overall,2600,2600,4940,4940,15080,2600,2600,4940,4940,15080
67,oPt,2015,OPT-15/DDA-3482/R/PROT/INGO/2094,11/7/2016 10:43:50 AM,Internally Displaced People,169,73,0,0,242,419,230,0,0,649
67,oPt,2015,OPT-15/DDA-3482/R/PROT/INGO/2094,11/7/2016 10:43:50 AM,Overall,169,73,0,0,242,419,230,0,0,649
67,oPt,2015,OPT-15/DDA-3482/R/SNFI/INGO/1137,9/4/2015 6:52:57 AM,Overall,91,72,95,88,346,93,74,100,90,357
67,oPt,2015,OPT-15/DDA-3482/R/SNFI/INGO/1148,8/13/2015 11:24:40 AM,Internally Displaced People,51,85,53,51,240,70,68,30,54,222
67,oPt,2015,OPT-15/DDA-3482/R/SNFI/INGO/1148,8/13/2015 11:24:40 AM,Other,16,0,0,0,16,0,0,0,0,0
67,oPt,2015,OPT-15/DDA-3482/R/SNFI/INGO/1148,8/13/2015 11:24:40 AM,Overall,67,85,53,51,256,70,68,30,54,222
67,oPt,2015,OPT-15/DDA-3482/R/WASH/INGO/1701,1/13/2016 1:44:26 PM,Internally Displaced People,275,300,254,242,1071,275,300,254,242,1071
67,oPt,2015,OPT-15/DDA-3482/R/WASH/INGO/1701,1/13/2016 1:44:26 PM,Overall,275,300,254,242,1071,275,300,254,242,1071
67,oPt,2016,OPT-16/DDA-3482/oPt/FSL/INGO/3029,2/27/2017 1:28:51 PM,Host Communities,355,355,484,484,1678,156,62,144,133,495
67,oPt,2016,OPT-16/DDA-3482/oPt/FSL/INGO/3029,2/27/2017 1:28:51 PM,Internally Displaced People,62,62,85,85,294,0,0,0,0,0
67,oPt,2016,OPT-16/DDA-3482/oPt/FSL/INGO/3029,2/27/2017 1:28:51 PM,Overall,1043,1043,1422,1422,4930,1459,1481,1240,1193,5373
67,oPt,2016,OPT-16/DDA-3482/oPt/FSL/INGO/3029,2/27/2017 1:28:51 PM,Refugees,626,626,853,853,2958,1303,1319,1096,1060,4778
67,oPt,2016,OPT-16/DDA-3482/oPt/FSL/INGO/3119,3/23/2017 11:28:31 AM,Overall,402,313,1795,1783,4293,700,514,2126,1828,5168
67,oPt,2016,OPT-16/DDA-3482/oPt/FSL/INGO/3127,5/21/2017 7:00:55 AM,Other,556,70,0,0,626,1696,1490,830,728,4744
67,oPt,2016,OPT-16/DDA-3482/oPt/FSL/INGO/3127,5/21/2017 7:00:55 AM,Overall,556,70,0,0,626,1696,1490,830,728,4744
67,oPt,2016,OPT-16/DDA-3482/oPt/FSL/INGO/3128,5/21/2017 6:56:58 AM,Host Communities,132,126,62,59,379,132,126,62,59,379
67,oPt,2016,OPT-16/DDA-3482/oPt/FSL/INGO/3128,5/21/2017 6:56:58 AM,Internally Displaced People,347,332,164,158,1001,347,332,164,158,1001
67,oPt,2016,OPT-16/DDA-3482/oPt/FSL/INGO/3128,5/21/2017 6:56:58 AM,Overall,694,665,327,314,2000,694,665,327,314,2000
67,oPt,2016,OPT-16/DDA-3482/oPt/FSL/INGO/3128,5/21/2017 6:56:58 AM,Refugees,215,207,101,97,620,215,207,101,97,620
67,oPt,2016,OPT-16/DDA-3482/oPt/FSL/NGO/3053,5/5/2017 7:50:21 AM,Overall,640,644,1081,1041,3406,769,769,1206,1255,3999
67,oPt,2016,OPT-16/DDA-3482/oPt/HNC/INGO/2998,1/10/2017 9:00:39 AM,Host Communities,1400,3000,2000,3600,10000,1942,3440,1876,2892,10150
67,oPt,2016,OPT-16/DDA-3482/oPt/HNC/INGO/2998,1/10/2017 9:00:39 AM,Overall,1400,3000,2000,3600,10000,1942,3440,1876,2892,10150
67,oPt,2016,OPT-16/DDA-3482/oPt/PROT/INGO/2984,3/20/2017 8:14:32 PM,Overall,51650,53350,36890,38110,180000,51650,53350,36890,38110,180000
67,oPt,2016,OPT-16/DDA-3482/oPt/PROT/INGO/3118,3/23/2017 11:13:06 AM,Overall,616,920,942,942,3420,647,1068,986,992,3693
67,oPt,2016,OPT-16/DDA-3482/oPt/PROT/INGO/3125,6/20/2017 8:15:12 AM,Other,230,1030,120,300,1680,204,1382,153,226,1965
67,oPt,2016,OPT-16/DDA-3482/oPt/PROT/INGO/3125,6/20/2017 8:15:12 AM,Overall,230,1030,120,300,1680,204,1382,153,226,1965
67,oPt,2016,OPT-16/DDA-3482/oPt/PROT/NGO/3055,4/4/2017 12:53:35 PM,Other,250,820,30,70,1170,96,1056,12,72,1236
67,oPt,2016,OPT-16/DDA-3482/oPt/PROT/NGO/3055,4/4/2017 12:53:35 PM,Overall,250,820,30,70,1170,96,1056,12,72,1236
67,oPt,2016,OPT-16/DDA-3482/oPt/PROT/UN/3008,2/10/2017 8:59:27 AM,Overall,890,1728,1940,1940,6498,752,1600,2392,2378,7122
67,oPt,2016,OPT-16/DDA-3482/oPt/SNFI/INGO/2966,2/20/2017 11:39:02 AM,Internally Displaced People,677,613,291,326,1907,424,458,622,554,2058
67,oPt,2016,OPT-16/DDA-3482/oPt/SNFI/INGO/2966,2/20/2017 11:39:02 AM,Overall,1467,1328,631,706,4132,902,973,1377,1241,4493
67,oPt,2016,OPT-16/DDA-3482/oPt/SNFI/INGO/3032,4/25/2017 6:42:43 AM,Overall,195,186,152,145,678,218,201,152,187,758
67,oPt,2016,OPT-16/DDA-3482/oPt/SNFI/INGO/3121,5/5/2017 7:59:26 AM,Overall,86,83,116,112,397,94,91,111,108,404
67,oPt,2016,OPT-16/DDA-3482/oPt/SNFI/INGO/3129,7/10/2017 5:56:26 AM,Internally Displaced People,408,392,563,542,1905,408,392,563,542,1905
67,oPt,2016,OPT-16/DDA-3482/oPt/SNFI/INGO/3129,7/10/2017 5:56:26 AM,Overall,408,392,563,542,1905,408,392,563,542,1905
67,oPt,2016,OPT-16/DDA-3482/oPt/SNFI/INGO/4398,6/21/2017 8:24:36 AM,Internally Displaced People,312,398,338,377,1425,407,519,440,492,1858
67,oPt,2016,OPT-16/DDA-3482/oPt/SNFI/INGO/4398,6/21/2017 8:24:36 AM,Other,55,0,0,0,55,55,0,0,0,55
67,oPt,2016,OPT-16/DDA-3482/oPt/SNFI/INGO/4398,6/21/2017 8:24:36 AM,Overall,742,875,743,830,3190,1335,1630,1384,1546,5895
67,oPt,2016,OPT-16/DDA-3482/oPt/SNFI/INGO/4399,6/20/2017 12:53:43 PM,Overall,156,145,141,143,585,209,167,204,169,749
67,oPt,2016,OPT-16/DDA-3482/oPt/SNFI/NGO/2991,2/9/2017 12:48:25 PM,Overall,111,137,106,136,490,111,137,106,136,490
67,oPt,2016,OPT-16/DDA-3482/oPt/SNFI/NGO/4410,6/20/2017 6:55:46 AM,Overall,188,192,131,139,650,125,144,217,220,706
67,oPt,2016,OPT-16/DDA-3482/oPt/SNFI/UN/4420,12/19/2017 8:16:57 AM,Internally Displaced People,314,34,348,348,1044,459,483,477,453,1872
67,oPt,2016,OPT-16/DDA-3482/oPt/SNFI/UN/4420,12/19/2017 8:16:57 AM,Overall,314,34,348,348,1044,459,483,477,453,1872
67,oPt,2016,OPT-16/DDA-3482/oPt/SNFI/UN/4426,8/8/2017 11:37:18 AM,Overall,1242,1194,0,0,2436,0,0,0,0,0
67,oPt,2016,OPT-16/DDA-3482/oPt/SNFI/UN/4426,8/8/2017 11:37:18 AM,Refugees,1242,1194,0,0,2436,202,194,0,0,396
67,oPt,2016,OPT-16/DDA-3482/oPt/WASH/INGO/2976,4/5/2017 11:11:00 AM,Other,486,553,593,582,2214,486,553,593,582,2214
67,oPt,2016,OPT-16/DDA-3482/oPt/WASH/INGO/2976,4/5/2017 11:11:00 AM,Overall,1029,1176,1264,1235,4704,1029,1176,1264,1235,4704
67,oPt,2016,OPT-16/DDA-3482/oPt/WASH/INGO/2976,4/5/2017 11:11:00 AM,Refugees,543,623,671,653,2490,543,623,671,653,2490
67,oPt,2016,OPT-16/DDA-3482/oPt/WASH/INGO/4423,8/1/2017 11:30:19 AM,Overall,2743,2426,5230,4455,14854,2743,2426,5230,4455,14854
67,oPt,2016,OPT-16/DDA-3482/oPt/WASH/INGO/4424,8/28/2017 10:49:26 AM,Overall,15141,14547,11422,10974,52084,15141,14547,11422,10974,52084
67,oPt,2016,OPT-16/DDA-3482/oPt/WASH/UN/4396,10/3/2017 8:26:16 AM,Overall,24534,23490,28710,27666,104400,24534,23490,28710,27666,104400
67,oPt,2016,OPT-16/DDA-3482/R/FSL/UN/2339,11/9/2016 11:51:03 AM,Other,7683,7904,7020,7393,30000,10969,9441,8026,6302,34738
67,oPt,2016,OPT-16/DDA-3482/R/FSL/UN/2339,11/9/2016 11:51:03 AM,Overall,7683,7904,7020,7393,30000,10969,9441,8026,6302,34738
67,oPt,2016,OPT-16/DDA-3482/R/PROT/NGO/2336,1/30/2017 10:08:13 AM,Overall,150,200,550,500,1400,349,351,718,1467,2885
67,oPt,2016,OPT-16/DDA-3482/R/WASH/UN/3146,4/13/2017 11:29:11 AM,Overall,4676,3459,6322,6240,20697,4747,3540,5958,6967,21212
67,oPt,2016,OPT-16/DDA-3482/R/WASH/UN/4351,4/5/2018 12:22:44 PM,Overall,18400,19100,19500,18000,75000,18400,19100,19500,18000,75000
67,oPt,2016,OPT-16/DDA-3482/R/WASH/UN/4351,4/5/2018 12:22:44 PM,Refugees,18400,19100,19500,18000,75000,18400,19100,19500,18000,75000
67,oPt,2017,OPT-17/DDA-3482/oPt /FSL/INGO/6650,5/14/2018 1:05:19 PM,Overall,192,245,208,233,878,268,305,216,264,1053
67,oPt,2017,OPT-17/DDA-3482/oPt /FSL/INGO/6710,6/5/2018 11:07:35 AM,Overall,182,176,197,191,746,262,270,286,303,1121
67,oPt,2017,OPT-17/DDA-3482/oPt /FSL/INGO/7614,12/13/2018 7:37:33 AM,Overall,535,555,653,679,2422,1145,1115,985,1006,4251
67,oPt,2017,OPT-17/DDA-3482/oPt /FSL/NGO/6658,9/17/2018 12:33:47 PM,Overall,98,42,322,336,798,120,55,363,385,923
67,oPt,2017,OPT-17/DDA-3482/oPt /FSL/NGO/6661,6/7/2018 6:29:46 AM,Overall,208,209,329,476,1222,213,213,486,570,1482
67,oPt,2017,OPT-17/DDA-3482/oPt /FSL/NGO/7616,7/26/2018 6:39:23 AM,Host Communities,35,35,67,65,202,0,0,0,0,0
67,oPt,2017,OPT-17/DDA-3482/oPt /FSL/NGO/7616,7/26/2018 6:39:23 AM,Internally Displaced People,0,0,0,0,0,40,43,44,46,173
67,oPt,2017,OPT-17/DDA-3482/oPt /FSL/NGO/7616,7/26/2018 6:39:23 AM,Overall,40,40,77,75,232,63,61,72,76,272
67,oPt,2017,OPT-17/DDA-3482/oPt /FSL/NGO/7616,7/26/2018 6:39:23 AM,Refugees,5,5,10,9,29,24,18,30,27,99
67,oPt,2017,OPT-17/DDA-3482/oPt /FSL/NGO/7618,10/17/2018 5:59:44 AM,Overall,89,96,82,75,342,99,102,378,312,891
67,oPt,2017,OPT-17/DDA-3482/oPt /FSL/NGO/7618,10/17/2018 5:59:44 AM,Refugees,62,58,53,49,222,99,102,372,318,891
67,oPt,2017,OPT-17/DDA-3482/oPt /HNC/UN/6681,10/17/2018 6:04:27 AM,Other,204400,158400,75600,61600,500000,128548,123406,133690,128548,514192
67,oPt,2017,OPT-17/DDA-3482/oPt /HNC/UN/6681,10/17/2018 6:04:27 AM,Overall,204400,158400,75600,61600,500000,128548,123406,133690,128548,514192
67,oPt,2017,OPT-17/DDA-3482/oPt /HNC/UN/7615,1/30/2019 2:14:10 PM,Overall,80,6620,12750,12750,32200,45,11626,13019,12510,37200
67,oPt,2017,OPT-17/DDA-3482/oPt /HNC/UN/7617,2/15/2019 6:12:05 AM,Host Communities,35870,37429,42108,40549,155956,0,0,0,0,0
67,oPt,2017,OPT-17/DDA-3482/oPt /HNC/UN/7617,2/15/2019 6:12:05 AM,Internally Displaced People,1949,1000,0,0,2949,0,0,0,0,0
67,oPt,2017,OPT-17/DDA-3482/oPt /HNC/UN/7617,2/15/2019 6:12:05 AM,Overall,114043,115018,131588,126715,487364,194634,186848,202419,194634,778535
67,oPt,2017,OPT-17/DDA-3482/oPt /HNC/UN/7617,2/15/2019 6:12:05 AM,Refugees,76224,76589,89480,86166,328459,0,0,0,0,0
67,oPt,2017,OPT-17/DDA-3482/oPt /WASH-HNC/UN/6717,2/12/2018 7:18:48 AM,Overall,498682,481079,476574,455932,1912267,498682,481079,476574,455932,1912267
67,oPt,2017,OPT-17/DDA-3482/OPT/EDU/INGO/5878,5/10/2018 12:11:18 PM,Host Communities,22,28,487,399,936,88,32,486,443,1049
67,oPt,2017,OPT-17/DDA-3482/OPT/EDU/INGO/5878,5/10/2018 12:11:18 PM,Internally Displaced People,3,2,34,21,60,5,5,50,30,90
67,oPt,2017,OPT-17/DDA-3482/OPT/EDU/INGO/5878,5/10/2018 12:11:18 PM,Overall,25,30,521,420,996,93,37,536,473,1139
67,oPt,2017,OPT-17/DDA-3482/OPT/EDU/INGO/5881,3/26/2018 8:38:28 AM,Overall,0,0,500,500,1000,0,0,430,437,867
67,oPt,2017,OPT-17/DDA-3482/OPT/FSL/INGO/5901,3/26/2018 9:03:43 AM,Overall,602,534,296,263,1695,513,361,438,407,1719
67,oPt,2017,OPT-17/DDA-3482/OPT/FSL/NGO/5835,4/24/2018 11:49:05 AM,Overall,498,498,781,813,2590,531,563,866,856,2816
67,oPt,2017,OPT-17/DDA-3482/OPT/FSL/NGO/5836,3/2/2018 6:50:32 AM,Other,60,60,0,0,120,50,50,0,0,100
67,oPt,2017,OPT-17/DDA-3482/OPT/FSL/NGO/5836,3/2/2018 6:50:32 AM,Overall,60,60,0,0,120,50,50,0,0,100
67,oPt,2017,OPT-17/DDA-3482/OPT/FSL/NGO/5866,5/10/2018 11:33:53 AM,Overall,122,56,0,0,178,147,57,0,0,204
67,oPt,2017,OPT-17/DDA-3482/OPT/FSL/NGO/5919,2/7/2018 9:53:04 AM,Host Communities,271,271,520,502,1564,281,282,525,510,1598
67,oPt,2017,OPT-17/DDA-3482/OPT/FSL/NGO/5919,2/7/2018 9:53:04 AM,Internally Displaced People,10,10,24,23,67,12,12,20,21,65
67,oPt,2017,OPT-17/DDA-3482/OPT/FSL/NGO/5919,2/7/2018 9:53:04 AM,Overall,321,321,620,600,1862,346,347,651,628,1972
67,oPt,2017,OPT-17/DDA-3482/OPT/FSL/NGO/5919,2/7/2018 9:53:04 AM,Refugees,40,40,76,75,231,53,54,97,105,309
67,oPt,2017,OPT-17/DDA-3482/oPt/FSL/UN/5556,11/13/2017 2:57:44 PM,Overall,1414,1519,2178,2033,7144,1608,1775,2415,2299,8097
67,oPt,2017,OPT-17/DDA-3482/oPt/FSL/UN/5556,11/13/2017 2:57:44 PM,Refugees,990,1063,1524,1423,5000,1201,1295,1848,1779,6123
67,oPt,2017,OPT-17/DDA-3482/OPT/HNC/INGO/5855,2/9/2018 1:48:48 PM,Other,86,114,900,900,2000,1989,1896,0,0,3885
67,oPt,2017,OPT-17/DDA-3482/OPT/HNC/INGO/5855,2/9/2018 1:48:48 PM,Overall,86,114,900,900,2000,160,138,1829,1758,3885
67,oPt,2017,OPT-17/DDA-3482/OPT/HNC/INGO/5903,3/26/2018 7:31:31 AM,Overall,1400,3000,2000,3600,10000,2376,9056,2394,2661,16487
67,oPt,2017,OPT-17/DDA-3482/OPT/HNC/INGO/5930,4/24/2018 12:13:42 PM,Overall,130,110,90,70,400,129,119,116,112,476
67,oPt,2017,OPT-17/DDA-3482/OPT/HNC/NGO/5888,2/12/2018 8:37:35 AM,Other,8,22220,0,6200,28428,8,22277,0,6200,28485
67,oPt,2017,OPT-17/DDA-3482/OPT/HNC/NGO/5888,2/12/2018 8:37:35 AM,Overall,40,111100,0,31000,142140,40,111383,0,31000,142423
67,oPt,2017,OPT-17/DDA-3482/OPT/HNC/NGO/5888,2/12/2018 8:37:35 AM,Refugees,32,88880,0,24800,113712,32,89106,0,24800,113938
67,oPt,2017,OPT-17/DDA-3482/OPT/HNC/NGO/5969,3/26/2018 6:55:47 AM,Overall,842,1963,1012,433,4250,1616,2142,833,628,5219
67,oPt,2017,OPT-17/DDA-3482/oPt/HNC/UN/5614,10/3/2017 1:12:14 PM,Overall,975256,937011,0,0,1912267,975256,937011,0,0,1912267
67,oPt,2017,OPT-17/DDA-3482/OPT/HNC/UN/5896,5/22/2018 8:53:50 AM,Overall,3142,2571,1347,1102,8162,3719,3089,1422,1081,9311
67,oPt,2017,OPT-17/DDA-3482/OPT/HNC/UN/5896,5/22/2018 8:53:50 AM,Refugees,1100,900,471,386,2857,1302,1081,498,378,3259
67,oPt,2017,OPT-17/DDA-3482/OPT/PROT/INGO/5847,6/28/2018 6:21:16 AM,Overall,232,10300,218,228,10978,284,10604,234,431,11553
67,oPt,2017,OPT-17/DDA-3482/OPT/PROT/INGO/5847,6/28/2018 6:21:16 AM,Refugees,232,10300,218,228,10978,227,8483,187,345,9242
67,oPt,2017,OPT-17/DDA-3482/OPT/PROT/INGO/5895,8/7/2018 6:32:07 AM,Host Communities,80,80,160,160,480,0,0,0,0,0
67,oPt,2017,OPT-17/DDA-3482/OPT/PROT/INGO/5895,8/7/2018 6:32:07 AM,Overall,80,80,160,160,480,30,30,90,90,240
67,oPt,2017,OPT-17/DDA-3482/OPT/PROT/INGO/5939,2/21/2018 1:25:28 PM,Host Communities,6,40,300,250,596,3,44,364,288,699
67,oPt,2017,OPT-17/DDA-3482/OPT/PROT/INGO/5939,2/21/2018 1:25:28 PM,Overall,8,60,505,355,928,8,87,531,308,934
67,oPt,2017,OPT-17/DDA-3482/OPT/PROT/INGO/5939,2/21/2018 1:25:28 PM,Refugees,2,20,205,105,332,5,43,164,20,232
67,oPt,2017,OPT-17/DDA-3482/OPT/PROT/INGO/5987,5/10/2018 12:03:14 PM,Host Communities,10,6,3,0,19,10,6,5,1,22
67,oPt,2017,OPT-17/DDA-3482/OPT/PROT/INGO/5987,5/10/2018 12:03:14 PM,Internally Displaced People,10,7,10,1,28,12,7,10,0,29
67,oPt,2017,OPT-17/DDA-3482/OPT/PROT/INGO/5987,5/10/2018 12:03:14 PM,Overall,30,20,18,2,70,35,20,21,2,78
67,oPt,2017,OPT-17/DDA-3482/OPT/PROT/INGO/5987,5/10/2018 12:03:14 PM,Refugees,10,7,5,1,23,13,7,6,1,27
67,oPt,2017,OPT-17/DDA-3482/OPT/PROT/NGO/5859,2/9/2018 2:02:48 PM,Internally Displaced People,100,203,120,255,678,162,300,300,363,1125
67,oPt,2017,OPT-17/DDA-3482/OPT/PROT/NGO/5859,2/9/2018 2:02:48 PM,Overall,267,1423,240,510,2440,314,1862,293,663,3132
67,oPt,2017,OPT-17/DDA-3482/OPT/PROT/NGO/5859,2/9/2018 2:02:48 PM,Refugees,167,1220,120,255,1762,145,1562,147,146,2000
67,oPt,2017,OPT-17/DDA-3482/OPT/PROT/NGO/5875,2/9/2018 2:08:29 PM,Internally Displaced People,138,1757,42,917,2854,138,1758,43,920,2859
67,oPt,2017,OPT-17/DDA-3482/OPT/PROT/NGO/5875,2/9/2018 2:08:29 PM,Overall,230,2510,60,1310,4110,230,2512,61,1314,4117
67,oPt,2017,OPT-17/DDA-3482/OPT/PROT/NGO/5875,2/9/2018 2:08:29 PM,Refugees,46,502,12,262,822,46,503,12,263,824
67,oPt,2017,OPT-17/DDA-3482/OPT/PROT/NGO/5915,2/21/2018 10:54:04 AM,Overall,270,196,160,188,814,270,196,160,188,814
67,oPt,2017,OPT-17/DDA-3482/OPT/PROT/NGO/5932,3/26/2018 7:03:23 AM,Other,97,128,42,53,320,61,81,53,32,227
67,oPt,2017,OPT-17/DDA-3482/OPT/PROT/NGO/5932,3/26/2018 7:03:23 AM,Overall,197,328,72,103,700,215,269,144,80,708
67,oPt,2017,OPT-17/DDA-3482/OPT/PROT/NGO/5932,3/26/2018 7:03:23 AM,Refugees,100,200,30,50,380,154,188,91,48,481
67,oPt,2017,OPT-17/DDA-3482/OPT/PROT/NGO/5983,9/14/2018 10:58:19 AM,Host Communities,38,32,20,13,103,99,217,114,147,577
67,oPt,2017,OPT-17/DDA-3482/OPT/PROT/NGO/5983,9/14/2018 10:58:19 AM,Other,77,100,60,47,284,0,0,0,0,0
67,oPt,2017,OPT-17/DDA-3482/OPT/PROT/NGO/5983,9/14/2018 10:58:19 AM,Overall,160,190,140,138,628,113,242,142,162,659
67,oPt,2017,OPT-17/DDA-3482/OPT/PROT/NGO/5983,9/14/2018 10:58:19 AM,Refugees,45,58,60,78,241,14,25,28,15,82
67,oPt,2017,OPT-17/DDA-3482/OPT/PROT/NGO/5984,8/8/2018 7:44:45 AM,Other,15,100,100,15,230,0,79,97,0,176
67,oPt,2017,OPT-17/DDA-3482/OPT/PROT/NGO/5984,8/8/2018 7:44:45 AM,Overall,30,200,200,30,460,0,179,204,3,386
67,oPt,2017,OPT-17/DDA-3482/OPT/PROT/NGO/5984,8/8/2018 7:44:45 AM,Refugees,15,100,100,15,230,0,89,75,0,164
67,oPt,2017,OPT-17/DDA-3482/OPT/SNFI/INGO/5872,4/10/2018 7:57:15 AM,Overall,56,54,60,58,228,62,56,109,91,318
67,oPt,2017,OPT-17/DDA-3482/OPT/SNFI/INGO/5876,12/26/2017 11:07:56 AM,Other,147,142,119,115,523,134,131,110,106,481
67,oPt,2017,OPT-17/DDA-3482/OPT/SNFI/INGO/5876,12/26/2017 11:07:56 AM,Overall,147,142,119,115,523,134,131,110,106,481
67,oPt,2017,OPT-17/DDA-3482/OPT/SNFI/INGO/5966,3/26/2018 8:51:45 AM,Overall,227,277,228,236,968,304,320,225,247,1096
67,oPt,2017,OPT-17/DDA-3482/OPT/SNFI/INGO/5966,3/26/2018 8:51:45 AM,Refugees,227,277,228,236,968,304,320,225,247,1096
67,oPt,2017,OPT-17/DDA-3482/OPT/WASH/NGO/5864,2/21/2018 10:55:38 AM,Other,292,274,135,137,838,252,237,117,118,724
67,oPt,2017,OPT-17/DDA-3482/OPT/WASH/NGO/5864,2/21/2018 10:55:38 AM,Overall,430,412,189,190,1221,370,354,163,163,1050
67,oPt,2017,OPT-17/DDA-3482/OPT/WASH/NGO/5864,2/21/2018 10:55:38 AM,Refugees,138,132,54,53,377,119,114,47,46,326
67,oPt,2017,OPT-17/DDA-3482/OPT/WASH/NGO/5941,3/26/2018 11:37:59 AM,Overall,310400,300802,289985,282148,1183335,310400,300802,289985,282148,1183335
67,oPt,2017,OPT-17/DDA-3482/OPT/WASH/NGO/5941,3/26/2018 11:37:59 AM,Refugees,186240,180481,173991,169288,710000,186240,180481,173991,169288,710000
67,oPt,2017,OPT-17/DDA-3482/OPT/WASH/UN/5947,2/26/2018 9:58:21 AM,Overall,4500,4277,6150,7216,22143,4515,4290,6169,6951,21925
67,oPt,2017,OPT-17/DDA-3482/oPt/WASH/UN/6260,3/26/2018 8:54:19 AM,Overall,355597,351355,266077,262902,1235931,355597,351355,266077,262902,1235931
67,oPt,2018,OPT-18/DDA-3482/RA1/HNC/INGO/9171,1/16/2019 7:36:10 AM,Overall,5000,300,0,0,5300,5030,302,0,0,5332
67,oPt,2018,OPT-18/DDA-3482/RA1/HNC/INGO/9182,1/30/2019 1:32:16 PM,Overall,80000,5000,10000,5000,100000,117125,7320,14641,7320,146406
67,oPt,2018,OPT-18/DDA-3482/RA1/HNC/INGO/9196,4/24/2019 12:22:03 PM,Overall,695,82,96,5,878,575,272,438,132,1417
67,oPt,2018,OPT-18/DDA-3482/RA1/HNC/NGO/9202,1/30/2019 1:30:27 PM,Other,1451,1022,630,512,3615,1852,1064,465,454,3835
67,oPt,2018,OPT-18/DDA-3482/RA1/HNC/NGO/9202,1/30/2019 1:30:27 PM,Overall,7255,5109,3152,2558,18074,9262,5318,2325,2272,19177
67,oPt,2018,OPT-18/DDA-3482/RA1/HNC/NGO/9202,1/30/2019 1:30:27 PM,Refugees,5804,4087,2522,2046,14459,7410,4254,1860,1818,15342
67,oPt,2018,OPT-18/DDA-3482/RA1/PROT/NGO/9200,1/31/2019 6:15:31 AM,Other,775,775,140,100,1790,852,326,281,111,1570
67,oPt,2018,OPT-18/DDA-3482/RA1/PROT/NGO/9200,1/31/2019 6:15:31 AM,Overall,2775,1775,390,260,5200,3348,1726,1154,621,6849
67,oPt,2018,OPT-18/DDA-3482/RA1/PROT/NGO/9200,1/31/2019 6:15:31 AM,Refugees,2000,1000,250,160,3410,2358,1230,853,461,4902
67,oPt,2018,OPT-18/DDA-3482/RA1/PROT/NGO/9203,2/6/2019 2:37:55 PM,Host Communities,750,350,30,35,1165,0,0,0,0,0
67,oPt,2018,OPT-18/DDA-3482/RA1/PROT/NGO/9203,2/6/2019 2:37:55 PM,Overall,750,350,30,35,1165,585,482,1232,72,2371
67,oPt,2018,OPT-18/DDA-3482/RA1/SNFI/INGO/7709,9/19/2018 12:52:59 PM,Other,317,314,359,364,1354,0,0,0,0,0
67,oPt,2018,OPT-18/DDA-3482/RA1/SNFI/INGO/7709,9/19/2018 12:52:59 PM,Overall,317,314,359,364,1354,399,383,432,449,1663
67,oPt,2018,OPT-18/DDA-3482/RA2/FSL-HNC/UN/7749,12/28/2018 10:19:55 AM,Overall,37072,35618,34221,32879,139790,39672,48714,43425,41957,173768
67,oPt,2018,OPT-18/DDA-3482/RA2/HNC/INGO/9451,1/30/2019 2:03:40 PM,Overall,64100,13700,17000,10200,105000,76673,17664,20977,12999,128313
67,oPt,2018,OPT-18/DDA-3482/RA2/HNC/INGO/9457,8/14/2019 6:47:27 AM,Overall,4782,201,978,39,6000,3814,2387,378,11,6590
67,oPt,2018,OPT-18/DDA-3482/RA2/HNC/NGO/9489,6/19/2019 5:42:47 AM,Overall,200,300,150,155,805,270,165,244,148,827
67,oPt,2018,OPT-18/DDA-3482/RA2/HNC/UN/9458,4/29/2019 2:09:15 PM,Overall,1480,95,345,20,1940,2101,2032,1393,1349,6875
67,oPt,2018,OPT-18/DDA-3482/RA2/HNC/UN/9458,4/29/2019 2:09:15 PM,Refugees,1480,95,345,20,1940,424481,424581,369202,352031,1570295
67,oPt,2018,OPT-18/DDA-3482/RA2/HNC/UN/9468,6/22/2020 7:49:07 AM,Other,7875,180,300,269,8624,22866,1962,7544,648,33020
67,oPt,2018,OPT-18/DDA-3482/RA2/HNC/UN/9468,6/22/2020 7:49:07 AM,Overall,26100,620,1040,956,28716,22866,1962,7544,648,33020
67,oPt,2018,OPT-18/DDA-3482/RA2/HNC/UN/9468,6/22/2020 7:49:07 AM,Refugees,3375,420,700,627,5122,0,0,0,0,0
67,oPt,2018,OPT-18/DDA-3482/RA2/HNC/UN/9535,1/24/2020 1:05:03 PM,Overall,0,27604,34726,26712,89042,0,27604,31611,29982,89197
67,oPt,2018,OPT-18/DDA-3482/RA2/PROT/INGO/9456,10/1/2019 8:54:19 AM,Overall,600,200,0,0,800,600,200,0,0,800
67,oPt,2018,OPT-18/DDA-3482/RA2/PROT/INGO/9521,8/6/2019 7:38:14 PM,Overall,181,240,635,380,1436,74,323,957,1218,2572
67,oPt,2018,OPT-18/DDA-3482/RA2/PROT/INGO/9536,7/18/2019 7:32:17 AM,Host Communities,366,424,617,582,1989,366,424,617,582,1989
67,oPt,2018,OPT-18/DDA-3482/RA2/PROT/INGO/9536,7/18/2019 7:32:17 AM,Overall,366,424,617,582,1989,366,424,617,582,1989
67,oPt,2018,OPT-18/DDA-3482/RA2/PROT/NGO/9448,7/23/2019 11:21:06 AM,Other,815,248,1515,546,3124,1100,356,2241,1095,4792
67,oPt,2018,OPT-18/DDA-3482/RA2/PROT/NGO/9448,7/23/2019 11:21:06 AM,Overall,3260,990,6060,2185,12495,3260,1124,6060,2865,13309
67,oPt,2018,OPT-18/DDA-3482/RA2/PROT/NGO/9448,7/23/2019 11:21:06 AM,Refugees,2445,742,4545,1639,9371,2160,768,3819,1770,8517
67,oPt,2018,OPT-18/DDA-3482/RA2/PROT/NGO/9512,6/25/2019 10:07:09 AM,Other,310,910,135,135,1490,0,0,0,0,0
67,oPt,2018,OPT-18/DDA-3482/RA2/PROT/NGO/9512,6/25/2019 10:07:09 AM,Overall,1025,3025,450,450,4950,1116,3728,529,496,5869
67,oPt,2018,OPT-18/DDA-3482/RA2/PROT/NGO/9512,6/25/2019 10:07:09 AM,Refugees,715,2115,315,315,3460,1116,3728,529,452,5825
67,oPt,2018,OPT-18/DDA-3482/RA3/HNC-WASH/UN/10516,2/11/2019 1:12:22 PM,Overall,498682,481079,486574,495932,1962267,498682,481079,486574,495932,1962267
67,oPt,2018,OPT-18/DDA-3482/SA1/PROT/INGO/9079,8/29/2019 10:05:18 AM,Internally Displaced People,200,200,30,20,450,168,160,93,83,504
67,oPt,2018,OPT-18/DDA-3482/SA1/PROT/INGO/9079,8/29/2019 10:05:18 AM,Other,826,859,425,345,2455,860,2060,1517,857,5294
67,oPt,2018,OPT-18/DDA-3482/SA1/PROT/INGO/9079,8/29/2019 10:05:18 AM,Overall,3420,3530,1515,1215,9680,3447,5720,2768,2125,14060
67,oPt,2018,OPT-18/DDA-3482/SA1/PROT/INGO/9079,8/29/2019 10:05:18 AM,Refugees,2394,2471,1060,850,6775,2419,3500,1158,1185,8262
67,oPt,2018,OPT-18/DDA-3482/SA1/PROT/INGO/9156,10/15/2019 12:50:00 PM,Host Communities,70,466,0,0,536,0,0,0,0,0
67,oPt,2018,OPT-18/DDA-3482/SA1/PROT/INGO/9156,10/15/2019 12:50:00 PM,Internally Displaced People,350,4000,200,200,4750,0,0,0,0,0
67,oPt,2018,OPT-18/DDA-3482/SA1/PROT/INGO/9156,10/15/2019 12:50:00 PM,Overall,770,8466,400,400,10036,606,15290,537,628,17061
67,oPt,2018,OPT-18/DDA-3482/SA1/PROT/INGO/9156,10/15/2019 12:50:00 PM,Refugees,350,4000,200,200,4750,0,0,0,0,0
67,oPt,2018,OPT-18/DDA-3482/SA1/PROT/NGO/9094,4/23/2019 1:08:04 PM,Internally Displaced People,265,2868,106,1401,4640,36,596,13,128,773
67,oPt,2018,OPT-18/DDA-3482/SA1/PROT/NGO/9094,4/23/2019 1:08:04 PM,Overall,780,8454,312,4127,13673,825,8535,392,4300,14052
67,oPt,2018,OPT-18/DDA-3482/SA1/PROT/NGO/9094,4/23/2019 1:08:04 PM,Refugees,390,4223,155,2064,6832,98,531,128,204,961
67,oPt,2018,OPT-18/DDA-3482/SA1/PROT/NGO/9159,10/29/2019 1:44:08 PM,Internally Displaced People,60,50,15,15,140,5,3,4,3,15
67,oPt,2018,OPT-18/DDA-3482/SA1/PROT/NGO/9159,10/29/2019 1:44:08 PM,Other,249,391,16,44,700,100,69,69,37,275
67,oPt,2018,OPT-18/DDA-3482/SA1/PROT/NGO/9159,10/29/2019 1:44:08 PM,Overall,449,581,171,199,1400,570,360,359,162,1451
67,oPt,2018,OPT-18/DDA-3482/SA1/PROT/NGO/9159,10/29/2019 1:44:08 PM,Refugees,140,140,140,140,560,456,283,281,122,1142
67,oPt,2018,OPT-18/DDA-3482/SA1/SNFI/INGO/9031,2/1/2019 2:28:28 PM,Overall,92,89,89,87,357,99,96,89,86,370
67,oPt,2018,OPT-18/DDA-3482/SA1/SNFI/INGO/9034,1/30/2019 2:11:22 PM,Other,14,38,64,48,164,28,43,36,33,140
67,oPt,2018,OPT-18/DDA-3482/SA1/SNFI/INGO/9034,1/30/2019 2:11:22 PM,Overall,38,106,178,134,456,135,181,98,89,503
67,oPt,2018,OPT-18/DDA-3482/SA1/SNFI/INGO/9034,1/30/2019 2:11:22 PM,Refugees,24,68,114,86,292,107,138,62,56,363
67,oPt,2018,OPT-18/DDA-3482/SA1/SNFI/INGO/9139,1/31/2019 2:52:07 PM,Overall,153,148,160,152,613,170,167,153,137,627
67,oPt,2018,OPT-18/DDA-3482/SA1/SNFI/INGO/9184,3/4/2019 11:58:40 AM,Host Communities,78,83,70,70,301,56,60,81,75,272
67,oPt,2018,OPT-18/DDA-3482/SA1/SNFI/INGO/9184,3/4/2019 11:58:40 AM,Overall,219,188,159,195,761,144,142,175,175,636
67,oPt,2018,OPT-18/DDA-3482/SA1/SNFI/INGO/9184,3/4/2019 11:58:40 AM,Refugees,141,105,89,125,460,88,82,94,100,364
67,oPt,2018,OPT-18/DDA-3482/SA1/SNFI/NGO/9030,2/28/2019 1:02:12 PM,Internally Displaced People,202,213,245,248,908,202,213,245,248,908
67,oPt,2018,OPT-18/DDA-3482/SA1/SNFI/NGO/9030,2/28/2019 1:02:12 PM,Overall,202,213,245,248,908,202,213,245,248,908
67,oPt,2018,OPT-18/DDA-3482/SA1/WASH/INGO/8994,4/25/2019 11:00:53 AM,Internally Displaced People,49,48,57,56,210,49,48,59,56,212
67,oPt,2018,OPT-18/DDA-3482/SA1/WASH/INGO/8994,4/25/2019 11:00:53 AM,Other,5149,5049,6143,5879,22220,5224,5125,6233,5967,22549
67,oPt,2018,OPT-18/DDA-3482/SA1/WASH/INGO/8994,4/25/2019 11:00:53 AM,Overall,21651,21234,25828,24727,93440,21808,21390,26019,24908,94125
67,oPt,2018,OPT-18/DDA-3482/SA1/WASH/INGO/8994,4/25/2019 11:00:53 AM,Refugees,16453,16137,19628,18792,71010,16696,16375,19918,19069,72058
67,oPt,2018,OPT-18/DDA-3482/SA1/WASH/INGO/9134,3/1/2019 10:59:27 AM,Other,1582,1660,1656,1687,6585,2369,2373,2384,2404,9530
67,oPt,2018,OPT-18/DDA-3482/SA1/WASH/INGO/9134,3/1/2019 10:59:27 AM,Overall,1582,1660,1656,1687,6585,2369,2373,2384,2404,9530
67,oPt,2018,OPT-18/DDA-3482/SA1/WASH/NGO/8999,5/3/2019 7:33:04 AM,Other,888,854,924,888,3554,684,675,702,675,2736
67,oPt,2018,OPT-18/DDA-3482/SA1/WASH/NGO/8999,5/3/2019 7:33:04 AM,Overall,888,854,924,888,3554,684,675,702,675,2736
67,oPt,2018,OPT-18/DDA-3482/SA1/WASH/NGO/9067,10/2/2019 9:50:01 AM,Overall,2132,2100,2447,2336,9015,2048,2032,3070,2832,9982
67,oPt,2018,OPT-18/DDA-3482/SA1/WASH/NGO/9067,10/2/2019 9:50:01 AM,Refugees,1279,1260,1468,1401,5408,2048,2032,3070,2832,9982
67,oPt,2018,OPT-18/DDA-3482/SA2/EDU/INGO/10680,2/13/2020 12:28:20 PM,Host Communities,148,230,3746,4209,8333,170,442,3750,4526,8888
67,oPt,2018,OPT-18/DDA-3482/SA2/EDU/INGO/10680,2/13/2020 12:28:20 PM,Overall,148,230,3746,4209,8333,170,442,3750,4526,8888
67,oPt,2018,OPT-18/DDA-3482/SA2/EDU/UN/10778,2/10/2020 10:08:29 AM,Overall,100,100,4000,2700,6900,429,245,4492,2364,7530
67,oPt,2018,OPT-18/DDA-3482/SA2/FSL/INGO/10653,10/22/2019 9:14:55 AM,Internally Displaced People,18,17,17,17,69,14,14,15,13,56
67,oPt,2018,OPT-18/DDA-3482/SA2/FSL/INGO/10653,10/22/2019 9:14:55 AM,Other,581,576,575,550,2282,550,535,610,533,2228
67,oPt,2018,OPT-18/DDA-3482/SA2/FSL/INGO/10653,10/22/2019 9:14:55 AM,Overall,2139,2120,2116,2025,8400,2540,2517,2513,2404,9974
67,oPt,2018,OPT-18/DDA-3482/SA2/FSL/INGO/10653,10/22/2019 9:14:55 AM,Refugees,1540,1527,1524,1458,6049,1976,1968,1888,1858,7690
67,oPt,2018,OPT-18/DDA-3482/SA2/FSL/INGO/10701,10/15/2019 1:12:34 PM,Overall,254,323,275,307,1159,367,467,397,444,1675
67,oPt,2018,OPT-18/DDA-3482/SA2/FSL/INGO/10721,11/11/2019 11:15:05 AM,Overall,619,642,754,785,2800,1522,1435,1280,1264,5501
67,oPt,2018,OPT-18/DDA-3482/SA2/FSL/NGO/10737,2/26/2020 6:57:42 AM,Other,528,509,550,529,2116,679,652,706,679,2716
67,oPt,2018,OPT-18/DDA-3482/SA2/FSL/NGO/10737,2/26/2020 6:57:42 AM,Overall,528,509,550,529,2116,679,652,706,679,2716
67,oPt,2018,OPT-18/DDA-3482/SA2/FSL/NGO/10757,11/5/2019 2:08:50 PM,Other,0,0,0,0,0,997,922,755,694,3368
67,oPt,2018,OPT-18/DDA-3482/SA2/FSL/NGO/10757,11/5/2019 2:08:50 PM,Overall,491,625,531,593,2240,997,922,755,694,3368
67,oPt,2018,OPT-18/DDA-3482/SA2/FSL/NGO/10757,11/5/2019 2:08:50 PM,Refugees,460,443,347,334,1584,0,0,0,0,0
67,oPt,2018,OPT-18/DDA-3482/SA2/FSL/NGO/10764,9/5/2019 11:18:58 AM,Overall,990,990,1461,1529,4970,891,999,1337,1498,4725
67,oPt,2018,OPT-18/DDA-3482/SA2/HNC/INGO/10762,4/10/2020 5:07:38 AM,Overall,498,324,106,102,1030,515,332,223,118,1188
67,oPt,2018,OPT-18/DDA-3482/SA2/HNC/NGO/10652,3/25/2020 2:06:43 PM,Overall,5610,2580,1420,1390,11000,6554,3020,1670,1608,12852
67,oPt,2018,OPT-18/DDA-3482/SA2/HNC/NGO/10725,12/15/2019 5:45:36 PM,Host Communities,1000,75,80,35,1190,671,68,109,27,875
67,oPt,2018,OPT-18/DDA-3482/SA2/HNC/NGO/10725,12/15/2019 5:45:36 PM,Overall,4300,255,380,105,5040,2870,295,541,96,3802
67,oPt,2018,OPT-18/DDA-3482/SA2/HNC/NGO/10725,12/15/2019 5:45:36 PM,Refugees,3300,180,300,70,3850,2199,227,432,69,2927
67,oPt,2018,OPT-18/DDA-3482/SA2/HNC/NGO/10807,1/23/2020 11:33:31 AM,Other,900,120,150,30,1200,588,625,81,20,1314
67,oPt,2018,OPT-18/DDA-3482/SA2/HNC/NGO/10807,1/23/2020 11:33:31 AM,Overall,900,120,150,30,1200,588,625,81,20,1314
67,oPt,2018,OPT-18/DDA-3482/SA2/PROT/INGO/10777,2/10/2020 9:47:53 AM,Overall,56,122,795,691,1664,153,1173,714,621,2661
67,oPt,2018,OPT-18/DDA-3482/SA2/SNFI/INGO/10747,10/15/2019 12:42:53 PM,Overall,66,74,79,87,306,84,87,70,63,304
67,oPt,2018,OPT-18/DDA-3482/SA2/WASH/INGO/10722,11/25/2019 6:26:16 AM,Host Communities,2505,2598,3058,3179,11340,3900,4044,4759,4950,17653
67,oPt,2018,OPT-18/DDA-3482/SA2/WASH/INGO/10722,11/25/2019 6:26:16 AM,Internally Displaced People,2881,2988,3516,3656,13041,4485,4651,5473,5692,20301
67,oPt,2018,OPT-18/DDA-3482/SA2/WASH/INGO/10722,11/25/2019 6:26:16 AM,Other,1503,1559,1834,1908,6804,2340,2426,2856,2970,10592
67,oPt,2018,OPT-18/DDA-3482/SA2/WASH/INGO/10722,11/25/2019 6:26:16 AM,Overall,12525,12992,15287,15896,56700,19499,20223,23798,24747,88267
67,oPt,2018,OPT-18/DDA-3482/SA2/WASH/INGO/10722,11/25/2019 6:26:16 AM,Refugees,5636,5847,6879,7153,25515,8774,9102,10710,11135,39721
67,oPt,2018,OPT-18/DDA-3482/SA2/WASH/INGO/10724,10/29/2019 1:38:31 PM,Internally Displaced People,648,636,773,740,2797,712,699,829,795,3035
67,oPt,2018,OPT-18/DDA-3482/SA2/WASH/INGO/10724,10/29/2019 1:38:31 PM,Other,25917,25418,30918,29601,111854,28394,27992,33129,31835,121350
67,oPt,2018,OPT-18/DDA-3482/SA2/WASH/INGO/10724,10/29/2019 1:38:31 PM,Overall,78593,77083,93760,89764,339200,86109,84885,100465,96541,368000
67,oPt,2018,OPT-18/DDA-3482/SA2/WASH/INGO/10724,10/29/2019 1:38:31 PM,Refugees,52028,51029,62069,59423,224549,57003,56194,66507,63911,243615
67,oPt,2018,OPT-18/DDA-3482/SA2/WASH/INGO/10793,12/4/2019 12:13:06 PM,Overall,12736,12800,19328,19136,64000,17091,16637,15439,14833,64000
67,oPt,2018,OPT-18/DDA-3482/SA2/WASH/NGO/10714,12/16/2019 5:50:03 PM,Overall,8660,7710,9360,8270,34000,12201,10610,12510,11550,46871
67,oPt,2018,OPT-18/DDA-3482/SA2/WASH/NGO/10714,12/16/2019 5:50:03 PM,Refugees,6078,5405,6584,5824,23891,12201,10610,12510,11550,46871
67,oPt,2018,OPT-18/DDA-3482/SA2/WASH/UN/10769,6/7/2020 6:50:17 AM,Overall,11823,11497,8457,8223,40000,11823,11497,8457,8223,40000
67,oPt,2019,OPT-19/DDA-3482/SA1/FSL/NGO/12322,6/23/2020 6:48:55 AM,Host Communities,246,243,116,100,705,312,270,133,138,853
67,oPt,2019,OPT-19/DDA-3482/SA1/FSL/NGO/12322,6/23/2020 6:48:55 AM,Overall,348,341,154,127,970,434,397,187,175,1193
67,oPt,2019,OPT-19/DDA-3482/SA1/FSL/NGO/12322,6/23/2020 6:48:55 AM,Refugees,102,98,38,27,265,122,127,54,37,340
67,oPt,2019,OPT-19/DDA-3482/SA1/FSL-PROT/NGO/12409,3/30/2020 7:34:43 PM,Host Communities,782,849,650,676,2957,1495,1011,942,846,4294
67,oPt,2019,OPT-19/DDA-3482/SA1/FSL-PROT/NGO/12409,3/30/2020 7:34:43 PM,Overall,782,849,650,676,2957,1495,1011,942,846,4294
67,oPt,2019,OPT-19/DDA-3482/SA1/HNC/INGO/12289,11/4/2020 9:13:35 AM,Other,1488,552,312,48,2400,1515,609,300,41,2465
67,oPt,2019,OPT-19/DDA-3482/SA1/HNC/INGO/12289,11/4/2020 9:13:35 AM,Overall,1488,552,312,48,2400,1515,609,300,41,2465
67,oPt,2019,OPT-19/DDA-3482/SA1/HNC/INGO/12339,12/3/2019 1:24:17 PM,Other,197518,12608,46332,2957,259415,237745,15176,55767,3558,312246
67,oPt,2019,OPT-19/DDA-3482/SA1/HNC/INGO/12339,12/3/2019 1:24:17 PM,Overall,197518,12608,46332,2957,259415,237745,15176,55767,3558,312246
67,oPt,2019,OPT-19/DDA-3482/SA1/HNC/INGO/12378,2/25/2020 9:05:43 AM,Other,1164,36,0,0,1200,1340,42,0,0,1382
67,oPt,2019,OPT-19/DDA-3482/SA1/HNC/INGO/12378,2/25/2020 9:05:43 AM,Overall,1164,36,0,0,1200,1340,42,0,0,1382
67,oPt,2019,OPT-19/DDA-3482/SA1/HNC/INGO/12465,7/14/2020 7:28:56 AM,Host Communities,600,1200,150,250,2200,256,588,164,139,1147
67,oPt,2019,OPT-19/DDA-3482/SA1/HNC/INGO/12465,7/14/2020 7:28:56 AM,Other,1679,896,0,0,2575,1270,725,17,10,2022
67,oPt,2019,OPT-19/DDA-3482/SA1/HNC/INGO/12465,7/14/2020 7:28:56 AM,Overall,2479,2396,200,300,5375,1700,1570,311,276,3857
67,oPt,2019,OPT-19/DDA-3482/SA1/HNC/INGO/12465,7/14/2020 7:28:56 AM,Refugees,200,300,50,50,600,174,257,130,127,688
67,oPt,2019,OPT-19/DDA-3482/SA1/HNC/NGO/12323,7/13/2020 5:56:56 AM,Other,1750,92,359,19,2220,749,41,230,11,1031
67,oPt,2019,OPT-19/DDA-3482/SA1/HNC/NGO/12323,7/13/2020 5:56:56 AM,Overall,5834,307,1196,63,7400,4005,206,890,52,5153
67,oPt,2019,OPT-19/DDA-3482/SA1/HNC/NGO/12323,7/13/2020 5:56:56 AM,Refugees,4084,215,837,44,5180,3256,165,660,41,4122
67,oPt,2019,OPT-19/DDA-3482/SA1/HNC/UN/12387,6/30/2020 12:06:17 PM,Host Communities,15852,15714,14562,13872,60000,22824,22625,20966,19973,86388
67,oPt,2019,OPT-19/DDA-3482/SA1/HNC/UN/12387,6/30/2020 12:06:17 PM,Overall,52840,52380,48540,46240,200000,76079,75417,69888,66576,287960
67,oPt,2019,OPT-19/DDA-3482/SA1/HNC/UN/12387,6/30/2020 12:06:17 PM,Refugees,36988,36666,33978,32368,140000,53255,52792,48922,46603,201572
67,oPt,2019,OPT-19/DDA-3482/SA1/PROT/INGO/12306,12/24/2020 11:53:30 AM,Host Communities,185,303,2800,2690,5978,365,611,4797,4037,9810
67,oPt,2019,OPT-19/DDA-3482/SA1/PROT/INGO/12306,12/24/2020 11:53:30 AM,Overall,185,303,2800,2690,5978,365,611,4797,4037,9810
67,oPt,2019,OPT-19/DDA-3482/SA1/PROT/INGO/12328,12/9/2020 7:34:29 AM,Internally Displaced People,535,191,0,0,726,597,241,0,0,838
67,oPt,2019,OPT-19/DDA-3482/SA1/PROT/INGO/12328,12/9/2020 7:34:29 AM,Overall,535,191,0,0,726,597,241,0,0,838
67,oPt,2019,OPT-19/DDA-3482/SA1/PROT/INGO/12365,7/12/2020 12:11:05 PM,Other,954,936,801,711,3402,1273,1997,1920,1435,6625
67,oPt,2019,OPT-19/DDA-3482/SA1/PROT/INGO/12365,7/12/2020 12:11:05 PM,Overall,3180,3120,2670,2370,11340,3600,5204,4961,4000,17765
67,oPt,2019,OPT-19/DDA-3482/SA1/PROT/INGO/12365,7/12/2020 12:11:05 PM,Refugees,2226,2184,1869,1659,7938,2327,3207,3041,2565,11140
67,oPt,2019,OPT-19/DDA-3482/SA1/PROT/NGO/12264,7/12/2020 12:17:54 PM,Host Communities,4000,300,1100,100,5500,1597,679,4009,163,6448
67,oPt,2019,OPT-19/DDA-3482/SA1/PROT/NGO/12264,7/12/2020 12:17:54 PM,Overall,4000,300,1100,100,5500,1597,679,4009,163,6448
67,oPt,2019,OPT-19/DDA-3482/SA1/PROT/NGO/12272,8/10/2020 7:57:14 AM,Other,750,2192,0,0,2942,753,3439,1,11,4204
67,oPt,2019,OPT-19/DDA-3482/SA1/PROT/NGO/12272,8/10/2020 7:57:14 AM,Overall,750,2192,0,0,2942,753,3439,1,11,4204
67,oPt,2019,OPT-19/DDA-3482/SA1/PROT/NGO/12318,8/12/2020 10:11:10 AM,Host Communities,30,30,30,30,120,8,15,7,27,57
67,oPt,2019,OPT-19/DDA-3482/SA1/PROT/NGO/12318,8/12/2020 10:11:10 AM,Internally Displaced People,60,60,60,60,240,38,48,45,50,181
67,oPt,2019,OPT-19/DDA-3482/SA1/PROT/NGO/12318,8/12/2020 10:11:10 AM,Other,790,4524,328,1895,7537,348,2294,195,784,3621
67,oPt,2019,OPT-19/DDA-3482/SA1/PROT/NGO/12318,8/12/2020 10:11:10 AM,Overall,2010,9389,1140,4275,16814,1832,7539,1048,2853,13272
67,oPt,2019,OPT-19/DDA-3482/SA1/PROT/NGO/12318,8/12/2020 10:11:10 AM,Refugees,1050,4695,642,2210,8597,1428,5122,791,1954,9295
67,oPt,2019,OPT-19/DDA-3482/SA1/PROT/NGO/12318,8/12/2020 10:11:10 AM,Returnees,80,80,80,80,320,10,60,10,38,118
67,oPt,2019,OPT-19/DDA-3482/SA1/PROT/NGO/12326,7/21/2020 7:25:29 AM,Other,870,1830,720,480,3900,975,1850,889,506,4220
67,oPt,2019,OPT-19/DDA-3482/SA1/PROT/NGO/12326,7/21/2020 7:25:29 AM,Overall,2900,6100,2400,1600,13000,3264,6144,2988,1676,14072
67,oPt,2019,OPT-19/DDA-3482/SA1/PROT/NGO/12326,7/21/2020 7:25:29 AM,Refugees,2030,4270,1680,1120,9100,2289,4294,2099,1170,9852
67,oPt,2019,OPT-19/DDA-3482/SA1/PROT/NGO/12395,7/12/2020 11:40:07 AM,Host Communities,333,1910,30,35,2308,399,1434,39,38,1910
67,oPt,2019,OPT-19/DDA-3482/SA1/PROT/NGO/12395,7/12/2020 11:40:07 AM,Overall,333,1910,30,35,2308,399,1434,39,38,1910
67,oPt,2019,OPT-19/DDA-3482/SA1/PROT/UN/12325,7/29/2020 11:40:30 AM,Other,3000,12650,0,0,15650,2836,13515,0,0,16351
67,oPt,2019,OPT-19/DDA-3482/SA1/PROT/UN/12325,7/29/2020 11:40:30 AM,Overall,3000,12650,0,0,15650,2836,13515,0,0,16351
67,oPt,2019,OPT-19/DDA-3482/SA1/PROT/UN/12330,3/3/2021 7:48:12 AM,Overall,1050,234,1304,564,3152,39,29,1024,544,1636
67,oPt,2019,OPT-19/DDA-3482/SA1/PROT/UN/12330,3/3/2021 7:48:12 AM,Refugees,1050,234,1304,564,3152,39,29,1024,544,1636
67,oPt,2019,OPT-19/DDA-3482/SA1/PROT-HNC/NGO/12316,9/17/2020 11:25:31 AM,Other,355,150,50,30,585,315,331,228,128,1002
67,oPt,2019,OPT-19/DDA-3482/SA1/PROT-HNC/NGO/12316,9/17/2020 11:25:31 AM,Overall,1183,664,511,212,2570,1322,996,812,351,3481
67,oPt,2019,OPT-19/DDA-3482/SA1/PROT-HNC/NGO/12316,9/17/2020 11:25:31 AM,Refugees,828,514,461,182,1985,1007,665,584,223,2479
67,oPt,2019,OPT-19/DDA-3482/SA1/SNFI/INGO/12373,3/23/2020 9:40:52 AM,Host Communities,115,112,166,154,547,148,139,207,221,715
67,oPt,2019,OPT-19/DDA-3482/SA1/SNFI/INGO/12373,3/23/2020 9:40:52 AM,Overall,119,116,173,159,567,165,161,216,230,772
67,oPt,2019,OPT-19/DDA-3482/SA1/SNFI/INGO/12373,3/23/2020 9:40:52 AM,Refugees,4,4,7,5,20,17,22,9,9,57
67,oPt,2019,OPT-19/DDA-3482/SA1/SNFI/INGO/12458,3/8/2020 11:33:17 AM,Host Communities,161,155,181,175,672,188,181,211,204,784
67,oPt,2019,OPT-19/DDA-3482/SA1/SNFI/INGO/12458,3/8/2020 11:33:17 AM,Internally Displaced People,1818,1743,2045,1970,7576,1818,1743,2045,1970,7576
67,oPt,2019,OPT-19/DDA-3482/SA1/SNFI/INGO/12458,3/8/2020 11:33:17 AM,Other,54,36,0,0,90,50,40,0,0,90
67,oPt,2019,OPT-19/DDA-3482/SA1/SNFI/INGO/12458,3/8/2020 11:33:17 AM,Overall,2033,1934,2226,2145,8338,2056,1964,2256,2174,8450
67,oPt,2019,OPT-19/DDA-3482/SA1/SNFI/NGO/12284,6/23/2020 5:45:09 AM,Host Communities,201,224,215,224,864,220,229,257,245,951
67,oPt,2019,OPT-19/DDA-3482/SA1/SNFI/NGO/12284,6/23/2020 5:45:09 AM,Overall,201,224,215,224,864,220,229,257,245,951
67,oPt,2019,OPT-19/DDA-3482/SA1/SNFI/NGO/12310,3/25/2020 7:24:25 AM,Host Communities,464,450,434,422,1770,1003,979,1000,956,3938
67,oPt,2019,OPT-19/DDA-3482/SA1/SNFI/NGO/12310,3/25/2020 7:24:25 AM,Internally Displaced People,1470,1425,1374,1336,5605,2060,2078,2101,2111,8350
67,oPt,2019,OPT-19/DDA-3482/SA1/SNFI/NGO/12310,3/25/2020 7:24:25 AM,Other,100,100,0,0,200,101,135,0,0,236
67,oPt,2019,OPT-19/DDA-3482/SA1/SNFI/NGO/12310,3/25/2020 7:24:25 AM,Overall,2034,1975,1808,1758,7575,3164,3192,3101,3067,12524
67,oPt,2019,OPT-19/DDA-3482/SA1/WASH/INGO/12270,4/20/2020 5:36:29 AM,Other,1668,1709,1284,1298,5959,1689,1729,1293,1322,6033
67,oPt,2019,OPT-19/DDA-3482/SA1/WASH/INGO/12270,4/20/2020 5:36:29 AM,Overall,1668,1709,1284,1298,5959,1689,1729,1293,1322,6033
67,oPt,2019,OPT-19/DDA-3482/SA1/WASH/NGO/12363,10/14/2020 8:56:30 AM,Host Communities,491,472,511,491,1965,491,472,511,491,1965
67,oPt,2019,OPT-19/DDA-3482/SA1/WASH/NGO/12363,10/14/2020 8:56:30 AM,Overall,491,472,511,491,1965,491,472,511,491,1965
67,oPt,2019,OPT-19/DDA-3482/SA2/EDU/INGO/14072,1/22/2021 6:56:39 AM,Other,0,0,1158,991,2149,0,0,1179,1245,2424
67,oPt,2019,OPT-19/DDA-3482/SA2/EDU/INGO/14072,1/22/2021 6:56:39 AM,Overall,0,0,1158,991,2149,0,0,1179,1245,2424
67,oPt,2019,OPT-19/DDA-3482/SA2/EDU/NGO/14093,1/17/2021 7:31:44 AM,Other,0,0,620,380,1000,0,0,627,375,1002
67,oPt,2019,OPT-19/DDA-3482/SA2/EDU/NGO/14093,1/17/2021 7:31:44 AM,Overall,0,0,620,380,1000,0,0,627,375,1002
67,oPt,2019,OPT-19/DDA-3482/SA2/EDU-PROT/UN/14119,10/26/2021 6:58:39 AM,Overall,50,50,350,250,700,187,133,720,243,1283
67,oPt,2019,OPT-19/DDA-3482/SA2/EDU-PROT/UN/14119,10/26/2021 6:58:39 AM,Refugees,50,50,350,250,700,187,133,720,243,1283
67,oPt,2019,OPT-19/DDA-3482/SA2/FSL/INGO/13931,9/28/2020 9:00:18 AM,Internally Displaced People,12,12,12,11,47,57,49,44,41,191
67,oPt,2019,OPT-19/DDA-3482/SA2/FSL/INGO/13931,9/28/2020 9:00:18 AM,Other,467,463,462,443,1835,274,280,230,239,1023
67,oPt,2019,OPT-19/DDA-3482/SA2/FSL/INGO/13931,9/28/2020 9:00:18 AM,Overall,2567,2544,2539,2430,10080,2934,3002,2724,2562,11222
67,oPt,2019,OPT-19/DDA-3482/SA2/FSL/INGO/13931,9/28/2020 9:00:18 AM,Refugees,1734,1718,1715,1641,6808,2358,2443,2189,2049,9039
67,oPt,2019,OPT-19/DDA-3482/SA2/FSL/INGO/13931,9/28/2020 9:00:18 AM,Returnees,354,351,350,335,1390,245,230,261,233,969
67,oPt,2019,OPT-19/DDA-3482/SA2/FSL/INGO/13993,10/4/2020 12:15:00 PM,Other,825,546,247,488,2106,783,824,874,817,3298
67,oPt,2019,OPT-19/DDA-3482/SA2/FSL/INGO/13993,10/4/2020 12:15:00 PM,Overall,825,546,247,488,2106,783,824,874,817,3298
67,oPt,2019,OPT-19/DDA-3482/SA2/FSL/INGO/14006,10/13/2020 12:12:15 PM,Other,1042,689,312,617,2660,821,854,941,939,3555
67,oPt,2019,OPT-19/DDA-3482/SA2/FSL/INGO/14006,10/13/2020 12:12:15 PM,Overall,1042,689,312,617,2660,821,854,941,939,3555
67,oPt,2019,OPT-19/DDA-3482/SA2/FSL/INGO/14043,1/12/2021 11:21:36 AM,Host Communities,811,536,242,480,2069,814,769,744,590,2917
67,oPt,2019,OPT-19/DDA-3482/SA2/FSL/INGO/14043,1/12/2021 11:21:36 AM,Overall,811,536,242,480,2069,814,769,744,590,2917
67,oPt,2019,OPT-19/DDA-3482/SA2/FSL/INGO/14101,11/30/2020 7:54:56 AM,Other,353,444,440,327,1564,606,515,354,336,1811
67,oPt,2019,OPT-19/DDA-3482/SA2/FSL/INGO/14101,11/30/2020 7:54:56 AM,Overall,353,444,440,327,1564,606,515,354,336,1811
67,oPt,2019,OPT-19/DDA-3482/SA2/FSL/INGO/14120,10/4/2020 8:04:14 AM,Other,263,254,235,228,980,361,349,323,314,1347
67,oPt,2019,OPT-19/DDA-3482/SA2/FSL/INGO/14120,10/4/2020 8:04:14 AM,Overall,263,254,235,228,980,361,349,323,314,1347
67,oPt,2019,OPT-19/DDA-3482/SA2/FSL/NGO/13998,1/29/2021 12:10:50 PM,Host Communities,699,692,547,548,2486,1813,1345,906,778,4842
67,oPt,2019,OPT-19/DDA-3482/SA2/FSL/NGO/13998,1/29/2021 12:10:50 PM,Overall,699,692,547,548,2486,1813,1345,906,778,4842
67,oPt,2019,OPT-19/DDA-3482/SA2/FSL/NGO/14022,1/31/2021 1:16:46 PM,Other,491,625,531,593,2240,629,601,831,780,2841
67,oPt,2019,OPT-19/DDA-3482/SA2/FSL/NGO/14022,1/31/2021 1:16:46 PM,Overall,491,625,531,593,2240,629,601,831,780,2841
67,oPt,2019,OPT-19/DDA-3482/SA2/FSL/UN/13929,6/26/2020 7:07:30 AM,Host Communities,33492,33827,27098,25583,120000,33423,33757,27042,25529,119751
67,oPt,2019,OPT-19/DDA-3482/SA2/FSL/UN/13929,6/26/2020 7:07:30 AM,Overall,33492,33827,27098,25583,120000,33423,33757,27042,25529,119751
67,oPt,2019,OPT-19/DDA-3482/SA2/FSL-PROT/INGO/13930,1/19/2021 8:40:38 AM,Host Communities,140,125,102,97,464,168,141,109,115,533
67,oPt,2019,OPT-19/DDA-3482/SA2/FSL-PROT/INGO/13930,1/19/2021 8:40:38 AM,Overall,1098,925,745,665,3433,1127,944,749,642,3462
67,oPt,2019,OPT-19/DDA-3482/SA2/FSL-PROT/INGO/13930,1/19/2021 8:40:38 AM,Refugees,958,800,643,568,2969,959,803,640,527,2929
67,oPt,2019,OPT-19/DDA-3482/SA2/HNC/INGO/14088,1/17/2021 7:54:25 AM,Other,103,5,19,3,130,123,1,7,0,131
67,oPt,2019,OPT-19/DDA-3482/SA2/HNC/INGO/14088,1/17/2021 7:54:25 AM,Overall,103,5,19,3,130,123,1,7,0,131
67,oPt,2019,OPT-19/DDA-3482/SA2/HNC/NGO/13988,12/23/2020 8:07:53 AM,Host Communities,627,72,90,26,815,126,9,18,2,155
67,oPt,2019,OPT-19/DDA-3482/SA2/HNC/NGO/13988,12/23/2020 8:07:53 AM,Overall,2690,250,437,75,3452,594,44,88,8,734
67,oPt,2019,OPT-19/DDA-3482/SA2/HNC/NGO/13988,12/23/2020 8:07:53 AM,Refugees,2063,178,347,49,2637,468,35,70,6,579
67,oPt,2019,OPT-19/DDA-3482/SA2/HNC/NGO/14071,1/31/2021 8:16:39 AM,Other,204,3177,0,0,3381,206,4712,0,0,4918
67,oPt,2019,OPT-19/DDA-3482/SA2/HNC/NGO/14071,1/31/2021 8:16:39 AM,Overall,680,10590,0,0,11270,689,15707,0,0,16396
67,oPt,2019,OPT-19/DDA-3482/SA2/HNC/NGO/14071,1/31/2021 8:16:39 AM,Refugees,476,7413,0,0,7889,483,10995,0,0,11478
67,oPt,2019,OPT-19/DDA-3482/SA2/HNC/O/14069,3/16/2020 7:07:31 AM,Other,807,75,167,11,1060,0,0,0,0,0
67,oPt,2019,OPT-19/DDA-3482/SA2/HNC/O/14069,3/16/2020 7:07:31 AM,Overall,807,75,167,11,1060,0,0,0,0,0
67,oPt,2019,OPT-19/DDA-3482/SA2/HNC/UN/13944,12/31/2020 9:44:13 AM,Host Communities,200,18076,11840,11060,41176,192,93449,395,528,94564
67,oPt,2019,OPT-19/DDA-3482/SA2/HNC/UN/13944,12/31/2020 9:44:13 AM,Overall,600,76889,11990,12340,101819,565,274851,1163,1554,278133
67,oPt,2019,OPT-19/DDA-3482/SA2/HNC/UN/13944,12/31/2020 9:44:13 AM,Refugees,400,58813,150,1280,60643,373,181402,768,1026,183569
67,oPt,2019,OPT-19/DDA-3482/SA2/PROT/INGO/13960,6/14/2021 12:16:11 PM,Host Communities,289,612,1375,1325,3601,563,936,2215,2308,6022
67,oPt,2019,OPT-19/DDA-3482/SA2/PROT/INGO/13960,6/14/2021 12:16:11 PM,Overall,289,612,1375,1325,3601,563,936,2215,2308,6022
67,oPt,2019,OPT-19/DDA-3482/SA2/PROT/NGO/14008,11/19/2020 10:49:57 AM,Other,721,312,297,161,1491,437,217,180,99,933
67,oPt,2019,OPT-19/DDA-3482/SA2/PROT/NGO/14008,11/19/2020 10:49:57 AM,Overall,3714,1454,1483,801,7452,1765,750,979,452,3946
67,oPt,2019,OPT-19/DDA-3482/SA2/PROT/NGO/14008,11/19/2020 10:49:57 AM,Refugees,2993,1142,1186,640,5961,1328,533,799,353,3013
67,oPt,2019,OPT-19/DDA-3482/SA2/PROT/NGO/14051,11/24/2020 12:25:54 PM,Host Communities,35,35,25,35,130,64,81,28,25,198
67,oPt,2019,OPT-19/DDA-3482/SA2/PROT/NGO/14051,11/24/2020 12:25:54 PM,Internally Displaced People,65,65,42,65,237,155,257,64,97,573
67,oPt,2019,OPT-19/DDA-3482/SA2/PROT/NGO/14051,11/24/2020 12:25:54 PM,Other,298,1874,12,810,2994,489,2522,114,481,3606
67,oPt,2019,OPT-19/DDA-3482/SA2/PROT/NGO/14051,11/24/2020 12:25:54 PM,Overall,976,4128,240,2000,7344,1109,4737,337,1005,7188
67,oPt,2019,OPT-19/DDA-3482/SA2/PROT/NGO/14051,11/24/2020 12:25:54 PM,Refugees,488,2064,110,1000,3662,316,1767,92,378,2553
67,oPt,2019,OPT-19/DDA-3482/SA2/PROT/NGO/14051,11/24/2020 12:25:54 PM,Returnees,90,90,51,90,321,85,110,39,24,258
67,oPt,2019,OPT-19/DDA-3482/SA2/PROT-EDU/INGO/14056,1/19/2021 8:07:13 AM,Host Communities,992,1403,5840,4576,12811,1445,2264,8733,6647,19089
67,oPt,2019,OPT-19/DDA-3482/SA2/PROT-EDU/INGO/14056,1/19/2021 8:07:13 AM,Overall,992,1403,5840,4576,12811,1445,2264,8733,6647,19089
67,oPt,2019,OPT-19/DDA-3482/SA2/PROT-EDU-FSL/INGO/14012,3/16/2021 8:55:30 AM,Other,1038,1080,1077,691,3886,1371,1597,1541,1121,5630
67,oPt,2019,OPT-19/DDA-3482/SA2/PROT-EDU-FSL/INGO/14012,3/16/2021 8:55:30 AM,Overall,2598,2700,2788,1858,9944,3108,3627,3967,2704,13406
67,oPt,2019,OPT-19/DDA-3482/SA2/PROT-EDU-FSL/INGO/14012,3/16/2021 8:55:30 AM,Refugees,1560,1620,1711,1167,6058,1737,2030,2426,1583,7776
67,oPt,2019,OPT-19/DDA-3482/SA2/SNFI/INGO/13938,10/14/2020 12:13:25 PM,Other,866,830,793,762,3251,985,847,629,712,3173
67,oPt,2019,OPT-19/DDA-3482/SA2/SNFI/INGO/13938,10/14/2020 12:13:25 PM,Overall,866,830,793,762,3251,985,847,629,712,3173
67,oPt,2019,OPT-19/DDA-3482/SA2/SNFI/INGO/13952,8/30/2020 7:46:12 AM,Other,901,870,806,783,3360,913,883,818,794,3408
67,oPt,2019,OPT-19/DDA-3482/SA2/SNFI/INGO/13952,8/30/2020 7:46:12 AM,Overall,901,870,806,783,3360,913,883,818,794,3408
67,oPt,2019,OPT-19/DDA-3482/SA2/SNFI/INGO/13963,1/21/2021 7:13:53 AM,Other,114,119,74,76,383,122,124,78,79,403
67,oPt,2019,OPT-19/DDA-3482/SA2/SNFI/INGO/13963,1/21/2021 7:13:53 AM,Overall,114,119,74,76,383,122,124,78,79,403
67,oPt,2019,OPT-19/DDA-3482/SA2/SNFI/INGO/13995,9/15/2020 9:39:21 AM,Other,604,581,679,656,2520,1020,984,852,810,3666
67,oPt,2019,OPT-19/DDA-3482/SA2/SNFI/INGO/13995,9/15/2020 9:39:21 AM,Overall,604,581,679,656,2520,1020,984,852,810,3666
67,oPt,2019,OPT-19/DDA-3482/SA2/SNFI/INGO/14061,7/7/2020 6:35:17 AM,Other,108,430,508,618,1664,213,355,325,279,1172
67,oPt,2019,OPT-19/DDA-3482/SA2/SNFI/INGO/14061,7/7/2020 6:35:17 AM,Overall,176,716,882,1024,2798,516,858,668,649,2691
67,oPt,2019,OPT-19/DDA-3482/SA2/SNFI/INGO/14061,7/7/2020 6:35:17 AM,Refugees,68,286,374,406,1134,303,503,343,370,1519
67,oPt,2019,OPT-19/DDA-3482/SA2/SNFI/INGO/14092,10/20/2020 9:54:54 AM,Other,190,238,236,176,840,247,228,197,167,839
67,oPt,2019,OPT-19/DDA-3482/SA2/SNFI/INGO/14092,10/20/2020 9:54:54 AM,Overall,190,238,236,176,840,247,228,197,167,839
67,oPt,2019,OPT-19/DDA-3482/SA2/SNFI-FSL-WASH/INGO/14025,6/25/2020 6:55:50 AM,Other,109,101,105,105,420,125,106,114,81,426
67,oPt,2019,OPT-19/DDA-3482/SA2/SNFI-FSL-WASH/INGO/14025,6/25/2020 6:55:50 AM,Overall,109,101,105,105,420,125,106,114,81,426
67,oPt,2019,OPT-19/DDA-3482/SA2/WASH/INGO/13936,3/15/2021 6:10:28 AM,Other,28373,27198,26024,25065,106660,38104,35307,33892,33866,141169
67,oPt,2019,OPT-19/DDA-3482/SA2/WASH/INGO/13936,3/15/2021 6:10:28 AM,Overall,28373,27198,26024,25065,106660,38104,35307,33892,33866,141169
67,oPt,2019,OPT-19/DDA-3482/SA2/WASH/INGO/13937,3/15/2021 7:35:13 AM,Host Communities,361,354,243,302,1260,356,348,236,297,1237
67,oPt,2019,OPT-19/DDA-3482/SA2/WASH/INGO/13937,3/15/2021 7:35:13 AM,Other,3199,1387,0,0,4586,3199,1387,0,0,4586
67,oPt,2019,OPT-19/DDA-3482/SA2/WASH/INGO/13937,3/15/2021 7:35:13 AM,Overall,3560,1741,243,302,5846,3555,1735,236,297,5823
67,oPt,2019,OPT-19/DDA-3482/SA2/WASH/INGO/13964,3/3/2021 7:21:02 AM,Other,1235,1196,1115,1071,4617,1234,1196,1126,1078,4634
67,oPt,2019,OPT-19/DDA-3482/SA2/WASH/INGO/13964,3/3/2021 7:21:02 AM,Overall,1235,1196,1115,1071,4617,1234,1196,1126,1078,4634
67,oPt,2019,OPT-19/DDA-3482/SA2/WASH/INGO/13980,1/18/2021 6:58:54 AM,Other,543,499,586,542,2170,600,581,557,500,2238
67,oPt,2019,OPT-19/DDA-3482/SA2/WASH/INGO/13980,1/18/2021 6:58:54 AM,Overall,543,499,586,542,2170,600,581,557,500,2238
67,oPt,2019,OPT-19/DDA-3482/SA2/WASH/INGO/14106,11/2/2020 8:13:04 AM,Internally Displaced People,96,94,110,115,415,96,94,110,115,415
67,oPt,2019,OPT-19/DDA-3482/SA2/WASH/INGO/14106,11/2/2020 8:13:04 AM,Other,3816,3744,4558,4354,16472,3816,3744,4558,4354,16472
67,oPt,2019,OPT-19/DDA-3482/SA2/WASH/INGO/14106,11/2/2020 8:13:04 AM,Overall,11576,11354,13811,13222,49963,11576,11354,13811,13222,49963
67,oPt,2019,OPT-19/DDA-3482/SA2/WASH/INGO/14106,11/2/2020 8:13:04 AM,Refugees,7664,7516,9143,8753,33076,7664,7516,9143,8753,33076
67,oPt,2019,OPT-19/DDA-3482/SA2/WASH/NGO/14057,10/22/2020 6:30:39 AM,Host Communities,1489,1475,1166,1168,5298,1489,1475,1166,1168,5298
67,oPt,2019,OPT-19/DDA-3482/SA2/WASH/NGO/14057,10/22/2020 6:30:39 AM,Overall,1489,1475,1166,1168,5298,1489,1475,1166,1168,5298
67,oPt,2019,OPT-19/DDA-3482/SA2/WASH/NGO/14075,4/21/2021 10:46:54 AM,Host Communities,1498,1328,1254,1304,5384,1498,1328,1254,1304,5384
67,oPt,2019,OPT-19/DDA-3482/SA2/WASH/NGO/14075,4/21/2021 10:46:54 AM,Overall,1498,1328,1254,1304,5384,1498,1328,1254,1304,5384
67,oPt,2020,OPT-20/DDA-3482/2RA/HNC/UN/15523,1/4/2021 12:40:00 PM,Host Communities,396,393,364,347,1500,16166,15796,13404,12750,58116
67,oPt,2020,OPT-20/DDA-3482/2RA/HNC/UN/15523,1/4/2021 12:40:00 PM,Overall,1311,1310,1213,1166,5000,53888,52654,44681,42499,193722
67,oPt,2020,OPT-20/DDA-3482/2RA/HNC/UN/15523,1/4/2021 12:40:00 PM,Refugees,915,917,849,819,3500,37722,36858,31277,29749,135606
67,oPt,2020,OPT-20/DDA-3482/RA1/HNC/NGO/14957,2/28/2021 8:20:35 AM,Host Communities,0,2670,3110,3055,8835,0,2862,2897,2906,8665
67,oPt,2020,OPT-20/DDA-3482/RA1/HNC/NGO/14957,2/28/2021 8:20:35 AM,Overall,0,4000,5100,4900,14000,0,4256,4779,4623,13658
67,oPt,2020,OPT-20/DDA-3482/RA1/HNC/NGO/14957,2/28/2021 8:20:35 AM,Refugees,0,1330,1990,1845,5165,0,1394,1882,1717,4993
67,oPt,2020,OPT-20/DDA-3482/RA1/SNFI/INGO/14958,11/4/2020 9:07:38 AM,Other,798,519,219,459,1995,598,669,405,424,2096
67,oPt,2020,OPT-20/DDA-3482/RA1/SNFI/INGO/14958,11/4/2020 9:07:38 AM,Overall,798,519,219,459,1995,598,669,405,424,2096
67,oPt,2020,OPT-20/DDA-3482/RA1/SNFI/INGO/14962,1/26/2021 12:26:23 PM,Other,120,220,180,170,690,209,334,233,211,987
67,oPt,2020,OPT-20/DDA-3482/RA1/SNFI/INGO/14962,1/26/2021 12:26:23 PM,Overall,380,740,610,550,2280,457,740,510,494,2201
67,oPt,2020,OPT-20/DDA-3482/RA1/SNFI/INGO/14962,1/26/2021 12:26:23 PM,Refugees,260,520,430,380,1590,248,406,277,283,1214
67,oPt,2020,OPT-20/DDA-3482/RA1/WASH/INGO/14951,10/1/2020 6:25:13 AM,Host Communities,1820,1820,1680,1680,7000,1820,1820,1680,1680,7000
67,oPt,2020,OPT-20/DDA-3482/RA1/WASH/INGO/14951,10/1/2020 6:25:13 AM,Overall,1820,1820,1680,1680,7000,1820,1820,1680,1680,7000
67,oPt,2020,OPT-20/DDA-3482/RA1/WASH/INGO/14956,11/2/2020 7:55:19 AM,Other,577527,567288,464890,438266,2047971,577527,567288,464890,438266,2047971
67,oPt,2020,OPT-20/DDA-3482/RA1/WASH/INGO/14956,11/2/2020 7:55:19 AM,Overall,577527,567288,464890,438266,2047971,577527,567288,464890,438266,2047971
67,oPt,2020,OPT-20/DDA-3482/RA1/WASH/INGO/14960,4/28/2021 7:34:39 AM,Host Communities,14580,14194,13171,12655,54600,14580,14194,13171,12655,54600
67,oPt,2020,OPT-20/DDA-3482/RA1/WASH/INGO/14960,4/28/2021 7:34:39 AM,Overall,18693,18197,16886,16224,70000,18693,18197,16886,16224,70000
67,oPt,2020,OPT-20/DDA-3482/RA1/WASH/INGO/14960,4/28/2021 7:34:39 AM,Refugees,4113,4003,3715,3569,15400,4113,4003,3715,3569,15400
67,oPt,2020,OPT-20/DDA-3482/RA3/HNC/INGO/15718,8/27/2020 12:39:39 PM,Other,35555,43184,2246,2744,83729,35555,43185,2246,2744,83730
67,oPt,2020,OPT-20/DDA-3482/RA3/HNC/INGO/15718,8/27/2020 12:39:39 PM,Overall,35555,43184,2246,2744,83729,35555,43185,2246,2744,83730
67,oPt,2020,OPT-20/DDA-3482/RA3/HNC/UN/15717,10/6/2020 8:22:24 AM,Host Communities,793,786,727,694,3000,1470,1304,239,212,3225
67,oPt,2020,OPT-20/DDA-3482/RA3/HNC/UN/15717,10/6/2020 8:22:24 AM,Overall,2642,2619,2427,2312,10000,4901,4346,798,707,10752
67,oPt,2020,OPT-20/DDA-3482/RA3/HNC/UN/15717,10/6/2020 8:22:24 AM,Refugees,1849,1833,1700,1618,7000,3431,3042,559,495,7527
67,oPt,2020,OPT-20/DDA-3482/RA3/HNC/UN/15720,2/1/2021 8:05:20 AM,Host Communities,23638,24465,113,94,48310,33283,40675,326,266,74550
67,oPt,2020,OPT-20/DDA-3482/RA3/HNC/UN/15720,2/1/2021 8:05:20 AM,Overall,23638,24465,113,94,48310,33283,40675,326,266,74550
67,oPt,2020,OPT-20/DDA-3482/RA3/HNC-WASH/UN/15721,3/14/2021 6:56:34 AM,Host Communities,94370,84546,32084,31475,242475,371696,342831,289094,278158,1281779
67,oPt,2020,OPT-20/DDA-3482/RA3/HNC-WASH/UN/15721,3/14/2021 6:56:34 AM,Overall,94370,84546,32084,31475,242475,371696,342831,289094,278158,1281779
67,oPt,2020,OPT-20/DDA-3482/RA3/PROT/UN/15725,1/31/2021 10:54:56 AM,Host Communities,732,2137,210,1403,4482,368,2099,667,2907,6041
67,oPt,2020,OPT-20/DDA-3482/RA3/PROT/UN/15725,1/31/2021 10:54:56 AM,Other,11,348,0,0,359,17,358,0,0,375
67,oPt,2020,OPT-20/DDA-3482/RA3/PROT/UN/15725,1/31/2021 10:54:56 AM,Overall,2045,6450,693,4675,13863,1055,5993,1852,8074,16974
67,oPt,2020,OPT-20/DDA-3482/RA3/PROT/UN/15725,1/31/2021 10:54:56 AM,Refugees,1302,3965,483,3272,9022,670,3536,1185,5167,10558
67,oPt,2020,OPT-20/DDA-3482/RA3/SNFI/INGO/15719,1/17/2021 7:17:33 AM,Host Communities,6983,4676,2126,4079,17864,8697,5798,2676,5129,22300
67,oPt,2020,OPT-20/DDA-3482/RA3/SNFI/INGO/15719,1/17/2021 7:17:33 AM,Overall,6983,4676,2126,4079,17864,8697,5798,2676,5129,22300
67,oPt,2020,OPT-20/DDA-3482/RA3/SNFI/INGO/15726,2/12/2021 8:41:00 AM,Other,2439,2514,1944,1901,8798,2439,2514,1944,1901,8798
67,oPt,2020,OPT-20/DDA-3482/RA3/SNFI/INGO/15726,2/12/2021 8:41:00 AM,Overall,2439,2514,1944,1901,8798,2439,2514,1944,1901,8798
67,oPt,2020,OPT-20/DDA-3482/RA3/SNFI/NGO/15724,3/1/2021 12:14:52 PM,Other,7441,5140,2477,2478,17536,17950,13311,3945,3447,38653
67,oPt,2020,OPT-20/DDA-3482/RA3/SNFI/NGO/15724,3/1/2021 12:14:52 PM,Overall,7441,5140,2477,2478,17536,17950,13311,3945,3447,38653
67,oPt,2020,OPT-20/DDA-3482/RA3/WASH/INGO/15723,10/1/2020 8:48:18 AM,Other,1551186,1492130,0,0,3043316,575874,558483,0,0,1134357
67,oPt,2020,OPT-20/DDA-3482/RA3/WASH/INGO/15723,10/1/2020 8:48:18 AM,Overall,1551186,1492130,0,0,3043316,575874,558483,0,0,1134357
67,oPt,2020,OPT-20/DDA-3482/RA3/WASH/UN/15722,5/25/2021 10:56:09 AM,Other,622992,605790,415327,403860,2047969,622992,605790,415327,403860,2047969
67,oPt,2020,OPT-20/DDA-3482/RA3/WASH/UN/15722,5/25/2021 10:56:09 AM,Overall,622992,605790,415327,403860,2047969,622992,605790,415327,403860,2047969
67,oPt,2020,OPT-20/DDA-3482/RA4/PROT/UN/17117,2/5/2023 10:34:02 AM,Other,500,500,0,0,1000,63,63,0,0,126
67,oPt,2020,OPT-20/DDA-3482/RA4/PROT/UN/17117,2/5/2023 10:34:02 AM,Overall,500,500,0,0,1000,63,63,0,0,126
67,oPt,2020,OPT-20/DDA-3482/SA1/FSL/INGO/15225,7/29/2021 10:22:26 AM,Other,869,840,778,756,3243,1108,1133,956,911,4108
67,oPt,2020,OPT-20/DDA-3482/SA1/FSL/INGO/15225,7/29/2021 10:22:26 AM,Overall,869,840,778,756,3243,1108,1133,956,911,4108
67,oPt,2020,OPT-20/DDA-3482/SA1/FSL/INGO/15309,5/3/2021 1:10:25 PM,Other,598,578,321,310,1807,682,690,623,701,2696
67,oPt,2020,OPT-20/DDA-3482/SA1/FSL/INGO/15309,5/3/2021 1:10:25 PM,Overall,598,578,321,310,1807,682,690,623,701,2696
67,oPt,2020,OPT-20/DDA-3482/SA1/FSL/INGO/15472,5/25/2021 11:03:05 AM,Other,2910,2869,2453,2347,10579,3035,3075,1978,1887,9975
67,oPt,2020,OPT-20/DDA-3482/SA1/FSL/INGO/15472,5/25/2021 11:03:05 AM,Overall,2910,2869,2453,2347,10579,3035,3075,1978,1887,9975
67,oPt,2020,OPT-20/DDA-3482/SA1/FSL/INGO/15567,2/19/2021 1:11:51 PM,Other,422,409,228,220,1279,619,596,341,347,1903
67,oPt,2020,OPT-20/DDA-3482/SA1/FSL/INGO/15567,2/19/2021 1:11:51 PM,Overall,422,409,228,220,1279,619,596,341,347,1903
67,oPt,2020,OPT-20/DDA-3482/SA1/FSL/NGO/15466,4/12/2021 9:20:04 AM,Host Communities,233,224,193,184,834,413,324,255,188,1180
67,oPt,2020,OPT-20/DDA-3482/SA1/FSL/NGO/15466,4/12/2021 9:20:04 AM,Overall,233,224,193,184,834,413,324,255,188,1180
67,oPt,2020,OPT-20/DDA-3482/SA1/HNC/INGO/15247,7/25/2021 7:41:34 AM,Other,177,177,58,58,470,145,97,163,129,534
67,oPt,2020,OPT-20/DDA-3482/SA1/HNC/INGO/15247,7/25/2021 7:41:34 AM,Overall,514,514,176,176,1380,358,254,436,332,1380
67,oPt,2020,OPT-20/DDA-3482/SA1/HNC/INGO/15247,7/25/2021 7:41:34 AM,Refugees,337,337,118,118,910,213,157,273,203,846
67,oPt,2020,OPT-20/DDA-3482/SA1/HNC/NGO/15422,10/31/2021 11:54:04 AM,Other,80,60,95,60,295,79,35,112,69,295
67,oPt,2020,OPT-20/DDA-3482/SA1/HNC/NGO/15422,10/31/2021 11:54:04 AM,Overall,400,300,474,300,1474,395,179,555,345,1474
67,oPt,2020,OPT-20/DDA-3482/SA1/HNC/NGO/15422,10/31/2021 11:54:04 AM,Refugees,320,240,379,240,1179,316,144,443,276,1179
67,oPt,2020,OPT-20/DDA-3482/SA1/HNC/NGO/15476,11/10/2021 11:13:56 AM,Host Communities,600,2230,816,340,3986,1047,6350,1112,876,9385
67,oPt,2020,OPT-20/DDA-3482/SA1/HNC/NGO/15476,11/10/2021 11:13:56 AM,Overall,600,2230,816,340,3986,1047,6350,1112,876,9385
67,oPt,2020,OPT-20/DDA-3482/SA1/HNC/NGO/15501,10/6/2021 6:31:13 AM,Host Communities,2000,3000,1000,1000,7000,2600,3843,1181,974,8598
67,oPt,2020,OPT-20/DDA-3482/SA1/HNC/NGO/15501,10/6/2021 6:31:13 AM,Overall,2000,3000,1000,1000,7000,2600,3843,1181,974,8598
67,oPt,2020,OPT-20/DDA-3482/SA1/HNC/UN/15337,7/27/2021 9:53:56 AM,Host Communities,100,1000,250,250,1600,330,356,477,477,1640
67,oPt,2020,OPT-20/DDA-3482/SA1/HNC/UN/15337,7/27/2021 9:53:56 AM,Overall,100,1000,250,250,1600,330,356,477,477,1640
67,oPt,2020,OPT-20/DDA-3482/SA1/PROT/NGO/15303,5/2/2021 10:13:48 AM,Host Communities,15,15,15,15,60,0,0,0,0,0
67,oPt,2020,OPT-20/DDA-3482/SA1/PROT/NGO/15303,5/2/2021 10:13:48 AM,Internally Displaced People,30,30,30,30,120,0,7,0,1,8
67,oPt,2020,OPT-20/DDA-3482/SA1/PROT/NGO/15303,5/2/2021 10:13:48 AM,Other,69,3058,55,2075,5257,80,1000,37,300,1417
67,oPt,2020,OPT-20/DDA-3482/SA1/PROT/NGO/15303,5/2/2021 10:13:48 AM,Overall,309,6283,190,2930,9712,280,3578,89,807,4754
67,oPt,2020,OPT-20/DDA-3482/SA1/PROT/NGO/15303,5/2/2021 10:13:48 AM,Refugees,150,3135,45,765,4095,200,2558,52,496,3306
67,oPt,2020,OPT-20/DDA-3482/SA1/PROT/NGO/15303,5/2/2021 10:13:48 AM,Returnees,45,45,45,45,180,0,13,0,10,23
67,oPt,2020,OPT-20/DDA-3482/SA1/PROT/NGO/15549,3/10/2022 11:09:13 AM,Other,1,815,100,160,1076,1,639,87,175,902
67,oPt,2020,OPT-20/DDA-3482/SA1/PROT/NGO/15549,3/10/2022 11:09:13 AM,Overall,1,815,100,160,1076,1,639,87,175,902
67,oPt,2020,OPT-20/DDA-3482/SA1/PROT/NGO/15572,11/21/2021 11:14:39 AM,Other,2048,9968,2048,4244,18308,3111,11410,2987,8385,25893
67,oPt,2020,OPT-20/DDA-3482/SA1/PROT/NGO/15572,11/21/2021 11:14:39 AM,Overall,2560,12460,2560,5305,22885,3889,14263,3734,10481,32367
67,oPt,2020,OPT-20/DDA-3482/SA1/PROT/NGO/15572,11/21/2021 11:14:39 AM,Refugees,512,2492,512,1061,4577,778,2853,747,2096,6474
67,oPt,2020,OPT-20/DDA-3482/SA1/PROT-HNC/NGO/15250,7/29/2021 9:49:40 AM,Other,252,108,37,17,414,246,248,101,77,672
67,oPt,2020,OPT-20/DDA-3482/SA1/PROT-HNC/NGO/15250,7/29/2021 9:49:40 AM,Overall,834,468,356,142,1800,798,796,362,218,2174
67,oPt,2020,OPT-20/DDA-3482/SA1/PROT-HNC/NGO/15250,7/29/2021 9:49:40 AM,Refugees,582,360,319,125,1386,552,548,261,141,1502
67,oPt,2020,OPT-20/DDA-3482/SA1/SNFI/INGO/15130,6/16/2021 9:17:09 AM,Other,177,155,213,189,734,181,161,218,194,754
67,oPt,2020,OPT-20/DDA-3482/SA1/SNFI/INGO/15130,6/16/2021 9:17:09 AM,Overall,177,155,213,189,734,181,161,218,194,754
67,oPt,2020,OPT-20/DDA-3482/SA1/SNFI/INGO/15324,4/1/2021 8:46:03 AM,Host Communities,80,94,115,116,405,95,95,121,100,411
67,oPt,2020,OPT-20/DDA-3482/SA1/SNFI/INGO/15324,4/1/2021 8:46:03 AM,Overall,80,94,115,116,405,95,95,121,100,411
67,oPt,2020,OPT-20/DDA-3482/SA1/WASH/INGO/15209,4/21/2021 11:02:58 AM,Other,3042,2028,936,1794,7800,3805,3949,3579,3806,15139
67,oPt,2020,OPT-20/DDA-3482/SA1/WASH/INGO/15209,4/21/2021 11:02:58 AM,Overall,3042,2028,936,1794,7800,3805,3949,3579,3806,15139
67,oPt,2020,OPT-20/DDA-3482/SA1/WASH/INGO/15509,3/29/2021 10:22:46 AM,Other,577527,567288,464890,438266,2047971,577527,567288,464890,438266,2047971
67,oPt,2020,OPT-20/DDA-3482/SA1/WASH/INGO/15509,3/29/2021 10:22:46 AM,Overall,577527,567288,464890,438266,2047971,577527,567288,464890,438266,2047971
67,oPt,2020,OPT-20/DDA-3482/SA1/WASH/INGO/15540,6/8/2021 9:50:29 AM,Other,31240,32660,39760,38340,142000,31240,32660,39760,38340,142000
67,oPt,2020,OPT-20/DDA-3482/SA1/WASH/INGO/15540,6/8/2021 9:50:29 AM,Overall,31240,32660,39760,38340,142000,31240,32660,39760,38340,142000
67,oPt,2020,OPT-20/DDA-3482/SA1/WASH/NGO/15541,6/10/2021 11:53:47 AM,Other,44580,45834,47535,49051,187000,26701,27451,28470,29378,112000
67,oPt,2020,OPT-20/DDA-3482/SA1/WASH/NGO/15541,6/10/2021 11:53:47 AM,Overall,44580,45834,47535,49051,187000,26701,27451,28470,29378,112000
67,oPt,2020,OPT-20/DDA-3482/SA2FT/FSL/INGO/17259,10/31/2021 12:00:24 PM,Internally Displaced People,41,36,34,28,139,41,36,34,28,139
67,oPt,2020,OPT-20/DDA-3482/SA2FT/FSL/INGO/17259,10/31/2021 12:00:24 PM,Other,2379,2340,2383,2276,9378,1067,1145,1527,1434,5173
67,oPt,2020,OPT-20/DDA-3482/SA2FT/FSL/INGO/17259,10/31/2021 12:00:24 PM,Overall,8802,8694,8659,8159,34314,7701,7482,8672,8079,31934
67,oPt,2020,OPT-20/DDA-3482/SA2FT/FSL/INGO/17259,10/31/2021 12:00:24 PM,Refugees,6281,6218,6148,5767,24414,6496,6205,7019,6531,26251
67,oPt,2020,OPT-20/DDA-3482/SA2FT/FSL/INGO/17259,10/31/2021 12:00:24 PM,Returnees,101,100,94,88,383,97,96,92,86,371
67,oPt,2020,OPT-20/DDA-3482/SA2FT/FSL/INGO/17269,8/10/2021 6:47:05 AM,Other,2223,2223,1482,1482,7410,2154,1966,1966,1816,7902
67,oPt,2020,OPT-20/DDA-3482/SA2FT/FSL/INGO/17269,8/10/2021 6:47:05 AM,Overall,2223,2223,1482,1482,7410,2154,1966,1966,1816,7902
67,oPt,2020,OPT-20/DDA-3482/SA2FT/FSL/NGO/17277,12/14/2021 10:39:48 AM,Other,1077,1035,812,781,3705,1232,1214,980,915,4341
67,oPt,2020,OPT-20/DDA-3482/SA2FT/FSL/NGO/17277,12/14/2021 10:39:48 AM,Overall,1077,1035,812,781,3705,1232,1214,980,915,4341
67,oPt,2020,OPT-20/DDA-3482/SA2FT/FSL/UN/17266,12/13/2021 8:38:28 AM,Host Communities,19553,17838,16715,15135,69241,19470,12951,19372,13485,65278
67,oPt,2020,OPT-20/DDA-3482/SA2FT/FSL/UN/17266,12/13/2021 8:38:28 AM,Overall,19553,17838,16715,15135,69241,19470,12951,19372,13485,65278
67,oPt,2020,OPT-20/DDA-3482/SA2FT/HNC/INGO/17248,5/10/2021 5:59:27 AM,Other,14429,14498,4520,4599,38046,14429,14498,4520,4599,38046
67,oPt,2020,OPT-20/DDA-3482/SA2FT/HNC/INGO/17248,5/10/2021 5:59:27 AM,Overall,14429,14498,4520,4599,38046,14429,14498,4520,4599,38046
67,oPt,2020,OPT-20/DDA-3482/SA2FT/HNC/INGO/17267,9/6/2021 5:42:55 AM,Other,19925,19609,10997,10629,61160,20829,19302,11122,10685,61938
67,oPt,2020,OPT-20/DDA-3482/SA2FT/HNC/INGO/17267,9/6/2021 5:42:55 AM,Overall,19925,19609,10997,10629,61160,20829,19302,11122,10685,61938
67,oPt,2020,OPT-20/DDA-3482/SA2FT/HNC/NGO/17236,9/2/2021 8:28:41 AM,Other,420,380,120,80,1000,543,531,49,46,1169
67,oPt,2020,OPT-20/DDA-3482/SA2FT/HNC/NGO/17236,9/2/2021 8:28:41 AM,Overall,2100,1900,600,400,5000,2715,2657,238,232,5842
67,oPt,2020,OPT-20/DDA-3482/SA2FT/HNC/NGO/17236,9/2/2021 8:28:41 AM,Refugees,1680,1520,480,320,4000,2172,2126,189,186,4673
67,oPt,2020,OPT-20/DDA-3482/SA2FT/HNC/NGO/17270,10/10/2021 6:55:09 AM,Host Communities,1500,1400,2200,1500,6600,3902,4209,1334,1325,10770
67,oPt,2020,OPT-20/DDA-3482/SA2FT/HNC/NGO/17270,10/10/2021 6:55:09 AM,Overall,3500,3200,4700,3600,15000,7551,8490,2706,2740,21487
67,oPt,2020,OPT-20/DDA-3482/SA2FT/HNC/NGO/17270,10/10/2021 6:55:09 AM,Refugees,2000,1800,2500,2100,8400,3649,4281,1372,1415,10717
67,oPt,2020,OPT-20/DDA-3482/SA2FT/HNC/NGO/17331,10/12/2021 12:38:23 PM,Other,6000,4000,0,0,10000,4950,5150,0,0,10100
67,oPt,2020,OPT-20/DDA-3482/SA2FT/HNC/NGO/17331,10/12/2021 12:38:23 PM,Overall,6000,4000,0,0,10000,4950,5150,0,0,10100
67,oPt,2020,OPT-20/DDA-3482/SA2FT/HNC/UN/17253,7/4/2021 1:33:04 PM,Host Communities,45281,44888,41596,39625,171390,117484,105562,73779,70263,367088
67,oPt,2020,OPT-20/DDA-3482/SA2FT/HNC/UN/17253,7/4/2021 1:33:04 PM,Overall,150937,149625,138654,132084,571300,287933,260675,186962,178058,913628
67,oPt,2020,OPT-20/DDA-3482/SA2FT/HNC/UN/17253,7/4/2021 1:33:04 PM,Refugees,105656,104737,97058,92459,399910,170449,155113,113183,107795,546540
67,oPt,2020,OPT-20/DDA-3482/SA2FT/WASH/INGO/17233,8/15/2021 10:13:40 AM,Other,9671,8260,6644,6425,31000,10094,8018,5272,5042,28426
67,oPt,2020,OPT-20/DDA-3482/SA2FT/WASH/INGO/17233,8/15/2021 10:13:40 AM,Overall,9671,8260,6644,6425,31000,10094,8018,5272,5042,28426
67,oPt,2020,OPT-20/DDA-3482/SA2FT/WASH/INGO/17261,11/9/2021 1:34:32 PM,Other,12203,12429,13871,13597,52100,52000,53200,59000,58000,222200
67,oPt,2020,OPT-20/DDA-3482/SA2FT/WASH/INGO/17261,11/9/2021 1:34:32 PM,Overall,12203,12429,13871,13597,52100,52000,53200,59000,58000,222200
67,oPt,2020,OPT-20/DDA-3482/SA2FT/WASH/INGO/17274,11/21/2021 11:20:58 AM,Other,265006,245378,235561,235561,981506,265006,245378,235561,235561,981506
67,oPt,2020,OPT-20/DDA-3482/SA2FT/WASH/INGO/17274,11/21/2021 11:20:58 AM,Overall,265006,245378,235561,235561,981506,265006,245378,235561,235561,981506
67,oPt,2020,OPT-20/DDA-3482/SA2FT/WASH/INGO/17373,10/20/2021 5:20:17 AM,Other,1943,1286,582,1151,4962,3669,2429,1099,2174,9371
67,oPt,2020,OPT-20/DDA-3482/SA2FT/WASH/INGO/17373,10/20/2021 5:20:17 AM,Overall,1943,1286,582,1151,4962,3669,2429,1099,2174,9371
67,oPt,2020,OPT-20/DDA-3482/SA2NT/EDU/INGO/17425,1/16/2022 7:01:04 AM,Other,34,52,924,1851,2861,39,52,925,1851,2867
67,oPt,2020,OPT-20/DDA-3482/SA2NT/EDU/INGO/17425,1/16/2022 7:01:04 AM,Overall,34,52,924,1851,2861,39,52,925,1851,2867
67,oPt,2020,OPT-20/DDA-3482/SA2NT/EDU/UN/17431,6/6/2022 12:21:50 PM,Overall,9,11,1175,1195,2390,9,11,1175,1195,2390
67,oPt,2020,OPT-20/DDA-3482/SA2NT/EDU/UN/17431,6/6/2022 12:21:50 PM,Refugees,9,11,1175,1195,2390,9,11,1175,1195,2390
67,oPt,2020,OPT-20/DDA-3482/SA2NT/EDU/UN/17440,3/21/2022 9:33:27 AM,Host Communities,0,0,200,200,400,90,624,200,286,1200
67,oPt,2020,OPT-20/DDA-3482/SA2NT/EDU/UN/17440,3/21/2022 9:33:27 AM,Overall,0,0,200,200,400,90,624,200,286,1200
67,oPt,2020,OPT-20/DDA-3482/SA2NT/FSL/INGO/17292,11/21/2021 11:17:35 AM,Other,479,463,257,248,1447,454,474,481,408,1817
67,oPt,2020,OPT-20/DDA-3482/SA2NT/FSL/INGO/17292,11/21/2021 11:17:35 AM,Overall,479,463,257,248,1447,454,474,481,408,1817
67,oPt,2020,OPT-20/DDA-3482/SA2NT/FSL/INGO/17439,12/14/2021 10:35:47 AM,Other,216,192,161,172,741,232,233,266,269,1000
67,oPt,2020,OPT-20/DDA-3482/SA2NT/FSL/INGO/17439,12/14/2021 10:35:47 AM,Overall,216,192,161,172,741,232,233,266,269,1000
67,oPt,2020,OPT-20/DDA-3482/SA2NT/FSL/INGO/17520,10/7/2021 10:36:21 AM,Other,331,297,197,197,1022,372,324,227,227,1150
67,oPt,2020,OPT-20/DDA-3482/SA2NT/FSL/INGO/17520,10/7/2021 10:36:21 AM,Overall,331,297,197,197,1022,372,324,227,227,1150
67,oPt,2020,OPT-20/DDA-3482/SA2NT/FSL/NGO/17242,11/10/2021 11:08:52 AM,Host Communities,1494,989,447,885,3815,1439,1460,1288,1225,5412
67,oPt,2020,OPT-20/DDA-3482/SA2NT/FSL/NGO/17242,11/10/2021 11:08:52 AM,Overall,1494,989,447,885,3815,1439,1460,1288,1225,5412
67,oPt,2020,OPT-20/DDA-3482/SA2NT/FSL/NGO/17457,10/14/2021 6:38:56 AM,Host Communities,613,612,498,486,2209,927,869,552,595,2943
67,oPt,2020,OPT-20/DDA-3482/SA2NT/FSL/NGO/17457,10/14/2021 6:38:56 AM,Overall,613,612,498,486,2209,927,869,552,595,2943
67,oPt,2020,OPT-20/DDA-3482/SA2NT/FSL/NGO/17462,11/22/2021 9:57:11 AM,Host Communities,511,506,400,400,1817,1182,1193,491,447,3313
67,oPt,2020,OPT-20/DDA-3482/SA2NT/FSL/NGO/17462,11/22/2021 9:57:11 AM,Overall,511,506,400,400,1817,1182,1193,491,447,3313
67,oPt,2020,OPT-20/DDA-3482/SA2NT/HNC/INGO/17418,1/30/2022 11:32:00 AM,Host Communities,170,150,5,5,330,200,164,35,16,415
67,oPt,2020,OPT-20/DDA-3482/SA2NT/HNC/INGO/17418,1/30/2022 11:32:00 AM,Overall,170,150,5,5,330,200,164,35,16,415
67,oPt,2020,OPT-20/DDA-3482/SA2NT/HNC/INGO/17422,3/21/2022 9:56:17 AM,Host Communities,2603,8411,4005,5006,20025,6291,14193,6921,7089,34494
67,oPt,2020,OPT-20/DDA-3482/SA2NT/HNC/INGO/17422,3/21/2022 9:56:17 AM,Overall,2603,8411,4005,5006,20025,6291,14193,6921,7089,34494
67,oPt,2020,OPT-20/DDA-3482/SA2NT/HNC/INGO/17466,1/31/2022 7:42:34 AM,Other,105,105,26,26,262,119,100,0,0,219
67,oPt,2020,OPT-20/DDA-3482/SA2NT/HNC/INGO/17466,1/31/2022 7:42:34 AM,Overall,150,150,37,37,374,200,205,0,2,407
67,oPt,2020,OPT-20/DDA-3482/SA2NT/HNC/INGO/17466,1/31/2022 7:42:34 AM,Refugees,45,45,11,11,112,81,105,0,2,188
67,oPt,2020,OPT-20/DDA-3482/SA2NT/HNC/NGO/17489,2/27/2022 12:51:35 PM,Other,45,41,41,39,166,74,40,31,22,167
67,oPt,2020,OPT-20/DDA-3482/SA2NT/HNC/NGO/17489,2/27/2022 12:51:35 PM,Overall,224,207,206,191,828,370,198,154,106,828
67,oPt,2020,OPT-20/DDA-3482/SA2NT/HNC/NGO/17489,2/27/2022 12:51:35 PM,Refugees,179,166,165,152,662,296,158,123,84,661
67,oPt,2020,OPT-20/DDA-3482/SA2NT/HNC/O/17484,11/14/2021 9:50:55 AM,Host Communities,94,86,79,72,331,111,55,260,81,507
67,oPt,2020,OPT-20/DDA-3482/SA2NT/HNC/O/17484,11/14/2021 9:50:55 AM,Overall,260,240,220,200,920,194,112,456,158,920
67,oPt,2020,OPT-20/DDA-3482/SA2NT/HNC/O/17484,11/14/2021 9:50:55 AM,Refugees,166,154,141,128,589,83,57,196,77,413
67,oPt,2020,OPT-20/DDA-3482/SA2NT/HNC/UN/17449,4/4/2022 11:05:15 AM,Host Communities,3339,6032,2154,2872,14397,2985,8688,2185,3450,17308
67,oPt,2020,OPT-20/DDA-3482/SA2NT/HNC/UN/17449,4/4/2022 11:05:15 AM,Overall,4468,8093,2890,3854,19305,2985,8688,2185,3450,17308
67,oPt,2020,OPT-20/DDA-3482/SA2NT/HNC/UN/17449,4/4/2022 11:05:15 AM,Refugees,1129,2061,736,982,4908,0,0,0,0,0
67,oPt,2020,OPT-20/DDA-3482/SA2NT/HNC/UN/17519,8/27/2021 6:30:34 AM,Overall,8955,8605,3606,3464,24630,2580,3427,1143,1107,8257
67,oPt,2020,OPT-20/DDA-3482/SA2NT/HNC/UN/17519,8/27/2021 6:30:34 AM,Refugees,8955,8605,3606,3464,24630,2580,3427,1143,1107,8257
67,oPt,2020,OPT-20/DDA-3482/SA2NT/PROT/INGO/17312,10/7/2021 11:34:18 AM,Other,1921,1879,1414,1286,6500,1545,1664,1304,1229,5742
67,oPt,2020,OPT-20/DDA-3482/SA2NT/PROT/INGO/17312,10/7/2021 11:34:18 AM,Overall,1921,1879,1414,1286,6500,1545,1664,1304,1229,5742
67,oPt,2020,OPT-20/DDA-3482/SA2NT/PROT/INGO/17316,4/25/2022 8:51:34 AM,Host Communities,751,1738,635,895,4019,1018,2131,1873,2095,7117
67,oPt,2020,OPT-20/DDA-3482/SA2NT/PROT/INGO/17316,4/25/2022 8:51:34 AM,Overall,751,1738,635,895,4019,1018,2131,1873,2095,7117
67,oPt,2020,OPT-20/DDA-3482/SA2NT/PROT/NGO/17366,1/19/2022 7:19:52 AM,Host Communities,18,218,18,18,272,6,10,6,8,30
67,oPt,2020,OPT-20/DDA-3482/SA2NT/PROT/NGO/17366,1/19/2022 7:19:52 AM,Internally Displaced People,36,36,36,36,144,12,17,12,17,58
67,oPt,2020,OPT-20/DDA-3482/SA2NT/PROT/NGO/17366,1/19/2022 7:19:52 AM,Other,126,1838,10,1174,3148,129,1760,19,613,2521
67,oPt,2020,OPT-20/DDA-3482/SA2NT/PROT/NGO/17366,1/19/2022 7:19:52 AM,Overall,495,5366,145,3109,9115,455,5597,99,1827,7978
67,oPt,2020,OPT-20/DDA-3482/SA2NT/PROT/NGO/17366,1/19/2022 7:19:52 AM,Refugees,297,3256,63,1863,5479,302,3802,56,1180,5340
67,oPt,2020,OPT-20/DDA-3482/SA2NT/PROT/NGO/17366,1/19/2022 7:19:52 AM,Returnees,18,18,18,18,72,6,8,6,9,29
67,oPt,2020,OPT-20/DDA-3482/SA2NT/PROT/NGO/17474,12/30/2021 8:57:24 AM,Host Communities,35,70,35,35,175,36,74,37,37,184
67,oPt,2020,OPT-20/DDA-3482/SA2NT/PROT/NGO/17474,12/30/2021 8:57:24 AM,Internally Displaced People,35,70,35,35,175,36,72,35,35,178
67,oPt,2020,OPT-20/DDA-3482/SA2NT/PROT/NGO/17474,12/30/2021 8:57:24 AM,Other,754,1406,700,720,3580,756,1406,703,724,3589
67,oPt,2020,OPT-20/DDA-3482/SA2NT/PROT/NGO/17474,12/30/2021 8:57:24 AM,Overall,2260,4606,1865,2035,10766,2266,4653,1880,2045,10844
67,oPt,2020,OPT-20/DDA-3482/SA2NT/PROT/NGO/17474,12/30/2021 8:57:24 AM,Refugees,1401,2930,1060,1170,6561,1402,2958,1068,1172,6600
67,oPt,2020,OPT-20/DDA-3482/SA2NT/PROT/NGO/17474,12/30/2021 8:57:24 AM,Returnees,35,130,35,75,275,36,143,37,77,293
67,oPt,2020,OPT-20/DDA-3482/SA2NT/PROT-EDU/INGO/17311,2/22/2022 7:31:25 AM,Other,846,1450,1106,1106,4508,987,1778,1294,1217,5276
67,oPt,2020,OPT-20/DDA-3482/SA2NT/PROT-EDU/INGO/17311,2/22/2022 7:31:25 AM,Overall,2115,3852,2830,2831,11628,2384,4379,3105,2898,12766
67,oPt,2020,OPT-20/DDA-3482/SA2NT/PROT-EDU/INGO/17311,2/22/2022 7:31:25 AM,Refugees,1269,2402,1724,1725,7120,1397,2601,1811,1681,7490
67,oPt,2020,OPT-20/DDA-3482/SA2NT/SNFI/INGO/17307,1/23/2022 6:41:31 AM,Other,400,375,419,411,1605,594,553,382,389,1918
67,oPt,2020,OPT-20/DDA-3482/SA2NT/SNFI/INGO/17307,1/23/2022 6:41:31 AM,Overall,400,375,419,411,1605,594,553,382,389,1918
67,oPt,2020,OPT-20/DDA-3482/SA2NT/SNFI/INGO/17403,10/31/2021 11:37:47 AM,Other,668,665,470,486,2289,646,691,513,492,2342
67,oPt,2020,OPT-20/DDA-3482/SA2NT/SNFI/INGO/17403,10/31/2021 11:37:47 AM,Overall,668,665,470,486,2289,646,691,513,492,2342
67,oPt,2020,OPT-20/DDA-3482/SA2NT/SNFI/INGO/17511,3/22/2023 9:08:37 AM,Host Communities,670,612,502,465,2249,670,612,502,465,2249
67,oPt,2020,OPT-20/DDA-3482/SA2NT/SNFI/INGO/17511,3/22/2023 9:08:37 AM,Internally Displaced People,6715,4439,2004,3942,17100,6715,4439,2004,3942,17100
67,oPt,2020,OPT-20/DDA-3482/SA2NT/SNFI/INGO/17511,3/22/2023 9:08:37 AM,Other,42,48,0,0,90,42,48,0,0,90
67,oPt,2020,OPT-20/DDA-3482/SA2NT/SNFI/INGO/17511,3/22/2023 9:08:37 AM,Overall,7427,5099,2506,4407,19439,7427,5099,2506,4407,19439
67,oPt,2020,OPT-20/DDA-3482/SA2NT/SNFI/INGO/17512,11/22/2021 2:14:55 PM,Other,526,522,515,491,2054,559,553,558,440,2110
67,oPt,2020,OPT-20/DDA-3482/SA2NT/SNFI/INGO/17512,11/22/2021 2:14:55 PM,Overall,526,522,515,491,2054,559,553,558,440,2110
67,oPt,2020,OPT-20/DDA-3482/SA2NT/SNFI/NGO/17491,5/10/2022 10:03:00 AM,Host Communities,124,120,116,113,473,124,120,116,113,473
67,oPt,2020,OPT-20/DDA-3482/SA2NT/SNFI/NGO/17491,5/10/2022 10:03:00 AM,Internally Displaced People,2456,2400,2036,1988,8880,2496,2439,2036,1988,8959
67,oPt,2020,OPT-20/DDA-3482/SA2NT/SNFI/NGO/17491,5/10/2022 10:03:00 AM,Overall,2580,2520,2152,2101,9353,2620,2559,2152,2101,9432
67,oPt,2021,OPT-21/DDA-3482/1SA/EDU/INGO/20948,6/15/2023 5:44:51 AM,Host Communities,87,345,640,960,2032,9,345,639,873,1866
67,oPt,2021,OPT-21/DDA-3482/1SA/EDU/INGO/20948,6/15/2023 5:44:51 AM,Overall,87,345,640,960,2032,9,345,639,873,1866
67,oPt,2021,OPT-21/DDA-3482/1SA/EDU/INGO/21037,7/18/2023 6:37:59 AM,Host Communities,60,84,92,66,302,48,223,414,394,1079
67,oPt,2021,OPT-21/DDA-3482/1SA/EDU/INGO/21037,7/18/2023 6:37:59 AM,Overall,60,84,92,66,302,48,223,414,394,1079
67,oPt,2021,OPT-21/DDA-3482/1SA/EDU/INGO/21062,7/27/2023 7:00:21 AM,Host Communities,137,136,762,455,1490,127,209,1055,729,2120
67,oPt,2021,OPT-21/DDA-3482/1SA/EDU/INGO/21062,7/27/2023 7:00:21 AM,Overall,154,212,844,493,1703,185,304,1155,761,2405
67,oPt,2021,OPT-21/DDA-3482/1SA/EDU/INGO/21062,7/27/2023 7:00:21 AM,Refugees,17,76,82,38,213,58,95,100,32,285
67,oPt,2021,OPT-21/DDA-3482/1SA/EDU/NGO/20966,5/3/2023 12:51:40 PM,Host Communities,150,200,550,600,1500,152,313,758,566,1789
67,oPt,2021,OPT-21/DDA-3482/1SA/EDU/NGO/20966,5/3/2023 12:51:40 PM,Overall,150,200,550,600,1500,152,313,758,566,1789
67,oPt,2021,OPT-21/DDA-3482/1SA/FSL/INGO/21053,5/7/2023 8:07:52 AM,Other,476,461,348,332,1617,649,542,413,402,2006
67,oPt,2021,OPT-21/DDA-3482/1SA/FSL/INGO/21053,5/7/2023 8:07:52 AM,Overall,476,461,348,332,1617,649,542,413,402,2006
67,oPt,2021,OPT-21/DDA-3482/1SA/FSL/NGO/20969,3/22/2023 9:28:21 AM,Host Communities,712,688,519,495,2414,2346,2068,1230,1189,6833
67,oPt,2021,OPT-21/DDA-3482/1SA/FSL/NGO/20969,3/22/2023 9:28:21 AM,Overall,712,688,519,495,2414,2346,2068,1230,1189,6833
67,oPt,2021,OPT-21/DDA-3482/1SA/HNC/INGO/20994,7/20/2022 5:23:46 AM,Other,214,336,0,0,550,365,572,0,0,937
67,oPt,2021,OPT-21/DDA-3482/1SA/HNC/INGO/20994,7/20/2022 5:23:46 AM,Overall,214,336,0,0,550,365,572,0,0,937
67,oPt,2021,OPT-21/DDA-3482/1SA/HNC/NGO/21009,2/21/2023 2:14:39 PM,Other,588,1540,308,364,2800,623,1630,220,282,2755
67,oPt,2021,OPT-21/DDA-3482/1SA/HNC/NGO/21009,2/21/2023 2:14:39 PM,Overall,1470,3850,770,910,7000,1558,4076,552,705,6891
67,oPt,2021,OPT-21/DDA-3482/1SA/HNC/NGO/21009,2/21/2023 2:14:39 PM,Refugees,882,2310,462,546,4200,935,2446,332,423,4136
67,oPt,2021,OPT-21/DDA-3482/1SA/PROT/INGO/21069,9/28/2023 6:17:06 AM,Other,912,904,880,880,3576,826,1880,1340,1612,5658
67,oPt,2021,OPT-21/DDA-3482/1SA/PROT/INGO/21069,9/28/2023 6:17:06 AM,Overall,1026,1018,990,990,4024,916,2079,1542,1798,6335
67,oPt,2021,OPT-21/DDA-3482/1SA/PROT/INGO/21069,9/28/2023 6:17:06 AM,Refugees,114,114,110,110,448,90,199,202,186,677
67,oPt,2021,OPT-21/DDA-3482/1SA/PROT/INGO/21072,6/25/2023 6:32:28 AM,Other,556,612,487,504,2159,481,591,542,622,2236
67,oPt,2021,OPT-21/DDA-3482/1SA/PROT/INGO/21072,6/25/2023 6:32:28 AM,Overall,1855,2040,1625,1680,7200,1613,1973,1811,2078,7475
67,oPt,2021,OPT-21/DDA-3482/1SA/PROT/INGO/21072,6/25/2023 6:32:28 AM,Refugees,1299,1428,1138,1176,5041,1132,1382,1269,1456,5239
67,oPt,2021,OPT-21/DDA-3482/1SA/PROT/INGO/21079,10/2/2023 7:56:57 AM,Host Communities,176,957,296,404,1833,2,1075,231,198,1506
67,oPt,2021,OPT-21/DDA-3482/1SA/PROT/INGO/21079,10/2/2023 7:56:57 AM,Overall,176,957,296,404,1833,2,1075,231,198,1506
67,oPt,2021,OPT-21/DDA-3482/1SA/PROT/NGO/20964,6/8/2023 12:40:24 PM,Host Communities,1000,1580,870,990,4440,1009,1598,832,964,4403
67,oPt,2021,OPT-21/DDA-3482/1SA/PROT/NGO/20964,6/8/2023 12:40:24 PM,Internally Displaced People,131,200,110,125,566,108,162,75,93,438
67,oPt,2021,OPT-21/DDA-3482/1SA/PROT/NGO/20964,6/8/2023 12:40:24 PM,Overall,2491,3970,2180,2465,11106,2391,4156,2143,2516,11206
67,oPt,2021,OPT-21/DDA-3482/1SA/PROT/NGO/20964,6/8/2023 12:40:24 PM,Refugees,1240,2000,1090,1230,5560,1160,2217,1137,1345,5859
67,oPt,2021,OPT-21/DDA-3482/1SA/PROT/NGO/20964,6/8/2023 12:40:24 PM,Returnees,120,190,110,120,540,114,179,99,114,506
67,oPt,2021,OPT-21/DDA-3482/1SA/PROT/NGO/21095,8/23/2023 12:00:09 PM,Other,99,595,137,261,1092,115,786,249,314,1464
67,oPt,2021,OPT-21/DDA-3482/1SA/PROT/NGO/21095,8/23/2023 12:00:09 PM,Overall,330,1982,456,870,3638,382,2619,830,1047,4878
67,oPt,2021,OPT-21/DDA-3482/1SA/PROT/NGO/21095,8/23/2023 12:00:09 PM,Refugees,231,1387,319,609,2546,267,1833,581,733,3414
67,oPt,2021,OPT-21/DDA-3482/1SA/SNFI/INGO/20975,12/19/2022 6:53:45 AM,Other,81,80,67,64,292,77,78,73,67,295
67,oPt,2021,OPT-21/DDA-3482/1SA/SNFI/INGO/20975,12/19/2022 6:53:45 AM,Overall,81,80,67,64,292,77,78,73,67,295
67,oPt,2021,OPT-21/DDA-3482/1SA/SNFI/INGO/21066,11/27/2022 9:54:58 AM,Other,276,247,200,210,933,210,224,242,210,886
67,oPt,2021,OPT-21/DDA-3482/1SA/SNFI/INGO/21066,11/27/2022 9:54:58 AM,Overall,276,247,200,210,933,210,224,242,210,886
67,oPt,2021,OPT-21/DDA-3482/1SA/SNFI/NGO/20987,12/22/2022 6:59:37 AM,Other,23,26,38,45,132,38,50,28,30,146
67,oPt,2021,OPT-21/DDA-3482/1SA/SNFI/NGO/20987,12/22/2022 6:59:37 AM,Overall,23,26,38,45,132,38,50,28,30,146
67,oPt,2021,OPT-21/DDA-3482/1SA/SNFI/NGO/21058,1/15/2023 8:14:22 AM,Other,258,306,210,216,990,267,261,293,303,1124
67,oPt,2021,OPT-21/DDA-3482/1SA/SNFI/NGO/21058,1/15/2023 8:14:22 AM,Overall,258,306,210,216,990,267,261,293,303,1124
67,oPt,2021,OPT-21/DDA-3482/1SA/WASH/NGO/21030,11/27/2022 9:50:17 AM,Other,649,687,558,587,2481,667,698,569,593,2527
67,oPt,2021,OPT-21/DDA-3482/1SA/WASH/NGO/21030,11/27/2022 9:50:17 AM,Overall,649,687,558,587,2481,667,698,569,593,2527
67,oPt,2021,OPT-21/DDA-3482/1SA/WASH/NGO/21105,4/12/2023 10:18:34 AM,Other,126,128,147,158,559,112,124,102,88,426
67,oPt,2021,OPT-21/DDA-3482/1SA/WASH/NGO/21105,4/12/2023 10:18:34 AM,Overall,126,128,147,158,559,112,124,102,88,426
67,oPt,2021,OPT-21/DDA-3482/1SA/WASH-FSL/INGO/20980,9/15/2023 6:06:37 AM,Other,70,66,69,67,272,70,66,69,67,272
67,oPt,2021,OPT-21/DDA-3482/1SA/WASH-FSL/INGO/20980,9/15/2023 6:06:37 AM,Overall,70,66,69,67,272,70,66,69,67,272
67,oPt,2021,OPT-21/DDA-3482/3RA/CSS/UN/19118,7/18/2023 11:25:42 AM,Other,1,1,1,1,4,1,1,1,1,4
67,oPt,2021,OPT-21/DDA-3482/3RA/CSS/UN/19118,7/18/2023 11:25:42 AM,Overall,1,1,1,1,4,1,1,1,1,4
67,oPt,2021,OPT-21/DDA-3482/3RA/CSS/UN/19119,7/7/2022 10:43:03 AM,Other,2,2,2,2,8,350000,350000,150000,150000,1000000
67,oPt,2021,OPT-21/DDA-3482/3RA/CSS/UN/19119,7/7/2022 10:43:03 AM,Overall,2,2,2,2,8,350000,350000,150000,150000,1000000
67,oPt,2021,OPT-21/DDA-3482/3RA/EDU/INGO/19049,4/19/2022 6:17:58 AM,Other,51,94,1140,2260,3545,50,92,1118,2491,3751
67,oPt,2021,OPT-21/DDA-3482/3RA/EDU/INGO/19049,4/19/2022 6:17:58 AM,Overall,51,94,1140,2260,3545,50,92,1118,2491,3751
67,oPt,2021,OPT-21/DDA-3482/3RA/EDU/INGO/19233,7/5/2022 6:45:44 AM,Other,206,710,1341,1459,3716,17,176,1181,1119,2493
67,oPt,2021,OPT-21/DDA-3482/3RA/EDU/INGO/19233,7/5/2022 6:45:44 AM,Overall,349,1513,3029,3634,8525,341,885,4013,4028,9267
67,oPt,2021,OPT-21/DDA-3482/3RA/EDU/INGO/19233,7/5/2022 6:45:44 AM,Refugees,55,219,464,481,1219,174,378,1150,1247,2949
67,oPt,2021,OPT-21/DDA-3482/3RA/EDU/INGO/19233,7/5/2022 6:45:44 AM,Returnees,88,584,1224,1694,3590,150,331,1682,1662,3825
67,oPt,2021,OPT-21/DDA-3482/3RA/EDU/NGO/19024,12/5/2021 9:37:42 AM,Host Communities,0,0,10474,6223,16697,0,0,11495,9549,21044
67,oPt,2021,OPT-21/DDA-3482/3RA/EDU/NGO/19024,12/5/2021 9:37:42 AM,Overall,0,0,10474,6223,16697,0,0,11495,9549,21044
67,oPt,2021,OPT-21/DDA-3482/3RA/FSL/INGO/19056,2/22/2022 7:27:40 AM,Other,145,141,137,125,548,184,185,173,156,698
67,oPt,2021,OPT-21/DDA-3482/3RA/FSL/INGO/19056,2/22/2022 7:27:40 AM,Overall,1107,1087,1067,1002,4263,1865,1874,1604,1575,6918
67,oPt,2021,OPT-21/DDA-3482/3RA/FSL/INGO/19056,2/22/2022 7:27:40 AM,Refugees,766,759,750,709,2984,725,727,574,598,2624
67,oPt,2021,OPT-21/DDA-3482/3RA/FSL/INGO/19056,2/22/2022 7:27:40 AM,Returnees,196,187,180,168,731,956,962,857,821,3596
67,oPt,2021,OPT-21/DDA-3482/3RA/FSL/INGO/19073,3/31/2022 11:53:25 AM,Other,1284,1240,689,665,3878,846,868,1075,1113,3902
67,oPt,2021,OPT-21/DDA-3482/3RA/FSL/INGO/19073,3/31/2022 11:53:25 AM,Overall,1284,1240,689,665,3878,846,868,1075,1113,3902
67,oPt,2021,OPT-21/DDA-3482/3RA/FSL/INGO/19097,5/16/2022 6:24:17 AM,Other,1488,1386,1293,1191,5358,1575,1416,1222,1112,5325
67,oPt,2021,OPT-21/DDA-3482/3RA/FSL/INGO/19097,5/16/2022 6:24:17 AM,Overall,1488,1386,1293,1191,5358,1575,1416,1222,1112,5325
67,oPt,2021,OPT-21/DDA-3482/3RA/FSL/INGO/19105,2/6/2022 7:26:40 AM,Other,1373,1335,1318,1282,5308,1787,1646,1551,1418,6402
67,oPt,2021,OPT-21/DDA-3482/3RA/FSL/INGO/19105,2/6/2022 7:26:40 AM,Overall,1373,1335,1318,1282,5308,1787,1646,1551,1418,6402
67,oPt,2021,OPT-21/DDA-3482/3RA/FSL/INGO/19133,4/3/2022 12:25:26 PM,Host Communities,11,7,0,0,18,10,8,0,0,18
67,oPt,2021,OPT-21/DDA-3482/3RA/FSL/INGO/19133,4/3/2022 12:25:26 PM,Other,1068,1178,695,744,3685,85,89,69,54,297
67,oPt,2021,OPT-21/DDA-3482/3RA/FSL/INGO/19133,4/3/2022 12:25:26 PM,Overall,1079,1185,695,744,3703,95,97,69,54,315
67,oPt,2021,OPT-21/DDA-3482/3RA/FSL/INGO/19262,6/5/2022 10:48:33 AM,Internally Displaced People,753,732,641,624,2750,1051,966,658,652,3327
67,oPt,2021,OPT-21/DDA-3482/3RA/FSL/INGO/19262,6/5/2022 10:48:33 AM,Overall,753,732,641,624,2750,1051,966,658,652,3327
67,oPt,2021,OPT-21/DDA-3482/3RA/FSL/NGO/19012,4/5/2022 12:03:20 PM,Other,234,260,477,459,1430,453,373,374,332,1532
67,oPt,2021,OPT-21/DDA-3482/3RA/FSL/NGO/19012,4/5/2022 12:03:20 PM,Overall,234,260,477,459,1430,453,373,374,332,1532
67,oPt,2021,OPT-21/DDA-3482/3RA/FSL/NGO/19108,4/12/2022 5:49:24 AM,Other,399,385,302,289,1375,494,507,418,396,1815
67,oPt,2021,OPT-21/DDA-3482/3RA/FSL/NGO/19108,4/12/2022 5:49:24 AM,Overall,399,385,302,289,1375,494,507,418,396,1815
67,oPt,2021,OPT-21/DDA-3482/3RA/FSL/UN/19074,5/12/2022 7:41:50 AM,Other,6197,5902,6579,6522,25200,6992,6931,9114,9485,32522
67,oPt,2021,OPT-21/DDA-3482/3RA/FSL/UN/19074,5/12/2022 7:41:50 AM,Overall,6197,5902,6579,6522,25200,6992,6931,9114,9485,32522
67,oPt,2021,OPT-21/DDA-3482/3RA/FSL/UN/19117,4/5/2022 9:24:22 AM,Other,3934,3745,2718,2551,12948,3934,3745,2718,2551,12948
67,oPt,2021,OPT-21/DDA-3482/3RA/FSL/UN/19117,4/5/2022 9:24:22 AM,Overall,3934,3745,2718,2551,12948,3934,3745,2718,2551,12948
67,oPt,2021,OPT-21/DDA-3482/3RA/FSL-EDU/INGO/19090,2/20/2022 9:23:24 AM,Other,74,74,359,359,866,48,48,332,302,730
67,oPt,2021,OPT-21/DDA-3482/3RA/FSL-EDU/INGO/19090,2/20/2022 9:23:24 AM,Overall,185,185,898,898,2166,195,189,1065,1077,2526
67,oPt,2021,OPT-21/DDA-3482/3RA/FSL-EDU/INGO/19090,2/20/2022 9:23:24 AM,Refugees,111,111,539,539,1300,147,141,733,775,1796
67,oPt,2021,OPT-21/DDA-3482/3RA/HNC/INGO/19065,4/14/2022 7:08:22 AM,Other,586,576,376,362,1900,626,2169,94,95,2984
67,oPt,2021,OPT-21/DDA-3482/3RA/HNC/INGO/19065,4/14/2022 7:08:22 AM,Overall,586,576,376,362,1900,626,2169,94,95,2984
67,oPt,2021,OPT-21/DDA-3482/3RA/HNC/NGO/19046,3/13/2022 7:20:57 AM,Other,1350,1890,1080,1080,5400,788,5199,1735,1507,9229
67,oPt,2021,OPT-21/DDA-3482/3RA/HNC/NGO/19046,3/13/2022 7:20:57 AM,Overall,3750,5250,3000,3000,15000,2188,9884,4695,4149,20916
67,oPt,2021,OPT-21/DDA-3482/3RA/HNC/NGO/19046,3/13/2022 7:20:57 AM,Refugees,2400,3360,1920,1920,9600,1400,4685,2960,2642,11687
67,oPt,2021,OPT-21/DDA-3482/3RA/HNC/NGO/19057,5/16/2022 10:57:08 AM,Other,1382,915,1116,834,4247,1113,1094,1295,1121,4623
67,oPt,2021,OPT-21/DDA-3482/3RA/HNC/NGO/19057,5/16/2022 10:57:08 AM,Overall,4607,3058,3734,2785,14184,4104,3903,4273,4042,16322
67,oPt,2021,OPT-21/DDA-3482/3RA/HNC/NGO/19057,5/16/2022 10:57:08 AM,Refugees,3225,2143,2618,1951,9937,2991,2809,2978,2921,11699
67,oPt,2021,OPT-21/DDA-3482/3RA/HNC/NGO/19163,5/15/2022 10:51:42 AM,Host Communities,1750,3400,1500,1450,8100,2404,5760,2319,2206,12689
67,oPt,2021,OPT-21/DDA-3482/3RA/HNC/NGO/19163,5/15/2022 10:51:42 AM,Overall,3350,6050,2875,2825,15100,4173,9541,4457,4232,22403
67,oPt,2021,OPT-21/DDA-3482/3RA/HNC/NGO/19163,5/15/2022 10:51:42 AM,Refugees,1600,2650,1375,1375,7000,1769,3781,2138,2026,9714
67,oPt,2021,OPT-21/DDA-3482/3RA/HNC/UN/19011,7/12/2022 8:49:22 AM,Host Communities,9959,9872,9149,8715,37695,16840,15867,14775,13854,61336
67,oPt,2021,OPT-21/DDA-3482/3RA/HNC/UN/19011,7/12/2022 8:49:22 AM,Overall,33197,32907,30496,29050,125650,56132,52891,49249,46179,204451
67,oPt,2021,OPT-21/DDA-3482/3RA/HNC/UN/19011,7/12/2022 8:49:22 AM,Refugees,23238,23035,21347,20335,87955,39292,37024,34474,32325,143115
67,oPt,2021,OPT-21/DDA-3482/3RA/HNC-PROT/UN/19091,3/13/2022 7:25:41 AM,Host Communities,451,7925,75,105,8556,897,8195,117,200,9409
67,oPt,2021,OPT-21/DDA-3482/3RA/HNC-PROT/UN/19091,3/13/2022 7:25:41 AM,Overall,1503,26416,250,350,28519,2573,27317,389,668,30947
67,oPt,2021,OPT-21/DDA-3482/3RA/HNC-PROT/UN/19091,3/13/2022 7:25:41 AM,Refugees,1052,18491,175,245,19963,1676,19122,272,468,21538
67,oPt,2021,OPT-21/DDA-3482/3RA/PROT/INGO/19248,3/29/2022 7:04:27 AM,Internally Displaced People,265,1604,3927,3869,9665,230,1693,3407,3580,8910
67,oPt,2021,OPT-21/DDA-3482/3RA/PROT/INGO/19248,3/29/2022 7:04:27 AM,Overall,265,1604,3927,3869,9665,230,1693,3407,3580,8910
67,oPt,2021,OPT-21/DDA-3482/3RA/PROT/NGO/19021,4/19/2022 6:56:51 AM,Host Communities,170,1615,40,930,2755,170,1620,40,930,2760
67,oPt,2021,OPT-21/DDA-3482/3RA/PROT/NGO/19021,4/19/2022 6:56:51 AM,Internally Displaced People,85,800,25,465,1375,85,800,25,465,1375
67,oPt,2021,OPT-21/DDA-3482/3RA/PROT/NGO/19021,4/19/2022 6:56:51 AM,Other,30,278,25,155,488,30,278,25,155,488
67,oPt,2021,OPT-21/DDA-3482/3RA/PROT/NGO/19021,4/19/2022 6:56:51 AM,Overall,565,5388,175,3100,9228,570,5428,180,3130,9308
67,oPt,2021,OPT-21/DDA-3482/3RA/PROT/NGO/19021,4/19/2022 6:56:51 AM,Refugees,255,2425,75,1395,4150,260,2450,80,1420,4210
67,oPt,2021,OPT-21/DDA-3482/3RA/PROT/NGO/19021,4/19/2022 6:56:51 AM,Returnees,25,270,10,155,460,25,280,10,160,475
67,oPt,2021,OPT-21/DDA-3482/3RA/PROT/NGO/19125,6/6/2022 12:10:25 PM,Other,10440,440,438,272,11590,7794,1085,464,267,9610
67,oPt,2021,OPT-21/DDA-3482/3RA/PROT/NGO/19125,6/6/2022 12:10:25 PM,Overall,10440,440,438,272,11590,7794,1085,464,267,9610
67,oPt,2021,OPT-21/DDA-3482/3RA/PROT/NGO/19136,5/9/2022 10:07:56 AM,Host Communities,471,1559,355,355,2740,471,1559,355,355,2740
67,oPt,2021,OPT-21/DDA-3482/3RA/PROT/NGO/19136,5/9/2022 10:07:56 AM,Internally Displaced People,471,1559,355,355,2740,471,1559,355,355,2740
67,oPt,2021,OPT-21/DDA-3482/3RA/PROT/NGO/19136,5/9/2022 10:07:56 AM,Overall,2319,7831,1775,1775,13700,2319,7831,1775,1775,13700
67,oPt,2021,OPT-21/DDA-3482/3RA/PROT/NGO/19136,5/9/2022 10:07:56 AM,Refugees,1141,3933,887,888,6849,1141,3933,887,888,6849
67,oPt,2021,OPT-21/DDA-3482/3RA/PROT/NGO/19136,5/9/2022 10:07:56 AM,Returnees,236,780,178,177,1371,236,780,178,177,1371
67,oPt,2021,OPT-21/DDA-3482/3RA/PROT-EDU/INGO/19040,1/31/2022 8:35:02 AM,Other,174,177,980,980,2311,165,468,1888,1918,4439
67,oPt,2021,OPT-21/DDA-3482/3RA/PROT-EDU/INGO/19040,1/31/2022 8:35:02 AM,Overall,174,177,980,980,2311,165,468,1888,1918,4439
67,oPt,2021,OPT-21/DDA-3482/3RA/PROT-WASH/UN/19079,6/21/2022 9:45:39 AM,Host Communities,135455,130893,135982,131648,533978,136633,131534,136074,129975,534216
67,oPt,2021,OPT-21/DDA-3482/3RA/PROT-WASH/UN/19079,6/21/2022 9:45:39 AM,Overall,135455,130893,135982,131648,533978,136633,131534,136074,129975,534216
67,oPt,2021,OPT-21/DDA-3482/3RA/SNFI/INGO/19027,4/10/2022 7:04:43 AM,Internally Displaced People,336,370,220,232,1158,349,310,350,284,1293
67,oPt,2021,OPT-21/DDA-3482/3RA/SNFI/INGO/19027,4/10/2022 7:04:43 AM,Other,11,7,0,0,18,11,7,0,0,18
67,oPt,2021,OPT-21/DDA-3482/3RA/SNFI/INGO/19027,4/10/2022 7:04:43 AM,Overall,347,377,220,232,1176,360,317,350,284,1311
67,oPt,2021,OPT-21/DDA-3482/3RA/SNFI/INGO/19045,6/6/2022 12:13:17 PM,Other,218,211,201,192,822,226,229,209,211,875
67,oPt,2021,OPT-21/DDA-3482/3RA/SNFI/INGO/19045,6/6/2022 12:13:17 PM,Overall,218,211,201,192,822,226,229,209,211,875
67,oPt,2021,OPT-21/DDA-3482/3RA/SNFI/INGO/19116,5/8/2022 11:36:34 AM,Internally Displaced People,80,75,75,70,300,70,69,78,63,280
67,oPt,2021,OPT-21/DDA-3482/3RA/SNFI/INGO/19116,5/8/2022 11:36:34 AM,Other,8,7,8,7,30,18,19,24,18,79
67,oPt,2021,OPT-21/DDA-3482/3RA/SNFI/INGO/19116,5/8/2022 11:36:34 AM,Overall,239,228,222,211,900,260,245,304,256,1065
67,oPt,2021,OPT-21/DDA-3482/3RA/SNFI/INGO/19116,5/8/2022 11:36:34 AM,Refugees,151,146,139,134,570,172,157,202,175,706
67,oPt,2021,OPT-21/DDA-3482/3RA/SNFI/NGO/19050,9/27/2022 11:36:32 AM,Internally Displaced People,94,97,106,80,377,86,86,88,74,334
67,oPt,2021,OPT-21/DDA-3482/3RA/SNFI/NGO/19050,9/27/2022 11:36:32 AM,Other,235,235,220,210,900,302,309,342,277,1230
67,oPt,2021,OPT-21/DDA-3482/3RA/SNFI/NGO/19050,9/27/2022 11:36:32 AM,Overall,329,332,326,290,1277,388,395,430,351,1564
67,oPt,2021,OPT-21/DDA-3482/3RA/SNFI/UN/19135,6/5/2022 10:38:04 AM,Internally Displaced People,192,164,154,118,628,192,164,154,118,628
67,oPt,2021,OPT-21/DDA-3482/3RA/SNFI/UN/19135,6/5/2022 10:38:04 AM,Overall,192,164,154,118,628,192,164,154,118,628
67,oPt,2021,OPT-21/DDA-3482/3RA/WASH/INGO/19016,4/11/2022 7:43:08 AM,Other,97684,96892,104980,100444,400000,97684,96892,104980,100444,400000
67,oPt,2021,OPT-21/DDA-3482/3RA/WASH/INGO/19016,4/11/2022 7:43:08 AM,Overall,97684,96892,104980,100444,400000,97684,96892,104980,100444,400000
67,oPt,2021,OPT-21/DDA-3482/3RA/WASH/INGO/19018,6/30/2022 11:26:17 AM,Other,334,330,333,302,1299,344,341,348,296,1329
67,oPt,2021,OPT-21/DDA-3482/3RA/WASH/INGO/19018,6/30/2022 11:26:17 AM,Overall,334,330,333,302,1299,344,341,348,296,1329
67,oPt,2021,OPT-21/DDA-3482/3RA/WASH/INGO/19127,4/14/2022 7:01:17 AM,Other,441,447,473,473,1834,504,460,462,458,1884
67,oPt,2021,OPT-21/DDA-3482/3RA/WASH/INGO/19127,4/14/2022 7:01:17 AM,Overall,441,447,473,473,1834,504,460,462,458,1884
67,oPt,2021,OPT-21/DDA-3482/3RA/WASH/INGO/19250,6/19/2022 6:34:43 AM,Other,354,344,302,293,1293,504,465,424,431,1824
67,oPt,2021,OPT-21/DDA-3482/3RA/WASH/INGO/19250,6/19/2022 6:34:43 AM,Overall,354,344,302,293,1293,504,465,424,431,1824
67,oPt,2021,OPT-21/DDA-3482/RA1/CSS/INGO/18053,1/25/2022 8:40:02 AM,Other,752640,783360,423360,440640,2400000,752640,783360,423360,440640,2400000
67,oPt,2021,OPT-21/DDA-3482/RA1/CSS/INGO/18053,1/25/2022 8:40:02 AM,Overall,752640,783360,423360,440640,2400000,752640,783360,423360,440640,2400000
67,oPt,2021,OPT-21/DDA-3482/RA2/FSL/INGO/18562,12/5/2021 9:42:13 AM,Other,1022,995,1079,1050,4146,1002,994,1077,1030,4103
67,oPt,2021,OPT-21/DDA-3482/RA2/FSL/INGO/18562,12/5/2021 9:42:13 AM,Overall,1022,995,1079,1050,4146,1002,994,1077,1030,4103
67,oPt,2021,OPT-21/DDA-3482/RA2/HNC/UN/18546,1/26/2022 7:30:17 AM,Host Communities,48349,47928,44414,42309,183000,54409,53935,49981,47612,205937
67,oPt,2021,OPT-21/DDA-3482/RA2/HNC/UN/18546,1/26/2022 7:30:17 AM,Overall,161162,159759,148047,141032,610000,181362,179783,166603,158708,686456
67,oPt,2021,OPT-21/DDA-3482/RA2/HNC/UN/18546,1/26/2022 7:30:17 AM,Refugees,112813,111831,103633,98723,427000,126953,125848,116622,111096,480519
67,oPt,2021,OPT-21/DDA-3482/RA2/HNC/UN/18547,4/21/2022 7:30:50 AM,Host Communities,2760,2760,690,690,6900,1640,1640,250,250,3780
67,oPt,2021,OPT-21/DDA-3482/RA2/HNC/UN/18547,4/21/2022 7:30:50 AM,Overall,2760,2760,690,690,6900,1640,1640,250,250,3780
67,oPt,2022,OPT-22/DDA-3482/2RA/CSS/INGO/21946,2/28/2023 12:05:59 PM,Other,582000,560000,476000,458000,2076000,652094,681263,390697,360921,2084975
67,oPt,2022,OPT-22/DDA-3482/2RA/CSS/INGO/21946,2/28/2023 12:05:59 PM,Overall,582000,560000,476000,458000,2076000,652094,681263,390697,360921,2084975
67,oPt,2022,OPT-22/DDA-3482/2RA/HNC/INGO/21947,8/11/2022 9:47:11 AM,Other,55,69,11,8,143,35,107,0,0,142
67,oPt,2022,OPT-22/DDA-3482/2RA/HNC/INGO/21947,8/11/2022 9:47:11 AM,Overall,55,69,11,8,143,35,107,0,0,142
67,oPt,2022,OPT-22/DDA-3482/SA1/FSL/INGO/22523,7/5/2023 11:06:23 AM,Other,1331,1329,718,714,4092,1410,1447,741,693,4291
67,oPt,2022,OPT-22/DDA-3482/SA1/FSL/INGO/22523,7/5/2023 11:06:23 AM,Overall,1331,1329,718,714,4092,1410,1447,741,693,4291
67,oPt,2022,OPT-22/DDA-3482/SA1/FSL/INGO/22569,7/11/2023 5:52:18 AM,Host Communities,1108,1080,945,920,4053,1097,1100,1018,1077,4292
67,oPt,2022,OPT-22/DDA-3482/SA1/FSL/INGO/22569,7/11/2023 5:52:18 AM,Overall,1108,1080,945,920,4053,1097,1100,1018,1077,4292
67,oPt,2022,OPT-22/DDA-3482/SA1/FSL/INGO/22617,7/5/2023 6:36:51 AM,Other,1183,1302,798,837,4120,1962,1797,1001,987,5747
67,oPt,2022,OPT-22/DDA-3482/SA1/FSL/INGO/22617,7/5/2023 6:36:51 AM,Overall,1183,1302,798,837,4120,1962,1797,1001,987,5747
67,oPt,2022,OPT-22/DDA-3482/SA1/FSL/NGO/22490,10/5/2023 7:13:21 AM,Host Communities,1459,1409,1063,1014,4945,2701,2286,1626,1446,8059
67,oPt,2022,OPT-22/DDA-3482/SA1/FSL/NGO/22490,10/5/2023 7:13:21 AM,Overall,1459,1409,1063,1014,4945,2701,2286,1626,1446,8059
67,oPt,2022,OPT-22/DDA-3482/SA1/FSL/NGO/22581,7/10/2023 5:44:38 AM,Host Communities,1253,1211,913,871,4248,2242,2002,1451,1199,6894
67,oPt,2022,OPT-22/DDA-3482/SA1/FSL/NGO/22581,7/10/2023 5:44:38 AM,Overall,1253,1211,913,871,4248,2242,2002,1451,1199,6894
67,oPt,2022,OPT-22/DDA-3482/SA1/HNC/INGO/22516,9/7/2023 10:25:07 AM,Host Communities,2888,9246,4444,5547,22125,4409,7240,6566,7308,25523
67,oPt,2022,OPT-22/DDA-3482/SA1/HNC/INGO/22516,9/7/2023 10:25:07 AM,Overall,2888,9246,4444,5547,22125,4409,7240,6566,7308,25523
67,oPt,2022,OPT-22/DDA-3482/SA1/HNC/INGO/22633,5/11/2023 10:29:10 AM,Other,32329,25633,9764,7528,75254,32884,26115,9972,7729,76700
67,oPt,2022,OPT-22/DDA-3482/SA1/HNC/INGO/22633,5/11/2023 10:29:10 AM,Overall,32329,25633,9764,7528,75254,32884,26115,9972,7729,76700
67,oPt,2022,OPT-22/DDA-3482/SA1/SNFI/INGO/22532,9/3/2023 10:18:57 AM,Other,214,204,196,186,800,237,227,210,210,884
67,oPt,2022,OPT-22/DDA-3482/SA1/SNFI/INGO/22532,9/3/2023 10:18:57 AM,Overall,214,204,196,186,800,237,227,210,210,884
67,oPt,2022,OPT-22/DDA-3482/SA1/SNFI/INGO/22565,7/5/2023 7:49:06 AM,Host Communities,57,52,55,54,218,50,50,45,55,200
67,oPt,2022,OPT-22/DDA-3482/SA1/SNFI/INGO/22565,7/5/2023 7:49:06 AM,Overall,57,52,55,54,218,50,50,45,55,200
67,oPt,2022,OPT-22/DDA-3482/SA1/SNFI/INGO/22587,6/25/2023 6:36:20 AM,Host Communities,11,7,0,0,18,10,8,0,0,18
67,oPt,2022,OPT-22/DDA-3482/SA1/SNFI/INGO/22587,6/25/2023 6:36:20 AM,Other,184,195,211,183,773,293,323,218,234,1068
67,oPt,2022,OPT-22/DDA-3482/SA1/SNFI/INGO/22587,6/25/2023 6:36:20 AM,Overall,195,202,211,183,791,303,331,218,234,1086
67,oPt,2022,OPT-22/DDA-3482/SA1/SNFI/INGO/22588,7/18/2023 10:45:31 AM,Host Communities,73,70,60,59,262,56,53,44,44,197
67,oPt,2022,OPT-22/DDA-3482/SA1/SNFI/INGO/22588,7/18/2023 10:45:31 AM,Overall,331,318,287,263,1199,345,344,291,279,1259
67,oPt,2022,OPT-22/DDA-3482/SA1/SNFI/INGO/22588,7/18/2023 10:45:31 AM,Refugees,258,248,227,204,937,289,291,247,235,1062
67,oPt,2022,OPT-22/DDA-3482/SA1/SNFI/INGO/22606,8/20/2023 5:40:16 AM,Host Communities,158,148,117,144,567,109,106,98,114,427
67,oPt,2022,OPT-22/DDA-3482/SA1/SNFI/INGO/22606,8/20/2023 5:40:16 AM,Overall,158,148,117,144,567,109,106,98,114,427
67,oPt,2022,OPT-22/DDA-3482/SA1/SNFI/NGO/22520,7/5/2023 10:44:16 AM,Other,34,36,90,105,265,46,52,71,57,226
67,oPt,2022,OPT-22/DDA-3482/SA1/SNFI/NGO/22520,7/5/2023 10:44:16 AM,Overall,34,36,90,105,265,46,52,71,57,226
67,oPt,2022,OPT-22/DDA-3482/SA1/SNFI/NGO/22522,7/25/2023 12:01:56 PM,Other,321,254,268,261,1104,347,336,305,334,1322
67,oPt,2022,OPT-22/DDA-3482/SA1/SNFI/NGO/22522,7/25/2023 12:01:56 PM,Overall,321,254,268,261,1104,347,336,305,334,1322
67,oPt,2022,OPT-22/DDA-3482/SA1/SNFI/NGO/22631,9/7/2023 10:40:00 AM,Host Communities,87,76,63,81,307,56,61,118,92,327
67,oPt,2022,OPT-22/DDA-3482/SA1/SNFI/NGO/22631,9/7/2023 10:40:00 AM,Overall,87,76,63,81,307,56,61,118,92,327
67,oPt,2022,OPT-22/DDA-3482/SA1/WASH/INGO/22480,7/5/2023 6:13:52 AM,Other,667,648,619,596,2530,667,648,619,596,2530
67,oPt,2022,OPT-22/DDA-3482/SA1/WASH/INGO/22480,7/5/2023 6:13:52 AM,Overall,667,648,619,596,2530,667,648,619,596,2530
67,oPt,2022,OPT-22/DDA-3482/SA1/WASH/INGO/22547,7/23/2023 5:23:55 AM,Host Communities,1288,1254,1522,1454,5518,1325,1289,1570,1498,5682
67,oPt,2022,OPT-22/DDA-3482/SA1/WASH/INGO/22547,7/23/2023 5:23:55 AM,Overall,1288,1254,1522,1454,5518,1325,1289,1570,1498,5682
67,oPt,2022,OPT-22/DDA-3482/SA1/WASH/NGO/22542,9/28/2023 7:57:45 AM,Host Communities,125,124,129,120,498,130,123,187,204,644
67,oPt,2022,OPT-22/DDA-3482/SA1/WASH/NGO/22542,9/28/2023 7:57:45 AM,Overall,125,124,129,120,498,130,123,187,204,644
67,oPt,2022,OPT-22/DDA-3482/SA1/WASH/NGO/23426,9/13/2023 6:17:51 AM,Other,2107,2035,1131,1092,6365,2107,2035,1131,1092,6365
67,oPt,2022,OPT-22/DDA-3482/SA1/WASH/NGO/23426,9/13/2023 6:17:51 AM,Overall,2107,2035,1131,1092,6365,2107,2035,1131,1092,6365
67,oPt,2022,OPT-22/DDA-3482/SA2/HNC/INGO/24035,9/3/2023 10:24:33 AM,Other,2939,2299,98,74,5410,2512,2282,73,56,4923
67,oPt,2022,OPT-22/DDA-3482/SA2/HNC/INGO/24035,9/3/2023 10:24:33 AM,Overall,2939,2299,98,74,5410,2512,2282,73,56,4923
60,Pakistan,2015,PAK-15/DDA-3474/(Q2) SA/CR/NGO/1434,5/16/2016 9:06:51 AM,Other,550,200,1800,1950,4500,950,1012,1505,1394,4861
60,Pakistan,2015,PAK-15/DDA-3474/(Q2) SA/CR/NGO/1434,5/16/2016 9:06:51 AM,Overall,550,200,1800,1950,4500,950,1012,1505,1394,4861
60,Pakistan,2015,PAK-15/DDA-3474/(Q2) SA/E/INGO/1449,5/29/2017 10:32:13 AM,Other,2466,2370,0,0,4836,0,0,0,0,0
60,Pakistan,2015,PAK-15/DDA-3474/(Q2) SA/E/INGO/1449,5/29/2017 10:32:13 AM,Overall,174,174,1450,1450,3248,174,174,779,1961,3088
60,Pakistan,2015,PAK-15/DDA-3474/(Q2) SA/FS/INGO/1426,10/18/2016 9:33:01 AM,Overall,2381,2070,3105,2795,10351,1643,2407,2239,2595,8884
60,Pakistan,2015,PAK-15/DDA-3474/(Q2) SA/FS/NGO/1441,5/16/2016 9:07:25 AM,Other,1123,1217,2246,2434,7020,1426,1399,2350,1997,7172
60,Pakistan,2015,PAK-15/DDA-3474/(Q2) SA/FS/NGO/1441,5/16/2016 9:07:25 AM,Overall,1123,1217,2246,2434,7020,1426,1399,2350,1997,7172
60,Pakistan,2015,PAK-15/DDA-3474/(Q2) SA/H/NGO/1442,5/16/2016 8:51:05 AM,Host Communities,589,651,835,895,2970,0,0,0,0,0
60,Pakistan,2015,PAK-15/DDA-3474/(Q2) SA/H/NGO/1442,5/16/2016 8:51:05 AM,Internally Displaced People,2356,2602,3338,3584,11880,1218,5634,4294,4520,15666
60,Pakistan,2015,PAK-15/DDA-3474/(Q2) SA/H/NGO/1442,5/16/2016 8:51:05 AM,Overall,2945,3253,4173,4479,14850,1218,5634,4294,4520,15666
60,Pakistan,2015,PAK-15/DDA-3474/(Q2) SA/H/NGO/1467,7/25/2016 8:06:31 AM,Other,2995,4118,6178,5429,18720,548,6520,4130,4739,15937
60,Pakistan,2015,PAK-15/DDA-3474/(Q2) SA/H/NGO/1467,7/25/2016 8:06:31 AM,Overall,2995,4118,6178,5429,18720,548,6520,4130,4739,15937
60,Pakistan,2015,PAK-15/DDA-3474/(Q2) SA/H/NGO/1469,5/16/2016 9:09:03 AM,Other,1276,1665,2126,2303,7370,896,4172,2317,1143,8528
60,Pakistan,2015,PAK-15/DDA-3474/(Q2) SA/H/NGO/1469,5/16/2016 9:09:03 AM,Overall,3240,5093,5724,6201,20258,2657,8280,6421,6681,24039
60,Pakistan,2015,PAK-15/DDA-3474/(Q2) SA/N/NGO/1430,7/25/2016 7:55:22 AM,Internally Displaced People,0,26560,20728,19444,66732,0,39970,21356,21186,82512
60,Pakistan,2015,PAK-15/DDA-3474/(Q2) SA/N/NGO/1430,7/25/2016 7:55:22 AM,Overall,0,13280,10364,9722,33366,0,19985,10678,10593,41256
60,Pakistan,2015,PAK-15/DDA-3474/(Q2) SA/N/UN/1451,2/20/2017 10:30:17 AM,Host Communities,0,4452,1113,1069,6634,0,4452,1113,1069,6634
60,Pakistan,2015,PAK-15/DDA-3474/(Q2) SA/N/UN/1451,2/20/2017 10:30:17 AM,Internally Displaced People,0,1113,278,267,1658,0,1113,278,267,1658
60,Pakistan,2015,PAK-15/DDA-3474/(Q2) SA/N/UN/1451,2/20/2017 10:30:17 AM,Overall,0,5565,1391,1336,8292,0,5565,1391,1336,8292
60,Pakistan,2015,PAK-15/DDA-3474/(Q2) SA/N/UN/1461,10/18/2016 7:12:26 AM,Host Communities,0,0,796,746,1542,0,0,364,593,957
60,Pakistan,2015,PAK-15/DDA-3474/(Q2) SA/N/UN/1461,10/18/2016 7:12:26 AM,Overall,0,0,796,746,1542,0,0,364,593,957
60,Pakistan,2015,PAK-15/DDA-3474/(Q2) SA/P/NGO/1466,5/16/2016 8:42:11 AM,Other,80,1000,2112,2288,5480,90,1351,2586,2135,6162
60,Pakistan,2015,PAK-15/DDA-3474/(Q2) SA/P/NGO/1466,5/16/2016 8:42:11 AM,Overall,80,1000,2112,2288,5480,90,1351,2586,2135,6162
60,Pakistan,2015,PAK-15/DDA-3474/(Q2) SA/Shelter/NFI/INGO/1445,9/9/2016 5:43:59 AM,Internally Displaced People,589,639,720,781,2729,797,802,1335,1146,4080
60,Pakistan,2015,PAK-15/DDA-3474/(Q2) SA/Shelter/NFI/INGO/1445,9/9/2016 5:43:59 AM,Overall,589,639,720,781,2729,797,802,1335,1146,4080
60,Pakistan,2015,PAK-15/DDA-3474/(Q2) SA/Shelter/NFI/INGO/1462,10/18/2016 9:39:30 AM,Other,778,745,907,810,3240,453,498,671,588,2210
60,Pakistan,2015,PAK-15/DDA-3474/(Q2) SA/Shelter/NFI/INGO/1462,10/18/2016 9:39:30 AM,Overall,778,745,907,810,3240,453,498,671,588,2210
60,Pakistan,2015,PAK-15/DDA-3474/(Q2) SA/Shelter/NFI/NGO/1437,5/16/2016 9:13:09 AM,Internally Displaced People,404,423,557,576,1960,662,698,934,839,3133
60,Pakistan,2015,PAK-15/DDA-3474/(Q2) SA/Shelter/NFI/NGO/1437,5/16/2016 9:13:09 AM,Overall,404,423,557,576,1960,662,698,934,839,3133
60,Pakistan,2015,PAK-15/DDA-3474/(Q2) SA/Shelter/NFI/NGO/1447,12/1/2016 10:23:12 AM,Other,326,378,437,421,1562,243,296,488,429,1456
60,Pakistan,2015,PAK-15/DDA-3474/(Q2) SA/Shelter/NFI/NGO/1447,12/1/2016 10:23:12 AM,Overall,326,378,437,421,1562,243,296,488,429,1456
60,Pakistan,2015,PAK-15/DDA-3474/(Q2) SA/WASH/INGO/1456,12/1/2016 10:13:38 AM,Overall,100,100,1650,1650,3500,80,70,1325,1630,3105
60,Pakistan,2015,PAK-15/DDA-3474/2015 (Q2) SA/E/NGO/1420,5/16/2016 8:47:54 AM,Other,300,300,2900,2900,6400,300,300,3716,3166,7482
60,Pakistan,2015,PAK-15/DDA-3474/2015 (Q2) SA/E/NGO/1420,5/16/2016 8:47:54 AM,Overall,300,300,2900,2900,6400,300,300,3716,3166,7482
60,Pakistan,2015,PAK-15/DDA-3474/2015 (Q2) SA/P/NGO/1419,10/18/2016 9:31:36 AM,Internally Displaced People,2000,2000,1000,1000,6000,0,0,0,0,0
60,Pakistan,2015,PAK-15/DDA-3474/2015 (Q2) SA/P/NGO/1419,10/18/2016 9:31:36 AM,Other,2000,2000,1000,1000,6000,2250,2570,1200,1290,7310
60,Pakistan,2015,PAK-15/DDA-3474/2015 (Q2) SA/P/NGO/1419,10/18/2016 9:31:36 AM,Overall,2000,2000,1000,1000,6000,2250,2570,1200,1290,7310
60,Pakistan,2015,PAK-15/DDA-3474/2015 (Q2) SA/WASH/NGO/1421,10/20/2016 6:12:41 AM,Internally Displaced People,2258,2360,3250,2726,10594,3435,3575,2383,2290,11683
60,Pakistan,2015,PAK-15/DDA-3474/2015 (Q2) SA/WASH/NGO/1421,10/20/2016 6:12:41 AM,Overall,2258,2360,3250,2726,10594,3435,3575,2383,2290,11683
60,Pakistan,2015,PAK-15/DDA-3474/2015( Q2) RA/CSS/UN/1682,5/1/2017 5:54:02 AM,Overall,1036000,1123000,650000,690000,3499000,418140,418140,563580,418140,1818000
60,Pakistan,2015,PAK-15/DDA-3474/2nd Reserve 2015/CCCM/UN/2536,2/1/2022 10:23:34 AM,Internally Displaced People,1400,1443,1964,1617,6424,1400,1443,1964,1617,6424
60,Pakistan,2015,PAK-15/DDA-3474/2nd Reserve 2015/CCCM/UN/2536,2/1/2022 10:23:34 AM,Overall,1371,1371,1849,1371,5962,1371,1371,1849,1371,5962
60,Pakistan,2015,PAK-15/DDA-3474/2nd Standard 2015/E/NGO/2166,1/26/2017 7:28:14 AM,Overall,60,60,2592,2208,4920,300,300,2484,2316,5400
60,Pakistan,2015,PAK-15/DDA-3474/2nd Standard 2015/E/NGO/2175,4/24/2017 5:29:35 AM,Other,280,280,0,0,560,280,280,0,0,560
60,Pakistan,2015,PAK-15/DDA-3474/2nd Standard 2015/E/NGO/2175,4/24/2017 5:29:35 AM,Overall,0,0,2240,2240,4480,0,0,2240,2240,4480
60,Pakistan,2015,PAK-15/DDA-3474/2nd Standard 2015/FS/INGO/2174,3/9/2017 10:11:27 AM,Overall,2331,2426,3108,3235,11100,2720,2831,3626,3774,12951
60,Pakistan,2015,PAK-15/DDA-3474/2nd Standard 2015/FS/NGO/2137,10/18/2016 9:41:31 AM,Other,1872,2028,4680,5070,13650,2850,2873,4078,3818,13619
60,Pakistan,2015,PAK-15/DDA-3474/2nd Standard 2015/FS/NGO/2137,10/18/2016 9:41:31 AM,Overall,1872,2028,4680,5070,13650,2850,2873,4078,3818,13619
60,Pakistan,2015,PAK-15/DDA-3474/2nd Standard 2015/H/NGO/2122,2/28/2017 5:20:10 AM,Other,4147,6359,9400,7741,27647,9472,7231,4149,3867,24719
60,Pakistan,2015,PAK-15/DDA-3474/2nd Standard 2015/H/NGO/2122,2/28/2017 5:20:10 AM,Overall,4147,6359,9400,7741,27647,9472,7231,4149,3867,24719
60,Pakistan,2015,PAK-15/DDA-3474/2nd Standard 2015/H/NGO/2141,1/5/2017 11:19:18 AM,Internally Displaced People,4500,9000,4950,4050,22500,4665,9230,5078,4180,23153
60,Pakistan,2015,PAK-15/DDA-3474/2nd Standard 2015/H/NGO/2141,1/5/2017 11:19:18 AM,Overall,4500,9000,4950,4050,22500,4665,9230,5078,4180,23153
60,Pakistan,2015,PAK-15/DDA-3474/2nd Standard 2015/H/NGO/2148,1/4/2017 10:16:29 AM,Other,65,38,0,0,103,65,38,0,0,103
60,Pakistan,2015,PAK-15/DDA-3474/2nd Standard 2015/H/NGO/2148,1/4/2017 10:16:29 AM,Overall,4769,9201,8358,9054,31382,7061,9929,7909,6604,31503
60,Pakistan,2015,PAK-15/DDA-3474/2nd Standard 2015/H/NGO/2178,2/28/2017 5:25:18 AM,Internally Displaced People,12420,12420,16740,12420,54000,15428,22317,12639,14022,64406
60,Pakistan,2015,PAK-15/DDA-3474/2nd Standard 2015/H/NGO/2178,2/28/2017 5:25:18 AM,Overall,12420,12420,16740,12420,54000,15428,22317,12639,14022,64406
60,Pakistan,2015,PAK-15/DDA-3474/2nd Standard 2015/N/NGO/2144,3/3/2017 6:31:31 AM,Internally Displaced People,0,11543,9427,8031,29001,0,20323,13524,13245,47092
60,Pakistan,2015,PAK-15/DDA-3474/2nd Standard 2015/N/NGO/2144,3/3/2017 6:31:31 AM,Overall,0,11543,9427,8031,29001,0,20323,13524,13245,47092
60,Pakistan,2015,PAK-15/DDA-3474/2nd Standard 2015/N/NGO/2195,1/25/2017 12:41:19 PM,Internally Displaced People,0,6646,4618,4437,15701,0,9095,7828,4880,21803
60,Pakistan,2015,PAK-15/DDA-3474/2nd Standard 2015/N/NGO/2195,1/25/2017 12:41:19 PM,Overall,0,6646,4618,4437,15701,0,9095,7828,4880,21803
60,Pakistan,2015,PAK-15/DDA-3474/2nd Standard 2015/N/UN/2120,3/9/2017 11:04:16 AM,Internally Displaced People,0,6070,2275,2186,10531,0,6639,2486,2598,11723
60,Pakistan,2015,PAK-15/DDA-3474/2nd Standard 2015/N/UN/2120,3/9/2017 11:04:16 AM,Overall,0,6070,2275,2186,10531,0,6639,2486,0,9125
60,Pakistan,2015,PAK-15/DDA-3474/2nd Standard 2015/N/UN/2171,3/3/2017 6:53:56 AM,Host Communities,0,0,5474,5259,10733,0,0,0,0,0
60,Pakistan,2015,PAK-15/DDA-3474/2nd Standard 2015/N/UN/2171,3/3/2017 6:53:56 AM,Overall,0,8064,786,738,9588,0,16975,10711,14545,42231
60,Pakistan,2015,PAK-15/DDA-3474/2nd Standard 2015/WASH/NGO/2118,12/29/2016 9:43:07 AM,Other,2940,3060,5440,5227,16667,11582,13789,20311,21357,67039
60,Pakistan,2015,PAK-15/DDA-3474/2nd Standard 2015/WASH/NGO/2118,12/29/2016 9:43:07 AM,Overall,2940,3060,5440,5227,16667,11582,13789,20311,21357,67039
60,Pakistan,2015,PAK-15/DDA-3474/2nd Standard 2015/WASH/NGO/2188,6/13/2017 7:03:30 AM,Other,1000,3000,1600,1600,7200,1000,3000,1750,1450,7200
60,Pakistan,2015,PAK-15/DDA-3474/2nd Standard 2015/WASH/NGO/2188,6/13/2017 7:03:30 AM,Overall,1000,3000,1600,1600,7200,1000,3000,1750,1450,7200
60,Pakistan,2016,PAK-16/DDA-3474/1st Allocation 2016/E/NGO/2964,3/8/2017 4:34:06 AM,Internally Displaced People,180,180,1500,1500,3360,240,120,2000,1000,3360
60,Pakistan,2016,PAK-16/DDA-3474/1st Allocation 2016/E/NGO/2964,3/8/2017 4:34:06 AM,Overall,180,180,1500,1500,3360,240,120,2000,1000,3360
60,Pakistan,2016,PAK-16/DDA-3474/1st Allocation 2016/E/NGO/3062,9/18/2017 8:46:11 AM,Other,1354,1366,1440,1560,5720,1450,1420,1620,1580,6070
60,Pakistan,2016,PAK-16/DDA-3474/1st Allocation 2016/E/NGO/3062,9/18/2017 8:46:11 AM,Overall,1354,1366,1440,1560,5720,1450,1420,1620,1580,6070
60,Pakistan,2016,PAK-16/DDA-3474/1st Allocation 2016/E/NGO/3072,5/17/2017 11:08:02 AM,Other,136,136,1500,1500,3272,1456,1280,3679,3898,10313
60,Pakistan,2016,PAK-16/DDA-3474/1st Allocation 2016/E/NGO/3072,5/17/2017 11:08:02 AM,Overall,136,136,1500,1500,3272,1456,1280,3679,3898,10313
60,Pakistan,2016,PAK-16/DDA-3474/1st Allocation 2016/H/NGO/3007,9/28/2017 7:28:20 AM,Other,30,10,0,0,40,30,10,0,0,40
60,Pakistan,2016,PAK-16/DDA-3474/1st Allocation 2016/H/NGO/3007,9/28/2017 7:28:20 AM,Overall,5143,10180,9097,9855,34275,5143,10180,9097,9855,34275
60,Pakistan,2016,PAK-16/DDA-3474/1st Allocation 2016/H/NGO/3059,6/15/2017 5:06:24 AM,Other,3900,4350,3450,3300,15000,0,0,0,0,0
60,Pakistan,2016,PAK-16/DDA-3474/1st Allocation 2016/H/NGO/3059,6/15/2017 5:06:24 AM,Overall,6500,7250,5500,5750,25000,4330,8885,7518,7513,28246
60,Pakistan,2016,PAK-16/DDA-3474/1st Allocation 2016/H/NGO/3111,8/16/2017 10:20:55 AM,Internally Displaced People,3560,4607,6072,6701,20940,4825,5333,4611,4838,19607
60,Pakistan,2016,PAK-16/DDA-3474/1st Allocation 2016/H/NGO/3111,8/16/2017 10:20:55 AM,Overall,3560,4607,6072,6701,20940,4825,5333,4611,4838,19607
60,Pakistan,2016,PAK-16/DDA-3474/1st Allocation 2016/H/UN/3066,2/15/2018 11:06:00 AM,Internally Displaced People,1000,10000,500,1500,13000,0,0,0,0,0
60,Pakistan,2016,PAK-16/DDA-3474/1st Allocation 2016/H/UN/3066,2/15/2018 11:06:00 AM,Overall,1000,10000,500,1500,13000,569,21547,0,0,22116
60,Pakistan,2016,PAK-16/DDA-3474/1st Allocation 2016/N/NGO/2999,9/18/2017 11:02:58 AM,Host Communities,0,1900,1561,1464,4925,0,1479,992,1006,3477
60,Pakistan,2016,PAK-16/DDA-3474/1st Allocation 2016/N/NGO/2999,9/18/2017 11:02:58 AM,Internally Displaced People,0,4100,3122,2928,10150,0,3816,2571,2653,9040
60,Pakistan,2016,PAK-16/DDA-3474/1st Allocation 2016/N/NGO/2999,9/18/2017 11:02:58 AM,Overall,0,6000,4683,4392,15075,0,5295,3563,3659,12517
60,Pakistan,2016,PAK-16/DDA-3474/1st Allocation 2016/N/NGO/3043,4/24/2017 5:09:58 AM,Internally Displaced People,0,6000,4683,4392,15075,0,10591,5157,5559,21307
60,Pakistan,2016,PAK-16/DDA-3474/1st Allocation 2016/N/NGO/3043,4/24/2017 5:09:58 AM,Overall,0,6000,4683,4392,15075,0,10591,5157,5559,21307
60,Pakistan,2016,PAK-16/DDA-3474/1st Allocation 2016/N/UN/3070,3/3/2017 6:55:08 AM,Internally Displaced People,0,5507,1143,1190,7840,0,8588,2657,2765,14010
60,Pakistan,2016,PAK-16/DDA-3474/1st Allocation 2016/N/UN/3070,3/3/2017 6:55:08 AM,Overall,0,5507,1143,1190,7840,0,8588,2657,2765,14010
60,Pakistan,2016,PAK-16/DDA-3474/1st Allocation 2016/N/UN/3104,3/15/2017 11:59:13 AM,Overall,0,0,120,115,235,0,0,126,131,257
60,Pakistan,2016,PAK-16/DDA-3474/1st Allocation 2016/N/UN/3106,3/8/2017 6:13:48 AM,Host Communities,0,12000,9365,8785,30150,0,0,0,0,0
60,Pakistan,2016,PAK-16/DDA-3474/1st Allocation 2016/N/UN/3106,3/8/2017 6:13:48 AM,Overall,0,12000,9365,8785,30150,0,4967,6212,6537,17716
60,Pakistan,2016,PAK-16/DDA-3474/1st Allocation 2016/P/INGO/3057,5/30/2017 9:04:58 AM,Other,2472,2504,3373,3030,11379,4102,3569,2494,2989,13154
60,Pakistan,2016,PAK-16/DDA-3474/1st Allocation 2016/P/INGO/3057,5/30/2017 9:04:58 AM,Overall,2472,2504,3373,3030,11379,4102,3569,2494,2989,13154
60,Pakistan,2016,PAK-16/DDA-3474/1st Allocation 2016/P/INGO/3065,8/22/2017 9:24:05 AM,Internally Displaced People,900,880,400,390,2570,0,0,0,0,0
60,Pakistan,2016,PAK-16/DDA-3474/1st Allocation 2016/P/INGO/3065,8/22/2017 9:24:05 AM,Overall,900,880,400,390,2570,546,248,82,118,994
60,Pakistan,2016,PAK-16/DDA-3474/1st Allocation 2016/P/INGO/3068,8/18/2017 4:03:07 AM,Internally Displaced People,900,880,400,390,2570,0,0,0,0,0
60,Pakistan,2016,PAK-16/DDA-3474/1st Allocation 2016/P/INGO/3068,8/18/2017 4:03:07 AM,Overall,900,880,400,390,2570,814,138,4,2,958
60,Pakistan,2016,PAK-16/DDA-3474/1st Allocation 2016/P/NGO/3012,9/26/2017 7:36:31 AM,Other,120,2678,4776,5162,12736,120,3233,7495,4811,15659
60,Pakistan,2016,PAK-16/DDA-3474/1st Allocation 2016/P/NGO/3012,9/26/2017 7:36:31 AM,Overall,120,2678,4776,5162,12736,120,3233,7495,4811,15659
60,Pakistan,2016,PAK-16/DDA-3474/1st Allocation 2016/P/NGO/3033,4/24/2017 4:31:53 AM,Internally Displaced People,1816,2067,1172,1173,6228,1873,2067,1184,1173,6297
60,Pakistan,2016,PAK-16/DDA-3474/1st Allocation 2016/P/NGO/3033,4/24/2017 4:31:53 AM,Overall,1816,2067,1172,1173,6228,1873,2067,1184,1173,6297
60,Pakistan,2016,PAK-16/DDA-3474/1st Allocation 2016/P/NGO/3069,4/24/2017 5:31:40 AM,Other,275,1300,2400,2600,6575,310,865,3938,2164,7277
60,Pakistan,2016,PAK-16/DDA-3474/1st Allocation 2016/P/NGO/3069,4/24/2017 5:31:40 AM,Overall,275,1300,2400,2600,6575,0,0,0,0,0
60,Pakistan,2016,PAK-16/DDA-3474/1st Allocation 2016/P/UN/3102,2/15/2018 11:08:22 AM,Host Communities,100,500,100,200,900,0,0,0,0,0
60,Pakistan,2016,PAK-16/DDA-3474/1st Allocation 2016/P/UN/3102,2/15/2018 11:08:22 AM,Internally Displaced People,400,2500,400,800,4100,0,0,0,0,0
60,Pakistan,2016,PAK-16/DDA-3474/1st Allocation 2016/P/UN/3102,2/15/2018 11:08:22 AM,Overall,500,3000,500,1000,5000,653,10096,49,4914,15712
60,Pakistan,2016,PAK-16/DDA-3474/1st Allocation 2016/Shelter/NFI/INGO/3016,10/23/2017 5:43:43 AM,Internally Displaced People,397,414,485,504,1800,306,308,891,754,2259
60,Pakistan,2016,PAK-16/DDA-3474/1st Allocation 2016/Shelter/NFI/INGO/3016,10/23/2017 5:43:43 AM,Overall,397,414,485,504,1800,306,308,891,754,2259
60,Pakistan,2016,PAK-16/DDA-3474/1st Allocation 2016/Shelter/NFI/NGO/2972,9/18/2017 10:57:02 AM,Internally Displaced People,139,208,223,297,867,476,382,615,562,2035
60,Pakistan,2016,PAK-16/DDA-3474/1st Allocation 2016/Shelter/NFI/NGO/2972,9/18/2017 10:57:02 AM,Overall,139,208,223,297,867,476,382,615,562,2035
60,Pakistan,2016,PAK-16/DDA-3474/1st Allocation 2016/Shelter/NFI/NGO/3025,8/2/2017 10:34:12 AM,Internally Displaced People,370,352,537,455,1714,370,352,537,455,1714
60,Pakistan,2016,PAK-16/DDA-3474/1st Allocation 2016/Shelter/NFI/NGO/3025,8/2/2017 10:34:12 AM,Overall,370,352,537,455,1714,370,352,537,455,1714
60,Pakistan,2016,PAK-16/DDA-3474/1st Allocation 2016/Shelter/NFI/NGO/3064,10/12/2017 7:52:08 AM,Other,500,600,650,700,2450,290,322,695,551,1858
60,Pakistan,2016,PAK-16/DDA-3474/1st Allocation 2016/Shelter/NFI/NGO/3064,10/12/2017 7:52:08 AM,Overall,500,600,650,700,2450,290,322,695,551,1858
60,Pakistan,2016,PAK-16/DDA-3474/1st Allocation 2016/Shelter/NFI/NGO/3096,9/18/2017 10:55:45 AM,Internally Displaced People,246,268,186,204,904,356,312,385,258,1311
60,Pakistan,2016,PAK-16/DDA-3474/1st Allocation 2016/Shelter/NFI/NGO/3096,9/18/2017 10:55:45 AM,Overall,246,268,186,204,904,356,312,385,258,1311
60,Pakistan,2016,PAK-16/DDA-3474/1st Allocation 2016/WASH/NGO/2974,3/9/2017 11:05:14 AM,Other,2975,3180,2980,3140,12275,2975,3180,2980,3140,12275
60,Pakistan,2016,PAK-16/DDA-3474/1st Allocation 2016/WASH/NGO/2974,3/9/2017 11:05:14 AM,Overall,2975,3180,2980,3140,12275,2975,3180,2980,3140,12275
60,Pakistan,2016,PAK-16/DDA-3474/1st Allocation 2016/WASH/NGO/3020,4/24/2017 5:19:05 AM,Internally Displaced People,3469,3588,2512,2631,12200,2512,2631,3469,3588,12200
60,Pakistan,2016,PAK-16/DDA-3474/1st Allocation 2016/WASH/NGO/3020,4/24/2017 5:19:05 AM,Overall,3469,3588,2512,2631,12200,2512,2631,3469,3588,12200
60,Pakistan,2016,PAK-16/DDA-3474/1st Allocation 2016/WASH/NGO/3089,5/1/2017 7:10:40 AM,Internally Displaced People,0,0,0,0,0,6366,6932,2583,2723,18604
60,Pakistan,2016,PAK-16/DDA-3474/1st Allocation 2016/WASH/NGO/3089,5/1/2017 7:10:40 AM,Other,2153,2153,4709,4440,13455,0,0,0,0,0
60,Pakistan,2016,PAK-16/DDA-3474/1st Allocation 2016/WASH/NGO/3089,5/1/2017 7:10:40 AM,Overall,2153,2153,4709,4440,13455,6366,6932,2583,2723,18604
60,Pakistan,2016,PAK-16/DDA-3474/1st Allocation 2016/WASH/NGO/3100,8/18/2017 3:59:53 AM,Other,2830,2945,2315,2410,10500,4748,5150,3896,3897,17691
60,Pakistan,2016,PAK-16/DDA-3474/1st Allocation 2016/WASH/NGO/3100,8/18/2017 3:59:53 AM,Overall,2830,2945,2315,2410,10500,4748,5150,3896,3897,17691
60,Pakistan,2016,PAK-16/DDA-3474/1st Allocation 2016/WASH/NGO/3110,8/2/2017 10:10:05 AM,Overall,2400,2160,1690,1890,8140,4237,3945,3068,3360,14610
60,Pakistan,2016,PAK-16/DDA-3474/1st Reserve Allocation 2016/CSS/UN/4429,3/13/2018 10:51:58 AM,Internally Displaced People,392403,347980,0,0,740383,482885,260015,0,0,742900
60,Pakistan,2016,PAK-16/DDA-3474/1st Reserve Allocation 2016/CSS/UN/4429,3/13/2018 10:51:58 AM,Overall,392403,347980,0,0,740383,482885,260015,0,0,742900
60,Pakistan,2016,PAK-16/DDA-3474/1st Reserve Allocation 2016/CSS/UN/4430,12/7/2022 6:08:12 AM,Overall,520,280,0,0,800,711,106,0,0,817
60,Pakistan,2017,PAK-17/DDA-3474/1st Standard Allocation 2017/E/NGO/5829,8/3/2018 6:03:30 AM,Internally Displaced People,60,65,600,600,1325,90,35,900,300,1325
60,Pakistan,2017,PAK-17/DDA-3474/1st Standard Allocation 2017/E/NGO/5829,8/3/2018 6:03:30 AM,Overall,60,65,600,600,1325,90,35,900,300,1325
60,Pakistan,2017,PAK-17/DDA-3474/1st Standard Allocation 2017/E/NGO/5904,10/26/2018 7:38:20 AM,Other,1020,1186,824,1030,4060,1050,1218,1168,1091,4527
60,Pakistan,2017,PAK-17/DDA-3474/1st Standard Allocation 2017/E/NGO/5904,10/26/2018 7:38:20 AM,Overall,1020,1186,824,1030,4060,1050,1218,1168,1091,4527
60,Pakistan,2017,PAK-17/DDA-3474/1st Standard Allocation 2017/H/NGO/6028,5/13/2022 7:11:24 AM,Internally Displaced People,5407,4888,4045,3810,18150,4002,8687,5012,6002,23703
60,Pakistan,2017,PAK-17/DDA-3474/1st Standard Allocation 2017/H/NGO/6028,5/13/2022 7:11:24 AM,Overall,5407,4888,4045,3810,18150,4002,8687,5012,6002,23703
60,Pakistan,2017,PAK-17/DDA-3474/1st Standard Allocation 2017/H/NGO/6080,9/24/2018 9:56:37 AM,Overall,6583,10807,12946,14024,44360,10208,19323,9218,7619,46368
60,Pakistan,2017,PAK-17/DDA-3474/1st Standard Allocation 2017/H/NGO/6082,8/30/2018 5:58:15 AM,Other,2600,2900,2200,2300,10000,12110,13508,10246,10713,46577
60,Pakistan,2017,PAK-17/DDA-3474/1st Standard Allocation 2017/H/NGO/6082,8/30/2018 5:58:15 AM,Overall,9100,10150,7700,8050,35000,12110,13507,10247,10713,46577
60,Pakistan,2017,PAK-17/DDA-3474/1st Standard Allocation 2017/N/NGO/5882,9/25/2018 4:36:44 AM,Internally Displaced People,0,1530,1066,980,3576,0,9017,1153,1051,11221
60,Pakistan,2017,PAK-17/DDA-3474/1st Standard Allocation 2017/N/NGO/5882,9/25/2018 4:36:44 AM,Overall,0,1530,1066,980,3576,0,1539,964,1112,3615
60,Pakistan,2017,PAK-17/DDA-3474/1st Standard Allocation 2017/N/NGO/5943,9/24/2018 10:05:09 AM,Internally Displaced People,0,3060,2132,1960,7152,8239,28259,17769,16337,70604
60,Pakistan,2017,PAK-17/DDA-3474/1st Standard Allocation 2017/N/NGO/5943,9/24/2018 10:05:09 AM,Overall,0,3400,2428,2233,8061,0,2482,1781,2197,6460
60,Pakistan,2017,PAK-17/DDA-3474/1st Standard Allocation 2017/N/UN/5926,10/14/2019 8:09:10 AM,Other,0,20000,875,850,21725,0,20000,895,830,21725
60,Pakistan,2017,PAK-17/DDA-3474/1st Standard Allocation 2017/N/UN/5926,10/14/2019 8:09:10 AM,Overall,0,20000,875,850,21725,0,31523,726,921,33170
60,Pakistan,2017,PAK-17/DDA-3474/1st Standard Allocation 2017/N/UN/6044,10/25/2018 9:36:04 AM,Internally Displaced People,0,2631,1409,1295,5335,0,3228,1911,2733,7872
60,Pakistan,2017,PAK-17/DDA-3474/1st Standard Allocation 2017/N/UN/6044,10/25/2018 9:36:04 AM,Overall,0,2631,1409,1295,5335,0,4021,1848,2003,7872
60,Pakistan,2017,PAK-17/DDA-3474/1st Standard Allocation 2017/Shelter/NFI/NGO/6192,8/30/2018 6:06:47 AM,Internally Displaced People,402,804,724,750,2680,737,0,0,0,737
60,Pakistan,2017,PAK-17/DDA-3474/1st Standard Allocation 2017/Shelter/NFI/NGO/6192,8/30/2018 6:06:47 AM,Overall,402,804,724,750,2680,454,431,639,499,2023
60,Pakistan,2017,PAK-17/DDA-3474/1st Standard Allocation 2017/WASH/INGO/6045,2/6/2019 8:41:29 AM,Other,32888,26908,26908,22016,108720,56879,61056,56067,63189,237191
60,Pakistan,2017,PAK-17/DDA-3474/1st Standard Allocation 2017/WASH/INGO/6045,2/6/2019 8:41:29 AM,Overall,32888,26908,26908,22016,108720,56880,61055,56068,63190,237193
60,Pakistan,2017,PAK-17/DDA-3474/1st Standard Allocation 2017/WASH/NGO/5870,8/3/2018 6:10:24 AM,Overall,5500,6500,6000,6000,24000,5707,6868,5734,6543,24852
60,Pakistan,2017,PAK-17/DDA-3474/1st Standard Allocation 2017/WASH/NGO/5880,9/7/2018 9:35:43 AM,Overall,8040,8729,2977,3225,22971,8039,8728,2977,3225,22969
60,Pakistan,2017,PAK-17/DDA-3474/1st Standard Allocation 2017/WASH/NGO/6054,8/30/2018 6:00:25 AM,Internally Displaced People,4577,4795,6320,6538,22230,4577,4795,6320,6538,22230
60,Pakistan,2017,PAK-17/DDA-3474/1st Standard Allocation 2017/WASH/NGO/6054,8/30/2018 6:00:25 AM,Overall,4577,4795,6320,6538,22230,4577,4795,6320,6538,22230
60,Pakistan,2018,PAK-18/DDA-3474/PAK 18/H/NGO/7832,8/8/2019 12:02:37 PM,Internally Displaced People,6810,9600,8400,8640,33450,8111,16187,6582,6172,37052
60,Pakistan,2018,PAK-18/DDA-3474/PAK 18/H/NGO/7832,8/8/2019 12:02:37 PM,Overall,6810,9600,8400,8640,33450,8111,16187,6582,6172,37052
60,Pakistan,2018,PAK-18/DDA-3474/PAK 18/H/NGO/7853,8/27/2019 10:12:58 AM,Other,9562,16985,20403,18550,65500,18991,18116,17283,13330,67720
60,Pakistan,2018,PAK-18/DDA-3474/PAK 18/H/NGO/7853,8/27/2019 10:12:58 AM,Overall,9562,16985,20403,18550,65500,18991,18116,17283,13330,67720
60,Pakistan,2018,PAK-18/DDA-3474/PAK 18/H/NGO/7918,7/2/2019 6:34:58 AM,Overall,5365,10227,8300,8988,32880,8133,17041,6419,5480,37073
60,Pakistan,2018,PAK-18/DDA-3474/PAK 18/Shelter/NFI/NGO/7783,3/22/2019 7:42:17 AM,Internally Displaced People,429,468,331,352,1580,527,579,521,563,2190
60,Pakistan,2018,PAK-18/DDA-3474/PAK 18/Shelter/NFI/NGO/7783,3/22/2019 7:42:17 AM,Overall,429,468,331,352,1580,527,579,521,563,2190
60,Pakistan,2018,PAK-18/DDA-3474/PAK 18/Shelter/NFI/NGO/7849,6/12/2019 6:33:01 AM,Internally Displaced People,456,912,821,851,3040,0,0,0,0,0
60,Pakistan,2018,PAK-18/DDA-3474/PAK 18/Shelter/NFI/NGO/7849,6/12/2019 6:33:01 AM,Overall,456,912,821,851,3040,551,619,747,519,2436
60,Pakistan,2018,PAK-18/DDA-3474/PAK 18/WASH/INGO/7754,3/3/2020 6:10:05 AM,Internally Displaced People,13744,14306,11245,11705,51000,14533,15076,11843,12380,53832
60,Pakistan,2018,PAK-18/DDA-3474/PAK 18/WASH/INGO/7754,3/3/2020 6:10:05 AM,Overall,13744,14306,11245,11705,51000,14533,15076,11843,12380,53832
60,Pakistan,2018,PAK-18/DDA-3474/PAK 18/WASH/INGO/7812,12/31/2019 6:48:11 AM,Host Communities,3675,3825,5430,5259,18189,3937,3744,5566,4848,18095
60,Pakistan,2018,PAK-18/DDA-3474/PAK 18/WASH/INGO/7812,12/31/2019 6:48:11 AM,Overall,3675,3825,5430,5259,18189,3937,3744,5566,4848,18095
60,Pakistan,2018,PAK-18/DDA-3474/PAK 18/WASH/INGO/7868,10/14/2019 8:23:42 AM,Internally Displaced People,13326,12691,2539,3172,31728,14045,12707,2675,4013,33440
60,Pakistan,2018,PAK-18/DDA-3474/PAK 18/WASH/INGO/7868,10/14/2019 8:23:42 AM,Overall,13326,12691,2539,3172,31728,14045,12707,2675,4013,33440
60,Pakistan,2018,PAK-18/DDA-3474/PAK 18/WASH/NGO/7962,8/27/2019 10:26:33 AM,Overall,7140,8330,7140,7140,29750,6000,7250,7000,9500,29750
60,Pakistan,2018,PAK-18/DDA-3474/PAK 18/WASH/NGO/7969,10/14/2019 8:13:51 AM,Internally Displaced People,4557,4743,3038,3162,15500,18030,18486,10980,11303,58799
60,Pakistan,2018,PAK-18/DDA-3474/PAK 18/WASH/NGO/7969,10/14/2019 8:13:51 AM,Overall,4557,4743,3038,3162,15500,18030,18486,10980,11303,58799
60,Pakistan,2018,PAK-18/DDA-3474/PAK 18/WASH/NGO/7995,8/27/2019 10:34:08 AM,Internally Displaced People,3000,3200,3800,4000,14000,3000,3200,3800,4000,14000
60,Pakistan,2018,PAK-18/DDA-3474/PAK 18/WASH/NGO/7995,8/27/2019 10:34:08 AM,Overall,3000,3200,3800,4000,14000,3000,3200,3800,4000,14000
60,Pakistan,2018,PAK-18/DDA-3474/PAK/H/NGO/8794,2/25/2020 6:38:43 AM,Internally Displaced People,863,772,600,522,2757,17021,26370,17827,19151,80369
60,Pakistan,2018,PAK-18/DDA-3474/PAK/H/NGO/8794,2/25/2020 6:38:43 AM,Overall,863,772,600,522,2757,17021,26370,17827,19151,80369
60,Pakistan,2019,PAK-19/DDA-3474/PAK/FS/NGO/11956,2/7/2020 4:32:11 AM,Host Communities,2170,3452,9590,8788,24000,2213,3472,9590,8788,24063
60,Pakistan,2019,PAK-19/DDA-3474/PAK/FS/NGO/11956,2/7/2020 4:32:11 AM,Overall,2170,3452,9590,8788,24000,2213,3472,9590,8788,24063
60,Pakistan,2019,PAK-19/DDA-3474/PAK/FS/UN/12235,1/17/2022 9:52:23 AM,Other,40233,36216,21191,19075,116715,47387,46112,25059,24052,142610
60,Pakistan,2019,PAK-19/DDA-3474/PAK/FS/UN/12235,1/17/2022 9:52:23 AM,Overall,40233,36216,21191,19075,116715,47387,46112,25059,24052,142610
60,Pakistan,2019,PAK-19/DDA-3474/PAK/FS-WASH/INGO/12011,9/23/2020 7:42:50 AM,Host Communities,2565,2066,2099,2238,8968,9238,9456,5259,5100,29053
60,Pakistan,2019,PAK-19/DDA-3474/PAK/FS-WASH/INGO/12011,9/23/2020 7:42:50 AM,Overall,2565,2066,2099,2238,8968,9238,9456,5259,5100,29053
60,Pakistan,2019,PAK-19/DDA-3474/PAK/FS-WASH/NGO/12136,11/10/2020 2:05:11 PM,Host Communities,3040,3380,4240,4340,15000,3040,3380,4240,4340,15000
60,Pakistan,2019,PAK-19/DDA-3474/PAK/FS-WASH/NGO/12136,11/10/2020 2:05:11 PM,Overall,3040,3380,4240,4340,15000,3040,3380,4240,4340,15000
60,Pakistan,2019,PAK-19/DDA-3474/PAK/H/NGO/11765,2/21/2020 5:45:19 AM,Internally Displaced People,3000,3000,9000,9000,24000,3000,3000,9000,9000,24000
60,Pakistan,2019,PAK-19/DDA-3474/PAK/H/NGO/11765,2/21/2020 5:45:19 AM,Overall,7000,7000,21000,21000,56000,7000,7000,21000,21000,56000
60,Pakistan,2019,PAK-19/DDA-3474/PAK/H/NGO/11765,2/21/2020 5:45:19 AM,Returnees,4000,4000,12000,12000,32000,4000,4000,12000,12000,32000
60,Pakistan,2019,PAK-19/DDA-3474/PAK/H-FS-WASH/NGO/12228,5/5/2020 9:54:21 AM,Host Communities,12329,13336,11209,13126,50000,19185,11207,17079,16057,63528
60,Pakistan,2019,PAK-19/DDA-3474/PAK/H-FS-WASH/NGO/12228,5/5/2020 9:54:21 AM,Overall,12329,13336,11209,13126,50000,19185,11207,17079,16057,63528
60,Pakistan,2019,PAK-19/DDA-3474/PAK/H-N-WASH/UN/12222,4/22/2020 7:24:04 AM,Other,4600,123860,59803,57418,245681,7798,147709,45449,50298,251254
60,Pakistan,2019,PAK-19/DDA-3474/PAK/H-N-WASH/UN/12222,4/22/2020 7:24:04 AM,Overall,4600,123860,59803,57418,245681,7798,147709,45449,50298,251254
60,Pakistan,2019,PAK-19/DDA-3474/PAK/H-WASH/INGO/11795,3/3/2020 6:13:04 AM,Host Communities,16170,16830,13230,13770,60000,19759,20565,16166,16827,73317
60,Pakistan,2019,PAK-19/DDA-3474/PAK/H-WASH/INGO/11795,3/3/2020 6:13:04 AM,Overall,16170,16830,13230,13770,60000,19759,20565,16166,16827,73317
60,Pakistan,2019,PAK-19/DDA-3474/PAK/N/UN/12231,4/28/2021 10:28:56 AM,Other,0,3000,1050,900,4950,0,5301,1268,1160,7729
60,Pakistan,2019,PAK-19/DDA-3474/PAK/N/UN/12231,4/28/2021 10:28:56 AM,Overall,0,3000,1050,900,4950,0,5301,1268,1160,7729
60,Pakistan,2019,PAK-19/DDA-3474/PAK/N/UN/12232,6/7/2022 9:35:53 AM,Host Communities,0,2778,2952,3073,8803,0,1111,833,834,2778
60,Pakistan,2019,PAK-19/DDA-3474/PAK/N/UN/12232,6/7/2022 9:35:53 AM,Overall,0,2778,2952,3073,8803,0,1111,833,834,2778
60,Pakistan,2019,PAK-19/DDA-3474/PAK/WASH/INGO/12239,3/16/2020 5:46:44 AM,Other,11086,9936,12837,11041,44900,7320,7120,12422,10136,36998
60,Pakistan,2019,PAK-19/DDA-3474/PAK/WASH/INGO/12239,3/16/2020 5:46:44 AM,Overall,11086,9936,12837,11041,44900,7320,7120,12422,10136,36998
60,Pakistan,2019,PAK-19/DDA-3474/PAK/WASH/NGO/12006,2/5/2020 5:05:07 AM,Host Communities,62655,56733,44574,38692,202654,62655,56733,44574,38692,202654
60,Pakistan,2019,PAK-19/DDA-3474/PAK/WASH/NGO/12006,2/5/2020 5:05:07 AM,Overall,62655,56733,44574,38692,202654,62655,56733,44574,38692,202654
60,Pakistan,2019,PAK-19/DDA-3474/PAK/WASH/NGO/12012,10/21/2022 10:01:13 AM,Host Communities,15910,13018,9225,7547,45700,13987,15345,10198,11229,50759
60,Pakistan,2019,PAK-19/DDA-3474/PAK/WASH/NGO/12012,10/21/2022 10:01:13 AM,Overall,15910,13018,9225,7547,45700,13987,15345,10198,11229,50759
60,Pakistan,2019,PAK-19/DDA-3474/PAK/WASH-FS/NGO/11796,1/1/2020 6:31:25 AM,Host Communities,10449,10193,5527,5304,31473,12823,11508,7106,6646,38083
60,Pakistan,2019,PAK-19/DDA-3474/PAK/WASH-FS/NGO/11796,1/1/2020 6:31:25 AM,Internally Displaced People,107,104,56,54,321,135,147,98,93,473
60,Pakistan,2019,PAK-19/DDA-3474/PAK/WASH-FS/NGO/11796,1/1/2020 6:31:25 AM,Overall,10771,10506,5696,5467,32440,13181,11900,7340,6874,39295
60,Pakistan,2019,PAK-19/DDA-3474/PAK/WASH-FS/NGO/11796,1/1/2020 6:31:25 AM,Refugees,215,209,113,109,646,223,245,136,135,739
60,Pakistan,2019,PAK-19/DDA-3474/PAK-19/RA2/H/NGO/13689,4/7/2022 11:16:27 AM,Internally Displaced People,2360,6480,2760,4000,15600,3898,6912,2145,4150,17105
60,Pakistan,2019,PAK-19/DDA-3474/PAK-19/RA2/H/NGO/13689,4/7/2022 11:16:27 AM,Overall,5900,16200,6900,10000,39000,7478,15747,6259,9809,39293
60,Pakistan,2019,PAK-19/DDA-3474/PAK-19/RA2/H/NGO/13689,4/7/2022 11:16:27 AM,Returnees,3540,9720,4140,6000,23400,3580,8835,4114,5659,22188
60,Pakistan,2019,PAK-19/DDA-3474/PAK-19/RA2/H/NGO/13690,9/22/2020 5:51:18 AM,Overall,37260,47610,64170,47610,196650,41586,52530,72229,52530,218875
60,Pakistan,2019,PAK-19/DDA-3474/PAK-19/RA2/H/NGO/13690,9/22/2020 5:51:18 AM,Returnees,37260,47610,64170,47610,196650,41586,52530,72229,52530,218875
60,Pakistan,2019,PAK-19/DDA-3474/PAK-19/RA2/N/UN/13688,8/19/2020 8:51:57 AM,Other,0,21719,20305,19046,61070,2108,24302,25041,25718,77169
60,Pakistan,2019,PAK-19/DDA-3474/PAK-19/RA2/N/UN/13688,8/19/2020 8:51:57 AM,Overall,0,21719,20305,19046,61070,2108,24302,25041,25718,77169
60,Pakistan,2019,PAK-19/DDA-3474/PAK-19/RA2/N/UN/13696,4/28/2021 10:42:25 AM,Other,0,4200,717,685,5602,0,5238,1158,1513,7909
60,Pakistan,2019,PAK-19/DDA-3474/PAK-19/RA2/N/UN/13696,4/28/2021 10:42:25 AM,Overall,0,4200,717,685,5602,0,5238,1158,1513,7909
60,Pakistan,2019,PAK-19/DDA-3474/PAK-19/RA2/N/UN/13698,6/7/2022 6:38:19 AM,Host Communities,0,5278,3360,3640,12278,0,2512,1901,1983,6396
60,Pakistan,2019,PAK-19/DDA-3474/PAK-19/RA2/N/UN/13698,6/7/2022 6:38:19 AM,Overall,0,5278,3360,3640,12278,0,2512,1901,1983,6396
60,Pakistan,2019,PAK-19/DDA-3474/PAK-19/RA2/WASH/INGO/13687,3/19/2022 10:38:19 AM,Overall,14250,14495,11652,8389,48786,14250,14495,11652,8389,48786
60,Pakistan,2019,PAK-19/DDA-3474/PAK-19/RA2/WASH/INGO/13687,3/19/2022 10:38:19 AM,Returnees,14250,14495,11652,8389,48786,14250,14495,11652,8389,48786
60,Pakistan,2019,PAK-19/DDA-3474/PAK-19/RA2/WASH/INGO/13693,1/22/2021 7:38:34 AM,Internally Displaced People,2379,2470,2105,2196,9150,2773,2943,1752,2165,9633
60,Pakistan,2019,PAK-19/DDA-3474/PAK-19/RA2/WASH/INGO/13693,1/22/2021 7:38:34 AM,Overall,2379,2470,2105,2196,9150,2773,2943,1752,2165,9633
60,Pakistan,2019,PAK-19/DDA-3474/PAK-19/RA2/WASH/NGO/13692,12/20/2020 12:03:49 PM,Overall,14700,15300,9800,10200,50000,14947,17791,14299,15709,62746
60,Pakistan,2019,PAK-19/DDA-3474/PAK-19/RA2/WASH/NGO/13692,12/20/2020 12:03:49 PM,Returnees,14700,15300,9800,10200,50000,14947,17791,14299,15709,62746
60,Pakistan,2020,PAK-20/DDA-3474/PAK/FS/INGO/17133,11/11/2021 8:12:03 AM,Host Communities,780,780,1560,1560,4680,1495,1439,1800,1603,6337
60,Pakistan,2020,PAK-20/DDA-3474/PAK/FS/INGO/17133,11/11/2021 8:12:03 AM,Internally Displaced People,50,50,80,80,260,96,96,110,85,387
60,Pakistan,2020,PAK-20/DDA-3474/PAK/FS/INGO/17133,11/11/2021 8:12:03 AM,Overall,880,880,1720,1720,5200,1681,1625,1955,1818,7079
60,Pakistan,2020,PAK-20/DDA-3474/PAK/FS/INGO/17133,11/11/2021 8:12:03 AM,Refugees,50,50,80,80,260,90,90,45,130,355
60,Pakistan,2020,PAK-20/DDA-3474/PAK/FS/INGO/17135,11/11/2021 8:00:13 AM,Host Communities,6674,7777,10653,11756,36860,6529,7493,5939,5571,25532
60,Pakistan,2020,PAK-20/DDA-3474/PAK/FS/INGO/17135,11/11/2021 8:00:13 AM,Other,3600,4200,5800,6400,20000,9787,8495,10041,5109,33432
60,Pakistan,2020,PAK-20/DDA-3474/PAK/FS/INGO/17135,11/11/2021 8:00:13 AM,Overall,10274,11977,16453,18156,56860,16316,15988,15980,10680,58964
60,Pakistan,2020,PAK-20/DDA-3474/PAK/FS/INGO/17446,11/11/2021 7:55:02 AM,Other,284027,272889,426040,409333,1392289,6103,5710,9446,7711,28970
60,Pakistan,2020,PAK-20/DDA-3474/PAK/FS/INGO/17446,11/11/2021 7:55:02 AM,Overall,284027,272889,426040,409333,1392289,6103,5710,9446,7711,28970
60,Pakistan,2020,PAK-20/DDA-3474/PAK/FS/NGO/17119,3/6/2022 9:01:31 AM,Host Communities,5128,4770,2485,2462,14845,6187,5793,6473,7337,25790
60,Pakistan,2020,PAK-20/DDA-3474/PAK/FS/NGO/17119,3/6/2022 9:01:31 AM,Overall,5585,5247,3047,3046,16925,6187,5793,6473,7337,25790
60,Pakistan,2020,PAK-20/DDA-3474/PAK/FS/NGO/17119,3/6/2022 9:01:31 AM,Refugees,457,477,562,584,2080,0,0,0,0,0
60,Pakistan,2020,PAK-20/DDA-3474/PAK/FS/NGO/17123,2/1/2022 10:25:46 AM,Host Communities,1480,1240,0,0,2720,1480,1240,0,0,2720
60,Pakistan,2020,PAK-20/DDA-3474/PAK/FS/NGO/17123,2/1/2022 10:25:46 AM,Overall,1840,1480,0,0,3320,1480,1840,0,0,3320
60,Pakistan,2020,PAK-20/DDA-3474/PAK/FS/NGO/17123,2/1/2022 10:25:46 AM,Refugees,360,240,0,0,600,0,600,0,0,600
60,Pakistan,2020,PAK-20/DDA-3474/PAK/FS/NGO/17125,11/11/2021 8:16:43 AM,Other,3470,3470,10410,6940,24290,3470,3470,10410,6940,24290
60,Pakistan,2020,PAK-20/DDA-3474/PAK/FS/NGO/17125,11/11/2021 8:16:43 AM,Overall,3470,3470,10410,6940,24290,3470,3470,10410,6940,24290
60,Pakistan,2020,PAK-20/DDA-3474/PAK/FS/NGO/17127,10/31/2021 10:04:27 AM,Host Communities,1906,2118,3177,3389,10590,1798,2418,2996,3196,10408
60,Pakistan,2020,PAK-20/DDA-3474/PAK/FS/NGO/17127,10/31/2021 10:04:27 AM,Overall,3331,3694,5036,5439,17500,2997,4030,4994,5327,17348
60,Pakistan,2020,PAK-20/DDA-3474/PAK/FS/NGO/17127,10/31/2021 10:04:27 AM,Refugees,1425,1576,1859,2050,6910,1199,1612,1998,2131,6940
60,Pakistan,2020,PAK-20/DDA-3474/PAK/FS/NGO/17139,1/31/2023 9:04:22 AM,Other,4856,5056,4859,5053,19824,2480,2231,2019,2480,9210
60,Pakistan,2020,PAK-20/DDA-3474/PAK/FS/NGO/17139,1/31/2023 9:04:22 AM,Overall,4856,5056,4859,5053,19824,2480,2231,2019,2480,9210
60,Pakistan,2020,PAK-20/DDA-3474/PAK/FS/NGO/17157,10/31/2021 10:07:14 AM,Host Communities,1100,1400,350,350,3200,1245,1492,213,250,3200
60,Pakistan,2020,PAK-20/DDA-3474/PAK/FS/NGO/17157,10/31/2021 10:07:14 AM,Other,20,10,10,15,55,15,17,8,10,50
60,Pakistan,2020,PAK-20/DDA-3474/PAK/FS/NGO/17157,10/31/2021 10:07:14 AM,Overall,1120,1410,360,365,3255,1260,1509,221,260,3250
60,Pakistan,2020,PAK-20/DDA-3474/PAK/FS/NGO/17447,4/28/2021 10:21:30 AM,Other,11390,11538,7122,7050,37100,6658,6706,9600,8532,31496
60,Pakistan,2020,PAK-20/DDA-3474/PAK/FS/NGO/17447,4/28/2021 10:21:30 AM,Overall,11390,11538,7122,7050,37100,6658,6706,9600,8532,31496
60,Pakistan,2020,PAK-20/DDA-3474/PAK/FS/UN/17451,1/30/2023 11:01:16 AM,Host Communities,18980,18100,17550,16870,71500,18980,18100,17550,16870,71500
60,Pakistan,2020,PAK-20/DDA-3474/PAK/FS/UN/17451,1/30/2023 11:01:16 AM,Overall,18980,18100,17550,16870,71500,18980,18100,17550,16870,71500
60,Pakistan,2020,PAK-20/DDA-3474/PAK/H/NGO/16170,2/9/2021 6:54:13 AM,Host Communities,60000,50000,30000,40000,180000,60000,50000,30000,40000,180000
60,Pakistan,2020,PAK-20/DDA-3474/PAK/H/NGO/16170,2/9/2021 6:54:13 AM,Overall,60000,50000,30000,40000,180000,60000,50000,30000,40000,180000
60,Pakistan,2020,PAK-20/DDA-3474/PAK/H/NGO/16177,2/8/2021 10:33:07 AM,Other,987,3579,1020,980,6566,2099,5278,1000,1000,9377
60,Pakistan,2020,PAK-20/DDA-3474/PAK/H/NGO/16177,2/8/2021 10:33:07 AM,Overall,987,3579,1020,980,6566,2099,5278,1000,1000,9377
60,Pakistan,2020,PAK-20/DDA-3474/PAK/H/NGO/16193,11/11/2021 8:01:35 AM,Host Communities,25000,25000,12500,12500,75000,36401,44636,12133,14878,108048
60,Pakistan,2020,PAK-20/DDA-3474/PAK/H/NGO/16193,11/11/2021 8:01:35 AM,Overall,30000,28000,15000,15000,88000,36401,44636,12133,14878,108048
60,Pakistan,2020,PAK-20/DDA-3474/PAK/H/NGO/16193,11/11/2021 8:01:35 AM,Refugees,5000,3000,2500,2500,13000,0,0,0,0,0
60,Pakistan,2020,PAK-20/DDA-3474/PAK/H/NGO/16247,2/8/2021 10:22:51 AM,Other,11628,14688,17136,17748,61200,22693,22754,16630,14977,77054
60,Pakistan,2020,PAK-20/DDA-3474/PAK/H/NGO/16247,2/8/2021 10:22:51 AM,Overall,12920,16320,19040,19720,68000,23856,23880,17854,16175,81765
60,Pakistan,2020,PAK-20/DDA-3474/PAK/H/NGO/16247,2/8/2021 10:22:51 AM,Refugees,1292,1632,1904,1972,6800,1163,1126,1224,1198,4711
60,Pakistan,2020,PAK-20/DDA-3474/PAK/H/UN/16119,10/31/2021 9:52:26 AM,Other,8189,3523,337,107,12156,8189,3523,337,107,12156
60,Pakistan,2020,PAK-20/DDA-3474/PAK/H/UN/16119,10/31/2021 9:52:26 AM,Overall,8189,3523,337,107,12156,8189,3523,337,107,12156
60,Pakistan,2020,PAK-20/DDA-3474/PAK/WASH/INGO/17444,3/13/2021 11:10:21 AM,Host Communities,6535,6415,11525,11375,35850,6591,6900,11626,11405,36522
60,Pakistan,2020,PAK-20/DDA-3474/PAK/WASH/INGO/17444,3/13/2021 11:10:21 AM,Overall,6535,6415,11525,11375,35850,6591,6900,11626,11405,36522
60,Pakistan,2020,PAK-20/DDA-3474/PAK/WASH/NGO/17443,3/13/2021 11:06:13 AM,Internally Displaced People,11940,12265,7133,7362,38700,5507,6057,13497,15701,40762
60,Pakistan,2020,PAK-20/DDA-3474/PAK/WASH/NGO/17443,3/13/2021 11:06:13 AM,Overall,11940,12265,7133,7362,38700,5507,6057,13497,15701,40762
60,Pakistan,2020,PAK-20/DDA-3474/PAK/WASH/NGO/17445,10/20/2022 9:15:32 AM,Internally Displaced People,36472,35042,21145,20316,112975,36472,35042,21145,20316,112975
60,Pakistan,2020,PAK-20/DDA-3474/PAK/WASH/NGO/17445,10/20/2022 9:15:32 AM,Overall,36472,35042,21145,20316,112975,36472,35042,21145,20316,112975
60,Pakistan,2020,PAK-20/DDA-3474/PAK/WASH/NGO/17450,3/13/2021 11:18:42 AM,Internally Displaced People,11549,10927,19869,18905,61250,11590,10977,19934,18929,61430
60,Pakistan,2020,PAK-20/DDA-3474/PAK/WASH/NGO/17450,3/13/2021 11:18:42 AM,Overall,11549,10927,19869,18905,61250,11590,10977,19934,18929,61430
60,Pakistan,2021,PAK-21/DDA-3474/PAK/H/NGO/19945,5/13/2022 6:26:35 AM,Host Communities,17272,20412,18842,21983,78509,12793,25969,20729,24642,84133
60,Pakistan,2021,PAK-21/DDA-3474/PAK/H/NGO/19945,5/13/2022 6:26:35 AM,Other,198,0,0,0,198,1,0,0,0,1
60,Pakistan,2021,PAK-21/DDA-3474/PAK/H/NGO/19945,5/13/2022 6:26:35 AM,Overall,19206,22464,20736,24192,86598,13459,27699,21137,25225,87520
60,Pakistan,2021,PAK-21/DDA-3474/PAK/H/NGO/19945,5/13/2022 6:26:35 AM,Refugees,1736,2052,1894,2209,7891,665,1730,408,583,3386
60,Pakistan,2021,PAK-21/DDA-3474/PAK/H/NGO/19966,5/30/2022 1:49:00 PM,Host Communities,58000,57000,26000,25000,166000,58000,57000,26000,25000,166000
60,Pakistan,2021,PAK-21/DDA-3474/PAK/H/NGO/19966,5/30/2022 1:49:00 PM,Overall,66000,65000,31000,30500,192500,66000,65000,31000,30500,192500
60,Pakistan,2021,PAK-21/DDA-3474/PAK/H/NGO/19966,5/30/2022 1:49:00 PM,Refugees,8000,8000,5000,5500,26500,8000,8000,5000,5500,26500
60,Pakistan,2021,PAK-21/DDA-3474/PAK/H/NGO/19968,6/13/2022 9:57:37 AM,Host Communities,24698,22798,5421,5004,57921,31437,37972,5350,7871,82630
60,Pakistan,2021,PAK-21/DDA-3474/PAK/H/NGO/19968,6/13/2022 9:57:37 AM,Overall,27290,25191,5990,5529,64000,35652,39839,5350,7871,88712
60,Pakistan,2021,PAK-21/DDA-3474/PAK/H/NGO/19968,6/13/2022 9:57:37 AM,Refugees,2592,2393,569,525,6079,4215,1867,0,0,6082
60,Pakistan,2021,PAK-21/DDA-3474/PAK/H/UN/19965,4/28/2022 10:21:13 AM,Host Communities,3300,2700,2400,1600,10000,3300,2700,2400,1600,10000
60,Pakistan,2021,PAK-21/DDA-3474/PAK/H/UN/19965,4/28/2022 10:21:13 AM,Overall,3300,2700,2400,1600,10000,3300,2700,2400,1600,10000
21,Somalia,2015,SOM-15/3485/ER /WASH/INGO/4364,2/1/2017 12:48:46 PM,Overall,6336,6864,6336,6864,26400,22464,24336,0,0,46800
21,Somalia,2015,SOM-15/DDA-3485/SA  1/Ed/INGO/2315,1/9/2017 1:21:20 PM,Internally Displaced People,1829,2035,0,0,3864,1490,1895,0,0,3385
21,Somalia,2015,SOM-15/DDA-3485/SA  1/Ed/INGO/2315,1/9/2017 1:21:20 PM,Internally Displaced People/Returnees,523,581,0,0,1104,113,97,0,0,210
21,Somalia,2015,SOM-15/DDA-3485/SA  1/Ed/INGO/2315,1/9/2017 1:21:20 PM,Other,261,291,0,0,552,643,886,0,0,1529
21,Somalia,2015,SOM-15/DDA-3485/SA  1/Ed/INGO/2315,1/9/2017 1:21:20 PM,Overall,226,169,2387,2738,5520,231,128,2027,2738,5124
21,Somalia,2015,SOM-15/DDA-3485/SA  1/Ed/INGO/2391,1/11/2017 7:09:45 AM,Internally Displaced People,1160,932,0,0,2092,41,11,980,829,1861
21,Somalia,2015,SOM-15/DDA-3485/SA  1/Ed/INGO/2391,1/11/2017 7:09:45 AM,Overall,98,42,1657,1332,3129,51,14,1225,1036,2326
21,Somalia,2015,SOM-15/DDA-3485/SA  1/Ed/INGO/2391,1/11/2017 7:09:45 AM,People in Host Communities,497,400,0,0,897,10,3,0,0,13
21,Somalia,2015,SOM-15/DDA-3485/SA  1/Ed/INGO/2391,1/11/2017 7:09:45 AM,"Trainers, Promoters, Caretakers, committee members, etc.",98,42,0,0,140,51,14,0,0,65
21,Somalia,2015,SOM-15/DDA-3485/SA  1/Ed/INGO/2418,8/9/2016 8:30:46 AM,Children under 18,1335,1165,0,0,2500,1334,1152,0,0,2486
21,Somalia,2015,SOM-15/DDA-3485/SA  1/Ed/INGO/2418,8/9/2016 8:30:46 AM,Internally Displaced People,436,388,0,0,824,433,377,0,0,810
21,Somalia,2015,SOM-15/DDA-3485/SA  1/Ed/INGO/2418,8/9/2016 8:30:46 AM,Other,19,19,0,0,38,51,20,0,0,71
21,Somalia,2015,SOM-15/DDA-3485/SA  1/Ed/INGO/2418,8/9/2016 8:30:46 AM,Overall,74,63,1335,1165,2637,85,52,1334,1152,2623
21,Somalia,2015,SOM-15/DDA-3485/SA  1/Ed/INGO/2436,12/13/2016 5:06:13 AM,Internally Displaced People/Returnees,1313,1274,0,0,2587,0,0,914,873,1787
21,Somalia,2015,SOM-15/DDA-3485/SA  1/Ed/INGO/2436,12/13/2016 5:06:13 AM,Overall,695,643,1178,1209,3725,0,0,1427,1282,2709
21,Somalia,2015,SOM-15/DDA-3485/SA  1/Ed/INGO/2436,12/13/2016 5:06:13 AM,People in Host Communities,560,578,0,0,1138,560,570,0,0,1130
21,Somalia,2015,SOM-15/DDA-3485/SA  1/Ed/INGO/2451,4/13/2017 7:00:53 AM,Children under 18,1030,1030,0,0,2060,1041,1024,0,0,2065
21,Somalia,2015,SOM-15/DDA-3485/SA  1/Ed/INGO/2451,4/13/2017 7:00:53 AM,Committees,28,21,0,0,49,24,32,0,0,56
21,Somalia,2015,SOM-15/DDA-3485/SA  1/Ed/INGO/2451,4/13/2017 7:00:53 AM,Overall,57,40,1030,1030,2157,51,48,1041,1024,2164
21,Somalia,2015,SOM-15/DDA-3485/SA  1/Ed/INGO/2451,4/13/2017 7:00:53 AM,"Staff (own or partner staff, authorities)",4,0,0,0,4,4,0,0,0,4
21,Somalia,2015,SOM-15/DDA-3485/SA  1/Ed/INGO/2451,4/13/2017 7:00:53 AM,"Trainers, Promoters, Caretakers, committee members, etc.",25,19,0,0,44,23,16,0,0,39
21,Somalia,2015,SOM-15/DDA-3485/SA  1/Ed/NGO/2318,6/23/2016 4:52:27 AM,Children under 18,1620,1620,0,0,3240,0,0,1872,1700,3572
21,Somalia,2015,SOM-15/DDA-3485/SA  1/Ed/NGO/2318,6/23/2016 4:52:27 AM,Other,55,47,0,0,102,55,47,0,0,102
21,Somalia,2015,SOM-15/DDA-3485/SA  1/Ed/NGO/2318,6/23/2016 4:52:27 AM,Overall,55,47,1620,1620,3342,55,47,1872,1700,3674
21,Somalia,2015,SOM-15/DDA-3485/SA  1/EP/INGO/2324,7/11/2017 11:58:43 AM,Aid Agencies,40,40,0,0,80,43,43,0,0,86
21,Somalia,2015,SOM-15/DDA-3485/SA  1/EP/INGO/2324,7/11/2017 11:58:43 AM,Overall,40,40,0,0,80,0,0,0,0,0
21,Somalia,2015,SOM-15/DDA-3485/SA  1/EP/UN/2406,5/10/2017 6:13:41 AM,Aid Agencies,200,0,0,0,200,200,0,0,0,200
21,Somalia,2015,SOM-15/DDA-3485/SA  1/EP/UN/2406,5/10/2017 6:13:41 AM,Overall,500000,500000,500000,500000,2000000,500000,500000,500000,500000,2000000
21,Somalia,2015,SOM-15/DDA-3485/SA  1/EP/UN/2406,5/10/2017 6:13:41 AM,"Staff (own or partner staff, authorities)",20,0,0,0,20,20,0,0,0,20
21,Somalia,2015,SOM-15/DDA-3485/SA  1/EP/UN/2414,10/4/2016 11:50:58 AM,Overall,3751327,3751327,0,0,7502654,3751327,3751327,0,0,7502654
21,Somalia,2015,SOM-15/DDA-3485/SA  1/FSC/INGO/2321,3/8/2017 6:35:49 PM,Agro-Pastoralists,788,800,0,0,1588,788,800,0,0,1588
21,Somalia,2015,SOM-15/DDA-3485/SA  1/FSC/INGO/2321,3/8/2017 6:35:49 PM,Internally Displaced People,776,786,0,0,1562,776,786,0,0,1562
21,Somalia,2015,SOM-15/DDA-3485/SA  1/FSC/INGO/2321,3/8/2017 6:35:49 PM,Overall,720,840,780,810,3150,720,840,780,810,3150
21,Somalia,2015,SOM-15/DDA-3485/SA  1/FSC/INGO/2338,3/17/2017 9:29:22 AM,Agro-Pastoralists,2112,2688,0,0,4800,2112,2688,0,0,4800
21,Somalia,2015,SOM-15/DDA-3485/SA  1/FSC/INGO/2338,3/17/2017 9:29:22 AM,Overall,816,1344,1296,1344,4800,816,1344,1296,1344,4800
21,Somalia,2015,SOM-15/DDA-3485/SA  1/FSC/INGO/2342,5/12/2017 8:22:04 AM,Internally Displaced People,1361,3175,0,0,4536,745,1014,1953,1876,5588
21,Somalia,2015,SOM-15/DDA-3485/SA  1/FSC/INGO/2342,5/12/2017 8:22:04 AM,Overall,891,2079,1069,1361,5400,0,0,0,0,0
21,Somalia,2015,SOM-15/DDA-3485/SA  1/FSC/INGO/2342,5/12/2017 8:22:04 AM,Urban Poor,259,605,0,0,864,133,182,393,378,1086
21,Somalia,2015,SOM-15/DDA-3485/SA  1/FSC/INGO/2372,3/17/2017 9:47:34 AM,Overall,591,927,694,1088,3300,326,966,1164,1047,3503
21,Somalia,2015,SOM-15/DDA-3485/SA  1/FSC/INGO/2372,3/17/2017 9:47:34 AM,Urban Poor,1285,2015,0,0,3300,326,966,1164,1047,3503
21,Somalia,2015,SOM-15/DDA-3485/SA  1/FSC/INGO/2384,3/17/2017 9:36:57 AM,Children under 18,3390,3390,0,0,6780,0,0,4444,3227,7671
21,Somalia,2015,SOM-15/DDA-3485/SA  1/FSC/INGO/2384,3/17/2017 9:36:57 AM,Internally Displaced People/Returnees,285,1110,0,0,1395,635,1112,0,0,1747
21,Somalia,2015,SOM-15/DDA-3485/SA  1/FSC/INGO/2384,3/17/2017 9:36:57 AM,Overall,485,1210,3390,3390,8475,2044,2101,4444,3227,11816
21,Somalia,2015,SOM-15/DDA-3485/SA  1/FSC/INGO/2384,3/17/2017 9:36:57 AM,People from Riverine Communities,200,100,0,0,300,221,125,0,0,346
21,Somalia,2015,SOM-15/DDA-3485/SA  1/FSC/NGO/2346,6/30/2017 9:48:32 AM,Agro-Pastoralists,2000,2000,0,0,4000,2000,2000,0,0,4000
21,Somalia,2015,SOM-15/DDA-3485/SA  1/FSC/NGO/2346,6/30/2017 9:48:32 AM,Overall,3200,3200,800,800,8000,3200,3200,800,800,8000
21,Somalia,2015,SOM-15/DDA-3485/SA  1/FSC/NGO/2346,6/30/2017 9:48:32 AM,People from Riverine Communities,2000,2000,0,0,4000,2000,2000,0,0,4000
21,Somalia,2015,SOM-15/DDA-3485/SA  1/FSC/NGO/2380,2/27/2017 8:14:52 AM,Internally Displaced People,400,200,0,0,600,400,200,0,0,600
21,Somalia,2015,SOM-15/DDA-3485/SA  1/FSC/NGO/2380,2/27/2017 8:14:52 AM,Overall,300,750,450,450,1950,300,750,450,450,1950
21,Somalia,2015,SOM-15/DDA-3485/SA  1/FSC/NGO/2380,2/27/2017 8:14:52 AM,Pastoralists,450,450,0,0,900,450,450,0,0,900
21,Somalia,2015,SOM-15/DDA-3485/SA  1/FSC/NGO/2380,2/27/2017 8:14:52 AM,People in Host Communities,200,100,0,0,300,200,100,0,0,300
21,Somalia,2015,SOM-15/DDA-3485/SA  1/FSC/UN/2355,3/17/2017 9:38:52 AM,Overall,2554,3826,638,956,7974,1390,4590,464,1530,7974
21,Somalia,2015,SOM-15/DDA-3485/SA  1/FSC/UN/2358,3/17/2017 4:47:27 AM,Children under 18,2894,2894,0,0,5788,3728,3644,0,0,7372
21,Somalia,2015,SOM-15/DDA-3485/SA  1/FSC/UN/2358,3/17/2017 4:47:27 AM,Internally Displaced People,3039,3039,0,0,6078,0,0,0,0,0
21,Somalia,2015,SOM-15/DDA-3485/SA  1/FSC/UN/2358,3/17/2017 4:47:27 AM,Overall,1447,1447,2894,2894,8682,1539,2248,3728,3644,11159
21,Somalia,2015,SOM-15/DDA-3485/SA  1/FSC/UN/2358,3/17/2017 4:47:27 AM,People in Host Communities,1302,1302,0,0,2604,1539,2248,3728,3644,11159
21,Somalia,2015,SOM-15/DDA-3485/SA  1/FSC/UN/2419,12/28/2016 11:40:51 AM,Agro-Pastoralists,71550,47700,0,0,119250,131755,87836,0,0,219591
21,Somalia,2015,SOM-15/DDA-3485/SA  1/FSC/UN/2419,12/28/2016 11:40:51 AM,Overall,100170,66780,42930,28620,238500,184456,122972,79052,52702,439182
21,Somalia,2015,SOM-15/DDA-3485/SA  1/FSC/UN/2419,12/28/2016 11:40:51 AM,Pastoralists,71550,47700,0,0,119250,131755,87836,0,0,219591
21,Somalia,2015,SOM-15/DDA-3485/SA  1/H/INGO/2364,8/9/2016 7:55:31 AM,Internally Displaced People,15309,23149,0,0,38458,3364,3193,0,0,6557
21,Somalia,2015,SOM-15/DDA-3485/SA  1/H/INGO/2364,8/9/2016 7:55:31 AM,Overall,21948,26054,9218,17456,74676,18012,36595,19361,18390,92358
21,Somalia,2015,SOM-15/DDA-3485/SA  1/H/INGO/2364,8/9/2016 7:55:31 AM,People in Host Communities,11576,17922,0,0,29498,34009,32285,0,0,66294
21,Somalia,2015,SOM-15/DDA-3485/SA  1/H/INGO/2364,8/9/2016 7:55:31 AM,Women of Child-Bearing Age,0,6720,0,0,6720,0,19507,0,0,19507
21,Somalia,2015,SOM-15/DDA-3485/SA  1/H/INGO/2369,7/19/2016 6:02:23 AM,Children under 5,7213,7213,0,0,14426,7439,7836,0,0,15275
21,Somalia,2015,SOM-15/DDA-3485/SA  1/H/INGO/2369,7/19/2016 6:02:23 AM,Internally Displaced People/Returnees,650,1350,0,0,2000,0,0,0,0,0
21,Somalia,2015,SOM-15/DDA-3485/SA  1/H/INGO/2369,7/19/2016 6:02:23 AM,Overall,662,13766,7213,7213,28854,980,4423,13880,13863,33146
21,Somalia,2015,SOM-15/DDA-3485/SA  1/H/INGO/2369,7/19/2016 6:02:23 AM,"Staff (own or partner staff, authorities)",12,12,0,0,24,10,10,10,0,30
21,Somalia,2015,SOM-15/DDA-3485/SA  1/H/INGO/2369,7/19/2016 6:02:23 AM,Women of Child-Bearing Age,0,12404,0,0,12404,0,3221,0,0,3221
21,Somalia,2015,SOM-15/DDA-3485/SA  1/H/INGO/2378,8/9/2016 8:17:32 AM,Children under 5,11044,12603,0,0,23647,12001,12972,0,0,24973
21,Somalia,2015,SOM-15/DDA-3485/SA  1/H/INGO/2378,8/9/2016 8:17:32 AM,Internally Displaced People/Returnees,2100,3474,0,0,5574,1900,2687,0,0,4587
21,Somalia,2015,SOM-15/DDA-3485/SA  1/H/INGO/2378,8/9/2016 8:17:32 AM,Overall,2100,13686,11044,12603,39433,1900,14219,12001,12972,41092
21,Somalia,2015,SOM-15/DDA-3485/SA  1/H/INGO/2378,8/9/2016 8:17:32 AM,Pregnant and Lactating Women,0,4521,0,0,4521,0,5379,0,0,5379
21,Somalia,2015,SOM-15/DDA-3485/SA  1/H/INGO/2378,8/9/2016 8:17:32 AM,Women of Child-Bearing Age,0,5691,0,0,5691,0,6153,0,0,6153
21,Somalia,2015,SOM-15/DDA-3485/SA  1/H/INGO/2383,5/10/2017 5:45:04 AM,Internally Displaced People/Returnees,4204,6307,0,0,10511,3969,5995,5945,9180,25089
21,Somalia,2015,SOM-15/DDA-3485/SA  1/H/INGO/2383,5/10/2017 5:45:04 AM,Overall,4205,6308,6307,9460,26280,3969,5995,5945,9180,25089
21,Somalia,2015,SOM-15/DDA-3485/SA  1/H/INGO/2462,3/8/2017 4:47:05 PM,Internally Displaced People/Returnees,0,106,0,0,106,0,198,0,0,198
21,Somalia,2015,SOM-15/DDA-3485/SA  1/H/INGO/2462,3/8/2017 4:47:05 PM,Overall,8,288,0,0,296,0,308,0,0,308
21,Somalia,2015,SOM-15/DDA-3485/SA  1/H/INGO/2462,3/8/2017 4:47:05 PM,People in Host Communities,8,182,0,0,190,0,110,0,0,110
21,Somalia,2015,SOM-15/DDA-3485/SA  1/H/NGO/2335,5/29/2017 9:43:18 AM,Children under 5,800,800,0,0,1600,0,0,7175,7356,14531
21,Somalia,2015,SOM-15/DDA-3485/SA  1/H/NGO/2335,5/29/2017 9:43:18 AM,Internally Displaced People/Returnees,500,800,0,0,1300,2122,1593,0,0,3715
21,Somalia,2015,SOM-15/DDA-3485/SA  1/H/NGO/2335,5/29/2017 9:43:18 AM,Overall,1500,2500,800,800,5600,10608,12255,7175,7356,37394
21,Somalia,2015,SOM-15/DDA-3485/SA  1/H/NGO/2335,5/29/2017 9:43:18 AM,People in Host Communities,800,1500,0,0,2300,8486,6371,0,0,14857
21,Somalia,2015,SOM-15/DDA-3485/SA  1/H/NGO/2335,5/29/2017 9:43:18 AM,Pregnant and Lactating Women,0,400,0,0,400,0,4291,0,0,4291
21,Somalia,2015,SOM-15/DDA-3485/SA  1/H/NGO/2365,1/9/2017 1:24:23 PM,Children under 5,4500,4500,0,0,9000,3568,4376,0,0,7944
21,Somalia,2015,SOM-15/DDA-3485/SA  1/H/NGO/2365,1/9/2017 1:24:23 PM,Overall,2100,5000,4300,5000,16400,1870,4653,4105,4232,14860
21,Somalia,2015,SOM-15/DDA-3485/SA  1/H/NGO/2365,1/9/2017 1:24:23 PM,People in HE and/or AFLC,1500,1500,0,0,3000,1280,1350,0,0,2630
21,Somalia,2015,SOM-15/DDA-3485/SA  1/H/NGO/2365,1/9/2017 1:24:23 PM,Pregnant and Lactating Women,0,4300,0,0,4300,0,4186,0,0,4186
21,Somalia,2015,SOM-15/DDA-3485/SA  1/H/NGO/2365,1/9/2017 1:24:23 PM,"Trainers, Promoters, Caretakers, committee members, etc.",40,60,0,0,100,40,60,0,0,100
21,Somalia,2015,SOM-15/DDA-3485/SA  1/H/NGO/2370,9/6/2016 9:02:52 AM,Children under 5,2000,2000,0,0,4000,2200,2250,0,0,4450
21,Somalia,2015,SOM-15/DDA-3485/SA  1/H/NGO/2370,9/6/2016 9:02:52 AM,Overall,1440,4055,2000,2000,9495,1630,4390,2200,2250,10470
21,Somalia,2015,SOM-15/DDA-3485/SA  1/H/UN/2320,1/11/2017 7:10:57 AM,Internally Displaced People,15079,21273,0,0,36352,8782,10976,5772,7470,33000
21,Somalia,2015,SOM-15/DDA-3485/SA  1/H/UN/2320,1/11/2017 7:10:57 AM,Overall,15936,22825,10623,14216,63600,25969,33019,13732,14734,87454
21,Somalia,2015,SOM-15/DDA-3485/SA  1/H/UN/2320,1/11/2017 7:10:57 AM,Pastoralists,2100,900,0,0,3000,1520,2067,2737,2134,8458
21,Somalia,2015,SOM-15/DDA-3485/SA  1/H/UN/2320,1/11/2017 7:10:57 AM,People in Host Communities,7180,10768,0,0,17948,11447,15058,2696,2735,31936
21,Somalia,2015,SOM-15/DDA-3485/SA  1/H/UN/2320,1/11/2017 7:10:57 AM,Returnees,2200,4100,0,0,6300,4220,4918,2527,2395,14060
21,Somalia,2015,SOM-15/DDA-3485/SA  1/H/UN/2353,6/21/2016 8:33:55 AM,Children under 5,10000,10000,0,0,20000,9408,12800,0,0,22208
21,Somalia,2015,SOM-15/DDA-3485/SA  1/H/UN/2353,6/21/2016 8:33:55 AM,Overall,60000,67000,15300,15300,157600,67500,71200,17600,18700,175000
21,Somalia,2015,SOM-15/DDA-3485/SA  1/H/UN/2353,6/21/2016 8:33:55 AM,People in Host Communities,50000,63600,0,0,113600,54742,68750,0,0,123492
21,Somalia,2015,SOM-15/DDA-3485/SA  1/H/UN/2353,6/21/2016 8:33:55 AM,Pregnant and Lactating Women,0,6000,0,0,6000,0,6700,0,0,6700
21,Somalia,2015,SOM-15/DDA-3485/SA  1/H/UN/2353,6/21/2016 8:33:55 AM,Returnees,8000,10000,0,0,18000,9500,13100,0,0,22600
21,Somalia,2015,SOM-15/DDA-3485/SA  1/MsR/INGO/2407,5/17/2017 10:17:17 AM,Agro-Pastoralists,946,1874,0,0,2820,73,176,305,288,842
21,Somalia,2015,SOM-15/DDA-3485/SA  1/MsR/INGO/2407,5/17/2017 10:17:17 AM,Internally Displaced People/Returnees,816,1634,0,0,2450,816,1634,0,0,2450
21,Somalia,2015,SOM-15/DDA-3485/SA  1/MsR/INGO/2407,5/17/2017 10:17:17 AM,Overall,635,1479,311,395,2820,501,887,651,620,2659
21,Somalia,2015,SOM-15/DDA-3485/SA  1/Nut/INGO/2323,2/20/2018 7:22:09 AM,Children under 5,484,546,0,0,1030,553,531,0,0,1084
21,Somalia,2015,SOM-15/DDA-3485/SA  1/Nut/INGO/2323,2/20/2018 7:22:09 AM,Overall,10,10,484,546,1050,26,26,553,531,1136
21,Somalia,2015,SOM-15/DDA-3485/SA  1/Nut/INGO/2323,2/20/2018 7:22:09 AM,"Trainers, Promoters, Caretakers, committee members, etc.",10,10,0,0,20,82,126,0,0,208
21,Somalia,2015,SOM-15/DDA-3485/SA  1/Nut/INGO/2349,8/9/2016 7:51:37 AM,Children under 5,1100,1100,0,0,2200,912,1024,0,0,1936
21,Somalia,2015,SOM-15/DDA-3485/SA  1/Nut/INGO/2349,8/9/2016 7:51:37 AM,Overall,20,2512,1100,1100,4732,20,2891,912,1024,4847
21,Somalia,2015,SOM-15/DDA-3485/SA  1/Nut/INGO/2349,8/9/2016 7:51:37 AM,Pregnant and Lactating Women,0,2470,0,0,2470,0,2849,0,0,2849
21,Somalia,2015,SOM-15/DDA-3485/SA  1/Nut/INGO/2349,8/9/2016 7:51:37 AM,"Staff (own or partner staff, authorities)",20,42,0,0,62,20,42,0,0,62
21,Somalia,2015,SOM-15/DDA-3485/SA  1/Nut/INGO/2388,8/9/2016 8:15:31 AM,Children under 5,5123,5123,0,0,10246,9480,10293,0,0,19773
21,Somalia,2015,SOM-15/DDA-3485/SA  1/Nut/INGO/2388,8/9/2016 8:15:31 AM,Overall,30,4572,5123,5123,14848,14441,16453,9480,10293,50667
21,Somalia,2015,SOM-15/DDA-3485/SA  1/Nut/INGO/2388,8/9/2016 8:15:31 AM,Pregnant and Lactating Women,0,4542,0,0,4542,0,16453,0,0,16453
21,Somalia,2015,SOM-15/DDA-3485/SA  1/Nut/INGO/2388,8/9/2016 8:15:31 AM,"Staff (own or partner staff, authorities)",9,9,0,0,18,9,9,0,0,18
21,Somalia,2015,SOM-15/DDA-3485/SA  1/Nut/INGO/2388,8/9/2016 8:15:31 AM,"Trainers, Promoters, Caretakers, committee members, etc.",21,21,0,0,42,0,0,0,0,0
21,Somalia,2015,SOM-15/DDA-3485/SA  1/Nut/INGO/2392,3/8/2017 4:44:52 PM,Children under 5,2668,4002,0,0,6670,0,0,1834,2420,4254
21,Somalia,2015,SOM-15/DDA-3485/SA  1/Nut/INGO/2392,3/8/2017 4:44:52 PM,Internally Displaced People,68,1878,0,0,1946,49,7777,1834,2420,12080
21,Somalia,2015,SOM-15/DDA-3485/SA  1/Nut/INGO/2392,3/8/2017 4:44:52 PM,Overall,68,1908,2668,4002,8646,49,7777,1834,2420,12080
21,Somalia,2015,SOM-15/DDA-3485/SA  1/Nut/INGO/2392,3/8/2017 4:44:52 PM,Pregnant and Lactating Women,0,1878,0,0,1878,0,7654,0,0,7654
21,Somalia,2015,SOM-15/DDA-3485/SA  1/Nut/INGO/2466,5/25/2017 9:38:56 AM,Children under 5,2410,2410,0,0,4820,0,0,6399,5701,12100
21,Somalia,2015,SOM-15/DDA-3485/SA  1/Nut/INGO/2466,5/25/2017 9:38:56 AM,Overall,0,1012,2410,2410,5832,0,4170,6399,5701,16270
21,Somalia,2015,SOM-15/DDA-3485/SA  1/Nut/INGO/2466,5/25/2017 9:38:56 AM,Pregnant and Lactating Women,0,1012,0,0,1012,0,4170,0,0,4170
21,Somalia,2015,SOM-15/DDA-3485/SA  1/Nut/INGO/2467,5/10/2017 5:49:28 AM,Children under 5,331,332,0,0,663,414,484,0,0,898
21,Somalia,2015,SOM-15/DDA-3485/SA  1/Nut/INGO/2467,5/10/2017 5:49:28 AM,Overall,17,6079,331,332,6759,176,6071,414,484,7145
21,Somalia,2015,SOM-15/DDA-3485/SA  1/Nut/INGO/2467,5/10/2017 5:49:28 AM,"Staff (own or partner staff, authorities)",17,28,0,0,45,8,39,0,0,47
21,Somalia,2015,SOM-15/DDA-3485/SA  1/Nut/INGO/2467,5/10/2017 5:49:28 AM,Women of Child-Bearing Age,0,6051,0,0,6051,0,6032,0,0,6032
21,Somalia,2015,SOM-15/DDA-3485/SA  1/Nut/INGO/2473,5/10/2017 5:46:42 AM,Children under 5,0,0,1609,1609,3218,0,0,1822,2815,4637
21,Somalia,2015,SOM-15/DDA-3485/SA  1/Nut/INGO/2473,5/10/2017 5:46:42 AM,Internally Displaced People,157,622,483,483,1745,282,1391,547,844,3064
21,Somalia,2015,SOM-15/DDA-3485/SA  1/Nut/INGO/2473,5/10/2017 5:46:42 AM,Overall,523,2072,1609,1609,5813,941,4637,1822,2815,10215
21,Somalia,2015,SOM-15/DDA-3485/SA  1/Nut/INGO/2473,5/10/2017 5:46:42 AM,"Staff (own or partner staff, authorities)",8,12,0,0,20,8,12,0,0,20
21,Somalia,2015,SOM-15/DDA-3485/SA  1/Nut/NGO/2340,5/10/2017 5:42:33 AM,Children under 5,1200,1200,0,0,2400,1540,1500,0,0,3040
21,Somalia,2015,SOM-15/DDA-3485/SA  1/Nut/NGO/2340,5/10/2017 5:42:33 AM,Overall,26,1038,1200,1200,3464,26,1280,1540,1500,4346
21,Somalia,2015,SOM-15/DDA-3485/SA  1/Nut/NGO/2340,5/10/2017 5:42:33 AM,Pregnant and Lactating Women,0,1000,0,0,1000,0,1280,0,0,1280
21,Somalia,2015,SOM-15/DDA-3485/SA  1/Nut/NGO/2371,1/11/2017 11:20:11 AM,Children under 5,900,900,0,0,1800,1079,1104,0,0,2183
21,Somalia,2015,SOM-15/DDA-3485/SA  1/Nut/NGO/2371,1/11/2017 11:20:11 AM,Overall,150,600,900,900,2550,170,1030,1079,1104,3383
21,Somalia,2015,SOM-15/DDA-3485/SA  1/Nut/NGO/2371,1/11/2017 11:20:11 AM,People in Host Communities,100,0,0,0,100,120,0,0,0,120
21,Somalia,2015,SOM-15/DDA-3485/SA  1/Nut/NGO/2371,1/11/2017 11:20:11 AM,Pregnant and Lactating Women,0,500,0,0,500,0,1030,0,0,1030
21,Somalia,2015,SOM-15/DDA-3485/SA  1/Nut/NGO/2371,1/11/2017 11:20:11 AM,"Trainers, Promoters, Caretakers, committee members, etc.",50,100,0,0,150,50,100,0,0,150
21,Somalia,2015,SOM-15/DDA-3485/SA  1/Nut/NGO/2385,8/9/2016 8:24:37 AM,Children under 5,1596,1348,0,0,2944,1596,1348,0,0,2944
21,Somalia,2015,SOM-15/DDA-3485/SA  1/Nut/NGO/2385,8/9/2016 8:24:37 AM,Overall,15,1340,1596,1348,4299,15,1340,1596,1348,4299
21,Somalia,2015,SOM-15/DDA-3485/SA  1/Nut/NGO/2385,8/9/2016 8:24:37 AM,Pregnant and Lactating Women,0,1325,0,0,1325,0,1325,0,0,1325
21,Somalia,2015,SOM-15/DDA-3485/SA  1/Nut/NGO/2385,8/9/2016 8:24:37 AM,"Staff (own or partner staff, authorities)",15,15,0,0,30,15,15,0,0,30
21,Somalia,2015,SOM-15/DDA-3485/SA  1/Nut/NGO/2468,8/18/2016 9:37:03 AM,Children under 5,799,798,0,0,1597,0,0,940,862,1802
21,Somalia,2015,SOM-15/DDA-3485/SA  1/Nut/NGO/2468,8/18/2016 9:37:03 AM,Overall,17,3273,799,798,4887,17,3350,940,862,5169
21,Somalia,2015,SOM-15/DDA-3485/SA  1/Nut/NGO/2468,8/18/2016 9:37:03 AM,Pregnant and Lactating Women,0,3256,0,0,3256,0,3350,0,0,3350
21,Somalia,2015,SOM-15/DDA-3485/SA  1/Nut/NGO/2468,8/18/2016 9:37:03 AM,"Staff (own or partner staff, authorities)",10,10,0,0,20,20,20,0,0,40
21,Somalia,2015,SOM-15/DDA-3485/SA  1/Nut/NGO/2468,8/18/2016 9:37:03 AM,"Trainers, Promoters, Caretakers, committee members, etc.",7,7,0,0,14,7,7,0,0,14
21,Somalia,2015,SOM-15/DDA-3485/SA  1/Nut/UN/2453,6/22/2016 11:44:20 AM,Children under 5,7305,7018,0,0,14323,9478,9105,0,0,18583
21,Somalia,2015,SOM-15/DDA-3485/SA  1/Nut/UN/2453,6/22/2016 11:44:20 AM,Overall,0,0,7305,7018,14323,0,0,9478,9105,18583
21,Somalia,2015,SOM-15/DDA-3485/SA  1/Prot/INGO/2404,1/30/2017 9:53:39 AM,Overall,10,210,0,0,220,65,355,25,46,491
21,Somalia,2015,SOM-15/DDA-3485/SA  1/Prot/INGO/2412,3/10/2017 9:53:59 AM,Children under 18,266,369,0,0,635,109,262,903,751,2025
21,Somalia,2015,SOM-15/DDA-3485/SA  1/Prot/INGO/2412,3/10/2017 9:53:59 AM,Overall,335,515,335,405,1590,225,415,903,751,2294
21,Somalia,2015,SOM-15/DDA-3485/SA  1/Prot/INGO/2412,3/10/2017 9:53:59 AM,"Staff (own or partner staff, authorities)",68,145,0,0,213,116,153,0,0,269
21,Somalia,2015,SOM-15/DDA-3485/SA  1/Prot/INGO/2415,3/19/2017 7:05:02 PM,Internally Displaced People/Returnees,2000,10500,0,0,12500,9318,17111,0,0,26429
21,Somalia,2015,SOM-15/DDA-3485/SA  1/Prot/INGO/2415,3/19/2017 7:05:02 PM,Overall,2000,7000,1000,2500,12500,5813,11151,3505,5960,26429
21,Somalia,2015,SOM-15/DDA-3485/SA  1/Prot/INGO/2416,3/19/2017 7:09:21 PM,Internally Displaced People,526,859,0,0,1385,495,1200,270,309,2274
21,Somalia,2015,SOM-15/DDA-3485/SA  1/Prot/INGO/2416,3/19/2017 7:09:21 PM,Overall,550,900,120,120,1690,663,1407,290,495,2855
21,Somalia,2015,SOM-15/DDA-3485/SA  1/Prot/UN/2402,3/19/2017 7:12:49 PM,Internally Displaced People,770,2930,0,0,3700,770,2930,0,0,3700
21,Somalia,2015,SOM-15/DDA-3485/SA  1/Prot/UN/2402,3/19/2017 7:12:49 PM,Overall,925,3600,300,300,5125,1020,3416,200,230,4866
21,Somalia,2015,SOM-15/DDA-3485/SA  1/Prot/UN/2402,3/19/2017 7:12:49 PM,"Trainers, Promoters, Caretakers, committee members, etc.",325,300,0,0,625,325,300,0,0,625
21,Somalia,2015,SOM-15/DDA-3485/SA  1/Prot/UN/2420,8/24/2016 11:45:50 AM,Internally Displaced People/Returnees,41884,80029,0,0,121913,0,0,0,0,0
21,Somalia,2015,SOM-15/DDA-3485/SA  1/Prot/UN/2420,8/24/2016 11:45:50 AM,Other,10470,20007,0,0,30477,20000,80000,0,0,100000
21,Somalia,2015,SOM-15/DDA-3485/SA  1/Prot/UN/2420,8/24/2016 11:45:50 AM,Overall,39130,63060,13309,37021,152520,298,2989,791,2573,6651
21,Somalia,2015,SOM-15/DDA-3485/SA  1/Shelter/INGO/2314,12/16/2016 7:36:34 AM,Internally Displaced People/Returnees,1932,2268,0,0,4200,2355,2075,0,0,4430
21,Somalia,2015,SOM-15/DDA-3485/SA  1/Shelter/INGO/2314,12/16/2016 7:36:34 AM,Overall,672,1008,1260,1260,4200,738,788,1617,1287,4430
21,Somalia,2015,SOM-15/DDA-3485/SA  1/Shelter/INGO/2433,12/16/2016 7:49:08 AM,Internally Displaced People/Returnees,8829,10791,0,0,19620,8452,10146,0,0,18598
21,Somalia,2015,SOM-15/DDA-3485/SA  1/Shelter/INGO/2433,12/16/2016 7:49:08 AM,Overall,3924,4905,4905,5886,19620,1562,8746,6890,1400,18598
21,Somalia,2015,SOM-15/DDA-3485/SA  1/Shelter/INGO/2442,10/17/2016 11:39:19 AM,Children under 18,3720,4200,0,0,7920,3902,3377,0,0,7279
21,Somalia,2015,SOM-15/DDA-3485/SA  1/Shelter/INGO/2442,10/17/2016 11:39:19 AM,Internally Displaced People,5646,6366,0,0,12012,5541,5449,0,0,10990
21,Somalia,2015,SOM-15/DDA-3485/SA  1/Shelter/INGO/2442,10/17/2016 11:39:19 AM,Overall,1926,2166,3720,4200,12012,1639,2072,3902,3377,10990
21,Somalia,2015,SOM-15/DDA-3485/SA  1/Shelter/INGO/2442,10/17/2016 11:39:19 AM,Pregnant and Lactating Women,0,750,0,0,750,0,865,0,0,865
21,Somalia,2015,SOM-15/DDA-3485/SA  1/Shelter/INGO/2442,10/17/2016 11:39:19 AM,Women of Child-Bearing Age,0,4000,0,0,4000,0,2758,0,0,2758
21,Somalia,2015,SOM-15/DDA-3485/SA  1/Shelter/INGO/2444,2/7/2017 4:59:08 AM,Internally Displaced People/Returnees,3449,5173,5974,2648,17244,5561,6015,1754,1779,15109
21,Somalia,2015,SOM-15/DDA-3485/SA  1/Shelter/INGO/2444,2/7/2017 4:59:08 AM,Overall,3449,5173,5974,2648,17244,5561,6015,1754,1779,15109
21,Somalia,2015,SOM-15/DDA-3485/SA  1/Shelter/NGO/2375,10/17/2016 11:37:04 AM,Internally Displaced People,1320,0,0,0,1320,334,462,270,264,1330
21,Somalia,2015,SOM-15/DDA-3485/SA  1/Shelter/NGO/2375,10/17/2016 11:37:04 AM,Overall,330,462,264,264,1320,334,462,270,264,1330
21,Somalia,2015,SOM-15/DDA-3485/SA  1/Shelter/NGO/2410,1/25/2017 10:21:49 AM,Internally Displaced People,828,972,0,0,1800,828,972,0,0,1800
21,Somalia,2015,SOM-15/DDA-3485/SA  1/Shelter/NGO/2410,1/25/2017 10:21:49 AM,Overall,324,396,504,576,1800,324,396,504,576,1800
21,Somalia,2015,SOM-15/DDA-3485/SA  1/WASH/INGO/2325,12/16/2016 7:44:27 AM,Internally Displaced People,2401,2792,2933,3419,11545,2836,3564,4817,5486,16703
21,Somalia,2015,SOM-15/DDA-3485/SA  1/WASH/INGO/2325,12/16/2016 7:44:27 AM,Overall,3430,3996,4190,4884,16500,4051,5091,6882,7837,23861
21,Somalia,2015,SOM-15/DDA-3485/SA  1/WASH/INGO/2325,12/16/2016 7:44:27 AM,People in Host Communities,1029,1204,1257,1465,4955,1215,1527,2065,2351,7158
21,Somalia,2015,SOM-15/DDA-3485/SA  1/WASH/INGO/2357,8/8/2016 12:42:13 PM,Children under 5,2142,2058,0,0,4200,0,0,2142,2058,4200
21,Somalia,2015,SOM-15/DDA-3485/SA  1/WASH/INGO/2357,8/8/2016 12:42:13 PM,Other,284,445,0,0,729,0,0,0,0,0
21,Somalia,2015,SOM-15/DDA-3485/SA  1/WASH/INGO/2357,8/8/2016 12:42:13 PM,Overall,5943,5754,4652,4652,21001,5943,5754,4652,4652,21001
21,Somalia,2015,SOM-15/DDA-3485/SA  1/WASH/INGO/2357,8/8/2016 12:42:13 PM,Pregnant and Lactating Women,0,1890,0,0,1890,0,1890,0,0,1890
21,Somalia,2015,SOM-15/DDA-3485/SA  1/WASH/INGO/2357,8/8/2016 12:42:13 PM,"Trainers, Promoters, Caretakers, committee members, etc.",65,65,0,0,130,78,49,0,0,127
21,Somalia,2015,SOM-15/DDA-3485/SA  1/WASH/INGO/2363,12/16/2016 7:30:30 AM,Overall,2515,2724,2724,2952,10915,2539,2761,2760,2980,11040
21,Somalia,2015,SOM-15/DDA-3485/SA  1/WASH/INGO/2363,12/16/2016 7:30:30 AM,Pastoralists,4191,4541,0,0,8732,4270,4590,0,0,8860
21,Somalia,2015,SOM-15/DDA-3485/SA  1/WASH/INGO/2363,12/16/2016 7:30:30 AM,People in Host Communities,1048,1135,0,0,2183,1060,1120,0,0,2180
21,Somalia,2015,SOM-15/DDA-3485/SA  1/WASH/INGO/2422,10/17/2016 12:48:25 PM,Overall,2771,4567,4404,4568,16310,2802,4615,4450,4615,16482
21,Somalia,2015,SOM-15/DDA-3485/SA  1/WASH/INGO/2422,10/17/2016 12:48:25 PM,Pastoralists,7175,9135,0,0,16310,7252,9230,0,0,16482
21,Somalia,2015,SOM-15/DDA-3485/SA  1/WASH/INGO/2428,8/18/2016 9:23:36 AM,Internally Displaced People,5772,18276,0,0,24048,12192,11856,0,0,24048
21,Somalia,2015,SOM-15/DDA-3485/SA  1/WASH/INGO/2428,8/18/2016 9:23:36 AM,Overall,3367,6493,2405,11783,24048,6565,6517,5627,5339,24048
21,Somalia,2015,SOM-15/DDA-3485/SA  1/WASH/INGO/2430,6/9/2016 9:02:35 AM,Agro-Pastoralists,5520,6480,0,0,12000,4907,6214,0,0,11121
21,Somalia,2015,SOM-15/DDA-3485/SA  1/WASH/INGO/2430,6/9/2016 9:02:35 AM,Internally Displaced People,962,1444,0,0,2406,749,2536,0,0,3285
21,Somalia,2015,SOM-15/DDA-3485/SA  1/WASH/INGO/2430,6/9/2016 9:02:35 AM,Overall,3314,4322,3168,3602,14406,3128,4508,2915,3855,14406
21,Somalia,2015,SOM-15/DDA-3485/SA  1/WASH/INGO/2445,7/6/2018 10:01:36 AM,Internally Displaced People,360,510,0,0,870,360,510,0,0,870
21,Somalia,2015,SOM-15/DDA-3485/SA  1/WASH/INGO/2445,7/6/2018 10:01:36 AM,Overall,2400,3150,3250,3900,12700,2400,3150,3250,3900,12700
21,Somalia,2015,SOM-15/DDA-3485/SA  1/WASH/INGO/2445,7/6/2018 10:01:36 AM,Pastoralists,5200,6630,0,0,11830,5200,6630,0,0,11830
21,Somalia,2015,SOM-15/DDA-3485/SA  1/WASH/INGO/2449,4/24/2017 4:38:37 AM,Internally Displaced People/Returnees,12000,18000,0,0,30000,5482,6225,12223,10337,34267
21,Somalia,2015,SOM-15/DDA-3485/SA  1/WASH/INGO/2449,4/24/2017 4:38:37 AM,Overall,4805,7207,7207,10811,30030,5482,6225,12223,10337,34267
21,Somalia,2015,SOM-15/DDA-3485/SA  1/WASH/INGO/2449,4/24/2017 4:38:37 AM,"Trainers, Promoters, Caretakers, committee members, etc.",10,20,0,0,30,10,20,0,0,30
21,Somalia,2015,SOM-15/DDA-3485/SA  1/WASH/NGO/2413,6/8/2017 11:01:19 AM,Internally Displaced People,3588,5382,0,0,8970,0,0,0,0,0
21,Somalia,2015,SOM-15/DDA-3485/SA  1/WASH/NGO/2413,6/8/2017 11:01:19 AM,Overall,3668,5504,3385,5081,17638,0,0,0,0,0
21,Somalia,2015,SOM-15/DDA-3485/SA  1/WASH/NGO/2413,6/8/2017 11:01:19 AM,People in Host Communities,3465,5203,0,0,8668,0,0,0,0,0
21,Somalia,2015,SOM-15/DDA-3485/SA  1/WASH/NGO/2424,12/16/2016 7:25:35 AM,Internally Displaced People,1260,1540,0,0,2800,420,700,840,840,2800
21,Somalia,2015,SOM-15/DDA-3485/SA  1/WASH/NGO/2424,12/16/2016 7:25:35 AM,Overall,2100,3500,4200,4200,14000,2100,3500,4200,4200,14000
21,Somalia,2015,SOM-15/DDA-3485/SA  1/WASH/NGO/2424,12/16/2016 7:25:35 AM,Urban Poor,5040,6160,0,0,11200,1680,2800,3360,3360,11200
21,Somalia,2015,SOM-15/DDA-3485/SA  1/WASH/UN/2382,3/13/2017 6:01:22 AM,Internally Displaced People,6357,7724,0,0,14081,6375,7706,0,0,14081
21,Somalia,2015,SOM-15/DDA-3485/SA  1/WASH/UN/2382,3/13/2017 6:01:22 AM,Overall,2119,2825,4238,4899,14081,2126,2833,4249,4873,14081
21,Somalia,2015,SOM-15/DDA-3485/SA  1/WASH/UN/2408,1/25/2017 11:28:31 AM,Aid Agencies,200,0,0,0,200,200,0,0,0,200
21,Somalia,2015,SOM-15/DDA-3485/SA  1/WASH/UN/2408,1/25/2017 11:28:31 AM,Overall,18750,18750,18750,18750,75000,18750,18750,18750,18750,75000
21,Somalia,2015,SOM-15/DDA-3485/SA  1/WASH/UN/2408,1/25/2017 11:28:31 AM,"Staff (own or partner staff, authorities)",20,0,0,0,20,20,0,0,0,20
21,Somalia,2015,SOM-15/DDA-3485/SA  1/WASH/UN/2443,2/15/2017 6:25:47 AM,Overall,2220,2960,4440,5180,14800,0,0,0,0,0
21,Somalia,2015,SOM-15/DDA-3485/SA  1/WASH/UN/2443,2/15/2017 6:25:47 AM,People in Host Communities,6660,8140,0,0,14800,23052,29814,0,0,52866
21,Somalia,2015,SOM-15/DDA-3485/SA  1/WASH/UN/2447,8/8/2016 12:45:24 PM,Children under 5,14580,17820,0,0,32400,0,0,20070,16421,36491
21,Somalia,2015,SOM-15/DDA-3485/SA  1/WASH/UN/2447,8/8/2016 12:45:24 PM,Internally Displaced People/Returnees,27000,33000,0,0,60000,20777,25395,16325,19953,82450
21,Somalia,2015,SOM-15/DDA-3485/SA  1/WASH/UN/2447,8/8/2016 12:45:24 PM,Overall,40824,49896,32076,39204,162000,45977,56195,36125,44153,182450
21,Somalia,2016,SOM-16/2470/R/Ed/INGO/2530,11/8/2017 12:44:22 PM,Committees,35,20,0,0,55,25,20,0,0,45
21,Somalia,2016,SOM-16/2470/R/Ed/INGO/2530,11/8/2017 12:44:22 PM,Internally Displaced People,0,0,735,601,1336,0,0,659,519,1178
21,Somalia,2016,SOM-16/2470/R/Ed/INGO/2530,11/8/2017 12:44:22 PM,Overall,35,20,1100,900,2055,52,23,775,611,1461
21,Somalia,2016,SOM-16/2470/R/Ed/INGO/2530,11/8/2017 12:44:22 PM,People in Host Communities,0,0,365,299,664,0,0,116,92,208
21,Somalia,2016,SOM-16/2470/R/Ed/INGO/2577,1/16/2018 7:09:58 AM,Children under 18,0,0,1116,1064,2180,0,0,676,586,1262
21,Somalia,2016,SOM-16/2470/R/Ed/INGO/2577,1/16/2018 7:09:58 AM,Overall,77,75,1116,1064,2332,86,56,676,586,1404
21,Somalia,2016,SOM-16/2470/R/Ed/INGO/2577,1/16/2018 7:09:58 AM,"Trainers, Promoters, Caretakers, committee members, etc.",77,75,0,0,152,86,56,0,0,142
21,Somalia,2016,SOM-16/2470/R/EP/UN/2518,10/19/2017 11:04:08 AM,Aid Agencies,200,200,0,0,400,200,200,0,0,400
21,Somalia,2016,SOM-16/2470/R/EP/UN/2518,10/19/2017 11:04:08 AM,Overall,420,420,0,0,840,420,420,0,0,840
21,Somalia,2016,SOM-16/2470/R/EP/UN/2518,10/19/2017 11:04:08 AM,"Staff (own or partner staff, authorities)",200,200,0,0,400,200,200,0,0,400
21,Somalia,2016,SOM-16/2470/R/EP/UN/2518,10/19/2017 11:04:08 AM,"Trainers, Promoters, Caretakers, committee members, etc.",20,20,0,0,40,20,20,0,0,40
21,Somalia,2016,SOM-16/2470/R/EP/UN/2519,3/14/2017 12:52:33 PM,Overall,3,1,0,0,4,4,0,0,0,4
21,Somalia,2016,SOM-16/2470/R/FSC/INGO/2502,5/22/2017 1:10:44 PM,Children under 18,0,0,1166,1120,2286,0,0,0,0,0
21,Somalia,2016,SOM-16/2470/R/FSC/INGO/2502,5/22/2017 1:10:44 PM,Children under 5,0,0,291,279,570,0,0,0,0,0
21,Somalia,2016,SOM-16/2470/R/FSC/INGO/2502,5/22/2017 1:10:44 PM,Overall,1451,1394,1456,1399,5700,1452,1574,1545,1615,6186
21,Somalia,2016,SOM-16/2470/R/FSC/INGO/2502,5/22/2017 1:10:44 PM,People in HE and/or AFLC,1451,1394,1456,1399,5700,1452,1574,1545,1615,6186
21,Somalia,2016,SOM-16/2470/R/FSC/INGO/2503,3/16/2017 9:33:05 AM,Overall,1233,1513,1457,1401,5604,1420,1330,2409,2402,7561
21,Somalia,2016,SOM-16/2470/R/FSC/INGO/2503,3/16/2017 9:33:05 AM,Pastoralists,1233,1513,1457,1401,5604,1420,1330,2409,2402,7561
21,Somalia,2016,SOM-16/2470/R/FSC/INGO/2509,3/16/2017 9:41:13 AM,Overall,343,3337,0,0,3680,1250,1560,418,335,3563
21,Somalia,2016,SOM-16/2470/R/FSC/INGO/2509,3/16/2017 9:41:13 AM,Pastoralists,343,337,0,0,680,379,301,0,0,680
21,Somalia,2016,SOM-16/2470/R/FSC/INGO/2527,7/26/2017 10:27:41 AM,Internally Displaced People,714,1176,1134,1176,4200,714,1176,1134,1176,4200
21,Somalia,2016,SOM-16/2470/R/FSC/INGO/2527,7/26/2017 10:27:41 AM,Overall,714,1176,1134,1176,4200,714,1176,1134,1176,4200
21,Somalia,2016,SOM-16/2470/R/FSC/NGO/2553,12/1/2017 5:37:43 AM,Internally Displaced People,550,680,550,440,2220,650,880,560,496,2586
21,Somalia,2016,SOM-16/2470/R/FSC/NGO/2553,12/1/2017 5:37:43 AM,Overall,550,680,550,440,2220,650,880,560,496,2586
21,Somalia,2016,SOM-16/2470/R/FSC/UN/2506,2/27/2017 7:44:34 AM,Overall,7643,5095,3275,2185,18198,120977,76946,50578,33745,282246
21,Somalia,2016,SOM-16/2470/R/FSC/UN/2582,11/30/2017 7:51:07 AM,Internally Displaced People,1462,2925,293,1170,5850,1200,3150,200,1300,5850
21,Somalia,2016,SOM-16/2470/R/FSC/UN/2582,11/30/2017 7:51:07 AM,Overall,1950,3900,390,1560,7800,1950,3900,390,1560,7800
21,Somalia,2016,SOM-16/2470/R/FSC/UN/2582,11/30/2017 7:51:07 AM,People in Host Communities,488,975,97,390,1950,302,1165,80,403,1950
21,Somalia,2016,SOM-16/2470/R/H/INGO/2500,1/18/2017 6:02:39 AM,Children under 5,0,0,13700,13701,27401,0,0,7523,8003,15526
21,Somalia,2016,SOM-16/2470/R/H/INGO/2500,1/18/2017 6:02:39 AM,Other,3423,5134,0,0,8557,3136,3967,0,0,7103
21,Somalia,2016,SOM-16/2470/R/H/INGO/2500,1/18/2017 6:02:39 AM,Overall,3657,12164,13700,13701,43222,3425,10951,7523,8003,29902
21,Somalia,2016,SOM-16/2470/R/H/INGO/2500,1/18/2017 6:02:39 AM,Pregnant and Lactating Women,0,6850,0,0,6850,0,6761,0,0,6761
21,Somalia,2016,SOM-16/2470/R/H/INGO/2500,1/18/2017 6:02:39 AM,"Trainers, Promoters, Caretakers, committee members, etc.",234,180,0,0,414,289,223,0,0,512
21,Somalia,2016,SOM-16/2470/R/H/INGO/2537,11/15/2017 12:56:06 PM,Children under 5,0,0,2200,2977,5177,0,0,2008,2580,4588
21,Somalia,2016,SOM-16/2470/R/H/INGO/2537,11/15/2017 12:56:06 PM,Other,705,37,0,0,742,850,37,0,0,887
21,Somalia,2016,SOM-16/2470/R/H/INGO/2537,11/15/2017 12:56:06 PM,Overall,705,8315,2200,2977,14197,850,7926,2008,2580,13364
21,Somalia,2016,SOM-16/2470/R/H/INGO/2537,11/15/2017 12:56:06 PM,Pregnant and Lactating Women,0,2850,0,0,2850,0,3580,0,0,3580
21,Somalia,2016,SOM-16/2470/R/H/INGO/2537,11/15/2017 12:56:06 PM,Women of Child-Bearing Age,0,5428,0,0,5428,0,4309,0,0,4309
21,Somalia,2016,SOM-16/2470/R/H/INGO/2543,11/15/2017 12:52:48 PM,Internally Displaced People/Returnees,1976,3857,4617,2639,13089,2411,3943,3268,2593,12215
21,Somalia,2016,SOM-16/2470/R/H/INGO/2543,11/15/2017 12:52:48 PM,Overall,1976,3857,4617,2639,13089,2411,3943,3268,2593,12215
21,Somalia,2016,SOM-16/2470/R/H/NGO/2501,7/3/2017 10:13:52 AM,Children under 5,0,0,6000,6000,12000,0,0,2977,3374,6351
21,Somalia,2016,SOM-16/2470/R/H/NGO/2501,7/3/2017 10:13:52 AM,Internally Displaced People,3000,3000,4000,4000,14000,1453,2878,1647,2633,8611
21,Somalia,2016,SOM-16/2470/R/H/NGO/2501,7/3/2017 10:13:52 AM,Overall,9000,15000,18000,18000,60000,3465,14138,6972,10586,35161
21,Somalia,2016,SOM-16/2470/R/H/NGO/2501,7/3/2017 10:13:52 AM,Pastoralists,6000,5000,8000,8000,27000,2012,4532,2348,4579,13471
21,Somalia,2016,SOM-16/2470/R/H/NGO/2501,7/3/2017 10:13:52 AM,Women of Child-Bearing Age,0,7000,0,0,7000,0,6728,0,0,6728
21,Somalia,2016,SOM-16/2470/R/H/NGO/2561,1/9/2018 12:24:33 PM,Overall,1553,2071,3107,3624,10355,1778,2272,3760,3944,11754
21,Somalia,2016,SOM-16/2470/R/H/UN/2574,11/28/2017 8:31:31 AM,Internally Displaced People/Returnees,2950,3950,6000,7140,20040,8393,19494,11490,14904,54281
21,Somalia,2016,SOM-16/2470/R/H/UN/2574,11/28/2017 8:31:31 AM,Overall,3950,5290,7920,9240,26400,12615,36589,16213,20538,85955
21,Somalia,2016,SOM-16/2470/R/H/UN/2574,11/28/2017 8:31:31 AM,People in Host Communities,1000,1340,1920,2100,6360,4222,17095,4723,5634,31674
21,Somalia,2016,SOM-16/2470/R/Nut/INGO/2485,12/20/2016 12:37:37 PM,Children under 5,0,0,4073,4073,8146,0,0,3750,4359,8109
21,Somalia,2016,SOM-16/2470/R/Nut/INGO/2485,12/20/2016 12:37:37 PM,Overall,1183,17692,4073,4073,27021,458,24650,3750,4359,33217
21,Somalia,2016,SOM-16/2470/R/Nut/INGO/2485,12/20/2016 12:37:37 PM,Pregnant and Lactating Women,0,2239,0,0,2239,0,458,0,0,458
21,Somalia,2016,SOM-16/2470/R/Nut/INGO/2485,12/20/2016 12:37:37 PM,Women of Child-Bearing Age,0,15453,0,0,15453,0,24650,0,0,24650
21,Somalia,2016,SOM-16/2470/R/Nut/INGO/2486,8/24/2017 7:28:20 AM,Children under 5,0,0,500,500,1000,0,0,320,306,626
21,Somalia,2016,SOM-16/2470/R/Nut/INGO/2486,8/24/2017 7:28:20 AM,Overall,345,1205,500,500,2550,313,1296,320,306,2235
21,Somalia,2016,SOM-16/2470/R/Nut/INGO/2486,8/24/2017 7:28:20 AM,"Staff (own or partner staff, authorities)",33,37,0,0,70,19,51,0,0,70
21,Somalia,2016,SOM-16/2470/R/Nut/INGO/2486,8/24/2017 7:28:20 AM,"Trainers, Promoters, Caretakers, committee members, etc.",312,168,0,0,480,294,302,0,0,596
21,Somalia,2016,SOM-16/2470/R/Nut/INGO/2486,8/24/2017 7:28:20 AM,Women of Child-Bearing Age,0,1000,0,0,1000,0,943,0,0,943
21,Somalia,2016,SOM-16/2470/R/Nut/INGO/2487,5/11/2017 6:45:53 AM,Children under 5,0,0,1250,1250,2500,0,0,2966,3509,6475
21,Somalia,2016,SOM-16/2470/R/Nut/INGO/2487,5/11/2017 6:45:53 AM,Overall,0,500,1250,1250,3000,0,660,2966,3509,7135
21,Somalia,2016,SOM-16/2470/R/Nut/INGO/2487,5/11/2017 6:45:53 AM,Pregnant and Lactating Women,0,500,0,0,500,0,660,0,0,660
21,Somalia,2016,SOM-16/2470/R/Nut/INGO/2560,3/8/2017 4:46:17 PM,Other,40,10,0,0,50,11,6,0,0,17
21,Somalia,2016,SOM-16/2470/R/Nut/INGO/2560,3/8/2017 4:46:17 PM,Overall,56,291,0,0,347,0,673,0,0,673
21,Somalia,2016,SOM-16/2470/R/Nut/INGO/2560,3/8/2017 4:46:17 PM,"Staff (own or partner staff, authorities)",6,6,0,0,12,0,4,0,0,4
21,Somalia,2016,SOM-16/2470/R/Nut/INGO/2560,3/8/2017 4:46:17 PM,"Trainers, Promoters, Caretakers, committee members, etc.",10,239,0,0,249,35,35,0,0,70
21,Somalia,2016,SOM-16/2470/R/Nut/INGO/2560,3/8/2017 4:46:17 PM,Women of Child-Bearing Age,0,36,0,0,36,0,668,0,0,668
21,Somalia,2016,SOM-16/2470/R/Prot/INGO/2512,5/11/2017 12:45:09 PM,Internally Displaced People,100,100,60,85,345,125,270,42,85,522
21,Somalia,2016,SOM-16/2470/R/Prot/INGO/2512,5/11/2017 12:45:09 PM,Overall,365,445,70,110,990,337,595,475,528,1935
21,Somalia,2016,SOM-16/2470/R/Prot/INGO/2512,5/11/2017 12:45:09 PM,People in Host Communities,90,90,60,75,315,100,94,0,7,201
21,Somalia,2016,SOM-16/2470/R/Prot/INGO/2512,5/11/2017 12:45:09 PM,Returnees,50,50,50,60,210,0,0,0,0,0
21,Somalia,2016,SOM-16/2470/R/Prot/INGO/2512,5/11/2017 12:45:09 PM,"Trainers, Promoters, Caretakers, committee members, etc.",60,60,0,0,120,14,18,0,0,32
21,Somalia,2016,SOM-16/2470/R/Prot/INGO/2514,1/24/2017 10:23:42 AM,Children under 18,0,0,1150,1150,2300,0,0,668,1580,2248
21,Somalia,2016,SOM-16/2470/R/Prot/INGO/2514,1/24/2017 10:23:42 AM,Children under 5,0,0,500,500,1000,0,0,621,786,1407
21,Somalia,2016,SOM-16/2470/R/Prot/INGO/2514,1/24/2017 10:23:42 AM,Internally Displaced People/Returnees,500,500,0,0,1000,2217,4491,2104,2651,11463
21,Somalia,2016,SOM-16/2470/R/Prot/INGO/2514,1/24/2017 10:23:42 AM,Overall,812,812,1650,1650,4924,917,2141,1454,2201,6713
21,Somalia,2016,SOM-16/2470/R/Prot/INGO/2514,1/24/2017 10:23:42 AM,Pastoralists,312,312,0,0,624,2217,4491,2104,8812,17624
21,Somalia,2016,SOM-16/2470/R/Prot/UN/2511,10/2/2018 8:49:15 AM,Children under 18,0,0,50,280,330,0,0,48,275,323
21,Somalia,2016,SOM-16/2470/R/Prot/UN/2511,10/2/2018 8:49:15 AM,Other,40,125,25,60,250,43,117,32,65,257
21,Somalia,2016,SOM-16/2470/R/Prot/UN/2511,10/2/2018 8:49:15 AM,Overall,200,400,100,300,1000,195,410,90,315,1010
21,Somalia,2016,SOM-16/2470/R/Prot/UN/2511,10/2/2018 8:49:15 AM,Returnees,10,25,5,10,50,8,23,8,12,51
21,Somalia,2016,SOM-16/2470/R/Prot/UN/2578,6/27/2017 6:08:24 AM,Internally Displaced People/Returnees,0,960,0,240,1200,0,1490,0,270,1760
21,Somalia,2016,SOM-16/2470/R/Prot/UN/2578,6/27/2017 6:08:24 AM,Overall,45,1235,0,300,1580,47,1785,0,340,2172
21,Somalia,2016,SOM-16/2470/R/Prot/UN/2578,6/27/2017 6:08:24 AM,People in Host Communities,0,240,0,60,300,0,250,0,70,320
21,Somalia,2016,SOM-16/2470/R/Prot/UN/2578,6/27/2017 6:08:24 AM,"Trainers, Promoters, Caretakers, committee members, etc.",45,35,0,0,80,47,45,0,0,92
21,Somalia,2016,SOM-16/2470/R/Shelter/UN/2516,3/21/2017 5:42:50 AM,Internally Displaced People,6400,8000,4800,4800,24000,6800,6000,3200,2000,18000
21,Somalia,2016,SOM-16/2470/R/Shelter/UN/2516,3/21/2017 5:42:50 AM,Overall,8000,10000,6000,6000,30000,8000,8000,7000,7000,30000
21,Somalia,2016,SOM-16/2470/R/Shelter/UN/2516,3/21/2017 5:42:50 AM,People in Host Communities,1600,2000,1200,1200,6000,2000,2300,750,950,6000
21,Somalia,2016,SOM-16/2470/R/Shelter/UN/2521,3/21/2017 5:44:36 AM,Internally Displaced People,3840,5760,5760,8640,24000,8500,11500,2500,1500,24000
21,Somalia,2016,SOM-16/2470/R/Shelter/UN/2521,3/21/2017 5:44:36 AM,Overall,3840,5760,5760,8640,24000,8500,11500,2500,1500,24000
21,Somalia,2016,SOM-16/2470/R/WASH/INGO/2479,1/24/2017 11:46:34 AM,Internally Displaced People/Returnees,2652,2548,3978,3822,13000,2179,2329,6293,6952,17753
21,Somalia,2016,SOM-16/2470/R/WASH/INGO/2479,1/24/2017 11:46:34 AM,Overall,2652,2548,3978,3822,13000,2179,2329,6293,6952,17753
21,Somalia,2016,SOM-16/2470/R/WASH/INGO/2481,10/17/2016 11:28:53 AM,Internally Displaced People/Returnees,2646,2754,1764,1836,9000,3763,4301,2957,2419,13440
21,Somalia,2016,SOM-16/2470/R/WASH/INGO/2481,10/17/2016 11:28:53 AM,Overall,3528,3672,2352,2448,12000,5376,4704,3024,3696,16800
21,Somalia,2016,SOM-16/2470/R/WASH/INGO/2481,10/17/2016 11:28:53 AM,People in Host Communities,882,918,588,612,3000,1075,941,739,605,3360
21,Somalia,2016,SOM-16/2470/R/WASH/INGO/2488,8/18/2016 9:15:15 AM,Agro-Pastoralists,393,1116,1123,1734,4366,0,0,0,0,0
21,Somalia,2016,SOM-16/2470/R/WASH/INGO/2488,8/18/2016 9:15:15 AM,Overall,3670,5504,5504,8255,22933,4876,7324,7300,10967,30467
21,Somalia,2016,SOM-16/2470/R/WASH/INGO/2488,8/18/2016 9:15:15 AM,Pastoralists,1384,1650,1661,2458,7153,4876,7324,7300,10967,30467
21,Somalia,2016,SOM-16/2470/R/WASH/INGO/2488,8/18/2016 9:15:15 AM,People in Host Communities,680,1254,1259,2264,5457,0,0,0,0,0
21,Somalia,2016,SOM-16/2470/R/WASH/INGO/2488,8/18/2016 9:15:15 AM,Urban Poor,1243,1454,1461,1799,5957,0,0,0,0,0
21,Somalia,2016,SOM-16/2470/R/WASH/INGO/2489,4/24/2017 4:39:31 AM,Internally Displaced People/Returnees,770,883,695,1143,3491,941,1073,1117,1325,4456
21,Somalia,2016,SOM-16/2470/R/WASH/INGO/2489,4/24/2017 4:39:31 AM,Overall,8865,11914,9559,14287,44625,6999,8805,9185,11612,36601
21,Somalia,2016,SOM-16/2470/R/WASH/INGO/2489,4/24/2017 4:39:31 AM,Pastoralists,1003,1500,1217,1714,5434,1376,1737,1656,2325,7094
21,Somalia,2016,SOM-16/2470/R/WASH/INGO/2489,4/24/2017 4:39:31 AM,People in Host Communities,7092,9531,7647,11430,35700,5014,5663,6413,7926,25016
21,Somalia,2016,SOM-16/2470/R/WASH/INGO/2491,12/16/2016 6:02:40 AM,Internally Displaced People,802,1002,1002,1202,4008,810,1030,1040,1250,4130
21,Somalia,2016,SOM-16/2470/R/WASH/INGO/2491,12/16/2016 6:02:40 AM,Overall,2004,2505,2505,3006,10020,2043,2553,2555,3064,10215
21,Somalia,2016,SOM-16/2470/R/WASH/INGO/2491,12/16/2016 6:02:40 AM,Pastoralists,1202,1503,1503,1804,6012,1233,1523,1515,1814,6085
21,Somalia,2016,SOM-16/2470/R/WASH/NGO/2494,8/23/2017 7:41:35 AM,Internally Displaced People,900,900,1200,1500,4500,450,750,900,900,3000
21,Somalia,2016,SOM-16/2470/R/WASH/NGO/2494,8/23/2017 7:41:35 AM,Overall,2250,3750,4500,4500,15000,2250,3750,4500,4500,15000
21,Somalia,2016,SOM-16/2470/R/WASH/NGO/2494,8/23/2017 7:41:35 AM,People in Host Communities,1650,1950,3150,3750,10500,1800,3000,3600,3600,12000
21,Somalia,2016,SOM-16/2470/R/WASH/NGO/2520,2/15/2017 6:25:22 AM,Internally Displaced People,0,0,0,0,0,10120,12375,12380,15125,50000
21,Somalia,2016,SOM-16/2470/R/WASH/NGO/2520,2/15/2017 6:25:22 AM,Overall,10120,12375,12380,15125,50000,10120,12375,12380,15125,50000
21,Somalia,2016,SOM-16/2470/R/WASH/UN/2482,2/15/2017 6:28:00 AM,Internally Displaced People,1350,1800,2700,3150,9000,1350,1800,2700,3150,9000
21,Somalia,2016,SOM-16/2470/R/WASH/UN/2482,2/15/2017 6:28:00 AM,Overall,1800,2400,3600,4200,12000,0,0,0,0,0
21,Somalia,2016,SOM-16/2470/R/WASH/UN/2482,2/15/2017 6:28:00 AM,People in Host Communities,450,600,900,1050,3000,450,600,900,1050,3000
21,Somalia,2016,SOM-16/2470/R/WASH/UN/2548,8/16/2018 7:32:12 AM,Internally Displaced People,1594,2125,3188,3719,10626,1639,2185,3278,3824,10926
21,Somalia,2016,SOM-16/2470/R/WASH/UN/2548,8/16/2018 7:32:12 AM,Overall,1875,2500,3750,4375,12500,1920,2560,3840,4480,12800
21,Somalia,2016,SOM-16/2470/R/WASH/UN/2548,8/16/2018 7:32:12 AM,People in Host Communities,281,375,562,656,1874,281,375,562,656,1874
21,Somalia,2016,SOM-16/3485/R/Ed/INGO/3168,8/15/2018 9:49:34 AM,Internally Displaced People/Returnees,67,23,3850,3150,7090,62,23,3889,1317,5291
21,Somalia,2016,SOM-16/3485/R/Ed/INGO/3168,8/15/2018 9:49:34 AM,Overall,224,75,5500,4500,10299,221,79,5476,3994,9770
21,Somalia,2016,SOM-16/3485/R/Ed/INGO/3168,8/15/2018 9:49:34 AM,People in Host Communities,157,52,1650,1350,3209,159,56,1587,2677,4479
21,Somalia,2016,SOM-16/3485/R/Ed/INGO/3777,1/9/2018 12:19:12 PM,Children under 18,0,0,823,823,1646,0,0,900,746,1646
21,Somalia,2016,SOM-16/3485/R/Ed/INGO/3777,1/9/2018 12:19:12 PM,Overall,42,41,823,823,1729,42,41,900,746,1729
21,Somalia,2016,SOM-16/3485/R/Ed/INGO/3777,1/9/2018 12:19:12 PM,"Trainers, Promoters, Caretakers, committee members, etc.",42,41,0,0,83,42,41,0,0,83
21,Somalia,2016,SOM-16/3485/R/Ed/INGO/3929,3/5/2018 10:42:09 AM,Children under 18,0,0,1140,1140,2280,0,0,1237,1098,2335
21,Somalia,2016,SOM-16/3485/R/Ed/INGO/3929,3/5/2018 10:42:09 AM,Committees,24,18,0,0,42,22,20,0,0,42
21,Somalia,2016,SOM-16/3485/R/Ed/INGO/3929,3/5/2018 10:42:09 AM,Overall,38,28,1140,1140,2346,40,26,1237,1098,2401
21,Somalia,2016,SOM-16/3485/R/Ed/INGO/3929,3/5/2018 10:42:09 AM,"Staff (own or partner staff, authorities)",14,10,0,0,24,18,6,0,0,24
21,Somalia,2016,SOM-16/3485/R/Ed/NGO/3706,2/20/2018 7:16:43 AM,Internally Displaced People,90,70,1500,1450,3110,93,78,1572,1550,3293
21,Somalia,2016,SOM-16/3485/R/Ed/NGO/3706,2/20/2018 7:16:43 AM,Overall,110,86,1800,1700,3696,103,93,1808,1892,3896
21,Somalia,2016,SOM-16/3485/R/Ed/NGO/3706,2/20/2018 7:16:43 AM,People in Host Communities,20,16,300,250,586,10,15,320,258,603
21,Somalia,2016,SOM-16/3485/R/Ed-WASH/INGO/4449,10/5/2017 10:59:12 AM,Agro-Pastoralists,1751,2140,0,0,3891,1171,1394,3238,3153,8956
21,Somalia,2016,SOM-16/3485/R/Ed-WASH/INGO/4449,10/5/2017 10:59:12 AM,Children under 18,0,0,4290,3510,7800,0,0,6166,6086,12252
21,Somalia,2016,SOM-16/3485/R/Ed-WASH/INGO/4449,10/5/2017 10:59:12 AM,Internally Displaced People,1489,1820,0,0,3309,991,1056,2928,2933,7908
21,Somalia,2016,SOM-16/3485/R/Ed-WASH/INGO/4449,10/5/2017 10:59:12 AM,Overall,3240,3960,4290,3510,15000,2162,2450,6166,6086,16864
21,Somalia,2016,SOM-16/3485/R/EP/INGO/4128,10/6/2017 8:15:48 AM,Overall,7500,2500,0,0,10000,7500,2500,0,0,10000
21,Somalia,2016,SOM-16/3485/R/EP/INGO/4128,10/6/2017 8:15:48 AM,"Staff (own or partner staff, authorities)",7500,2500,0,0,10000,7500,2500,0,0,10000
21,Somalia,2016,SOM-16/3485/R/EP/INGO/4328,4/12/2018 5:43:56 AM,Overall,40,40,0,0,80,42,42,0,0,84
21,Somalia,2016,SOM-16/3485/R/EP/UN/3492,8/23/2017 12:41:56 PM,Overall,2359634,2320366,0,0,4680000,2359634,2320366,0,0,4680000
21,Somalia,2016,SOM-16/3485/R/FSC/INGO/2539,12/13/2017 5:40:41 AM,Internally Displaced People/Returnees,176,308,905,814,2203,176,308,905,814,2203
21,Somalia,2016,SOM-16/3485/R/FSC/INGO/2539,12/13/2017 5:40:41 AM,Overall,294,514,1505,1359,3672,294,514,1505,1359,3672
21,Somalia,2016,SOM-16/3485/R/FSC/INGO/2539,12/13/2017 5:40:41 AM,People in Host Communities,73,129,376,340,918,73,129,376,340,918
21,Somalia,2016,SOM-16/3485/R/FSC/INGO/2551,9/7/2017 12:19:49 PM,Internally Displaced People,630,945,630,945,3150,630,945,630,945,3150
21,Somalia,2016,SOM-16/3485/R/FSC/INGO/2551,9/7/2017 12:19:49 PM,Overall,840,1260,840,1260,4200,840,1260,840,1260,4200
21,Somalia,2016,SOM-16/3485/R/FSC/INGO/2551,9/7/2017 12:19:49 PM,Urban Poor,210,315,210,315,1050,210,315,210,315,1050
21,Somalia,2016,SOM-16/3485/R/FSC/INGO/2567,5/29/2017 9:32:10 AM,Internally Displaced People,633,875,1724,1793,5025,758,862,1897,1707,5224
21,Somalia,2016,SOM-16/3485/R/FSC/INGO/2567,5/29/2017 9:32:10 AM,Overall,633,875,1724,1793,5025,758,862,1897,1707,5224
21,Somalia,2016,SOM-16/3485/R/FSC/INGO/3817,10/19/2017 8:33:48 AM,Internally Displaced People,130,227,664,599,1620,464,266,541,346,1617
21,Somalia,2016,SOM-16/3485/R/FSC/INGO/3817,10/19/2017 8:33:48 AM,Overall,143,254,737,666,1800,579,332,676,433,2020
21,Somalia,2016,SOM-16/3485/R/FSC/INGO/3817,10/19/2017 8:33:48 AM,People in Host Communities,13,27,73,67,180,115,66,135,87,403
21,Somalia,2016,SOM-16/3485/R/FSC/INGO/3896,3/19/2018 6:00:46 AM,Internally Displaced People/Returnees,60,144,0,0,204,50,165,0,0,215
21,Somalia,2016,SOM-16/3485/R/FSC/INGO/3896,3/19/2018 6:00:46 AM,Overall,70,215,0,0,285,70,215,0,0,285
21,Somalia,2016,SOM-16/3485/R/FSC/INGO/3896,3/19/2018 6:00:46 AM,People in Host Communities,10,32,0,0,42,20,50,0,0,70
21,Somalia,2016,SOM-16/3485/R/FSC/INGO/3896,3/19/2018 6:00:46 AM,Women of Child-Bearing Age,0,39,0,0,39,0,200,0,0,200
21,Somalia,2016,SOM-16/3485/R/FSC/INGO/3901,5/24/2018 8:25:02 AM,Internally Displaced People/Returnees,28,150,0,0,178,28,155,422,413,1018
21,Somalia,2016,SOM-16/3485/R/FSC/INGO/3901,5/24/2018 8:25:02 AM,Overall,28,150,0,0,178,28,155,422,413,1018
21,Somalia,2016,SOM-16/3485/R/FSC/INGO/4458,10/19/2017 12:18:50 PM,Agro-Pastoralists,81,135,129,135,480,81,135,129,135,480
21,Somalia,2016,SOM-16/3485/R/FSC/INGO/4458,10/19/2017 12:18:50 PM,Overall,530,874,842,874,3120,530,874,842,874,3120
21,Somalia,2016,SOM-16/3485/R/FSC/INGO/4458,10/19/2017 12:18:50 PM,Pastoralists,449,739,713,739,2640,449,739,713,739,2640
21,Somalia,2016,SOM-16/3485/R/FSC/INGO/4468,10/3/2017 11:13:29 AM,Agro-Pastoralists,1478,1430,1156,1156,5220,1646,1661,1097,1109,5513
21,Somalia,2016,SOM-16/3485/R/FSC/INGO/4468,10/3/2017 11:13:29 AM,Overall,2190,2122,1714,1714,7740,2184,1971,2683,2548,9386
21,Somalia,2016,SOM-16/3485/R/FSC/INGO/4468,10/3/2017 11:13:29 AM,Pastoralists,712,691,558,558,2519,893,850,305,322,2370
21,Somalia,2016,SOM-16/3485/R/FSC/INGO/4483,10/2/2017 5:44:02 AM,Children under 18,0,0,4773,4558,9331,0,0,4123,4338,8461
21,Somalia,2016,SOM-16/3485/R/FSC/INGO/4483,10/2/2017 5:44:02 AM,Children under 5,0,0,1233,1217,2450,0,0,4074,4236,8310
21,Somalia,2016,SOM-16/3485/R/FSC/INGO/4483,10/2/2017 5:44:02 AM,Overall,5775,5544,6006,5775,23100,9122,9655,4074,4236,27087
21,Somalia,2016,SOM-16/3485/R/FSC/INGO/4483,10/2/2017 5:44:02 AM,People in Host Communities,5775,5544,0,0,11319,4999,5317,0,0,10316
21,Somalia,2016,SOM-16/3485/R/FSC/NGO/3891,3/7/2018 12:35:16 PM,Internally Displaced People,261,391,87,131,870,261,391,87,131,870
21,Somalia,2016,SOM-16/3485/R/FSC/NGO/3891,3/7/2018 12:35:16 PM,Overall,261,391,87,131,870,261,391,87,131,870
21,Somalia,2016,SOM-16/3485/R/FSC/UN/3902,2/8/2018 7:44:03 AM,Internally Displaced People,706,1646,176,412,2940,706,1646,176,412,2940
21,Somalia,2016,SOM-16/3485/R/FSC/UN/3902,2/8/2018 7:44:03 AM,Overall,706,1646,176,412,2940,706,1646,176,412,2940
21,Somalia,2016,SOM-16/3485/R/H/INGO/3774,2/20/2018 7:21:16 AM,Children under 5,0,0,9000,8000,17000,0,0,6939,9019,15958
21,Somalia,2016,SOM-16/3485/R/H/INGO/3774,2/20/2018 7:21:16 AM,Other,50,50,0,0,100,25,75,0,0,100
21,Somalia,2016,SOM-16/3485/R/H/INGO/3774,2/20/2018 7:21:16 AM,Overall,60,10320,9000,8000,27380,33,10747,6939,9019,26738
21,Somalia,2016,SOM-16/3485/R/H/INGO/3774,2/20/2018 7:21:16 AM,"Staff (own or partner staff, authorities)",10,20,0,0,30,8,17,0,0,25
21,Somalia,2016,SOM-16/3485/R/H/INGO/3774,2/20/2018 7:21:16 AM,Women of Child-Bearing Age,0,10250,0,0,10250,0,10747,0,0,10747
21,Somalia,2016,SOM-16/3485/R/H/INGO/3911,3/15/2018 7:28:52 AM,Internally Displaced People,12084,21136,4028,4277,41525,8927,39121,13216,13228,74492
21,Somalia,2016,SOM-16/3485/R/H/INGO/3911,3/15/2018 7:28:52 AM,Overall,12084,21136,4028,4277,41525,8927,39121,13216,13228,74492
21,Somalia,2016,SOM-16/3485/R/H/INGO/4460,2/5/2018 7:30:48 AM,Children under 5,0,0,2205,2205,4410,0,0,3956,4920,8876
21,Somalia,2016,SOM-16/3485/R/H/INGO/4460,2/5/2018 7:30:48 AM,Internally Displaced People,2656,2994,649,649,6948,891,1281,222,380,2774
21,Somalia,2016,SOM-16/3485/R/H/INGO/4460,2/5/2018 7:30:48 AM,Overall,9068,12210,2854,2854,26986,6028,13430,4179,5211,28848
21,Somalia,2016,SOM-16/3485/R/H/INGO/4460,2/5/2018 7:30:48 AM,People in Host Communities,6412,6677,0,0,13089,5130,7406,0,0,12536
21,Somalia,2016,SOM-16/3485/R/H/INGO/4460,2/5/2018 7:30:48 AM,Pregnant and Lactating Women,0,2539,0,0,2539,0,4771,0,0,4771
21,Somalia,2016,SOM-16/3485/R/H/NGO/2540,1/15/2018 12:33:09 PM,Internally Displaced People,355,12278,3500,4174,20307,355,12278,3500,4174,20307
21,Somalia,2016,SOM-16/3485/R/H/NGO/2540,1/15/2018 12:33:09 PM,Overall,384,12307,3500,4174,20365,384,12307,3500,4174,20365
21,Somalia,2016,SOM-16/3485/R/H/NGO/2540,1/15/2018 12:33:09 PM,"Staff (own or partner staff, authorities)",29,29,0,0,58,29,29,0,0,58
21,Somalia,2016,SOM-16/3485/R/H/NGO/3752,1/24/2018 12:41:54 PM,Children under 5,0,0,2000,2000,4000,0,0,2200,2300,4500
21,Somalia,2016,SOM-16/3485/R/H/NGO/3752,1/24/2018 12:41:54 PM,Overall,1440,4055,2000,2000,9495,1728,4460,2200,2300,10688
21,Somalia,2016,SOM-16/3485/R/H/NGO/3845,1/29/2018 12:19:18 PM,Children under 5,0,0,3500,3500,7000,0,0,3470,3600,7070
21,Somalia,2016,SOM-16/3485/R/H/NGO/3845,1/29/2018 12:19:18 PM,Internally Displaced People,6860,7840,2450,2450,19600,6910,8660,2670,3324,21564
21,Somalia,2016,SOM-16/3485/R/H/NGO/3845,1/29/2018 12:19:18 PM,Overall,9800,11200,7000,7000,35000,9910,11940,6970,7824,36644
21,Somalia,2016,SOM-16/3485/R/H/NGO/3845,1/29/2018 12:19:18 PM,People in Host Communities,2940,3360,1050,1050,8400,3000,3280,830,900,8010
21,Somalia,2016,SOM-16/3485/R/H/NGO/4463,10/24/2017 9:14:40 AM,Internally Displaced People/Returnees,5068,7930,1545,2090,16633,5068,7930,1545,2090,16633
21,Somalia,2016,SOM-16/3485/R/H/NGO/4463,10/24/2017 9:14:40 AM,Overall,7488,11232,2745,3495,24960,7488,11232,2745,3495,24960
21,Somalia,2016,SOM-16/3485/R/H/NGO/4463,10/24/2017 9:14:40 AM,People in Host Communities,2410,3277,1200,1405,8292,2410,3277,1200,1405,8292
21,Somalia,2016,SOM-16/3485/R/H/NGO/4463,10/24/2017 9:14:40 AM,"Staff (own or partner staff, authorities)",10,25,0,0,35,10,25,0,0,35
21,Somalia,2016,SOM-16/3485/R/H/NGO/4478,10/30/2017 8:38:58 AM,Overall,1650,2200,3300,3850,11000,971,1798,2240,3145,8154
21,Somalia,2016,SOM-16/3485/R/H/NGO/4478,10/30/2017 8:38:58 AM,Pastoralists,825,300,1650,1925,4700,750,300,1120,1595,3765
21,Somalia,2016,SOM-16/3485/R/H/NGO/4478,10/30/2017 8:38:58 AM,People in HE and/or AFLC,825,1100,1650,1925,5500,221,698,1120,1550,3589
21,Somalia,2016,SOM-16/3485/R/H/NGO/4478,10/30/2017 8:38:58 AM,Women of Child-Bearing Age,0,800,0,0,800,0,800,0,0,800
21,Somalia,2016,SOM-16/3485/R/H/UN/3885,8/17/2018 7:17:16 AM,Internally Displaced People,3672,4896,7344,8568,24480,4103,6651,7185,8857,26796
21,Somalia,2016,SOM-16/3485/R/H/UN/3885,8/17/2018 7:17:16 AM,Overall,4320,5760,8640,10080,28800,4103,6651,7185,8857,26796
21,Somalia,2016,SOM-16/3485/R/H/UN/3885,8/17/2018 7:17:16 AM,People in Host Communities,648,864,1296,1512,4320,0,0,0,0,0
21,Somalia,2016,SOM-16/3485/R/Nut/INGO/2558,11/1/2017 5:31:52 AM,Children under 5,0,0,1658,2158,3816,0,0,5153,5937,11090
21,Somalia,2016,SOM-16/3485/R/Nut/INGO/2558,11/1/2017 5:31:52 AM,Internally Displaced People/Returnees,1500,2000,0,0,3500,0,0,0,0,0
21,Somalia,2016,SOM-16/3485/R/Nut/INGO/2558,11/1/2017 5:31:52 AM,Overall,1515,5013,1658,2158,10344,1721,8632,5153,5937,21443
21,Somalia,2016,SOM-16/3485/R/Nut/INGO/2558,11/1/2017 5:31:52 AM,Pregnant and Lactating Women,0,3000,0,0,3000,0,8632,0,0,8632
21,Somalia,2016,SOM-16/3485/R/Nut/INGO/2558,11/1/2017 5:31:52 AM,"Trainers, Promoters, Caretakers, committee members, etc.",15,13,0,0,28,18,53,0,0,71
21,Somalia,2016,SOM-16/3485/R/Nut/INGO/2569,5/2/2018 9:17:00 AM,Children under 5,0,0,4921,4921,9842,0,0,20349,25232,45581
21,Somalia,2016,SOM-16/3485/R/Nut/INGO/2569,5/2/2018 9:17:00 AM,Internally Displaced People,1733,0,0,0,1733,14609,0,0,0,14609
21,Somalia,2016,SOM-16/3485/R/Nut/INGO/2569,5/2/2018 9:17:00 AM,Overall,1733,19926,4921,4921,31501,14609,22903,20349,25232,83093
21,Somalia,2016,SOM-16/3485/R/Nut/INGO/2569,5/2/2018 9:17:00 AM,Pregnant and Lactating Women,0,642,0,0,642,0,7679,0,0,7679
21,Somalia,2016,SOM-16/3485/R/Nut/INGO/2569,5/2/2018 9:17:00 AM,Women of Child-Bearing Age,0,19284,0,0,19284,0,15224,0,0,15224
21,Somalia,2016,SOM-16/3485/R/Nut/INGO/3759,3/19/2018 6:12:10 AM,Internally Displaced People,0,0,0,0,0,176,5166,1882,2666,9890
21,Somalia,2016,SOM-16/3485/R/Nut/INGO/3759,3/19/2018 6:12:10 AM,Overall,300,2700,1530,1470,6000,286,5476,1882,2666,10310
21,Somalia,2016,SOM-16/3485/R/Nut/INGO/3759,3/19/2018 6:12:10 AM,"Staff (own or partner staff, authorities)",0,0,0,0,0,10,10,0,0,20
21,Somalia,2016,SOM-16/3485/R/Nut/INGO/3759,3/19/2018 6:12:10 AM,"Trainers, Promoters, Caretakers, committee members, etc.",100,250,0,0,350,100,300,0,0,400
21,Somalia,2016,SOM-16/3485/R/Nut/INGO/3826,4/24/2018 10:00:51 AM,Children under 5,0,0,1972,1950,3922,0,0,1600,2127,3727
21,Somalia,2016,SOM-16/3485/R/Nut/INGO/3826,4/24/2018 10:00:51 AM,Overall,8,1774,1972,1950,5704,8,1755,1600,2127,5490
21,Somalia,2016,SOM-16/3485/R/Nut/INGO/3826,4/24/2018 10:00:51 AM,Pregnant and Lactating Women,0,1765,0,0,1765,0,1755,0,0,1755
21,Somalia,2016,SOM-16/3485/R/Nut/INGO/3826,4/24/2018 10:00:51 AM,"Staff (own or partner staff, authorities)",8,9,0,0,17,8,9,0,0,17
21,Somalia,2016,SOM-16/3485/R/Nut/INGO/3893,2/22/2018 7:32:24 AM,Children under 5,0,0,3662,3663,7325,0,0,5089,6543,11632
21,Somalia,2016,SOM-16/3485/R/Nut/INGO/3893,2/22/2018 7:32:24 AM,Overall,1075,8850,3662,3663,17250,362,18765,5089,6543,30759
21,Somalia,2016,SOM-16/3485/R/Nut/INGO/3893,2/22/2018 7:32:24 AM,Pregnant and Lactating Women,0,1311,0,0,1311,0,3200,0,0,3200
21,Somalia,2016,SOM-16/3485/R/Nut/INGO/3893,2/22/2018 7:32:24 AM,Women of Child-Bearing Age,0,7539,0,0,7539,0,15927,0,0,15927
21,Somalia,2016,SOM-16/3485/R/Nut/NGO/2546,2/22/2018 11:46:12 AM,Children under 5,0,0,1000,1100,2100,0,0,1200,1190,2390
21,Somalia,2016,SOM-16/3485/R/Nut/NGO/2546,2/22/2018 11:46:12 AM,Overall,0,500,1000,1100,2600,0,600,1200,1190,2990
21,Somalia,2016,SOM-16/3485/R/Nut/NGO/2546,2/22/2018 11:46:12 AM,Pregnant and Lactating Women,0,500,0,0,500,0,600,1200,1190,2990
21,Somalia,2016,SOM-16/3485/R/Nut/NGO/2556,3/6/2018 8:06:17 AM,Children under 5,0,0,2145,2233,4378,0,0,1433,1492,2925
21,Somalia,2016,SOM-16/3485/R/Nut/NGO/2556,3/6/2018 8:06:17 AM,Internally Displaced People,10757,11190,0,0,21947,7203,17662,0,0,24865
21,Somalia,2016,SOM-16/3485/R/Nut/NGO/2556,3/6/2018 8:06:17 AM,Overall,10757,11190,2145,2233,26325,7203,17662,1532,1563,27960
21,Somalia,2016,SOM-16/3485/R/Nut/NGO/3751,5/2/2018 11:19:13 AM,Children under 5,0,0,1500,1500,3000,0,0,1659,1715,3374
21,Somalia,2016,SOM-16/3485/R/Nut/NGO/3751,5/2/2018 11:19:13 AM,Overall,26,1038,1500,1500,4064,26,1179,1659,1715,4579
21,Somalia,2016,SOM-16/3485/R/Nut/NGO/3751,5/2/2018 11:19:13 AM,Pregnant and Lactating Women,0,1000,0,0,1000,0,1179,0,0,1179
21,Somalia,2016,SOM-16/3485/R/Nut/NGO/3848,2/26/2018 5:46:59 AM,Children under 5,0,0,1350,1350,2700,0,0,1290,1512,2802
21,Somalia,2016,SOM-16/3485/R/Nut/NGO/3848,2/26/2018 5:46:59 AM,Overall,100,900,1350,1350,3700,100,2526,1290,1512,5428
21,Somalia,2016,SOM-16/3485/R/Nut/NGO/3848,2/26/2018 5:46:59 AM,Pregnant and Lactating Women,0,800,0,0,800,0,2526,0,0,2526
21,Somalia,2016,SOM-16/3485/R/Nut/NGO/3848,2/26/2018 5:46:59 AM,"Trainers, Promoters, Caretakers, committee members, etc.",100,100,0,0,200,100,100,0,0,200
21,Somalia,2016,SOM-16/3485/R/Nut/UN/4479,2/20/2018 10:59:37 AM,Children under 5,0,0,4410,4590,9000,0,0,4410,4590,9000
21,Somalia,2016,SOM-16/3485/R/Nut/UN/4479,2/20/2018 10:59:37 AM,Overall,0,182250,4410,4590,191250,0,96428,4410,4590,105428
21,Somalia,2016,SOM-16/3485/R/Nut/UN/4479,2/20/2018 10:59:37 AM,Pregnant and Lactating Women,0,182250,0,0,182250,0,96428,0,0,96428
21,Somalia,2016,SOM-16/3485/R/Prot/INGO/2544,3/16/2018 6:21:33 AM,Internally Displaced People/Returnees,1090,2190,500,500,4280,2089,2813,1600,2358,8860
21,Somalia,2016,SOM-16/3485/R/Prot/INGO/2544,3/16/2018 6:21:33 AM,Overall,1090,2190,500,500,4280,2089,2813,1600,2358,8860
21,Somalia,2016,SOM-16/3485/R/Prot/INGO/2547,9/5/2017 7:53:55 AM,Children under 18,0,0,500,500,1000,0,0,490,520,1010
21,Somalia,2016,SOM-16/3485/R/Prot/INGO/2547,9/5/2017 7:53:55 AM,Internally Displaced People,150,430,70,100,750,280,1029,100,130,1539
21,Somalia,2016,SOM-16/3485/R/Prot/INGO/2547,9/5/2017 7:53:55 AM,Overall,270,560,570,600,2000,350,1100,590,650,2690
21,Somalia,2016,SOM-16/3485/R/Prot/INGO/2547,9/5/2017 7:53:55 AM,"Staff (own or partner staff, authorities)",120,130,0,0,250,70,71,0,0,141
21,Somalia,2016,SOM-16/3485/R/Prot/INGO/2575,7/3/2017 8:10:37 AM,Children under 18,0,0,490,460,950,0,0,1076,921,1997
21,Somalia,2016,SOM-16/3485/R/Prot/INGO/2575,7/3/2017 8:10:37 AM,Internally Displaced People,220,220,0,0,440,850,1356,978,847,4031
21,Somalia,2016,SOM-16/3485/R/Prot/INGO/2575,7/3/2017 8:10:37 AM,Overall,220,220,490,460,1390,850,1356,1076,921,4203
21,Somalia,2016,SOM-16/3485/R/Prot/INGO/2579,1/29/2018 9:46:10 AM,Committees,20,10,0,0,30,53,42,0,0,95
21,Somalia,2016,SOM-16/3485/R/Prot/INGO/2579,1/29/2018 9:46:10 AM,Internally Displaced People/Returnees,4900,6500,100,500,12000,8281,15453,271,631,24636
21,Somalia,2016,SOM-16/3485/R/Prot/INGO/2579,1/29/2018 9:46:10 AM,Overall,6000,8000,120,610,14730,9403,16639,293,665,27000
21,Somalia,2016,SOM-16/3485/R/Prot/INGO/2579,1/29/2018 9:46:10 AM,People in Host Communities,980,1390,20,110,2500,1042,1135,22,34,2233
21,Somalia,2016,SOM-16/3485/R/Prot/INGO/2579,1/29/2018 9:46:10 AM,"Staff (own or partner staff, authorities)",100,100,0,0,200,27,9,0,0,36
21,Somalia,2016,SOM-16/3485/R/Prot/INGO/3824,1/16/2018 11:08:20 AM,Children under 18,0,0,0,0,0,0,0,99,74,173
21,Somalia,2016,SOM-16/3485/R/Prot/INGO/3824,1/16/2018 11:08:20 AM,Internally Displaced People,959,959,1479,1479,4876,912,765,1098,730,3505
21,Somalia,2016,SOM-16/3485/R/Prot/INGO/3824,1/16/2018 11:08:20 AM,Overall,1132,1132,1720,1720,5704,730,1080,2012,1788,5610
21,Somalia,2016,SOM-16/3485/R/Prot/INGO/3824,1/16/2018 11:08:20 AM,People in Host Communities,158,158,241,241,798,139,129,914,622,1804
21,Somalia,2016,SOM-16/3485/R/Prot/INGO/3824,1/16/2018 11:08:20 AM,"Staff (own or partner staff, authorities)",15,15,0,0,30,14,16,0,0,30
21,Somalia,2016,SOM-16/3485/R/Prot/INGO/3905,4/25/2018 7:24:00 AM,Children under 18,0,0,0,0,0,0,0,161,132,293
21,Somalia,2016,SOM-16/3485/R/Prot/INGO/3905,4/25/2018 7:24:00 AM,Internally Displaced People,0,0,0,0,0,0,0,1091,1036,2127
21,Somalia,2016,SOM-16/3485/R/Prot/INGO/3905,4/25/2018 7:24:00 AM,Overall,600,736,701,850,2887,729,1457,1091,1036,4313
21,Somalia,2016,SOM-16/3485/R/Prot/INGO/3905,4/25/2018 7:24:00 AM,People in Host Communities,0,0,0,0,0,513,1292,1054,1021,3880
21,Somalia,2016,SOM-16/3485/R/Prot/INGO/3905,4/25/2018 7:24:00 AM,"Trainers, Promoters, Caretakers, committee members, etc.",0,0,0,0,0,200,145,37,15,397
21,Somalia,2016,SOM-16/3485/R/Prot/INGO/3948,3/19/2018 6:07:15 AM,Committees,34,8,0,0,42,51,22,0,0,73
21,Somalia,2016,SOM-16/3485/R/Prot/INGO/3948,3/19/2018 6:07:15 AM,Internally Displaced People/Returnees,3000,4000,60,305,7365,3472,3975,159,238,7844
21,Somalia,2016,SOM-16/3485/R/Prot/INGO/3948,3/19/2018 6:07:15 AM,Other,32,8,0,0,40,235,260,10,16,521
21,Somalia,2016,SOM-16/3485/R/Prot/INGO/3948,3/19/2018 6:07:15 AM,Overall,3816,5016,75,381,9288,4624,5172,207,311,10314
21,Somalia,2016,SOM-16/3485/R/Prot/INGO/3948,3/19/2018 6:07:15 AM,People in Host Communities,750,1000,15,76,1841,844,937,38,57,1876
21,Somalia,2016,SOM-16/3485/R/Prot/NGO/2532,7/25/2017 7:43:45 AM,Internally Displaced People/Returnees,500,700,500,800,2500,500,700,500,800,2500
21,Somalia,2016,SOM-16/3485/R/Prot/NGO/2532,7/25/2017 7:43:45 AM,Overall,700,1000,500,800,3000,700,1000,500,800,3000
21,Somalia,2016,SOM-16/3485/R/Prot/NGO/2532,7/25/2017 7:43:45 AM,People in Host Communities,200,300,0,0,500,200,300,0,0,500
21,Somalia,2016,SOM-16/3485/R/Prot/NGO/3801,5/18/2018 8:07:00 AM,Internally Displaced People,1446,1774,10,40,3270,504,2589,237,170,3500
21,Somalia,2016,SOM-16/3485/R/Prot/NGO/3801,5/18/2018 8:07:00 AM,Overall,1515,1955,10,40,3520,504,2589,237,170,3500
21,Somalia,2016,SOM-16/3485/R/Prot/NGO/3801,5/18/2018 8:07:00 AM,"Trainers, Promoters, Caretakers, committee members, etc.",69,181,0,0,250,2,8,0,0,10
21,Somalia,2016,SOM-16/3485/R/Prot/NGO/3897,7/25/2018 6:00:31 AM,Internally Displaced People,800,4000,800,800,6400,800,4000,800,800,6400
21,Somalia,2016,SOM-16/3485/R/Prot/NGO/3897,7/25/2018 6:00:31 AM,Internally Displaced People/Returnees,400,1600,800,800,3600,400,1600,800,800,3600
21,Somalia,2016,SOM-16/3485/R/Prot/NGO/3897,7/25/2018 6:00:31 AM,Overall,1920,6400,2000,2000,12320,1651,5955,1613,1840,11059
21,Somalia,2016,SOM-16/3485/R/Prot/NGO/3897,7/25/2018 6:00:31 AM,"Trainers, Promoters, Caretakers, committee members, etc.",720,800,400,400,2320,451,355,13,240,1059
21,Somalia,2016,SOM-16/3485/R/Prot/UN/3916,5/2/2018 6:28:32 AM,Aid Agencies,45,70,0,0,115,45,70,0,0,115
21,Somalia,2016,SOM-16/3485/R/Prot/UN/3916,5/2/2018 6:28:32 AM,Internally Displaced People,385,1105,220,275,1985,1168,2444,270,517,4399
21,Somalia,2016,SOM-16/3485/R/Prot/UN/3916,5/2/2018 6:28:32 AM,Overall,520,1375,250,355,2500,1303,2714,300,597,4914
21,Somalia,2016,SOM-16/3485/R/Prot/UN/3916,5/2/2018 6:28:32 AM,People in Host Communities,90,200,30,80,400,0,0,0,0,0
21,Somalia,2016,SOM-16/3485/R/Shelter/INGO/2526,12/20/2017 7:24:51 AM,Internally Displaced People,405,389,174,167,1135,206,192,490,268,1156
21,Somalia,2016,SOM-16/3485/R/Shelter/INGO/2526,12/20/2017 7:24:51 AM,Overall,578,556,248,238,1620,280,274,735,519,1808
21,Somalia,2016,SOM-16/3485/R/Shelter/INGO/2526,12/20/2017 7:24:51 AM,People in Host Communities,173,167,74,71,485,74,82,245,251,652
21,Somalia,2016,SOM-16/3485/R/Shelter/INGO/2534,12/26/2017 6:01:26 AM,Internally Displaced People/Returnees,3842,5765,3842,5763,19212,5120,8192,3072,4096,20480
21,Somalia,2016,SOM-16/3485/R/Shelter/INGO/2534,12/26/2017 6:01:26 AM,Overall,3842,5765,3842,5763,19212,5120,8192,3072,4096,20480
21,Somalia,2016,SOM-16/3485/R/Shelter/INGO/3880,1/30/2018 10:39:44 AM,Internally Displaced People,1080,1620,1350,1350,5400,1033,1269,1588,1546,5436
21,Somalia,2016,SOM-16/3485/R/Shelter/INGO/3880,1/30/2018 10:39:44 AM,Overall,1080,1620,1350,1350,5400,1033,1269,1588,1546,5436
21,Somalia,2016,SOM-16/3485/R/Shelter/INGO/3930,2/22/2018 6:40:42 AM,Internally Displaced People,1349,1297,578,556,3780,1298,1156,2002,1473,5929
21,Somalia,2016,SOM-16/3485/R/Shelter/INGO/3930,2/22/2018 6:40:42 AM,Overall,1928,1852,826,794,5400,1298,1156,2002,1473,5929
21,Somalia,2016,SOM-16/3485/R/Shelter/INGO/3930,2/22/2018 6:40:42 AM,People in Host Communities,579,555,248,238,1620,0,0,0,0,0
21,Somalia,2016,SOM-16/3485/R/Shelter/NGO/2529,12/26/2017 5:55:58 AM,Internally Displaced People,360,420,180,240,1200,720,840,360,480,2400
21,Somalia,2016,SOM-16/3485/R/Shelter/NGO/2529,12/26/2017 5:55:58 AM,Overall,360,420,180,240,1200,360,420,180,240,1200
21,Somalia,2016,SOM-16/3485/R/Shelter/NGO/2552,12/7/2017 1:09:15 PM,Internally Displaced People,812,869,638,681,3000,812,869,638,681,3000
21,Somalia,2016,SOM-16/3485/R/Shelter/NGO/2552,12/7/2017 1:09:15 PM,Overall,812,869,638,681,3000,812,869,638,681,3000
21,Somalia,2016,SOM-16/3485/R/Shelter/NGO/3898,2/21/2018 7:00:27 AM,Internally Displaced People,1435,1349,1248,1368,5400,1435,1349,1248,1368,5400
21,Somalia,2016,SOM-16/3485/R/Shelter/NGO/3898,2/21/2018 7:00:27 AM,Overall,1435,1349,1248,1368,5400,1435,1349,1248,1368,5400
21,Somalia,2016,SOM-16/3485/R/Shelter/UN/3903,10/30/2017 5:31:20 AM,Internally Displaced People,689,864,1152,1228,3933,679,874,1205,1228,3986
21,Somalia,2016,SOM-16/3485/R/Shelter/UN/3903,10/30/2017 5:31:20 AM,Overall,810,1080,1620,1890,5400,747,1090,1673,1890,5400
21,Somalia,2016,SOM-16/3485/R/Shelter/UN/3903,10/30/2017 5:31:20 AM,People in Host Communities,121,216,468,662,1467,68,216,468,662,1414
21,Somalia,2016,SOM-16/3485/R/WASH/INGO/2557,12/23/2017 7:16:15 PM,Internally Displaced People,3776,3628,1618,1555,10577,3828,4000,7654,7999,23481
21,Somalia,2016,SOM-16/3485/R/WASH/INGO/2557,12/23/2017 7:16:15 PM,Overall,5394,5183,2312,2221,15110,4785,5000,9568,9999,29352
21,Somalia,2016,SOM-16/3485/R/WASH/INGO/2557,12/23/2017 7:16:15 PM,People in Host Communities,1618,1555,694,666,4533,957,1000,1914,2000,5871
21,Somalia,2016,SOM-16/3485/R/WASH/INGO/2570,10/6/2017 7:42:38 AM,Internally Displaced People,3575,3875,3675,3875,15000,2369,2743,3452,2744,11308
21,Somalia,2016,SOM-16/3485/R/WASH/INGO/2570,10/6/2017 7:42:38 AM,Overall,5000,5483,5181,5484,21148,5985,6726,7190,6727,26628
21,Somalia,2016,SOM-16/3485/R/WASH/INGO/2570,10/6/2017 7:42:38 AM,People in Host Communities,1425,1608,1506,1609,6148,3616,3983,3738,3983,15320
21,Somalia,2016,SOM-16/3485/R/WASH/INGO/3713,1/30/2018 11:18:07 AM,Internally Displaced People,2779,3923,3355,3655,13712,3471,3914,4243,4784,16412
21,Somalia,2016,SOM-16/3485/R/WASH/INGO/3713,1/30/2018 11:18:07 AM,Overall,2779,3923,3355,3655,13712,3471,3914,4243,4784,16412
21,Somalia,2016,SOM-16/3485/R/WASH/INGO/4155,8/23/2017 6:42:00 AM,Internally Displaced People/Returnees,1582,1714,1582,1714,6592,1582,1714,1582,1714,6592
21,Somalia,2016,SOM-16/3485/R/WASH/INGO/4155,8/23/2017 6:42:00 AM,Overall,2261,2448,2261,2449,9419,2261,2448,2261,2449,9419
21,Somalia,2016,SOM-16/3485/R/WASH/INGO/4456,9/19/2017 6:46:20 AM,Internally Displaced People,750,1250,1200,1130,4330,1652,1632,3027,2658,8969
21,Somalia,2016,SOM-16/3485/R/WASH/INGO/4456,9/19/2017 6:46:20 AM,Internally Displaced People/Returnees,20,70,60,50,200,0,0,0,0,0
21,Somalia,2016,SOM-16/3485/R/WASH/INGO/4456,9/19/2017 6:46:20 AM,Other,30,150,140,150,470,0,0,0,0,0
21,Somalia,2016,SOM-16/3485/R/WASH/INGO/4456,9/19/2017 6:46:20 AM,Overall,800,1470,1400,1330,5000,1652,1632,3027,2658,8969
21,Somalia,2016,SOM-16/3485/R/WASH/NGO/2554,12/26/2017 5:59:12 AM,Internally Displaced People/Returnees,887,961,697,755,3300,887,961,697,755,3300
21,Somalia,2016,SOM-16/3485/R/WASH/NGO/2554,12/26/2017 5:59:12 AM,Overall,4032,4368,3168,3432,15000,4032,4368,3168,3432,15000
21,Somalia,2016,SOM-16/3485/R/WASH/NGO/2554,12/26/2017 5:59:12 AM,People in Host Communities,3145,3407,2471,2677,11700,3145,3407,2471,2677,11700
21,Somalia,2016,SOM-16/3485/R/WASH/NGO/3783,3/9/2018 9:39:26 AM,Internally Displaced People,3142,3192,2537,2579,11450,3142,3192,2537,2579,11450
21,Somalia,2016,SOM-16/3485/R/WASH/NGO/3783,3/9/2018 9:39:26 AM,Overall,3142,3192,2537,2579,11450,3142,3192,2537,2579,11450
21,Somalia,2016,SOM-16/3485/R/WASH/NGO/3789,3/9/2018 9:30:34 AM,Internally Displaced People,3103,4655,1034,1552,10344,3103,4655,1034,1552,10344
21,Somalia,2016,SOM-16/3485/R/WASH/NGO/3789,3/9/2018 9:30:34 AM,Overall,3103,4655,1034,1552,10344,3103,4655,1034,1552,10344
21,Somalia,2016,SOM-16/3485/R/WASH-Ed/INGO/4455,10/5/2017 10:22:44 AM,Overall,7282,7557,6694,6589,28122,7389,7344,9927,9345,34005
21,Somalia,2016,SOM-16/3485/R/WASH-Ed/UN/4470,9/19/2017 6:41:25 AM,Children under 18,0,0,4297,5251,9548,0,0,4742,5796,10538
21,Somalia,2016,SOM-16/3485/R/WASH-Ed/UN/4470,9/19/2017 6:41:25 AM,Overall,5468,6684,4297,5251,21700,6035,7376,4742,5796,23949
21,Somalia,2016,SOM-16/3485/R/WASH-Ed/UN/4470,9/19/2017 6:41:25 AM,People in Host Communities,5468,6684,0,0,12152,6035,7376,0,0,13411
21,Somalia,2017,SOM-17/3485/R/CCCM/INGO/6641,11/23/2018 4:12:41 AM,Internally Displaced People,2268,2268,972,972,6480,4376,4376,1876,1876,12504
21,Somalia,2017,SOM-17/3485/R/CCCM/INGO/6641,11/23/2018 4:12:41 AM,Overall,2835,2835,1215,1215,8100,5470,5470,2345,2345,15630
21,Somalia,2017,SOM-17/3485/R/CCCM/INGO/6641,11/23/2018 4:12:41 AM,People in Host Communities,567,567,243,243,1620,1094,1094,469,469,3126
21,Somalia,2017,SOM-17/3485/R/Ed-FSC-H-Nut-WASH/INGO/6668,7/19/2018 8:51:34 AM,Children under 18,0,0,1732,1337,3069,0,0,0,0,0
21,Somalia,2017,SOM-17/3485/R/Ed-FSC-H-Nut-WASH/INGO/6668,7/19/2018 8:51:34 AM,Internally Displaced People,3087,3265,3314,3055,12721,0,0,0,0,0
21,Somalia,2017,SOM-17/3485/R/Ed-FSC-H-Nut-WASH/INGO/6668,7/19/2018 8:51:34 AM,Overall,9069,16288,7576,6922,39855,9069,16288,7576,6922,39855
21,Somalia,2017,SOM-17/3485/R/Ed-FSC-H-Nut-WASH/INGO/6668,7/19/2018 8:51:34 AM,People in Host Communities,5472,12768,2280,2280,22800,0,0,0,0,0
21,Somalia,2017,SOM-17/3485/R/Ed-FSC-H-Nut-WASH/INGO/6668,7/19/2018 8:51:34 AM,"Staff (own or partner staff, authorities)",30,15,0,0,45,0,0,0,0,0
21,Somalia,2017,SOM-17/3485/R/Ed-FSC-H-Nut-WASH/INGO/6669,11/29/2018 9:22:28 AM,Children under 5,0,0,3709,3994,7703,0,0,6957,7018,13975
21,Somalia,2017,SOM-17/3485/R/Ed-FSC-H-Nut-WASH/INGO/6669,11/29/2018 9:22:28 AM,Overall,2425,4136,3709,3994,14264,937,1731,6957,7018,16643
21,Somalia,2017,SOM-17/3485/R/Ed-FSC-H-Nut-WASH/INGO/6669,11/29/2018 9:22:28 AM,Pregnant and Lactating Women,0,3209,0,0,3209,0,1731,0,0,1731
21,Somalia,2017,SOM-17/3485/R/Ed-FSC-H-Nut-WASH/INGO/6676,10/30/2018 7:53:33 AM,Agro-Pastoralists,5194,0,2530,1244,8968,0,0,0,0,0
21,Somalia,2017,SOM-17/3485/R/Ed-FSC-H-Nut-WASH/INGO/6676,10/30/2018 7:53:33 AM,Internally Displaced People,2693,2895,1439,2347,9374,0,0,0,0,0
21,Somalia,2017,SOM-17/3485/R/Ed-FSC-H-Nut-WASH/INGO/6676,10/30/2018 7:53:33 AM,Overall,7887,7993,3969,3591,23440,13132,19308,9906,9915,52261
21,Somalia,2017,SOM-17/3485/R/Ed-FSC-H-Nut-WASH/INGO/6676,10/30/2018 7:53:33 AM,Pregnant and Lactating Women,0,5098,0,0,5098,0,0,0,0,0
21,Somalia,2017,SOM-17/3485/R/Ed-FSC-H-Nut-WASH/INGO/6677,2/11/2019 8:45:55 AM,Children under 5,0,0,8179,8179,16358,0,0,13470,15329,28799
21,Somalia,2017,SOM-17/3485/R/Ed-FSC-H-Nut-WASH/INGO/6677,2/11/2019 8:45:55 AM,Overall,16,26017,8179,8179,42391,98,75333,13470,15330,104231
21,Somalia,2017,SOM-17/3485/R/Ed-FSC-H-Nut-WASH/INGO/6677,2/11/2019 8:45:55 AM,Pregnant and Lactating Women,0,7163,0,0,7163,0,36406,0,0,36406
21,Somalia,2017,SOM-17/3485/R/Ed-FSC-H-Nut-WASH/INGO/6677,2/11/2019 8:45:55 AM,"Staff (own or partner staff, authorities)",16,42,0,0,58,86,35,0,0,121
21,Somalia,2017,SOM-17/3485/R/Ed-FSC-H-Nut-WASH/INGO/6677,2/11/2019 8:45:55 AM,Women of Child-Bearing Age,0,18812,0,0,18812,12,38890,0,0,38902
21,Somalia,2017,SOM-17/3485/R/Ed-FSC-H-Nut-WASH/NGO/6662,8/30/2018 6:31:18 AM,Children under 5,0,0,1940,2371,4311,0,697,519,635,1851
21,Somalia,2017,SOM-17/3485/R/Ed-FSC-H-Nut-WASH/NGO/6662,8/30/2018 6:31:18 AM,Internally Displaced People,14400,17100,2560,2579,36639,12767,18751,3989,4388,39895
21,Somalia,2017,SOM-17/3485/R/Ed-FSC-H-Nut-WASH/NGO/6662,8/30/2018 6:31:18 AM,Overall,14400,21150,4500,4950,45000,12766,22015,4823,5406,45010
21,Somalia,2017,SOM-17/3485/R/Ed-FSC-H-Nut-WASH/NGO/6662,8/30/2018 6:31:18 AM,Pregnant and Lactating Women,0,4050,0,0,4050,0,3264,0,0,3264
21,Somalia,2017,SOM-17/3485/R/Ed-FSC-H-Nut-WASH/NGO/6663,7/19/2018 8:25:48 AM,Children under 5,0,0,2315,2050,4365,0,0,2345,2378,4723
21,Somalia,2017,SOM-17/3485/R/Ed-FSC-H-Nut-WASH/NGO/6663,7/19/2018 8:25:48 AM,Internally Displaced People,2840,5650,0,0,8490,5425,0,0,0,5425
21,Somalia,2017,SOM-17/3485/R/Ed-FSC-H-Nut-WASH/NGO/6663,7/19/2018 8:25:48 AM,Overall,5261,9499,2315,2050,19125,5525,10983,2345,2378,21231
21,Somalia,2017,SOM-17/3485/R/Ed-FSC-H-Nut-WASH/NGO/6663,7/19/2018 8:25:48 AM,People in Host Communities,2421,2540,0,0,4961,100,1679,0,0,1779
21,Somalia,2017,SOM-17/3485/R/Ed-FSC-H-Nut-WASH/NGO/6663,7/19/2018 8:25:48 AM,Pregnant and Lactating Women,0,1309,0,0,1309,0,9304,0,0,9304
21,Somalia,2017,SOM-17/3485/R/Ed-FSC-H-Nut-WASH/NGO/6672,9/7/2018 10:02:57 AM,Children under 5,0,0,1280,1280,2560,0,0,1709,1862,3571
21,Somalia,2017,SOM-17/3485/R/Ed-FSC-H-Nut-WASH/NGO/6672,9/7/2018 10:02:57 AM,Internally Displaced People/Returnees,2355,1095,0,0,3450,2091,2291,0,0,4382
21,Somalia,2017,SOM-17/3485/R/Ed-FSC-H-Nut-WASH/NGO/6672,9/7/2018 10:02:57 AM,Overall,4915,5325,1280,1280,12800,4935,5508,1709,1862,14014
21,Somalia,2017,SOM-17/3485/R/Ed-FSC-H-Nut-WASH/NGO/6672,9/7/2018 10:02:57 AM,People in Host Communities,2560,3130,0,0,5690,2844,2252,0,0,5096
21,Somalia,2017,SOM-17/3485/R/Ed-FSC-H-Nut-WASH/NGO/6672,9/7/2018 10:02:57 AM,Pregnant and Lactating Women,0,1100,0,0,1100,0,965,0,0,965
21,Somalia,2017,SOM-17/3485/R/Ed-FSC-H-Nut-WASH/NGO/6776,2/11/2019 8:16:05 AM,Children under 5,0,0,374,468,842,0,0,374,468,842
21,Somalia,2017,SOM-17/3485/R/Ed-FSC-H-Nut-WASH/NGO/6776,2/11/2019 8:16:05 AM,Internally Displaced People,4320,5916,0,0,10236,4320,6000,0,0,10320
21,Somalia,2017,SOM-17/3485/R/Ed-FSC-H-Nut-WASH/NGO/6776,2/11/2019 8:16:05 AM,Overall,5134,7701,374,468,13677,5134,7701,374,468,13677
21,Somalia,2017,SOM-17/3485/R/Ed-FSC-H-Nut-WASH/NGO/6776,2/11/2019 8:16:05 AM,People in Host Communities,814,1221,0,0,2035,804,1350,0,0,2154
21,Somalia,2017,SOM-17/3485/R/Ed-FSC-H-Nut-WASH/NGO/6776,2/11/2019 8:16:05 AM,Pregnant and Lactating Women,0,564,0,0,564,0,571,0,0,571
21,Somalia,2017,SOM-17/3485/R/Ed-FSC-H-Nut-WASH/NGO/6918,9/10/2018 6:34:01 AM,Children under 5,0,0,3737,3737,7474,0,0,3968,3592,7560
21,Somalia,2017,SOM-17/3485/R/Ed-FSC-H-Nut-WASH/NGO/6918,9/10/2018 6:34:01 AM,Other,8842,2774,3163,3163,17942,8414,3657,2201,2402,16674
21,Somalia,2017,SOM-17/3485/R/Ed-FSC-H-Nut-WASH/NGO/6918,9/10/2018 6:34:01 AM,Overall,8842,14735,6900,6900,37377,8414,9423,6169,5994,30000
21,Somalia,2017,SOM-17/3485/R/Ed-FSC-H-Nut-WASH/NGO/6918,9/10/2018 6:34:01 AM,Pregnant and Lactating Women,0,3364,0,0,3364,0,2214,0,0,2214
21,Somalia,2017,SOM-17/3485/R/Ed-FSC-H-Nut-WASH/NGO/6918,9/10/2018 6:34:01 AM,Women of Child-Bearing Age,0,8597,0,0,8597,0,3552,0,0,3552
21,Somalia,2017,SOM-17/3485/R/EP/INGO/4978,1/11/2018 2:46:05 PM,Children under 18,0,0,200000,200000,400000,0,0,200000,200000,400000
21,Somalia,2017,SOM-17/3485/R/EP/INGO/4978,1/11/2018 2:46:05 PM,Internally Displaced People/Returnees,500000,500000,0,0,1000000,500000,500000,0,0,1000000
21,Somalia,2017,SOM-17/3485/R/EP/INGO/4978,1/11/2018 2:46:05 PM,Overall,2000000,2000000,200000,200000,4400000,2000000,2000000,200000,200000,4400000
21,Somalia,2017,SOM-17/3485/R/EP/INGO/4978,1/11/2018 2:46:05 PM,Pastoralists,250000,100000,0,0,350000,250000,100000,0,0,350000
21,Somalia,2017,SOM-17/3485/R/EP/INGO/4978,1/11/2018 2:46:05 PM,People from Riverine Communities,400000,400000,0,0,800000,400000,400000,0,0,800000
21,Somalia,2017,SOM-17/3485/R/EP/INGO/5899,4/4/2018 7:15:37 AM,Aid Agencies,150,150,0,0,300,150,150,0,0,300
21,Somalia,2017,SOM-17/3485/R/EP/INGO/5899,4/4/2018 7:15:37 AM,Overall,150,150,0,0,300,150,150,0,0,300
21,Somalia,2017,SOM-17/3485/R/EP/INGO/6901,7/6/2018 9:44:04 AM,Overall,7500,2500,0,0,10000,7500,2500,0,0,10000
21,Somalia,2017,SOM-17/3485/R/EP/INGO/6901,7/6/2018 9:44:04 AM,"Staff (own or partner staff, authorities)",7500,2500,0,0,10000,0,0,0,0,0
21,Somalia,2017,SOM-17/3485/R/EP/INGO/6902,1/30/2019 9:21:18 AM,Aid Agencies,40,40,0,0,80,62,31,0,0,93
21,Somalia,2017,SOM-17/3485/R/EP/INGO/6902,1/30/2019 9:21:18 AM,Overall,40,40,0,0,80,51,42,0,0,93
21,Somalia,2017,SOM-17/3485/R/EP/UN/4734,8/15/2018 9:00:54 AM,Overall,3165758,3078242,0,0,6244000,3165758,3078242,0,0,6244000
21,Somalia,2017,SOM-17/3485/R/FSC-Ed-H-Nut-WASH/INGO/6813,3/19/2019 11:07:07 AM,Children under 5,0,0,2303,2597,4900,0,0,7041,7207,14248
21,Somalia,2017,SOM-17/3485/R/FSC-Ed-H-Nut-WASH/INGO/6813,3/19/2019 11:07:07 AM,Other,6200,0,0,0,6200,4021,0,0,0,4021
21,Somalia,2017,SOM-17/3485/R/FSC-Ed-H-Nut-WASH/INGO/6813,3/19/2019 11:07:07 AM,Overall,6200,8900,2303,2597,20000,4021,8382,7041,7207,26651
21,Somalia,2017,SOM-17/3485/R/FSC-Ed-H-Nut-WASH/INGO/6813,3/19/2019 11:07:07 AM,Pregnant and Lactating Women,0,1800,0,0,1800,0,2467,0,0,2467
21,Somalia,2017,SOM-17/3485/R/FSC-Ed-H-Nut-WASH/INGO/6813,3/19/2019 11:07:07 AM,Women of Child-Bearing Age,0,7100,0,0,7100,0,5915,0,0,5915
21,Somalia,2017,SOM-17/3485/R/FSC-Ed-WASH/INGO/6278,3/9/2018 10:20:14 AM,Children under 18,0,0,360,360,720,0,0,360,360,720
21,Somalia,2017,SOM-17/3485/R/FSC-Ed-WASH/INGO/6278,3/9/2018 10:20:14 AM,Internally Displaced People,3700,3940,1680,1920,11240,3700,3940,1680,1920,11240
21,Somalia,2017,SOM-17/3485/R/FSC-Ed-WASH/INGO/6278,3/9/2018 10:20:14 AM,Overall,3720,3960,2040,2280,12000,3720,3960,2040,2280,12000
21,Somalia,2017,SOM-17/3485/R/FSC-Ed-WASH/INGO/6278,3/9/2018 10:20:14 AM,"Trainers, Promoters, Caretakers, committee members, etc.",20,20,0,0,40,20,20,0,0,40
21,Somalia,2017,SOM-17/3485/R/FSC-Ed-WASH/INGO/6283,8/16/2018 8:55:39 AM,Committees,20,10,0,0,30,16,5,0,0,21
21,Somalia,2017,SOM-17/3485/R/FSC-Ed-WASH/INGO/6283,8/16/2018 8:55:39 AM,Internally Displaced People,559,966,990,970,3485,510,1011,1105,567,3193
21,Somalia,2017,SOM-17/3485/R/FSC-Ed-WASH/INGO/6283,8/16/2018 8:55:39 AM,Overall,843,1596,1066,1072,4577,843,1345,1306,716,4210
21,Somalia,2017,SOM-17/3485/R/FSC-Ed-WASH/INGO/6283,8/16/2018 8:55:39 AM,People in Host Communities,264,620,76,102,1062,303,452,201,149,1105
21,Somalia,2017,SOM-17/3485/R/FSC-H-Nut-WASH/O/6664,2/8/2019 7:30:14 AM,Children under 18,0,0,17262,19425,36687,0,0,0,0,0
21,Somalia,2017,SOM-17/3485/R/FSC-H-Nut-WASH/O/6664,2/8/2019 7:30:14 AM,Children under 5,0,0,9020,9588,18608,0,0,28918,33728,62646
21,Somalia,2017,SOM-17/3485/R/FSC-H-Nut-WASH/O/6664,2/8/2019 7:30:14 AM,Overall,14252,32094,33050,35805,115201,6912,30393,28918,33728,99951
21,Somalia,2017,SOM-17/3485/R/FSC-H-Nut-WASH/O/6664,2/8/2019 7:30:14 AM,Pregnant and Lactating Women,0,21600,0,0,21600,0,30393,0,0,30393
21,Somalia,2017,SOM-17/3485/R/FSC-H-Nut-WASH/O/6664,2/8/2019 7:30:14 AM,"Staff (own or partner staff, authorities)",30,45,0,0,75,6912,0,0,0,6912
21,Somalia,2017,SOM-17/3485/R/FSC-WASH-Ed-H-Nut/NGO/6751,4/4/2019 6:04:43 AM,Children under 5,0,0,1221,1492,2713,0,0,4434,5605,10039
21,Somalia,2017,SOM-17/3485/R/FSC-WASH-Ed-H-Nut/NGO/6751,4/4/2019 6:04:43 AM,Internally Displaced People,1484,1500,1558,1834,6376,1354,1547,0,0,2901
21,Somalia,2017,SOM-17/3485/R/FSC-WASH-Ed-H-Nut/NGO/6751,4/4/2019 6:04:43 AM,Overall,4240,4858,6194,7372,22664,4770,6781,4434,5605,21590
21,Somalia,2017,SOM-17/3485/R/FSC-WASH-Ed-H-Nut/NGO/6751,4/4/2019 6:04:43 AM,People in Host Communities,2756,2358,3415,4046,12575,3416,3647,0,0,7063
21,Somalia,2017,SOM-17/3485/R/FSC-WASH-Ed-H-Nut/NGO/6751,4/4/2019 6:04:43 AM,Pregnant and Lactating Women,0,1000,0,0,1000,0,1587,0,0,1587
21,Somalia,2017,SOM-17/3485/R/H/INGO/4518,2/26/2018 8:42:07 AM,Children under 5,0,0,13540,13540,27080,0,0,16756,18275,35031
21,Somalia,2017,SOM-17/3485/R/H/INGO/4518,2/26/2018 8:42:07 AM,Other,37254,6668,226,16317,60465,18592,3800,15212,16184,53788
21,Somalia,2017,SOM-17/3485/R/H/INGO/4518,2/26/2018 8:42:07 AM,Overall,37291,36491,31766,29857,135405,29741,42675,16756,18275,107447
21,Somalia,2017,SOM-17/3485/R/H/INGO/4518,2/26/2018 8:42:07 AM,"Staff (own or partner staff, authorities)",37,35,0,0,72,44,31,0,0,75
21,Somalia,2017,SOM-17/3485/R/H/INGO/4518,2/26/2018 8:42:07 AM,Women of Child-Bearing Age,0,29788,0,0,29788,0,18553,0,0,18553
21,Somalia,2017,SOM-17/3485/R/H/UN/6830,11/6/2018 9:29:03 AM,Overall,0,0,222757,222757,445514,0,0,224217,224216,448433
21,Somalia,2017,SOM-17/3485/R/Nut-H-WASH/INGO/6250,2/26/2018 6:03:23 AM,Children under 5,0,0,2000,2186,4186,0,0,1412,1156,2568
21,Somalia,2017,SOM-17/3485/R/Nut-H-WASH/INGO/6250,2/26/2018 6:03:23 AM,Internally Displaced People,4821,1988,789,940,8538,4556,1928,757,921,8162
21,Somalia,2017,SOM-17/3485/R/Nut-H-WASH/INGO/6250,2/26/2018 6:03:23 AM,Overall,4821,9464,2789,3126,20200,4556,8560,2708,2932,18756
21,Somalia,2017,SOM-17/3485/R/Nut-H-WASH/INGO/6250,2/26/2018 6:03:23 AM,Pregnant and Lactating Women,0,2662,0,0,2662,0,2568,0,0,2568
21,Somalia,2017,SOM-17/3485/R/Nut-H-WASH/INGO/6250,2/26/2018 6:03:23 AM,Women of Child-Bearing Age,0,4814,0,0,4814,0,4064,0,0,4064
21,Somalia,2017,SOM-17/3485/R/Nut-H-WASH/NGO/6251,2/15/2018 12:32:25 PM,Children under 5,0,0,3500,4230,7730,0,0,3521,4361,7882
21,Somalia,2017,SOM-17/3485/R/Nut-H-WASH/NGO/6251,2/15/2018 12:32:25 PM,Other,3027,4000,0,0,7027,3075,4019,0,0,7094
21,Somalia,2017,SOM-17/3485/R/Nut-H-WASH/NGO/6251,2/15/2018 12:32:25 PM,Overall,3109,5101,3500,4230,15940,3157,5159,3521,4361,16198
21,Somalia,2017,SOM-17/3485/R/Nut-H-WASH/NGO/6251,2/15/2018 12:32:25 PM,Pregnant and Lactating Women,0,1000,0,0,1000,0,1039,0,0,1039
21,Somalia,2017,SOM-17/3485/R/Nut-H-WASH/NGO/6251,2/15/2018 12:32:25 PM,"Trainers, Promoters, Caretakers, committee members, etc.",82,101,0,0,183,82,101,0,0,183
21,Somalia,2017,SOM-17/3485/R/Nut-H-WASH/NGO/6252,2/20/2018 6:26:22 AM,Children under 5,0,0,2450,2450,4900,0,0,2758,2971,5729
21,Somalia,2017,SOM-17/3485/R/Nut-H-WASH/NGO/6252,2/20/2018 6:26:22 AM,Internally Displaced People,4399,4603,2050,2050,13102,3618,4408,1857,2292,12175
21,Somalia,2017,SOM-17/3485/R/Nut-H-WASH/NGO/6252,2/20/2018 6:26:22 AM,Overall,5875,9625,4500,4500,24500,5080,9723,4615,5263,24681
21,Somalia,2017,SOM-17/3485/R/Nut-H-WASH/NGO/6252,2/20/2018 6:26:22 AM,Pregnant and Lactating Women,0,2205,0,0,2205,0,2457,0,0,2457
21,Somalia,2017,SOM-17/3485/R/Nut-H-WASH/NGO/6252,2/20/2018 6:26:22 AM,"Trainers, Promoters, Caretakers, committee members, etc.",1476,2817,0,0,4293,1462,2858,0,0,4320
21,Somalia,2017,SOM-17/3485/R/Nut-H-WASH/NGO/6253,5/15/2018 1:22:55 PM,Agro-Pastoralists,2070,4658,2432,2432,11592,1930,5008,2135,2301,11374
21,Somalia,2017,SOM-17/3485/R/Nut-H-WASH/NGO/6253,5/15/2018 1:22:55 PM,Internally Displaced People,690,1552,811,811,3864,460,1130,951,1122,3663
21,Somalia,2017,SOM-17/3485/R/Nut-H-WASH/NGO/6253,5/15/2018 1:22:55 PM,Overall,2760,6210,3243,3243,15456,2390,6138,3086,3423,15037
21,Somalia,2017,SOM-17/3485/R/Nut-H-WASH/NGO/6273,11/16/2018 9:26:52 AM,Agro-Pastoralists,5500,0,0,0,5500,7518,5486,0,0,13004
21,Somalia,2017,SOM-17/3485/R/Nut-H-WASH/NGO/6273,11/16/2018 9:26:52 AM,Children under 5,0,0,10451,10041,20492,0,392,24417,26059,50868
21,Somalia,2017,SOM-17/3485/R/Nut-H-WASH/NGO/6273,11/16/2018 9:26:52 AM,Overall,5550,8247,10451,10041,34289,4143,12587,12180,13254,42164
21,Somalia,2017,SOM-17/3485/R/Nut-H-WASH/NGO/6273,11/16/2018 9:26:52 AM,Pregnant and Lactating Women,0,8197,0,0,8197,0,14644,0,0,14644
21,Somalia,2017,SOM-17/3485/R/Nut-H-WASH/NGO/6273,11/16/2018 9:26:52 AM,"Trainers, Promoters, Caretakers, committee members, etc.",50,50,0,0,100,758,5044,0,0,5802
21,Somalia,2017,SOM-17/3485/R/Prot/INGO/6634,8/13/2018 8:10:16 AM,Children under 18,0,0,1200,800,2000,0,0,3363,1919,5282
21,Somalia,2017,SOM-17/3485/R/Prot/INGO/6634,8/13/2018 8:10:16 AM,Internally Displaced People/Returnees,500,800,0,0,1300,3051,2608,0,0,5659
21,Somalia,2017,SOM-17/3485/R/Prot/INGO/6634,8/13/2018 8:10:16 AM,Overall,520,840,1200,800,3360,3071,2648,3363,1919,11001
21,Somalia,2017,SOM-17/3485/R/Prot/INGO/6634,8/13/2018 8:10:16 AM,"Staff (own or partner staff, authorities)",20,40,0,0,60,20,40,0,0,60
21,Somalia,2017,SOM-17/3485/R/Prot/NGO/6291,3/14/2018 1:06:27 PM,Internally Displaced People,20,20,1780,1780,3600,18,522,2100,1960,4600
21,Somalia,2017,SOM-17/3485/R/Prot/NGO/6291,3/14/2018 1:06:27 PM,Overall,70,70,2650,2650,5440,45,555,2475,2260,5335
21,Somalia,2017,SOM-17/3485/R/Prot/NGO/6291,3/14/2018 1:06:27 PM,People in Host Communities,50,50,870,870,1840,27,33,375,300,735
21,Somalia,2017,SOM-17/3485/R/Prot/NGO/6292,7/26/2018 9:03:46 AM,Internally Displaced People,294,982,273,724,2273,294,1400,150,724,2568
21,Somalia,2017,SOM-17/3485/R/Prot/NGO/6292,7/26/2018 9:03:46 AM,Internally Displaced People/Returnees,135,422,77,108,742,75,300,77,108,560
21,Somalia,2017,SOM-17/3485/R/Prot/NGO/6292,7/26/2018 9:03:46 AM,Overall,620,1861,485,1044,4010,497,2179,344,1003,4023
21,Somalia,2017,SOM-17/3485/R/Prot/NGO/6292,7/26/2018 9:03:46 AM,People in Host Communities,191,457,135,212,995,128,479,117,171,895
21,Somalia,2017,SOM-17/3485/R/Prot/NGO/6631,8/2/2018 3:07:59 PM,Internally Displaced People,320,790,0,0,1110,7,958,0,0,965
21,Somalia,2017,SOM-17/3485/R/Prot/NGO/6631,8/2/2018 3:07:59 PM,Overall,536,1026,79,79,1720,215,1429,48,48,1740
21,Somalia,2017,SOM-17/3485/R/Prot/NGO/6631,8/2/2018 3:07:59 PM,"Trainers, Promoters, Caretakers, committee members, etc.",216,236,79,79,610,208,471,48,48,775
21,Somalia,2017,SOM-17/3485/R/Prot/NGO/6643,10/3/2018 1:19:25 PM,Internally Displaced People,500,1134,950,1550,4134,292,1607,1786,1755,5440
21,Somalia,2017,SOM-17/3485/R/Prot/NGO/6643,10/3/2018 1:19:25 PM,Overall,500,1134,950,1550,4134,292,1607,1786,1755,5440
21,Somalia,2017,SOM-17/3485/R/Prot-Shelter/NGO/6758,5/30/2019 12:00:53 PM,Internally Displaced People,3807,5702,8478,8334,26321,3494,5445,8211,8101,25251
21,Somalia,2017,SOM-17/3485/R/Prot-Shelter/NGO/6758,5/30/2019 12:00:53 PM,Overall,3807,5702,8478,8334,26321,3494,5445,8211,8101,25251
21,Somalia,2017,SOM-17/3485/R/Shelter/INGO/6286,5/29/2018 10:50:36 AM,Committees,0,0,0,0,0,74,76,0,0,150
21,Somalia,2017,SOM-17/3485/R/Shelter/INGO/6286,5/29/2018 10:50:36 AM,Internally Displaced People,2100,6100,4000,5800,18000,2100,6100,4000,5800,18000
21,Somalia,2017,SOM-17/3485/R/Shelter/INGO/6286,5/29/2018 10:50:36 AM,Overall,2100,6100,4000,5800,18000,2100,6100,4000,5800,18000
21,Somalia,2017,SOM-17/3485/R/Shelter/INGO/6638,5/29/2018 10:48:20 AM,Committees,0,0,0,0,0,104,121,0,0,225
21,Somalia,2017,SOM-17/3485/R/Shelter/INGO/6638,5/29/2018 10:48:20 AM,Internally Displaced People,1800,5500,3500,4200,15000,3791,3935,6304,5217,19247
21,Somalia,2017,SOM-17/3485/R/Shelter/INGO/6638,5/29/2018 10:48:20 AM,Overall,1800,5500,3500,4200,15000,3791,3935,6304,5217,19247
21,Somalia,2017,SOM-17/3485/R/Shelter/NGO/6290,2/12/2018 5:30:11 AM,Internally Displaced People,4590,6120,2295,2295,15300,4590,6120,2295,2295,15300
21,Somalia,2017,SOM-17/3485/R/Shelter/NGO/6290,2/12/2018 5:30:11 AM,Overall,4590,6120,2295,2295,15300,4590,6120,2295,2295,15300
21,Somalia,2017,SOM-17/3485/R/Shelter/NGO/6627,3/27/2018 9:42:10 AM,Internally Displaced People,3420,4560,1710,1710,11400,3420,4560,1710,1710,11400
21,Somalia,2017,SOM-17/3485/R/Shelter/NGO/6627,3/27/2018 9:42:10 AM,Overall,3420,4560,1710,1710,11400,3420,4560,1710,1710,11400
21,Somalia,2017,SOM-17/3485/R/Shelter/NGO/6629,5/29/2018 10:46:41 AM,Internally Displaced People,810,1890,1080,1620,5400,810,1890,1080,1620,5400
21,Somalia,2017,SOM-17/3485/R/Shelter/NGO/6629,5/29/2018 10:46:41 AM,Overall,810,1890,1080,1620,5400,810,1890,1080,1620,5400
21,Somalia,2017,SOM-17/3485/R/Shelter-CCCM-WASH-Prot/INGO/6289,7/31/2018 11:52:11 AM,Internally Displaced People,5091,5991,6278,6765,24125,5745,7708,6623,10852,30928
21,Somalia,2017,SOM-17/3485/R/Shelter-CCCM-WASH-Prot/INGO/6289,7/31/2018 11:52:11 AM,Overall,5454,6403,6811,7682,26350,6079,8543,7185,12526,34333
21,Somalia,2017,SOM-17/3485/R/Shelter-CCCM-WASH-Prot/INGO/6289,7/31/2018 11:52:11 AM,People in Host Communities,363,412,533,917,2225,334,835,562,1674,3405
21,Somalia,2017,SOM-17/3485/R/WASH/NGO/6747,8/15/2018 8:33:35 AM,Internally Displaced People,1162,1458,1991,2269,6880,904,1366,1224,1875,5369
21,Somalia,2017,SOM-17/3485/R/WASH/NGO/6747,8/15/2018 8:33:35 AM,Overall,3511,4255,5600,6750,20116,3436,4450,4948,6539,19373
21,Somalia,2017,SOM-17/3485/R/WASH/NGO/6747,8/15/2018 8:33:35 AM,Pastoralists,884,1150,1058,1361,4453,440,624,564,648,2276
21,Somalia,2017,SOM-17/3485/R/WASH/NGO/6747,8/15/2018 8:33:35 AM,People in Host Communities,1084,1175,2133,2567,6959,1864,2180,2896,3720,10660
21,Somalia,2017,SOM-17/3485/R/WASH/NGO/6747,8/15/2018 8:33:35 AM,Returnees,381,472,418,553,1824,228,280,264,296,1068
21,Somalia,2017,SOM-17/3485/R/WASH-FSC/INGO/6688,7/25/2018 5:57:07 AM,Internally Displaced People,3333,3243,2750,2674,12000,0,0,0,0,0
21,Somalia,2017,SOM-17/3485/R/WASH-FSC/INGO/6688,7/25/2018 5:57:07 AM,Overall,6666,6486,5500,5348,24000,19704,27736,15984,21834,85258
21,Somalia,2017,SOM-17/3485/R/WASH-FSC/INGO/6688,7/25/2018 5:57:07 AM,People in Host Communities,3333,3243,2750,2674,12000,0,0,0,0,0
21,Somalia,2017,SOM-17/3485/SA1 2017/Ed/INGO/4563,10/23/2017 9:30:57 AM,Children under 18,0,0,1120,924,2044,0,0,1376,869,2245
21,Somalia,2017,SOM-17/3485/SA1 2017/Ed/INGO/4563,10/23/2017 9:30:57 AM,Overall,149,148,1120,924,2341,149,148,1376,869,2542
21,Somalia,2017,SOM-17/3485/SA1 2017/Ed/INGO/4563,10/23/2017 9:30:57 AM,"Trainers, Promoters, Caretakers, committee members, etc.",149,148,0,0,297,149,148,0,0,297
21,Somalia,2017,SOM-17/3485/SA1 2017/Ed/INGO/4577,3/6/2018 7:28:33 AM,Internally Displaced People/Returnees,23,15,784,591,1413,53,19,1007,946,2025
21,Somalia,2017,SOM-17/3485/SA1 2017/Ed/INGO/4577,3/6/2018 7:28:33 AM,Overall,52,34,1743,1314,3143,97,35,2030,1874,4036
21,Somalia,2017,SOM-17/3485/SA1 2017/Ed/INGO/4577,3/6/2018 7:28:33 AM,People in Host Communities,29,19,959,723,1730,44,16,1023,928,2011
21,Somalia,2017,SOM-17/3485/SA1 2017/Ed/INGO/4591,11/15/2017 10:51:33 AM,Internally Displaced People,24,15,525,525,1089,77,48,3208,2616,5949
21,Somalia,2017,SOM-17/3485/SA1 2017/Ed/INGO/4591,11/15/2017 10:51:33 AM,Overall,77,48,1750,1750,3625,77,48,3208,2616,5949
21,Somalia,2017,SOM-17/3485/SA1 2017/Ed/INGO/4591,11/15/2017 10:51:33 AM,People in Host Communities,53,33,1225,1225,2536,0,0,0,0,0
21,Somalia,2017,SOM-17/3485/SA1 2017/Ed/INGO/4616,1/8/2018 11:16:36 AM,Agro-Pastoralists,170,56,0,0,226,205,48,0,0,253
21,Somalia,2017,SOM-17/3485/SA1 2017/Ed/INGO/4616,1/8/2018 11:16:36 AM,Children under 18,0,0,2400,1600,4000,0,0,4293,3332,7625
21,Somalia,2017,SOM-17/3485/SA1 2017/Ed/INGO/4616,1/8/2018 11:16:36 AM,Internally Displaced People,22,15,0,0,37,10,4,0,0,14
21,Somalia,2017,SOM-17/3485/SA1 2017/Ed/INGO/4616,1/8/2018 11:16:36 AM,Overall,192,71,2400,1600,4263,215,52,4293,3332,7892
21,Somalia,2017,SOM-17/3485/SA1 2017/Ed/INGO/4620,10/6/2017 7:05:19 AM,Children under 18,0,0,399,235,634,0,0,539,435,974
21,Somalia,2017,SOM-17/3485/SA1 2017/Ed/INGO/4620,10/6/2017 7:05:19 AM,Internally Displaced People/Returnees,0,0,426,440,866,0,0,426,440,866
21,Somalia,2017,SOM-17/3485/SA1 2017/Ed/INGO/4620,10/6/2017 7:05:19 AM,Overall,72,48,825,675,1620,56,29,965,875,1925
21,Somalia,2017,SOM-17/3485/SA1 2017/Ed/INGO/4638,7/6/2018 9:42:19 AM,Children under 18,0,0,1833,1733,3566,0,0,2088,1028,3116
21,Somalia,2017,SOM-17/3485/SA1 2017/Ed/INGO/4638,7/6/2018 9:42:19 AM,Overall,226,93,1833,1733,3885,278,62,2088,1028,3456
21,Somalia,2017,SOM-17/3485/SA1 2017/Ed/INGO/4638,7/6/2018 9:42:19 AM,"Staff (own or partner staff, authorities)",226,93,0,0,319,278,62,0,0,340
21,Somalia,2017,SOM-17/3485/SA1 2017/Ed/INGO/4639,10/6/2017 7:01:41 AM,Children under 18,0,0,1036,755,1791,0,0,1045,798,1843
21,Somalia,2017,SOM-17/3485/SA1 2017/Ed/INGO/4639,10/6/2017 7:01:41 AM,Committees,24,12,0,0,36,31,5,0,0,36
21,Somalia,2017,SOM-17/3485/SA1 2017/Ed/INGO/4639,10/6/2017 7:01:41 AM,Overall,48,24,1036,755,1863,64,8,1045,798,1915
21,Somalia,2017,SOM-17/3485/SA1 2017/Ed/INGO/4639,10/6/2017 7:01:41 AM,"Staff (own or partner staff, authorities)",24,12,0,0,36,33,3,0,0,36
21,Somalia,2017,SOM-17/3485/SA1 2017/Ed/INGO/4672,8/16/2018 7:29:35 AM,Children under 18,0,0,587,424,1011,0,0,529,406,935
21,Somalia,2017,SOM-17/3485/SA1 2017/Ed/INGO/4672,8/16/2018 7:29:35 AM,Committees,30,20,0,0,50,23,21,0,0,44
21,Somalia,2017,SOM-17/3485/SA1 2017/Ed/INGO/4672,8/16/2018 7:29:35 AM,Other,25,25,0,0,50,30,13,0,0,43
21,Somalia,2017,SOM-17/3485/SA1 2017/Ed/INGO/4672,8/16/2018 7:29:35 AM,Overall,55,45,587,424,1111,53,34,529,406,1022
21,Somalia,2017,SOM-17/3485/SA1 2017/Ed/INGO/5037,2/21/2018 12:50:47 PM,Committees,35,28,0,0,63,35,28,0,0,63
21,Somalia,2017,SOM-17/3485/SA1 2017/Ed/INGO/5037,2/21/2018 12:50:47 PM,Overall,50,43,1750,1750,3593,50,43,1985,1597,3675
21,Somalia,2017,SOM-17/3485/SA1 2017/Ed/INGO/5037,2/21/2018 12:50:47 PM,"Staff (own or partner staff, authorities)",15,15,0,0,30,15,15,0,0,30
21,Somalia,2017,SOM-17/3485/SA1 2017/Ed/NGO/5039,1/11/2018 5:47:43 AM,Children under 18,0,0,1562,1042,2604,0,0,1473,1114,2587
21,Somalia,2017,SOM-17/3485/SA1 2017/Ed/NGO/5039,1/11/2018 5:47:43 AM,Other,65,7,0,0,72,65,7,0,0,72
21,Somalia,2017,SOM-17/3485/SA1 2017/Ed/NGO/5039,1/11/2018 5:47:43 AM,Overall,65,7,1562,1042,2676,65,7,1473,1114,2659
21,Somalia,2017,SOM-17/3485/SA1 2017/Ed/NGO/5280,3/15/2018 10:05:00 AM,Children under 18,0,0,1485,1015,2500,0,0,1853,1547,3400
21,Somalia,2017,SOM-17/3485/SA1 2017/Ed/NGO/5280,3/15/2018 10:05:00 AM,Overall,81,77,1485,1015,2658,102,56,1853,1547,3558
21,Somalia,2017,SOM-17/3485/SA1 2017/Ed/NGO/5280,3/15/2018 10:05:00 AM,"Trainers, Promoters, Caretakers, committee members, etc.",81,77,0,0,158,102,56,0,0,158
21,Somalia,2017,SOM-17/3485/SA1 2017/FSC/INGO/4564,7/31/2017 6:59:07 AM,Internally Displaced People,300,2650,25,25,3000,300,2650,25,25,3000
21,Somalia,2017,SOM-17/3485/SA1 2017/FSC/INGO/4564,7/31/2017 6:59:07 AM,Overall,600,5300,50,50,6000,600,5300,50,50,6000
21,Somalia,2017,SOM-17/3485/SA1 2017/FSC/INGO/4564,7/31/2017 6:59:07 AM,Urban Poor,300,2650,25,25,3000,300,2650,25,25,3000
21,Somalia,2017,SOM-17/3485/SA1 2017/FSC/INGO/4569,11/27/2017 10:26:36 AM,Agro-Pastoralists,714,1176,1134,1176,4200,714,1176,1134,1176,4200
21,Somalia,2017,SOM-17/3485/SA1 2017/FSC/INGO/4569,11/27/2017 10:26:36 AM,Overall,714,1176,1134,1176,4200,714,1176,1134,1176,4200
21,Somalia,2017,SOM-17/3485/SA1 2017/FSC/INGO/4587,12/7/2017 1:04:30 PM,Agro-Pastoralists,150,500,150,200,1000,203,211,168,157,739
21,Somalia,2017,SOM-17/3485/SA1 2017/FSC/INGO/4587,12/7/2017 1:04:30 PM,Internally Displaced People/Returnees,55,185,55,75,370,84,84,52,52,272
21,Somalia,2017,SOM-17/3485/SA1 2017/FSC/INGO/4587,12/7/2017 1:04:30 PM,Overall,765,1797,647,1009,4218,1100,1623,684,811,4218
21,Somalia,2017,SOM-17/3485/SA1 2017/FSC/INGO/4587,12/7/2017 1:04:30 PM,Pastoralists,475,844,315,461,2095,613,970,337,445,2365
21,Somalia,2017,SOM-17/3485/SA1 2017/FSC/INGO/4587,12/7/2017 1:04:30 PM,Urban Poor,85,268,127,273,753,200,358,127,157,842
21,Somalia,2017,SOM-17/3485/SA1 2017/FSC/INGO/4608,3/6/2018 8:04:05 AM,Internally Displaced People/Returnees,450,600,500,700,2250,620,876,693,877,3066
21,Somalia,2017,SOM-17/3485/SA1 2017/FSC/INGO/4608,3/6/2018 8:04:05 AM,Overall,850,1200,950,1200,4200,1323,1476,856,725,4380
21,Somalia,2017,SOM-17/3485/SA1 2017/FSC/INGO/4608,3/6/2018 8:04:05 AM,People in Host Communities,400,400,450,500,1750,265,375,297,376,1313
21,Somalia,2017,SOM-17/3485/SA1 2017/FSC/INGO/4625,2/12/2018 6:46:38 AM,Internally Displaced People/Returnees,232,406,1189,1073,2900,232,406,1189,1073,2900
21,Somalia,2017,SOM-17/3485/SA1 2017/FSC/INGO/4625,2/12/2018 6:46:38 AM,Overall,258,451,1321,1192,3222,258,451,1321,1192,3222
21,Somalia,2017,SOM-17/3485/SA1 2017/FSC/INGO/4625,2/12/2018 6:46:38 AM,People in Host Communities,26,45,132,119,322,26,45,132,119,322
21,Somalia,2017,SOM-17/3485/SA1 2017/FSC/INGO/4633,6/4/2018 7:58:14 AM,Overall,4060,1540,0,0,5600,4060,1540,0,0,5600
21,Somalia,2017,SOM-17/3485/SA1 2017/FSC/INGO/4652,10/30/2017 9:28:23 AM,Internally Displaced People/Returnees,441,584,750,850,2625,92,138,137,206,573
21,Somalia,2017,SOM-17/3485/SA1 2017/FSC/INGO/4652,10/30/2017 9:28:23 AM,Overall,1152,1728,1728,2592,7200,1316,1975,1974,2961,8226
21,Somalia,2017,SOM-17/3485/SA1 2017/FSC/INGO/4652,10/30/2017 9:28:23 AM,People from Riverine Communities,106,118,152,252,628,180,271,270,406,1127
21,Somalia,2017,SOM-17/3485/SA1 2017/FSC/INGO/4652,10/30/2017 9:28:23 AM,People in Host Communities,605,926,826,1490,3847,697,1045,1045,1567,4354
21,Somalia,2017,SOM-17/3485/SA1 2017/FSC/INGO/4652,10/30/2017 9:28:23 AM,Pregnant and Lactating Women,0,100,0,0,100,0,121,0,0,121
21,Somalia,2017,SOM-17/3485/SA1 2017/FSC/INGO/4706,11/16/2017 11:19:28 AM,Agro-Pastoralists,486,1980,414,1620,4500,616,2508,524,2052,5700
21,Somalia,2017,SOM-17/3485/SA1 2017/FSC/INGO/4706,11/16/2017 11:19:28 AM,Internally Displaced People,162,660,138,540,1500,205,836,175,684,1900
21,Somalia,2017,SOM-17/3485/SA1 2017/FSC/INGO/4706,11/16/2017 11:19:28 AM,Overall,648,2640,552,2160,6000,821,3344,699,2736,7600
21,Somalia,2017,SOM-17/3485/SA1 2017/FSC/INGO/5041,11/15/2017 12:50:44 PM,Agro-Pastoralists,340,1386,290,1134,3150,414,1687,352,1379,3832
21,Somalia,2017,SOM-17/3485/SA1 2017/FSC/INGO/5041,11/15/2017 12:50:44 PM,Internally Displaced People,340,1386,290,1134,3150,414,1686,353,1380,3833
21,Somalia,2017,SOM-17/3485/SA1 2017/FSC/INGO/5041,11/15/2017 12:50:44 PM,Overall,680,2772,580,2268,6300,828,3373,705,2759,7665
21,Somalia,2017,SOM-17/3485/SA1 2017/FSC/NGO/4568,9/19/2017 9:58:30 AM,Agro-Pastoralists,430,535,2606,3185,6756,467,655,2621,2909,6652
21,Somalia,2017,SOM-17/3485/SA1 2017/FSC/NGO/4568,9/19/2017 9:58:30 AM,Overall,712,875,4285,5238,11110,779,1092,4368,4681,10920
21,Somalia,2017,SOM-17/3485/SA1 2017/FSC/NGO/4568,9/19/2017 9:58:30 AM,Pastoralists,282,340,1679,2053,4354,312,437,1747,1872,4368
21,Somalia,2017,SOM-17/3485/SA1 2017/FSC/NGO/4570,1/30/2018 9:44:46 AM,Overall,5686,8379,1862,2793,18720,5686,8379,1862,2793,18720
21,Somalia,2017,SOM-17/3485/SA1 2017/FSC/NGO/4570,1/30/2018 9:44:46 AM,Pastoralists,5686,8379,1862,2793,18720,5686,8379,1862,2793,18720
21,Somalia,2017,SOM-17/3485/SA1 2017/FSC/NGO/4575,7/30/2018 5:53:09 AM,Agro-Pastoralists,650,1237,992,1285,4164,650,1237,992,1285,4164
21,Somalia,2017,SOM-17/3485/SA1 2017/FSC/NGO/4575,7/30/2018 5:53:09 AM,Overall,2169,4122,3308,4282,13881,2169,4122,3308,4282,13881
21,Somalia,2017,SOM-17/3485/SA1 2017/FSC/NGO/4575,7/30/2018 5:53:09 AM,Pastoralists,1085,2061,1654,2140,6940,1085,2061,1654,2140,6940
21,Somalia,2017,SOM-17/3485/SA1 2017/FSC/NGO/4575,7/30/2018 5:53:09 AM,People in Host Communities,434,824,662,857,2777,434,824,662,857,2777
21,Somalia,2017,SOM-17/3485/SA1 2017/FSC/NGO/4630,11/15/2017 12:54:20 PM,Agro-Pastoralists,2592,3565,3888,4355,14400,2592,3565,3888,4355,14400
21,Somalia,2017,SOM-17/3485/SA1 2017/FSC/NGO/4630,11/15/2017 12:54:20 PM,Overall,2592,3565,3888,4355,14400,2592,3565,3888,4355,14400
21,Somalia,2017,SOM-17/3485/SA1 2017/FSC/NGO/4636,1/31/2018 9:49:10 AM,Agro-Pastoralists,300,400,0,0,700,300,400,0,0,700
21,Somalia,2017,SOM-17/3485/SA1 2017/FSC/NGO/4636,1/31/2018 9:49:10 AM,Internally Displaced People,170,200,0,0,370,170,200,0,0,370
21,Somalia,2017,SOM-17/3485/SA1 2017/FSC/NGO/4636,1/31/2018 9:49:10 AM,Overall,940,1280,0,0,2220,940,1280,0,0,2220
21,Somalia,2017,SOM-17/3485/SA1 2017/FSC/NGO/4636,1/31/2018 9:49:10 AM,Pastoralists,320,540,0,0,860,320,540,0,0,860
21,Somalia,2017,SOM-17/3485/SA1 2017/FSC/NGO/4636,1/31/2018 9:49:10 AM,People in Host Communities,150,140,0,0,290,150,140,0,0,290
21,Somalia,2017,SOM-17/3485/SA1 2017/FSC/NGO/4659,1/22/2018 8:04:14 AM,Agro-Pastoralists,720,823,206,309,2058,874,998,250,374,2496
21,Somalia,2017,SOM-17/3485/SA1 2017/FSC/NGO/4659,1/22/2018 8:04:14 AM,Internally Displaced People,2760,3120,2880,3240,12000,32076,36450,34992,42282,145800
21,Somalia,2017,SOM-17/3485/SA1 2017/FSC/NGO/4659,1/22/2018 8:04:14 AM,Internally Displaced People/Returnees,271,310,77,116,774,328,374,94,140,936
21,Somalia,2017,SOM-17/3485/SA1 2017/FSC/NGO/4659,1/22/2018 8:04:14 AM,Overall,4562,5179,3395,4012,17148,34260,38946,35616,43218,152040
21,Somalia,2017,SOM-17/3485/SA1 2017/FSC/NGO/4659,1/22/2018 8:04:14 AM,Urban Poor,811,926,232,347,2316,983,1123,281,0,2387
21,Somalia,2017,SOM-17/3485/SA1 2017/H/INGO/4549,2/20/2018 7:03:08 AM,Children under 5,0,0,12075,12075,24150,0,0,11230,11713,22943
21,Somalia,2017,SOM-17/3485/SA1 2017/H/INGO/4549,2/20/2018 7:03:08 AM,Internally Displaced People/Returnees,14273,0,0,0,14273,12703,0,0,0,12703
21,Somalia,2017,SOM-17/3485/SA1 2017/H/INGO/4549,2/20/2018 7:03:08 AM,Overall,14273,32199,12075,12075,70622,12703,30861,11230,11713,66507
21,Somalia,2017,SOM-17/3485/SA1 2017/H/INGO/4549,2/20/2018 7:03:08 AM,Pregnant and Lactating Women,0,9056,0,0,9056,0,8875,0,0,8875
21,Somalia,2017,SOM-17/3485/SA1 2017/H/INGO/4549,2/20/2018 7:03:08 AM,Women of Child-Bearing Age,0,23143,0,0,23143,0,21986,0,0,21986
21,Somalia,2017,SOM-17/3485/SA1 2017/H/INGO/4583,10/30/2017 7:39:04 AM,Internally Displaced People/Returnees,3706,13732,2180,2180,21798,2922,13171,2258,2341,20692
21,Somalia,2017,SOM-17/3485/SA1 2017/H/INGO/4583,10/30/2017 7:39:04 AM,Overall,26411,97541,15481,15481,154914,20752,93546,16033,16624,146955
21,Somalia,2017,SOM-17/3485/SA1 2017/H/INGO/4583,10/30/2017 7:39:04 AM,Pastoralists,80,0,0,0,80,45,35,0,0,80
21,Somalia,2017,SOM-17/3485/SA1 2017/H/INGO/4583,10/30/2017 7:39:04 AM,People in Host Communities,22613,83797,13301,13301,133012,17769,80332,13775,14283,126159
21,Somalia,2017,SOM-17/3485/SA1 2017/H/INGO/4583,10/30/2017 7:39:04 AM,"Staff (own or partner staff, authorities)",12,12,0,0,24,16,8,0,0,24
21,Somalia,2017,SOM-17/3485/SA1 2017/H/INGO/4770,6/20/2018 10:25:08 AM,Internally Displaced People,394,2236,2754,3278,8662,2241,4884,3818,4642,15585
21,Somalia,2017,SOM-17/3485/SA1 2017/H/INGO/4770,6/20/2018 10:25:08 AM,Overall,10930,18363,17136,19540,65969,6404,13518,10907,13211,44040
21,Somalia,2017,SOM-17/3485/SA1 2017/H/INGO/4770,6/20/2018 10:25:08 AM,People in Host Communities,2576,3944,3014,3114,12648,4163,8634,7089,8569,28455
21,Somalia,2017,SOM-17/3485/SA1 2017/H/INGO/5048,7/16/2018 6:50:18 AM,Children under 5,0,0,9614,9614,19228,0,0,10310,11718,22028
21,Somalia,2017,SOM-17/3485/SA1 2017/H/INGO/5048,7/16/2018 6:50:18 AM,Overall,41,26494,9614,9614,45763,81,44309,10300,11728,66418
21,Somalia,2017,SOM-17/3485/SA1 2017/H/INGO/5048,7/16/2018 6:50:18 AM,Pregnant and Lactating Women,0,15877,0,0,15877,0,22787,0,0,22787
21,Somalia,2017,SOM-17/3485/SA1 2017/H/INGO/5048,7/16/2018 6:50:18 AM,"Staff (own or partner staff, authorities)",41,33,0,0,74,81,131,0,0,212
21,Somalia,2017,SOM-17/3485/SA1 2017/H/INGO/5048,7/16/2018 6:50:18 AM,Women of Child-Bearing Age,0,10584,0,0,10584,0,21391,0,0,21391
21,Somalia,2017,SOM-17/3485/SA1 2017/H/NGO/4536,7/6/2018 7:43:49 AM,Children under 5,0,0,3300,3300,6600,0,0,3433,3800,7233
21,Somalia,2017,SOM-17/3485/SA1 2017/H/NGO/4536,7/6/2018 7:43:49 AM,Overall,3500,4750,6600,7150,22000,3210,4715,6443,7874,22242
21,Somalia,2017,SOM-17/3485/SA1 2017/H/NGO/4536,7/6/2018 7:43:49 AM,People in HE and/or AFLC,3250,2850,3100,3650,12850,2960,2665,2810,3874,12309
21,Somalia,2017,SOM-17/3485/SA1 2017/H/NGO/4536,7/6/2018 7:43:49 AM,Pregnant and Lactating Women,0,1600,0,0,1600,0,1750,0,0,1750
21,Somalia,2017,SOM-17/3485/SA1 2017/H/NGO/4536,7/6/2018 7:43:49 AM,"Staff (own or partner staff, authorities)",250,300,200,200,950,250,300,200,200,950
21,Somalia,2017,SOM-17/3485/SA1 2017/H/NGO/4542,8/14/2018 9:01:31 AM,Children under 5,0,0,5800,6200,12000,0,0,5499,6101,11600
21,Somalia,2017,SOM-17/3485/SA1 2017/H/NGO/4542,8/14/2018 9:01:31 AM,Other,28771,0,0,0,28771,29900,5500,600,870,36870
21,Somalia,2017,SOM-17/3485/SA1 2017/H/NGO/4542,8/14/2018 9:01:31 AM,Overall,28785,19215,5800,6200,60000,29900,23694,6099,6971,66664
21,Somalia,2017,SOM-17/3485/SA1 2017/H/NGO/4542,8/14/2018 9:01:31 AM,"Staff (own or partner staff, authorities)",14,15,0,0,29,17,9,0,0,26
21,Somalia,2017,SOM-17/3485/SA1 2017/H/NGO/4542,8/14/2018 9:01:31 AM,Women of Child-Bearing Age,0,19200,0,0,19200,0,18194,0,0,18194
21,Somalia,2017,SOM-17/3485/SA1 2017/H/NGO/4603,2/21/2018 12:36:51 PM,Children under 5,0,0,6000,6000,12000,0,0,6100,6150,12250
21,Somalia,2017,SOM-17/3485/SA1 2017/H/NGO/4603,2/21/2018 12:36:51 PM,Overall,810,5010,6000,6000,17820,920,5200,6100,6150,18370
21,Somalia,2017,SOM-17/3485/SA1 2017/H/NGO/4603,2/21/2018 12:36:51 PM,"Trainers, Promoters, Caretakers, committee members, etc.",20,0,0,0,20,20,0,0,0,20
21,Somalia,2017,SOM-17/3485/SA1 2017/H/NGO/4603,2/21/2018 12:36:51 PM,Women of Child-Bearing Age,0,5000,0,0,5000,0,5200,0,0,5200
21,Somalia,2017,SOM-17/3485/SA1 2017/H/NGO/4622,4/17/2018 10:13:37 AM,Children under 18,0,0,1320,1408,2728,0,0,2840,3130,5970
21,Somalia,2017,SOM-17/3485/SA1 2017/H/NGO/4622,4/17/2018 10:13:37 AM,Children under 5,0,0,5690,6577,12267,0,0,12221,11889,24110
21,Somalia,2017,SOM-17/3485/SA1 2017/H/NGO/4622,4/17/2018 10:13:37 AM,Overall,8573,8958,7010,7985,32526,12723,14982,15061,15019,57785
21,Somalia,2017,SOM-17/3485/SA1 2017/H/NGO/4622,4/17/2018 10:13:37 AM,"Staff (own or partner staff, authorities)",22,20,0,0,42,27,14,0,0,41
21,Somalia,2017,SOM-17/3485/SA1 2017/H/NGO/4622,4/17/2018 10:13:37 AM,Urban Poor,8551,8938,0,0,17489,12696,14968,0,0,27664
21,Somalia,2017,SOM-17/3485/SA1 2017/H/NGO/4628,8/8/2018 12:55:14 PM,Agro-Pastoralists,1000,3000,1000,1000,6000,1900,3000,1100,1000,7000
21,Somalia,2017,SOM-17/3485/SA1 2017/H/NGO/4628,8/8/2018 12:55:14 PM,Children under 5,1000,1500,500,300,3300,1000,1500,500,300,3300
21,Somalia,2017,SOM-17/3485/SA1 2017/H/NGO/4628,8/8/2018 12:55:14 PM,Internally Displaced People,1000,500,500,500,2500,1000,500,500,500,2500
21,Somalia,2017,SOM-17/3485/SA1 2017/H/NGO/4628,8/8/2018 12:55:14 PM,Overall,4300,5200,2200,2300,14000,4300,5200,2200,2300,14000
21,Somalia,2017,SOM-17/3485/SA1 2017/H/NGO/4628,8/8/2018 12:55:14 PM,Pregnant and Lactating Women,300,200,200,500,1200,300,200,200,500,1200
21,Somalia,2017,SOM-17/3485/SA1 2017/H/NGO/4645,2/26/2018 11:59:20 AM,Children under 5,0,0,2000,2000,4000,0,0,2000,2000,4000
21,Somalia,2017,SOM-17/3485/SA1 2017/H/NGO/4645,2/26/2018 11:59:20 AM,Internally Displaced People,2000,2000,3500,3500,11000,2000,2000,3500,3500,11000
21,Somalia,2017,SOM-17/3485/SA1 2017/H/NGO/4645,2/26/2018 11:59:20 AM,Overall,3000,7500,9000,10500,30000,3000,7500,9000,10500,30000
21,Somalia,2017,SOM-17/3485/SA1 2017/H/NGO/4645,2/26/2018 11:59:20 AM,People in HE and/or AFLC,1000,1000,3500,5000,10500,1000,1000,1000,5000,8000
21,Somalia,2017,SOM-17/3485/SA1 2017/H/NGO/4645,2/26/2018 11:59:20 AM,Pregnant and Lactating Women,0,4500,0,0,4500,0,4500,0,0,4500
21,Somalia,2017,SOM-17/3485/SA1 2017/H/NGO/4687,3/9/2018 6:34:24 AM,Children under 5,0,0,2100,2100,4200,0,0,1995,2310,4305
21,Somalia,2017,SOM-17/3485/SA1 2017/H/NGO/4687,3/9/2018 6:34:24 AM,Internally Displaced People,3100,3325,4200,4200,14825,2785,3582,3990,4620,14977
21,Somalia,2017,SOM-17/3485/SA1 2017/H/NGO/4687,3/9/2018 6:34:24 AM,Overall,3150,5250,6300,6300,21000,2835,5512,5985,6930,21262
21,Somalia,2017,SOM-17/3485/SA1 2017/H/NGO/4687,3/9/2018 6:34:24 AM,Pregnant and Lactating Women,0,1890,0,0,1890,0,1895,0,0,1895
21,Somalia,2017,SOM-17/3485/SA1 2017/H/NGO/4687,3/9/2018 6:34:24 AM,Returnees,50,35,0,0,85,50,35,0,0,85
21,Somalia,2017,SOM-17/3485/SA1 2017/H/NGO/4988,2/19/2018 9:47:04 AM,Children under 5,0,0,5096,5096,10192,0,0,9175,8671,17846
21,Somalia,2017,SOM-17/3485/SA1 2017/H/NGO/4988,2/19/2018 9:47:04 AM,Internally Displaced People,4000,5430,3161,4111,16702,8722,6692,3248,3387,22049
21,Somalia,2017,SOM-17/3485/SA1 2017/H/NGO/4988,2/19/2018 9:47:04 AM,Overall,8600,19340,11510,11510,50960,8843,19427,12423,12058,52751
21,Somalia,2017,SOM-17/3485/SA1 2017/H/NGO/4988,2/19/2018 9:47:04 AM,"Trainers, Promoters, Caretakers, committee members, etc.",121,361,0,0,482,121,361,0,0,482
21,Somalia,2017,SOM-17/3485/SA1 2017/H/NGO/4988,2/19/2018 9:47:04 AM,Women of Child-Bearing Age,0,11721,0,0,11721,0,12374,0,0,12374
21,Somalia,2017,SOM-17/3485/SA1 2017/H/O/5002,6/21/2018 6:28:53 AM,Children under 18,0,0,7830,8811,16641,835,0,4042,3134,8011
21,Somalia,2017,SOM-17/3485/SA1 2017/H/O/5002,6/21/2018 6:28:53 AM,Children under 5,0,0,4091,4349,8440,0,0,4833,5820,10653
21,Somalia,2017,SOM-17/3485/SA1 2017/H/O/5002,6/21/2018 6:28:53 AM,Overall,6443,14509,14941,16187,52080,867,16154,8875,8954,34850
21,Somalia,2017,SOM-17/3485/SA1 2017/H/O/5002,6/21/2018 6:28:53 AM,Pregnant and Lactating Women,0,7787,0,0,7787,0,16118,0,0,16118
21,Somalia,2017,SOM-17/3485/SA1 2017/H/O/5002,6/21/2018 6:28:53 AM,"Staff (own or partner staff, authorities)",8,12,0,0,20,28,40,0,0,68
21,Somalia,2017,SOM-17/3485/SA1 2017/Nut/INGO/4540,2/20/2018 6:55:17 AM,Children under 5,0,0,9077,9077,18154,0,0,9114,9286,18400
21,Somalia,2017,SOM-17/3485/SA1 2017/Nut/INGO/4540,2/20/2018 6:55:17 AM,Other,100,40,0,0,140,176,58,0,0,234
21,Somalia,2017,SOM-17/3485/SA1 2017/Nut/INGO/4540,2/20/2018 6:55:17 AM,Overall,163,7064,9077,9077,25381,199,7557,9114,9286,26156
21,Somalia,2017,SOM-17/3485/SA1 2017/Nut/INGO/4540,2/20/2018 6:55:17 AM,Pregnant and Lactating Women,0,6983,0,0,6983,0,7500,0,0,7500
21,Somalia,2017,SOM-17/3485/SA1 2017/Nut/INGO/4540,2/20/2018 6:55:17 AM,"Staff (own or partner staff, authorities)",40,40,0,0,80,23,17,0,0,40
21,Somalia,2017,SOM-17/3485/SA1 2017/Nut/INGO/4550,10/30/2017 7:44:31 AM,Children under 5,0,0,2100,2450,4550,0,0,3020,3675,6695
21,Somalia,2017,SOM-17/3485/SA1 2017/Nut/INGO/4550,10/30/2017 7:44:31 AM,Overall,16,3856,2100,2450,8422,16,3944,3020,3675,10655
21,Somalia,2017,SOM-17/3485/SA1 2017/Nut/INGO/4550,10/30/2017 7:44:31 AM,Pregnant and Lactating Women,0,3840,0,0,3840,0,3928,0,0,3928
21,Somalia,2017,SOM-17/3485/SA1 2017/Nut/INGO/4550,10/30/2017 7:44:31 AM,"Staff (own or partner staff, authorities)",16,16,0,0,32,16,16,0,0,32
21,Somalia,2017,SOM-17/3485/SA1 2017/Nut/INGO/4607,10/25/2017 11:46:08 AM,Children under 5,0,0,350,350,700,0,0,440,588,1028
21,Somalia,2017,SOM-17/3485/SA1 2017/Nut/INGO/4607,10/25/2017 11:46:08 AM,Overall,0,300,350,350,1000,0,276,440,588,1304
21,Somalia,2017,SOM-17/3485/SA1 2017/Nut/INGO/4607,10/25/2017 11:46:08 AM,Pregnant and Lactating Women,0,300,0,0,300,0,276,0,0,276
21,Somalia,2017,SOM-17/3485/SA1 2017/Nut/INGO/4663,2/20/2018 7:51:04 AM,Children under 5,0,0,564,500,1064,0,0,2214,2815,5029
21,Somalia,2017,SOM-17/3485/SA1 2017/Nut/INGO/4663,2/20/2018 7:51:04 AM,Overall,21,5222,564,500,6307,21,9374,2214,2815,14424
21,Somalia,2017,SOM-17/3485/SA1 2017/Nut/INGO/4663,2/20/2018 7:51:04 AM,Pregnant and Lactating Women,0,5208,0,0,5208,0,9374,0,0,9374
21,Somalia,2017,SOM-17/3485/SA1 2017/Nut/INGO/4663,2/20/2018 7:51:04 AM,"Staff (own or partner staff, authorities)",21,14,0,0,35,21,14,0,0,35
21,Somalia,2017,SOM-17/3485/SA1 2017/Nut/INGO/4667,9/4/2018 7:58:10 AM,Children under 5,0,0,750,750,1500,0,0,785,812,1597
21,Somalia,2017,SOM-17/3485/SA1 2017/Nut/INGO/4667,9/4/2018 7:58:10 AM,Committees,160,80,0,0,240,232,305,0,0,537
21,Somalia,2017,SOM-17/3485/SA1 2017/Nut/INGO/4667,9/4/2018 7:58:10 AM,Overall,187,3146,750,750,4833,270,3196,785,812,5063
21,Somalia,2017,SOM-17/3485/SA1 2017/Nut/INGO/4667,9/4/2018 7:58:10 AM,Pregnant and Lactating Women,0,3000,0,0,3000,0,2837,0,0,2837
21,Somalia,2017,SOM-17/3485/SA1 2017/Nut/INGO/4667,9/4/2018 7:58:10 AM,"Staff (own or partner staff, authorities)",27,66,0,0,93,47,88,0,0,135
21,Somalia,2017,SOM-17/3485/SA1 2017/Nut/INGO/4674,11/21/2017 9:16:03 AM,Children under 5,0,0,1335,1282,2617,0,0,1692,1755,3447
21,Somalia,2017,SOM-17/3485/SA1 2017/Nut/INGO/4674,11/21/2017 9:16:03 AM,Overall,472,2465,1335,1282,5554,517,2930,1692,1755,6894
21,Somalia,2017,SOM-17/3485/SA1 2017/Nut/INGO/4674,11/21/2017 9:16:03 AM,"Staff (own or partner staff, authorities)",10,10,0,0,20,0,0,0,0,0
21,Somalia,2017,SOM-17/3485/SA1 2017/Nut/INGO/4674,11/21/2017 9:16:03 AM,"Trainers, Promoters, Caretakers, committee members, etc.",462,2455,0,0,2917,16,2,0,0,18
21,Somalia,2017,SOM-17/3485/SA1 2017/Nut/INGO/4693,1/16/2018 11:10:09 AM,Children under 5,0,0,2277,2369,4646,0,0,2282,2398,4680
21,Somalia,2017,SOM-17/3485/SA1 2017/Nut/INGO/4693,1/16/2018 11:10:09 AM,Overall,278,2003,2277,2369,6927,75,2514,2282,2398,7269
21,Somalia,2017,SOM-17/3485/SA1 2017/Nut/INGO/4693,1/16/2018 11:10:09 AM,Pregnant and Lactating Women,0,2003,0,0,2003,0,2389,0,0,2389
21,Somalia,2017,SOM-17/3485/SA1 2017/Nut/INGO/4693,1/16/2018 11:10:09 AM,"Trainers, Promoters, Caretakers, committee members, etc.",278,0,0,0,278,75,125,0,0,200
21,Somalia,2017,SOM-17/3485/SA1 2017/Nut/INGO/4707,2/22/2018 8:24:05 AM,Children under 5,0,0,2629,2629,5258,0,0,3894,4840,8734
21,Somalia,2017,SOM-17/3485/SA1 2017/Nut/INGO/4707,2/22/2018 8:24:05 AM,Other,1082,0,0,0,1082,757,0,0,0,757
21,Somalia,2017,SOM-17/3485/SA1 2017/Nut/INGO/4707,2/22/2018 8:24:05 AM,Overall,1082,12159,2629,2629,18499,757,21855,3894,4840,31346
21,Somalia,2017,SOM-17/3485/SA1 2017/Nut/INGO/4707,2/22/2018 8:24:05 AM,Pregnant and Lactating Women,0,5618,0,0,5618,0,10098,0,0,10098
21,Somalia,2017,SOM-17/3485/SA1 2017/Nut/INGO/4707,2/22/2018 8:24:05 AM,Women of Child-Bearing Age,0,6541,0,0,6541,0,11757,0,0,11757
21,Somalia,2017,SOM-17/3485/SA1 2017/Nut/NGO/4538,3/12/2018 6:32:22 AM,Children under 5,0,0,2600,2600,5200,0,0,2650,2710,5360
21,Somalia,2017,SOM-17/3485/SA1 2017/Nut/NGO/4538,3/12/2018 6:32:22 AM,Overall,140,2760,2600,2600,8100,18,2780,2650,2710,8158
21,Somalia,2017,SOM-17/3485/SA1 2017/Nut/NGO/4538,3/12/2018 6:32:22 AM,Pregnant and Lactating Women,0,2600,0,0,2600,0,2780,0,0,2780
21,Somalia,2017,SOM-17/3485/SA1 2017/Nut/NGO/4538,3/12/2018 6:32:22 AM,"Staff (own or partner staff, authorities)",18,9,0,0,27,18,9,0,0,27
21,Somalia,2017,SOM-17/3485/SA1 2017/Nut/NGO/4561,5/2/2018 12:45:38 PM,Children under 5,0,0,484,727,1211,0,0,3106,4659,7765
21,Somalia,2017,SOM-17/3485/SA1 2017/Nut/NGO/4561,5/2/2018 12:45:38 PM,Overall,0,7869,484,727,9080,69,12043,3106,4659,19877
21,Somalia,2017,SOM-17/3485/SA1 2017/Nut/NGO/4561,5/2/2018 12:45:38 PM,Pregnant and Lactating Women,0,7869,0,0,7869,0,12043,0,0,12043
21,Somalia,2017,SOM-17/3485/SA1 2017/Nut/NGO/4588,3/5/2018 10:18:59 AM,Children under 5,0,0,2000,2000,4000,0,0,2140,2230,4370
21,Somalia,2017,SOM-17/3485/SA1 2017/Nut/NGO/4588,3/5/2018 10:18:59 AM,Overall,20,1225,2000,2000,5245,20,1320,2140,2230,5710
21,Somalia,2017,SOM-17/3485/SA1 2017/Nut/NGO/4588,3/5/2018 10:18:59 AM,Pregnant and Lactating Women,0,1200,0,0,1200,0,1320,0,0,1320
21,Somalia,2017,SOM-17/3485/SA1 2017/Nut/NGO/4588,3/5/2018 10:18:59 AM,"Trainers, Promoters, Caretakers, committee members, etc.",20,25,0,0,45,20,25,0,0,45
21,Somalia,2017,SOM-17/3485/SA1 2017/Nut/NGO/4589,6/29/2018 7:54:19 AM,Children under 5,0,0,1500,1500,3000,0,0,1700,1800,3500
21,Somalia,2017,SOM-17/3485/SA1 2017/Nut/NGO/4589,6/29/2018 7:54:19 AM,Overall,20,818,1500,1500,3838,20,868,1700,1800,4388
21,Somalia,2017,SOM-17/3485/SA1 2017/Nut/NGO/4589,6/29/2018 7:54:19 AM,Pregnant and Lactating Women,0,500,0,0,500,0,850,0,0,850
21,Somalia,2017,SOM-17/3485/SA1 2017/Nut/NGO/4589,6/29/2018 7:54:19 AM,"Staff (own or partner staff, authorities)",10,8,0,0,18,0,8,0,0,8
21,Somalia,2017,SOM-17/3485/SA1 2017/Nut/NGO/4589,6/29/2018 7:54:19 AM,"Trainers, Promoters, Caretakers, committee members, etc.",10,10,0,0,20,10,10,0,0,20
21,Somalia,2017,SOM-17/3485/SA1 2017/Nut/NGO/4604,2/20/2018 8:11:24 AM,Children under 5,0,0,2000,2000,4000,0,0,2100,2200,4300
21,Somalia,2017,SOM-17/3485/SA1 2017/Nut/NGO/4604,2/20/2018 8:11:24 AM,Overall,18,1017,2000,2000,5035,18,1017,2100,2200,5335
21,Somalia,2017,SOM-17/3485/SA1 2017/Nut/NGO/4604,2/20/2018 8:11:24 AM,Pregnant and Lactating Women,0,1000,0,0,1000,0,1000,0,0,1000
21,Somalia,2017,SOM-17/3485/SA1 2017/Nut/NGO/4604,2/20/2018 8:11:24 AM,"Staff (own or partner staff, authorities)",18,17,0,0,35,18,17,0,0,35
21,Somalia,2017,SOM-17/3485/SA1 2017/Nut/NGO/4605,2/22/2018 8:58:44 AM,Children under 5,0,0,3865,3640,7505,0,0,3289,3375,6664
21,Somalia,2017,SOM-17/3485/SA1 2017/Nut/NGO/4605,2/22/2018 8:58:44 AM,Overall,31,3402,3865,3640,10938,31,2855,3289,3375,9550
21,Somalia,2017,SOM-17/3485/SA1 2017/Nut/NGO/4605,2/22/2018 8:58:44 AM,Pregnant and Lactating Women,0,3377,0,0,3377,0,2830,0,0,2830
21,Somalia,2017,SOM-17/3485/SA1 2017/Nut/NGO/4605,2/22/2018 8:58:44 AM,"Staff (own or partner staff, authorities)",31,25,0,0,56,31,25,0,0,56
21,Somalia,2017,SOM-17/3485/SA1 2017/Nut/NGO/4618,5/24/2018 7:59:16 AM,Children under 5,0,0,1445,1822,3267,0,0,4123,4929,9052
21,Somalia,2017,SOM-17/3485/SA1 2017/Nut/NGO/4618,5/24/2018 7:59:16 AM,Overall,18,2270,1445,1822,5555,23,2659,4123,4929,11734
21,Somalia,2017,SOM-17/3485/SA1 2017/Nut/NGO/4618,5/24/2018 7:59:16 AM,Pregnant and Lactating Women,0,2258,0,0,2258,0,2652,0,0,2652
21,Somalia,2017,SOM-17/3485/SA1 2017/Nut/NGO/4618,5/24/2018 7:59:16 AM,"Staff (own or partner staff, authorities)",18,12,0,0,30,23,7,0,0,30
21,Somalia,2017,SOM-17/3485/SA1 2017/Nut/NGO/4676,6/25/2018 7:51:36 AM,Children under 5,0,0,1980,1980,3960,0,0,2178,2185,4363
21,Somalia,2017,SOM-17/3485/SA1 2017/Nut/NGO/4676,6/25/2018 7:51:36 AM,Overall,0,1161,1980,1980,5121,0,1276,2178,2185,5639
21,Somalia,2017,SOM-17/3485/SA1 2017/Nut/NGO/4676,6/25/2018 7:51:36 AM,Pregnant and Lactating Women,0,1161,0,0,1161,0,1276,0,0,1276
21,Somalia,2017,SOM-17/3485/SA1 2017/Nut/NGO/4679,2/27/2018 11:29:25 AM,Children under 5,0,0,1200,1200,2400,0,0,1175,1236,2411
21,Somalia,2017,SOM-17/3485/SA1 2017/Nut/NGO/4679,2/27/2018 11:29:25 AM,Overall,35,935,1200,1200,3370,70,1245,1175,1236,3726
21,Somalia,2017,SOM-17/3485/SA1 2017/Nut/NGO/4679,2/27/2018 11:29:25 AM,Pregnant and Lactating Women,0,900,0,0,900,0,1210,0,0,1210
21,Somalia,2017,SOM-17/3485/SA1 2017/Nut/NGO/4679,2/27/2018 11:29:25 AM,"Staff (own or partner staff, authorities)",35,35,0,0,70,70,35,0,0,105
21,Somalia,2017,SOM-17/3485/SA1 2017/Nut/NGO/5010,3/5/2018 10:19:32 AM,Children under 5,0,0,1200,1200,2400,0,0,939,953,1892
21,Somalia,2017,SOM-17/3485/SA1 2017/Nut/NGO/5010,3/5/2018 10:19:32 AM,Overall,20,1020,1200,1200,3440,19,1096,939,953,3007
21,Somalia,2017,SOM-17/3485/SA1 2017/Nut/NGO/5010,3/5/2018 10:19:32 AM,Pregnant and Lactating Women,0,1000,0,0,1000,0,1096,0,0,1096
21,Somalia,2017,SOM-17/3485/SA1 2017/Nut/NGO/5010,3/5/2018 10:19:32 AM,"Staff (own or partner staff, authorities)",20,20,0,0,40,19,21,0,0,40
21,Somalia,2017,SOM-17/3485/SA1 2017/Nut/NGO/5038,5/18/2018 6:47:52 AM,Children under 5,0,0,1275,1275,2550,0,0,1364,1432,2796
21,Somalia,2017,SOM-17/3485/SA1 2017/Nut/NGO/5038,5/18/2018 6:47:52 AM,Other,165,0,0,0,165,104,0,0,0,104
21,Somalia,2017,SOM-17/3485/SA1 2017/Nut/NGO/5038,5/18/2018 6:47:52 AM,Overall,185,2815,1275,1275,5550,104,2875,1364,1432,5775
21,Somalia,2017,SOM-17/3485/SA1 2017/Nut/NGO/5038,5/18/2018 6:47:52 AM,Pregnant and Lactating Women,0,2800,0,0,2800,0,2875,0,0,2875
21,Somalia,2017,SOM-17/3485/SA1 2017/Nut/NGO/5038,5/18/2018 6:47:52 AM,"Staff (own or partner staff, authorities)",20,15,0,0,35,20,15,0,0,35
21,Somalia,2017,SOM-17/3485/SA1 2017/Prot/INGO/4554,6/21/2018 7:54:38 AM,Children under 18,0,0,800,980,1780,0,0,700,820,1520
21,Somalia,2017,SOM-17/3485/SA1 2017/Prot/INGO/4554,6/21/2018 7:54:38 AM,Internally Displaced People/Returnees,645,2115,150,150,3060,1000,2800,400,510,4710
21,Somalia,2017,SOM-17/3485/SA1 2017/Prot/INGO/4554,6/21/2018 7:54:38 AM,Overall,740,2315,1000,1180,5235,1280,3820,1200,1433,7733
21,Somalia,2017,SOM-17/3485/SA1 2017/Prot/INGO/4554,6/21/2018 7:54:38 AM,People in Host Communities,80,185,50,50,365,210,800,100,103,1213
21,Somalia,2017,SOM-17/3485/SA1 2017/Prot/INGO/4554,6/21/2018 7:54:38 AM,"Staff (own or partner staff, authorities)",15,15,0,0,30,70,220,0,0,290
21,Somalia,2017,SOM-17/3485/SA1 2017/Prot/INGO/4594,8/1/2018 5:19:56 AM,Internally Displaced People,166,1244,124,469,2003,2950,1844,1106,2213,8113
21,Somalia,2017,SOM-17/3485/SA1 2017/Prot/INGO/4594,8/1/2018 5:19:56 AM,Overall,555,4148,410,1565,6678,3606,2894,1500,2737,10737
21,Somalia,2017,SOM-17/3485/SA1 2017/Prot/INGO/4594,8/1/2018 5:19:56 AM,People in Host Communities,389,2904,286,1096,4675,656,1050,394,524,2624
21,Somalia,2017,SOM-17/3485/SA1 2017/Prot/INGO/4612,4/6/2018 8:25:55 AM,Internally Displaced People/Returnees,1113,1608,177,252,3150,631,2481,274,488,3874
21,Somalia,2017,SOM-17/3485/SA1 2017/Prot/INGO/4612,4/6/2018 8:25:55 AM,Other,352,352,23,23,750,195,325,73,87,680
21,Somalia,2017,SOM-17/3485/SA1 2017/Prot/INGO/4612,4/6/2018 8:25:55 AM,Overall,1496,2020,200,275,3991,859,2868,347,575,4649
21,Somalia,2017,SOM-17/3485/SA1 2017/Prot/INGO/4612,4/6/2018 8:25:55 AM,"Staff (own or partner staff, authorities)",31,60,0,0,91,33,62,0,0,95
21,Somalia,2017,SOM-17/3485/SA1 2017/Prot/INGO/4642,7/25/2018 5:53:45 AM,Committees,39,18,0,0,57,31,40,3,4,78
21,Somalia,2017,SOM-17/3485/SA1 2017/Prot/INGO/4642,7/25/2018 5:53:45 AM,Internally Displaced People/Returnees,1767,2692,205,329,4993,2014,2689,217,375,5295
21,Somalia,2017,SOM-17/3485/SA1 2017/Prot/INGO/4642,7/25/2018 5:53:45 AM,Overall,2348,3523,293,470,6634,8046,13972,372,1065,23455
21,Somalia,2017,SOM-17/3485/SA1 2017/Prot/INGO/4642,7/25/2018 5:53:45 AM,People in Host Communities,542,813,88,141,1584,667,882,69,120,1738
21,Somalia,2017,SOM-17/3485/SA1 2017/Prot/INGO/4678,7/25/2018 7:11:05 AM,Overall,4205,4604,5482,3789,18080,2684,2712,12363,9021,26780
21,Somalia,2017,SOM-17/3485/SA1 2017/Prot/INGO/4678,7/25/2018 7:11:05 AM,People in Host Communities,4205,4604,5482,3789,18080,0,0,0,0,0
21,Somalia,2017,SOM-17/3485/SA1 2017/Prot/INGO/4683,1/16/2018 7:19:59 AM,Children under 18,0,0,1040,1560,2600,0,0,790,1376,2166
21,Somalia,2017,SOM-17/3485/SA1 2017/Prot/INGO/4683,1/16/2018 7:19:59 AM,Internally Displaced People,223,891,0,0,1114,260,1292,0,0,1552
21,Somalia,2017,SOM-17/3485/SA1 2017/Prot/INGO/4683,1/16/2018 7:19:59 AM,Overall,223,891,1040,1560,3714,260,1292,790,1376,3718
21,Somalia,2017,SOM-17/3485/SA1 2017/Prot/INGO/4690,2/9/2018 6:01:21 AM,Internally Displaced People/Returnees,333,1125,391,1571,3420,711,864,744,1188,3507
21,Somalia,2017,SOM-17/3485/SA1 2017/Prot/INGO/4690,2/9/2018 6:01:21 AM,Overall,502,1375,565,1893,4335,1188,1440,1240,1981,5849
21,Somalia,2017,SOM-17/3485/SA1 2017/Prot/INGO/4690,2/9/2018 6:01:21 AM,Pastoralists,169,250,174,322,915,477,576,496,793,2342
21,Somalia,2017,SOM-17/3485/SA1 2017/Prot/INGO/5298,2/8/2018 8:12:40 AM,Internally Displaced People,100,138,535,535,1308,98,222,371,382,1073
21,Somalia,2017,SOM-17/3485/SA1 2017/Prot/INGO/5298,2/8/2018 8:12:40 AM,Overall,119,163,535,535,1352,106,259,371,382,1118
21,Somalia,2017,SOM-17/3485/SA1 2017/Prot/INGO/5298,2/8/2018 8:12:40 AM,"Staff (own or partner staff, authorities)",19,25,0,0,44,8,37,0,0,45
21,Somalia,2017,SOM-17/3485/SA1 2017/Prot/NGO/4547,1/31/2018 3:08:59 PM,Internally Displaced People,250,200,20,40,510,154,398,0,0,552
21,Somalia,2017,SOM-17/3485/SA1 2017/Prot/NGO/4547,1/31/2018 3:08:59 PM,Overall,775,2075,55,95,3000,864,1549,2,62,2477
21,Somalia,2017,SOM-17/3485/SA1 2017/Prot/NGO/4547,1/31/2018 3:08:59 PM,People in Host Communities,400,900,30,50,1380,619,929,0,0,1548
21,Somalia,2017,SOM-17/3485/SA1 2017/Prot/NGO/4547,1/31/2018 3:08:59 PM,"Trainers, Promoters, Caretakers, committee members, etc.",100,800,5,5,910,89,61,0,0,150
21,Somalia,2017,SOM-17/3485/SA1 2017/Prot/NGO/4572,2/2/2018 6:23:41 AM,Internally Displaced People,270,802,243,243,1558,230,1506,28,115,1879
21,Somalia,2017,SOM-17/3485/SA1 2017/Prot/NGO/4572,2/2/2018 6:23:41 AM,Overall,470,1597,493,493,3053,361,1778,57,178,2374
21,Somalia,2017,SOM-17/3485/SA1 2017/Prot/NGO/4572,2/2/2018 6:23:41 AM,People in HE and/or AFLC,200,795,250,250,1495,131,272,29,63,495
21,Somalia,2017,SOM-17/3485/SA1 2017/Prot/NGO/4606,2/23/2018 9:25:31 AM,Internally Displaced People,150,500,25,25,700,80,330,148,60,618
21,Somalia,2017,SOM-17/3485/SA1 2017/Prot/NGO/4606,2/23/2018 9:25:31 AM,Overall,412,818,75,75,1380,257,644,336,144,1381
21,Somalia,2017,SOM-17/3485/SA1 2017/Prot/NGO/4606,2/23/2018 9:25:31 AM,People in Host Communities,147,318,50,50,565,70,202,99,22,393
21,Somalia,2017,SOM-17/3485/SA1 2017/Prot/NGO/4606,2/23/2018 9:25:31 AM,"Trainers, Promoters, Caretakers, committee members, etc.",115,0,0,0,115,119,96,0,0,215
21,Somalia,2017,SOM-17/3485/SA1 2017/Prot/NGO/4699,11/10/2017 5:58:34 AM,Internally Displaced People,170,1000,15,40,1225,38,1324,54,196,1612
21,Somalia,2017,SOM-17/3485/SA1 2017/Prot/NGO/4699,11/10/2017 5:58:34 AM,Overall,207,1255,22,50,1534,83,1941,84,285,2393
21,Somalia,2017,SOM-17/3485/SA1 2017/Prot/NGO/4699,11/10/2017 5:58:34 AM,People in Host Communities,37,255,7,10,309,45,617,30,89,781
21,Somalia,2017,SOM-17/3485/SA1 2017/Prot/NGO/4997,6/6/2018 1:12:11 PM,Aid Agencies,0,0,0,0,0,10,10,0,0,20
21,Somalia,2017,SOM-17/3485/SA1 2017/Prot/NGO/4997,6/6/2018 1:12:11 PM,Internally Displaced People,0,0,350,500,850,53,36,420,648,1157
21,Somalia,2017,SOM-17/3485/SA1 2017/Prot/NGO/4997,6/6/2018 1:12:11 PM,Overall,10,10,450,810,1280,98,63,536,901,1598
21,Somalia,2017,SOM-17/3485/SA1 2017/Prot/NGO/4997,6/6/2018 1:12:11 PM,People in Host Communities,10,10,100,310,430,35,17,116,253,421
21,Somalia,2017,SOM-17/3485/SA1 2017/Shelter/INGO/4609,10/6/2017 6:59:47 AM,Internally Displaced People/Returnees,3085,2963,1322,1270,8640,1962,2098,4153,3431,11644
21,Somalia,2017,SOM-17/3485/SA1 2017/Shelter/INGO/4609,10/6/2017 6:59:47 AM,Overall,3856,3704,1652,1588,10800,2453,2622,5191,4289,14555
21,Somalia,2017,SOM-17/3485/SA1 2017/Shelter/INGO/4609,10/6/2017 6:59:47 AM,People in Host Communities,771,741,330,318,2160,491,524,1038,858,2911
21,Somalia,2017,SOM-17/3485/SA1 2017/Shelter/NGO/4580,10/6/2017 6:25:39 AM,Internally Displaced People,2160,3240,2700,2700,10800,2160,3240,2700,2700,10800
21,Somalia,2017,SOM-17/3485/SA1 2017/Shelter/NGO/4580,10/6/2017 6:25:39 AM,Overall,2160,3240,2700,2700,10800,2160,3240,2700,2700,10800
21,Somalia,2017,SOM-17/3485/SA1 2017/WASH/INGO/4529,11/13/2017 7:43:09 AM,Internally Displaced People/Returnees,3370,3500,2250,4800,13920,4826,5339,7502,6704,24371
21,Somalia,2017,SOM-17/3485/SA1 2017/WASH/INGO/4529,11/13/2017 7:43:09 AM,Overall,4000,4400,3200,5800,17400,5362,5932,8336,7449,27079
21,Somalia,2017,SOM-17/3485/SA1 2017/WASH/INGO/4529,11/13/2017 7:43:09 AM,People in Host Communities,630,900,950,1000,3480,536,593,834,745,2708
21,Somalia,2017,SOM-17/3485/SA1 2017/WASH/INGO/4543,11/2/2017 8:12:21 AM,Internally Displaced People,196,219,228,257,900,190,236,296,244,966
21,Somalia,2017,SOM-17/3485/SA1 2017/WASH/INGO/4543,11/2/2017 8:12:21 AM,Overall,2004,2199,2253,2544,9000,1787,2463,2718,2365,9333
21,Somalia,2017,SOM-17/3485/SA1 2017/WASH/INGO/4543,11/2/2017 8:12:21 AM,Pastoralists,415,445,458,515,1833,404,472,460,408,1744
21,Somalia,2017,SOM-17/3485/SA1 2017/WASH/INGO/4543,11/2/2017 8:12:21 AM,People in Host Communities,1393,1535,1567,1772,6267,1193,1755,1952,1713,6613
21,Somalia,2017,SOM-17/3485/SA1 2017/WASH/INGO/4548,12/23/2017 7:21:57 PM,Overall,1891,3115,3003,3115,11124,1891,3115,3003,3115,11124
21,Somalia,2017,SOM-17/3485/SA1 2017/WASH/INGO/4548,12/23/2017 7:21:57 PM,Pastoralists,1891,3115,3003,3115,11124,1891,3115,3003,3115,11124
21,Somalia,2017,SOM-17/3485/SA1 2017/WASH/INGO/4555,1/30/2018 11:39:33 AM,Internally Displaced People/Returnees,2400,6500,2558,6786,18244,3250,5325,3432,3965,15972
21,Somalia,2017,SOM-17/3485/SA1 2017/WASH/INGO/4555,1/30/2018 11:39:33 AM,Overall,4050,7475,4814,8018,24357,6230,9500,6387,9250,31367
21,Somalia,2017,SOM-17/3485/SA1 2017/WASH/INGO/4555,1/30/2018 11:39:33 AM,People in Host Communities,1650,975,2256,1232,6113,4250,6300,3020,1825,15395
21,Somalia,2017,SOM-17/3485/SA1 2017/WASH/INGO/4574,10/5/2017 10:58:54 AM,Internally Displaced People/Returnees,6360,6890,12721,13781,39752,6360,6890,12721,13871,39842
21,Somalia,2017,SOM-17/3485/SA1 2017/WASH/INGO/4574,10/5/2017 10:58:54 AM,Overall,9086,9844,18173,19687,56790,9086,9844,18173,19687,56790
21,Somalia,2017,SOM-17/3485/SA1 2017/WASH/INGO/4574,10/5/2017 10:58:54 AM,People in Host Communities,2725,2954,5452,5906,17037,2725,2954,5452,5906,17037
21,Somalia,2017,SOM-17/3485/SA1 2017/WASH/INGO/4586,11/27/2017 6:55:33 AM,Internally Displaced People,678,658,532,532,2400,670,1874,915,975,4434
21,Somalia,2017,SOM-17/3485/SA1 2017/WASH/INGO/4586,11/27/2017 6:55:33 AM,Overall,7640,7398,5981,5981,27000,4432,12395,6051,6447,29325
21,Somalia,2017,SOM-17/3485/SA1 2017/WASH/INGO/4586,11/27/2017 6:55:33 AM,People in Host Communities,6962,6740,5449,5449,24600,3762,10521,5136,5472,24891
21,Somalia,2017,SOM-17/3485/SA1 2017/WASH/INGO/4677,1/30/2018 11:36:06 AM,Internally Displaced People,1700,2125,2125,2000,7950,1590,1988,1989,2401,7968
21,Somalia,2017,SOM-17/3485/SA1 2017/WASH/INGO/4677,1/30/2018 11:36:06 AM,Overall,3710,4638,4637,5015,18000,3600,4501,4501,5401,18003
21,Somalia,2017,SOM-17/3485/SA1 2017/WASH/INGO/4677,1/30/2018 11:36:06 AM,Pastoralists,2010,2513,2512,3000,10035,2010,2513,2512,3000,10035
21,Somalia,2017,SOM-17/3485/SA1 2017/WASH/INGO/4682,11/28/2017 5:05:34 AM,Internally Displaced People,410,509,1590,2065,4574,560,659,1590,2065,4874
21,Somalia,2017,SOM-17/3485/SA1 2017/WASH/INGO/4682,11/28/2017 5:05:34 AM,Overall,999,1221,3885,4995,11100,1149,1371,3885,4995,11400
21,Somalia,2017,SOM-17/3485/SA1 2017/WASH/INGO/4682,11/28/2017 5:05:34 AM,People in Host Communities,350,427,1292,1750,3819,350,427,1292,1750,3819
21,Somalia,2017,SOM-17/3485/SA1 2017/WASH/INGO/4682,11/28/2017 5:05:34 AM,Urban Poor,239,285,1003,1180,2707,239,285,1003,1180,2707
21,Somalia,2017,SOM-17/3485/SA1 2017/WASH/INGO/4691,10/18/2017 6:02:52 AM,Children under 18,0,0,580,420,1000,0,0,621,521,1142
21,Somalia,2017,SOM-17/3485/SA1 2017/WASH/INGO/4691,10/18/2017 6:02:52 AM,Internally Displaced People,882,918,600,600,3000,1025,1237,671,811,3744
21,Somalia,2017,SOM-17/3485/SA1 2017/WASH/INGO/4691,10/18/2017 6:02:52 AM,Overall,3234,3366,2780,2620,12000,3936,4059,2337,1968,12300
21,Somalia,2017,SOM-17/3485/SA1 2017/WASH/INGO/4691,10/18/2017 6:02:52 AM,People in Host Communities,2352,2448,1600,1600,8000,2236,2672,1388,1118,7414
21,Somalia,2017,SOM-17/3485/SA1 2017/WASH/INGO/4704,1/30/2018 11:41:43 AM,Agro-Pastoralists,2407,4148,2050,3395,12000,7610,13115,6482,10734,37941
21,Somalia,2017,SOM-17/3485/SA1 2017/WASH/INGO/4704,1/30/2018 11:41:43 AM,Internally Displaced People,1203,2074,1026,1697,6000,3805,6558,3242,5367,18972
21,Somalia,2017,SOM-17/3485/SA1 2017/WASH/INGO/4704,1/30/2018 11:41:43 AM,Overall,6619,11407,5638,9336,33000,20928,36067,17826,29519,104340
21,Somalia,2017,SOM-17/3485/SA1 2017/WASH/INGO/4704,1/30/2018 11:41:43 AM,Pastoralists,3009,5185,2562,4244,15000,9513,16394,8102,13418,47427
21,Somalia,2017,SOM-17/3485/SA1 2017/WASH/NGO/4541,10/24/2017 5:12:43 AM,Overall,4046,8092,14270,14270,40678,4078,8092,14270,14270,40710
21,Somalia,2017,SOM-17/3485/SA1 2017/WASH/NGO/4541,10/24/2017 5:12:43 AM,People from Riverine Communities,4046,8092,14270,14270,40678,4078,8092,14270,14270,40710
21,Somalia,2017,SOM-17/3485/SA1 2017/WASH/NGO/4560,10/24/2017 5:42:07 AM,Overall,8782,13173,2928,4391,29274,8782,13173,2928,4391,29274
21,Somalia,2017,SOM-17/3485/SA1 2017/WASH/NGO/4560,10/24/2017 5:42:07 AM,Pastoralists,8782,13173,2928,4391,29274,8782,13173,2928,4391,29274
21,Somalia,2017,SOM-17/3485/SA1 2017/WASH/NGO/4571,11/13/2017 7:23:01 AM,Agro-Pastoralists,1000,1600,1080,1020,4700,1000,1600,1100,1200,4900
21,Somalia,2017,SOM-17/3485/SA1 2017/WASH/NGO/4571,11/13/2017 7:23:01 AM,Overall,2400,3600,2880,3120,12000,2440,3600,2900,3300,12240
21,Somalia,2017,SOM-17/3485/SA1 2017/WASH/NGO/4571,11/13/2017 7:23:01 AM,Pastoralists,1400,2000,1800,2100,7300,1440,2000,1800,2100,7340
21,Somalia,2017,SOM-17/3485/SA1 2017/WASH/NGO/4593,10/30/2017 5:33:39 AM,Agro-Pastoralists,3091,3146,2503,2538,11278,3091,3146,2781,2750,11768
21,Somalia,2017,SOM-17/3485/SA1 2017/WASH/NGO/4593,10/30/2017 5:33:39 AM,Overall,5276,5372,4553,4547,19748,5276,5372,4831,4759,20238
21,Somalia,2017,SOM-17/3485/SA1 2017/WASH/NGO/4593,10/30/2017 5:33:39 AM,Pastoralists,2185,2226,2050,2009,8470,2185,2226,2050,2009,8470
21,Somalia,2017,SOM-17/3485/SA1 2017/WASH/NGO/4646,2/28/2018 5:09:23 AM,Internally Displaced People/Returnees,630,1050,1260,1260,4200,630,1050,1260,1260,4200
21,Somalia,2017,SOM-17/3485/SA1 2017/WASH/NGO/4646,2/28/2018 5:09:23 AM,Overall,2250,3750,4500,4500,15000,2250,3750,4500,4500,15000
21,Somalia,2017,SOM-17/3485/SA1 2017/WASH/NGO/4646,2/28/2018 5:09:23 AM,Pastoralists,1620,2700,3240,3240,10800,1620,2700,3240,3240,10800
21,Somalia,2017,SOM-17/3485/SA1 2017/WASH/NGO/4653,11/2/2017 8:25:42 AM,Internally Displaced People/Returnees,270,449,541,541,1801,270,449,541,541,1801
21,Somalia,2017,SOM-17/3485/SA1 2017/WASH/NGO/4653,11/2/2017 8:25:42 AM,Overall,1889,3149,3781,3781,12600,1889,3149,3781,3781,12600
21,Somalia,2017,SOM-17/3485/SA1 2017/WASH/NGO/4653,11/2/2017 8:25:42 AM,Pastoralists,1619,2700,3240,3240,10799,1619,2700,3240,3240,10799
21,Somalia,2017,SOM-17/3485/SA1 2017/WASH/NGO/4662,12/23/2017 7:19:18 PM,Internally Displaced People,750,1250,1500,1500,5000,750,1250,1500,1500,5000
21,Somalia,2017,SOM-17/3485/SA1 2017/WASH/NGO/4662,12/23/2017 7:19:18 PM,Overall,2310,3850,4620,4620,15400,2310,3850,4620,4620,15400
21,Somalia,2017,SOM-17/3485/SA1 2017/WASH/NGO/4662,12/23/2017 7:19:18 PM,Pastoralists,1560,2600,3120,3120,10400,1560,2600,3120,3120,10400
21,Somalia,2017,SOM-17/3485/SA2/CCCM-Shelter-Prot/INGO/7425,3/19/2019 7:25:39 AM,Internally Displaced People,3227,5176,4765,4817,17985,13220,27361,2681,2426,45688
21,Somalia,2017,SOM-17/3485/SA2/CCCM-Shelter-Prot/INGO/7425,3/19/2019 7:25:39 AM,Overall,4200,5920,5879,6033,22032,13220,27361,2681,2426,45688
21,Somalia,2017,SOM-17/3485/SA2/CCCM-Shelter-Prot/INGO/7425,3/19/2019 7:25:39 AM,People in Host Communities,505,558,610,688,2361,0,0,0,0,0
21,Somalia,2017,SOM-17/3485/SA2/CCCM-Shelter-Prot/INGO/7425,3/19/2019 7:25:39 AM,"Trainers, Promoters, Caretakers, committee members, etc.",168,186,204,228,786,0,0,0,0,0
21,Somalia,2017,SOM-17/3485/SA2/Ed/INGO/7581,9/28/2018 6:47:03 AM,Children under 18,0,0,0,0,0,0,0,5471,4629,10100
21,Somalia,2017,SOM-17/3485/SA2/Ed/INGO/7581,9/28/2018 6:47:03 AM,Internally Displaced People,20,15,368,250,653,0,0,0,0,0
21,Somalia,2017,SOM-17/3485/SA2/Ed/INGO/7581,9/28/2018 6:47:03 AM,Overall,275,128,3111,2055,5569,251,119,4079,3079,7528
21,Somalia,2017,SOM-17/3485/SA2/Ed/INGO/7581,9/28/2018 6:47:03 AM,People in Host Communities,255,113,2743,1805,4916,0,62,28,0,90
21,Somalia,2017,SOM-17/3485/SA2/Ed-FSC-H-Nut-WASH/INGO/7531,2/15/2019 8:11:30 AM,Internally Displaced People,1712,4342,2289,3541,11884,6535,9686,1663,1789,19673
21,Somalia,2017,SOM-17/3485/SA2/Ed-FSC-H-Nut-WASH/INGO/7531,2/15/2019 8:11:30 AM,Overall,2706,6192,3289,4801,16988,7536,11696,2996,2890,25118
21,Somalia,2017,SOM-17/3485/SA2/Ed-FSC-H-Nut-WASH/INGO/7531,2/15/2019 8:11:30 AM,People in Host Communities,994,1850,1000,1260,5104,1001,2010,1333,1101,5445
21,Somalia,2017,SOM-17/3485/SA2/Ed-FSC-H-Nut-WASH/NGO/7402,12/6/2018 8:30:41 AM,Children under 5,0,0,7500,7500,15000,0,0,7438,7820,15258
21,Somalia,2017,SOM-17/3485/SA2/Ed-FSC-H-Nut-WASH/NGO/7402,12/6/2018 8:30:41 AM,Internally Displaced People/Returnees,1690,1400,0,0,3090,1362,1482,0,0,2844
21,Somalia,2017,SOM-17/3485/SA2/Ed-FSC-H-Nut-WASH/NGO/7402,12/6/2018 8:30:41 AM,Overall,4500,5500,7500,7500,25000,4349,5782,7438,7820,25389
21,Somalia,2017,SOM-17/3485/SA2/Ed-FSC-H-Nut-WASH/NGO/7402,12/6/2018 8:30:41 AM,People in Host Communities,2810,3100,0,0,5910,2987,3217,0,0,6204
21,Somalia,2017,SOM-17/3485/SA2/Ed-FSC-H-Nut-WASH/NGO/7402,12/6/2018 8:30:41 AM,Pregnant and Lactating Women,0,1000,0,0,1000,0,1083,0,0,1083
21,Somalia,2017,SOM-17/3485/SA2/Ed-H-Nut-FSC-WASH/NGO/7572,2/7/2019 11:42:38 AM,Children under 5,0,0,2592,2808,5400,0,0,0,0,0
21,Somalia,2017,SOM-17/3485/SA2/Ed-H-Nut-FSC-WASH/NGO/7572,2/7/2019 11:42:38 AM,Other,6480,4590,3888,4212,19170,0,0,0,0,0
21,Somalia,2017,SOM-17/3485/SA2/Ed-H-Nut-FSC-WASH/NGO/7572,2/7/2019 11:42:38 AM,Overall,6480,7020,6480,7020,27000,2232,6519,7232,6678,22661
21,Somalia,2017,SOM-17/3485/SA2/Ed-H-Nut-FSC-WASH/NGO/7572,2/7/2019 11:42:38 AM,Pregnant and Lactating Women,0,2430,0,0,2430,0,0,0,0,0
21,Somalia,2017,SOM-17/3485/SA2/FSC/INGO/7419,2/18/2019 7:19:25 AM,Internally Displaced People,500,600,600,700,2400,167,225,62,74,528
21,Somalia,2017,SOM-17/3485/SA2/FSC/INGO/7419,2/18/2019 7:19:25 AM,Overall,1000,1200,1300,1318,4818,1000,1200,1300,1318,4818
21,Somalia,2017,SOM-17/3485/SA2/FSC/INGO/7419,2/18/2019 7:19:25 AM,Pastoralists,500,600,700,618,2418,74,112,40,49,275
21,Somalia,2017,SOM-17/3485/SA2/FSC/INGO/7583,10/30/2018 7:41:59 AM,Children under 18,0,0,1824,1724,3548,0,0,1640,1713,3353
21,Somalia,2017,SOM-17/3485/SA2/FSC/INGO/7583,10/30/2018 7:41:59 AM,Children under 5,0,0,590,590,1180,0,0,775,851,1626
21,Somalia,2017,SOM-17/3485/SA2/FSC/INGO/7583,10/30/2018 7:41:59 AM,Internally Displaced People/Returnees,1508,1383,0,0,2891,1265,1309,0,0,2574
21,Somalia,2017,SOM-17/3485/SA2/FSC/INGO/7583,10/30/2018 7:41:59 AM,Overall,1708,1726,2414,2314,8162,1721,1814,2458,2516,8509
21,Somalia,2017,SOM-17/3485/SA2/FSC/INGO/7583,10/30/2018 7:41:59 AM,People in Host Communities,200,343,0,0,543,457,499,0,0,956
21,Somalia,2017,SOM-17/3485/SA2/FSC/NGO/7414,8/10/2018 8:16:39 AM,Overall,600,800,1100,1400,3900,600,800,1100,1400,3900
21,Somalia,2017,SOM-17/3485/SA2/FSC/NGO/7414,8/10/2018 8:16:39 AM,Pastoralists,600,800,1100,1400,3900,361,289,1529,1709,3888
21,Somalia,2017,SOM-17/3485/SA2/FSC/NGO/7554,9/4/2018 6:45:45 AM,Other,210,250,0,0,460,0,0,0,0,0
21,Somalia,2017,SOM-17/3485/SA2/FSC/NGO/7554,9/4/2018 6:45:45 AM,Overall,800,1000,0,0,1800,800,1000,0,0,1800
21,Somalia,2017,SOM-17/3485/SA2/FSC/NGO/7554,9/4/2018 6:45:45 AM,Pastoralists,590,750,0,0,1340,1002,798,0,0,1800
21,Somalia,2017,SOM-17/3485/SA2/FSC-H-WASH-Nut-Ed/NGO/7477,2/11/2019 7:04:14 AM,Internally Displaced People,4288,5302,3570,4340,17500,4190,6325,4526,5175,20216
21,Somalia,2017,SOM-17/3485/SA2/FSC-H-WASH-Nut-Ed/NGO/7477,2/11/2019 7:04:14 AM,Overall,6125,7575,5100,6200,25000,6225,8890,6200,6900,28215
21,Somalia,2017,SOM-17/3485/SA2/FSC-H-WASH-Nut-Ed/NGO/7477,2/11/2019 7:04:14 AM,People in Host Communities,1837,2273,1530,1860,7500,2035,2565,1674,1725,7999
21,Somalia,2017,SOM-17/3485/SA2/FSC-WASH-H-Nut-Ed/INGO/7551,3/7/2019 8:18:22 AM,Children under 5,0,0,2100,2100,4200,0,0,0,0,0
21,Somalia,2017,SOM-17/3485/SA2/FSC-WASH-H-Nut-Ed/INGO/7551,3/7/2019 8:18:22 AM,Internally Displaced People,2620,0,0,0,2620,2500,2200,2600,2500,9800
21,Somalia,2017,SOM-17/3485/SA2/FSC-WASH-H-Nut-Ed/INGO/7551,3/7/2019 8:18:22 AM,Overall,2620,3180,2100,2100,10000,2500,2200,2600,2500,9800
21,Somalia,2017,SOM-17/3485/SA2/FSC-WASH-H-Nut-Ed/INGO/7551,3/7/2019 8:18:22 AM,Pregnant and Lactating Women,0,2000,0,0,2000,0,0,0,0,0
21,Somalia,2017,SOM-17/3485/SA2/FSC-WASH-H-Nut-Ed/INGO/7551,3/7/2019 8:18:22 AM,Women of Child-Bearing Age,0,1180,0,0,1180,0,0,0,0,0
21,Somalia,2017,SOM-17/3485/SA2/H/INGO/7435,11/1/2019 6:13:05 AM,Children under 5,0,0,498,622,1120,2105,2406,601,902,6014
21,Somalia,2017,SOM-17/3485/SA2/H/INGO/7435,11/1/2019 6:13:05 AM,Internally Displaced People,190,334,312,335,1171,3006,4811,1203,3007,12027
21,Somalia,2017,SOM-17/3485/SA2/H/INGO/7435,11/1/2019 6:13:05 AM,Overall,3480,5845,5445,6221,20991,4823,10399,6647,8200,30069
21,Somalia,2017,SOM-17/3485/SA2/H/INGO/7435,11/1/2019 6:13:05 AM,Pregnant and Lactating Women,0,492,0,0,492,1579,1804,451,677,4511
21,Somalia,2017,SOM-17/3485/SA2/H/INGO/7435,11/1/2019 6:13:05 AM,Women of Child-Bearing Age,0,1461,0,0,1461,2631,3007,752,1127,7517
21,Somalia,2017,SOM-17/3485/SA2/H/NGO/7484,7/8/2020 8:01:13 AM,Children under 18,0,0,9582,13645,23227,0,0,9590,13567,23157
21,Somalia,2017,SOM-17/3485/SA2/H/NGO/7484,7/8/2020 8:01:13 AM,Overall,23670,18103,9582,13645,65000,23647,18200,9590,13567,65004
21,Somalia,2017,SOM-17/3485/SA2/H/NGO/7484,7/8/2020 8:01:13 AM,People in Host Communities,23670,0,0,0,23670,23670,0,0,0,23670
21,Somalia,2017,SOM-17/3485/SA2/H/NGO/7484,7/8/2020 8:01:13 AM,Pregnant and Lactating Women,0,5400,0,0,5400,0,3349,0,0,3349
21,Somalia,2017,SOM-17/3485/SA2/H/NGO/7484,7/8/2020 8:01:13 AM,Women of Child-Bearing Age,0,12703,0,0,12703,0,14851,0,0,14851
21,Somalia,2017,SOM-17/3485/SA2/H-Nut-WASH/INGO/7596,4/29/2019 9:38:18 AM,Children under 18,0,0,7691,8040,15731,0,0,2519,2691,5210
21,Somalia,2017,SOM-17/3485/SA2/H-Nut-WASH/INGO/7596,4/29/2019 9:38:18 AM,Internally Displaced People/Returnees,9439,9788,0,0,19227,1051,17871,2519,2691,24132
21,Somalia,2017,SOM-17/3485/SA2/H-Nut-WASH/INGO/7596,4/29/2019 9:38:18 AM,Overall,9439,9788,7691,8040,34958,1051,17871,5183,5200,29305
21,Somalia,2017,SOM-17/3485/SA2/H-Nut-WASH/NGO/7410,11/23/2018 5:39:52 AM,Children under 5,0,0,2650,2650,5300,0,0,7790,8027,15817
21,Somalia,2017,SOM-17/3485/SA2/H-Nut-WASH/NGO/7410,11/23/2018 5:39:52 AM,Internally Displaced People,4264,5685,3796,3796,17541,7106,8059,0,0,15165
21,Somalia,2017,SOM-17/3485/SA2/H-Nut-WASH/NGO/7410,11/23/2018 5:39:52 AM,Overall,4496,9112,6446,6446,26500,7206,16348,7790,8027,39371
21,Somalia,2017,SOM-17/3485/SA2/H-Nut-WASH/NGO/7410,11/23/2018 5:39:52 AM,Pregnant and Lactating Women,0,2385,0,0,2385,0,7278,0,0,7278
21,Somalia,2017,SOM-17/3485/SA2/H-Nut-WASH/NGO/7410,11/23/2018 5:39:52 AM,"Trainers, Promoters, Caretakers, committee members, etc.",232,1042,0,0,1274,100,1011,0,0,1111
21,Somalia,2017,SOM-17/3485/SA2/H-Nut-WASH-Ed-FSC/INGO/7464,2/18/2019 11:29:30 AM,Children under 5,0,0,7200,7200,14400,0,0,15407,15285,30692
21,Somalia,2017,SOM-17/3485/SA2/H-Nut-WASH-Ed-FSC/INGO/7464,2/18/2019 11:29:30 AM,Overall,10,23058,7200,7200,37468,28,29877,15407,15285,60597
21,Somalia,2017,SOM-17/3485/SA2/H-Nut-WASH-Ed-FSC/INGO/7464,2/18/2019 11:29:30 AM,Pregnant and Lactating Women,0,6480,0,0,6480,0,9237,0,0,9237
21,Somalia,2017,SOM-17/3485/SA2/H-Nut-WASH-Ed-FSC/INGO/7464,2/18/2019 11:29:30 AM,"Staff (own or partner staff, authorities)",10,18,0,0,28,28,53,0,0,81
21,Somalia,2017,SOM-17/3485/SA2/H-Nut-WASH-Ed-FSC/INGO/7464,2/18/2019 11:29:30 AM,Women of Child-Bearing Age,0,16560,0,0,16560,0,20587,0,0,20587
21,Somalia,2017,SOM-17/3485/SA2/H-WASH-Nut/NGO/7413,2/5/2019 8:13:38 AM,Children under 5,0,0,2800,3000,5800,0,0,1400,2500,3900
21,Somalia,2017,SOM-17/3485/SA2/H-WASH-Nut/NGO/7413,2/5/2019 8:13:38 AM,Other,2000,0,0,0,2000,800,0,0,0,800
21,Somalia,2017,SOM-17/3485/SA2/H-WASH-Nut/NGO/7413,2/5/2019 8:13:38 AM,Overall,2000,3200,2800,3000,11000,2400,3400,3000,3500,12300
21,Somalia,2017,SOM-17/3485/SA2/H-WASH-Nut/NGO/7413,2/5/2019 8:13:38 AM,Pregnant and Lactating Women,0,3200,0,0,3200,0,1050,0,0,1050
21,Somalia,2017,SOM-17/3485/SA2/L/UN/7647,7/16/2018 6:48:55 AM,Other,2000,2000,0,0,4000,0,0,0,0,0
21,Somalia,2017,SOM-17/3485/SA2/L/UN/7647,7/16/2018 6:48:55 AM,Overall,2000,2000,0,0,4000,2025,2025,0,0,4050
21,Somalia,2017,SOM-17/3485/SA2/Nut/INGO/7588,3/5/2019 9:07:44 AM,Children under 5,0,0,1065,1065,2130,0,0,923,1002,1925
21,Somalia,2017,SOM-17/3485/SA2/Nut/INGO/7588,3/5/2019 9:07:44 AM,Other,2290,0,0,0,2290,554,13901,0,0,14455
21,Somalia,2017,SOM-17/3485/SA2/Nut/INGO/7588,3/5/2019 9:07:44 AM,Overall,2290,9517,1065,1065,13937,579,15597,923,1002,18101
21,Somalia,2017,SOM-17/3485/SA2/Nut/INGO/7588,3/5/2019 9:07:44 AM,Pregnant and Lactating Women,0,355,0,0,355,0,810,0,0,810
21,Somalia,2017,SOM-17/3485/SA2/Nut/INGO/7588,3/5/2019 9:07:44 AM,Women of Child-Bearing Age,0,9162,0,0,9162,0,50,0,0,50
21,Somalia,2017,SOM-17/3485/SA2/Nut/INGO/7646,2/12/2019 12:56:44 PM,Children under 5,0,0,1530,1470,3000,0,0,1720,1729,3449
21,Somalia,2017,SOM-17/3485/SA2/Nut/INGO/7646,2/12/2019 12:56:44 PM,Overall,75,375,1530,1470,3450,76,965,1720,1729,4490
21,Somalia,2017,SOM-17/3485/SA2/Nut/INGO/7646,2/12/2019 12:56:44 PM,Pregnant and Lactating Women,0,300,0,0,300,0,1441,0,0,1441
21,Somalia,2017,SOM-17/3485/SA2/Nut/INGO/7646,2/12/2019 12:56:44 PM,"Staff (own or partner staff, authorities)",75,75,0,0,150,76,45,0,0,121
21,Somalia,2017,SOM-17/3485/SA2/Nut/NGO/7497,2/12/2019 10:28:45 AM,Children under 5,0,0,3500,3700,7200,0,0,3500,3700,7200
21,Somalia,2017,SOM-17/3485/SA2/Nut/NGO/7497,2/12/2019 10:28:45 AM,Overall,12,1513,3500,3700,8725,12,1513,3500,3700,8725
21,Somalia,2017,SOM-17/3485/SA2/Nut/NGO/7497,2/12/2019 10:28:45 AM,Pregnant and Lactating Women,0,1500,0,0,1500,0,1500,0,0,1500
21,Somalia,2017,SOM-17/3485/SA2/Nut/NGO/7497,2/12/2019 10:28:45 AM,"Trainers, Promoters, Caretakers, committee members, etc.",12,13,0,0,25,25,0,0,0,25
21,Somalia,2017,SOM-17/3485/SA2/Prot/INGO/7472,3/22/2019 7:14:49 AM,Children under 18,0,0,330,350,680,0,0,366,746,1112
21,Somalia,2017,SOM-17/3485/SA2/Prot/INGO/7472,3/22/2019 7:14:49 AM,Internally Displaced People/Returnees,650,700,850,850,3050,542,2675,293,1730,5240
21,Somalia,2017,SOM-17/3485/SA2/Prot/INGO/7472,3/22/2019 7:14:49 AM,Other,550,550,750,750,2600,550,922,600,810,2882
21,Somalia,2017,SOM-17/3485/SA2/Prot/INGO/7472,3/22/2019 7:14:49 AM,Overall,1268,1314,1930,1950,6462,1242,3697,1159,3286,9384
21,Somalia,2017,SOM-17/3485/SA2/Prot/INGO/7472,3/22/2019 7:14:49 AM,"Staff (own or partner staff, authorities)",68,64,0,0,132,68,64,0,0,132
21,Somalia,2017,SOM-17/3485/SA2/Prot-Shelter-CCCM/NGO/7549,8/27/2018 9:49:20 AM,Internally Displaced People,1072,1265,726,1109,4172,867,1897,1604,1500,5868
21,Somalia,2017,SOM-17/3485/SA2/Prot-Shelter-CCCM/NGO/7549,8/27/2018 9:49:20 AM,Overall,1377,1968,1557,2278,7180,1076,2489,1861,1790,7216
21,Somalia,2017,SOM-17/3485/SA2/Prot-Shelter-CCCM/NGO/7549,8/27/2018 9:49:20 AM,People in Host Communities,305,703,831,1169,3008,245,533,275,295,1348
21,Somalia,2017,SOM-17/3485/SA2/Shelter/INGO/7587,2/27/2019 8:43:31 AM,Internally Displaced People,1152,1152,2688,2688,7680,1457,1606,3020,2436,8519
21,Somalia,2017,SOM-17/3485/SA2/Shelter/INGO/7587,2/27/2019 8:43:31 AM,Overall,1440,1440,3360,3360,9600,1821,2007,3775,3045,10648
21,Somalia,2017,SOM-17/3485/SA2/Shelter/INGO/7587,2/27/2019 8:43:31 AM,People in Host Communities,288,288,672,672,1920,364,401,755,609,2129
21,Somalia,2017,SOM-17/3485/SA2/Shelter-CCCM-FSC/NGO/7575,8/15/2018 8:25:14 AM,Internally Displaced People,2880,3880,1920,2880,11560,583,4977,389,4450,10399
21,Somalia,2017,SOM-17/3485/SA2/Shelter-CCCM-FSC/NGO/7575,8/15/2018 8:25:14 AM,Overall,2880,4320,1920,2880,12000,583,6658,389,4450,12080
21,Somalia,2017,SOM-17/3485/SA2/Shelter-CCCM-FSC/NGO/7575,8/15/2018 8:25:14 AM,Pregnant and Lactating Women,0,432,0,0,432,0,1681,0,0,1681
21,Somalia,2017,SOM-17/3485/SA2/Shelter-CCCM-Prot/NGO/7553,7/31/2018 1:27:31 PM,Internally Displaced People,4500,6000,2250,2250,15000,4500,6000,2250,2250,15000
21,Somalia,2017,SOM-17/3485/SA2/Shelter-CCCM-Prot/NGO/7553,7/31/2018 1:27:31 PM,Overall,4500,6000,2250,2250,15000,4500,6000,2250,2250,15000
21,Somalia,2017,SOM-17/3485/SA2/Shelter-Prot-CCCM/NGO/7590,9/4/2018 11:15:25 AM,Children under 18,0,0,220,300,520,0,0,220,300,520
21,Somalia,2017,SOM-17/3485/SA2/Shelter-Prot-CCCM/NGO/7590,9/4/2018 11:15:25 AM,Internally Displaced People,780,1200,431,424,2835,780,1200,431,424,2835
21,Somalia,2017,SOM-17/3485/SA2/Shelter-Prot-CCCM/NGO/7590,9/4/2018 11:15:25 AM,Overall,825,1320,801,954,3900,825,1320,801,954,3900
21,Somalia,2017,SOM-17/3485/SA2/Shelter-Prot-CCCM/NGO/7590,9/4/2018 11:15:25 AM,People in Host Communities,45,120,150,230,545,45,120,150,230,545
21,Somalia,2017,SOM-17/3485/SA2/WASH/INGO/7407,4/3/2019 10:16:54 AM,Internally Displaced People,3105,3726,3105,2484,12420,3664,4194,3570,2856,14284
21,Somalia,2017,SOM-17/3485/SA2/WASH/INGO/7407,4/3/2019 10:16:54 AM,Overall,3664,4194,3570,2856,14284,3664,4194,3570,2856,14284
21,Somalia,2017,SOM-17/3485/SA2/WASH/INGO/7407,4/3/2019 10:16:54 AM,People in Host Communities,559,468,465,372,1864,0,0,0,0,0
21,Somalia,2017,SOM-17/3485/SA2/WASH/INGO/7512,8/31/2018 4:59:45 AM,Internally Displaced People/Returnees,981,2305,267,1247,4800,981,2305,267,1247,4800
21,Somalia,2017,SOM-17/3485/SA2/WASH/INGO/7512,8/31/2018 4:59:45 AM,Overall,1234,7460,1106,2200,12000,1234,7460,1106,2200,12000
21,Somalia,2017,SOM-17/3485/SA2/WASH/INGO/7512,8/31/2018 4:59:45 AM,People in Host Communities,253,5155,839,953,7200,253,5155,839,953,7200
21,Somalia,2017,SOM-17/3485/SA2/WASH-Nut-H/NGO/7476,7/18/2019 7:18:28 AM,Internally Displaced People,3323,2810,4353,5804,16290,3553,4990,5335,5124,19002
21,Somalia,2017,SOM-17/3485/SA2/WASH-Nut-H/NGO/7476,7/18/2019 7:18:28 AM,Overall,3446,4535,4353,5804,18138,3679,6681,4835,5124,20319
21,Somalia,2017,SOM-17/3485/SA2/WASH-Nut-H/NGO/7476,7/18/2019 7:18:28 AM,Pregnant and Lactating Women,0,1632,0,0,1632,0,2101,0,0,2101
21,Somalia,2017,SOM-17/3485/SA2/WASH-Nut-H/NGO/7476,7/18/2019 7:18:28 AM,"Staff (own or partner staff, authorities)",33,33,0,0,66,36,30,0,0,66
21,Somalia,2017,SOM-17/3485/SA2/WASH-Nut-H/NGO/7476,7/18/2019 7:18:28 AM,"Trainers, Promoters, Caretakers, committee members, etc.",90,60,0,0,150,90,60,0,0,150
21,Somalia,2018,SOM-18/3485/RA1/Ed-Prot/INGO/9224,4/4/2019 6:07:38 AM,Children under 18,0,0,3200,2029,5229,0,0,2176,1352,3528
21,Somalia,2018,SOM-18/3485/RA1/Ed-Prot/INGO/9224,4/4/2019 6:07:38 AM,Overall,70,50,3200,2029,5349,70,50,2176,1352,3648
21,Somalia,2018,SOM-18/3485/RA1/Ed-Prot/INGO/9224,4/4/2019 6:07:38 AM,"Staff (own or partner staff, authorities)",70,50,0,0,120,90,30,0,0,120
21,Somalia,2018,SOM-18/3485/RA1/Ed-Prot/NGO/9216,3/6/2019 6:09:30 AM,Children under 18,0,0,4884,4980,9864,0,0,3053,2097,5150
21,Somalia,2018,SOM-18/3485/RA1/Ed-Prot/NGO/9216,3/6/2019 6:09:30 AM,Internally Displaced People,1458,2274,0,0,3732,2662,4676,5964,5866,19168
21,Somalia,2018,SOM-18/3485/RA1/Ed-Prot/NGO/9216,3/6/2019 6:09:30 AM,Overall,1525,2327,4884,4980,13716,2730,4698,9017,7963,24408
21,Somalia,2018,SOM-18/3485/RA1/Ed-Prot/NGO/9216,3/6/2019 6:09:30 AM,"Trainers, Promoters, Caretakers, committee members, etc.",67,53,0,0,120,68,22,0,0,90
21,Somalia,2018,SOM-18/3485/RA1/Ed-Prot/NGO/9221,3/7/2019 8:10:15 AM,Children under 18,0,0,1800,1400,3200,0,0,692,607,1299
21,Somalia,2018,SOM-18/3485/RA1/Ed-Prot/NGO/9221,3/7/2019 8:10:15 AM,Overall,1083,1285,1800,1400,5568,1173,3010,1397,1417,6997
21,Somalia,2018,SOM-18/3485/RA1/Ed-Prot/NGO/9221,3/7/2019 8:10:15 AM,"Trainers, Promoters, Caretakers, committee members, etc.",1083,1285,0,0,2368,55,55,0,0,110
21,Somalia,2018,SOM-18/3485/RA1/H-Ed-Nut-WASH/INGO/9502,9/11/2019 12:50:29 PM,Internally Displaced People,6938,7598,8920,9581,33037,8420,9222,10825,11627,40094
21,Somalia,2018,SOM-18/3485/RA1/H-Ed-Nut-WASH/INGO/9502,9/11/2019 12:50:29 PM,Other,0,0,0,0,0,6556,7182,8431,9054,31223
21,Somalia,2018,SOM-18/3485/RA1/H-Ed-Nut-WASH/INGO/9502,9/11/2019 12:50:29 PM,Overall,27750,30393,35679,38322,132144,29337,32131,37719,40513,139700
21,Somalia,2018,SOM-18/3485/RA1/H-Ed-Nut-WASH/INGO/9502,9/11/2019 12:50:29 PM,Urban Poor,12488,13677,16056,1745,43966,16251,17797,20893,22442,77383
21,Somalia,2018,SOM-18/3485/RA1/Prot/NGO/9214,3/6/2019 11:24:27 AM,Children under 18,0,0,3584,3256,6840,0,0,4226,3594,7820
21,Somalia,2018,SOM-18/3485/RA1/Prot/NGO/9214,3/6/2019 11:24:27 AM,Other,424,676,0,0,1100,132,459,0,0,591
21,Somalia,2018,SOM-18/3485/RA1/Prot/NGO/9214,3/6/2019 11:24:27 AM,Overall,424,676,3584,3256,7940,132,459,4226,3594,8411
21,Somalia,2018,SOM-18/3485/RA2018/FSC/NGO/9579,7/8/2019 11:53:36 AM,Agro-Pastoralists,137,187,180,216,720,66,14,84,16,180
21,Somalia,2018,SOM-18/3485/RA2018/FSC/NGO/9579,7/8/2019 11:53:36 AM,Other,83,114,110,131,438,144,48,183,57,432
21,Somalia,2018,SOM-18/3485/RA2018/FSC/NGO/9579,7/8/2019 11:53:36 AM,Overall,933,1276,1227,1472,4908,683,1293,868,1518,4362
21,Somalia,2018,SOM-18/3485/RA2018/FSC/NGO/9579,7/8/2019 11:53:36 AM,Pastoralists,713,957,937,1125,3732,564,1336,717,1568,4185
21,Somalia,2018,SOM-18/3485/RA2018/FSC/NGO/9580,4/4/2019 5:59:13 AM,Agro-Pastoralists,1116,1336,1268,1438,5158,0,0,0,0,0
21,Somalia,2018,SOM-18/3485/RA2018/FSC/NGO/9580,4/4/2019 5:59:13 AM,Overall,2231,2636,2535,2738,10140,2231,2636,2535,2738,10140
21,Somalia,2018,SOM-18/3485/RA2018/FSC/NGO/9580,4/4/2019 5:59:13 AM,Pastoralists,1115,1300,1267,1300,4982,0,0,0,0,0
21,Somalia,2018,SOM-18/3485/RA2018/H-Nut-WASH/INGO/9578,9/17/2019 6:44:07 AM,Children under 5,0,0,5839,5839,11678,0,0,6493,6089,12582
21,Somalia,2018,SOM-18/3485/RA2018/H-Nut-WASH/INGO/9578,9/17/2019 6:44:07 AM,Overall,9379,10077,5839,5839,31134,10684,16647,6493,6089,39913
21,Somalia,2018,SOM-18/3485/RA2018/H-Nut-WASH/INGO/9578,9/17/2019 6:44:07 AM,People in HE and/or AFLC,9359,9311,0,0,18670,0,0,0,0,0
21,Somalia,2018,SOM-18/3485/RA2018/H-Nut-WASH/INGO/9578,9/17/2019 6:44:07 AM,Pregnant and Lactating Women,0,746,0,0,746,0,5664,0,0,5664
21,Somalia,2018,SOM-18/3485/RA2018/H-Nut-WASH/INGO/9578,9/17/2019 6:44:07 AM,"Trainers, Promoters, Caretakers, committee members, etc.",20,20,0,0,40,10684,10983,0,0,21667
21,Somalia,2018,SOM-18/3485/RA2018/Shelter-Prot/NGO/9590,6/6/2019 9:06:40 AM,Agro-Pastoralists,630,1060,880,1023,3593,0,0,0,0,0
21,Somalia,2018,SOM-18/3485/RA2018/Shelter-Prot/NGO/9590,6/6/2019 9:06:40 AM,Internally Displaced People,550,1140,1148,1136,3974,1500,2262,1152,1445,6359
21,Somalia,2018,SOM-18/3485/RA2018/Shelter-Prot/NGO/9590,6/6/2019 9:06:40 AM,Overall,1827,3350,3273,3606,12056,1500,2259,1150,1450,6359
21,Somalia,2018,SOM-18/3485/RA2018/Shelter-Prot/NGO/9590,6/6/2019 9:06:40 AM,Pastoralists,647,1150,1245,1447,4489,0,0,0,0,0
21,Somalia,2018,SOM-18/3485/RA3/CCCM-Prot/INGO/10140,1/26/2020 11:05:34 AM,Internally Displaced People,2613,2830,2889,3007,11339,5450,6035,4720,3450,19655
21,Somalia,2018,SOM-18/3485/RA3/CCCM-Prot/INGO/10140,1/26/2020 11:05:34 AM,Overall,4355,4717,4816,5012,18900,5450,6035,4720,3450,19655
21,Somalia,2018,SOM-18/3485/RA3/CCCM-Prot/INGO/10140,1/26/2020 11:05:34 AM,People in Host Communities,1742,1887,1926,2005,7560,0,0,0,0,0
21,Somalia,2018,SOM-18/3485/RA3/CCCM-Shelter-WASH/INGO/10162,1/28/2020 12:00:17 PM,Internally Displaced People,2408,3131,3371,3131,12041,7599,11399,3419,5129,27546
21,Somalia,2018,SOM-18/3485/RA3/CCCM-Shelter-WASH/INGO/10162,1/28/2020 12:00:17 PM,Overall,2676,3479,3746,3479,13380,7599,11399,3419,5129,27546
21,Somalia,2018,SOM-18/3485/RA3/CCCM-Shelter-WASH/INGO/10162,1/28/2020 12:00:17 PM,People in Host Communities,268,348,375,348,1339,0,0,0,0,0
21,Somalia,2018,SOM-18/3485/RA3/Ed-Prot-WASH/NGO/10145,1/23/2020 5:51:34 AM,Internally Displaced People/Returnees,1784,4918,4607,4800,16109,1634,4887,4540,4602,15663
21,Somalia,2018,SOM-18/3485/RA3/Ed-Prot-WASH/NGO/10145,1/23/2020 5:51:34 AM,Overall,3020,7975,7256,7488,25739,2846,7769,7145,7276,25036
21,Somalia,2018,SOM-18/3485/RA3/Ed-Prot-WASH/NGO/10145,1/23/2020 5:51:34 AM,People in Host Communities,1061,2882,2619,2658,9220,1111,2792,2521,2591,9015
21,Somalia,2018,SOM-18/3485/RA3/Ed-Prot-WASH/NGO/10145,1/23/2020 5:51:34 AM,"Staff (own or partner staff, authorities)",20,20,0,0,40,8,7,0,0,15
21,Somalia,2018,SOM-18/3485/RA3/Ed-Prot-WASH/NGO/10145,1/23/2020 5:51:34 AM,"Trainers, Promoters, Caretakers, committee members, etc.",155,155,30,30,370,93,83,84,83,343
21,Somalia,2018,SOM-18/3485/RA3/Ed-WASH-Prot/INGO/10089,9/11/2019 7:43:50 AM,Children under 18,0,0,2165,1617,3782,0,0,2461,1893,4354
21,Somalia,2018,SOM-18/3485/RA3/Ed-WASH-Prot/INGO/10089,9/11/2019 7:43:50 AM,Committees,18,18,0,0,36,0,0,0,0,0
21,Somalia,2018,SOM-18/3485/RA3/Ed-WASH-Prot/INGO/10089,9/11/2019 7:43:50 AM,Other,3240,2160,0,0,5400,3590,2396,0,0,5986
21,Somalia,2018,SOM-18/3485/RA3/Ed-WASH-Prot/INGO/10089,9/11/2019 7:43:50 AM,Overall,3324,2184,2165,1617,9290,3590,2396,2461,1893,10340
21,Somalia,2018,SOM-18/3485/RA3/Ed-WASH-Prot/INGO/10089,9/11/2019 7:43:50 AM,"Trainers, Promoters, Caretakers, committee members, etc.",36,0,0,0,36,0,0,0,0,0
21,Somalia,2018,SOM-18/3485/RA3/FSC/INGO/10011,11/19/2019 9:13:53 AM,Internally Displaced People,60,75,135,30,300,446,406,420,357,1629
21,Somalia,2018,SOM-18/3485/RA3/FSC/INGO/10011,11/19/2019 9:13:53 AM,Overall,300,375,675,150,1500,446,406,420,357,1629
21,Somalia,2018,SOM-18/3485/RA3/FSC/INGO/10011,11/19/2019 9:13:53 AM,Urban Poor,240,300,540,120,1200,0,0,0,0,0
21,Somalia,2018,SOM-18/3485/RA3/FSC/NGO/9998,5/29/2019 5:34:36 AM,Internally Displaced People/Returnees,50,90,0,0,140,197,290,232,257,976
21,Somalia,2018,SOM-18/3485/RA3/FSC/NGO/9998,5/29/2019 5:34:36 AM,Overall,104,180,0,0,284,104,180,0,0,284
21,Somalia,2018,SOM-18/3485/RA3/FSC/NGO/9998,5/29/2019 5:34:36 AM,Pastoralists,54,90,0,0,144,234,271,178,181,864
21,Somalia,2018,SOM-18/3485/RA3/FSC/O/9973,5/23/2019 5:47:55 AM,Internally Displaced People,54,162,72,72,360,90,270,120,120,600
21,Somalia,2018,SOM-18/3485/RA3/FSC/O/9973,5/23/2019 5:47:55 AM,Overall,180,540,240,240,1200,180,540,240,240,1200
21,Somalia,2018,SOM-18/3485/RA3/FSC/O/9973,5/23/2019 5:47:55 AM,Urban Poor,126,378,168,168,840,90,270,120,120,600
21,Somalia,2018,SOM-18/3485/RA3/FSC-Nut/INGO/10125,7/22/2020 12:37:58 PM,Internally Displaced People,50,200,350,450,1050,38,60,141,105,344
21,Somalia,2018,SOM-18/3485/RA3/FSC-Nut/INGO/10125,7/22/2020 12:37:58 PM,Overall,100,300,500,600,1500,248,313,668,565,1794
21,Somalia,2018,SOM-18/3485/RA3/FSC-Nut/INGO/10125,7/22/2020 12:37:58 PM,Pastoralists,50,100,150,150,450,210,253,527,460,1450
21,Somalia,2018,SOM-18/3485/RA3/H-Nut-WASH/INGO/9912,9/10/2019 1:22:03 PM,Children under 5,0,0,1768,1768,3536,0,0,7042,6452,13494
21,Somalia,2018,SOM-18/3485/RA3/H-Nut-WASH/INGO/9912,9/10/2019 1:22:03 PM,Internally Displaced People,522,801,940,1218,3481,0,0,0,0,0
21,Somalia,2018,SOM-18/3485/RA3/H-Nut-WASH/INGO/9912,9/10/2019 1:22:03 PM,Overall,4623,8613,10006,12446,35688,10538,33651,18400,21527,84116
21,Somalia,2018,SOM-18/3485/RA3/H-Nut-WASH/INGO/9912,9/10/2019 1:22:03 PM,People in Host Communities,4055,6217,7298,9460,27030,10507,33520,11358,15075,70460
21,Somalia,2018,SOM-18/3485/RA3/H-Nut-WASH/INGO/9912,9/10/2019 1:22:03 PM,"Trainers, Promoters, Caretakers, committee members, etc.",46,1595,0,0,1641,31,131,0,0,162
21,Somalia,2018,SOM-18/3485/RA3/Nut-H-WASH/INGO/9974,9/5/2019 11:10:55 AM,Children under 5,0,0,17265,17265,34530,0,0,12055,12885,24940
21,Somalia,2018,SOM-18/3485/RA3/Nut-H-WASH/INGO/9974,9/5/2019 11:10:55 AM,Other,1481,0,0,0,1481,990,0,0,0,990
21,Somalia,2018,SOM-18/3485/RA3/Nut-H-WASH/INGO/9974,9/5/2019 11:10:55 AM,Overall,1481,32360,17265,17265,68371,990,23461,12055,12885,49391
21,Somalia,2018,SOM-18/3485/RA3/Nut-H-WASH/INGO/9974,9/5/2019 11:10:55 AM,Pregnant and Lactating Women,0,6500,0,0,6500,0,0,0,0,0
21,Somalia,2018,SOM-18/3485/RA3/Nut-H-WASH/INGO/9974,9/5/2019 11:10:55 AM,Women of Child-Bearing Age,0,25860,0,0,25860,0,23461,0,0,23461
21,Somalia,2018,SOM-18/3485/RA3/Nut-H-WASH/NGO/9985,8/30/2019 7:28:09 AM,Agro-Pastoralists,10710,8974,0,0,19684,16585,13990,0,0,30575
21,Somalia,2018,SOM-18/3485/RA3/Nut-H-WASH/NGO/9985,8/30/2019 7:28:09 AM,Children under 5,0,0,5716,5750,11466,0,0,9536,9947,19483
21,Somalia,2018,SOM-18/3485/RA3/Nut-H-WASH/NGO/9985,8/30/2019 7:28:09 AM,Internally Displaced People,2950,3200,7500,7370,21020,5043,5327,11561,11605,33536
21,Somalia,2018,SOM-18/3485/RA3/Nut-H-WASH/NGO/9985,8/30/2019 7:28:09 AM,Overall,13660,17334,13216,13120,57330,14217,18169,13855,14169,60410
21,Somalia,2018,SOM-18/3485/RA3/Nut-H-WASH/NGO/9985,8/30/2019 7:28:09 AM,Pregnant and Lactating Women,0,5160,0,0,5160,0,8474,0,0,8474
21,Somalia,2018,SOM-18/3485/RA3/Prot/NGO/10154,1/28/2020 6:26:11 PM,Internally Displaced People/Returnees,2676,3479,3746,3479,13380,2676,3479,3746,3479,13380
21,Somalia,2018,SOM-18/3485/RA3/Prot/NGO/10154,1/28/2020 6:26:11 PM,Overall,2676,3479,3746,3479,13380,2676,3479,3746,3479,13380
21,Somalia,2018,SOM-18/3485/RA3/Shelter-WASH/INGO/10139,1/26/2020 11:14:02 AM,Internally Displaced People,11312,11312,4848,4848,32320,33264,33264,14256,14256,95040
21,Somalia,2018,SOM-18/3485/RA3/Shelter-WASH/INGO/10139,1/26/2020 11:14:02 AM,Overall,14140,14140,6060,6060,40400,41580,41580,17820,17820,118800
21,Somalia,2018,SOM-18/3485/RA3/Shelter-WASH/INGO/10139,1/26/2020 11:14:02 AM,People in Host Communities,2828,2828,1212,1212,8080,8316,8316,3564,3564,23760
21,Somalia,2018,SOM-18/3485/RA3/WASH/INGO/10126,10/13/2020 8:02:14 AM,Agro-Pastoralists,3000,8000,4000,4500,19500,3000,8000,4000,4500,19500
21,Somalia,2018,SOM-18/3485/RA3/WASH/INGO/10126,10/13/2020 8:02:14 AM,Internally Displaced People/Returnees,500,2000,1000,1000,4500,500,2000,1000,1000,4500
21,Somalia,2018,SOM-18/3485/RA3/WASH/INGO/10126,10/13/2020 8:02:14 AM,Overall,3500,10000,5000,5500,24000,3500,10000,5000,5500,24000
21,Somalia,2018,SOM-18/3485/RA3/WASH/INGO/10143,7/8/2020 12:43:06 PM,Internally Displaced People,420,630,780,1170,3000,267,271,387,359,1284
21,Somalia,2018,SOM-18/3485/RA3/WASH/INGO/10143,7/8/2020 12:43:06 PM,Overall,2300,3450,4271,6406,16427,2300,3450,4271,6407,16428
21,Somalia,2018,SOM-18/3485/RA3/WASH/INGO/10143,7/8/2020 12:43:06 PM,People in Host Communities,1880,2820,3491,5236,13427,2033,3179,3884,6048,15144
21,Somalia,2018,SOM-18/3485/RA4/Shelter/INGO/10956,7/18/2019 9:10:02 AM,Internally Displaced People,6750,7300,8250,8950,31250,12837,14286,8450,7915,43488
21,Somalia,2018,SOM-18/3485/RA4/Shelter/INGO/10956,7/18/2019 9:10:02 AM,Overall,6954,7676,8558,9212,32400,12837,14286,8450,7915,43488
21,Somalia,2018,SOM-18/3485/RA4/Shelter/INGO/10956,7/18/2019 9:10:02 AM,People from Riverine Communities,204,376,308,262,1150,0,0,0,0,0
21,Somalia,2018,SOM-18/3485/RA4/Shelter/NGO/10955,7/18/2019 8:52:44 AM,Internally Displaced People/Returnees,7920,10560,3960,3960,26400,7920,10560,3960,3960,26400
21,Somalia,2018,SOM-18/3485/RA4/Shelter/NGO/10955,7/18/2019 8:52:44 AM,Overall,9900,13200,4950,4950,33000,9900,13200,4950,4950,33000
21,Somalia,2018,SOM-18/3485/RA4/Shelter/NGO/10955,7/18/2019 8:52:44 AM,People in Host Communities,1980,2640,990,990,6600,1980,2640,990,990,6600
21,Somalia,2018,SOM-18/3485/SA1/CCCM/INGO/8629,7/3/2019 8:49:15 AM,Internally Displaced People,12170,12367,9958,10118,44613,12265,12519,9985,10260,45029
21,Somalia,2018,SOM-18/3485/SA1/CCCM/INGO/8629,7/3/2019 8:49:15 AM,Overall,12811,13018,10482,10650,46961,12911,13178,10511,10800,47400
21,Somalia,2018,SOM-18/3485/SA1/CCCM/INGO/8629,7/3/2019 8:49:15 AM,People in Host Communities,641,651,524,532,2348,646,659,526,540,2371
21,Somalia,2018,SOM-18/3485/SA1/CCCM/INGO/8673,7/3/2019 8:48:28 AM,Internally Displaced People,5956,6452,6716,7276,26400,0,0,0,0,0
21,Somalia,2018,SOM-18/3485/SA1/CCCM/INGO/8673,7/3/2019 8:48:28 AM,Overall,7445,8065,8395,9095,33000,4245,6843,10815,13487,35390
21,Somalia,2018,SOM-18/3485/SA1/CCCM/INGO/8673,7/3/2019 8:48:28 AM,People in Host Communities,1489,1613,1679,1819,6600,0,0,0,0,0
21,Somalia,2018,SOM-18/3485/SA1/CCCM-Prot-WASH-Shelter/INGO/8505,7/18/2019 8:40:56 AM,Internally Displaced People,8663,9385,9769,10583,38400,7343,8254,8684,10074,34355
21,Somalia,2018,SOM-18/3485/SA1/CCCM-Prot-WASH-Shelter/INGO/8505,7/18/2019 8:40:56 AM,Overall,10829,11731,12211,13229,48000,7343,8254,8684,10074,34355
21,Somalia,2018,SOM-18/3485/SA1/CCCM-Prot-WASH-Shelter/INGO/8505,7/18/2019 8:40:56 AM,People in Host Communities,2166,2346,2442,2646,9600,0,0,0,0,0
21,Somalia,2018,SOM-18/3485/SA1/CCCM-WASH-Shelter/INGO/8671,6/16/2019 5:33:41 AM,Internally Displaced People,5400,7020,7560,7020,27000,10800,14040,15120,14040,54000
21,Somalia,2018,SOM-18/3485/SA1/CCCM-WASH-Shelter/INGO/8671,6/16/2019 5:33:41 AM,Overall,5400,7020,7560,7020,27000,10800,14040,15120,14040,54000
21,Somalia,2018,SOM-18/3485/SA1/Ed/INGO/8512,7/4/2019 6:11:27 AM,Children under 18,0,0,1192,765,1957,0,0,0,0,0
21,Somalia,2018,SOM-18/3485/SA1/Ed/INGO/8512,7/4/2019 6:11:27 AM,Overall,34,27,1192,765,2018,34,27,1192,765,2018
21,Somalia,2018,SOM-18/3485/SA1/Ed/INGO/8512,7/4/2019 6:11:27 AM,"Trainers, Promoters, Caretakers, committee members, etc.",34,27,0,0,61,0,0,0,0,0
21,Somalia,2018,SOM-18/3485/SA1/Ed/INGO/8577,5/17/2019 6:52:19 AM,Children under 18,0,0,1450,855,2305,0,0,0,0,0
21,Somalia,2018,SOM-18/3485/SA1/Ed/INGO/8577,5/17/2019 6:52:19 AM,Committees,10,5,0,0,15,0,0,0,0,0
21,Somalia,2018,SOM-18/3485/SA1/Ed/INGO/8577,5/17/2019 6:52:19 AM,Other,65,3,0,0,68,0,0,0,0,0
21,Somalia,2018,SOM-18/3485/SA1/Ed/INGO/8577,5/17/2019 6:52:19 AM,Overall,90,8,1450,855,2403,90,8,1900,1085,3083
21,Somalia,2018,SOM-18/3485/SA1/Ed/INGO/8577,5/17/2019 6:52:19 AM,"Trainers, Promoters, Caretakers, committee members, etc.",15,0,0,0,15,0,0,0,0,0
21,Somalia,2018,SOM-18/3485/SA1/Ed/INGO/8625,1/23/2020 4:21:19 AM,Agro-Pastoralists,120,40,2100,1400,3660,152,47,2714,1737,4650
21,Somalia,2018,SOM-18/3485/SA1/Ed/INGO/8625,1/23/2020 4:21:19 AM,Internally Displaced People,38,13,300,200,551,6,6,86,66,164
21,Somalia,2018,SOM-18/3485/SA1/Ed/INGO/8625,1/23/2020 4:21:19 AM,Overall,158,53,2803,1800,4814,158,53,2803,1800,4814
21,Somalia,2018,SOM-18/3485/SA1/Ed/NGO/8641,9/11/2019 12:42:30 PM,Children under 18,0,0,1800,1200,3000,0,0,1784,1447,3231
21,Somalia,2018,SOM-18/3485/SA1/Ed/NGO/8641,9/11/2019 12:42:30 PM,Committees,32,31,0,0,63,71,41,0,0,112
21,Somalia,2018,SOM-18/3485/SA1/Ed/NGO/8641,9/11/2019 12:42:30 PM,Overall,71,41,1800,1200,3112,71,41,1784,1447,3343
21,Somalia,2018,SOM-18/3485/SA1/Ed/NGO/8641,9/11/2019 12:42:30 PM,"Staff (own or partner staff, authorities)",39,10,0,0,49,0,0,0,0,0
21,Somalia,2018,SOM-18/3485/SA1/Ed/NGO/8703,7/8/2019 10:30:31 AM,Children under 18,0,0,0,0,0,0,0,839,719,1558
21,Somalia,2018,SOM-18/3485/SA1/Ed/NGO/8703,7/8/2019 10:30:31 AM,Internally Displaced People/Returnees,9,10,400,400,819,0,0,524,543,1067
21,Somalia,2018,SOM-18/3485/SA1/Ed/NGO/8703,7/8/2019 10:30:31 AM,Overall,37,22,600,500,1159,42,17,839,719,1617
21,Somalia,2018,SOM-18/3485/SA1/Ed/NGO/8703,7/8/2019 10:30:31 AM,People in Host Communities,28,12,200,100,340,43,16,315,176,550
21,Somalia,2018,SOM-18/3485/SA1/FSC/INGO/8465,5/16/2019 1:17:35 PM,Children under 18,0,0,1742,1806,3548,0,0,1848,1917,3765
21,Somalia,2018,SOM-18/3485/SA1/FSC/INGO/8465,5/16/2019 1:17:35 PM,Overall,1096,1806,1742,1806,6450,1164,1917,1849,1917,6847
21,Somalia,2018,SOM-18/3485/SA1/FSC/INGO/8465,5/16/2019 1:17:35 PM,Pastoralists,1096,1806,0,0,2902,1165,1917,0,0,3082
21,Somalia,2018,SOM-18/3485/SA1/FSC/INGO/8529,3/29/2019 6:53:01 AM,Children under 5,0,0,0,0,0,0,0,1686,1614,3300
21,Somalia,2018,SOM-18/3485/SA1/FSC/INGO/8529,3/29/2019 6:53:01 AM,Internally Displaced People/Returnees,1230,1107,1637,1590,5564,1498,1250,2658,2339,7745
21,Somalia,2018,SOM-18/3485/SA1/FSC/INGO/8529,3/29/2019 6:53:01 AM,Overall,1758,1581,2339,2272,7950,2047,1659,3548,3133,10387
21,Somalia,2018,SOM-18/3485/SA1/FSC/INGO/8529,3/29/2019 6:53:01 AM,People in Host Communities,527,474,702,682,2385,549,409,890,794,2642
21,Somalia,2018,SOM-18/3485/SA1/FSC/INGO/8529,3/29/2019 6:53:01 AM,Pregnant and Lactating Women,0,0,0,0,0,0,571,0,0,571
21,Somalia,2018,SOM-18/3485/SA1/FSC/INGO/8612,3/4/2019 11:34:23 AM,Agro-Pastoralists,0,0,0,0,0,249,245,431,440,1365
21,Somalia,2018,SOM-18/3485/SA1/FSC/INGO/8612,3/4/2019 11:34:23 AM,Internally Displaced People,779,1025,1153,1324,4281,643,819,1233,1361,4056
21,Somalia,2018,SOM-18/3485/SA1/FSC/INGO/8612,3/4/2019 11:34:23 AM,Overall,2412,2773,4305,4182,13672,2362,2657,4545,4366,13930
21,Somalia,2018,SOM-18/3485/SA1/FSC/INGO/8612,3/4/2019 11:34:23 AM,Pastoralists,0,0,0,0,0,637,642,1106,1034,3419
21,Somalia,2018,SOM-18/3485/SA1/FSC/INGO/8612,3/4/2019 11:34:23 AM,Urban Poor,0,0,0,0,0,833,951,1775,1531,5090
21,Somalia,2018,SOM-18/3485/SA1/FSC/INGO/8618,3/14/2019 5:42:40 AM,Internally Displaced People,75,150,50,63,338,115,155,0,0,270
21,Somalia,2018,SOM-18/3485/SA1/FSC/INGO/8618,3/14/2019 5:42:40 AM,Overall,150,300,100,126,676,290,386,0,0,676
21,Somalia,2018,SOM-18/3485/SA1/FSC/INGO/8618,3/14/2019 5:42:40 AM,Pastoralists,75,150,50,63,338,164,242,0,0,406
21,Somalia,2018,SOM-18/3485/SA1/FSC/NGO/8596,5/21/2019 9:34:25 AM,Agro-Pastoralists,419,473,176,188,1256,266,357,463,555,1641
21,Somalia,2018,SOM-18/3485/SA1/FSC/NGO/8596,5/21/2019 9:34:25 AM,Internally Displaced People/Returnees,540,563,250,310,1663,257,352,453,503,1565
21,Somalia,2018,SOM-18/3485/SA1/FSC/NGO/8596,5/21/2019 9:34:25 AM,Overall,1259,1389,576,658,3882,752,1013,1398,1505,4668
21,Somalia,2018,SOM-18/3485/SA1/FSC/NGO/8596,5/21/2019 9:34:25 AM,People in Host Communities,300,353,150,160,963,229,304,482,447,1462
21,Somalia,2018,SOM-18/3485/SA1/FSC/NGO/8694,2/11/2019 8:42:55 AM,Internally Displaced People,702,810,540,658,2710,871,1006,672,806,3355
21,Somalia,2018,SOM-18/3485/SA1/FSC/NGO/8694,2/11/2019 8:42:55 AM,Overall,1962,2264,1510,1812,7548,2423,2795,1864,2237,9319
21,Somalia,2018,SOM-18/3485/SA1/FSC/NGO/8694,2/11/2019 8:42:55 AM,Pastoralists,636,734,490,578,2438,1211,1397,934,1117,4659
21,Somalia,2018,SOM-18/3485/SA1/FSC/NGO/8694,2/11/2019 8:42:55 AM,People in HE and/or AFLC,624,720,480,576,2400,343,392,260,315,1310
21,Somalia,2018,SOM-18/3485/SA1/FSC-H-Nut-WASH-Ed/NGO/8496,8/30/2019 6:17:23 AM,Internally Displaced People,7128,7524,2376,2772,19800,7128,7524,2376,2772,19800
21,Somalia,2018,SOM-18/3485/SA1/FSC-H-Nut-WASH-Ed/NGO/8496,8/30/2019 6:17:23 AM,Overall,7128,7524,2376,2772,19800,7128,7524,2376,2772,19800
21,Somalia,2018,SOM-18/3485/SA1/FSC-Nut-H-Ed-WASH/NGO/8624,2/4/2019 12:21:13 PM,Children under 18,0,0,6000,6000,12000,0,0,3600,3370,6970
21,Somalia,2018,SOM-18/3485/SA1/FSC-Nut-H-Ed-WASH/NGO/8624,2/4/2019 12:21:13 PM,Internally Displaced People,3200,4900,400,900,9400,3400,4600,2880,3690,14570
21,Somalia,2018,SOM-18/3485/SA1/FSC-Nut-H-Ed-WASH/NGO/8624,2/4/2019 12:21:13 PM,Overall,4700,6400,7450,8200,26750,4700,6400,7450,8200,26750
21,Somalia,2018,SOM-18/3485/SA1/FSC-Nut-H-Ed-WASH/NGO/8624,2/4/2019 12:21:13 PM,People in Host Communities,1500,1500,1050,1300,5350,1300,1800,970,1140,5210
21,Somalia,2018,SOM-18/3485/SA1/FSC-WASH-Nut-H-Ed/NGO/8758,10/17/2019 6:56:55 AM,Agro-Pastoralists,6410,6384,1335,1335,15464,7143,6987,1676,2619,18425
21,Somalia,2018,SOM-18/3485/SA1/FSC-WASH-Nut-H-Ed/NGO/8758,10/17/2019 6:56:55 AM,Children under 18,0,0,340,340,680,0,0,1293,857,2150
21,Somalia,2018,SOM-18/3485/SA1/FSC-WASH-Nut-H-Ed/NGO/8758,10/17/2019 6:56:55 AM,Children under 5,0,0,2000,2000,4000,0,0,818,1518,2336
21,Somalia,2018,SOM-18/3485/SA1/FSC-WASH-Nut-H-Ed/NGO/8758,10/17/2019 6:56:55 AM,Overall,6410,9384,3675,3675,23144,7143,14657,3787,4994,30581
21,Somalia,2018,SOM-18/3485/SA1/FSC-WASH-Nut-H-Ed/NGO/8758,10/17/2019 6:56:55 AM,Pregnant and Lactating Women,0,3000,0,0,3000,0,7670,0,0,7670
21,Somalia,2018,SOM-18/3485/SA1/H/INGO/8649,8/15/2019 7:58:25 AM,Agro-Pastoralists,25,5885,4344,4433,14687,9686,25519,13,759,35977
21,Somalia,2018,SOM-18/3485/SA1/H/INGO/8649,8/15/2019 7:58:25 AM,Internally Displaced People/Returnees,25,5885,4344,4432,14686,6267,16787,14,23,23091
21,Somalia,2018,SOM-18/3485/SA1/H/INGO/8649,8/15/2019 7:58:25 AM,Overall,60,11780,8688,8865,29393,63,12842,9428,12598,34931
21,Somalia,2018,SOM-18/3485/SA1/H/INGO/8649,8/15/2019 7:58:25 AM,"Staff (own or partner staff, authorities)",10,10,0,0,20,36,30,0,0,66
21,Somalia,2018,SOM-18/3485/SA1/H/INGO/8654,1/23/2020 5:49:57 AM,Internally Displaced People,2274,2894,2480,2687,10335,738,2195,1214,1397,5544
21,Somalia,2018,SOM-18/3485/SA1/H/INGO/8654,1/23/2020 5:49:57 AM,Overall,24161,30751,26357,28554,109823,14757,44013,24018,27661,110449
21,Somalia,2018,SOM-18/3485/SA1/H/INGO/8654,1/23/2020 5:49:57 AM,People in Host Communities,21887,27857,23877,25867,99488,14019,41818,22804,26264,104905
21,Somalia,2018,SOM-18/3485/SA1/H/NGO/8470,9/19/2019 8:40:51 AM,Agro-Pastoralists,9373,13122,4545,5495,32535,5484,6285,3482,3740,18991
21,Somalia,2018,SOM-18/3485/SA1/H/NGO/8470,9/19/2019 8:40:51 AM,Internally Displaced People,100,100,200,400,800,3988,6963,1274,2161,14386
21,Somalia,2018,SOM-18/3485/SA1/H/NGO/8470,9/19/2019 8:40:51 AM,Overall,9488,13232,4745,5895,33360,9490,13263,4756,5901,33410
21,Somalia,2018,SOM-18/3485/SA1/H/NGO/8470,9/19/2019 8:40:51 AM,"Staff (own or partner staff, authorities)",15,10,0,0,25,18,15,0,0,33
21,Somalia,2018,SOM-18/3485/SA1/H/NGO/8748,9/11/2019 12:27:43 PM,Children under 5,0,0,5920,6691,12611,0,0,5360,5984,11344
21,Somalia,2018,SOM-18/3485/SA1/H/NGO/8748,9/11/2019 12:27:43 PM,Overall,35,20218,5920,6691,32864,35,20162,5360,5984,31541
21,Somalia,2018,SOM-18/3485/SA1/H/NGO/8748,9/11/2019 12:27:43 PM,Pregnant and Lactating Women,0,5675,0,0,5675,0,5497,0,0,5497
21,Somalia,2018,SOM-18/3485/SA1/H/NGO/8748,9/11/2019 12:27:43 PM,"Staff (own or partner staff, authorities)",35,40,0,0,75,35,40,0,0,75
21,Somalia,2018,SOM-18/3485/SA1/H/NGO/8748,9/11/2019 12:27:43 PM,Women of Child-Bearing Age,0,14503,0,0,14503,0,14625,0,0,14625
21,Somalia,2018,SOM-18/3485/SA1/H-Nut/NGO/8738,6/14/2021 1:42:06 PM,Children under 5,0,0,3000,4200,7200,0,0,1500,2100,3600
21,Somalia,2018,SOM-18/3485/SA1/H-Nut/NGO/8738,6/14/2021 1:42:06 PM,Other,1500,0,0,0,1500,600,0,0,0,600
21,Somalia,2018,SOM-18/3485/SA1/H-Nut/NGO/8738,6/14/2021 1:42:06 PM,Overall,1500,3000,3000,4200,11700,600,1500,1500,2100,5700
21,Somalia,2018,SOM-18/3485/SA1/H-Nut/NGO/8738,6/14/2021 1:42:06 PM,Women of Child-Bearing Age,0,3000,0,0,3000,0,1500,0,0,1500
21,Somalia,2018,SOM-18/3485/SA1/H-Nut-WASH/INGO/8628,5/18/2020 10:50:59 AM,Children under 5,0,0,12672,13728,26400,0,0,27308,27393,54701
21,Somalia,2018,SOM-18/3485/SA1/H-Nut-WASH/INGO/8628,5/18/2020 10:50:59 AM,Other,42530,38290,33725,36535,151080,59673,36783,15006,20582,132044
21,Somalia,2018,SOM-18/3485/SA1/H-Nut-WASH/INGO/8628,5/18/2020 10:50:59 AM,Overall,42530,54130,46397,50263,193320,59673,47887,42314,47975,197849
21,Somalia,2018,SOM-18/3485/SA1/H-Nut-WASH/INGO/8628,5/18/2020 10:50:59 AM,Pregnant and Lactating Women,0,15840,0,0,15840,0,11104,0,0,11104
21,Somalia,2018,SOM-18/3485/SA1/H-Nut-WASH/NGO/8493,9/13/2019 6:13:21 AM,Children under 5,0,0,12800,12800,25600,0,0,5491,5407,10898
21,Somalia,2018,SOM-18/3485/SA1/H-Nut-WASH/NGO/8493,9/13/2019 6:13:21 AM,Other,14600,3320,0,0,17920,14345,10836,7254,7518,39953
21,Somalia,2018,SOM-18/3485/SA1/H-Nut-WASH/NGO/8493,9/13/2019 6:13:21 AM,Overall,14600,23800,12800,12800,64000,14345,23790,12745,12925,63805
21,Somalia,2018,SOM-18/3485/SA1/H-Nut-WASH/NGO/8493,9/13/2019 6:13:21 AM,Pregnant and Lactating Women,0,5760,0,0,5760,0,5182,0,0,5182
21,Somalia,2018,SOM-18/3485/SA1/H-Nut-WASH/NGO/8493,9/13/2019 6:13:21 AM,Women of Child-Bearing Age,0,14720,0,0,14720,0,7772,0,0,7772
21,Somalia,2018,SOM-18/3485/SA1/H-Nut-WASH/NGO/8538,8/15/2019 12:59:34 PM,Children under 5,0,0,4950,4950,9900,0,0,14369,16639,31008
21,Somalia,2018,SOM-18/3485/SA1/H-Nut-WASH/NGO/8538,8/15/2019 12:59:34 PM,Internally Displaced People,8245,12789,6650,6650,34334,11342,15598,0,0,26940
21,Somalia,2018,SOM-18/3485/SA1/H-Nut-WASH/NGO/8538,8/15/2019 12:59:34 PM,Overall,8400,17900,11600,11600,49500,11484,33510,14369,16639,76002
21,Somalia,2018,SOM-18/3485/SA1/H-Nut-WASH/NGO/8538,8/15/2019 12:59:34 PM,Pregnant and Lactating Women,0,4455,0,0,4455,0,17243,0,0,17243
21,Somalia,2018,SOM-18/3485/SA1/H-Nut-WASH/NGO/8538,8/15/2019 12:59:34 PM,"Trainers, Promoters, Caretakers, committee members, etc.",155,656,0,0,811,142,669,0,0,811
21,Somalia,2018,SOM-18/3485/SA1/H-Nut-WASH/NGO/8539,8/15/2019 7:28:09 AM,Children under 5,0,0,2500,3500,6000,0,0,3500,2500,6000
21,Somalia,2018,SOM-18/3485/SA1/H-Nut-WASH/NGO/8539,8/15/2019 7:28:09 AM,Other,3000,0,0,0,3000,3000,0,0,0,3000
21,Somalia,2018,SOM-18/3485/SA1/H-Nut-WASH/NGO/8539,8/15/2019 7:28:09 AM,Overall,3000,3500,2500,3500,12500,3000,3500,2500,3500,12500
21,Somalia,2018,SOM-18/3485/SA1/H-Nut-WASH/NGO/8539,8/15/2019 7:28:09 AM,Pregnant and Lactating Women,0,3500,0,0,3500,0,3500,0,0,3500
21,Somalia,2018,SOM-18/3485/SA1/H-Nut-WASH/NGO/8619,6/2/2020 8:05:46 AM,Internally Displaced People,6703,8290,5582,6785,27360,4504,5565,3747,4554,18370
21,Somalia,2018,SOM-18/3485/SA1/H-Nut-WASH/NGO/8619,6/2/2020 8:05:46 AM,Overall,11172,13817,9302,11309,45600,11172,13817,9302,11309,45600
21,Somalia,2018,SOM-18/3485/SA1/H-Nut-WASH/NGO/8619,6/2/2020 8:05:46 AM,People in Host Communities,4469,5527,3720,4524,18240,6665,8253,5556,6756,27230
21,Somalia,2018,SOM-18/3485/SA1/Nut/INGO/8759,8/29/2019 7:41:55 AM,Children under 5,0,0,1829,1830,3659,0,0,0,0,0
21,Somalia,2018,SOM-18/3485/SA1/Nut/INGO/8759,8/29/2019 7:41:55 AM,Other,1026,2315,0,0,3341,0,0,0,0,0
21,Somalia,2018,SOM-18/3485/SA1/Nut/INGO/8759,8/29/2019 7:41:55 AM,Overall,1026,19271,1829,1830,23956,917,26954,2192,2408,32471
21,Somalia,2018,SOM-18/3485/SA1/Nut/INGO/8759,8/29/2019 7:41:55 AM,Pregnant and Lactating Women,0,1206,0,0,1206,0,0,0,0,0
21,Somalia,2018,SOM-18/3485/SA1/Nut/INGO/8759,8/29/2019 7:41:55 AM,Women of Child-Bearing Age,0,15750,0,0,15750,0,0,0,0,0
21,Somalia,2018,SOM-18/3485/SA1/Nut/NGO/8472,11/1/2019 6:22:32 AM,Children under 5,0,0,8065,7749,15814,0,0,8290,7958,16248
21,Somalia,2018,SOM-18/3485/SA1/Nut/NGO/8472,11/1/2019 6:22:32 AM,Overall,29,7155,8065,7749,22998,29,7386,8290,7958,23663
21,Somalia,2018,SOM-18/3485/SA1/Nut/NGO/8472,11/1/2019 6:22:32 AM,Pregnant and Lactating Women,0,7116,0,0,7116,0,7361,0,0,7361
21,Somalia,2018,SOM-18/3485/SA1/Nut/NGO/8472,11/1/2019 6:22:32 AM,"Staff (own or partner staff, authorities)",29,39,0,0,68,29,25,0,0,54
21,Somalia,2018,SOM-18/3485/SA1/Nut/NGO/8503,10/14/2019 7:13:00 AM,Children under 5,0,0,1231,1847,3078,0,0,1403,2059,3462
21,Somalia,2018,SOM-18/3485/SA1/Nut/NGO/8503,10/14/2019 7:13:00 AM,Overall,0,1106,1231,1847,4184,0,1126,1422,2131,4679
21,Somalia,2018,SOM-18/3485/SA1/Nut/NGO/8503,10/14/2019 7:13:00 AM,Pregnant and Lactating Women,0,1106,0,0,1106,0,1217,0,0,1217
21,Somalia,2018,SOM-18/3485/SA1/Nut/NGO/8749,7/5/2019 7:26:53 AM,Children under 5,0,0,1200,1200,2400,0,0,1189,1272,2461
21,Somalia,2018,SOM-18/3485/SA1/Nut/NGO/8749,7/5/2019 7:26:53 AM,Overall,35,935,1200,1200,3370,35,1235,1189,1272,3731
21,Somalia,2018,SOM-18/3485/SA1/Nut/NGO/8749,7/5/2019 7:26:53 AM,Pregnant and Lactating Women,0,900,0,0,900,0,1200,0,0,1200
21,Somalia,2018,SOM-18/3485/SA1/Nut/NGO/8749,7/5/2019 7:26:53 AM,"Staff (own or partner staff, authorities)",35,35,0,0,70,35,35,0,0,70
21,Somalia,2018,SOM-18/3485/SA1/Nut-WASH-H/NGO/8455,7/12/2019 6:53:30 AM,Children under 5,0,0,3000,3200,6200,0,0,2987,3329,6316
21,Somalia,2018,SOM-18/3485/SA1/Nut-WASH-H/NGO/8455,7/12/2019 6:53:30 AM,Internally Displaced People/Returnees,1328,2800,0,0,4128,1267,3065,0,0,4332
21,Somalia,2018,SOM-18/3485/SA1/Nut-WASH-H/NGO/8455,7/12/2019 6:53:30 AM,Overall,1410,3901,3000,3200,11511,1349,4198,2987,3329,11863
21,Somalia,2018,SOM-18/3485/SA1/Nut-WASH-H/NGO/8455,7/12/2019 6:53:30 AM,Pregnant and Lactating Women,0,1000,0,0,1000,0,1032,0,0,1032
21,Somalia,2018,SOM-18/3485/SA1/Nut-WASH-H/NGO/8455,7/12/2019 6:53:30 AM,"Trainers, Promoters, Caretakers, committee members, etc.",82,101,0,0,183,82,101,0,0,183
21,Somalia,2018,SOM-18/3485/SA1/Prot/INGO/8609,7/26/2019 6:32:52 AM,Internally Displaced People,226,394,658,888,2166,611,2082,640,866,4199
21,Somalia,2018,SOM-18/3485/SA1/Prot/INGO/8609,7/26/2019 6:32:52 AM,Overall,251,437,731,983,2402,618,2168,640,866,4292
21,Somalia,2018,SOM-18/3485/SA1/Prot/INGO/8609,7/26/2019 6:32:52 AM,People in Host Communities,25,43,73,95,236,7,86,0,0,93
21,Somalia,2018,SOM-18/3485/SA1/Prot/NGO/8477,8/2/2019 8:26:51 AM,Children under 18,0,0,1000,1400,2400,520,1240,1000,1400,4160
21,Somalia,2018,SOM-18/3485/SA1/Prot/NGO/8477,8/2/2019 8:26:51 AM,Internally Displaced People,0,1200,0,0,1200,420,640,800,800,2660
21,Somalia,2018,SOM-18/3485/SA1/Prot/NGO/8477,8/2/2019 8:26:51 AM,Other,500,0,0,0,500,100,600,200,600,1500
21,Somalia,2018,SOM-18/3485/SA1/Prot/NGO/8477,8/2/2019 8:26:51 AM,Overall,520,1240,1000,1400,4160,520,1240,1000,1400,4160
21,Somalia,2018,SOM-18/3485/SA1/Prot/NGO/8477,8/2/2019 8:26:51 AM,"Staff (own or partner staff, authorities)",20,40,0,0,60,40,20,0,0,60
21,Somalia,2018,SOM-18/3485/SA1/Prot/NGO/8533,3/4/2019 7:23:07 AM,Internally Displaced People,236,248,860,588,1932,238,736,2174,1931,5079
21,Somalia,2018,SOM-18/3485/SA1/Prot/NGO/8533,3/4/2019 7:23:07 AM,Overall,295,310,1075,735,2415,298,1038,2717,2427,6480
21,Somalia,2018,SOM-18/3485/SA1/Prot/NGO/8533,3/4/2019 7:23:07 AM,People in Host Communities,59,62,215,147,483,60,302,543,496,1401
21,Somalia,2018,SOM-18/3485/SA1/Prot/NGO/8651,7/19/2019 5:42:58 AM,Internally Displaced People,510,1160,135,175,1980,520,1160,130,170,1980
21,Somalia,2018,SOM-18/3485/SA1/Prot/NGO/8651,7/19/2019 5:42:58 AM,Other,13,13,0,0,26,0,10,5,5,20
21,Somalia,2018,SOM-18/3485/SA1/Prot/NGO/8651,7/19/2019 5:42:58 AM,Overall,523,1173,135,175,2006,520,1170,135,175,2000
21,Somalia,2018,SOM-18/3485/SA1/Prot/NGO/8672,3/8/2019 9:28:14 AM,Children under 18,0,0,500,500,1000,0,0,0,0,0
21,Somalia,2018,SOM-18/3485/SA1/Prot/NGO/8672,3/8/2019 9:28:14 AM,Internally Displaced People,150,450,70,100,770,610,845,185,230,1870
21,Somalia,2018,SOM-18/3485/SA1/Prot/NGO/8672,3/8/2019 9:28:14 AM,Overall,270,560,570,600,2000,270,560,570,600,2000
21,Somalia,2018,SOM-18/3485/SA1/Prot/NGO/8672,3/8/2019 9:28:14 AM,"Trainers, Promoters, Caretakers, committee members, etc.",120,110,0,0,230,50,80,0,0,130
21,Somalia,2018,SOM-18/3485/SA1/Prot/NGO/8676,7/8/2019 12:27:10 PM,Internally Displaced People,970,1537,884,929,4320,1005,1575,884,929,4393
21,Somalia,2018,SOM-18/3485/SA1/Prot/NGO/8676,7/8/2019 12:27:10 PM,Overall,1030,1597,884,929,4440,1025,1595,884,929,4433
21,Somalia,2018,SOM-18/3485/SA1/Prot/NGO/8676,7/8/2019 12:27:10 PM,"Staff (own or partner staff, authorities)",40,40,0,0,80,20,20,0,0,40
21,Somalia,2018,SOM-18/3485/SA1/Prot-WASH-Shelter-CCCM/NGO/8658,9/10/2019 10:24:24 AM,Internally Displaced People,1662,3664,1370,2749,9445,2745,7904,1730,4058,16437
21,Somalia,2018,SOM-18/3485/SA1/Prot-WASH-Shelter-CCCM/NGO/8658,9/10/2019 10:24:24 AM,Overall,2445,4504,1799,3264,12012,3203,17442,2018,4734,27397
21,Somalia,2018,SOM-18/3485/SA1/Prot-WASH-Shelter-CCCM/NGO/8658,9/10/2019 10:24:24 AM,People in Host Communities,783,655,429,515,2382,458,1318,288,676,2740
21,Somalia,2018,SOM-18/3485/SA1/Prot-WASH-Shelter-CCCM/NGO/8658,9/10/2019 10:24:24 AM,Pregnant and Lactating Women,0,185,0,0,185,0,8220,0,0,8220
21,Somalia,2018,SOM-18/3485/SA1/Shelter/INGO/8506,1/16/2019 12:10:19 PM,Internally Displaced People,720,720,1680,1680,4800,938,1059,2302,1935,6234
21,Somalia,2018,SOM-18/3485/SA1/Shelter/INGO/8506,1/16/2019 12:10:19 PM,Overall,900,900,2100,2100,6000,1172,1324,2878,2419,7793
21,Somalia,2018,SOM-18/3485/SA1/Shelter/INGO/8506,1/16/2019 12:10:19 PM,People in Host Communities,180,180,420,420,1200,234,265,576,484,1559
21,Somalia,2018,SOM-18/3485/SA1/Shelter/NGO/8653,12/21/2018 5:47:17 AM,Children under 18,0,0,210,310,520,0,0,210,310,520
21,Somalia,2018,SOM-18/3485/SA1/Shelter/NGO/8653,12/21/2018 5:47:17 AM,Internally Displaced People,890,1050,740,900,3580,890,1050,740,900,3580
21,Somalia,2018,SOM-18/3485/SA1/Shelter/NGO/8653,12/21/2018 5:47:17 AM,Overall,1100,1200,1300,1600,5200,1100,1200,1300,1600,5200
21,Somalia,2018,SOM-18/3485/SA1/Shelter/NGO/8653,12/21/2018 5:47:17 AM,People in Host Communities,210,150,350,390,1100,210,150,350,390,1100
21,Somalia,2018,SOM-18/3485/SA1/Shelter/NGO/8681,2/13/2019 5:37:23 AM,Internally Displaced People/Returnees,5760,7680,2880,2880,19200,0,0,0,0,0
21,Somalia,2018,SOM-18/3485/SA1/Shelter/NGO/8681,2/13/2019 5:37:23 AM,Overall,7200,9600,3600,3600,24000,7200,9600,3600,3600,24000
21,Somalia,2018,SOM-18/3485/SA1/Shelter/NGO/8681,2/13/2019 5:37:23 AM,People in Host Communities,1440,1920,720,720,4800,0,0,0,0,0
21,Somalia,2018,SOM-18/3485/SA1/Shelter-WASH-CCCM-Prot/NGO/8682,12/24/2018 5:15:59 AM,Internally Displaced People,5400,7200,2700,2700,18000,5400,7200,2700,2700,18000
21,Somalia,2018,SOM-18/3485/SA1/Shelter-WASH-CCCM-Prot/NGO/8682,12/24/2018 5:15:59 AM,Overall,5400,7200,2700,2700,18000,5400,7200,2700,2700,18000
21,Somalia,2018,SOM-18/3485/SA1/WASH/INGO/8692,7/18/2019 9:00:25 AM,Overall,23366,24564,5991,5991,59912,10624,11600,21386,20154,63764
21,Somalia,2018,SOM-18/3485/SA1/WASH/INGO/8766,7/15/2019 12:36:59 PM,Committees,5,3,0,0,8,0,0,0,0,0
21,Somalia,2018,SOM-18/3485/SA1/WASH/INGO/8766,7/15/2019 12:36:59 PM,Internally Displaced People,3715,3957,2040,2280,11992,3720,3960,2040,2280,12000
21,Somalia,2018,SOM-18/3485/SA1/WASH/INGO/8766,7/15/2019 12:36:59 PM,Overall,3720,3960,2040,2280,12000,3720,3960,2040,2280,12000
21,Somalia,2018,SOM-18/3485/SA1/WASH/NGO/8675,3/28/2019 11:36:04 AM,Internally Displaced People,735,909,612,744,3000,761,640,556,650,2607
21,Somalia,2018,SOM-18/3485/SA1/WASH/NGO/8675,3/28/2019 11:36:04 AM,Overall,2817,3485,2346,2852,11500,4484,5545,3733,4538,18300
21,Somalia,2018,SOM-18/3485/SA1/WASH/NGO/8675,3/28/2019 11:36:04 AM,People in HE and/or AFLC,2082,2576,1734,2108,8500,4268,4282,3272,3871,15693
21,Somalia,2018,SOM-18/3485/SA1/WASH/NGO/8711,5/11/2020 11:02:28 AM,Internally Displaced People,2352,2909,1958,2390,9609,2352,2909,1958,2390,9609
21,Somalia,2018,SOM-18/3485/SA1/WASH/NGO/8711,5/11/2020 11:02:28 AM,Overall,6174,7636,5140,6250,25200,6174,7636,5140,6250,25200
21,Somalia,2018,SOM-18/3485/SA1/WASH/NGO/8711,5/11/2020 11:02:28 AM,People in HE and/or AFLC,3822,4727,3182,3860,15591,3822,4727,3182,3860,15591
21,Somalia,2018,SOM-18/3485/SA1/WASH-Nut-H/NGO/8750,9/11/2019 12:17:04 PM,Children under 5,0,0,1500,1500,3000,0,0,1463,1748,3211
21,Somalia,2018,SOM-18/3485/SA1/WASH-Nut-H/NGO/8750,9/11/2019 12:17:04 PM,Other,1000,0,0,0,1000,1086,0,0,0,1086
21,Somalia,2018,SOM-18/3485/SA1/WASH-Nut-H/NGO/8750,9/11/2019 12:17:04 PM,Overall,1000,2000,1500,1500,6000,1086,2112,1463,1748,6409
21,Somalia,2018,SOM-18/3485/SA1/WASH-Nut-H/NGO/8750,9/11/2019 12:17:04 PM,Pregnant and Lactating Women,0,2000,0,0,2000,0,2112,0,0,2112
21,Somalia,2018,SOM-18/3485/SA2/CCCM/INGO/11119,6/25/2020 2:03:13 PM,Internally Displaced People,4972,6078,8841,7737,27628,5035,6080,9097,8027,28239
21,Somalia,2018,SOM-18/3485/SA2/CCCM/INGO/11119,6/25/2020 2:03:13 PM,Overall,5234,6398,9306,8144,29082,5300,6400,9576,8450,29726
21,Somalia,2018,SOM-18/3485/SA2/CCCM/INGO/11119,6/25/2020 2:03:13 PM,People in Host Communities,262,320,465,407,1454,265,320,479,423,1487
21,Somalia,2018,SOM-18/3485/SA2/CCCM/INGO/11158,7/2/2020 8:12:46 AM,Internally Displaced People,8568,9135,6930,6867,31500,8568,9135,6930,6867,31500
21,Somalia,2018,SOM-18/3485/SA2/CCCM/INGO/11158,7/2/2020 8:12:46 AM,Overall,8568,9135,6930,6867,31500,8568,9135,6930,6867,31500
21,Somalia,2018,SOM-18/3485/SA2/CCCM-Shelter/INGO/11160,6/19/2020 10:14:51 AM,Internally Displaced People,2000,2000,4000,3760,11760,2679,2726,5938,4728,16071
21,Somalia,2018,SOM-18/3485/SA2/CCCM-Shelter/INGO/11160,6/19/2020 10:14:51 AM,Overall,2500,2500,5000,4700,14700,2757,2804,6148,4915,16624
21,Somalia,2018,SOM-18/3485/SA2/CCCM-Shelter/INGO/11160,6/19/2020 10:14:51 AM,People in Host Communities,500,500,1000,940,2940,78,78,210,187,553
21,Somalia,2018,SOM-18/3485/SA2/CCCM-Shelter/NGO/11050,2/25/2020 11:11:04 AM,Internally Displaced People,1114,2240,1200,1400,5954,1613,3541,746,1298,7198
21,Somalia,2018,SOM-18/3485/SA2/CCCM-Shelter/NGO/11050,2/25/2020 11:11:04 AM,Overall,1392,2800,1500,1750,7442,1613,3541,746,1298,7198
21,Somalia,2018,SOM-18/3485/SA2/CCCM-Shelter/NGO/11050,2/25/2020 11:11:04 AM,People in Host Communities,278,560,300,350,1488,0,0,0,0,0
21,Somalia,2018,SOM-18/3485/SA2/CCCM-Shelter-WASH/INGO/11193,7/8/2020 10:42:38 AM,Internally Displaced People,2289,2595,5495,4885,15264,3560,4035,8545,7596,23736
21,Somalia,2018,SOM-18/3485/SA2/CCCM-Shelter-WASH/INGO/11193,7/8/2020 10:42:38 AM,Overall,2289,2595,5495,4885,15264,3560,4035,8545,7596,23736
21,Somalia,2018,SOM-18/3485/SA2/Ed/INGO/11031,6/5/2020 10:08:31 AM,Children under 18,0,0,2175,1421,3596,0,0,2415,2130,4545
21,Somalia,2018,SOM-18/3485/SA2/Ed/INGO/11031,6/5/2020 10:08:31 AM,Committees,32,32,0,0,64,39,25,0,0,64
21,Somalia,2018,SOM-18/3485/SA2/Ed/INGO/11031,6/5/2020 10:08:31 AM,Other,10,2,0,0,12,45,3,0,0,48
21,Somalia,2018,SOM-18/3485/SA2/Ed/INGO/11031,6/5/2020 10:08:31 AM,Overall,74,50,2175,1421,3720,249,85,2415,2130,4879
21,Somalia,2018,SOM-18/3485/SA2/Ed/INGO/11031,6/5/2020 10:08:31 AM,"Trainers, Promoters, Caretakers, committee members, etc.",32,16,0,0,48,165,57,0,0,222
21,Somalia,2018,SOM-18/3485/SA2/Ed/INGO/11084,2/26/2020 7:55:06 AM,Internally Displaced People/Returnees,56,10,1496,1051,2613,89,24,1665,1184,2962
21,Somalia,2018,SOM-18/3485/SA2/Ed/INGO/11084,2/26/2020 7:55:06 AM,Overall,106,18,2355,1602,4081,148,41,2774,1975,4938
21,Somalia,2018,SOM-18/3485/SA2/Ed/INGO/11084,2/26/2020 7:55:06 AM,People in Host Communities,50,8,859,551,1468,59,17,1109,791,1976
21,Somalia,2018,SOM-18/3485/SA2/Ed/NGO/11076,9/28/2020 4:51:59 PM,Children under 18,0,0,2305,1922,4227,0,0,2305,1922,4227
21,Somalia,2018,SOM-18/3485/SA2/Ed/NGO/11076,9/28/2020 4:51:59 PM,Overall,98,75,2305,1922,4400,98,75,2305,1922,4400
21,Somalia,2018,SOM-18/3485/SA2/Ed/NGO/11076,9/28/2020 4:51:59 PM,"Staff (own or partner staff, authorities)",66,44,0,0,110,66,44,0,0,110
21,Somalia,2018,SOM-18/3485/SA2/Ed/NGO/11076,9/28/2020 4:51:59 PM,"Trainers, Promoters, Caretakers, committee members, etc.",32,31,0,0,63,32,31,0,0,63
21,Somalia,2018,SOM-18/3485/SA2/Ed-Prot/INGO/11206,11/7/2019 8:12:07 AM,Children under 18,0,0,0,0,0,0,0,2340,1875,4215
21,Somalia,2018,SOM-18/3485/SA2/Ed-Prot/INGO/11206,11/7/2019 8:12:07 AM,Internally Displaced People,0,0,0,0,0,301,865,0,0,1166
21,Somalia,2018,SOM-18/3485/SA2/Ed-Prot/INGO/11206,11/7/2019 8:12:07 AM,Overall,322,298,2291,2185,5096,301,865,2340,1875,5381
21,Somalia,2018,SOM-18/3485/SA2/Ed-Prot/NGO/10992,7/8/2020 7:51:01 AM,Children under 18,0,0,1781,1615,3396,0,0,1784,1800,3584
21,Somalia,2018,SOM-18/3485/SA2/Ed-Prot/NGO/10992,7/8/2020 7:51:01 AM,Committees,14,14,0,0,28,6,6,0,0,12
21,Somalia,2018,SOM-18/3485/SA2/Ed-Prot/NGO/10992,7/8/2020 7:51:01 AM,Internally Displaced People,0,0,0,0,0,111,158,0,0,269
21,Somalia,2018,SOM-18/3485/SA2/Ed-Prot/NGO/10992,7/8/2020 7:51:01 AM,Overall,67,29,1781,1615,3492,117,164,1784,1800,3865
21,Somalia,2018,SOM-18/3485/SA2/Ed-Prot/NGO/10992,7/8/2020 7:51:01 AM,"Staff (own or partner staff, authorities)",44,15,0,0,59,0,0,0,0,0
21,Somalia,2018,SOM-18/3485/SA2/EP/INGO/11213,2/26/2020 7:34:03 AM,Overall,7500,2500,0,0,10000,7500,2500,0,0,10000
21,Somalia,2018,SOM-18/3485/SA2/EP/INGO/11214,1/14/2021 12:47:50 PM,Overall,43,43,0,0,86,47,46,0,0,93
21,Somalia,2018,SOM-18/3485/SA2/FSC/INGO/11059,11/29/2019 6:26:08 AM,Agro-Pastoralists,348,202,492,458,1500,779,1273,580,384,3016
21,Somalia,2018,SOM-18/3485/SA2/FSC/INGO/11059,11/29/2019 6:26:08 AM,Internally Displaced People,300,500,300,400,1500,0,0,0,0,0
21,Somalia,2018,SOM-18/3485/SA2/FSC/INGO/11059,11/29/2019 6:26:08 AM,Overall,648,702,792,858,3000,779,1273,580,384,3016
21,Somalia,2018,SOM-18/3485/SA2/FSC/INGO/11151,9/9/2019 7:22:36 AM,Overall,672,1013,2235,2210,6130,900,1112,2174,2189,6375
21,Somalia,2018,SOM-18/3485/SA2/FSC/INGO/11204,1/31/2020 8:14:57 AM,Internally Displaced People,1000,1000,2000,2000,6000,1498,1635,2215,1905,7253
21,Somalia,2018,SOM-18/3485/SA2/FSC/INGO/11204,1/31/2020 8:14:57 AM,Overall,2000,2000,4000,4000,12000,3199,3413,5170,4242,16024
21,Somalia,2018,SOM-18/3485/SA2/FSC/INGO/11204,1/31/2020 8:14:57 AM,People in Host Communities,1000,1000,2000,2000,6000,1701,1778,2955,2337,8771
21,Somalia,2018,SOM-18/3485/SA2/FSC/NGO/10991,1/28/2020 7:59:03 PM,Internally Displaced People,1500,3500,1500,1600,8100,1350,3750,1330,1670,8100
21,Somalia,2018,SOM-18/3485/SA2/FSC/NGO/10991,1/28/2020 7:59:03 PM,Overall,1500,3500,1500,1600,8100,1350,3750,1330,1670,8100
21,Somalia,2018,SOM-18/3485/SA2/FSC/NGO/11017,10/28/2019 6:20:26 AM,Internally Displaced People,3715,3921,1238,1446,10320,3715,3921,1238,1446,10320
21,Somalia,2018,SOM-18/3485/SA2/FSC/NGO/11017,10/28/2019 6:20:26 AM,Overall,3715,3921,1238,1446,10320,3715,3921,1238,1446,10320
21,Somalia,2018,SOM-18/3485/SA2/FSC/NGO/11039,11/5/2019 12:54:54 PM,Agro-Pastoralists,425,675,430,450,1980,305,416,237,287,1245
21,Somalia,2018,SOM-18/3485/SA2/FSC/NGO/11039,11/5/2019 12:54:54 PM,Overall,775,1125,530,670,3100,775,1125,530,670,3100
21,Somalia,2018,SOM-18/3485/SA2/FSC/NGO/11039,11/5/2019 12:54:54 PM,Pastoralists,350,450,100,220,1120,470,709,293,383,1855
21,Somalia,2018,SOM-18/3485/SA2/H/INGO/11139,2/7/2020 6:10:36 AM,Children under 5,0,0,4500,6500,11000,0,0,4500,6500,11000
21,Somalia,2018,SOM-18/3485/SA2/H/INGO/11139,2/7/2020 6:10:36 AM,Other,1000,0,0,0,1000,1000,0,0,0,1000
21,Somalia,2018,SOM-18/3485/SA2/H/INGO/11139,2/7/2020 6:10:36 AM,Overall,1000,4000,4500,6500,16000,1000,4000,4500,6500,16000
21,Somalia,2018,SOM-18/3485/SA2/H/INGO/11139,2/7/2020 6:10:36 AM,Women of Child-Bearing Age,0,4000,0,0,4000,0,4000,0,0,4000
21,Somalia,2018,SOM-18/3485/SA2/H/NGO/11111,6/3/2020 9:00:19 AM,Children under 5,0,0,1900,1900,3800,350,540,2650,2700,6240
21,Somalia,2018,SOM-18/3485/SA2/H/NGO/11111,6/3/2020 9:00:19 AM,Internally Displaced People,1625,2000,2375,2375,8375,2100,2110,2600,2600,9410
21,Somalia,2018,SOM-18/3485/SA2/H/NGO/11111,6/3/2020 9:00:19 AM,Overall,2850,4750,5700,5700,19000,2850,4750,5700,5700,19000
21,Somalia,2018,SOM-18/3485/SA2/H/NGO/11111,6/3/2020 9:00:19 AM,People in HE and/or AFLC,1225,1000,1425,1425,5075,400,1175,450,400,2425
21,Somalia,2018,SOM-18/3485/SA2/H/NGO/11111,6/3/2020 9:00:19 AM,Pregnant and Lactating Women,0,1750,0,0,1750,0,925,0,0,925
21,Somalia,2018,SOM-18/3485/SA2/H/NGO/11162,1/22/2021 11:59:52 AM,Children under 5,0,0,3400,3400,6800,0,0,3140,3330,6470
21,Somalia,2018,SOM-18/3485/SA2/H/NGO/11162,1/22/2021 11:59:52 AM,Other,10880,5440,0,0,16320,7649,4596,0,0,12245
21,Somalia,2018,SOM-18/3485/SA2/H/NGO/11162,1/22/2021 11:59:52 AM,Overall,10880,16320,3400,3400,34000,7649,16006,3140,3330,30125
21,Somalia,2018,SOM-18/3485/SA2/H/NGO/11162,1/22/2021 11:59:52 AM,Pregnant and Lactating Women,0,3060,0,0,3060,0,3221,0,0,3221
21,Somalia,2018,SOM-18/3485/SA2/H/NGO/11162,1/22/2021 11:59:52 AM,Women of Child-Bearing Age,0,7820,0,0,7820,0,8189,0,0,8189
21,Somalia,2018,SOM-18/3485/SA2/H-Nut-WASH/INGO/11156,2/19/2021 8:18:27 AM,Children under 5,0,0,7327,7626,14953,0,0,10511,17041,27552
21,Somalia,2018,SOM-18/3485/SA2/H-Nut-WASH/INGO/11156,2/19/2021 8:18:27 AM,Other,32122,37365,0,0,69487,36552,36398,0,0,72950
21,Somalia,2018,SOM-18/3485/SA2/H-Nut-WASH/INGO/11156,2/19/2021 8:18:27 AM,Overall,32122,40883,7327,7626,87958,36552,41289,10511,17041,105393
21,Somalia,2018,SOM-18/3485/SA2/H-Nut-WASH/INGO/11156,2/19/2021 8:18:27 AM,Pregnant and Lactating Women,0,3518,0,0,3518,0,4891,0,0,4891
21,Somalia,2018,SOM-18/3485/SA2/H-Nut-WASH/INGO/11211,3/11/2020 11:03:34 AM,Children under 5,0,0,15629,15833,31462,0,0,17047,18894,35941
21,Somalia,2018,SOM-18/3485/SA2/H-Nut-WASH/INGO/11211,3/11/2020 11:03:34 AM,Overall,8846,52899,15829,15833,93407,3611,26905,17047,18894,66457
21,Somalia,2018,SOM-18/3485/SA2/H-Nut-WASH/INGO/11211,3/11/2020 11:03:34 AM,Pregnant and Lactating Women,0,17646,0,0,17646,0,9536,0,0,9536
21,Somalia,2018,SOM-18/3485/SA2/H-Nut-WASH/INGO/11211,3/11/2020 11:03:34 AM,Women of Child-Bearing Age,0,35253,0,0,35253,3611,17369,0,0,20980
21,Somalia,2018,SOM-18/3485/SA2/H-Nut-WASH/NGO/11058,2/8/2021 6:37:20 AM,Agro-Pastoralists,2762,3042,4100,5941,15845,3358,1679,4513,6900,16450
21,Somalia,2018,SOM-18/3485/SA2/H-Nut-WASH/NGO/11058,2/8/2021 6:37:20 AM,Internally Displaced People,789,689,1359,1956,4793,191,0,685,852,1728
21,Somalia,2018,SOM-18/3485/SA2/H-Nut-WASH/NGO/11058,2/8/2021 6:37:20 AM,Overall,3578,8956,5459,7897,25890,3567,8628,5198,7752,25145
21,Somalia,2018,SOM-18/3485/SA2/H-Nut-WASH/NGO/11058,2/8/2021 6:37:20 AM,Pregnant and Lactating Women,0,4568,0,0,4568,0,6925,0,0,6925
21,Somalia,2018,SOM-18/3485/SA2/H-Nut-WASH/NGO/11058,2/8/2021 6:37:20 AM,"Staff (own or partner staff, authorities)",27,57,0,0,84,18,24,0,0,42
21,Somalia,2018,SOM-18/3485/SA2/H-Nut-WASH/NGO/11079,1/22/2021 12:02:21 PM,Internally Displaced People,1920,3200,3840,3840,12800,1827,3423,4132,4477,13859
21,Somalia,2018,SOM-18/3485/SA2/H-Nut-WASH/NGO/11079,1/22/2021 12:02:21 PM,Overall,4800,8000,9600,9600,32000,4502,8245,9138,9795,31680
21,Somalia,2018,SOM-18/3485/SA2/H-Nut-WASH/NGO/11079,1/22/2021 12:02:21 PM,People in Host Communities,2880,4800,5760,5760,19200,2675,4822,5006,5318,17821
21,Somalia,2018,SOM-18/3485/SA2/H-Nut-WASH/NGO/11080,10/14/2019 12:39:45 PM,Children under 5,0,0,3500,3700,7200,0,0,3500,3700,7200
21,Somalia,2018,SOM-18/3485/SA2/H-Nut-WASH/NGO/11080,10/14/2019 12:39:45 PM,Overall,200,2000,3500,3700,9400,200,2000,3500,3700,9400
21,Somalia,2018,SOM-18/3485/SA2/H-Nut-WASH/NGO/11080,10/14/2019 12:39:45 PM,Pregnant and Lactating Women,0,1800,0,0,1800,0,2000,0,0,2000
21,Somalia,2018,SOM-18/3485/SA2/H-Nut-WASH/NGO/11080,10/14/2019 12:39:45 PM,"Trainers, Promoters, Caretakers, committee members, etc.",20,200,0,0,220,200,0,0,0,200
21,Somalia,2018,SOM-18/3485/SA2/Nut/NGO/11057,6/3/2020 8:40:24 AM,Children under 5,0,0,5474,7370,12844,0,0,6062,9097,15159
21,Somalia,2018,SOM-18/3485/SA2/Nut/NGO/11057,6/3/2020 8:40:24 AM,Other,3936,0,0,0,3936,4546,0,0,0,4546
21,Somalia,2018,SOM-18/3485/SA2/Nut/NGO/11057,6/3/2020 8:40:24 AM,Overall,3936,5204,5474,7370,21984,4546,5559,6062,9097,25264
21,Somalia,2018,SOM-18/3485/SA2/Nut/NGO/11057,6/3/2020 8:40:24 AM,Pregnant and Lactating Women,0,5204,0,0,5204,0,5559,0,0,5559
21,Somalia,2018,SOM-18/3485/SA2/Nut/O/11013,7/8/2020 7:59:52 AM,Children under 5,0,0,2100,2450,4550,0,0,1790,2310,4100
21,Somalia,2018,SOM-18/3485/SA2/Nut/O/11013,7/8/2020 7:59:52 AM,Overall,15,3865,2100,2450,8430,15,3037,1790,2310,7152
21,Somalia,2018,SOM-18/3485/SA2/Nut/O/11013,7/8/2020 7:59:52 AM,Pregnant and Lactating Women,0,3840,0,0,3840,0,3012,0,0,3012
21,Somalia,2018,SOM-18/3485/SA2/Nut/O/11013,7/8/2020 7:59:52 AM,"Staff (own or partner staff, authorities)",15,25,0,0,40,15,25,0,0,40
21,Somalia,2018,SOM-18/3485/SA2/Nut-H-WASH/NGO/11185,1/23/2020 5:14:36 AM,Children under 5,0,0,1750,1750,3500,0,0,1523,1707,3230
21,Somalia,2018,SOM-18/3485/SA2/Nut-H-WASH/NGO/11185,1/23/2020 5:14:36 AM,Internally Displaced People/Returnees,2150,2100,2600,2600,9450,2512,2865,1917,2002,9296
21,Somalia,2018,SOM-18/3485/SA2/Nut-H-WASH/NGO/11185,1/23/2020 5:14:36 AM,Overall,2625,4375,5250,5250,17500,3238,6541,3982,4192,17953
21,Somalia,2018,SOM-18/3485/SA2/Nut-H-WASH/NGO/11185,1/23/2020 5:14:36 AM,People in HE and/or AFLC,475,700,900,900,2975,726,826,542,483,2577
21,Somalia,2018,SOM-18/3485/SA2/Nut-H-WASH/NGO/11185,1/23/2020 5:14:36 AM,Pregnant and Lactating Women,0,1575,0,0,1575,0,2850,0,0,2850
21,Somalia,2018,SOM-18/3485/SA2/Prot/INGO/11146,6/26/2020 10:45:56 AM,Committees,88,82,0,0,170,8,15,0,0,23
21,Somalia,2018,SOM-18/3485/SA2/Prot/INGO/11146,6/26/2020 10:45:56 AM,Internally Displaced People/Returnees,14277,12853,567,851,28548,11536,28854,498,770,41658
21,Somalia,2018,SOM-18/3485/SA2/Prot/INGO/11146,6/26/2020 10:45:56 AM,Overall,17104,15409,669,1004,34186,15267,34231,746,1109,51353
21,Somalia,2018,SOM-18/3485/SA2/Prot/INGO/11146,6/26/2020 10:45:56 AM,People in Host Communities,2563,2309,102,153,5127,3708,5349,248,339,9644
21,Somalia,2018,SOM-18/3485/SA2/Prot/INGO/11146,6/26/2020 10:45:56 AM,"Staff (own or partner staff, authorities)",176,165,0,0,341,15,13,0,0,28
21,Somalia,2018,SOM-18/3485/SA2/Prot/NGO/11008,6/30/2020 8:21:58 AM,Internally Displaced People,680,2020,300,400,3400,334,1063,215,365,1977
21,Somalia,2018,SOM-18/3485/SA2/Prot/NGO/11008,6/30/2020 8:21:58 AM,Overall,710,2055,300,400,3465,350,1083,215,365,2013
21,Somalia,2018,SOM-18/3485/SA2/Prot/NGO/11008,6/30/2020 8:21:58 AM,"Staff (own or partner staff, authorities)",30,35,0,0,65,16,20,0,0,36
21,Somalia,2018,SOM-18/3485/SA2/Shelter/NGO/11010,9/10/2019 10:21:59 AM,Internally Displaced People,5328,7104,2664,2664,17760,5328,7104,2664,2664,17760
21,Somalia,2018,SOM-18/3485/SA2/Shelter/NGO/11010,9/10/2019 10:21:59 AM,Overall,6660,8880,3330,3330,22200,6660,8880,3330,3330,22200
21,Somalia,2018,SOM-18/3485/SA2/Shelter/NGO/11010,9/10/2019 10:21:59 AM,People in Host Communities,1332,1776,666,666,4440,1332,1776,666,666,4440
21,Somalia,2018,SOM-18/3485/SA2/Shelter/NGO/11086,7/29/2019 9:57:48 AM,Children under 18,0,0,420,530,950,0,0,420,550,970
21,Somalia,2018,SOM-18/3485/SA2/Shelter/NGO/11086,7/29/2019 9:57:48 AM,Internally Displaced People/Returnees,1680,1850,1280,1400,6210,1680,1850,1280,1400,6210
21,Somalia,2018,SOM-18/3485/SA2/Shelter/NGO/11086,7/29/2019 9:57:48 AM,Overall,2100,2150,2300,2550,9100,2100,2150,2300,2550,9100
21,Somalia,2018,SOM-18/3485/SA2/Shelter/NGO/11086,7/29/2019 9:57:48 AM,People in Host Communities,420,300,600,600,1920,420,300,600,600,1920
21,Somalia,2018,SOM-18/3485/SA2/WASH/INGO/11130,4/7/2020 1:09:15 PM,Agro-Pastoralists,1220,1450,863,907,4440,1670,1900,1093,1159,5822
21,Somalia,2018,SOM-18/3485/SA2/WASH/INGO/11130,4/7/2020 1:09:15 PM,Overall,6050,7420,2393,2449,18312,8400,9691,4420,4089,26600
21,Somalia,2018,SOM-18/3485/SA2/WASH/INGO/11130,4/7/2020 1:09:15 PM,People from Riverine Communities,4830,5970,1530,1542,13872,6730,7791,3327,2930,20778
21,Somalia,2018,SOM-18/3485/SA2/WASH/INGO/11210,6/1/2020 6:29:38 AM,Children under 18,0,0,3506,3739,7245,0,0,0,0,0
21,Somalia,2018,SOM-18/3485/SA2/WASH/INGO/11210,6/1/2020 6:29:38 AM,Internally Displaced People,3803,0,0,0,3803,3913,3956,3613,3878,15360
21,Somalia,2018,SOM-18/3485/SA2/WASH/INGO/11210,6/1/2020 6:29:38 AM,Overall,3803,3832,3506,3739,14880,3913,3956,3613,3878,15360
21,Somalia,2018,SOM-18/3485/SA2/WASH/INGO/11210,6/1/2020 6:29:38 AM,Women of Child-Bearing Age,0,3832,0,0,3832,0,0,0,0,0
21,Somalia,2018,SOM-18/3485/SA2/WASH/NGO/11032,5/11/2020 10:55:27 AM,Agro-Pastoralists,625,804,385,385,2199,605,992,0,0,1597
21,Somalia,2018,SOM-18/3485/SA2/WASH/NGO/11032,5/11/2020 10:55:27 AM,Children under 18,470,579,197,90,1336,0,0,1758,1677,3435
21,Somalia,2018,SOM-18/3485/SA2/WASH/NGO/11032,5/11/2020 10:55:27 AM,Other,265,552,387,200,1404,705,1156,0,0,1861
21,Somalia,2018,SOM-18/3485/SA2/WASH/NGO/11032,5/11/2020 10:55:27 AM,Overall,2500,4105,1855,1560,10020,2525,4140,1758,1677,10100
21,Somalia,2018,SOM-18/3485/SA2/WASH/NGO/11032,5/11/2020 10:55:27 AM,People from Riverine Communities,1140,2170,886,885,5081,1215,1992,0,0,3207
21,Somalia,2018,SOM-18/3485/SA2/WASH/NGO/11034,5/11/2020 12:56:59 PM,Internally Displaced People,1512,2520,3024,3024,10080,756,1260,1512,1512,5040
21,Somalia,2018,SOM-18/3485/SA2/WASH/NGO/11034,5/11/2020 12:56:59 PM,Overall,2520,4200,5040,5040,16800,2520,4200,5040,5040,16800
21,Somalia,2018,SOM-18/3485/SA2/WASH/NGO/11034,5/11/2020 12:56:59 PM,People in Host Communities,1008,1680,2016,2016,6720,1764,2940,3528,3528,11760
21,Somalia,2018,SOM-18/3485/SA2/WASH/NGO/11173,5/19/2020 7:02:16 AM,Internally Displaced People,1875,3125,3750,3750,12500,993,1563,1815,1937,6308
21,Somalia,2018,SOM-18/3485/SA2/WASH/NGO/11173,5/19/2020 7:02:16 AM,Overall,3750,6250,7500,7500,25000,3750,6250,7200,7800,25000
21,Somalia,2018,SOM-18/3485/SA2/WASH/NGO/11173,5/19/2020 7:02:16 AM,People in HE and/or AFLC,375,625,750,750,2500,829,1250,1450,1554,5083
21,Somalia,2018,SOM-18/3485/SA2/WASH/NGO/11173,5/19/2020 7:02:16 AM,People in Host Communities,1500,2500,3000,3000,10000,1928,3437,3935,4309,13609
21,Somalia,2018,SOM-18/3485/SA2/WASH-Prot/INGO/11154,5/8/2020 7:21:39 AM,Internally Displaced People,1800,3700,3700,4000,13200,3006,2881,3131,3382,12400
21,Somalia,2018,SOM-18/3485/SA2/WASH-Prot/INGO/11154,5/8/2020 7:21:39 AM,Overall,2000,4000,4000,4400,14400,3006,2881,3131,3382,12400
21,Somalia,2018,SOM-18/3485/SA2/WASH-Prot/INGO/11154,5/8/2020 7:21:39 AM,People in Host Communities,200,300,300,400,1200,0,0,0,0,0
21,Somalia,2018,SOM-18/3485/SA2/WASH-Prot/NGO/11027,5/11/2020 11:13:17 AM,Internally Displaced People/Returnees,2100,3640,3800,5800,15340,2088,3181,3059,5158,13486
21,Somalia,2018,SOM-18/3485/SA2/WASH-Prot/NGO/11027,5/11/2020 11:13:17 AM,Overall,3100,4440,4480,6480,18500,3073,4537,4393,6783,18786
21,Somalia,2018,SOM-18/3485/SA2/WASH-Prot/NGO/11027,5/11/2020 11:13:17 AM,People in Host Communities,1000,800,680,680,3160,985,1356,1334,1625,5300
21,Somalia,2019,SOM-19/3485/R3/Ed-Prot/NGO/14508,9/4/2020 6:54:07 AM,Host Communities,800,1000,2200,2500,6500,896,1853,3450,2751,8950
21,Somalia,2019,SOM-19/3485/R3/Ed-Prot/NGO/14508,9/4/2020 6:54:07 AM,Internally Displaced People,1250,2000,3900,4500,11650,1577,3133,4200,4418,13328
21,Somalia,2019,SOM-19/3485/R3/Ed-Prot/NGO/14508,9/4/2020 6:54:07 AM,Other,0,0,8200,10000,18200,0,0,9992,9063,19055
21,Somalia,2019,SOM-19/3485/R3/Ed-Prot/NGO/14508,9/4/2020 6:54:07 AM,Overall,2050,3000,10200,12000,27250,2473,4986,17642,16232,41333
21,Somalia,2019,SOM-19/3485/R3/FSC/INGO/14568,10/22/2020 7:31:16 AM,Host Communities,40,45,20,25,130,1716,1983,3679,3415,10793
21,Somalia,2019,SOM-19/3485/R3/FSC/INGO/14568,10/22/2020 7:31:16 AM,Internally Displaced People,640,650,645,647,2582,1476,1774,3038,2919,9207
21,Somalia,2019,SOM-19/3485/R3/FSC/INGO/14568,10/22/2020 7:31:16 AM,Overall,680,695,665,672,2712,3192,3757,6717,6334,20000
21,Somalia,2019,SOM-19/3485/R3/FSC/INGO/14601,10/13/2020 1:01:57 PM,Host Communities,6500,5000,3250,3250,18000,6500,5000,3250,3250,18000
21,Somalia,2019,SOM-19/3485/R3/FSC/INGO/14601,10/13/2020 1:01:57 PM,Overall,6500,5000,3250,3250,18000,6500,5000,3250,3250,18000
21,Somalia,2019,SOM-19/3485/R3/H/NGO/14877,12/23/2020 5:19:04 PM,Host Communities,210,910,1362,1318,3800,223,940,1364,1322,3849
21,Somalia,2019,SOM-19/3485/R3/H/NGO/14877,12/23/2020 5:19:04 PM,Internally Displaced People,800,1740,1312,848,4700,814,1757,1314,853,4738
21,Somalia,2019,SOM-19/3485/R3/H/NGO/14877,12/23/2020 5:19:04 PM,Overall,1010,2650,2674,2166,8500,1037,2697,2678,2175,8587
21,Somalia,2019,SOM-19/3485/R3/H-Nut/INGO/14605,2/19/2021 11:50:12 AM,Host Communities,1463,1787,788,962,5000,674,983,543,396,2596
21,Somalia,2019,SOM-19/3485/R3/H-Nut/INGO/14605,2/19/2021 11:50:12 AM,Internally Displaced People,10238,12512,5513,6737,35000,2578,2578,2578,2572,10306
21,Somalia,2019,SOM-19/3485/R3/H-Nut/INGO/14605,2/19/2021 11:50:12 AM,Overall,11701,14299,6301,7699,40000,3252,3561,3121,2968,12902
21,Somalia,2019,SOM-19/3485/R3/H-Nut-WASH/NGO/14533,9/28/2020 4:48:58 PM,Host Communities,1000,1000,1000,1000,4000,1000,1000,1000,1000,4000
21,Somalia,2019,SOM-19/3485/R3/H-Nut-WASH/NGO/14533,9/28/2020 4:48:58 PM,Internally Displaced People,2000,3000,2000,2000,9000,2000,3000,2100,2000,9100
21,Somalia,2019,SOM-19/3485/R3/H-Nut-WASH/NGO/14533,9/28/2020 4:48:58 PM,Overall,3000,4000,3000,3000,13000,3000,4000,3100,3000,13100
21,Somalia,2019,SOM-19/3485/R3/Prot/NGO/14535,6/1/2020 6:20:56 AM,Host Communities,3,400,224,216,843,3,400,224,216,843
21,Somalia,2019,SOM-19/3485/R3/Prot/NGO/14535,6/1/2020 6:20:56 AM,Internally Displaced People,12,1600,896,864,3372,12,1600,856,824,3292
21,Somalia,2019,SOM-19/3485/R3/Prot/NGO/14535,6/1/2020 6:20:56 AM,Overall,15,2000,1120,1080,4215,15,2000,1080,1040,4135
21,Somalia,2019,SOM-19/3485/R3/Prot/NGO/14540,7/23/2020 7:05:14 AM,Host Communities,1135,2325,1620,1600,6680,917,3415,1495,1743,7570
21,Somalia,2019,SOM-19/3485/R3/Prot/NGO/14540,7/23/2020 7:05:14 AM,Internally Displaced People,3185,4645,2985,3555,14370,2480,6631,2657,4067,15835
21,Somalia,2019,SOM-19/3485/R3/Prot/NGO/14540,7/23/2020 7:05:14 AM,Overall,4320,6970,4605,5155,21050,3397,10046,4152,5810,23405
21,Somalia,2019,SOM-19/3485/R3/Shelter/NGO/14511,7/23/2020 8:24:28 AM,Internally Displaced People,1437,1439,2947,2949,8772,1437,1439,2947,2949,8772
21,Somalia,2019,SOM-19/3485/R3/Shelter/NGO/14511,7/23/2020 8:24:28 AM,Overall,1437,1439,2947,2949,8772,1437,1439,2947,2949,8772
21,Somalia,2019,SOM-19/3485/R3/Shelter/NGO/14529,7/21/2020 4:55:45 AM,Internally Displaced People,6570,10950,13140,13140,43800,6570,10950,13140,13140,43800
21,Somalia,2019,SOM-19/3485/R3/Shelter/NGO/14529,7/21/2020 4:55:45 AM,Overall,6570,10950,13140,13140,43800,6570,10950,13140,13140,43800
21,Somalia,2019,SOM-19/3485/R3/Shelter-CCCM/INGO/14521,10/27/2020 8:36:14 AM,Host Communities,554,553,1291,1292,3690,237,335,200,200,972
21,Somalia,2019,SOM-19/3485/R3/Shelter-CCCM/INGO/14521,10/27/2020 8:36:14 AM,Internally Displaced People,1291,1292,3014,3013,8610,2494,11718,8534,4615,27361
21,Somalia,2019,SOM-19/3485/R3/Shelter-CCCM/INGO/14521,10/27/2020 8:36:14 AM,Overall,1845,1845,4305,4305,12300,2731,12053,8734,4815,28333
21,Somalia,2019,SOM-19/3485/R3/WASH/INGO/14510,9/11/2020 10:06:27 AM,Host Communities,4066,4345,2877,2602,13890,4066,4345,2877,2602,13890
21,Somalia,2019,SOM-19/3485/R3/WASH/INGO/14510,9/11/2020 10:06:27 AM,Overall,4066,4345,2877,2602,13890,4066,4345,2877,2602,13890
21,Somalia,2019,SOM-19/3485/R3/WASH/INGO/14532,2/4/2021 7:42:00 PM,Host Communities,7313,8937,3938,4812,25000,6256,7248,6040,7996,27540
21,Somalia,2019,SOM-19/3485/R3/WASH/INGO/14532,2/4/2021 7:42:00 PM,Overall,7313,8937,3938,4812,25000,6256,7248,6040,7996,27540
21,Somalia,2019,SOM-19/3485/R3/WASH/INGO/14571,11/4/2020 10:03:48 AM,Host Communities,1500,1500,1500,1500,6000,1500,1500,1500,1500,6000
21,Somalia,2019,SOM-19/3485/R3/WASH/INGO/14571,11/4/2020 10:03:48 AM,Internally Displaced People,6000,6000,6000,6000,24000,5921,6000,5709,5890,23520
21,Somalia,2019,SOM-19/3485/R3/WASH/INGO/14571,11/4/2020 10:03:48 AM,Overall,7500,7500,7500,7500,30000,7421,7500,7209,7390,29520
21,Somalia,2019,SOM-19/3485/R3/WASH/NGO/14509,9/8/2020 4:52:19 PM,Internally Displaced People,5000,7000,3000,3000,18000,5700,7060,4142,6000,22902
21,Somalia,2019,SOM-19/3485/R3/WASH/NGO/14509,9/8/2020 4:52:19 PM,Overall,5000,7000,3000,3000,18000,5700,7060,4142,6000,22902
21,Somalia,2019,SOM-19/3485/R3/WASH/NGO/14524,7/22/2020 12:05:56 PM,Host Communities,1391,3564,830,1421,7206,4023,5095,2170,2265,13553
21,Somalia,2019,SOM-19/3485/R3/WASH/NGO/14524,7/22/2020 12:05:56 PM,Internally Displaced People,2411,2670,1238,1680,7999,4824,6295,2000,1881,15000
21,Somalia,2019,SOM-19/3485/R3/WASH/NGO/14524,7/22/2020 12:05:56 PM,Overall,3802,6234,2068,3101,15205,8847,11390,4170,4146,28553
21,Somalia,2019,SOM-19/3485/R3/WASH/NGO/14543,9/7/2020 7:41:34 AM,Host Communities,1800,3000,3600,3600,12000,1800,3000,3600,3600,12000
21,Somalia,2019,SOM-19/3485/R3/WASH/NGO/14543,9/7/2020 7:41:34 AM,Internally Displaced People,1200,2000,2400,2400,8000,1200,2000,2400,2400,8000
21,Somalia,2019,SOM-19/3485/R3/WASH/NGO/14543,9/7/2020 7:41:34 AM,Overall,3000,5000,6000,6000,20000,3000,5000,6000,6000,20000
21,Somalia,2019,SOM-19/3485/R3/WASH/NGO/14566,10/21/2020 7:34:49 AM,Host Communities,2800,2900,2107,2193,10000,2800,2900,2107,2193,10000
21,Somalia,2019,SOM-19/3485/R3/WASH/NGO/14566,10/21/2020 7:34:49 AM,Internally Displaced People,2870,2972,2153,2255,10250,2870,2972,2153,2255,10250
21,Somalia,2019,SOM-19/3485/R3/WASH/NGO/14566,10/21/2020 7:34:49 AM,Overall,5670,5872,4260,4448,20250,5670,5872,4260,4448,20250
21,Somalia,2019,SOM-19/3485/R3/WASH-H-Nut/INGO/14582,2/3/2021 6:57:28 AM,Other,15032,31553,12139,13152,71876,12405,61742,16162,16136,106445
21,Somalia,2019,SOM-19/3485/R3/WASH-H-Nut/INGO/14582,2/3/2021 6:57:28 AM,Overall,15032,31553,12139,13152,71876,12405,61742,16162,16136,106445
21,Somalia,2019,SOM-19/3485/RA1/EP/INGO/13245,7/8/2020 8:04:32 AM,Host Communities,26400,21600,0,0,48000,25970,27030,0,0,53000
21,Somalia,2019,SOM-19/3485/RA1/EP/INGO/13245,7/8/2020 8:04:32 AM,Internally Displaced People,17600,14400,0,0,32000,23030,23970,0,0,47000
21,Somalia,2019,SOM-19/3485/RA1/EP/INGO/13245,7/8/2020 8:04:32 AM,Overall,44000,36000,0,0,80000,49000,51000,0,0,100000
21,Somalia,2019,SOM-19/3485/RA1/EP/INGO/14833,6/2/2021 8:33:32 AM,Internally Displaced People,50,50,0,0,100,55,55,0,0,110
21,Somalia,2019,SOM-19/3485/RA1/EP/INGO/14833,6/2/2021 8:33:32 AM,Overall,50,50,0,0,100,55,55,0,0,110
21,Somalia,2019,SOM-19/3485/RA1/EP/INGO/14835,2/24/2021 6:59:34 AM,Other,7500,2500,0,0,10000,7500,2500,0,0,10000
21,Somalia,2019,SOM-19/3485/RA1/EP/INGO/14835,2/24/2021 6:59:34 AM,Overall,7500,2500,0,0,10000,7500,2500,0,0,10000
21,Somalia,2019,SOM-19/3485/RA1/EP/UN/14836,7/30/2023 7:59:09 AM,Other,200,200,0,0,400,51,51,0,0,102
21,Somalia,2019,SOM-19/3485/RA1/EP/UN/14836,7/30/2023 7:59:09 AM,Overall,200,200,0,0,400,51,51,0,0,102
21,Somalia,2019,SOM-19/3485/RA1/WASH/UN/12984,1/26/2020 11:55:29 AM,Host Communities,10488,11592,16560,16560,55200,11805,12354,13728,17023,54910
21,Somalia,2019,SOM-19/3485/RA1/WASH/UN/12984,1/26/2020 11:55:29 AM,Internally Displaced People,15732,17388,24840,24840,82800,23542,24637,27374,33943,109496
21,Somalia,2019,SOM-19/3485/RA1/WASH/UN/12984,1/26/2020 11:55:29 AM,Overall,26220,28980,41400,41400,138000,35347,36991,41102,50966,164406
21,Somalia,2019,SOM-19/3485/RA2/CCCM/INGO/13265,9/7/2020 8:06:25 AM,Internally Displaced People,2000,3500,2900,3600,12000,1800,3250,2800,2970,10820
21,Somalia,2019,SOM-19/3485/RA2/CCCM/INGO/13265,9/7/2020 8:06:25 AM,Overall,2000,3500,2900,3600,12000,1800,3250,2800,2970,10820
21,Somalia,2019,SOM-19/3485/RA2/CCCM/NGO/13273,7/8/2020 10:17:15 AM,Internally Displaced People,6282,5760,1680,1608,15330,5336,7022,1551,2103,16012
21,Somalia,2019,SOM-19/3485/RA2/CCCM/NGO/13273,7/8/2020 10:17:15 AM,Overall,6282,5760,1680,1608,15330,5336,7022,1551,2103,16012
21,Somalia,2019,SOM-19/3485/RA2/Ed/INGO/13826,10/21/2020 8:14:03 AM,Host Communities,0,0,800,600,1400,0,0,800,600,1400
21,Somalia,2019,SOM-19/3485/RA2/Ed/INGO/13826,10/21/2020 8:14:03 AM,Internally Displaced People,0,0,1400,1200,2600,0,0,1400,1200,2600
21,Somalia,2019,SOM-19/3485/RA2/Ed/INGO/13826,10/21/2020 8:14:03 AM,Overall,0,0,2200,1800,4000,0,0,2200,1800,4000
21,Somalia,2019,SOM-19/3485/RA2/Ed/NGO/13787,8/19/2020 7:52:29 AM,Other,127,57,0,0,184,127,57,0,0,184
21,Somalia,2019,SOM-19/3485/RA2/Ed/NGO/13787,8/19/2020 7:52:29 AM,Overall,127,57,0,0,184,127,57,0,0,184
21,Somalia,2019,SOM-19/3485/RA2/Ed-Prot/NGO/13283,6/1/2020 6:10:55 AM,Host Communities,44,25,1141,1092,2302,44,25,1141,1092,2302
21,Somalia,2019,SOM-19/3485/RA2/Ed-Prot/NGO/13283,6/1/2020 6:10:55 AM,Internally Displaced People,38,28,1388,1247,2701,38,28,1388,1247,2701
21,Somalia,2019,SOM-19/3485/RA2/Ed-Prot/NGO/13283,6/1/2020 6:10:55 AM,Overall,82,53,2529,2339,5003,82,53,2529,2339,5003
21,Somalia,2019,SOM-19/3485/RA2/FSC/INGO/13263,7/23/2020 6:55:43 AM,Other,1589,2142,2287,2229,8247,1635,1655,3349,3405,10044
21,Somalia,2019,SOM-19/3485/RA2/FSC/INGO/13263,7/23/2020 6:55:43 AM,Overall,1589,2142,2287,2229,8247,1635,1655,3349,3405,10044
21,Somalia,2019,SOM-19/3485/RA2/FSC/INGO/13266,7/8/2020 10:38:42 AM,Host Communities,2798,2709,2188,2190,9885,2314,2950,1507,1588,8359
21,Somalia,2019,SOM-19/3485/RA2/FSC/INGO/13266,7/8/2020 10:38:42 AM,Internally Displaced People,936,908,735,736,3315,1544,1967,1434,1591,6536
21,Somalia,2019,SOM-19/3485/RA2/FSC/INGO/13266,7/8/2020 10:38:42 AM,Overall,3734,3617,2923,2926,13200,3858,4917,2941,3179,14895
21,Somalia,2019,SOM-19/3485/RA2/FSC/INGO/13269,7/7/2020 12:08:53 PM,Host Communities,2033,2518,2615,2518,9684,2595,2479,3458,3770,12302
21,Somalia,2019,SOM-19/3485/RA2/FSC/INGO/13269,7/7/2020 12:08:53 PM,Overall,2033,2518,2615,2518,9684,2595,2479,3458,3770,12302
21,Somalia,2019,SOM-19/3485/RA2/FSC/INGO/13293,7/21/2020 11:59:13 AM,Host Communities,775,775,1265,1265,4080,1108,1108,1808,1808,5832
21,Somalia,2019,SOM-19/3485/RA2/FSC/INGO/13293,7/21/2020 11:59:13 AM,Internally Displaced People,137,137,223,223,720,196,196,318,319,1029
21,Somalia,2019,SOM-19/3485/RA2/FSC/INGO/13293,7/21/2020 11:59:13 AM,Overall,912,912,1488,1488,4800,1304,1304,2126,2127,6861
21,Somalia,2019,SOM-19/3485/RA2/FSC/NGO/13282,6/19/2020 10:08:03 AM,Host Communities,200,186,162,120,668,200,186,162,120,668
21,Somalia,2019,SOM-19/3485/RA2/FSC/NGO/13282,6/19/2020 10:08:03 AM,Internally Displaced People,557,600,595,580,2332,557,600,595,580,2332
21,Somalia,2019,SOM-19/3485/RA2/FSC/NGO/13282,6/19/2020 10:08:03 AM,Overall,757,786,757,700,3000,757,786,757,700,3000
21,Somalia,2019,SOM-19/3485/RA2/H-Nut/NGO/13268,8/7/2020 7:12:28 AM,Host Communities,600,650,900,800,2950,430,802,784,852,2868
21,Somalia,2019,SOM-19/3485/RA2/H-Nut/NGO/13268,8/7/2020 7:12:28 AM,Internally Displaced People,1500,3000,3100,3400,11000,1379,2969,3117,3281,10746
21,Somalia,2019,SOM-19/3485/RA2/H-Nut/NGO/13268,8/7/2020 7:12:28 AM,Overall,2100,3650,4000,4200,13950,1809,3771,3901,4133,13614
21,Somalia,2019,SOM-19/3485/RA2/H-Nut/NGO/13289,2/19/2021 11:49:55 AM,Host Communities,2100,3500,4200,4200,14000,5488,8085,4800,4591,22964
21,Somalia,2019,SOM-19/3485/RA2/H-Nut/NGO/13289,2/19/2021 11:49:55 AM,Internally Displaced People,3150,5250,6300,6300,21000,3673,6615,3701,4664,18653
21,Somalia,2019,SOM-19/3485/RA2/H-Nut/NGO/13289,2/19/2021 11:49:55 AM,Overall,5250,8750,10500,10500,35000,9161,14700,8501,9255,41617
21,Somalia,2019,SOM-19/3485/RA2/Nut-H/NGO/13260,3/20/2021 5:33:19 AM,Host Communities,0,3435,1620,1980,7035,2000,7929,9112,10535,29576
21,Somalia,2019,SOM-19/3485/RA2/Nut-H/NGO/13260,3/20/2021 5:33:19 AM,Other,0,180,0,0,180,0,360,0,0,360
21,Somalia,2019,SOM-19/3485/RA2/Nut-H/NGO/13260,3/20/2021 5:33:19 AM,Overall,0,3615,1620,1980,7215,2000,8289,9112,10535,29936
21,Somalia,2019,SOM-19/3485/RA2/Nut-H/NGO/13261,7/28/2021 7:16:56 AM,Host Communities,7,2244,1942,2331,6524,7,1235,1085,1377,3704
21,Somalia,2019,SOM-19/3485/RA2/Nut-H/NGO/13261,7/28/2021 7:16:56 AM,Internally Displaced People,2,856,505,757,2120,2,291,193,257,743
21,Somalia,2019,SOM-19/3485/RA2/Nut-H/NGO/13261,7/28/2021 7:16:56 AM,Other,31,387,275,867,1560,31,131,148,194,504
21,Somalia,2019,SOM-19/3485/RA2/Nut-H/NGO/13261,7/28/2021 7:16:56 AM,Overall,40,3487,2722,3955,10204,40,1657,1426,1828,4951
21,Somalia,2019,SOM-19/3485/RA2/Prot/INGO/13255,9/23/2020 6:14:26 AM,Host Communities,80,185,50,50,365,82,193,47,52,374
21,Somalia,2019,SOM-19/3485/RA2/Prot/INGO/13255,9/23/2020 6:14:26 AM,Internally Displaced People,1145,2215,250,250,3860,1170,2330,280,315,4095
21,Somalia,2019,SOM-19/3485/RA2/Prot/INGO/13255,9/23/2020 6:14:26 AM,Other,20,20,600,845,1485,21,22,630,860,1533
21,Somalia,2019,SOM-19/3485/RA2/Prot/INGO/13255,9/23/2020 6:14:26 AM,Overall,1245,2420,900,1145,5710,1273,2545,957,1227,6002
21,Somalia,2019,SOM-19/3485/RA2/Prot/NGO/13267,6/9/2020 7:30:27 PM,Host Communities,100,320,150,150,720,119,386,147,183,835
21,Somalia,2019,SOM-19/3485/RA2/Prot/NGO/13267,6/9/2020 7:30:27 PM,Internally Displaced People,1140,3400,300,340,5180,1045,3459,311,376,5191
21,Somalia,2019,SOM-19/3485/RA2/Prot/NGO/13267,6/9/2020 7:30:27 PM,Overall,1240,3720,450,490,5900,1164,3845,458,559,6026
21,Somalia,2019,SOM-19/3485/RA2/Prot-CCCM/NGO/13287,7/10/2020 7:55:41 AM,Internally Displaced People,3220,10072,4328,6360,23980,5541,9987,1775,3212,20515
21,Somalia,2019,SOM-19/3485/RA2/Prot-CCCM/NGO/13287,7/10/2020 7:55:41 AM,Overall,3220,10072,4328,6360,23980,5541,9987,1775,3212,20515
21,Somalia,2019,SOM-19/3485/RA2/Shelter/NGO/13254,5/28/2020 2:02:56 PM,Host Communities,432,576,216,216,1440,432,576,216,216,1440
21,Somalia,2019,SOM-19/3485/RA2/Shelter/NGO/13254,5/28/2020 2:02:56 PM,Internally Displaced People,1728,2304,864,864,5760,1728,2304,864,864,5760
21,Somalia,2019,SOM-19/3485/RA2/Shelter/NGO/13254,5/28/2020 2:02:56 PM,Overall,2160,2880,1080,1080,7200,2160,2880,1080,1080,7200
21,Somalia,2019,SOM-19/3485/RA2/Shelter/NGO/13285,6/21/2020 7:37:53 AM,Host Communities,100,120,300,250,770,100,120,300,250,770
21,Somalia,2019,SOM-19/3485/RA2/Shelter/NGO/13285,6/21/2020 7:37:53 AM,Internally Displaced People,700,880,1000,1150,3730,700,880,1000,1150,3730
21,Somalia,2019,SOM-19/3485/RA2/Shelter/NGO/13285,6/21/2020 7:37:53 AM,Overall,800,1000,1300,1400,4500,800,1000,1300,1400,4500
21,Somalia,2019,SOM-19/3485/RA2/WASH/INGO/13253,1/19/2021 1:54:56 PM,Host Communities,4226,4008,4000,4500,16734,4277,4103,4419,4392,17191
21,Somalia,2019,SOM-19/3485/RA2/WASH/INGO/13253,1/19/2021 1:54:56 PM,Internally Displaced People,1150,1300,1200,1416,5066,1201,1472,1391,1467,5531
21,Somalia,2019,SOM-19/3485/RA2/WASH/INGO/13253,1/19/2021 1:54:56 PM,Overall,5376,5308,5200,5916,21800,5478,5575,5810,5859,22722
21,Somalia,2019,SOM-19/3485/RA2/WASH/NGO/13277,11/12/2020 1:32:41 PM,Host Communities,1000,2000,2450,1260,6710,1000,2000,2450,1260,6710
21,Somalia,2019,SOM-19/3485/RA2/WASH/NGO/13277,11/12/2020 1:32:41 PM,Internally Displaced People,500,1500,2500,2540,7040,500,1500,2500,2450,6950
21,Somalia,2019,SOM-19/3485/RA2/WASH/NGO/13277,11/12/2020 1:32:41 PM,Overall,1500,3500,4950,3800,13750,1500,3500,4950,3710,13660
21,Somalia,2019,SOM-19/3485/SA1/CCCM/INGO/12385,7/15/2020 12:52:13 PM,Internally Displaced People,8155,10603,11421,10601,40780,8155,10603,11421,10601,40780
21,Somalia,2019,SOM-19/3485/SA1/CCCM/INGO/12385,7/15/2020 12:52:13 PM,Overall,8155,10603,11421,10601,40780,8155,10603,11421,10601,40780
21,Somalia,2019,SOM-19/3485/SA1/CCCM/NGO/12351,7/13/2020 5:37:26 AM,Internally Displaced People,1033,1720,640,810,4203,1534,2107,1329,1697,6667
21,Somalia,2019,SOM-19/3485/SA1/CCCM/NGO/12351,7/13/2020 5:37:26 AM,Overall,1033,1720,640,810,4203,1534,2107,1329,1697,6667
21,Somalia,2019,SOM-19/3485/SA1/CCCM/NGO/12443,7/16/2020 2:21:13 PM,Host Communities,3240,4320,1620,1620,10800,3240,4320,1620,1620,10800
21,Somalia,2019,SOM-19/3485/SA1/CCCM/NGO/12443,7/16/2020 2:21:13 PM,Internally Displaced People,12960,17280,6480,6480,43200,12960,17280,6480,6480,43200
21,Somalia,2019,SOM-19/3485/SA1/CCCM/NGO/12443,7/16/2020 2:21:13 PM,Overall,16200,21600,8100,8100,54000,16200,21600,8100,8100,54000
21,Somalia,2019,SOM-19/3485/SA1/CCCM/NGO/12484,7/15/2020 12:07:41 PM,Internally Displaced People,7031,12646,8643,10326,38646,7713,14230,4484,8448,34875
21,Somalia,2019,SOM-19/3485/SA1/CCCM/NGO/12484,7/15/2020 12:07:41 PM,Overall,7031,12646,8643,10326,38646,7713,14230,4484,8448,34875
21,Somalia,2019,SOM-19/3485/SA1/Ed/INGO/12352,3/8/2021 7:10:46 AM,Internally Displaced People,64,64,1070,1075,2273,64,64,1070,1075,2273
21,Somalia,2019,SOM-19/3485/SA1/Ed/INGO/12352,3/8/2021 7:10:46 AM,Overall,64,64,1070,1075,2273,64,64,1070,1075,2273
21,Somalia,2019,SOM-19/3485/SA1/Ed/INGO/12463,2/3/2021 1:00:06 PM,Host Communities,90,37,877,810,1814,94,47,933,718,1792
21,Somalia,2019,SOM-19/3485/SA1/Ed/INGO/12463,2/3/2021 1:00:06 PM,Internally Displaced People,90,43,2633,2430,5196,80,32,2879,2231,5222
21,Somalia,2019,SOM-19/3485/SA1/Ed/INGO/12463,2/3/2021 1:00:06 PM,Overall,180,80,3510,3240,7010,174,79,3812,2949,7014
21,Somalia,2019,SOM-19/3485/SA1/Ed/NGO/12346,3/9/2021 6:35:53 AM,Host Communities,20,5,300,200,525,20,5,303,197,525
21,Somalia,2019,SOM-19/3485/SA1/Ed/NGO/12346,3/9/2021 6:35:53 AM,Internally Displaced People,75,70,1000,1000,2145,73,72,1000,1000,2145
21,Somalia,2019,SOM-19/3485/SA1/Ed/NGO/12346,3/9/2021 6:35:53 AM,Overall,95,75,1300,1200,2670,93,77,1303,1197,2670
21,Somalia,2019,SOM-19/3485/SA1/Ed/NGO/12357,6/3/2020 8:39:11 AM,Host Communities,6,10,50,100,166,10,6,44,50,110
21,Somalia,2019,SOM-19/3485/SA1/Ed/NGO/12357,6/3/2020 8:39:11 AM,Internally Displaced People,43,29,782,668,1522,48,40,844,974,1906
21,Somalia,2019,SOM-19/3485/SA1/Ed/NGO/12357,6/3/2020 8:39:11 AM,Overall,49,39,832,768,1688,58,46,888,1024,2016
21,Somalia,2019,SOM-19/3485/SA1/Ed/NGO/12429,7/21/2020 6:48:48 AM,Internally Displaced People,38,38,1617,1434,3127,52,32,1663,1699,3446
21,Somalia,2019,SOM-19/3485/SA1/Ed/NGO/12429,7/21/2020 6:48:48 AM,Overall,38,38,1617,1434,3127,52,32,1663,1699,3446
21,Somalia,2019,SOM-19/3485/SA1/Ed-Prot/INGO/12388,9/28/2020 4:50:12 PM,Host Communities,4600,3050,2420,1599,11669,1835,2188,3034,1902,8959
21,Somalia,2019,SOM-19/3485/SA1/Ed-Prot/INGO/12388,9/28/2020 4:50:12 PM,Internally Displaced People,1104,732,710,648,3194,1890,1127,780,761,4558
21,Somalia,2019,SOM-19/3485/SA1/Ed-Prot/INGO/12388,9/28/2020 4:50:12 PM,Overall,5704,3782,3130,2247,14863,3725,3315,3814,2663,13517
21,Somalia,2019,SOM-19/3485/SA1/Ed-Prot/INGO/12530,9/28/2020 4:47:57 PM,Host Communities,1950,2200,1380,907,6437,1982,2231,2602,2581,9396
21,Somalia,2019,SOM-19/3485/SA1/Ed-Prot/INGO/12530,9/28/2020 4:47:57 PM,Internally Displaced People,750,1100,1304,887,4041,1031,1421,1640,1693,5785
21,Somalia,2019,SOM-19/3485/SA1/Ed-Prot/INGO/12530,9/28/2020 4:47:57 PM,Other,124,56,0,0,180,139,56,0,0,195
21,Somalia,2019,SOM-19/3485/SA1/Ed-Prot/INGO/12530,9/28/2020 4:47:57 PM,Overall,2824,3356,2684,1794,10658,3152,3708,4242,4274,15376
21,Somalia,2019,SOM-19/3485/SA1/Ed-Prot/NGO/12413,2/24/2021 9:07:18 AM,Host Communities,24,13,447,393,877,15,123,340,390,868
21,Somalia,2019,SOM-19/3485/SA1/Ed-Prot/NGO/12413,2/24/2021 9:07:18 AM,Internally Displaced People,21,20,843,717,1601,18,34,882,666,1600
21,Somalia,2019,SOM-19/3485/SA1/Ed-Prot/NGO/12413,2/24/2021 9:07:18 AM,Overall,45,33,1290,1110,2478,33,157,1222,1056,2468
21,Somalia,2019,SOM-19/3485/SA1/Ed-Prot/NGO/12511,7/8/2020 7:50:19 AM,Host Communities,914,1360,1096,1160,4530,832,1423,1008,1287,4550
21,Somalia,2019,SOM-19/3485/SA1/Ed-Prot/NGO/12511,7/8/2020 7:50:19 AM,Internally Displaced People,812,1005,1007,1095,3919,752,1012,1113,992,3869
21,Somalia,2019,SOM-19/3485/SA1/Ed-Prot/NGO/12511,7/8/2020 7:50:19 AM,Other,93,94,240,240,667,93,94,240,240,667
21,Somalia,2019,SOM-19/3485/SA1/Ed-Prot/NGO/12511,7/8/2020 7:50:19 AM,Overall,1819,2459,2343,2495,9116,1677,2529,2361,2519,9086
21,Somalia,2019,SOM-19/3485/SA1/FSC/INGO/12348,1/31/2020 9:18:40 AM,Host Communities,405,505,2525,2025,5460,405,505,2525,2025,5460
21,Somalia,2019,SOM-19/3485/SA1/FSC/INGO/12348,1/31/2020 9:18:40 AM,Overall,405,505,2525,2025,5460,405,505,2525,2025,5460
21,Somalia,2019,SOM-19/3485/SA1/FSC/INGO/12430,5/28/2020 2:30:52 PM,Internally Displaced People,2788,4196,2328,2328,11640,1958,3226,3110,3226,11520
21,Somalia,2019,SOM-19/3485/SA1/FSC/INGO/12430,5/28/2020 2:30:52 PM,Overall,2788,4196,2328,2328,11640,1958,3226,3110,3226,11520
21,Somalia,2019,SOM-19/3485/SA1/FSC/INGO/12471,7/20/2020 11:07:37 AM,Internally Displaced People,870,2175,652,653,4350,870,2175,652,653,4350
21,Somalia,2019,SOM-19/3485/SA1/FSC/INGO/12471,7/20/2020 11:07:37 AM,Overall,870,2175,652,653,4350,870,2175,652,653,4350
21,Somalia,2019,SOM-19/3485/SA1/FSC/INGO/12507,6/22/2020 1:13:59 PM,Host Communities,1160,1910,1842,1910,6822,1162,1255,4103,1508,8028
21,Somalia,2019,SOM-19/3485/SA1/FSC/INGO/12507,6/22/2020 1:13:59 PM,Overall,1160,1910,1842,1910,6822,1162,1255,4103,1508,8028
21,Somalia,2019,SOM-19/3485/SA1/FSC/INGO/12532,1/28/2020 6:49:59 PM,Host Communities,1289,1934,1240,1292,5755,1353,2014,1244,1298,5909
21,Somalia,2019,SOM-19/3485/SA1/FSC/INGO/12532,1/28/2020 6:49:59 PM,Internally Displaced People,322,484,310,323,1439,350,504,311,331,1496
21,Somalia,2019,SOM-19/3485/SA1/FSC/INGO/12532,1/28/2020 6:49:59 PM,Overall,1611,2418,1550,1615,7194,1703,2518,1555,1629,7405
21,Somalia,2019,SOM-19/3485/SA1/FSC/INGO/12581,7/8/2020 9:50:58 AM,Host Communities,650,650,1300,1300,3900,778,825,1293,0,2896
21,Somalia,2019,SOM-19/3485/SA1/FSC/INGO/12581,7/8/2020 9:50:58 AM,Overall,650,650,1300,1300,3900,778,825,1293,0,2896
21,Somalia,2019,SOM-19/3485/SA1/FSC/NGO/12477,12/3/2019 6:25:56 AM,Host Communities,810,1012,676,878,3376,837,972,1283,1334,4426
21,Somalia,2019,SOM-19/3485/SA1/FSC/NGO/12477,12/3/2019 6:25:56 AM,Internally Displaced People,348,434,290,376,1448,281,327,428,442,1478
21,Somalia,2019,SOM-19/3485/SA1/FSC/NGO/12477,12/3/2019 6:25:56 AM,Overall,1158,1446,966,1254,4824,1118,1299,1711,1776,5904
21,Somalia,2019,SOM-19/3485/SA1/FSC/NGO/12488,6/10/2020 6:55:24 PM,Host Communities,178,200,217,245,840,84,250,240,205,779
21,Somalia,2019,SOM-19/3485/SA1/FSC/NGO/12488,6/10/2020 6:55:24 PM,Internally Displaced People,711,801,869,979,3360,803,779,890,1003,3475
21,Somalia,2019,SOM-19/3485/SA1/FSC/NGO/12488,6/10/2020 6:55:24 PM,Overall,889,1001,1086,1224,4200,887,1029,1130,1208,4254
21,Somalia,2019,SOM-19/3485/SA1/FSC/NGO/12491,1/6/2020 7:18:38 AM,Internally Displaced People,228,312,300,360,1200,263,274,318,342,1197
21,Somalia,2019,SOM-19/3485/SA1/FSC/NGO/12491,1/6/2020 7:18:38 AM,Other,789,963,840,1008,3600,910,845,889,959,3603
21,Somalia,2019,SOM-19/3485/SA1/FSC/NGO/12491,1/6/2020 7:18:38 AM,Overall,1017,1275,1140,1368,4800,1173,1119,1207,1301,4800
21,Somalia,2019,SOM-19/3485/SA1/FSC/NGO/12495,7/3/2020 3:30:43 AM,Host Communities,400,700,700,700,2500,387,859,622,783,2651
21,Somalia,2019,SOM-19/3485/SA1/FSC/NGO/12495,7/3/2020 3:30:43 AM,Internally Displaced People,200,300,300,300,1100,170,412,255,326,1163
21,Somalia,2019,SOM-19/3485/SA1/FSC/NGO/12495,7/3/2020 3:30:43 AM,Overall,600,1000,1000,1000,3600,557,1271,877,1109,3814
21,Somalia,2019,SOM-19/3485/SA1/FSC/NGO/12522,2/26/2020 11:11:56 AM,Host Communities,303,289,424,424,1440,303,289,424,424,1440
21,Somalia,2019,SOM-19/3485/SA1/FSC/NGO/12522,2/26/2020 11:11:56 AM,Internally Displaced People,1119,1075,1578,1578,5350,1119,1075,1578,1578,5350
21,Somalia,2019,SOM-19/3485/SA1/FSC/NGO/12522,2/26/2020 11:11:56 AM,Overall,1422,1364,2002,2002,6790,1422,1364,2002,2002,6790
21,Somalia,2019,SOM-19/3485/SA1/FSC/NGO/12533,7/6/2020 1:50:55 PM,Host Communities,270,450,540,540,1800,236,394,472,472,1574
21,Somalia,2019,SOM-19/3485/SA1/FSC/NGO/12533,7/6/2020 1:50:55 PM,Internally Displaced People,90,150,180,180,600,79,131,158,158,526
21,Somalia,2019,SOM-19/3485/SA1/FSC/NGO/12533,7/6/2020 1:50:55 PM,Overall,360,600,720,720,2400,315,525,630,630,2100
21,Somalia,2019,SOM-19/3485/SA1/FSC/NGO/12558,7/22/2020 10:49:02 AM,Host Communities,1591,2387,530,796,5304,1591,2387,530,796,5304
21,Somalia,2019,SOM-19/3485/SA1/FSC/NGO/12558,7/22/2020 10:49:02 AM,Internally Displaced People,720,1080,240,360,2400,720,1080,240,360,2400
21,Somalia,2019,SOM-19/3485/SA1/FSC/NGO/12558,7/22/2020 10:49:02 AM,Overall,2311,3467,770,1156,7704,2311,3467,770,1156,7704
21,Somalia,2019,SOM-19/3485/SA1/FSC/O/12479,1/28/2020 12:23:40 PM,Host Communities,105,362,25,25,517,105,362,25,25,517
21,Somalia,2019,SOM-19/3485/SA1/FSC/O/12479,1/28/2020 12:23:40 PM,Internally Displaced People,47,200,28,33,308,47,200,28,33,308
21,Somalia,2019,SOM-19/3485/SA1/FSC/O/12479,1/28/2020 12:23:40 PM,Overall,152,562,53,58,825,152,562,53,58,825
21,Somalia,2019,SOM-19/3485/SA1/H/INGO/12472,8/31/2020 1:52:04 PM,Host Communities,130,1716,1700,1600,5146,18,3372,1063,1227,5680
21,Somalia,2019,SOM-19/3485/SA1/H/INGO/12472,8/31/2020 1:52:04 PM,Overall,130,1716,1700,1600,5146,18,3372,1063,1227,5680
21,Somalia,2019,SOM-19/3485/SA1/H/INGO/12502,7/8/2020 7:32:39 AM,Host Communities,13680,26432,6248,6249,52609,10654,41991,30993,31328,114966
21,Somalia,2019,SOM-19/3485/SA1/H/INGO/12502,7/8/2020 7:32:39 AM,Overall,13680,26432,6248,6249,52609,10654,41991,30993,31328,114966
21,Somalia,2019,SOM-19/3485/SA1/H/INGO/12542,9/9/2020 2:13:46 PM,Host Communities,9984,10816,2600,2600,26000,3470,10107,3729,5061,22367
21,Somalia,2019,SOM-19/3485/SA1/H/INGO/12542,9/9/2020 2:13:46 PM,Internally Displaced People,5376,5824,1400,1400,14000,3011,3261,784,784,7840
21,Somalia,2019,SOM-19/3485/SA1/H/INGO/12542,9/9/2020 2:13:46 PM,Overall,15360,16640,4000,4000,40000,6481,13368,4513,5845,30207
21,Somalia,2019,SOM-19/3485/SA1/H/INGO/12547,7/10/2020 7:33:32 AM,Host Communities,1348,4319,4260,4300,14227,8239,11396,7115,7424,34174
21,Somalia,2019,SOM-19/3485/SA1/H/INGO/12547,7/10/2020 7:33:32 AM,Overall,1348,4319,4260,4300,14227,8239,11396,7115,7424,34174
21,Somalia,2019,SOM-19/3485/SA1/H/INGO/12552,10/21/2020 8:11:45 AM,Host Communities,120,3320,4655,4845,12940,1544,9686,3867,3391,18488
21,Somalia,2019,SOM-19/3485/SA1/H/INGO/12552,10/21/2020 8:11:45 AM,Overall,120,3320,4655,4845,12940,1544,9686,3867,3391,18488
21,Somalia,2019,SOM-19/3485/SA1/H/NGO/12425,9/4/2020 7:08:33 AM,Host Communities,2362,2929,1890,2268,9449,2362,2929,1890,2268,9449
21,Somalia,2019,SOM-19/3485/SA1/H/NGO/12425,9/4/2020 7:08:33 AM,Internally Displaced People,2888,3581,2310,2772,11551,2888,3981,2360,2772,12001
21,Somalia,2019,SOM-19/3485/SA1/H/NGO/12425,9/4/2020 7:08:33 AM,Overall,5250,6510,4200,5040,21000,5250,6910,4250,5040,21450
21,Somalia,2019,SOM-19/3485/SA1/H/NGO/12442,1/11/2021 10:44:29 AM,Host Communities,3305,3841,893,893,8932,3894,3248,878,940,8960
21,Somalia,2019,SOM-19/3485/SA1/H/NGO/12442,1/11/2021 10:44:29 AM,Internally Displaced People,2069,3234,615,550,6468,1372,2167,629,634,4802
21,Somalia,2019,SOM-19/3485/SA1/H/NGO/12442,1/11/2021 10:44:29 AM,Overall,5374,7075,1508,1443,15400,5266,5415,1507,1574,13762
21,Somalia,2019,SOM-19/3485/SA1/H/NGO/12476,10/21/2020 7:45:43 AM,Host Communities,9436,14386,2475,2475,28772,9436,14386,2890,2885,29597
21,Somalia,2019,SOM-19/3485/SA1/H/NGO/12476,10/21/2020 7:45:43 AM,Other,11,35,0,0,46,10,20,0,0,30
21,Somalia,2019,SOM-19/3485/SA1/H/NGO/12476,10/21/2020 7:45:43 AM,Overall,9447,14421,2475,2475,28818,9446,14406,2890,2885,29627
21,Somalia,2019,SOM-19/3485/SA1/H/O/12512,7/16/2020 7:12:08 AM,Host Communities,580,4640,2876,2981,11077,1879,5655,4520,4796,16850
21,Somalia,2019,SOM-19/3485/SA1/H/O/12512,7/16/2020 7:12:08 AM,Internally Displaced People,580,4640,2876,2982,11078,1734,5220,4173,4427,15554
21,Somalia,2019,SOM-19/3485/SA1/H/O/12512,7/16/2020 7:12:08 AM,Overall,1160,9280,5752,5963,22155,3613,10875,8693,9223,32404
21,Somalia,2019,SOM-19/3485/SA1/Nut/INGO/12478,2/19/2021 9:21:01 AM,Host Communities,236,3381,3547,3278,10442,291,2396,2253,2379,7319
21,Somalia,2019,SOM-19/3485/SA1/Nut/INGO/12478,2/19/2021 9:21:01 AM,Overall,236,3381,3547,3278,10442,291,2396,2253,2379,7319
21,Somalia,2019,SOM-19/3485/SA1/Nut/INGO/12560,7/5/2021 4:24:17 PM,Host Communities,10500,14000,3820,3821,32141,1583,14320,8637,13240,37780
21,Somalia,2019,SOM-19/3485/SA1/Nut/INGO/12560,7/5/2021 4:24:17 PM,Internally Displaced People,8511,10471,4424,4424,27830,678,8730,9560,10066,29034
21,Somalia,2019,SOM-19/3485/SA1/Nut/INGO/12560,7/5/2021 4:24:17 PM,Overall,19011,24471,8244,8245,59971,2261,23050,18197,23306,66814
21,Somalia,2019,SOM-19/3485/SA1/Nut/NGO/12494,5/12/2021 8:24:00 AM,Host Communities,0,800,1000,1000,2800,0,713,874,939,2526
21,Somalia,2019,SOM-19/3485/SA1/Nut/NGO/12494,5/12/2021 8:24:00 AM,Internally Displaced People,0,400,500,500,1400,0,291,259,447,997
21,Somalia,2019,SOM-19/3485/SA1/Nut/NGO/12494,5/12/2021 8:24:00 AM,Overall,0,1200,1500,1500,4200,0,1004,1133,1386,3523
21,Somalia,2019,SOM-19/3485/SA1/Nut/NGO/12516,2/1/2021 7:10:58 PM,Host Communities,0,1226,2000,2000,5226,10,4387,4341,4300,13038
21,Somalia,2019,SOM-19/3485/SA1/Nut/NGO/12516,2/1/2021 7:10:58 PM,Internally Displaced People,10,1000,1415,1420,3845,50,2400,2353,2300,7103
21,Somalia,2019,SOM-19/3485/SA1/Nut/NGO/12516,2/1/2021 7:10:58 PM,Other,20,26,0,0,46,20,26,0,0,46
21,Somalia,2019,SOM-19/3485/SA1/Nut/NGO/12516,2/1/2021 7:10:58 PM,Overall,30,2252,3415,3420,9117,80,6813,6694,6600,20187
21,Somalia,2019,SOM-19/3485/SA1/Nut/NGO/12525,2/19/2021 9:25:27 AM,Host Communities,0,17345,19272,19272,55889,0,24133,22320,24133,70586
21,Somalia,2019,SOM-19/3485/SA1/Nut/NGO/12525,2/19/2021 9:25:27 AM,Internally Displaced People,0,7433,8259,8259,23951,0,10342,9566,10343,30251
21,Somalia,2019,SOM-19/3485/SA1/Nut/NGO/12525,2/19/2021 9:25:27 AM,Other,46,46,0,0,92,46,46,0,0,92
21,Somalia,2019,SOM-19/3485/SA1/Nut/NGO/12525,2/19/2021 9:25:27 AM,Overall,46,24824,27531,27531,79932,46,34521,31886,34476,100929
21,Somalia,2019,SOM-19/3485/SA1/Nut/NGO/12569,2/19/2021 9:18:11 AM,Host Communities,42,162,360,350,914,36,140,280,350,806
21,Somalia,2019,SOM-19/3485/SA1/Nut/NGO/12569,2/19/2021 9:18:11 AM,Internally Displaced People,0,100,80,90,270,0,84,68,77,229
21,Somalia,2019,SOM-19/3485/SA1/Nut/NGO/12569,2/19/2021 9:18:11 AM,Overall,42,262,440,440,1184,36,224,348,427,1035
21,Somalia,2019,SOM-19/3485/SA1/Prot/INGO/12362,9/23/2020 6:17:06 AM,Host Communities,80,185,50,50,365,94,320,50,50,514
21,Somalia,2019,SOM-19/3485/SA1/Prot/INGO/12362,9/23/2020 6:17:06 AM,Internally Displaced People,1145,3215,250,250,4860,1168,3320,550,620,5658
21,Somalia,2019,SOM-19/3485/SA1/Prot/INGO/12362,9/23/2020 6:17:06 AM,Other,20,20,900,1145,2085,32,28,1050,1156,2266
21,Somalia,2019,SOM-19/3485/SA1/Prot/INGO/12362,9/23/2020 6:17:06 AM,Overall,1245,3420,1200,1445,7310,1294,3668,1650,1826,8438
21,Somalia,2019,SOM-19/3485/SA1/Prot/INGO/12376,11/22/2021 12:57:14 PM,Host Communities,366,1244,324,669,2603,929,2012,416,761,4118
21,Somalia,2019,SOM-19/3485/SA1/Prot/INGO/12376,11/22/2021 12:57:14 PM,Internally Displaced People,699,3004,386,1196,5285,1392,3017,623,1141,6173
21,Somalia,2019,SOM-19/3485/SA1/Prot/INGO/12376,11/22/2021 12:57:14 PM,Overall,1065,4248,710,1865,7888,2321,5029,1039,1902,10291
21,Somalia,2019,SOM-19/3485/SA1/Prot/INGO/12469,1/18/2021 7:41:02 AM,Host Communities,1895,2053,2117,2315,8380,2069,2222,2213,2416,8920
21,Somalia,2019,SOM-19/3485/SA1/Prot/INGO/12469,1/18/2021 7:41:02 AM,Internally Displaced People,7580,8212,8548,9260,33600,14208,9393,10187,11014,44802
21,Somalia,2019,SOM-19/3485/SA1/Prot/INGO/12469,1/18/2021 7:41:02 AM,Overall,9475,10265,10665,11575,41980,16277,11615,12400,13430,53722
21,Somalia,2019,SOM-19/3485/SA1/Prot/NGO/12396,11/5/2020 11:18:43 AM,Host Communities,182,1173,367,367,2089,84,1031,102,320,1537
21,Somalia,2019,SOM-19/3485/SA1/Prot/NGO/12396,11/5/2020 11:18:43 AM,Internally Displaced People,310,2487,707,707,4211,318,1984,155,441,2898
21,Somalia,2019,SOM-19/3485/SA1/Prot/NGO/12396,11/5/2020 11:18:43 AM,Overall,492,3660,1074,1074,6300,402,3015,257,761,4435
21,Somalia,2019,SOM-19/3485/SA1/Prot/NGO/12404,7/20/2020 10:58:39 AM,Host Communities,60,210,375,335,980,75,318,514,905,1812
21,Somalia,2019,SOM-19/3485/SA1/Prot/NGO/12404,7/20/2020 10:58:39 AM,Internally Displaced People,300,400,1500,1800,4000,230,568,5868,5878,12544
21,Somalia,2019,SOM-19/3485/SA1/Prot/NGO/12404,7/20/2020 10:58:39 AM,Overall,360,610,1875,2135,4980,305,886,6382,6783,14356
21,Somalia,2019,SOM-19/3485/SA1/Prot/NGO/12462,7/7/2020 10:47:37 AM,Host Communities,149,2189,512,512,3362,159,2287,553,527,3526
21,Somalia,2019,SOM-19/3485/SA1/Prot/NGO/12462,7/7/2020 10:47:37 AM,Internally Displaced People,234,3298,768,768,5068,243,3439,779,775,5236
21,Somalia,2019,SOM-19/3485/SA1/Prot/NGO/12462,7/7/2020 10:47:37 AM,Other,61,44,0,0,105,61,44,0,0,105
21,Somalia,2019,SOM-19/3485/SA1/Prot/NGO/12462,7/7/2020 10:47:37 AM,Overall,444,5531,1280,1280,8535,463,5770,1332,1302,8867
21,Somalia,2019,SOM-19/3485/SA1/Prot/NGO/12559,7/29/2020 7:48:14 AM,Host Communities,500,1500,850,850,3700,64,912,570,264,1810
21,Somalia,2019,SOM-19/3485/SA1/Prot/NGO/12559,7/29/2020 7:48:14 AM,Internally Displaced People,1500,5055,1591,3450,11596,1533,5254,1471,3335,11593
21,Somalia,2019,SOM-19/3485/SA1/Prot/NGO/12559,7/29/2020 7:48:14 AM,Overall,2000,6555,2441,4300,15296,1597,6166,2041,3599,13403
21,Somalia,2019,SOM-19/3485/SA1/Shelter/INGO/12500,2/3/2020 6:26:32 AM,Host Communities,990,990,2310,2310,6600,1386,1403,2203,2395,7387
21,Somalia,2019,SOM-19/3485/SA1/Shelter/INGO/12500,2/3/2020 6:26:32 AM,Internally Displaced People,3959,3959,9241,9241,26400,5542,5611,8814,9581,29548
21,Somalia,2019,SOM-19/3485/SA1/Shelter/INGO/12500,2/3/2020 6:26:32 AM,Overall,4949,4949,11551,11551,33000,6928,7014,11017,11976,36935
21,Somalia,2019,SOM-19/3485/SA1/Shelter/NGO/12383,7/8/2020 10:44:43 AM,Host Communities,2862,3816,1431,1431,9540,2862,3816,1431,1431,9540
21,Somalia,2019,SOM-19/3485/SA1/Shelter/NGO/12383,7/8/2020 10:44:43 AM,Internally Displaced People,6678,8904,3339,3339,22260,6678,8904,3339,3339,22260
21,Somalia,2019,SOM-19/3485/SA1/Shelter/NGO/12383,7/8/2020 10:44:43 AM,Overall,9540,12720,4770,4770,31800,9540,12720,4770,4770,31800
21,Somalia,2019,SOM-19/3485/SA1/Shelter/NGO/12461,1/25/2020 7:47:22 AM,Host Communities,600,600,1140,1000,3340,600,600,1140,1000,3340
21,Somalia,2019,SOM-19/3485/SA1/Shelter/NGO/12461,1/25/2020 7:47:22 AM,Internally Displaced People,3000,3100,2760,2800,11660,3000,3100,2760,2800,11660
21,Somalia,2019,SOM-19/3485/SA1/Shelter/NGO/12461,1/25/2020 7:47:22 AM,Overall,3600,3700,3900,3800,15000,3600,3700,3900,3800,15000
21,Somalia,2019,SOM-19/3485/SA1/Shelter/NGO/12483,1/30/2020 9:24:52 AM,Internally Displaced People,380,1700,380,790,3250,375,1695,385,795,3250
21,Somalia,2019,SOM-19/3485/SA1/Shelter/NGO/12483,1/30/2020 9:24:52 AM,Overall,380,1700,380,790,3250,375,1695,385,795,3250
21,Somalia,2019,SOM-19/3485/SA1/WASH/INGO/12397,7/13/2020 2:03:19 PM,Host Communities,4537,4572,6530,6061,21700,4537,4572,6530,6061,21700
21,Somalia,2019,SOM-19/3485/SA1/WASH/INGO/12397,7/13/2020 2:03:19 PM,Internally Displaced People,663,724,954,959,3300,883,1054,1134,1229,4300
21,Somalia,2019,SOM-19/3485/SA1/WASH/INGO/12397,7/13/2020 2:03:19 PM,Overall,5200,5296,7484,7020,25000,5420,5626,7664,7290,26000
21,Somalia,2019,SOM-19/3485/SA1/WASH/INGO/12410,7/20/2020 10:50:56 AM,Other,14373,14960,9778,9778,48889,10273,12841,12327,15923,51364
21,Somalia,2019,SOM-19/3485/SA1/WASH/INGO/12410,7/20/2020 10:50:56 AM,Overall,14373,14960,9778,9778,48889,10273,12841,12327,15923,51364
21,Somalia,2019,SOM-19/3485/SA1/WASH/INGO/12411,3/15/2021 5:33:08 AM,Host Communities,2339,2546,5181,4790,14856,4368,5376,3360,3696,16800
21,Somalia,2019,SOM-19/3485/SA1/WASH/INGO/12411,3/15/2021 5:33:08 AM,Internally Displaced People,3695,3998,8161,7530,23384,8112,9984,6240,6864,31200
21,Somalia,2019,SOM-19/3485/SA1/WASH/INGO/12411,3/15/2021 5:33:08 AM,Overall,6034,6544,13342,12320,38240,12480,15360,9600,10560,48000
21,Somalia,2019,SOM-19/3485/SA1/WASH/INGO/12470,1/27/2021 8:44:56 AM,Host Communities,8174,9240,9240,8885,35539,7273,8874,10157,8654,34958
21,Somalia,2019,SOM-19/3485/SA1/WASH/INGO/12470,1/27/2021 8:44:56 AM,Internally Displaced People,4087,4620,4620,4442,17769,2743,4317,5930,4457,17447
21,Somalia,2019,SOM-19/3485/SA1/WASH/INGO/12470,1/27/2021 8:44:56 AM,Other,1362,1540,1540,1480,5922,694,1684,2358,2359,7095
21,Somalia,2019,SOM-19/3485/SA1/WASH/INGO/12470,1/27/2021 8:44:56 AM,Overall,13623,15400,15400,14807,59230,10710,14875,18445,15470,59500
21,Somalia,2019,SOM-19/3485/SA1/WASH/NGO/12405,7/22/2020 12:52:22 PM,Host Communities,4186,5441,5023,6278,20928,5300,6200,5100,6328,22928
21,Somalia,2019,SOM-19/3485/SA1/WASH/NGO/12405,7/22/2020 12:52:22 PM,Other,65,65,0,0,130,76,54,0,0,130
21,Somalia,2019,SOM-19/3485/SA1/WASH/NGO/12405,7/22/2020 12:52:22 PM,Overall,4251,5506,5023,6278,21058,5376,6254,5100,6328,23058
21,Somalia,2019,SOM-19/3485/SA1/WASH/NGO/12428,9/11/2020 10:14:15 AM,Host Communities,1020,1700,2040,2040,6800,1800,1805,2040,2040,7685
21,Somalia,2019,SOM-19/3485/SA1/WASH/NGO/12428,9/11/2020 10:14:15 AM,Internally Displaced People,1530,2550,3060,3060,10200,1659,2550,3060,3060,10329
21,Somalia,2019,SOM-19/3485/SA1/WASH/NGO/12428,9/11/2020 10:14:15 AM,Overall,2550,4250,5100,5100,17000,3459,4355,5100,5100,18014
21,Somalia,2019,SOM-19/3485/SA1/WASH/NGO/12554,9/7/2020 8:26:55 AM,Host Communities,3631,3941,4419,4204,16195,3564,3871,4323,4132,15890
21,Somalia,2019,SOM-19/3485/SA1/WASH/NGO/12554,9/7/2020 8:26:55 AM,Internally Displaced People,1282,1437,1915,1540,6174,1249,1400,1874,1499,6022
21,Somalia,2019,SOM-19/3485/SA1/WASH/NGO/12554,9/7/2020 8:26:55 AM,Overall,4913,5378,6334,5744,22369,4813,5271,6197,5631,21912
21,Somalia,2019,SOM-19/3485/SA1/WASH/NGO/12557,7/29/2020 6:39:29 AM,Host Communities,1688,2812,3375,3375,11250,1688,2812,3375,3375,11250
21,Somalia,2019,SOM-19/3485/SA1/WASH/NGO/12557,7/29/2020 6:39:29 AM,Internally Displaced People,563,937,1125,1125,3750,563,937,1125,1125,3750
21,Somalia,2019,SOM-19/3485/SA1/WASH/NGO/12557,7/29/2020 6:39:29 AM,Overall,2251,3749,4500,4500,15000,2251,3749,4500,4500,15000
21,Somalia,2020,SOM-20/3485/RA1/CCCM/NGO/17368,6/11/2021 5:43:34 AM,Internally Displaced People,3400,3400,2800,2800,12400,4077,12869,3657,7348,27951
21,Somalia,2020,SOM-20/3485/RA1/CCCM/NGO/17368,6/11/2021 5:43:34 AM,Overall,3400,3400,2800,2800,12400,4077,12869,3657,7348,27951
21,Somalia,2020,SOM-20/3485/RA1/CCCM/UN/17326,1/28/2022 9:15:31 AM,Internally Displaced People,3641,4794,4983,5750,19168,3641,4794,4983,5750,19168
21,Somalia,2020,SOM-20/3485/RA1/CCCM/UN/17326,1/28/2022 9:15:31 AM,Overall,3641,4794,4983,5750,19168,3641,4794,4983,5750,19168
21,Somalia,2020,SOM-20/3485/RA1/CCCM-EP/NGO/16592,10/21/2021 6:34:24 AM,Internally Displaced People,2883,2747,6626,6009,18265,2883,2747,6626,6009,18265
21,Somalia,2020,SOM-20/3485/RA1/CCCM-EP/NGO/16592,10/21/2021 6:34:24 AM,Overall,2883,2747,6626,6009,18265,2883,2747,6626,6009,18265
21,Somalia,2020,SOM-20/3485/RA1/Ed-Prot-WASH/NGO/17340,9/21/2021 9:20:29 AM,Host Communities,66,60,1200,800,2126,66,60,1205,797,2128
21,Somalia,2020,SOM-20/3485/RA1/Ed-Prot-WASH/NGO/17340,9/21/2021 9:20:29 AM,Overall,66,60,1200,800,2126,66,60,1205,797,2128
21,Somalia,2020,SOM-20/3485/RA1/EP/UN/17405,8/18/2023 5:52:41 AM,Other,33,0,0,0,33,33,0,0,0,33
21,Somalia,2020,SOM-20/3485/RA1/EP/UN/17405,8/18/2023 5:52:41 AM,Overall,33,0,0,0,33,33,0,0,0,33
21,Somalia,2020,SOM-20/3485/RA1/FSC/NGO/17380,6/16/2021 2:01:54 PM,Internally Displaced People,1000,1000,1400,1400,4800,1000,1000,1400,1400,4800
21,Somalia,2020,SOM-20/3485/RA1/FSC/NGO/17380,6/16/2021 2:01:54 PM,Overall,1000,1000,1400,1400,4800,1000,1000,1400,1400,4800
21,Somalia,2020,SOM-20/3485/RA1/FSC/NGO/17398,9/7/2021 2:24:29 PM,Host Communities,4855,5026,3650,3800,17331,4950,5340,3750,3900,17940
21,Somalia,2020,SOM-20/3485/RA1/FSC/NGO/17398,9/7/2021 2:24:29 PM,Internally Displaced People,3237,3350,2430,2537,11554,3430,3520,2560,6270,15780
21,Somalia,2020,SOM-20/3485/RA1/FSC/NGO/17398,9/7/2021 2:24:29 PM,Overall,8092,8376,6080,6337,28885,8380,8860,6310,10170,33720
21,Somalia,2020,SOM-20/3485/RA1/H/NGO/17354,7/3/2021 12:19:41 PM,Host Communities,460,1540,771,1000,3771,549,2279,1272,1560,5660
21,Somalia,2020,SOM-20/3485/RA1/H/NGO/17354,7/3/2021 12:19:41 PM,Internally Displaced People,444,968,1350,1480,4242,534,1990,2301,2670,7495
21,Somalia,2020,SOM-20/3485/RA1/H/NGO/17354,7/3/2021 12:19:41 PM,Other,6,12,0,0,18,8,12,0,0,20
21,Somalia,2020,SOM-20/3485/RA1/H/NGO/17354,7/3/2021 12:19:41 PM,Overall,910,2520,2121,2480,8031,1091,4281,3573,4230,13175
21,Somalia,2020,SOM-20/3485/RA1/H/UN/15931,6/15/2021 8:15:00 AM,Host Communities,6750,6750,6750,6750,27000,12505,14713,617,726,28561
21,Somalia,2020,SOM-20/3485/RA1/H/UN/15931,6/15/2021 8:15:00 AM,Other,6,0,0,0,6,6,0,0,0,6
21,Somalia,2020,SOM-20/3485/RA1/H/UN/15931,6/15/2021 8:15:00 AM,Overall,6756,6750,6750,6750,27006,12511,14713,617,726,28567
21,Somalia,2020,SOM-20/3485/RA1/H-Nut/NGO/17349,7/15/2021 7:29:02 AM,Host Communities,4545,5556,2448,2991,15540,668,5423,3947,4334,14372
21,Somalia,2020,SOM-20/3485/RA1/H-Nut/NGO/17349,7/15/2021 7:29:02 AM,Internally Displaced People,1597,1952,1106,1351,6006,86,1250,973,1520,3829
21,Somalia,2020,SOM-20/3485/RA1/H-Nut/NGO/17349,7/15/2021 7:29:02 AM,Overall,6142,7508,3554,4342,21546,754,6673,4920,5854,18201
21,Somalia,2020,SOM-20/3485/RA1/H-Nut/NGO/17379,6/15/2021 5:45:16 AM,Internally Displaced People,1150,2250,4250,4350,12000,1150,2250,4250,4350,12000
21,Somalia,2020,SOM-20/3485/RA1/H-Nut/NGO/17379,6/15/2021 5:45:16 AM,Overall,1150,2250,4250,4350,12000,1150,2250,4250,4350,12000
21,Somalia,2020,SOM-20/3485/RA1/L/UN/16474,9/4/2023 7:55:27 AM,Other,30,0,0,0,30,38,0,0,0,38
21,Somalia,2020,SOM-20/3485/RA1/L/UN/16474,9/4/2023 7:55:27 AM,Overall,30,0,0,0,30,38,0,0,0,38
21,Somalia,2020,SOM-20/3485/RA1/Nut-H/NGO/17400,10/14/2021 5:14:33 AM,Host Communities,1080,1370,1015,2415,5880,1071,1321,1005,2396,5793
21,Somalia,2020,SOM-20/3485/RA1/Nut-H/NGO/17400,10/14/2021 5:14:33 AM,Internally Displaced People,1100,1580,2430,2610,7720,1054,1508,2419,2604,7585
21,Somalia,2020,SOM-20/3485/RA1/Nut-H/NGO/17400,10/14/2021 5:14:33 AM,Overall,2180,2950,3445,5025,13600,2125,2829,3424,5000,13378
21,Somalia,2020,SOM-20/3485/RA1/Prot/INGO/17330,7/1/2021 6:02:04 AM,Host Communities,260,399,250,400,1309,506,744,508,754,2512
21,Somalia,2020,SOM-20/3485/RA1/Prot/INGO/17330,7/1/2021 6:02:04 AM,Internally Displaced People,800,1530,750,1600,4680,1012,1489,1016,1509,5026
21,Somalia,2020,SOM-20/3485/RA1/Prot/INGO/17330,7/1/2021 6:02:04 AM,Overall,1060,1929,1000,2000,5989,1518,2233,1524,2263,7538
21,Somalia,2020,SOM-20/3485/RA1/Prot/INGO/17377,7/17/2021 3:25:55 PM,Internally Displaced People,7562,13093,8890,10455,40000,7562,13093,8890,10455,40000
21,Somalia,2020,SOM-20/3485/RA1/Prot/INGO/17377,7/17/2021 3:25:55 PM,Overall,7562,13093,8890,10455,40000,7562,13093,8890,10455,40000
21,Somalia,2020,SOM-20/3485/RA1/Prot/INGO/17396,10/13/2021 12:34:11 PM,Host Communities,316,422,211,264,1213,386,548,368,358,1660
21,Somalia,2020,SOM-20/3485/RA1/Prot/INGO/17396,10/13/2021 12:34:11 PM,Internally Displaced People,428,499,356,356,1639,325,417,467,321,1530
21,Somalia,2020,SOM-20/3485/RA1/Prot/INGO/17396,10/13/2021 12:34:11 PM,Overall,1054,1311,847,748,3960,946,1262,1232,930,4370
21,Somalia,2020,SOM-20/3485/RA1/Prot/INGO/17396,10/13/2021 12:34:11 PM,Refugees,310,390,280,128,1108,235,297,397,251,1180
21,Somalia,2020,SOM-20/3485/RA1/Prot/NGO/17290,6/1/2021 9:01:37 AM,Host Communities,300,600,300,350,1550,254,556,238,338,1386
21,Somalia,2020,SOM-20/3485/RA1/Prot/NGO/17290,6/1/2021 9:01:37 AM,Internally Displaced People,1600,3600,1200,1200,7600,1113,3069,831,1023,6036
21,Somalia,2020,SOM-20/3485/RA1/Prot/NGO/17290,6/1/2021 9:01:37 AM,Other,140,120,170,170,600,140,120,98,153,511
21,Somalia,2020,SOM-20/3485/RA1/Prot/NGO/17290,6/1/2021 9:01:37 AM,Overall,2040,4320,1670,1720,9750,1507,3745,1167,1514,7933
21,Somalia,2020,SOM-20/3485/RA1/Prot/NGO/17367,9/6/2021 11:27:57 AM,Internally Displaced People,5600,8400,4200,6300,24500,6591,10715,3941,5110,26357
21,Somalia,2020,SOM-20/3485/RA1/Prot/NGO/17367,9/6/2021 11:27:57 AM,Overall,5600,8400,4200,6300,24500,6591,10715,3941,5110,26357
21,Somalia,2020,SOM-20/3485/RA1/Shelter/INGO/17363,6/22/2021 8:16:21 PM,Host Communities,243,243,567,567,1620,365,309,572,507,1753
21,Somalia,2020,SOM-20/3485/RA1/Shelter/INGO/17363,6/22/2021 8:16:21 PM,Internally Displaced People,972,972,2268,2268,6480,1759,1806,2682,2692,8939
21,Somalia,2020,SOM-20/3485/RA1/Shelter/INGO/17363,6/22/2021 8:16:21 PM,Overall,1215,1215,2835,2835,8100,2124,2115,3254,3199,10692
21,Somalia,2020,SOM-20/3485/RA1/Shelter/INGO/17384,11/26/2021 12:16:16 PM,Host Communities,1562,2530,1637,1711,7440,1562,2530,1637,1711,7440
21,Somalia,2020,SOM-20/3485/RA1/Shelter/INGO/17384,11/26/2021 12:16:16 PM,Internally Displaced People,866,1401,907,948,4122,866,1401,907,948,4122
21,Somalia,2020,SOM-20/3485/RA1/Shelter/INGO/17384,11/26/2021 12:16:16 PM,Overall,2428,3931,2544,2659,11562,2428,3931,2544,2659,11562
21,Somalia,2020,SOM-20/3485/RA1/Shelter/NGO/17324,8/24/2021 9:33:28 AM,Internally Displaced People,6300,6400,6700,6700,26100,6300,6400,6700,6700,26100
21,Somalia,2020,SOM-20/3485/RA1/Shelter/NGO/17324,8/24/2021 9:33:28 AM,Overall,6300,6400,6700,6700,26100,6300,6400,6700,6700,26100
21,Somalia,2020,SOM-20/3485/RA1/WASH/INGO/17408,8/31/2021 12:39:35 PM,Internally Displaced People,5580,8905,930,1085,16500,5580,8905,930,1085,16500
21,Somalia,2020,SOM-20/3485/RA1/WASH/INGO/17408,8/31/2021 12:39:35 PM,Overall,5580,8905,930,1085,16500,5580,8905,930,1085,16500
21,Somalia,2020,SOM-20/3485/RA1/WASH/NGO/16546,9/15/2021 11:12:55 AM,Internally Displaced People,11371,18650,7726,7738,45485,11331,20268,8130,7765,47494
21,Somalia,2020,SOM-20/3485/RA1/WASH/NGO/16546,9/15/2021 11:12:55 AM,Overall,11371,18650,7726,7738,45485,11331,20268,8130,7765,47494
21,Somalia,2020,SOM-20/3485/RA1/WASH/NGO/17301,6/14/2021 10:31:38 AM,Host Communities,1000,1070,1200,1200,4470,1314,1171,1361,1332,5178
21,Somalia,2020,SOM-20/3485/RA1/WASH/NGO/17301,6/14/2021 10:31:38 AM,Internally Displaced People,2750,3000,3390,3390,12530,2478,2965,3289,3325,12057
21,Somalia,2020,SOM-20/3485/RA1/WASH/NGO/17301,6/14/2021 10:31:38 AM,Overall,3750,4070,4590,4590,17000,3792,4136,4650,4657,17235
21,Somalia,2020,SOM-20/3485/RA1/WASH/NGO/17320,7/8/2021 1:03:50 PM,Host Communities,2749,3160,2818,3498,12225,2548,3157,2624,3340,11669
21,Somalia,2020,SOM-20/3485/RA1/WASH/NGO/17320,7/8/2021 1:03:50 PM,Internally Displaced People,1832,2108,1879,2333,8152,1871,2441,1777,2451,8540
21,Somalia,2020,SOM-20/3485/RA1/WASH/NGO/17320,7/8/2021 1:03:50 PM,Overall,4581,5268,4697,5831,20377,4419,5598,4401,5791,20209
21,Somalia,2020,SOM-20/3485/RA1/WASH/NGO/17327,6/14/2021 10:34:24 AM,Host Communities,1950,3250,3900,3900,13000,1950,3250,3900,3900,13000
21,Somalia,2020,SOM-20/3485/RA1/WASH/NGO/17327,6/14/2021 10:34:24 AM,Internally Displaced People,900,1500,1800,1800,6000,900,1500,1800,1800,6000
21,Somalia,2020,SOM-20/3485/RA1/WASH/NGO/17327,6/14/2021 10:34:24 AM,Overall,2850,4750,5700,5700,19000,2850,4750,5700,5700,19000
21,Somalia,2020,SOM-20/3485/RA1/WASH/NGO/17352,5/27/2021 8:24:50 AM,Host Communities,2100,1500,2000,2000,7600,1525,1619,2200,2051,7395
21,Somalia,2020,SOM-20/3485/RA1/WASH/NGO/17352,5/27/2021 8:24:50 AM,Internally Displaced People,3000,1200,3000,3200,10400,2200,1200,3005,3400,9805
21,Somalia,2020,SOM-20/3485/RA1/WASH/NGO/17352,5/27/2021 8:24:50 AM,Overall,5100,2700,5000,5200,18000,3725,2819,5205,5451,17200
21,Somalia,2020,SOM-20/3485/SA1/CCCM/INGO/15304,7/7/2021 11:39:56 AM,Internally Displaced People,17614,26223,13402,34889,92128,70532,105801,35268,44085,255686
21,Somalia,2020,SOM-20/3485/SA1/CCCM/INGO/15304,7/7/2021 11:39:56 AM,Overall,17614,26223,13402,34889,92128,70532,105801,35268,44085,255686
21,Somalia,2020,SOM-20/3485/SA1/CCCM/NGO/17051,4/21/2022 7:50:40 AM,Internally Displaced People,17868,25670,14449,20870,78857,18121,26238,14460,20117,78936
21,Somalia,2020,SOM-20/3485/SA1/CCCM/NGO/17051,4/21/2022 7:50:40 AM,Overall,17868,25670,14449,20870,78857,18121,26238,14460,20117,78936
21,Somalia,2020,SOM-20/3485/SA1/CCCM-Prot/NGO/15428,8/15/2021 5:26:29 PM,Internally Displaced People,3283,4886,6505,9710,24384,6142,12054,2156,4093,24445
21,Somalia,2020,SOM-20/3485/SA1/CCCM-Prot/NGO/15428,8/15/2021 5:26:29 PM,Overall,3283,4886,6505,9710,24384,6142,12054,2156,4093,24445
21,Somalia,2020,SOM-20/3485/SA1/CCCM-Prot-Shelter-WASH/NGO/15214,8/3/2021 1:53:14 PM,Internally Displaced People,3516,3724,1590,1610,10440,3516,3724,1590,1610,10440
21,Somalia,2020,SOM-20/3485/SA1/CCCM-Prot-Shelter-WASH/NGO/15214,8/3/2021 1:53:14 PM,Overall,3516,3724,1590,1610,10440,3516,3724,1590,1610,10440
21,Somalia,2020,SOM-20/3485/SA1/Ed/INGO/15119,6/30/2021 9:48:17 AM,Host Communities,3000,3000,2500,2500,11000,3117,3252,2456,2531,11356
21,Somalia,2020,SOM-20/3485/SA1/Ed/INGO/15119,6/30/2021 9:48:17 AM,Internally Displaced People,1950,1940,2500,2500,8890,1816,1973,2378,2562,8729
21,Somalia,2020,SOM-20/3485/SA1/Ed/INGO/15119,6/30/2021 9:48:17 AM,Overall,4950,4940,5000,5000,19890,4933,5225,4834,5093,20085
21,Somalia,2020,SOM-20/3485/SA1/Ed/INGO/15270,6/29/2021 6:18:08 AM,Host Communities,4927,3286,0,0,8213,5000,5000,0,0,10000
21,Somalia,2020,SOM-20/3485/SA1/Ed/INGO/15270,6/29/2021 6:18:08 AM,Internally Displaced People,11558,7710,1892,2001,23161,30316,47378,2131,2100,81925
21,Somalia,2020,SOM-20/3485/SA1/Ed/INGO/15270,6/29/2021 6:18:08 AM,Overall,16485,10996,1892,2001,31374,35316,52378,2131,2100,91925
21,Somalia,2020,SOM-20/3485/SA1/Ed/NGO/15138,8/25/2021 12:36:21 PM,Internally Displaced People,46,30,2588,2096,4760,50,25,2676,2514,5265
21,Somalia,2020,SOM-20/3485/SA1/Ed/NGO/15138,8/25/2021 12:36:21 PM,Overall,46,30,2588,2096,4760,50,25,2676,2514,5265
21,Somalia,2020,SOM-20/3485/SA1/Ed-Prot/NGO/15114,5/10/2021 3:50:21 PM,Host Communities,120,120,550,550,1340,104,98,564,628,1394
21,Somalia,2020,SOM-20/3485/SA1/Ed-Prot/NGO/15114,5/10/2021 3:50:21 PM,Internally Displaced People,120,120,1200,1092,2532,95,127,953,1029,2204
21,Somalia,2020,SOM-20/3485/SA1/Ed-Prot/NGO/15114,5/10/2021 3:50:21 PM,Other,0,0,120,120,240,0,0,118,128,246
21,Somalia,2020,SOM-20/3485/SA1/Ed-Prot/NGO/15114,5/10/2021 3:50:21 PM,Overall,240,240,1870,1762,4112,199,225,1635,1785,3844
21,Somalia,2020,SOM-20/3485/SA1/FSC/INGO/15147,3/11/2021 7:48:43 AM,Internally Displaced People,1027,1543,990,1030,4590,1027,1543,990,1030,4590
21,Somalia,2020,SOM-20/3485/SA1/FSC/INGO/15147,3/11/2021 7:48:43 AM,Overall,1027,1543,990,1030,4590,1027,1543,990,1030,4590
21,Somalia,2020,SOM-20/3485/SA1/FSC/INGO/15255,1/25/2021 7:05:08 AM,Internally Displaced People,1229,1366,1766,1819,6180,1399,1103,2428,2273,7203
21,Somalia,2020,SOM-20/3485/SA1/FSC/INGO/15255,1/25/2021 7:05:08 AM,Overall,1229,1366,1766,1819,6180,1399,1103,2428,2273,7203
21,Somalia,2020,SOM-20/3485/SA1/FSC/NGO/15124,3/17/2021 6:34:15 PM,Host Communities,1266,1355,774,900,4295,1266,1355,774,900,4295
21,Somalia,2020,SOM-20/3485/SA1/FSC/NGO/15124,3/17/2021 6:34:15 PM,Internally Displaced People,180,250,100,155,685,180,250,100,155,685
21,Somalia,2020,SOM-20/3485/SA1/FSC/NGO/15124,3/17/2021 6:34:15 PM,Other,50,60,30,40,180,50,60,30,40,180
21,Somalia,2020,SOM-20/3485/SA1/FSC/NGO/15124,3/17/2021 6:34:15 PM,Overall,1496,1665,904,1095,5160,1496,1665,904,1095,5160
21,Somalia,2020,SOM-20/3485/SA1/FSC/NGO/15145,2/3/2021 10:37:56 AM,Internally Displaced People,1500,1500,2400,2400,7800,1500,1500,2400,2400,7800
21,Somalia,2020,SOM-20/3485/SA1/FSC/NGO/15145,2/3/2021 10:37:56 AM,Overall,1500,1500,2400,2400,7800,1500,1500,2400,2400,7800
21,Somalia,2020,SOM-20/3485/SA1/FSC/NGO/15157,2/1/2021 9:44:40 AM,Host Communities,2663,2554,3041,3036,11294,2663,2554,3041,3036,11294
21,Somalia,2020,SOM-20/3485/SA1/FSC/NGO/15157,2/1/2021 9:44:40 AM,Internally Displaced People,275,265,330,330,1200,275,265,330,330,1200
21,Somalia,2020,SOM-20/3485/SA1/FSC/NGO/15157,2/1/2021 9:44:40 AM,Overall,2938,2819,3371,3366,12494,2938,2819,3371,3366,12494
21,Somalia,2020,SOM-20/3485/SA1/FSC/NGO/15161,2/23/2021 7:35:17 AM,Internally Displaced People,2000,4000,1500,1500,9000,2000,4000,1500,1500,9000
21,Somalia,2020,SOM-20/3485/SA1/FSC/NGO/15161,2/23/2021 7:35:17 AM,Overall,2000,4000,1500,1500,9000,2000,4000,1500,1500,9000
21,Somalia,2020,SOM-20/3485/SA1/FSC/NGO/15308,1/10/2021 9:21:37 AM,Other,1009,1381,1328,1593,5311,995,1345,1298,1567,5205
21,Somalia,2020,SOM-20/3485/SA1/FSC/NGO/15308,1/10/2021 9:21:37 AM,Overall,1009,1381,1328,1593,5311,995,1345,1298,1567,5205
21,Somalia,2020,SOM-20/3485/SA1/FSC/NGO/15384,4/5/2021 6:11:04 AM,Host Communities,712,814,203,305,2034,712,814,203,305,2034
21,Somalia,2020,SOM-20/3485/SA1/FSC/NGO/15384,4/5/2021 6:11:04 AM,Internally Displaced People,863,986,247,370,2466,863,986,247,370,2466
21,Somalia,2020,SOM-20/3485/SA1/FSC/NGO/15384,4/5/2021 6:11:04 AM,Overall,1575,1800,450,675,4500,1575,1800,450,675,4500
21,Somalia,2020,SOM-20/3485/SA1/H/INGO/15237,4/19/2021 11:26:13 AM,Host Communities,5000,10000,10000,11000,36000,3772,17372,5220,5607,31971
21,Somalia,2020,SOM-20/3485/SA1/H/INGO/15237,4/19/2021 11:26:13 AM,Internally Displaced People,2000,8000,7000,7000,24000,2026,11600,3395,3396,20417
21,Somalia,2020,SOM-20/3485/SA1/H/INGO/15237,4/19/2021 11:26:13 AM,Overall,7000,18000,17000,18000,60000,5798,28972,8615,9003,52388
21,Somalia,2020,SOM-20/3485/SA1/H/NGO/15475,7/14/2021 10:30:46 AM,Host Communities,14324,14908,3581,3727,36540,12443,12885,9360,9745,44433
21,Somalia,2020,SOM-20/3485/SA1/H/NGO/15475,7/14/2021 10:30:46 AM,Internally Displaced People,1592,1656,406,406,4060,1500,1620,1150,1220,5490
21,Somalia,2020,SOM-20/3485/SA1/H/NGO/15475,7/14/2021 10:30:46 AM,Overall,15916,16564,3987,4133,40600,13943,14505,10510,10965,49923
21,Somalia,2020,SOM-20/3485/SA1/H-Nut/INGO/15242,7/14/2021 11:19:56 AM,Host Communities,8448,11088,11087,16964,47587,3520,14212,7772,8354,33858
21,Somalia,2020,SOM-20/3485/SA1/H-Nut/INGO/15242,7/14/2021 11:19:56 AM,Internally Displaced People,7448,7752,1862,1938,19000,1111,4488,2454,2592,10645
21,Somalia,2020,SOM-20/3485/SA1/H-Nut/INGO/15242,7/14/2021 11:19:56 AM,Overall,15896,18840,12949,18902,66587,4631,18700,10226,10946,44503
21,Somalia,2020,SOM-20/3485/SA1/H-Nut/INGO/15459,7/1/2021 5:16:47 PM,Host Communities,154,9010,11638,11638,32440,4100,11100,7099,7542,29841
21,Somalia,2020,SOM-20/3485/SA1/H-Nut/INGO/15459,7/1/2021 5:16:47 PM,Internally Displaced People,358,21023,27155,27157,75693,6089,25899,16564,17599,66151
21,Somalia,2020,SOM-20/3485/SA1/H-Nut/INGO/15459,7/1/2021 5:16:47 PM,Overall,512,30033,38793,38795,108133,10189,36999,23663,25141,95992
21,Somalia,2020,SOM-20/3485/SA1/H-Nut/NGO/15268,7/21/2021 6:53:36 AM,Host Communities,500,3000,4000,3500,11000,8466,20849,21162,24944,75421
21,Somalia,2020,SOM-20/3485/SA1/H-Nut/NGO/15268,7/21/2021 6:53:36 AM,Internally Displaced People,500,1200,2000,2500,6200,950,2339,2376,2795,8460
21,Somalia,2020,SOM-20/3485/SA1/H-Nut/NGO/15268,7/21/2021 6:53:36 AM,Overall,1000,4200,6000,6000,17200,9416,23188,23538,27739,83881
21,Somalia,2020,SOM-20/3485/SA1/H-Prot/INGO/15230,2/22/2021 11:39:49 AM,Host Communities,400,600,150,150,1300,262,478,96,120,956
21,Somalia,2020,SOM-20/3485/SA1/H-Prot/INGO/15230,2/22/2021 11:39:49 AM,Internally Displaced People,600,3000,300,300,4200,587,3100,264,320,4271
21,Somalia,2020,SOM-20/3485/SA1/H-Prot/INGO/15230,2/22/2021 11:39:49 AM,Other,70,120,200,200,590,38,74,134,210,456
21,Somalia,2020,SOM-20/3485/SA1/H-Prot/INGO/15230,2/22/2021 11:39:49 AM,Overall,1070,3720,650,650,6090,887,3652,494,650,5683
21,Somalia,2020,SOM-20/3485/SA1/H-WASH/INGO/15166,7/7/2021 6:55:36 AM,Host Communities,1994,1884,1794,1702,7374,1450,1678,1530,1489,6147
21,Somalia,2020,SOM-20/3485/SA1/H-WASH/INGO/15166,7/7/2021 6:55:36 AM,Internally Displaced People,1993,1883,1794,1702,7372,557,1056,1530,1675,4818
21,Somalia,2020,SOM-20/3485/SA1/H-WASH/INGO/15166,7/7/2021 6:55:36 AM,Overall,3987,3767,3588,3404,14746,2007,2734,3060,3164,10965
21,Somalia,2020,SOM-20/3485/SA1/H-WASH/NGO/15144,7/15/2021 10:16:25 AM,Host Communities,300,4900,2800,3800,11800,2751,4900,3428,3854,14933
21,Somalia,2020,SOM-20/3485/SA1/H-WASH/NGO/15144,7/15/2021 10:16:25 AM,Internally Displaced People,150,2350,2090,1310,5900,945,2350,2832,1880,8007
21,Somalia,2020,SOM-20/3485/SA1/H-WASH/NGO/15144,7/15/2021 10:16:25 AM,Overall,450,7250,4890,5110,17700,3696,7250,6260,5734,22940
21,Somalia,2020,SOM-20/3485/SA1/Nut/INGO/15156,7/31/2021 8:47:47 AM,Host Communities,0,12800,9953,10096,32849,0,12800,9953,10096,32849
21,Somalia,2020,SOM-20/3485/SA1/Nut/INGO/15156,7/31/2021 8:47:47 AM,Internally Displaced People,0,3918,1334,1389,6641,0,3918,2490,2490,8898
21,Somalia,2020,SOM-20/3485/SA1/Nut/INGO/15156,7/31/2021 8:47:47 AM,Overall,0,16718,11287,11485,39490,0,16718,12443,12586,41747
21,Somalia,2020,SOM-20/3485/SA1/Nut/INGO/15194,9/10/2021 8:38:30 AM,Host Communities,0,902,537,559,1998,0,2747,695,775,4217
21,Somalia,2020,SOM-20/3485/SA1/Nut/INGO/15194,9/10/2021 8:38:30 AM,Internally Displaced People,0,135,69,71,275,0,44,21,23,88
21,Somalia,2020,SOM-20/3485/SA1/Nut/INGO/15194,9/10/2021 8:38:30 AM,Overall,0,1037,606,630,2273,0,2791,716,798,4305
21,Somalia,2020,SOM-20/3485/SA1/Prot/INGO/15135,3/15/2021 10:42:12 AM,Host Communities,550,1000,200,200,1950,302,748,304,376,1730
21,Somalia,2020,SOM-20/3485/SA1/Prot/INGO/15135,3/15/2021 10:42:12 AM,Internally Displaced People,650,1378,850,850,3728,494,463,853,1147,2957
21,Somalia,2020,SOM-20/3485/SA1/Prot/INGO/15135,3/15/2021 10:42:12 AM,Other,68,64,750,750,1632,51,69,981,842,1943
21,Somalia,2020,SOM-20/3485/SA1/Prot/INGO/15135,3/15/2021 10:42:12 AM,Overall,1268,2442,1800,1800,7310,847,1280,2138,2365,6630
21,Somalia,2020,SOM-20/3485/SA1/Prot/INGO/15442,8/12/2021 6:26:07 AM,Host Communities,3439,3100,130,195,6864,28101,41451,230,938,70720
21,Somalia,2020,SOM-20/3485/SA1/Prot/INGO/15442,8/12/2021 6:26:07 AM,Internally Displaced People,15094,13607,570,856,30127,131137,193439,1074,4375,330025
21,Somalia,2020,SOM-20/3485/SA1/Prot/INGO/15442,8/12/2021 6:26:07 AM,Other,382,345,14,22,763,18734,27634,153,625,47146
21,Somalia,2020,SOM-20/3485/SA1/Prot/INGO/15442,8/12/2021 6:26:07 AM,Overall,19106,17224,721,1084,38135,187339,276341,1534,6251,471465
21,Somalia,2020,SOM-20/3485/SA1/Prot/INGO/15442,8/12/2021 6:26:07 AM,Refugees,191,172,7,11,381,9367,13817,77,313,23574
21,Somalia,2020,SOM-20/3485/SA1/Prot/INGO/17115,3/1/2022 3:27:25 PM,Host Communities,975,1669,115,172,2931,941,2448,23,97,3509
21,Somalia,2020,SOM-20/3485/SA1/Prot/INGO/17115,3/1/2022 3:27:25 PM,Internally Displaced People,4105,7030,485,723,12343,3963,10306,121,384,14774
21,Somalia,2020,SOM-20/3485/SA1/Prot/INGO/17115,3/1/2022 3:27:25 PM,Other,51,88,6,9,154,50,118,7,10,185
21,Somalia,2020,SOM-20/3485/SA1/Prot/INGO/17115,3/1/2022 3:27:25 PM,Overall,5131,8787,606,904,15428,4954,12872,151,491,18468
21,Somalia,2020,SOM-20/3485/SA1/Prot/NGO/15118,3/24/2021 4:52:29 PM,Host Communities,30,1110,40,350,1530,1,1079,9,444,1533
21,Somalia,2020,SOM-20/3485/SA1/Prot/NGO/15118,3/24/2021 4:52:29 PM,Internally Displaced People,50,1480,100,350,1980,2,1511,8,434,1955
21,Somalia,2020,SOM-20/3485/SA1/Prot/NGO/15118,3/24/2021 4:52:29 PM,Other,5,14,0,0,19,5,14,0,0,19
21,Somalia,2020,SOM-20/3485/SA1/Prot/NGO/15118,3/24/2021 4:52:29 PM,Overall,85,2604,140,700,3529,8,2604,17,878,3507
21,Somalia,2020,SOM-20/3485/SA1/Prot/NGO/15127,1/18/2021 5:32:53 AM,Host Communities,0,85,0,40,125,0,206,0,17,223
21,Somalia,2020,SOM-20/3485/SA1/Prot/NGO/15127,1/18/2021 5:32:53 AM,Internally Displaced People,0,2490,0,220,2710,32,2347,0,778,3157
21,Somalia,2020,SOM-20/3485/SA1/Prot/NGO/15127,1/18/2021 5:32:53 AM,Overall,0,2575,0,260,2835,32,2553,0,795,3380
21,Somalia,2020,SOM-20/3485/SA1/Prot/NGO/15224,8/10/2021 8:23:58 AM,Host Communities,800,1100,1650,1350,4900,854,1074,1390,1483,4801
21,Somalia,2020,SOM-20/3485/SA1/Prot/NGO/15224,8/10/2021 8:23:58 AM,Internally Displaced People,1950,2350,2400,2250,8950,1872,2768,1896,3356,9892
21,Somalia,2020,SOM-20/3485/SA1/Prot/NGO/15224,8/10/2021 8:23:58 AM,Other,0,0,4050,3200,7250,0,0,2954,3256,6210
21,Somalia,2020,SOM-20/3485/SA1/Prot/NGO/15224,8/10/2021 8:23:58 AM,Overall,2750,3450,8100,6800,21100,2726,3842,6240,8095,20903
21,Somalia,2020,SOM-20/3485/SA1/Shelter/NGO/15158,3/9/2021 6:28:36 AM,Host Communities,2034,2712,1017,1017,6780,2034,2712,1017,1017,6780
21,Somalia,2020,SOM-20/3485/SA1/Shelter/NGO/15158,3/9/2021 6:28:36 AM,Internally Displaced People,8136,10848,4068,4068,27120,8136,10848,4068,4068,27120
21,Somalia,2020,SOM-20/3485/SA1/Shelter/NGO/15158,3/9/2021 6:28:36 AM,Overall,10170,13560,5085,5085,33900,10170,13560,5085,5085,33900
21,Somalia,2020,SOM-20/3485/SA1/Shelter/NGO/15180,6/10/2021 5:44:04 AM,Internally Displaced People,2186,3246,4315,6435,16182,2447,2678,6467,6301,17893
21,Somalia,2020,SOM-20/3485/SA1/Shelter/NGO/15180,6/10/2021 5:44:04 AM,Overall,2186,3246,4315,6435,16182,2447,2678,6467,6301,17893
21,Somalia,2020,SOM-20/3485/SA1/Shelter/NGO/16900,5/17/2021 6:17:02 AM,Host Communities,288,594,387,531,1800,261,290,514,466,1531
21,Somalia,2020,SOM-20/3485/SA1/Shelter/NGO/16900,5/17/2021 6:17:02 AM,Internally Displaced People,3506,7453,4385,6580,21924,4529,4687,8668,8054,25938
21,Somalia,2020,SOM-20/3485/SA1/Shelter/NGO/16900,5/17/2021 6:17:02 AM,Overall,3794,8047,4772,7111,23724,4790,4977,9182,8520,27469
21,Somalia,2020,SOM-20/3485/SA1/Shelter/NGO/16918,4/16/2021 11:55:22 AM,Internally Displaced People,1728,2925,3324,5319,13296,2078,2217,5208,4967,14470
21,Somalia,2020,SOM-20/3485/SA1/Shelter/NGO/16918,4/16/2021 11:55:22 AM,Overall,1728,2925,3324,5319,13296,2078,2217,5208,4967,14470
21,Somalia,2020,SOM-20/3485/SA1/Shelter-CCCM/NGO/15159,7/2/2021 5:10:47 AM,Host Communities,1692,2256,846,846,5640,1692,2256,846,846,5640
21,Somalia,2020,SOM-20/3485/SA1/Shelter-CCCM/NGO/15159,7/2/2021 5:10:47 AM,Internally Displaced People,6768,9024,3384,3384,22560,6768,9024,3384,3384,22560
21,Somalia,2020,SOM-20/3485/SA1/Shelter-CCCM/NGO/15159,7/2/2021 5:10:47 AM,Overall,8460,11280,4230,4230,28200,8460,11280,4230,4230,28200
21,Somalia,2020,SOM-20/3485/SA1/WASH/INGO/15185,6/18/2021 5:28:32 AM,Internally Displaced People,3175,3467,4569,4593,15804,5520,5980,4600,6900,23000
21,Somalia,2020,SOM-20/3485/SA1/WASH/INGO/15185,6/18/2021 5:28:32 AM,Overall,3175,3467,4569,4593,15804,5520,5980,4600,6900,23000
21,Somalia,2020,SOM-20/3485/SA1/WASH/INGO/15280,9/23/2021 6:05:41 AM,Host Communities,925,959,754,788,3426,1168,1211,952,995,4326
21,Somalia,2020,SOM-20/3485/SA1/WASH/INGO/15280,9/23/2021 6:05:41 AM,Internally Displaced People,3700,3838,3015,3152,13705,4672,4845,3807,3981,17305
21,Somalia,2020,SOM-20/3485/SA1/WASH/INGO/15280,9/23/2021 6:05:41 AM,Overall,4625,4797,3769,3940,17131,5840,6056,4759,4976,21631
21,Somalia,2020,SOM-20/3485/SA1/WASH/INGO/15396,7/13/2021 1:17:59 PM,Host Communities,1930,2425,2425,2920,9700,1930,2425,2425,2920,9700
21,Somalia,2020,SOM-20/3485/SA1/WASH/INGO/15396,7/13/2021 1:17:59 PM,Internally Displaced People,545,675,675,805,2700,545,675,675,805,2700
21,Somalia,2020,SOM-20/3485/SA1/WASH/INGO/15396,7/13/2021 1:17:59 PM,Other,520,650,650,780,2600,520,650,650,780,2600
21,Somalia,2020,SOM-20/3485/SA1/WASH/INGO/15396,7/13/2021 1:17:59 PM,Overall,2995,3750,3750,4505,15000,2995,3750,3750,4505,15000
21,Somalia,2020,SOM-20/3485/SA1/WASH/INGO/15411,6/22/2021 8:04:18 PM,Host Communities,1836,2604,584,776,5800,1579,2502,1967,1978,8026
21,Somalia,2020,SOM-20/3485/SA1/WASH/INGO/15411,6/22/2021 8:04:18 PM,Internally Displaced People,6144,9216,1536,2304,19200,3763,9448,6510,6945,26666
21,Somalia,2020,SOM-20/3485/SA1/WASH/INGO/15411,6/22/2021 8:04:18 PM,Overall,7980,11820,2120,3080,25000,5342,11950,8477,8923,34692
21,Somalia,2020,SOM-20/3485/SA1/WASH/INGO/15440,9/1/2021 9:05:11 AM,Internally Displaced People,6283,8936,9955,14210,39384,7277,10034,9358,12715,39384
21,Somalia,2020,SOM-20/3485/SA1/WASH/INGO/15440,9/1/2021 9:05:11 AM,Overall,6283,8936,9955,14210,39384,7277,10034,9358,12715,39384
21,Somalia,2020,SOM-20/3485/SA1/WASH/NGO/15251,7/29/2021 8:03:05 AM,Host Communities,1458,2437,2927,2927,9749,1323,2205,2646,2646,8820
21,Somalia,2020,SOM-20/3485/SA1/WASH/NGO/15251,7/29/2021 8:03:05 AM,Internally Displaced People,968,1613,1935,1935,6451,882,1470,1764,1764,5880
21,Somalia,2020,SOM-20/3485/SA1/WASH/NGO/15251,7/29/2021 8:03:05 AM,Overall,2426,4050,4862,4862,16200,2205,3675,4410,4410,14700
21,Somalia,2020,SOM-20/3485/SA1/WASH/NGO/15332,2/12/2021 6:00:08 AM,Host Communities,1530,1620,3150,2700,9000,1530,1620,3150,2700,9000
21,Somalia,2020,SOM-20/3485/SA1/WASH/NGO/15332,2/12/2021 6:00:08 AM,Internally Displaced People,1020,1080,2100,1800,6000,1020,1080,2100,1800,6000
21,Somalia,2020,SOM-20/3485/SA1/WASH/NGO/15332,2/12/2021 6:00:08 AM,Overall,2550,2700,5250,4500,15000,2550,2700,5250,4500,15000
21,Somalia,2021,SOM-21/3485/RA2/CCCM/NGO/19857,12/15/2022 11:52:53 AM,Host Communities,1700,1900,2200,3050,8850,1700,1900,2200,3050,8850
21,Somalia,2021,SOM-21/3485/RA2/CCCM/NGO/19857,12/15/2022 11:52:53 AM,Internally Displaced People,8000,9500,10700,12950,41150,8000,9500,10700,12950,41150
21,Somalia,2021,SOM-21/3485/RA2/CCCM/NGO/19857,12/15/2022 11:52:53 AM,Overall,9700,11400,12900,16000,50000,9700,11400,12900,16000,50000
21,Somalia,2021,SOM-21/3485/RA2/CCCM-Prot/NGO/19796,11/23/2022 1:14:48 PM,Internally Displaced People,10368,14760,5227,6320,36675,4548,22207,3095,9726,39576
21,Somalia,2021,SOM-21/3485/RA2/CCCM-Prot/NGO/19796,11/23/2022 1:14:48 PM,Overall,10368,14760,5227,6320,36675,4548,22207,3095,9726,39576
21,Somalia,2021,SOM-21/3485/RA2/Ed/NGO/19774,1/26/2023 10:02:44 AM,Host Communities,0,0,2310,1890,4200,0,0,2310,1890,4200
21,Somalia,2021,SOM-21/3485/RA2/Ed/NGO/19774,1/26/2023 10:02:44 AM,Internally Displaced People,0,0,990,810,1800,0,0,990,810,1800
21,Somalia,2021,SOM-21/3485/RA2/Ed/NGO/19774,1/26/2023 10:02:44 AM,Other,108,92,0,0,200,108,92,0,0,200
21,Somalia,2021,SOM-21/3485/RA2/Ed/NGO/19774,1/26/2023 10:02:44 AM,Overall,108,92,3300,2700,6200,108,92,3300,2700,6200
21,Somalia,2021,SOM-21/3485/RA2/FSC/INGO/19788,4/5/2022 7:29:43 AM,Other,1366,2134,7125,10375,21000,1302,2198,6408,11092,21000
21,Somalia,2021,SOM-21/3485/RA2/FSC/INGO/19788,4/5/2022 7:29:43 AM,Overall,1366,2134,7125,10375,21000,1302,2198,6408,11092,21000
21,Somalia,2021,SOM-21/3485/RA2/FSC/INGO/19852,8/1/2022 7:53:28 AM,Host Communities,2429,3168,2112,2851,10560,2680,3181,4034,4371,14266
21,Somalia,2021,SOM-21/3485/RA2/FSC/INGO/19852,8/1/2022 7:53:28 AM,Overall,2429,3168,2112,2851,10560,2680,3181,4034,4371,14266
21,Somalia,2021,SOM-21/3485/RA2/FSC/NGO/19782,4/22/2022 12:12:10 PM,Host Communities,740,590,689,756,2775,284,280,0,0,564
21,Somalia,2021,SOM-21/3485/RA2/FSC/NGO/19782,4/22/2022 12:12:10 PM,Internally Displaced People,650,470,579,454,2153,126,135,0,0,261
21,Somalia,2021,SOM-21/3485/RA2/FSC/NGO/19782,4/22/2022 12:12:10 PM,Other,10,12,0,0,22,0,0,0,0,0
21,Somalia,2021,SOM-21/3485/RA2/FSC/NGO/19782,4/22/2022 12:12:10 PM,Overall,1400,1072,1268,1210,4950,410,415,0,0,825
21,Somalia,2021,SOM-21/3485/RA2/FSC/NGO/19792,5/4/2022 9:20:13 AM,Host Communities,1464,2440,2922,2922,9748,1464,2440,2922,2922,9748
21,Somalia,2021,SOM-21/3485/RA2/FSC/NGO/19792,5/4/2022 9:20:13 AM,Internally Displaced People,625,1041,1256,1256,4178,625,1041,1256,1256,4178
21,Somalia,2021,SOM-21/3485/RA2/FSC/NGO/19792,5/4/2022 9:20:13 AM,Overall,2089,3481,4178,4178,13926,2089,3481,4178,4178,13926
21,Somalia,2021,SOM-21/3485/RA2/FSC/NGO/19801,5/17/2022 1:45:42 PM,Host Communities,960,830,1078,1400,4268,347,1184,3100,5000,9631
21,Somalia,2021,SOM-21/3485/RA2/FSC/NGO/19801,5/17/2022 1:45:42 PM,Internally Displaced People,950,1420,1540,2850,6760,70,237,490,600,1397
21,Somalia,2021,SOM-21/3485/RA2/FSC/NGO/19801,5/17/2022 1:45:42 PM,Overall,1910,2250,2618,4250,11028,417,1421,3590,5600,11028
21,Somalia,2021,SOM-21/3485/RA2/FSC/NGO/19819,4/4/2022 6:29:27 PM,Host Communities,397,413,495,495,1800,397,413,495,495,1800
21,Somalia,2021,SOM-21/3485/RA2/FSC/NGO/19819,4/4/2022 6:29:27 PM,Internally Displaced People,794,826,990,990,3600,794,826,990,990,3600
21,Somalia,2021,SOM-21/3485/RA2/FSC/NGO/19819,4/4/2022 6:29:27 PM,Overall,1191,1239,1485,1485,5400,1191,1239,1485,1485,5400
21,Somalia,2021,SOM-21/3485/RA2/FSC/NGO/19829,3/25/2022 1:51:46 PM,Host Communities,1118,3036,503,744,5401,953,2678,289,432,4352
21,Somalia,2021,SOM-21/3485/RA2/FSC/NGO/19829,3/25/2022 1:51:46 PM,Other,3352,9108,1507,2232,16199,7135,9370,647,96,17248
21,Somalia,2021,SOM-21/3485/RA2/FSC/NGO/19829,3/25/2022 1:51:46 PM,Overall,4470,12144,2010,2976,21600,8088,12048,936,528,21600
21,Somalia,2021,SOM-21/3485/RA2/FSC/NGO/19842,4/4/2022 6:52:41 PM,Host Communities,1759,2938,3528,3529,11754,1759,2938,3528,3529,11754
21,Somalia,2021,SOM-21/3485/RA2/FSC/NGO/19842,4/4/2022 6:52:41 PM,Internally Displaced People,507,845,1019,1019,3390,507,845,1019,1019,3390
21,Somalia,2021,SOM-21/3485/RA2/FSC/NGO/19842,4/4/2022 6:52:41 PM,Overall,2266,3783,4547,4548,15144,2266,3783,4547,4548,15144
21,Somalia,2021,SOM-21/3485/RA2/FSC/NGO/19859,1/4/2023 10:47:40 AM,Host Communities,3200,5500,1100,2200,12000,3200,5500,1100,2200,12000
21,Somalia,2021,SOM-21/3485/RA2/FSC/NGO/19859,1/4/2023 10:47:40 AM,Internally Displaced People,1360,2480,700,1100,5640,1360,2480,700,1100,5640
21,Somalia,2021,SOM-21/3485/RA2/FSC/NGO/19859,1/4/2023 10:47:40 AM,Other,12,14,0,0,26,12,14,0,0,26
21,Somalia,2021,SOM-21/3485/RA2/FSC/NGO/19859,1/4/2023 10:47:40 AM,Overall,4572,7994,1800,3300,17666,4572,7994,1800,3300,17666
21,Somalia,2021,SOM-21/3485/RA2/FSC/NGO/19862,8/1/2022 7:39:41 AM,Internally Displaced People,3888,5832,1296,1944,12960,3888,5832,1296,1944,12960
21,Somalia,2021,SOM-21/3485/RA2/FSC/NGO/19862,8/1/2022 7:39:41 AM,Overall,3888,5832,1296,1944,12960,3888,5832,1296,1944,12960
21,Somalia,2021,SOM-21/3485/RA2/FSC/NGO/19883,4/22/2022 10:20:58 AM,Host Communities,3389,7455,1084,1626,13554,3389,7455,1084,1626,13554
21,Somalia,2021,SOM-21/3485/RA2/FSC/NGO/19883,4/22/2022 10:20:58 AM,Overall,3389,7455,1084,1626,13554,3389,7455,1084,1626,13554
21,Somalia,2021,SOM-21/3485/RA2/FSC/NGO/19897,3/25/2022 12:12:27 PM,Internally Displaced People,560,550,300,400,1810,732,807,129,142,1810
21,Somalia,2021,SOM-21/3485/RA2/FSC/NGO/19897,3/25/2022 12:12:27 PM,Overall,560,550,300,400,1810,732,807,129,142,1810
21,Somalia,2021,SOM-21/3485/RA2/FSC/NGO/19917,6/29/2022 11:53:52 AM,Host Communities,398,488,665,665,2216,398,488,665,665,2216
21,Somalia,2021,SOM-21/3485/RA2/FSC/NGO/19917,6/29/2022 11:53:52 AM,Internally Displaced People,1596,1950,2660,2660,8866,1596,1950,2660,2660,8866
21,Somalia,2021,SOM-21/3485/RA2/FSC/NGO/19917,6/29/2022 11:53:52 AM,Overall,1994,2438,3325,3325,11082,1994,2438,3325,3325,11082
21,Somalia,2021,SOM-21/3485/RA2/H/INGO/19790,11/30/2022 1:05:02 PM,Host Communities,1611,4755,3860,4070,14296,1348,3171,3452,3773,11744
21,Somalia,2021,SOM-21/3485/RA2/H/INGO/19790,11/30/2022 1:05:02 PM,Internally Displaced People,3758,11095,9007,9496,33356,3144,7400,8056,8807,27407
21,Somalia,2021,SOM-21/3485/RA2/H/INGO/19790,11/30/2022 1:05:02 PM,Overall,5369,15850,12867,13566,47652,4492,10571,11508,12580,39151
21,Somalia,2021,SOM-21/3485/RA2/H/INGO/19808,12/14/2022 12:12:58 PM,Host Communities,21655,20982,5414,5245,53296,7937,15172,10262,9653,43024
21,Somalia,2021,SOM-21/3485/RA2/H/INGO/19808,12/14/2022 12:12:58 PM,Internally Displaced People,1528,1487,510,495,4020,1186,2267,1533,1443,6429
21,Somalia,2021,SOM-21/3485/RA2/H/INGO/19808,12/14/2022 12:12:58 PM,Overall,23183,22469,5924,5740,57316,9123,17439,11795,11096,49453
21,Somalia,2021,SOM-21/3485/RA2/H/INGO/19828,4/5/2023 8:43:28 AM,Host Communities,16605,15795,4131,3969,40500,8142,9700,8005,8032,33879
21,Somalia,2021,SOM-21/3485/RA2/H/INGO/19828,4/5/2023 8:43:28 AM,Internally Displaced People,1845,1755,459,441,4500,1000,1063,700,500,3263
21,Somalia,2021,SOM-21/3485/RA2/H/INGO/19828,4/5/2023 8:43:28 AM,Overall,18450,17550,4590,4410,45000,9142,10763,8705,8532,37142
21,Somalia,2021,SOM-21/3485/RA2/H/NGO/19787,12/20/2022 2:45:31 PM,Host Communities,5000,7000,7400,10000,29400,5054,7049,7445,10089,29637
21,Somalia,2021,SOM-21/3485/RA2/H/NGO/19787,12/20/2022 2:45:31 PM,Internally Displaced People,1200,3000,3200,3200,10600,1302,3069,3264,3255,10890
21,Somalia,2021,SOM-21/3485/RA2/H/NGO/19787,12/20/2022 2:45:31 PM,Overall,6200,10000,10600,13200,40000,6356,10118,10709,13344,40527
21,Somalia,2021,SOM-21/3485/RA2/H/NGO/19880,12/9/2022 8:55:47 AM,Host Communities,5051,6735,2526,2526,16838,4304,6024,2414,2549,15291
21,Somalia,2021,SOM-21/3485/RA2/H/NGO/19880,12/9/2022 8:55:47 AM,Internally Displaced People,6949,9265,3474,3474,23162,6596,7632,4285,3405,21918
21,Somalia,2021,SOM-21/3485/RA2/H/NGO/19880,12/9/2022 8:55:47 AM,Overall,12000,16000,6000,6000,40000,10900,13656,6699,5954,37209
21,Somalia,2021,SOM-21/3485/RA2/H/NGO/19893,12/20/2022 3:01:42 PM,Host Communities,3500,18000,4500,4500,30500,4959,13949,6062,8240,33210
21,Somalia,2021,SOM-21/3485/RA2/H/NGO/19893,12/20/2022 3:01:42 PM,Internally Displaced People,2500,3000,2000,2000,9500,1896,4245,2875,2706,11722
21,Somalia,2021,SOM-21/3485/RA2/H/NGO/19893,12/20/2022 3:01:42 PM,Overall,6000,21000,6500,6500,40000,6855,18194,8937,10946,44932
21,Somalia,2021,SOM-21/3485/RA2/H-Nut/INGO/19873,12/9/2022 1:11:59 PM,Host Communities,11758,18270,4388,4567,38983,2016,7212,1880,2252,13360
21,Somalia,2021,SOM-21/3485/RA2/H-Nut/INGO/19873,12/9/2022 1:11:59 PM,Internally Displaced People,4131,6397,1536,1599,13663,3025,10817,2821,3377,20040
21,Somalia,2021,SOM-21/3485/RA2/H-Nut/INGO/19873,12/9/2022 1:11:59 PM,Overall,15889,24667,5924,6166,52646,5041,18029,4701,5629,33400
21,Somalia,2021,SOM-21/3485/RA2/H-Nut/NGO/19769,10/24/2022 10:57:27 AM,Host Communities,1000,2000,3350,4210,10560,1000,2000,3350,4210,10560
21,Somalia,2021,SOM-21/3485/RA2/H-Nut/NGO/19769,10/24/2022 10:57:27 AM,Internally Displaced People,1200,2400,4300,4060,11960,1200,2400,4300,4060,11960
21,Somalia,2021,SOM-21/3485/RA2/H-Nut/NGO/19769,10/24/2022 10:57:27 AM,Overall,2200,4400,7650,8270,22520,2200,4400,7650,8270,22520
21,Somalia,2021,SOM-21/3485/RA2/H-Nut/NGO/19875,10/26/2022 2:51:32 PM,Host Communities,1300,10300,6000,7500,25100,1300,10300,6000,7500,25100
21,Somalia,2021,SOM-21/3485/RA2/H-Nut/NGO/19875,10/26/2022 2:51:32 PM,Internally Displaced People,1100,10300,6000,7500,24900,1100,10300,6000,7500,24900
21,Somalia,2021,SOM-21/3485/RA2/H-Nut/NGO/19875,10/26/2022 2:51:32 PM,Overall,2400,20600,12000,15000,50000,2400,20600,12000,15000,50000
21,Somalia,2021,SOM-21/3485/RA2/H-Nut/NGO/19891,12/14/2022 12:21:31 PM,Host Communities,6624,7776,1764,1836,18000,6835,7114,1709,1778,17436
21,Somalia,2021,SOM-21/3485/RA2/H-Nut/NGO/19891,12/14/2022 12:21:31 PM,Internally Displaced People,3312,3888,882,918,9000,1953,2033,488,508,4982
21,Somalia,2021,SOM-21/3485/RA2/H-Nut/NGO/19891,12/14/2022 12:21:31 PM,Overall,9936,11664,2646,2754,27000,8788,9147,2197,2286,22418
21,Somalia,2021,SOM-21/3485/RA2/Nut/NGO/19771,4/5/2023 8:07:48 AM,Host Communities,30,2000,800,900,3730,30,2000,800,900,3730
21,Somalia,2021,SOM-21/3485/RA2/Nut/NGO/19771,4/5/2023 8:07:48 AM,Internally Displaced People,0,1840,600,800,3240,0,1840,600,800,3240
21,Somalia,2021,SOM-21/3485/RA2/Nut/NGO/19771,4/5/2023 8:07:48 AM,Overall,30,3840,1400,1700,6970,30,3840,1400,1700,6970
21,Somalia,2021,SOM-21/3485/RA2/Nut/NGO/19797,2/13/2023 4:57:20 PM,Host Communities,35,500,550,450,1535,50,600,650,550,1850
21,Somalia,2021,SOM-21/3485/RA2/Nut/NGO/19797,2/13/2023 4:57:20 PM,Internally Displaced People,13,300,280,230,823,20,480,370,350,1220
21,Somalia,2021,SOM-21/3485/RA2/Nut/NGO/19797,2/13/2023 4:57:20 PM,Overall,48,800,830,680,2358,70,1080,1020,900,3070
21,Somalia,2021,SOM-21/3485/RA2/Nut/NGO/19798,3/7/2023 7:25:56 PM,Host Communities,13835,18263,3361,4108,39567,13835,18263,3361,4108,39567
21,Somalia,2021,SOM-21/3485/RA2/Nut/NGO/19798,3/7/2023 7:25:56 PM,Internally Displaced People,23960,31336,5125,6684,67105,23960,31336,5125,6684,67105
21,Somalia,2021,SOM-21/3485/RA2/Nut/NGO/19798,3/7/2023 7:25:56 PM,Overall,37795,49599,8486,10792,106672,37795,49599,8486,10792,106672
21,Somalia,2021,SOM-21/3485/RA2/Nut/NGO/19814,6/9/2023 8:33:48 AM,Host Communities,0,800,1000,1080,2880,0,1478,856,936,3270
21,Somalia,2021,SOM-21/3485/RA2/Nut/NGO/19814,6/9/2023 8:33:48 AM,Internally Displaced People,0,400,500,420,1320,0,618,462,430,1510
21,Somalia,2021,SOM-21/3485/RA2/Nut/NGO/19814,6/9/2023 8:33:48 AM,Overall,0,1200,1500,1500,4200,0,2096,1318,1366,4780
21,Somalia,2021,SOM-21/3485/RA2/Nut/NGO/19847,1/17/2023 9:01:42 AM,Host Communities,0,1552,1178,1132,3862,0,2212,1884,1940,6036
21,Somalia,2021,SOM-21/3485/RA2/Nut/NGO/19847,1/17/2023 9:01:42 AM,Internally Displaced People,0,1270,964,926,3160,0,1427,1189,1264,3880
21,Somalia,2021,SOM-21/3485/RA2/Nut/NGO/19847,1/17/2023 9:01:42 AM,Other,4,106,0,0,110,25,85,0,0,110
21,Somalia,2021,SOM-21/3485/RA2/Nut/NGO/19847,1/17/2023 9:01:42 AM,Overall,4,2928,2142,2058,7132,25,3724,3073,3204,10026
21,Somalia,2021,SOM-21/3485/RA2/Nut/NGO/19868,10/27/2022 2:28:43 PM,Host Communities,0,700,1576,2300,4576,0,5316,4981,6731,17028
21,Somalia,2021,SOM-21/3485/RA2/Nut/NGO/19868,10/27/2022 2:28:43 PM,Internally Displaced People,0,300,1000,1564,2864,0,3907,2081,3545,9533
21,Somalia,2021,SOM-21/3485/RA2/Nut/NGO/19868,10/27/2022 2:28:43 PM,Overall,0,1000,2576,3864,7440,0,9223,7062,10276,26561
21,Somalia,2021,SOM-21/3485/RA2/Nut/NGO/19876,5/10/2023 10:01:45 AM,Host Communities,246,4669,11950,12110,28975,178,2984,6571,8346,18079
21,Somalia,2021,SOM-21/3485/RA2/Nut/NGO/19876,5/10/2023 10:01:45 AM,Internally Displaced People,61,1167,3290,3161,7679,53,895,2387,1453,4788
21,Somalia,2021,SOM-21/3485/RA2/Nut/NGO/19876,5/10/2023 10:01:45 AM,Overall,307,5836,15240,15271,36654,231,3879,8958,9799,22867
21,Somalia,2021,SOM-21/3485/RA2/Nut/NGO/19877,4/5/2023 8:09:57 AM,Host Communities,3495,5244,2625,2394,13758,1171,10154,9218,11054,31597
21,Somalia,2021,SOM-21/3485/RA2/Nut/NGO/19877,4/5/2023 8:09:57 AM,Overall,3495,5244,2625,2394,13758,1171,10154,9218,11054,31597
21,Somalia,2021,SOM-21/3485/RA2/Prot/INGO/19838,5/9/2022 10:18:00 AM,Internally Displaced People,120,1300,118,500,2038,0,500,0,100,600
21,Somalia,2021,SOM-21/3485/RA2/Prot/INGO/19838,5/9/2022 10:18:00 AM,Overall,120,1300,118,500,2038,0,500,0,100,600
21,Somalia,2021,SOM-21/3485/RA2/Prot/NGO/19786,1/9/2023 7:10:43 AM,Host Communities,500,1000,300,350,2150,473,1086,293,368,2220
21,Somalia,2021,SOM-21/3485/RA2/Prot/NGO/19786,1/9/2023 7:10:43 AM,Internally Displaced People,3000,6000,1500,2000,12500,2707,6189,1542,2051,12489
21,Somalia,2021,SOM-21/3485/RA2/Prot/NGO/19786,1/9/2023 7:10:43 AM,Overall,3500,7000,1800,2350,14650,3180,7275,1835,2419,14709
21,Somalia,2021,SOM-21/3485/RA2/Prot/NGO/19817,12/27/2022 6:57:41 AM,Internally Displaced People,1209,1935,300,450,3894,1146,1929,144,288,3507
21,Somalia,2021,SOM-21/3485/RA2/Prot/NGO/19817,12/27/2022 6:57:41 AM,Overall,1209,1935,300,450,3894,1146,1929,144,288,3507
21,Somalia,2021,SOM-21/3485/RA2/Prot/NGO/19854,1/12/2023 9:55:14 AM,Internally Displaced People,8583,10675,9103,12433,40794,2345,20167,6302,11980,40794
21,Somalia,2021,SOM-21/3485/RA2/Prot/NGO/19854,1/12/2023 9:55:14 AM,Overall,8583,10675,9103,12433,40794,2345,20167,6302,11980,40794
21,Somalia,2021,SOM-21/3485/RA2/Prot/NGO/19874,12/27/2022 7:01:11 AM,Host Communities,250,300,200,280,1030,250,300,200,280,1030
21,Somalia,2021,SOM-21/3485/RA2/Prot/NGO/19874,12/27/2022 7:01:11 AM,Internally Displaced People,500,800,500,650,2450,500,800,500,650,2450
21,Somalia,2021,SOM-21/3485/RA2/Prot/NGO/19874,12/27/2022 7:01:11 AM,Overall,770,1135,730,965,3600,770,1135,730,965,3600
21,Somalia,2021,SOM-21/3485/RA2/Prot/NGO/19874,12/27/2022 7:01:11 AM,Refugees,20,35,30,35,120,20,35,30,35,120
21,Somalia,2021,SOM-21/3485/RA2/Shelter/NGO/19849,6/15/2022 6:40:26 AM,Internally Displaced People,2300,2400,2000,2000,8700,2300,2400,2000,2000,8700
21,Somalia,2021,SOM-21/3485/RA2/Shelter/NGO/19849,6/15/2022 6:40:26 AM,Overall,2300,2400,2000,2000,8700,2300,2400,2000,2000,8700
21,Somalia,2021,SOM-21/3485/RA2/Shelter/NGO/19850,5/9/2022 5:26:57 PM,Internally Displaced People,1507,1507,3203,3203,9420,1364,1555,4230,4051,11200
21,Somalia,2021,SOM-21/3485/RA2/Shelter/NGO/19850,5/9/2022 5:26:57 PM,Overall,1507,1507,3203,3203,9420,1364,1555,4230,4051,11200
21,Somalia,2021,SOM-21/3485/RA2/Shelter/NGO/19888,5/17/2022 2:11:08 PM,Internally Displaced People,9000,12000,4500,4500,30000,9000,12000,4500,4500,30000
21,Somalia,2021,SOM-21/3485/RA2/Shelter/NGO/19888,5/17/2022 2:11:08 PM,Overall,9000,12000,4500,4500,30000,9000,12000,4500,4500,30000
21,Somalia,2021,SOM-21/3485/RA2/Shelter-HLP/NGO/19885,7/26/2022 5:20:03 AM,Internally Displaced People,3400,3600,3040,3160,13200,3400,3600,3040,3160,13200
21,Somalia,2021,SOM-21/3485/RA2/Shelter-HLP/NGO/19885,7/26/2022 5:20:03 AM,Overall,3400,3600,3040,3160,13200,3400,3600,3040,3160,13200
21,Somalia,2021,SOM-21/3485/RA2/WASH/INGO/19778,7/6/2022 7:00:42 AM,Internally Displaced People,4032,5443,4637,6048,20160,6930,9355,7969,10395,34649
21,Somalia,2021,SOM-21/3485/RA2/WASH/INGO/19778,7/6/2022 7:00:42 AM,Overall,4032,5443,4637,6048,20160,6930,9355,7969,10395,34649
21,Somalia,2021,SOM-21/3485/RA2/WASH/INGO/19784,8/9/2023 12:35:05 PM,Host Communities,2398,2507,2944,3053,10902,2346,2453,2879,2986,10664
21,Somalia,2021,SOM-21/3485/RA2/WASH/INGO/19784,8/9/2023 12:35:05 PM,Internally Displaced People,902,943,1106,1147,4098,990,1035,1215,1260,4500
21,Somalia,2021,SOM-21/3485/RA2/WASH/INGO/19784,8/9/2023 12:35:05 PM,Overall,3300,3450,4050,4200,15000,3336,3488,4094,4246,15164
21,Somalia,2021,SOM-21/3485/RA2/WASH/INGO/19794,9/8/2022 2:20:48 PM,Internally Displaced People,4715,5057,3446,3782,17000,4542,5351,3911,4174,17978
21,Somalia,2021,SOM-21/3485/RA2/WASH/INGO/19794,9/8/2022 2:20:48 PM,Overall,4715,5057,3446,3782,17000,4542,5351,3911,4174,17978
21,Somalia,2021,SOM-21/3485/RA2/WASH/INGO/19806,12/19/2022 10:59:14 AM,Host Communities,4194,4334,2796,2656,13980,5077,5246,3385,3217,16925
21,Somalia,2021,SOM-21/3485/RA2/WASH/INGO/19806,12/19/2022 10:59:14 AM,Internally Displaced People,1206,1246,804,764,4020,1457,1506,971,923,4857
21,Somalia,2021,SOM-21/3485/RA2/WASH/INGO/19806,12/19/2022 10:59:14 AM,Overall,5400,5580,3600,3420,18000,6534,6752,4356,4140,21782
21,Somalia,2021,SOM-21/3485/RA2/WASH/INGO/19860,9/23/2022 6:12:24 AM,Host Communities,2661,3326,1996,3105,11088,2526,3257,1932,2983,10698
21,Somalia,2021,SOM-21/3485/RA2/WASH/INGO/19860,9/23/2022 6:12:24 AM,Internally Displaced People,1156,1446,866,1347,4815,1086,1379,843,1278,4586
21,Somalia,2021,SOM-21/3485/RA2/WASH/INGO/19860,9/23/2022 6:12:24 AM,Overall,3817,4772,2862,4452,15903,3612,4636,2775,4261,15284
21,Somalia,2021,SOM-21/3485/RA2/WASH/INGO/19906,10/24/2022 2:23:31 PM,Other,3312,3599,3600,3889,14400,7005,7840,9343,10042,34230
21,Somalia,2021,SOM-21/3485/RA2/WASH/INGO/19906,10/24/2022 2:23:31 PM,Overall,3312,3599,3600,3889,14400,7005,7840,9343,10042,34230
21,Somalia,2021,SOM-21/3485/RA2/WASH/INGO/19908,1/31/2023 8:30:06 AM,Internally Displaced People,3988,4245,2187,2444,12864,4054,4315,2223,2484,13076
21,Somalia,2021,SOM-21/3485/RA2/WASH/INGO/19908,1/31/2023 8:30:06 AM,Overall,3988,4245,2187,2444,12864,4054,4315,2223,2484,13076
21,Somalia,2021,SOM-21/3485/RA2/WASH/NGO/19772,9/1/2022 11:37:11 AM,Host Communities,1575,2625,3150,3150,10500,1575,2625,3150,3150,10500
21,Somalia,2021,SOM-21/3485/RA2/WASH/NGO/19772,9/1/2022 11:37:11 AM,Internally Displaced People,675,1125,1350,1350,4500,675,1125,1350,1350,4500
21,Somalia,2021,SOM-21/3485/RA2/WASH/NGO/19772,9/1/2022 11:37:11 AM,Overall,2250,3750,4500,4500,15000,2250,3750,4500,4500,15000
21,Somalia,2021,SOM-21/3485/RA2/WASH/NGO/19775,10/18/2022 7:37:03 AM,Host Communities,1769,1920,3300,2900,9889,1769,1920,3300,2900,9889
21,Somalia,2021,SOM-21/3485/RA2/WASH/NGO/19775,10/18/2022 7:37:03 AM,Internally Displaced People,1781,1780,2950,3000,9511,1781,1780,2950,3000,9511
21,Somalia,2021,SOM-21/3485/RA2/WASH/NGO/19775,10/18/2022 7:37:03 AM,Other,10,12,0,0,22,16,6,0,0,22
21,Somalia,2021,SOM-21/3485/RA2/WASH/NGO/19775,10/18/2022 7:37:03 AM,Overall,3560,3712,6250,5900,19422,3566,3706,6250,5900,19422
21,Somalia,2021,SOM-21/3485/RA2/WASH/NGO/19820,9/9/2022 2:04:23 PM,Host Communities,596,620,742,742,2700,596,620,742,742,2700
21,Somalia,2021,SOM-21/3485/RA2/WASH/NGO/19820,9/9/2022 2:04:23 PM,Internally Displaced People,2672,2782,3333,3333,12120,2672,2782,3333,3333,12120
21,Somalia,2021,SOM-21/3485/RA2/WASH/NGO/19820,9/9/2022 2:04:23 PM,Overall,3268,3402,4075,4075,14820,3268,3402,4075,4075,14820
21,Somalia,2021,SOM-21/3485/RA2/WASH/NGO/19823,11/14/2022 8:01:13 AM,Host Communities,900,1510,348,655,3413,1148,1402,765,935,4250
21,Somalia,2021,SOM-21/3485/RA2/WASH/NGO/19823,11/14/2022 8:01:13 AM,Internally Displaced People,3621,5520,1355,2290,12786,3102,3791,2068,2527,11488
21,Somalia,2021,SOM-21/3485/RA2/WASH/NGO/19823,11/14/2022 8:01:13 AM,Overall,4521,7030,1703,2945,16199,4250,5193,2833,3462,15738
21,Somalia,2021,SOM-21/3485/RA2/WASH/NGO/19843,11/29/2022 6:11:35 AM,Host Communities,1400,1400,2800,2800,8400,1106,1104,2212,2212,6634
21,Somalia,2021,SOM-21/3485/RA2/WASH/NGO/19843,11/29/2022 6:11:35 AM,Internally Displaced People,440,440,1060,1060,3000,348,345,832,837,2362
21,Somalia,2021,SOM-21/3485/RA2/WASH/NGO/19843,11/29/2022 6:11:35 AM,Other,350,350,450,450,1600,272,270,356,356,1254
21,Somalia,2021,SOM-21/3485/RA2/WASH/NGO/19843,11/29/2022 6:11:35 AM,Overall,2190,2190,4310,4310,13000,1726,1719,3400,3405,10250
21,Somalia,2021,SOM-21/3485/RA2/WASH/NGO/19863,7/21/2022 9:22:32 AM,Host Communities,2840,4258,946,1420,9464,2840,4258,946,1420,9464
21,Somalia,2021,SOM-21/3485/RA2/WASH/NGO/19863,7/21/2022 9:22:32 AM,Internally Displaced People,2111,3166,704,1055,7036,2111,3166,704,1055,7036
21,Somalia,2021,SOM-21/3485/RA2/WASH/NGO/19863,7/21/2022 9:22:32 AM,Overall,4951,7424,1650,2475,16500,4951,7424,1650,2475,16500
21,Somalia,2021,SOM-21/3485/RA2/WASH/NGO/19905,12/16/2022 2:36:19 PM,Host Communities,3051,3654,3104,3805,13614,3051,3654,3104,3805,13614
21,Somalia,2021,SOM-21/3485/RA2/WASH/NGO/19905,12/16/2022 2:36:19 PM,Internally Displaced People,1324,1624,1350,1700,5998,1324,1624,1350,1700,5998
21,Somalia,2021,SOM-21/3485/RA2/WASH/NGO/19905,12/16/2022 2:36:19 PM,Overall,4375,5278,4454,5505,19612,4375,5278,4454,5505,19612
21,Somalia,2021,SOM-21/3485/RA4/Ed-CP/INGO/20981,11/16/2022 7:02:50 AM,Host Communities,25,7,1512,1484,3028,20,5,1413,1247,2685
21,Somalia,2021,SOM-21/3485/RA4/Ed-CP/INGO/20981,11/16/2022 7:02:50 AM,Internally Displaced People,61,15,3209,3061,6346,454,1074,7306,7163,15997
21,Somalia,2021,SOM-21/3485/RA4/Ed-CP/INGO/20981,11/16/2022 7:02:50 AM,Overall,86,22,4721,4545,9374,474,1079,8719,8410,18682
21,Somalia,2021,SOM-21/3485/RA4/Ed-CP/NGO/20859,9/29/2022 9:59:18 AM,Host Communities,90,68,1600,1400,3158,90,68,1600,1400,3158
21,Somalia,2021,SOM-21/3485/RA4/Ed-CP/NGO/20859,9/29/2022 9:59:18 AM,Internally Displaced People,8,10,600,400,1018,8,10,600,400,1018
21,Somalia,2021,SOM-21/3485/RA4/Ed-CP/NGO/20859,9/29/2022 9:59:18 AM,Overall,98,78,2200,1800,4176,98,78,2200,1800,4176
21,Somalia,2021,SOM-21/3485/RA4/Nut/INGO/20899,4/5/2023 8:14:23 AM,Host Communities,0,1603,1846,2166,5615,0,4405,1900,2060,8365
21,Somalia,2021,SOM-21/3485/RA4/Nut/INGO/20899,4/5/2023 8:14:23 AM,Internally Displaced People,0,624,431,505,1560,0,820,296,194,1310
21,Somalia,2021,SOM-21/3485/RA4/Nut/INGO/20899,4/5/2023 8:14:23 AM,Overall,0,2227,2277,2671,7175,0,5225,2196,2254,9675
21,Somalia,2021,SOM-21/3485/RA4/Nut/NGO/20857,6/9/2023 8:34:20 AM,Host Communities,0,1200,1600,1400,4200,0,1189,1771,1516,4476
21,Somalia,2021,SOM-21/3485/RA4/Nut/NGO/20857,6/9/2023 8:34:20 AM,Internally Displaced People,0,800,400,600,1800,0,724,478,581,1783
21,Somalia,2021,SOM-21/3485/RA4/Nut/NGO/20857,6/9/2023 8:34:20 AM,Overall,0,2000,2000,2000,6000,0,1913,2249,2097,6259
21,Somalia,2021,SOM-21/3485/RA4/Nut-WASH/INGO/20864,11/25/2022 4:53:25 PM,Host Communities,8978,8645,2609,2508,22740,4200,6518,8629,8380,27727
21,Somalia,2021,SOM-21/3485/RA4/Nut-WASH/INGO/20864,11/25/2022 4:53:25 PM,Internally Displaced People,2058,1982,600,600,5240,1007,1900,1200,1400,5507
21,Somalia,2021,SOM-21/3485/RA4/Nut-WASH/INGO/20864,11/25/2022 4:53:25 PM,Overall,11036,10627,3209,3108,27980,5207,8418,9829,9780,33234
21,Somalia,2021,SOM-21/3485/RA4/Prot-CCCM/NGO/20860,2/9/2023 2:39:17 PM,Host Communities,900,2400,600,1800,5700,660,1646,350,1360,4016
21,Somalia,2021,SOM-21/3485/RA4/Prot-CCCM/NGO/20860,2/9/2023 2:39:17 PM,Internally Displaced People,1600,5800,1900,4800,14100,1700,5400,2000,3500,12600
21,Somalia,2021,SOM-21/3485/RA4/Prot-CCCM/NGO/20860,2/9/2023 2:39:17 PM,Other,90,90,0,0,180,64,56,0,0,120
21,Somalia,2021,SOM-21/3485/RA4/Prot-CCCM/NGO/20860,2/9/2023 2:39:17 PM,Overall,2640,8410,2530,6700,20280,2468,7214,2370,4930,16982
21,Somalia,2021,SOM-21/3485/RA4/Prot-CCCM/NGO/20860,2/9/2023 2:39:17 PM,Refugees,50,120,30,100,300,44,112,20,70,246
21,Somalia,2021,SOM-21/3485/RA4/WASH/NGO/20862,9/19/2022 8:55:10 AM,Host Communities,3288,5481,1096,4667,14532,3288,5481,1096,4667,14532
21,Somalia,2021,SOM-21/3485/RA4/WASH/NGO/20862,9/19/2022 8:55:10 AM,Internally Displaced People,5520,9200,1840,2040,18600,5520,9200,1840,2040,18600
21,Somalia,2021,SOM-21/3485/RA4/WASH/NGO/20862,9/19/2022 8:55:10 AM,Overall,8808,14681,2936,6707,33132,8808,14681,2936,6707,33132
21,Somalia,2021,SOM-21/3485/RA4/WASH-Ed/INGO/20858,1/12/2023 7:48:16 PM,Host Communities,4064,5080,5080,6096,20320,3707,4722,4807,5823,19059
21,Somalia,2021,SOM-21/3485/RA4/WASH-Ed/INGO/20858,1/12/2023 7:48:16 PM,Internally Displaced People,1736,2170,2170,2604,8680,1736,2170,2170,2604,8680
21,Somalia,2021,SOM-21/3485/RA4/WASH-Ed/INGO/20858,1/12/2023 7:48:16 PM,Overall,5800,7250,7250,8700,29000,5443,6892,6977,8427,27739
21,Somalia,2021,SOM-21/3485/RA4/WASH-Nut-CCCM/INGO/20917,11/25/2022 5:03:01 PM,Host Communities,5260,7380,3340,3910,19890,5531,9024,4601,5186,24342
21,Somalia,2021,SOM-21/3485/RA4/WASH-Nut-CCCM/INGO/20917,11/25/2022 5:03:01 PM,Internally Displaced People,3680,5260,1980,2190,13110,3031,4758,1926,2339,12054
21,Somalia,2021,SOM-21/3485/RA4/WASH-Nut-CCCM/INGO/20917,11/25/2022 5:03:01 PM,Overall,8940,12640,5320,6100,33000,8562,13782,6527,7525,36396
21,Somalia,2021,SOM-21/3485/RA5/EP/INGO/21013,9/1/2023 8:18:16 AM,Internally Displaced People,70,70,0,0,140,0,0,0,0,0
21,Somalia,2021,SOM-21/3485/RA5/EP/INGO/21013,9/1/2023 8:18:16 AM,Overall,70,70,0,0,140,0,0,0,0,0
21,Somalia,2021,SOM-21/3485/SA1/CCCM/INGO/18258,7/1/2022 2:31:29 PM,Internally Displaced People,9861,10683,2568,2568,25680,9861,10683,2568,2568,25680
21,Somalia,2021,SOM-21/3485/SA1/CCCM/INGO/18258,7/1/2022 2:31:29 PM,Overall,9861,10683,2568,2568,25680,9861,10683,2568,2568,25680
21,Somalia,2021,SOM-21/3485/SA1/CCCM/NGO/18117,7/14/2022 12:06:34 PM,Internally Displaced People,9000,14760,6000,6240,36000,9296,12647,6926,8815,37684
21,Somalia,2021,SOM-21/3485/SA1/CCCM/NGO/18117,7/14/2022 12:06:34 PM,Overall,9000,14760,6000,6240,36000,9296,12647,6926,8815,37684
21,Somalia,2021,SOM-21/3485/SA1/CCCM/NGO/18158,8/24/2022 2:10:55 PM,Internally Displaced People,10309,12159,18269,21093,61830,10309,12159,18269,21093,61830
21,Somalia,2021,SOM-21/3485/SA1/CCCM/NGO/18158,8/24/2022 2:10:55 PM,Overall,10309,12159,18269,21093,61830,10309,12159,18269,21093,61830
21,Somalia,2021,SOM-21/3485/SA1/CCCM/NGO/18215,7/14/2022 10:12:49 AM,Internally Displaced People,10800,14400,5400,5400,36000,10800,14400,5400,5400,36000
21,Somalia,2021,SOM-21/3485/SA1/CCCM/NGO/18215,7/14/2022 10:12:49 AM,Overall,10800,14400,5400,5400,36000,10800,14400,5400,5400,36000
21,Somalia,2021,SOM-21/3485/SA1/CCCM-Prot/NGO/18120,7/18/2022 7:52:52 AM,Internally Displaced People,1721,2380,4889,6553,15543,3100,5014,4968,6690,19772
21,Somalia,2021,SOM-21/3485/SA1/CCCM-Prot/NGO/18120,7/18/2022 7:52:52 AM,Overall,1721,2380,4889,6553,15543,3100,5014,4968,6690,19772
21,Somalia,2021,SOM-21/3485/SA1/Ed/INGO/18124,7/21/2022 10:14:18 AM,Host Communities,33,20,886,734,1673,56,37,1113,908,2114
21,Somalia,2021,SOM-21/3485/SA1/Ed/INGO/18124,7/21/2022 10:14:18 AM,Internally Displaced People,14,8,380,315,717,27,13,708,593,1341
21,Somalia,2021,SOM-21/3485/SA1/Ed/INGO/18124,7/21/2022 10:14:18 AM,Overall,47,28,1266,1049,2390,83,50,1821,1501,3455
21,Somalia,2021,SOM-21/3485/SA1/Ed/INGO/18205,8/1/2022 8:18:13 AM,Host Communities,81,49,1318,1103,2551,58,26,1102,955,2141
21,Somalia,2021,SOM-21/3485/SA1/Ed/INGO/18205,8/1/2022 8:18:13 AM,Internally Displaced People,44,26,710,594,1374,50,23,938,814,1825
21,Somalia,2021,SOM-21/3485/SA1/Ed/INGO/18205,8/1/2022 8:18:13 AM,Overall,125,75,2028,1697,3925,108,49,2040,1769,3966
21,Somalia,2021,SOM-21/3485/SA1/Ed/NGO/18101,7/31/2022 2:36:03 PM,Host Communities,8,10,800,630,1448,6,2,474,339,821
21,Somalia,2021,SOM-21/3485/SA1/Ed/NGO/18101,7/31/2022 2:36:03 PM,Internally Displaced People,6,8,920,950,1884,9,15,1309,1212,2545
21,Somalia,2021,SOM-21/3485/SA1/Ed/NGO/18101,7/31/2022 2:36:03 PM,Overall,14,18,1720,1580,3332,15,17,1783,1551,3366
21,Somalia,2021,SOM-21/3485/SA1/EP/INGO/18126,5/14/2022 8:57:11 AM,Other,7500,2500,0,0,10000,7500,2500,0,0,10000
21,Somalia,2021,SOM-21/3485/SA1/EP/INGO/18126,5/14/2022 8:57:11 AM,Overall,7500,2500,0,0,10000,7500,2500,0,0,10000
21,Somalia,2021,SOM-21/3485/SA1/FSC/INGO/18210,2/9/2022 9:04:06 AM,Host Communities,831,1369,1321,1369,4890,831,1369,1321,1369,4890
21,Somalia,2021,SOM-21/3485/SA1/FSC/INGO/18210,2/9/2022 9:04:06 AM,Overall,831,1369,1321,1369,4890,831,1369,1321,1369,4890
21,Somalia,2021,SOM-21/3485/SA1/FSC/NGO/18115,3/1/2022 3:30:41 PM,Host Communities,469,885,1273,1343,3970,460,880,1250,1325,3915
21,Somalia,2021,SOM-21/3485/SA1/FSC/NGO/18115,3/1/2022 3:30:41 PM,Internally Displaced People,31,49,59,91,230,40,54,82,109,285
21,Somalia,2021,SOM-21/3485/SA1/FSC/NGO/18115,3/1/2022 3:30:41 PM,Overall,500,934,1332,1434,4200,500,934,1332,1434,4200
21,Somalia,2021,SOM-21/3485/SA1/FSC/NGO/18116,2/8/2022 10:19:04 AM,Host Communities,410,478,205,273,1366,410,478,205,273,1366
21,Somalia,2021,SOM-21/3485/SA1/FSC/NGO/18116,2/8/2022 10:19:04 AM,Internally Displaced People,176,205,89,117,587,176,205,89,117,587
21,Somalia,2021,SOM-21/3485/SA1/FSC/NGO/18116,2/8/2022 10:19:04 AM,Overall,586,683,294,390,1953,586,683,294,390,1953
21,Somalia,2021,SOM-21/3485/SA1/FSC/NGO/18171,5/4/2022 9:15:04 AM,Host Communities,117,195,234,234,780,195,332,399,411,1337
21,Somalia,2021,SOM-21/3485/SA1/FSC/NGO/18171,5/4/2022 9:15:04 AM,Internally Displaced People,468,780,936,936,3120,460,775,931,931,3097
21,Somalia,2021,SOM-21/3485/SA1/FSC/NGO/18171,5/4/2022 9:15:04 AM,Overall,585,975,1170,1170,3900,655,1107,1330,1342,4434
21,Somalia,2021,SOM-21/3485/SA1/FSC/NGO/18176,2/7/2022 9:29:09 AM,Host Communities,508,763,169,254,1694,508,763,169,254,1694
21,Somalia,2021,SOM-21/3485/SA1/FSC/NGO/18176,2/7/2022 9:29:09 AM,Internally Displaced People,763,1144,254,381,2542,763,1144,254,381,2542
21,Somalia,2021,SOM-21/3485/SA1/FSC/NGO/18176,2/7/2022 9:29:09 AM,Overall,1271,1907,423,635,4236,1271,1907,423,635,4236
21,Somalia,2021,SOM-21/3485/SA1/FSC/NGO/18244,1/21/2022 6:47:17 AM,Host Communities,632,1048,1260,1260,4200,632,1048,1260,1260,4200
21,Somalia,2021,SOM-21/3485/SA1/FSC/NGO/18244,1/21/2022 6:47:17 AM,Internally Displaced People,268,452,540,540,1800,268,452,540,540,1800
21,Somalia,2021,SOM-21/3485/SA1/FSC/NGO/18244,1/21/2022 6:47:17 AM,Overall,900,1500,1800,1800,6000,900,1500,1800,1800,6000
21,Somalia,2021,SOM-21/3485/SA1/H/INGO/18247,7/11/2022 8:05:04 AM,Host Communities,13726,21600,4037,4037,43400,6603,31155,5071,5976,48805
21,Somalia,2021,SOM-21/3485/SA1/H/INGO/18247,7/11/2022 8:05:04 AM,Internally Displaced People,6095,8191,2021,2021,18328,2866,13458,2188,2567,21079
21,Somalia,2021,SOM-21/3485/SA1/H/INGO/18247,7/11/2022 8:05:04 AM,Other,21,30,0,0,51,59,98,0,0,157
21,Somalia,2021,SOM-21/3485/SA1/H/INGO/18247,7/11/2022 8:05:04 AM,Overall,19910,30001,6138,6138,62187,9528,44711,7259,8543,70041
21,Somalia,2021,SOM-21/3485/SA1/H/INGO/18247,7/11/2022 8:05:04 AM,Refugees,68,180,80,80,408,0,0,0,0,0
21,Somalia,2021,SOM-21/3485/SA1/H/INGO/18259,9/20/2022 2:30:25 PM,Host Communities,1932,7448,3774,3928,17082,2568,9855,2805,3419,18647
21,Somalia,2021,SOM-21/3485/SA1/H/INGO/18259,9/20/2022 2:30:25 PM,Internally Displaced People,828,3192,1618,1684,7322,1100,4224,1202,1465,7991
21,Somalia,2021,SOM-21/3485/SA1/H/INGO/18259,9/20/2022 2:30:25 PM,Overall,2760,10640,5392,5612,24404,3668,14079,4007,4884,26638
21,Somalia,2021,SOM-21/3485/SA1/H/NGO/18214,7/11/2022 8:03:53 AM,Host Communities,1570,1848,2053,2172,7643,1540,2921,2117,2234,8812
21,Somalia,2021,SOM-21/3485/SA1/H/NGO/18214,7/11/2022 8:03:53 AM,Internally Displaced People,824,1743,1410,1286,5263,1201,2530,1450,1338,6519
21,Somalia,2021,SOM-21/3485/SA1/H/NGO/18214,7/11/2022 8:03:53 AM,Other,10,14,0,0,24,10,14,0,0,24
21,Somalia,2021,SOM-21/3485/SA1/H/NGO/18214,7/11/2022 8:03:53 AM,Overall,3277,4599,4519,4628,17023,3796,7245,4870,4913,20824
21,Somalia,2021,SOM-21/3485/SA1/H/NGO/18214,7/11/2022 8:03:53 AM,Refugees,873,994,1056,1170,4093,1045,1780,1303,1341,5469
21,Somalia,2021,SOM-21/3485/SA1/H-Nut/INGO/18230,6/9/2022 6:20:23 AM,Host Communities,500,3400,5200,4700,13800,3800,7545,3376,4729,19450
21,Somalia,2021,SOM-21/3485/SA1/H-Nut/INGO/18230,6/9/2022 6:20:23 AM,Internally Displaced People,150,300,1000,750,2200,250,443,807,863,2363
21,Somalia,2021,SOM-21/3485/SA1/H-Nut/INGO/18230,6/9/2022 6:20:23 AM,Overall,650,3700,6200,5450,16000,4050,7988,4183,5592,21813
21,Somalia,2021,SOM-21/3485/SA1/H-Nut/NGO/18166,9/14/2022 8:51:39 AM,Host Communities,720,1800,2420,3200,8140,870,1926,2510,3316,8622
21,Somalia,2021,SOM-21/3485/SA1/H-Nut/NGO/18166,9/14/2022 8:51:39 AM,Internally Displaced People,800,2000,2420,3040,8260,862,2087,2491,3074,8514
21,Somalia,2021,SOM-21/3485/SA1/H-Nut/NGO/18166,9/14/2022 8:51:39 AM,Overall,1520,3800,4840,6240,16400,1732,4013,5001,6390,17136
21,Somalia,2021,SOM-21/3485/SA1/H-Nut/NGO/18209,7/11/2022 8:02:19 AM,Host Communities,700,5500,570,610,7380,688,5500,522,600,7310
21,Somalia,2021,SOM-21/3485/SA1/H-Nut/NGO/18209,7/11/2022 8:02:19 AM,Internally Displaced People,800,5700,630,740,7870,797,5500,656,745,7698
21,Somalia,2021,SOM-21/3485/SA1/H-Nut/NGO/18209,7/11/2022 8:02:19 AM,Overall,1500,11200,1200,1350,15250,1485,11000,1178,1345,15008
21,Somalia,2021,SOM-21/3485/SA1/H-WASH/NGO/18211,7/12/2022 6:35:51 AM,Host Communities,450,1000,1620,1810,4880,612,1251,1578,1909,5350
21,Somalia,2021,SOM-21/3485/SA1/H-WASH/NGO/18211,7/12/2022 6:35:51 AM,Internally Displaced People,800,1200,2020,2000,6020,756,1580,2111,2345,6792
21,Somalia,2021,SOM-21/3485/SA1/H-WASH/NGO/18211,7/12/2022 6:35:51 AM,Overall,1250,2200,3640,3810,10900,1368,2831,3689,4254,12142
21,Somalia,2021,SOM-21/3485/SA1/Nut/INGO/18109,6/22/2022 9:50:21 AM,Host Communities,0,17752,16108,16765,50625,0,15346,18093,24398,57837
21,Somalia,2021,SOM-21/3485/SA1/Nut/INGO/18109,6/22/2022 9:50:21 AM,Internally Displaced People,0,3133,2843,2958,8934,0,2709,3193,4306,10208
21,Somalia,2021,SOM-21/3485/SA1/Nut/INGO/18109,6/22/2022 9:50:21 AM,Overall,0,20885,18951,19723,59559,0,18055,21286,28704,68045
21,Somalia,2021,SOM-21/3485/SA1/Nut/INGO/18112,3/7/2023 7:27:59 PM,Host Communities,0,6800,4385,6099,17284,27,14383,7593,9862,31865
21,Somalia,2021,SOM-21/3485/SA1/Nut/INGO/18112,3/7/2023 7:27:59 PM,Internally Displaced People,0,10802,6412,10096,27310,5,19755,8343,10159,38262
21,Somalia,2021,SOM-21/3485/SA1/Nut/INGO/18112,3/7/2023 7:27:59 PM,Overall,0,17602,10797,16195,44594,32,34138,15936,20021,70127
21,Somalia,2021,SOM-21/3485/SA1/Nut/NGO/18191,7/25/2023 6:56:55 AM,Host Communities,30,2167,2494,2322,7013,30,2167,2494,2322,7013
21,Somalia,2021,SOM-21/3485/SA1/Nut/NGO/18191,7/25/2023 6:56:55 AM,Internally Displaced People,20,353,406,378,1157,20,353,406,378,1157
21,Somalia,2021,SOM-21/3485/SA1/Nut/NGO/18191,7/25/2023 6:56:55 AM,Overall,50,2520,2900,2700,8170,50,2520,2900,2700,8170
21,Somalia,2021,SOM-21/3485/SA1/Nut/NGO/18220,1/26/2023 6:54:16 AM,Host Communities,0,2384,790,830,4004,0,11838,6131,6793,24762
21,Somalia,2021,SOM-21/3485/SA1/Nut/NGO/18220,1/26/2023 6:54:16 AM,Internally Displaced People,0,596,198,208,1002,0,2341,1589,1744,5674
21,Somalia,2021,SOM-21/3485/SA1/Nut/NGO/18220,1/26/2023 6:54:16 AM,Other,0,298,99,104,501,0,178,73,82,333
21,Somalia,2021,SOM-21/3485/SA1/Nut/NGO/18220,1/26/2023 6:54:16 AM,Overall,0,3278,1087,1142,5507,0,14357,7793,8619,30769
21,Somalia,2021,SOM-21/3485/SA1/Prot/INGO/18111,2/14/2022 2:16:59 PM,Host Communities,2056,2828,103,154,5141,1311,2431,245,154,4141
21,Somalia,2021,SOM-21/3485/SA1/Prot/INGO/18111,2/14/2022 2:16:59 PM,Internally Displaced People,5858,8017,318,472,14665,4359,8296,985,1896,15536
21,Somalia,2021,SOM-21/3485/SA1/Prot/INGO/18111,2/14/2022 2:16:59 PM,Other,411,565,21,31,1028,396,410,15,28,849
21,Somalia,2021,SOM-21/3485/SA1/Prot/INGO/18111,2/14/2022 2:16:59 PM,Overall,8325,11410,442,657,20834,6066,11137,1245,2078,20526
21,Somalia,2021,SOM-21/3485/SA1/Prot/INGO/18135,3/1/2022 3:35:52 PM,Host Communities,250,350,600,750,1950,1000,670,1000,920,3590
21,Somalia,2021,SOM-21/3485/SA1/Prot/INGO/18135,3/1/2022 3:35:52 PM,Internally Displaced People,600,750,700,900,2950,2403,1200,2500,3041,9144
21,Somalia,2021,SOM-21/3485/SA1/Prot/INGO/18135,3/1/2022 3:35:52 PM,Overall,850,1100,1300,1650,4900,3403,1870,3500,3961,12734
21,Somalia,2021,SOM-21/3485/SA1/Prot/NGO/18103,3/26/2022 2:45:14 PM,Host Communities,150,450,100,100,800,162,443,103,105,813
21,Somalia,2021,SOM-21/3485/SA1/Prot/NGO/18103,3/26/2022 2:45:14 PM,Internally Displaced People,400,2640,400,600,4040,396,2619,415,611,4041
21,Somalia,2021,SOM-21/3485/SA1/Prot/NGO/18103,3/26/2022 2:45:14 PM,Other,40,80,20,20,160,36,87,23,27,173
21,Somalia,2021,SOM-21/3485/SA1/Prot/NGO/18103,3/26/2022 2:45:14 PM,Overall,590,3170,520,720,5000,594,3149,541,743,5027
21,Somalia,2021,SOM-21/3485/SA1/Prot/NGO/18162,7/26/2022 10:09:13 AM,Host Communities,116,239,950,605,1910,116,239,950,605,1910
21,Somalia,2021,SOM-21/3485/SA1/Prot/NGO/18162,7/26/2022 10:09:13 AM,Internally Displaced People,206,469,1700,1305,3680,206,469,1700,1305,3680
21,Somalia,2021,SOM-21/3485/SA1/Prot/NGO/18162,7/26/2022 10:09:13 AM,Overall,322,708,2650,1910,5590,322,708,2650,1910,5590
21,Somalia,2021,SOM-21/3485/SA1/Prot/NGO/18262,11/14/2022 7:57:12 AM,Host Communities,190,300,100,170,760,190,300,100,170,760
21,Somalia,2021,SOM-21/3485/SA1/Prot/NGO/18262,11/14/2022 7:57:12 AM,Internally Displaced People,280,520,200,450,1450,280,520,200,450,1450
21,Somalia,2021,SOM-21/3485/SA1/Prot/NGO/18262,11/14/2022 7:57:12 AM,Overall,490,840,330,670,2330,490,840,330,670,2330
21,Somalia,2021,SOM-21/3485/SA1/Prot/NGO/18262,11/14/2022 7:57:12 AM,Refugees,20,20,30,50,120,20,20,30,50,120
21,Somalia,2021,SOM-21/3485/SA1/Prot-WASH/INGO/18301,10/19/2022 5:56:17 AM,Host Communities,500,800,800,900,3000,2000,3050,3500,2350,10900
21,Somalia,2021,SOM-21/3485/SA1/Prot-WASH/INGO/18301,10/19/2022 5:56:17 AM,Internally Displaced People,5000,7000,6000,9000,27000,20708,15796,33050,25190,94744
21,Somalia,2021,SOM-21/3485/SA1/Prot-WASH/INGO/18301,10/19/2022 5:56:17 AM,Overall,5500,7800,6800,9900,30000,22708,18846,36550,27540,105644
21,Somalia,2021,SOM-21/3485/SA1/Shelter/INGO/18180,4/25/2022 8:02:33 AM,Host Communities,112,112,263,263,750,0,0,0,0,0
21,Somalia,2021,SOM-21/3485/SA1/Shelter/INGO/18180,4/25/2022 8:02:33 AM,Internally Displaced People,450,450,1050,1050,3000,1006,1086,2149,1964,6205
21,Somalia,2021,SOM-21/3485/SA1/Shelter/INGO/18180,4/25/2022 8:02:33 AM,Overall,562,562,1313,1313,3750,1006,1086,2149,1964,6205
21,Somalia,2021,SOM-21/3485/SA1/Shelter/NGO/18142,4/29/2022 6:51:31 AM,Host Communities,242,248,462,428,1380,290,361,542,565,1758
21,Somalia,2021,SOM-21/3485/SA1/Shelter/NGO/18142,4/29/2022 6:51:31 AM,Internally Displaced People,2208,2272,4228,3912,12620,2273,2489,4691,4532,13985
21,Somalia,2021,SOM-21/3485/SA1/Shelter/NGO/18142,4/29/2022 6:51:31 AM,Overall,2450,2520,4690,4340,14000,2563,2850,5233,5097,15743
21,Somalia,2021,SOM-21/3485/SA1/Shelter/NGO/18170,2/7/2022 6:33:43 AM,Internally Displaced People,2016,2688,1008,1008,6720,2016,2688,1008,1008,6720
21,Somalia,2021,SOM-21/3485/SA1/Shelter/NGO/18170,2/7/2022 6:33:43 AM,Overall,2016,2688,1008,1008,6720,2016,2688,1008,1008,6720
21,Somalia,2021,SOM-21/3485/SA1/Shelter/NGO/18201,2/1/2022 12:28:20 PM,Internally Displaced People,1500,1500,1200,1200,5400,1500,1500,1200,1200,5400
21,Somalia,2021,SOM-21/3485/SA1/Shelter/NGO/18201,2/1/2022 12:28:20 PM,Overall,1500,1500,1200,1200,5400,1500,1500,1200,1200,5400
21,Somalia,2021,SOM-21/3485/SA1/WASH/INGO/18185,7/12/2022 8:11:26 AM,Host Communities,1824,1976,1520,2280,7600,1824,1976,1520,2280,7600
21,Somalia,2021,SOM-21/3485/SA1/WASH/INGO/18185,7/12/2022 8:11:26 AM,Internally Displaced People,480,816,408,696,2400,480,816,408,696,2400
21,Somalia,2021,SOM-21/3485/SA1/WASH/INGO/18185,7/12/2022 8:11:26 AM,Overall,2304,2792,1928,2976,10000,2304,2792,1928,2976,10000
21,Somalia,2021,SOM-21/3485/SA1/WASH/NGO/18125,6/27/2022 6:41:37 AM,Host Communities,1961,2941,490,736,6128,2040,2662,1394,1536,7632
21,Somalia,2021,SOM-21/3485/SA1/WASH/NGO/18125,6/27/2022 6:41:37 AM,Internally Displaced People,2265,3398,567,850,7080,4190,5752,754,1539,12235
21,Somalia,2021,SOM-21/3485/SA1/WASH/NGO/18125,6/27/2022 6:41:37 AM,Overall,4226,6339,1057,1586,13208,6230,8414,2148,3075,19867
21,Somalia,2021,SOM-21/3485/SA1/WASH/NGO/18133,4/13/2022 10:18:04 AM,Host Communities,1575,2625,3150,3150,10500,1575,2625,3150,3150,10500
21,Somalia,2021,SOM-21/3485/SA1/WASH/NGO/18133,4/13/2022 10:18:04 AM,Internally Displaced People,675,1125,1350,1350,4500,675,1125,1350,1350,4500
21,Somalia,2021,SOM-21/3485/SA1/WASH/NGO/18133,4/13/2022 10:18:04 AM,Overall,2250,3750,4500,4500,15000,2250,3750,4500,4500,15000
21,Somalia,2021,SOM-21/3485/SA1/WASH/NGO/18216,7/14/2022 8:17:40 AM,Host Communities,1550,3700,610,610,6470,1550,3700,610,610,6470
21,Somalia,2021,SOM-21/3485/SA1/WASH/NGO/18216,7/14/2022 8:17:40 AM,Internally Displaced People,1950,4100,820,820,7690,1950,4100,820,820,7690
21,Somalia,2021,SOM-21/3485/SA1/WASH/NGO/18216,7/14/2022 8:17:40 AM,Overall,3500,7800,1430,1430,14160,3500,7800,1430,1430,14160
21,Somalia,2021,SOM-21/3485/SA1/WASH-H/INGO/18271,5/30/2022 8:31:39 AM,Other,5060,5500,5500,5940,22000,15229,26885,13807,18216,74137
21,Somalia,2021,SOM-21/3485/SA1/WASH-H/INGO/18271,5/30/2022 8:31:39 AM,Overall,5060,5500,5500,5940,22000,15229,26885,13807,18216,74137
21,Somalia,2022,SOM-22/3485/RA1/EP/INGO/21878,7/21/2023 8:26:23 AM,Other,7500,2500,0,0,10000,7500,2500,0,0,10000
21,Somalia,2022,SOM-22/3485/RA1/EP/INGO/21878,7/21/2023 8:26:23 AM,Overall,7500,2500,0,0,10000,7500,2500,0,0,10000
21,Somalia,2022,SOM-22/3485/RA2 /CCCM/NGO/21985,4/14/2023 6:41:29 AM,Host Communities,1396,2291,950,950,5587,746,3369,395,586,5096
21,Somalia,2022,SOM-22/3485/RA2 /CCCM/NGO/21985,4/14/2023 6:41:29 AM,Internally Displaced People,5586,9161,3798,3799,22344,2663,7536,5463,7194,22856
21,Somalia,2022,SOM-22/3485/RA2 /CCCM/NGO/21985,4/14/2023 6:41:29 AM,Overall,6982,11452,4748,4749,27931,3409,10905,5858,7780,27952
21,Somalia,2022,SOM-22/3485/RA2 /CCCM/NGO/21988,4/12/2023 2:22:30 PM,Internally Displaced People,5799,15279,5323,8721,35122,5597,19626,4886,7432,37541
21,Somalia,2022,SOM-22/3485/RA2 /CCCM/NGO/21988,4/12/2023 2:22:30 PM,Overall,5799,15279,5323,8721,35122,5597,19626,4886,7432,37541
21,Somalia,2022,SOM-22/3485/RA2 /CP-GBV/NGO/21975,3/2/2023 11:33:38 AM,Host Communities,600,900,500,900,2900,355,600,300,610,1865
21,Somalia,2022,SOM-22/3485/RA2 /CP-GBV/NGO/21975,3/2/2023 11:33:38 AM,Internally Displaced People,1000,2186,900,1300,5386,720,1500,1300,1600,5120
21,Somalia,2022,SOM-22/3485/RA2 /CP-GBV/NGO/21975,3/2/2023 11:33:38 AM,Other,50,100,100,100,350,60,170,165,130,525
21,Somalia,2022,SOM-22/3485/RA2 /CP-GBV/NGO/21975,3/2/2023 11:33:38 AM,Overall,1650,3186,1500,2300,8636,1135,2270,1765,2340,7510
21,Somalia,2022,SOM-22/3485/RA2 /FSC/INGO/21972,3/9/2023 1:02:10 PM,Host Communities,388,413,213,237,1251,516,550,283,316,1665
21,Somalia,2022,SOM-22/3485/RA2 /FSC/INGO/21972,3/9/2023 1:02:10 PM,Internally Displaced People,7368,7844,4041,4516,23769,9810,10443,5380,6012,31645
21,Somalia,2022,SOM-22/3485/RA2 /FSC/INGO/21972,3/9/2023 1:02:10 PM,Overall,7756,8257,4254,4753,25020,10326,10993,5663,6328,33310
21,Somalia,2022,SOM-22/3485/RA2 /FSC/INGO/21993,2/10/2023 7:37:16 AM,Host Communities,365,654,415,366,1800,365,654,415,366,1800
21,Somalia,2022,SOM-22/3485/RA2 /FSC/INGO/21993,2/10/2023 7:37:16 AM,Internally Displaced People,1206,1944,1584,2280,7014,1206,1944,1584,2280,7014
21,Somalia,2022,SOM-22/3485/RA2 /FSC/INGO/21993,2/10/2023 7:37:16 AM,Overall,1571,2598,1999,2646,8814,1571,2598,1999,2646,8814
21,Somalia,2022,SOM-22/3485/RA2 /FSC/INGO/22052,3/9/2023 12:38:48 PM,Host Communities,919,995,956,956,3826,919,995,956,956,3826
21,Somalia,2022,SOM-22/3485/RA2 /FSC/INGO/22052,3/9/2023 12:38:48 PM,Internally Displaced People,1705,1847,1777,1777,7106,1705,1847,1777,1777,7106
21,Somalia,2022,SOM-22/3485/RA2 /FSC/INGO/22052,3/9/2023 12:38:48 PM,Overall,2624,2842,2733,2733,10932,2624,2842,2733,2733,10932
21,Somalia,2022,SOM-22/3485/RA2 /FSC/INGO/22055,6/22/2023 8:40:22 AM,Host Communities,688,1134,1094,1134,4050,974,1606,1547,1606,5733
21,Somalia,2022,SOM-22/3485/RA2 /FSC/INGO/22055,6/22/2023 8:40:22 AM,Internally Displaced People,928,1529,1474,1529,5460,741,1222,1179,1221,4363
21,Somalia,2022,SOM-22/3485/RA2 /FSC/INGO/22055,6/22/2023 8:40:22 AM,Overall,1616,2663,2568,2663,9510,1715,2828,2726,2827,10096
21,Somalia,2022,SOM-22/3485/RA2 /FSC/INGO/22056,2/10/2023 7:19:30 AM,Host Communities,1000,1200,250,300,2750,2025,1976,2753,2643,9397
21,Somalia,2022,SOM-22/3485/RA2 /FSC/INGO/22056,2/10/2023 7:19:30 AM,Internally Displaced People,400,500,300,250,1450,707,709,643,625,2684
21,Somalia,2022,SOM-22/3485/RA2 /FSC/INGO/22056,2/10/2023 7:19:30 AM,Overall,1400,1700,550,550,4200,2732,2685,3396,3268,12081
21,Somalia,2022,SOM-22/3485/RA2 /FSC/NGO/22005,5/29/2023 2:55:36 PM,Host Communities,464,763,600,899,2726,464,763,600,899,2726
21,Somalia,2022,SOM-22/3485/RA2 /FSC/NGO/22005,5/29/2023 2:55:36 PM,Internally Displaced People,577,950,746,1119,3392,577,950,746,1119,3392
21,Somalia,2022,SOM-22/3485/RA2 /FSC/NGO/22005,5/29/2023 2:55:36 PM,Other,378,622,489,733,2222,378,622,489,733,2222
21,Somalia,2022,SOM-22/3485/RA2 /FSC/NGO/22005,5/29/2023 2:55:36 PM,Overall,1419,2335,1835,2751,8340,1419,2335,1835,2751,8340
21,Somalia,2022,SOM-22/3485/RA2 /FSC/NGO/22018,2/2/2023 4:58:12 AM,Host Communities,2000,2800,280,280,5360,2000,2800,280,280,5360
21,Somalia,2022,SOM-22/3485/RA2 /FSC/NGO/22018,2/2/2023 4:58:12 AM,Internally Displaced People,2416,3200,320,320,6256,2416,3200,320,320,6256
21,Somalia,2022,SOM-22/3485/RA2 /FSC/NGO/22018,2/2/2023 4:58:12 AM,Overall,4416,6000,600,600,11616,4416,6000,600,600,11616
21,Somalia,2022,SOM-22/3485/RA2 /GBV-CP/NGO/21973,3/22/2023 5:25:56 AM,Host Communities,200,1200,200,800,2400,0,0,0,0,0
21,Somalia,2022,SOM-22/3485/RA2 /GBV-CP/NGO/21973,3/22/2023 5:25:56 AM,Internally Displaced People,200,3000,200,1200,4600,120,2981,396,1309,4806
21,Somalia,2022,SOM-22/3485/RA2 /GBV-CP/NGO/21973,3/22/2023 5:25:56 AM,Overall,400,4200,400,2000,7000,120,2981,396,1309,4806
21,Somalia,2022,SOM-22/3485/RA2 /H/INGO/22070,4/13/2023 7:11:08 AM,Host Communities,3591,4389,6583,5387,19950,581,3439,1972,1693,7685
21,Somalia,2022,SOM-22/3485/RA2 /H/INGO/22070,4/13/2023 7:11:08 AM,Internally Displaced People,189,231,347,283,1050,31,181,104,89,405
21,Somalia,2022,SOM-22/3485/RA2 /H/INGO/22070,4/13/2023 7:11:08 AM,Overall,3780,4620,6930,5670,21000,612,3620,2076,1782,8090
21,Somalia,2022,SOM-22/3485/RA2 /H/NGO/22015,1/25/2023 6:43:22 PM,Host Communities,5480,6280,1441,1499,14700,5971,6215,1493,1554,15233
21,Somalia,2022,SOM-22/3485/RA2 /H/NGO/22015,1/25/2023 6:43:22 PM,Internally Displaced People,2470,2570,617,643,6300,2559,2663,640,666,6528
21,Somalia,2022,SOM-22/3485/RA2 /H/NGO/22015,1/25/2023 6:43:22 PM,Overall,7950,8850,2058,2142,21000,8530,8878,2133,2220,21761
21,Somalia,2022,SOM-22/3485/RA2 /H-Nut/INGO/22000,2/4/2023 9:48:03 AM,Host Communities,2570,2684,2624,2624,10502,1763,2769,4153,3901,12586
21,Somalia,2022,SOM-22/3485/RA2 /H-Nut/INGO/22000,2/4/2023 9:48:03 AM,Internally Displaced People,1101,1149,1124,1124,4498,818,1308,1744,1578,5448
21,Somalia,2022,SOM-22/3485/RA2 /H-Nut/INGO/22000,2/4/2023 9:48:03 AM,Overall,3671,3833,3748,3748,15000,2581,4077,5897,5479,18034
21,Somalia,2022,SOM-22/3485/RA2 /H-Nut/NGO/21976,6/1/2023 7:24:05 PM,Host Communities,1200,3400,2500,2100,9200,1241,3420,2550,2150,9361
21,Somalia,2022,SOM-22/3485/RA2 /H-Nut/NGO/21976,6/1/2023 7:24:05 PM,Internally Displaced People,1400,3600,2800,3000,10800,1424,3700,2950,3150,11224
21,Somalia,2022,SOM-22/3485/RA2 /H-Nut/NGO/21976,6/1/2023 7:24:05 PM,Overall,2600,7000,5300,5100,20000,2665,7120,5500,5300,20585
21,Somalia,2022,SOM-22/3485/RA2 /L/UN/22046,1/26/2023 6:09:54 AM,Other,50,50,0,0,100,1320,1319,0,0,2639
21,Somalia,2022,SOM-22/3485/RA2 /L/UN/22046,1/26/2023 6:09:54 AM,Overall,50,50,0,0,100,1320,1319,0,0,2639
21,Somalia,2022,SOM-22/3485/RA2 /Nut-H/INGO/21996,2/22/2023 6:21:46 AM,Host Communities,0,0,2700,2700,5400,0,475,3499,3745,7719
21,Somalia,2022,SOM-22/3485/RA2 /Nut-H/INGO/21996,2/22/2023 6:21:46 AM,Internally Displaced People,0,0,2741,2701,5442,0,895,3193,4103,8191
21,Somalia,2022,SOM-22/3485/RA2 /Nut-H/INGO/21996,2/22/2023 6:21:46 AM,Overall,0,0,5441,5401,10842,0,1370,6692,7848,15910
21,Somalia,2022,SOM-22/3485/RA2 /Nut-H/NGO/21977,2/4/2023 9:49:42 AM,Host Communities,1500,3750,5125,5125,15500,1928,4210,6230,6430,18798
21,Somalia,2022,SOM-22/3485/RA2 /Nut-H/NGO/21977,2/4/2023 9:49:42 AM,Internally Displaced People,1000,2500,3000,3000,9500,1250,2829,3680,3560,11319
21,Somalia,2022,SOM-22/3485/RA2 /Nut-H/NGO/21977,2/4/2023 9:49:42 AM,Overall,2500,6250,8125,8125,25000,3178,7039,9910,9990,30117
21,Somalia,2022,SOM-22/3485/RA2 /Nut-H/NGO/21978,6/9/2023 7:10:51 AM,Host Communities,10000,6700,6517,6783,30000,5000,9090,6517,6783,27390
21,Somalia,2022,SOM-22/3485/RA2 /Nut-H/NGO/21978,6/9/2023 7:10:51 AM,Overall,5000,6700,6517,6783,25000,5000,9090,6517,6783,27390
21,Somalia,2022,SOM-22/3485/RA2 /Nut-H/NGO/21992,4/3/2023 7:27:19 AM,Host Communities,700,5000,600,600,6900,700,5000,600,600,6900
21,Somalia,2022,SOM-22/3485/RA2 /Nut-H/NGO/21992,4/3/2023 7:27:19 AM,Internally Displaced People,800,6000,600,700,8100,800,6000,600,700,8100
21,Somalia,2022,SOM-22/3485/RA2 /Nut-H/NGO/21992,4/3/2023 7:27:19 AM,Overall,1500,11000,1200,1300,15000,1500,11000,1200,1300,15000
21,Somalia,2022,SOM-22/3485/RA2 /Nut-H/NGO/22011,1/30/2023 7:29:17 PM,Host Communities,1125,2815,3655,3655,11250,1170,3991,4583,4680,14424
21,Somalia,2022,SOM-22/3485/RA2 /Nut-H/NGO/22011,1/30/2023 7:29:17 PM,Internally Displaced People,375,935,1220,1220,3750,390,1330,1528,1560,4808
21,Somalia,2022,SOM-22/3485/RA2 /Nut-H/NGO/22011,1/30/2023 7:29:17 PM,Overall,1500,3750,4875,4875,15000,1560,5321,6111,6240,19232
21,Somalia,2022,SOM-22/3485/RA2 /Prot/NGO/21981,2/16/2023 12:02:19 PM,Host Communities,0,51,0,46,97,0,51,0,46,97
21,Somalia,2022,SOM-22/3485/RA2 /Prot/NGO/21981,2/16/2023 12:02:19 PM,Internally Displaced People,144,1050,3,1100,2297,144,1050,3,1100,2297
21,Somalia,2022,SOM-22/3485/RA2 /Prot/NGO/21981,2/16/2023 12:02:19 PM,Overall,144,1105,3,1153,2405,144,1105,3,1153,2405
21,Somalia,2022,SOM-22/3485/RA2 /Prot/NGO/21981,2/16/2023 12:02:19 PM,Refugees,0,4,0,7,11,0,4,0,7,11
21,Somalia,2022,SOM-22/3485/RA2 /Shelter/NGO/21970,1/31/2023 1:11:31 PM,Internally Displaced People,6750,9450,4050,6750,27000,5959,7140,7852,9410,30361
21,Somalia,2022,SOM-22/3485/RA2 /Shelter/NGO/21970,1/31/2023 1:11:31 PM,Overall,6750,9450,4050,6750,27000,5959,7140,7852,9410,30361
21,Somalia,2022,SOM-22/3485/RA2 /Shelter/NGO/21990,2/9/2023 3:08:53 PM,Internally Displaced People,4076,4076,8662,8662,25476,3590,4209,12125,12090,32014
21,Somalia,2022,SOM-22/3485/RA2 /Shelter/NGO/21990,2/9/2023 3:08:53 PM,Overall,4076,4076,8662,8662,25476,3590,4209,12125,12090,32014
21,Somalia,2022,SOM-22/3485/RA2 /Shelter/NGO/22037,2/24/2023 8:38:40 AM,Internally Displaced People,7500,7500,6000,6000,27000,7500,7500,6000,6000,27000
21,Somalia,2022,SOM-22/3485/RA2 /Shelter/NGO/22037,2/24/2023 8:38:40 AM,Overall,7500,7500,6000,6000,27000,7500,7500,6000,6000,27000
21,Somalia,2022,SOM-22/3485/RA2 /WASH/INGO/22003,6/8/2023 12:58:39 PM,Host Communities,9737,11984,7490,8239,37450,10071,12395,8522,7747,38735
21,Somalia,2022,SOM-22/3485/RA2 /WASH/INGO/22003,6/8/2023 12:58:39 PM,Internally Displaced People,4173,5136,3210,3531,16050,6714,8263,5681,5165,25823
21,Somalia,2022,SOM-22/3485/RA2 /WASH/INGO/22003,6/8/2023 12:58:39 PM,Overall,13910,17120,10700,11770,53500,16785,20658,14203,12912,64558
21,Somalia,2022,SOM-22/3485/RA2 /WASH/INGO/22007,3/20/2023 5:53:46 AM,Host Communities,2243,3028,2579,3364,11214,2243,3028,2579,3364,11214
21,Somalia,2022,SOM-22/3485/RA2 /WASH/INGO/22007,3/20/2023 5:53:46 AM,Internally Displaced People,3042,4107,3498,4563,15210,3042,4107,3498,4563,15210
21,Somalia,2022,SOM-22/3485/RA2 /WASH/INGO/22007,3/20/2023 5:53:46 AM,Overall,5285,7135,6077,7927,26424,5285,7135,6077,7927,26424
21,Somalia,2022,SOM-22/3485/RA2 /WASH/INGO/22030,3/22/2023 2:04:04 PM,Host Communities,540,540,1260,1260,3600,1200,1254,1710,1836,6000
21,Somalia,2022,SOM-22/3485/RA2 /WASH/INGO/22030,3/22/2023 2:04:04 PM,Internally Displaced People,2160,2160,5040,5040,14400,5566,5794,7615,7925,26900
21,Somalia,2022,SOM-22/3485/RA2 /WASH/INGO/22030,3/22/2023 2:04:04 PM,Overall,2700,2700,6300,6300,18000,6766,7048,9325,9761,32900
21,Somalia,2022,SOM-22/3485/RA2 /WASH/INGO/22060,3/1/2023 1:01:43 PM,Host Communities,3200,5500,610,690,10000,3200,5500,610,690,10000
21,Somalia,2022,SOM-22/3485/RA2 /WASH/INGO/22060,3/1/2023 1:01:43 PM,Internally Displaced People,3200,5500,610,690,10000,3200,5500,610,690,10000
21,Somalia,2022,SOM-22/3485/RA2 /WASH/INGO/22060,3/1/2023 1:01:43 PM,Overall,6400,11000,1220,1380,20000,6400,11000,1220,1380,20000
21,Somalia,2022,SOM-22/3485/RA2 /WASH/NGO/21979,2/3/2023 6:41:26 AM,Host Communities,2100,8100,1400,1400,13000,2100,8100,1400,1400,13000
21,Somalia,2022,SOM-22/3485/RA2 /WASH/NGO/21979,2/3/2023 6:41:26 AM,Internally Displaced People,2760,9000,1620,1620,15000,2760,9000,1620,1620,15000
21,Somalia,2022,SOM-22/3485/RA2 /WASH/NGO/21979,2/3/2023 6:41:26 AM,Overall,4860,17100,3020,3020,28000,4860,17100,3020,3020,28000
21,Somalia,2022,SOM-22/3485/RA2 /WASH/NGO/21984,5/29/2023 10:49:14 AM,Internally Displaced People,6300,7350,3150,4200,21000,5280,8643,3403,3754,21080
21,Somalia,2022,SOM-22/3485/RA2 /WASH/NGO/21984,5/29/2023 10:49:14 AM,Overall,6300,7350,3150,4200,21000,5280,8643,3403,3754,21080
21,Somalia,2022,SOM-22/3485/RA2 /WASH/NGO/21991,4/12/2023 2:04:26 PM,Host Communities,5384,5832,4486,6730,22432,5384,5832,4486,6730,22432
21,Somalia,2022,SOM-22/3485/RA2 /WASH/NGO/21991,4/12/2023 2:04:26 PM,Internally Displaced People,1346,1458,1122,1682,5608,1346,1458,1122,1682,5608
21,Somalia,2022,SOM-22/3485/RA2 /WASH/NGO/21991,4/12/2023 2:04:26 PM,Overall,6730,7290,5608,8412,28040,6730,7290,5608,8412,28040
21,Somalia,2022,SOM-22/3485/RA2 /WASH/NGO/21998,1/31/2023 1:05:13 PM,Host Communities,5333,5549,6650,6650,24182,5333,5549,6650,6650,24182
21,Somalia,2022,SOM-22/3485/RA2 /WASH/NGO/21998,1/31/2023 1:05:13 PM,Internally Displaced People,1323,1377,1650,1650,6000,1323,1377,1650,1650,6000
21,Somalia,2022,SOM-22/3485/RA2 /WASH/NGO/21998,1/31/2023 1:05:13 PM,Overall,6656,6926,8300,8300,30182,6656,6926,8300,8300,30182
21,Somalia,2022,SOM-22/3485/RA2 /WASH/NGO/22006,9/26/2023 9:46:56 AM,Host Communities,5907,6891,2953,3938,19689,5907,6891,2953,3938,19689
21,Somalia,2022,SOM-22/3485/RA2 /WASH/NGO/22006,9/26/2023 9:46:56 AM,Internally Displaced People,2844,3318,1422,1896,9480,2844,3318,1422,1896,9480
21,Somalia,2022,SOM-22/3485/RA2 /WASH/NGO/22006,9/26/2023 9:46:56 AM,Overall,8751,10209,4375,5834,29169,8751,10209,4375,5834,29169
21,Somalia,2022,SOM-22/3485/RA2 /WASH/NGO/22027,2/15/2023 7:00:02 AM,Host Communities,4516,4485,6227,8140,23368,4516,4495,6238,8130,23379
21,Somalia,2022,SOM-22/3485/RA2 /WASH/NGO/22027,2/15/2023 7:00:02 AM,Internally Displaced People,370,405,512,545,1832,370,405,512,545,1832
21,Somalia,2022,SOM-22/3485/RA2 /WASH/NGO/22027,2/15/2023 7:00:02 AM,Overall,4886,4890,6739,8685,25200,4886,4900,6750,8675,25211
21,Somalia,2022,SOM-22/3485/RA2 /WASH/NGO/22039,5/31/2023 2:23:35 PM,Internally Displaced People,6246,9369,2290,2915,20820,6246,9369,2290,2915,20820
21,Somalia,2022,SOM-22/3485/RA2 /WASH/NGO/22039,5/31/2023 2:23:35 PM,Overall,6246,9369,2290,2915,20820,6246,9369,2290,2915,20820
21,Somalia,2022,SOM-22/3485/RA2 /WASH-H/INGO/22038,5/19/2023 10:28:12 AM,Host Communities,6021,6267,3387,3525,19200,3746,8944,3593,5596,21879
21,Somalia,2022,SOM-22/3485/RA2 /WASH-H/INGO/22038,5/19/2023 10:28:12 AM,Internally Displaced People,9032,9400,5080,5288,28800,6378,15566,6553,10777,39274
21,Somalia,2022,SOM-22/3485/RA2 /WASH-H/INGO/22038,5/19/2023 10:28:12 AM,Overall,15053,15667,8467,8813,48000,10124,24510,10146,16373,61153
21,Somalia,2022,SOM-22/3485/RA3/CCCM/NGO/22739,5/9/2023 6:54:58 AM,Internally Displaced People,11471,57355,20000,25884,114710,11471,57355,20000,25884,114710
21,Somalia,2022,SOM-22/3485/RA3/CCCM/NGO/22739,5/9/2023 6:54:58 AM,Overall,11471,57355,20000,25884,114710,11471,57355,20000,25884,114710
21,Somalia,2022,SOM-22/3485/RA3/CP-GBV-HLP/INGO/22722,7/11/2023 11:35:59 AM,Host Communities,1050,1500,750,1200,4500,1050,1500,781,1200,4531
21,Somalia,2022,SOM-22/3485/RA3/CP-GBV-HLP/INGO/22722,7/11/2023 11:35:59 AM,Internally Displaced People,1850,3000,2000,3200,10050,2110,3000,2000,3200,10310
21,Somalia,2022,SOM-22/3485/RA3/CP-GBV-HLP/INGO/22722,7/11/2023 11:35:59 AM,Overall,2900,4500,2750,4400,14550,3160,4500,2781,4400,14841
21,Somalia,2022,SOM-22/3485/RA3/CP-GBV-HLP/NGO/22746,6/7/2023 2:06:25 PM,Internally Displaced People,1788,5364,894,894,8940,45,2888,3221,4863,11017
21,Somalia,2022,SOM-22/3485/RA3/CP-GBV-HLP/NGO/22746,6/7/2023 2:06:25 PM,Overall,1788,5364,894,894,8940,45,2888,3221,4863,11017
21,Somalia,2022,SOM-22/3485/RA3/FSC/INGO/22765,3/29/2023 11:14:59 AM,Host Communities,533,577,555,555,2220,532,578,555,555,2220
21,Somalia,2022,SOM-22/3485/RA3/FSC/INGO/22765,3/29/2023 11:14:59 AM,Internally Displaced People,619,671,645,645,2580,619,671,645,645,2580
21,Somalia,2022,SOM-22/3485/RA3/FSC/INGO/22765,3/29/2023 11:14:59 AM,Overall,1152,1248,1200,1200,4800,1151,1249,1200,1200,4800
21,Somalia,2022,SOM-22/3485/RA3/FSC/INGO/22798,6/7/2023 4:40:11 PM,Internally Displaced People,2500,2900,1700,1900,9000,2500,2900,1700,1900,9000
21,Somalia,2022,SOM-22/3485/RA3/FSC/INGO/22798,6/7/2023 4:40:11 PM,Overall,2500,2900,1700,1900,9000,2500,2900,1700,1900,9000
21,Somalia,2022,SOM-22/3485/RA3/FSC/NGO/22695,5/29/2023 10:11:10 AM,Host Communities,600,1220,200,200,2220,678,1000,242,300,2220
21,Somalia,2022,SOM-22/3485/RA3/FSC/NGO/22695,5/29/2023 10:11:10 AM,Internally Displaced People,1200,3200,650,650,5700,900,3900,400,500,5700
21,Somalia,2022,SOM-22/3485/RA3/FSC/NGO/22695,5/29/2023 10:11:10 AM,Overall,1800,4420,850,850,7920,1578,4900,642,800,7920
21,Somalia,2022,SOM-22/3485/RA3/FSC/NGO/22699,3/20/2023 8:32:50 AM,Host Communities,200,800,100,100,1200,200,800,100,100,1200
21,Somalia,2022,SOM-22/3485/RA3/FSC/NGO/22699,3/20/2023 8:32:50 AM,Internally Displaced People,600,1800,300,300,3000,600,1800,300,300,3000
21,Somalia,2022,SOM-22/3485/RA3/FSC/NGO/22699,3/20/2023 8:32:50 AM,Overall,800,2600,400,400,4200,800,2600,400,400,4200
21,Somalia,2022,SOM-22/3485/RA3/FSC/NGO/22737,3/30/2023 7:29:25 AM,Host Communities,500,1200,2500,2850,7050,500,1200,2500,2850,7050
21,Somalia,2022,SOM-22/3485/RA3/FSC/NGO/22737,3/30/2023 7:29:25 AM,Internally Displaced People,50,100,0,0,150,50,100,0,0,150
21,Somalia,2022,SOM-22/3485/RA3/FSC/NGO/22737,3/30/2023 7:29:25 AM,Overall,550,1300,2500,2850,7200,550,1300,2500,2850,7200
21,Somalia,2022,SOM-22/3485/RA3/H-Nut/NGO/22763,8/22/2023 5:51:58 AM,Host Communities,5346,5975,9908,10221,31450,804,10346,9641,8420,29211
21,Somalia,2022,SOM-22/3485/RA3/H-Nut/NGO/22763,8/22/2023 5:51:58 AM,Internally Displaced People,944,1054,1748,1804,5550,1024,8510,3230,4991,17755
21,Somalia,2022,SOM-22/3485/RA3/H-Nut/NGO/22763,8/22/2023 5:51:58 AM,Overall,6290,7029,11656,12025,37000,1828,18856,12871,13411,46966
21,Somalia,2022,SOM-22/3485/RA3/Nut-H/INGO/22721,6/1/2023 7:18:37 PM,Host Communities,1500,4500,5688,6062,17750,1500,4500,5688,6062,17750
21,Somalia,2022,SOM-22/3485/RA3/Nut-H/INGO/22721,6/1/2023 7:18:37 PM,Internally Displaced People,700,1000,2500,3000,7200,700,1000,2500,3000,7200
21,Somalia,2022,SOM-22/3485/RA3/Nut-H/INGO/22721,6/1/2023 7:18:37 PM,Overall,2200,5500,8188,9062,24950,2200,5500,8188,9062,24950
21,Somalia,2022,SOM-22/3485/RA3/Nut-H/NGO/22692,7/20/2023 8:03:27 AM,Host Communities,1200,3400,2500,2100,9200,1240,3500,2550,2200,9490
21,Somalia,2022,SOM-22/3485/RA3/Nut-H/NGO/22692,7/20/2023 8:03:27 AM,Internally Displaced People,1400,3600,2800,3000,10800,1440,3660,2900,3120,11120
21,Somalia,2022,SOM-22/3485/RA3/Nut-H/NGO/22692,7/20/2023 8:03:27 AM,Overall,2600,7000,5300,5100,20000,2680,7160,5450,5320,20610
21,Somalia,2022,SOM-22/3485/RA3/Nut-H/NGO/22698,6/1/2023 7:19:36 PM,Host Communities,1960,4200,3920,3920,14000,2632,4354,4222,4602,15810
21,Somalia,2022,SOM-22/3485/RA3/Nut-H/NGO/22698,6/1/2023 7:19:36 PM,Internally Displaced People,840,1800,1680,1680,6000,1139,1870,1935,1788,6732
21,Somalia,2022,SOM-22/3485/RA3/Nut-H/NGO/22698,6/1/2023 7:19:36 PM,Overall,2800,6000,5600,5600,20000,3771,6224,6157,6390,22542
21,Somalia,2022,SOM-22/3485/RA3/Nut-H/NGO/22705,6/26/2023 7:58:33 AM,Host Communities,2925,4875,5850,5850,19500,2963,5014,5923,6083,19983
21,Somalia,2022,SOM-22/3485/RA3/Nut-H/NGO/22705,6/26/2023 7:58:33 AM,Internally Displaced People,825,1375,1650,1650,5500,953,1497,1624,1708,5782
21,Somalia,2022,SOM-22/3485/RA3/Nut-H/NGO/22705,6/26/2023 7:58:33 AM,Overall,3750,6250,7500,7500,25000,3916,6511,7547,7791,25765
21,Somalia,2022,SOM-22/3485/RA3/Nut-H/NGO/22715,4/7/2023 8:39:06 AM,Host Communities,3200,5990,3930,2550,15670,3259,6231,4318,3007,16815
21,Somalia,2022,SOM-22/3485/RA3/Nut-H/NGO/22715,4/7/2023 8:39:06 AM,Internally Displaced People,7600,9800,11560,12100,41060,7879,10143,14007,15723,47752
21,Somalia,2022,SOM-22/3485/RA3/Nut-H/NGO/22715,4/7/2023 8:39:06 AM,Overall,10800,15790,15490,14650,56730,11138,16374,18325,18730,64567
21,Somalia,2022,SOM-22/3485/RA3/WASH/INGO/22697,7/28/2023 10:07:43 AM,Host Communities,1942,2082,1419,1557,7000,1972,2093,1429,1541,7035
21,Somalia,2022,SOM-22/3485/RA3/WASH/INGO/22697,7/28/2023 10:07:43 AM,Internally Displaced People,1996,2142,1460,1602,7200,1947,2164,1515,1587,7213
21,Somalia,2022,SOM-22/3485/RA3/WASH/INGO/22697,7/28/2023 10:07:43 AM,Overall,3938,4224,2879,3159,14200,3919,4257,2944,3128,14248
21,Somalia,2022,SOM-22/3485/RA3/WASH/INGO/22720,5/9/2023 7:05:23 AM,Host Communities,1226,1337,1476,1532,5571,1426,1562,1720,1781,6489
21,Somalia,2022,SOM-22/3485/RA3/WASH/INGO/22720,5/9/2023 7:05:23 AM,Internally Displaced People,1838,2005,2214,2298,8355,2062,2245,2484,2578,9369
21,Somalia,2022,SOM-22/3485/RA3/WASH/INGO/22720,5/9/2023 7:05:23 AM,Overall,3064,3342,3690,3830,13926,3488,3807,4204,4359,15858
21,Somalia,2022,SOM-22/3485/RA3/WASH/INGO/22734,4/5/2023 9:47:05 AM,Internally Displaced People,5330,5686,2933,3264,17213,5330,5686,2933,3264,17213
21,Somalia,2022,SOM-22/3485/RA3/WASH/INGO/22734,4/5/2023 9:47:05 AM,Overall,5330,5686,2933,3264,17213,5330,5686,2933,3264,17213
21,Somalia,2022,SOM-22/3485/RA3/WASH/NGO/22696,8/30/2023 12:40:54 PM,Host Communities,2000,3400,1500,1500,8400,1800,3600,1400,1600,8400
21,Somalia,2022,SOM-22/3485/RA3/WASH/NGO/22696,8/30/2023 12:40:54 PM,Internally Displaced People,5880,9020,2200,2500,19600,5700,9100,2200,2600,19600
21,Somalia,2022,SOM-22/3485/RA3/WASH/NGO/22696,8/30/2023 12:40:54 PM,Overall,7880,12420,3700,4000,28000,7500,12700,3600,4200,28000
21,Somalia,2022,SOM-22/3485/RA3/WASH/NGO/22700,4/3/2023 12:39:45 PM,Host Communities,2300,3500,640,960,7400,2300,3500,640,960,7400
21,Somalia,2022,SOM-22/3485/RA3/WASH/NGO/22700,4/3/2023 12:39:45 PM,Internally Displaced People,2820,4180,640,960,8600,2820,4180,640,960,8600
21,Somalia,2022,SOM-22/3485/RA3/WASH/NGO/22700,4/3/2023 12:39:45 PM,Overall,5120,7680,1280,1920,16000,5120,7680,1280,1920,16000
21,Somalia,2022,SOM-22/3485/RA3/WASH/NGO/22742,5/1/2023 1:04:44 PM,Host Communities,2304,3456,576,864,7200,1983,2420,1329,1618,7350
21,Somalia,2022,SOM-22/3485/RA3/WASH/NGO/22742,5/1/2023 1:04:44 PM,Internally Displaced People,1536,2304,384,576,4800,731,899,514,632,2776
21,Somalia,2022,SOM-22/3485/RA3/WASH/NGO/22742,5/1/2023 1:04:44 PM,Overall,3840,5760,960,1440,12000,2714,3319,1843,2250,10126
21,Somalia,2022,SOM-22/3485/RA4/CCCM/INGO/23898,9/21/2023 9:07:48 AM,Internally Displaced People,11410,14040,9603,11667,46720,11410,14040,9603,11667,46720
21,Somalia,2022,SOM-22/3485/RA4/CCCM/INGO/23898,9/21/2023 9:07:48 AM,Overall,11410,14040,9603,11667,46720,11410,14040,9603,11667,46720
21,Somalia,2022,SOM-22/3485/RA4/CCCM/INGO/23917,8/29/2023 12:51:39 PM,Internally Displaced People,4790,5965,5987,7178,23920,8295,14140,7985,10350,40770
21,Somalia,2022,SOM-22/3485/RA4/CCCM/INGO/23917,8/29/2023 12:51:39 PM,Overall,4790,5965,5987,7178,23920,8295,14140,7985,10350,40770
21,Somalia,2022,SOM-22/3485/RA4/CCCM/NGO/23930,8/3/2023 8:38:25 AM,Internally Displaced People,12000,30000,9000,11006,62006,12000,30000,9000,11006,62006
21,Somalia,2022,SOM-22/3485/RA4/CCCM/NGO/23930,8/3/2023 8:38:25 AM,Overall,12000,30000,9000,11006,62006,12000,30000,9000,11006,62006
21,Somalia,2022,SOM-22/3485/RA4/CP/INGO/23942,8/8/2023 7:37:17 AM,Host Communities,1950,2150,1300,1600,7000,1950,2150,1300,1600,7000
21,Somalia,2022,SOM-22/3485/RA4/CP/INGO/23942,8/8/2023 7:37:17 AM,Internally Displaced People,2150,2150,1850,1850,8000,2150,2150,1850,1850,8000
21,Somalia,2022,SOM-22/3485/RA4/CP/INGO/23942,8/8/2023 7:37:17 AM,Overall,4100,4300,3150,3450,15000,4100,4300,3150,3450,15000
21,Somalia,2022,SOM-22/3485/RA4/CP-GBV/INGO/23881,8/21/2023 8:25:48 AM,Host Communities,0,400,200,300,900,0,400,200,300,900
21,Somalia,2022,SOM-22/3485/RA4/CP-GBV/INGO/23881,8/21/2023 8:25:48 AM,Internally Displaced People,200,1200,1100,2300,4800,200,1200,1100,2300,4800
21,Somalia,2022,SOM-22/3485/RA4/CP-GBV/INGO/23881,8/21/2023 8:25:48 AM,Overall,200,1600,1300,2600,5700,200,1600,1300,2600,5700
21,Somalia,2022,SOM-22/3485/RA4/FSC/INGO/23925,9/4/2023 7:47:08 AM,Host Communities,949,1010,520,581,3060,465,543,1107,1027,3142
21,Somalia,2022,SOM-22/3485/RA4/FSC/INGO/23925,9/4/2023 7:47:08 AM,Internally Displaced People,949,1010,520,581,3060,783,983,1938,1831,5535
21,Somalia,2022,SOM-22/3485/RA4/FSC/INGO/23925,9/4/2023 7:47:08 AM,Overall,1898,2020,1040,1162,6120,1248,1526,3045,2858,8677
21,Somalia,2022,SOM-22/3485/RA4/FSC/INGO/23941,7/10/2023 6:25:15 AM,Other,1274,1276,2474,2476,7500,1256,1571,2855,2937,8619
21,Somalia,2022,SOM-22/3485/RA4/FSC/INGO/23941,7/10/2023 6:25:15 AM,Overall,1274,1276,2474,2476,7500,1256,1571,2855,2937,8619
21,Somalia,2022,SOM-22/3485/RA4/FSC/INGO/23956,6/10/2023 5:50:49 PM,Host Communities,263,292,378,388,1321,608,603,1130,977,3318
21,Somalia,2022,SOM-22/3485/RA4/FSC/INGO/23956,6/10/2023 5:50:49 PM,Internally Displaced People,1050,1167,1509,1553,5279,1330,1273,2200,1958,6761
21,Somalia,2022,SOM-22/3485/RA4/FSC/INGO/23956,6/10/2023 5:50:49 PM,Overall,1313,1459,1887,1941,6600,1938,1876,3330,2935,10079
21,Somalia,2022,SOM-22/3485/RA4/FSC/NGO/23877,6/26/2023 10:19:50 AM,Internally Displaced People,666,1422,144,468,2700,974,1407,63,256,2700
21,Somalia,2022,SOM-22/3485/RA4/FSC/NGO/23877,6/26/2023 10:19:50 AM,Other,519,1105,111,365,2100,756,1093,51,200,2100
21,Somalia,2022,SOM-22/3485/RA4/FSC/NGO/23877,6/26/2023 10:19:50 AM,Overall,1185,2527,255,833,4800,1730,2500,114,456,4800
21,Somalia,2022,SOM-22/3485/RA4/FSC/NGO/23913,5/29/2023 2:43:59 PM,Host Communities,648,1022,800,620,3090,648,1022,800,620,3090
21,Somalia,2022,SOM-22/3485/RA4/FSC/NGO/23913,5/29/2023 2:43:59 PM,Internally Displaced People,780,1054,940,700,3474,780,1054,940,700,3474
21,Somalia,2022,SOM-22/3485/RA4/FSC/NGO/23913,5/29/2023 2:43:59 PM,Overall,1428,2076,1740,1320,6564,1428,2076,1740,1320,6564
21,Somalia,2022,SOM-22/3485/RA4/FSC/NGO/23927,7/13/2023 11:14:15 AM,Host Communities,1052,1248,1968,2296,6564,1052,1248,1968,2296,6564
21,Somalia,2022,SOM-22/3485/RA4/FSC/NGO/23927,7/13/2023 11:14:15 AM,Overall,1052,1248,1968,2296,6564,1052,1248,1968,2296,6564
21,Somalia,2022,SOM-22/3485/RA4/FSC/NGO/23943,8/21/2023 1:08:10 PM,Host Communities,500,1000,100,100,1700,500,1000,100,100,1700
21,Somalia,2022,SOM-22/3485/RA4/FSC/NGO/23943,8/21/2023 1:08:10 PM,Internally Displaced People,1000,2000,200,200,3400,1000,2000,200,200,3400
21,Somalia,2022,SOM-22/3485/RA4/FSC/NGO/23943,8/21/2023 1:08:10 PM,Overall,1500,3000,300,300,5100,1500,3000,300,300,5100
21,Somalia,2022,SOM-22/3485/RA4/GBV-CP/NGO/23882,8/21/2023 8:43:42 AM,Internally Displaced People,1788,5364,1034,1034,9220,23,3573,2327,4527,10450
21,Somalia,2022,SOM-22/3485/RA4/GBV-CP/NGO/23882,8/21/2023 8:43:42 AM,Overall,1788,5364,1034,1034,9220,23,3573,2327,4527,10450
21,Somalia,2022,SOM-22/3485/RA4/Shelter/NGO/23907,8/9/2023 12:40:25 PM,Host Communities,357,399,693,651,2100,503,503,641,629,2276
21,Somalia,2022,SOM-22/3485/RA4/Shelter/NGO/23907,8/9/2023 12:40:25 PM,Internally Displaced People,3213,3591,6237,5859,18900,4139,3883,6548,6080,20650
21,Somalia,2022,SOM-22/3485/RA4/Shelter/NGO/23907,8/9/2023 12:40:25 PM,Overall,3570,3990,6930,6510,21000,4642,4386,7189,6709,22926
21,Somalia,2022,SOM-22/3485/RA4/Shelter-HLP/NGO/23883,9/4/2023 8:37:17 AM,Internally Displaced People,6963,6963,14795,14795,43516,5241,5519,15628,15146,41534
21,Somalia,2022,SOM-22/3485/RA4/Shelter-HLP/NGO/23883,9/4/2023 8:37:17 AM,Overall,6963,6963,14795,14795,43516,5241,5519,15628,15146,41534
21,Somalia,2022,SOM-22/3485/RA4/WASH/INGO/23885,8/30/2023 11:57:47 AM,Host Communities,2580,3821,1279,1920,9600,3236,3924,3721,4404,15285
21,Somalia,2022,SOM-22/3485/RA4/WASH/INGO/23885,8/30/2023 11:57:47 AM,Internally Displaced People,1070,1447,1203,1180,4900,2222,2722,3698,4202,12844
21,Somalia,2022,SOM-22/3485/RA4/WASH/INGO/23885,8/30/2023 11:57:47 AM,Overall,3650,5268,2482,3100,14500,5458,6646,7419,8606,28129
21,Somalia,2022,SOM-22/3485/RA4/WASH/NGO/23902,9/19/2023 9:53:15 AM,Host Communities,500,1500,200,200,2400,500,1500,200,200,2400
21,Somalia,2022,SOM-22/3485/RA4/WASH/NGO/23902,9/19/2023 9:53:15 AM,Internally Displaced People,3000,7500,800,800,12100,3000,7500,800,800,12100
21,Somalia,2022,SOM-22/3485/RA4/WASH/NGO/23902,9/19/2023 9:53:15 AM,Overall,3500,9000,1000,1000,14500,3500,9000,1000,1000,14500
21,Somalia,2022,SOM-22/3485/RA4/WASH/NGO/23909,9/5/2023 6:30:17 AM,Host Communities,3184,4362,1524,1909,10979,3670,4659,2846,3320,14495
21,Somalia,2022,SOM-22/3485/RA4/WASH/NGO/23909,9/5/2023 6:30:17 AM,Internally Displaced People,935,1437,264,385,3021,557,706,439,488,2190
21,Somalia,2022,SOM-22/3485/RA4/WASH/NGO/23909,9/5/2023 6:30:17 AM,Overall,4119,5799,1788,2294,14000,4227,5365,3285,3808,16685
21,Somalia,2022,SOM-22/3485/RA4/WASH/NGO/23915,9/26/2023 9:59:11 AM,Host Communities,990,1650,1980,1980,6600,990,1650,1980,1980,6600
21,Somalia,2022,SOM-22/3485/RA4/WASH/NGO/23915,9/26/2023 9:59:11 AM,Internally Displaced People,660,1100,1320,1320,4400,660,1100,1320,1320,4400
21,Somalia,2022,SOM-22/3485/RA4/WASH/NGO/23915,9/26/2023 9:59:11 AM,Overall,1650,2750,3300,3300,11000,1650,2750,3300,3300,11000
21,Somalia,2022,SOM-22/3485/RA4/WASH/NGO/23938,8/29/2023 8:04:55 AM,Host Communities,1500,2000,1200,1400,6100,1700,1800,1200,1400,6100
21,Somalia,2022,SOM-22/3485/RA4/WASH/NGO/23938,8/29/2023 8:04:55 AM,Internally Displaced People,2000,2900,1500,2000,8400,2000,2667,1774,1959,8400
21,Somalia,2022,SOM-22/3485/RA4/WASH/NGO/23938,8/29/2023 8:04:55 AM,Overall,3500,4900,2700,3400,14500,3700,4467,2974,3359,14500
21,Somalia,2022,SOM-22/3485/SA1/CCCM/INGO/21465,1/31/2023 6:19:08 AM,Internally Displaced People,11000,16000,200,241,27441,11000,16000,200,241,27441
21,Somalia,2022,SOM-22/3485/SA1/CCCM/INGO/21465,1/31/2023 6:19:08 AM,Overall,11000,16000,200,241,27441,11000,16000,200,241,27441
21,Somalia,2022,SOM-22/3485/SA1/CCCM/NGO/21464,3/6/2023 2:33:44 PM,Host Communities,700,1800,300,680,3480,700,1800,300,680,3480
21,Somalia,2022,SOM-22/3485/SA1/CCCM/NGO/21464,3/6/2023 2:33:44 PM,Internally Displaced People,2050,6600,1350,3920,13920,2050,6600,1350,3920,13920
21,Somalia,2022,SOM-22/3485/SA1/CCCM/NGO/21464,3/6/2023 2:33:44 PM,Overall,2750,8400,1650,4600,17400,2750,8400,1650,4600,17400
21,Somalia,2022,SOM-22/3485/SA1/CCCM-HLP/NGO/21494,3/15/2023 12:53:41 PM,Internally Displaced People,4634,6550,2565,3446,17195,3688,8458,2497,3528,18171
21,Somalia,2022,SOM-22/3485/SA1/CCCM-HLP/NGO/21494,3/15/2023 12:53:41 PM,Overall,4634,6550,2565,3446,17195,3688,8458,2497,3528,18171
21,Somalia,2022,SOM-22/3485/SA1/Ed-CP/INGO/21496,6/22/2023 8:41:03 AM,Host Communities,135,102,1478,1122,2837,113,97,1620,1422,3252
21,Somalia,2022,SOM-22/3485/SA1/Ed-CP/INGO/21496,6/22/2023 8:41:03 AM,Internally Displaced People,202,154,2218,1682,4256,151,89,1023,1302,2565
21,Somalia,2022,SOM-22/3485/SA1/Ed-CP/INGO/21496,6/22/2023 8:41:03 AM,Overall,337,256,3696,2804,7093,264,186,2643,2724,5817
21,Somalia,2022,SOM-22/3485/SA1/Ed-CP/NGO/21420,7/10/2023 6:18:40 AM,Host Communities,468,732,3927,3213,8340,428,695,3702,2974,7799
21,Somalia,2022,SOM-22/3485/SA1/Ed-CP/NGO/21420,7/10/2023 6:18:40 AM,Internally Displaced People,312,487,1848,1512,4159,298,450,1794,1429,3971
21,Somalia,2022,SOM-22/3485/SA1/Ed-CP/NGO/21420,7/10/2023 6:18:40 AM,Other,166,102,0,0,268,166,102,0,0,268
21,Somalia,2022,SOM-22/3485/SA1/Ed-CP/NGO/21420,7/10/2023 6:18:40 AM,Overall,946,1321,5775,4725,12767,892,1247,5496,4403,12038
21,Somalia,2022,SOM-22/3485/SA1/Ed-CP/NGO/21463,7/10/2023 6:25:05 AM,Host Communities,71,41,1787,920,2819,71,41,1787,920,2819
21,Somalia,2022,SOM-22/3485/SA1/Ed-CP/NGO/21463,7/10/2023 6:25:05 AM,Internally Displaced People,150,200,2663,2364,5377,150,200,2663,2364,5377
21,Somalia,2022,SOM-22/3485/SA1/Ed-CP/NGO/21463,7/10/2023 6:25:05 AM,Overall,221,241,4450,3284,8196,221,241,4450,3284,8196
21,Somalia,2022,SOM-22/3485/SA1/FSC/INGO/21442,1/12/2023 10:19:34 AM,Host Communities,1073,1041,473,568,3155,567,645,1064,1347,3623
21,Somalia,2022,SOM-22/3485/SA1/FSC/INGO/21442,1/12/2023 10:19:34 AM,Internally Displaced People,1331,1291,587,704,3913,622,754,1529,1810,4715
21,Somalia,2022,SOM-22/3485/SA1/FSC/INGO/21442,1/12/2023 10:19:34 AM,Overall,2404,2332,1060,1272,7068,1189,1399,2593,3157,8338
21,Somalia,2022,SOM-22/3485/SA1/FSC/INGO/21498,1/9/2023 7:15:40 AM,Host Communities,338,367,353,353,1411,881,955,918,918,3672
21,Somalia,2022,SOM-22/3485/SA1/FSC/INGO/21498,1/9/2023 7:15:40 AM,Internally Displaced People,571,620,595,595,2381,893,967,930,930,3720
21,Somalia,2022,SOM-22/3485/SA1/FSC/INGO/21498,1/9/2023 7:15:40 AM,Overall,909,987,948,948,3792,1774,1922,1848,1848,7392
21,Somalia,2022,SOM-22/3485/SA1/FSC/INGO/21534,6/16/2023 5:52:24 AM,Host Communities,704,1159,1118,1159,4140,747,1231,1187,1230,4395
21,Somalia,2022,SOM-22/3485/SA1/FSC/INGO/21534,6/16/2023 5:52:24 AM,Overall,704,1159,1118,1159,4140,747,1231,1187,1230,4395
21,Somalia,2022,SOM-22/3485/SA1/FSC/NGO/21437,11/17/2022 11:19:14 AM,Host Communities,882,2250,252,396,3780,1061,1246,427,1046,3780
21,Somalia,2022,SOM-22/3485/SA1/FSC/NGO/21437,11/17/2022 11:19:14 AM,Other,1260,2244,216,1200,4920,1285,1775,719,1141,4920
21,Somalia,2022,SOM-22/3485/SA1/FSC/NGO/21437,11/17/2022 11:19:14 AM,Overall,2142,4494,468,1596,8700,2346,3021,1146,2187,8700
21,Somalia,2022,SOM-22/3485/SA1/FSC/NGO/21472,1/4/2023 6:32:48 AM,Host Communities,900,1575,1260,3510,7245,900,1575,1260,3510,7245
21,Somalia,2022,SOM-22/3485/SA1/FSC/NGO/21472,1/4/2023 6:32:48 AM,Overall,900,1575,1260,3510,7245,900,1575,1260,3510,7245
21,Somalia,2022,SOM-22/3485/SA1/FSC/NGO/21488,1/9/2023 1:50:40 PM,Host Communities,1000,1250,1840,2030,6120,620,1280,1450,2770,6120
21,Somalia,2022,SOM-22/3485/SA1/FSC/NGO/21488,1/9/2023 1:50:40 PM,Overall,1000,1250,1840,2030,6120,620,1280,1450,2770,6120
21,Somalia,2022,SOM-22/3485/SA1/FSC/NGO/21518,1/4/2023 11:45:11 AM,Host Communities,1113,1206,290,290,2899,1113,1206,290,290,2899
21,Somalia,2022,SOM-22/3485/SA1/FSC/NGO/21518,1/4/2023 11:45:11 AM,Internally Displaced People,477,516,124,124,1241,477,516,124,124,1241
21,Somalia,2022,SOM-22/3485/SA1/FSC/NGO/21518,1/4/2023 11:45:11 AM,Overall,1590,1722,414,414,4140,1590,1722,414,414,4140
21,Somalia,2022,SOM-22/3485/SA1/FSC/NGO/21538,1/10/2023 11:43:55 AM,Host Communities,1469,1528,1832,1832,6661,1469,1528,1832,1832,6661
21,Somalia,2022,SOM-22/3485/SA1/FSC/NGO/21538,1/10/2023 11:43:55 AM,Internally Displaced People,529,550,660,660,2399,529,550,660,660,2399
21,Somalia,2022,SOM-22/3485/SA1/FSC/NGO/21538,1/10/2023 11:43:55 AM,Overall,1998,2078,2492,2492,9060,1998,2078,2492,2492,9060
21,Somalia,2022,SOM-22/3485/SA1/FSC/NGO/21560,1/10/2023 6:41:41 AM,Host Communities,840,420,70,70,1400,1087,455,93,94,1729
21,Somalia,2022,SOM-22/3485/SA1/FSC/NGO/21560,1/10/2023 6:41:41 AM,Internally Displaced People,360,180,30,30,600,80,114,7,6,207
21,Somalia,2022,SOM-22/3485/SA1/FSC/NGO/21560,1/10/2023 6:41:41 AM,Overall,1200,600,100,100,2000,1167,569,100,100,1936
21,Somalia,2022,SOM-22/3485/SA1/H-GBV/NGO/21427,6/21/2023 1:15:40 PM,Host Communities,1876,3304,1680,1785,8645,2422,6254,2527,2831,14034
21,Somalia,2022,SOM-22/3485/SA1/H-GBV/NGO/21427,6/21/2023 1:15:40 PM,Internally Displaced People,804,1416,720,765,3705,1615,4170,1684,1887,9356
21,Somalia,2022,SOM-22/3485/SA1/H-GBV/NGO/21427,6/21/2023 1:15:40 PM,Overall,2680,4720,2400,2550,12350,4037,10424,4211,4718,23390
21,Somalia,2022,SOM-22/3485/SA1/H-GBV/NGO/21433,2/17/2023 4:12:00 AM,Host Communities,585,4680,2340,4095,11700,1306,7671,2745,6698,18420
21,Somalia,2022,SOM-22/3485/SA1/H-GBV/NGO/21433,2/17/2023 4:12:00 AM,Internally Displaced People,195,1560,780,1365,3900,514,2883,1396,2045,6838
21,Somalia,2022,SOM-22/3485/SA1/H-GBV/NGO/21433,2/17/2023 4:12:00 AM,Other,12,108,0,0,120,12,108,0,0,120
21,Somalia,2022,SOM-22/3485/SA1/H-GBV/NGO/21433,2/17/2023 4:12:00 AM,Overall,792,6348,3120,5460,15720,1832,10662,4141,8743,25378
21,Somalia,2022,SOM-22/3485/SA1/H-GBV/NGO/21440,8/17/2023 11:03:41 AM,Host Communities,1383,3290,1890,2232,8795,1381,3290,1894,2232,8797
21,Somalia,2022,SOM-22/3485/SA1/H-GBV/NGO/21440,8/17/2023 11:03:41 AM,Internally Displaced People,1141,1976,1650,1598,6365,1141,1986,1656,1600,6383
21,Somalia,2022,SOM-22/3485/SA1/H-GBV/NGO/21440,8/17/2023 11:03:41 AM,Other,16,43,0,0,59,16,43,0,0,59
21,Somalia,2022,SOM-22/3485/SA1/H-GBV/NGO/21440,8/17/2023 11:03:41 AM,Overall,2540,5309,3540,3830,15219,2538,5319,3550,3832,15239
21,Somalia,2022,SOM-22/3485/SA1/H-GBV/NGO/21505,6/2/2023 8:55:06 AM,Host Communities,3000,7000,2500,2500,15000,2778,6482,2172,2200,13632
21,Somalia,2022,SOM-22/3485/SA1/H-GBV/NGO/21505,6/2/2023 8:55:06 AM,Internally Displaced People,1100,2200,1000,1000,5300,926,2038,976,948,4888
21,Somalia,2022,SOM-22/3485/SA1/H-GBV/NGO/21505,6/2/2023 8:55:06 AM,Overall,4100,9200,3500,3500,20300,3704,8520,3148,3148,18520
21,Somalia,2022,SOM-22/3485/SA1/HLP-Shelter/NGO/21493,2/13/2023 8:30:29 AM,Host Communities,689,736,538,580,2543,689,736,538,580,2543
21,Somalia,2022,SOM-22/3485/SA1/HLP-Shelter/NGO/21493,2/13/2023 8:30:29 AM,Internally Displaced People,7095,7920,3676,3840,22531,7095,7920,3676,3840,22531
21,Somalia,2022,SOM-22/3485/SA1/HLP-Shelter/NGO/21493,2/13/2023 8:30:29 AM,Overall,7784,8656,4214,4420,25074,7784,8656,4214,4420,25074
21,Somalia,2022,SOM-22/3485/SA1/H-Nut/INGO/21431,7/5/2023 7:53:22 AM,Host Communities,4223,5386,9920,9165,28694,3892,9201,2559,2259,17911
21,Somalia,2022,SOM-22/3485/SA1/H-Nut/INGO/21431,7/5/2023 7:53:22 AM,Internally Displaced People,1809,2534,4051,5380,13774,1211,2101,2543,3435,9290
21,Somalia,2022,SOM-22/3485/SA1/H-Nut/INGO/21431,7/5/2023 7:53:22 AM,Overall,6032,7920,13971,14545,42468,5103,11302,5102,5694,27201
21,Somalia,2022,SOM-22/3485/SA1/H-Nut/INGO/21554,6/26/2023 10:07:31 AM,Host Communities,12890,16316,21238,24212,74656,15347,50593,28157,30834,124931
21,Somalia,2022,SOM-22/3485/SA1/H-Nut/INGO/21554,6/26/2023 10:07:31 AM,Internally Displaced People,6607,9382,9412,12782,38183,6577,21683,12068,13214,53542
21,Somalia,2022,SOM-22/3485/SA1/H-Nut/INGO/21554,6/26/2023 10:07:31 AM,Overall,19497,25698,30650,36994,112839,21924,72276,40225,44048,178473
21,Somalia,2022,SOM-22/3485/SA1/H-Nut/NGO/21430,6/22/2023 11:21:53 AM,Host Communities,3402,4158,2184,2352,12096,4397,5810,3552,4056,17815
21,Somalia,2022,SOM-22/3485/SA1/H-Nut/NGO/21430,6/22/2023 11:21:53 AM,Internally Displaced People,1458,1782,936,1008,5184,2918,4371,2327,3619,13235
21,Somalia,2022,SOM-22/3485/SA1/H-Nut/NGO/21430,6/22/2023 11:21:53 AM,Overall,4860,5940,3120,3360,17280,7315,10181,5879,7675,31050
21,Somalia,2022,SOM-22/3485/SA1/H-Nut/NGO/21535,6/9/2023 7:52:48 AM,Host Communities,500,2000,2500,3000,8000,750,1800,2800,3500,8850
21,Somalia,2022,SOM-22/3485/SA1/H-Nut/NGO/21535,6/9/2023 7:52:48 AM,Internally Displaced People,700,3000,3000,3500,10200,900,3800,3300,4100,12100
21,Somalia,2022,SOM-22/3485/SA1/H-Nut/NGO/21535,6/9/2023 7:52:48 AM,Overall,1200,5000,5500,6500,18200,1650,5600,6100,7600,20950
21,Somalia,2022,SOM-22/3485/SA1/Nut/UN/21552,9/4/2023 7:52:16 AM,Host Communities,0,10211,7169,7462,24842,0,9350,6536,6803,22689
21,Somalia,2022,SOM-22/3485/SA1/Nut/UN/21552,9/4/2023 7:52:16 AM,Internally Displaced People,0,6808,4780,4974,16562,0,6233,4357,4535,15125
21,Somalia,2022,SOM-22/3485/SA1/Nut/UN/21552,9/4/2023 7:52:16 AM,Overall,0,17019,11949,12436,41404,0,15583,10893,11338,37814
21,Somalia,2022,SOM-22/3485/SA1/Nut-H/NGO/21524,6/9/2023 8:03:06 AM,Host Communities,6000,8000,8000,8000,30000,5300,7554,7539,7760,28153
21,Somalia,2022,SOM-22/3485/SA1/Nut-H/NGO/21524,6/9/2023 8:03:06 AM,Internally Displaced People,4000,6000,5000,5000,20000,3470,5294,4417,4514,17695
21,Somalia,2022,SOM-22/3485/SA1/Nut-H/NGO/21524,6/9/2023 8:03:06 AM,Overall,10000,14000,13000,13000,50000,8770,12848,11956,12274,45848
21,Somalia,2022,SOM-22/3485/SA1/Nut-WASH/INGO/21513,7/12/2023 8:36:42 AM,Host Communities,4199,6297,4598,5898,20992,3528,4240,1984,2525,12277
21,Somalia,2022,SOM-22/3485/SA1/Nut-WASH/INGO/21513,7/12/2023 8:36:42 AM,Internally Displaced People,1800,2699,1970,2528,8997,3833,5750,4217,5366,19166
21,Somalia,2022,SOM-22/3485/SA1/Nut-WASH/INGO/21513,7/12/2023 8:36:42 AM,Overall,5999,8996,6568,8426,29989,7361,9990,6201,7891,31443
21,Somalia,2022,SOM-22/3485/SA1/Nut-WASH/NGO/21478,6/26/2023 10:05:26 AM,Host Communities,1045,7524,840,940,10349,1045,7524,840,940,10349
21,Somalia,2022,SOM-22/3485/SA1/Nut-WASH/NGO/21478,6/26/2023 10:05:26 AM,Internally Displaced People,553,4380,443,498,5874,553,4380,443,498,5874
21,Somalia,2022,SOM-22/3485/SA1/Nut-WASH/NGO/21478,6/26/2023 10:05:26 AM,Overall,1598,11904,1283,1438,16223,1598,11904,1283,1438,16223
21,Somalia,2022,SOM-22/3485/SA1/Shelter/NGO/21471,1/31/2023 7:52:03 AM,Host Communities,253,275,498,462,1488,321,332,622,608,1883
21,Somalia,2022,SOM-22/3485/SA1/Shelter/NGO/21471,1/31/2023 7:52:03 AM,Internally Displaced People,2290,2492,4512,4176,13470,2875,2973,5579,5451,16878
21,Somalia,2022,SOM-22/3485/SA1/Shelter/NGO/21471,1/31/2023 7:52:03 AM,Overall,2543,2767,5010,4638,14958,3196,3305,6201,6059,18761
21,Somalia,2022,SOM-22/3485/SA1/Shelter-HLP/INGO/21510,3/6/2023 6:11:55 AM,Host Communities,1012,1947,880,1003,4842,974,2297,1027,940,5238
21,Somalia,2022,SOM-22/3485/SA1/Shelter-HLP/INGO/21510,3/6/2023 6:11:55 AM,Internally Displaced People,4050,7789,3518,4012,19369,3900,9188,4108,3762,20958
21,Somalia,2022,SOM-22/3485/SA1/Shelter-HLP/INGO/21510,3/6/2023 6:11:55 AM,Overall,5062,9736,4398,5015,24211,4874,11485,5135,4702,26196
21,Somalia,2022,SOM-22/3485/SA1/WASH/INGO/21453,8/21/2023 6:55:05 AM,Host Communities,4903,5126,6018,6241,22288,4939,5164,6063,6286,22452
21,Somalia,2022,SOM-22/3485/SA1/WASH/INGO/21453,8/21/2023 6:55:05 AM,Internally Displaced People,1232,1288,1511,1567,5598,1242,1350,1525,1582,5699
21,Somalia,2022,SOM-22/3485/SA1/WASH/INGO/21453,8/21/2023 6:55:05 AM,Overall,6135,6414,7529,7808,27886,6181,6514,7588,7868,28151
21,Somalia,2022,SOM-22/3485/SA1/WASH/INGO/21475,8/2/2023 1:47:39 PM,Host Communities,1319,1428,1374,1374,5495,1319,1428,1374,1374,5495
21,Somalia,2022,SOM-22/3485/SA1/WASH/INGO/21475,8/2/2023 1:47:39 PM,Internally Displaced People,3077,3334,3206,3206,12823,3077,3334,3206,3206,12823
21,Somalia,2022,SOM-22/3485/SA1/WASH/INGO/21475,8/2/2023 1:47:39 PM,Overall,4396,4762,4580,4580,18318,4396,4762,4580,4580,18318
21,Somalia,2022,SOM-22/3485/SA1/WASH/INGO/21490,3/21/2023 12:35:51 PM,Host Communities,2614,4306,4170,4288,15378,2606,4206,4152,4412,15376
21,Somalia,2022,SOM-22/3485/SA1/WASH/INGO/21490,3/21/2023 12:35:51 PM,Internally Displaced People,959,1579,1523,1579,5640,979,1613,1555,1614,5761
21,Somalia,2022,SOM-22/3485/SA1/WASH/INGO/21490,3/21/2023 12:35:51 PM,Overall,3573,5885,5693,5867,21018,3585,5819,5707,6026,21137
21,Somalia,2022,SOM-22/3485/SA1/WASH/INGO/21556,2/2/2023 10:12:02 AM,Host Communities,3050,4014,1320,1450,9834,3050,4014,1320,1450,9834
21,Somalia,2022,SOM-22/3485/SA1/WASH/INGO/21556,2/2/2023 10:12:02 AM,Internally Displaced People,1793,1895,925,1053,5666,1793,1895,925,1053,5666
21,Somalia,2022,SOM-22/3485/SA1/WASH/INGO/21556,2/2/2023 10:12:02 AM,Overall,4843,5909,2245,2503,15500,4843,5909,2245,2503,15500
21,Somalia,2022,SOM-22/3485/SA1/WASH/NGO/21422,3/1/2023 1:06:57 PM,Host Communities,1094,1438,1065,355,3952,1012,1417,1073,936,4438
21,Somalia,2022,SOM-22/3485/SA1/WASH/NGO/21422,3/1/2023 1:06:57 PM,Internally Displaced People,2490,2795,1895,2104,9284,2176,2809,1903,2208,9096
21,Somalia,2022,SOM-22/3485/SA1/WASH/NGO/21422,3/1/2023 1:06:57 PM,Overall,3584,4233,2960,2459,13236,3188,4226,2976,3144,13534
21,Somalia,2022,SOM-22/3485/SA1/WASH/NGO/21444,2/2/2023 9:03:02 AM,Host Communities,1000,2000,3000,3000,9000,1000,2000,3000,3000,9000
21,Somalia,2022,SOM-22/3485/SA1/WASH/NGO/21444,2/2/2023 9:03:02 AM,Internally Displaced People,1000,2000,4000,4000,11000,1000,2000,4000,4000,11000
21,Somalia,2022,SOM-22/3485/SA1/WASH/NGO/21444,2/2/2023 9:03:02 AM,Overall,2000,4000,7000,7000,20000,2000,4000,7000,7000,20000
21,Somalia,2022,SOM-22/3485/SA1/WASH/NGO/21466,8/21/2023 8:19:49 AM,Host Communities,2540,3429,2921,3810,12700,3364,4540,3864,5040,16808
21,Somalia,2022,SOM-22/3485/SA1/WASH/NGO/21466,8/21/2023 8:19:49 AM,Internally Displaced People,1272,1717,1463,1908,6360,1853,2503,2122,2768,9246
21,Somalia,2022,SOM-22/3485/SA1/WASH/NGO/21466,8/21/2023 8:19:49 AM,Overall,3812,5146,4384,5718,19060,5217,7043,5986,7808,26054
21,Somalia,2022,SOM-22/3485/SA1/WASH/NGO/21477,6/2/2023 8:03:43 AM,Host Communities,800,1600,450,450,3300,800,1600,450,450,3300
21,Somalia,2022,SOM-22/3485/SA1/WASH/NGO/21477,6/2/2023 8:03:43 AM,Internally Displaced People,4200,8900,2000,2000,17100,4200,8900,2000,2000,17100
21,Somalia,2022,SOM-22/3485/SA1/WASH/NGO/21477,6/2/2023 8:03:43 AM,Overall,5000,10500,2450,2450,20400,5000,10500,2450,2450,20400
21,Somalia,2022,SOM-22/3485/SA1/WASH/NGO/21532,4/16/2023 5:20:17 PM,Internally Displaced People,2000,3000,6460,11460,22920,2000,4000,5450,11470,22920
21,Somalia,2022,SOM-22/3485/SA1/WASH/NGO/21532,4/16/2023 5:20:17 PM,Overall,2000,3000,6460,11460,22920,2000,4000,5450,11470,22920
21,Somalia,2022,SOM-22/3485/SA1/WASH/NGO/21533,3/8/2023 12:30:32 PM,Host Communities,1600,2210,950,2500,7260,2028,2247,2666,2671,9612
21,Somalia,2022,SOM-22/3485/SA1/WASH/NGO/21533,3/8/2023 12:30:32 PM,Internally Displaced People,4600,5790,3800,5498,19688,4145,4924,5447,5551,20067
21,Somalia,2022,SOM-22/3485/SA1/WASH/NGO/21533,3/8/2023 12:30:32 PM,Overall,6200,8000,4750,7998,26948,6173,7171,8113,8222,29679
21,Somalia,2022,SOM-22/3485/SA1/WASH/NGO/21540,6/2/2023 8:09:24 AM,Host Communities,2040,2160,4200,3600,12000,2040,2160,4200,3600,12000
21,Somalia,2022,SOM-22/3485/SA1/WASH/NGO/21540,6/2/2023 8:09:24 AM,Internally Displaced People,1360,1440,2800,2400,8000,1360,1440,2800,2400,8000
21,Somalia,2022,SOM-22/3485/SA1/WASH/NGO/21540,6/2/2023 8:09:24 AM,Overall,3400,3600,7000,6000,20000,3400,3600,7000,6000,20000
21,Somalia,2022,SOM-22/3485/SA1/WASH-Nut/NGO/21508,6/26/2023 9:49:00 AM,Host Communities,1376,1376,2064,2064,6880,1376,1478,2159,2261,7274
21,Somalia,2022,SOM-22/3485/SA1/WASH-Nut/NGO/21508,6/26/2023 9:49:00 AM,Internally Displaced People,2064,2064,3096,3096,10320,2064,2064,3096,3096,10320
21,Somalia,2022,SOM-22/3485/SA1/WASH-Nut/NGO/21508,6/26/2023 9:49:00 AM,Overall,3440,3440,5160,5160,17200,3440,3542,5255,5357,17594
20,South Sudan,2020,SSD-20/HSS10/RA1/H/UN/16404,2/18/2021 2:39:08 PM,Other,1474,794,0,0,2268,5381,5169,0,0,10550
20,South Sudan,2020,SSD-20/HSS10/RA1/H/UN/16404,2/18/2021 2:39:08 PM,Overall,1474,794,0,0,2268,5381,5169,0,0,10550
20,South Sudan,2020,SSD-20/HSS10/RA2/CCS/UN/17639,10/19/2021 1:07:10 PM,Internally Displaced People,39107,55019,25305,33933,153364,0,0,0,0,0
20,South Sudan,2020,SSD-20/HSS10/RA2/CCS/UN/17639,10/19/2021 1:07:10 PM,Other,0,0,0,40,40,0,0,0,0,0
20,South Sudan,2020,SSD-20/HSS10/RA2/CCS/UN/17639,10/19/2021 1:07:10 PM,Overall,39107,55019,25305,33973,153404,0,0,0,0,0
20,South Sudan,2020,SSD-20/HSS10/RA2/FSL/INGO/17630,11/2/2021 7:59:30 AM,Host Communities,11114,13582,25930,31694,82320,20542,32762,64800,66011,184115
20,South Sudan,2020,SSD-20/HSS10/RA2/FSL/INGO/17630,11/2/2021 7:59:30 AM,Internally Displaced People,16670,20374,38896,47540,123480,3446,3970,5826,8443,21685
20,South Sudan,2020,SSD-20/HSS10/RA2/FSL/INGO/17630,11/2/2021 7:59:30 AM,Overall,27784,33956,64826,79234,205800,23988,36732,70626,74454,205800
20,South Sudan,2020,SSD-20/HSS10/RA2/H-FSL/INGO/17616,10/25/2021 6:34:58 AM,Host Communities,360,1080,180,180,1800,4210,14421,3148,3338,25117
20,South Sudan,2020,SSD-20/HSS10/RA2/H-FSL/INGO/17616,10/25/2021 6:34:58 AM,Internally Displaced People,3240,9720,1620,1620,16200,530,879,330,1262,3001
20,South Sudan,2020,SSD-20/HSS10/RA2/H-FSL/INGO/17616,10/25/2021 6:34:58 AM,Overall,3600,10800,1800,1800,18000,4740,15300,3478,4600,28118
20,South Sudan,2020,SSD-20/HSS10/RA2/H-N/INGO/17641,8/26/2021 9:08:46 AM,Other,12638,20704,11092,10239,54673,14027,35303,36600,42746,128676
20,South Sudan,2020,SSD-20/HSS10/RA2/H-N/INGO/17641,8/26/2021 9:08:46 AM,Overall,12638,20704,11092,10239,54673,14027,35303,36600,42746,128676
20,South Sudan,2020,SSD-20/HSS10/RA2/N/INGO/17619,10/4/2021 8:11:14 AM,Host Communities,253,2773,3142,3439,9607,698,8834,1257,1637,12426
20,South Sudan,2020,SSD-20/HSS10/RA2/N/INGO/17619,10/4/2021 8:11:14 AM,Internally Displaced People,469,4135,4712,5070,14386,465,1885,539,701,3590
20,South Sudan,2020,SSD-20/HSS10/RA2/N/INGO/17619,10/4/2021 8:11:14 AM,Overall,722,6908,7854,8509,23993,1163,10719,1796,2338,16016
20,South Sudan,2020,SSD-20/HSS10/RA2/N/INGO/17643,9/1/2021 12:24:48 PM,Host Communities,0,900,800,900,2600,0,525,479,536,1540
20,South Sudan,2020,SSD-20/HSS10/RA2/N/INGO/17643,9/1/2021 12:24:48 PM,Internally Displaced People,0,344,233,106,683,0,57,26,25,108
20,South Sudan,2020,SSD-20/HSS10/RA2/N/INGO/17643,9/1/2021 12:24:48 PM,Overall,0,1274,1063,1106,3443,0,583,505,561,1649
20,South Sudan,2020,SSD-20/HSS10/RA2/N/INGO/17643,9/1/2021 12:24:48 PM,Returnees,0,30,30,100,160,0,1,0,0,1
20,South Sudan,2020,SSD-20/HSS10/RA2/N/NGO/17632,6/30/2021 11:05:20 AM,Host Communities,0,900,800,900,2600,0,1900,900,1000,3800
20,South Sudan,2020,SSD-20/HSS10/RA2/N/NGO/17632,6/30/2021 11:05:20 AM,Internally Displaced People,0,166,200,210,576,0,217,200,325,742
20,South Sudan,2020,SSD-20/HSS10/RA2/N/NGO/17632,6/30/2021 11:05:20 AM,Overall,0,1366,1117,1210,3693,0,2417,1261,1454,5132
20,South Sudan,2020,SSD-20/HSS10/RA2/N/NGO/17632,6/30/2021 11:05:20 AM,Returnees,0,300,117,100,517,0,300,161,129,590
20,South Sudan,2020,SSD-20/HSS10/RA2/NFI/INGO/17624,9/6/2021 10:43:06 AM,Host Communities,3587,3734,2391,2489,12201,1441,2472,1637,2169,7719
20,South Sudan,2020,SSD-20/HSS10/RA2/NFI/INGO/17624,9/6/2021 10:43:06 AM,Internally Displaced People,14347,14932,9565,9955,48799,8714,9532,9221,9987,37454
20,South Sudan,2020,SSD-20/HSS10/RA2/NFI/INGO/17624,9/6/2021 10:43:06 AM,Overall,17934,18666,11956,12444,61000,10155,12004,10858,12156,45173
20,South Sudan,2020,SSD-20/HSS10/RA2/NFI/INGO/17627,7/1/2021 12:08:39 PM,Host Communities,2380,2678,4760,5057,14875,5212,6646,5163,6463,23484
20,South Sudan,2020,SSD-20/HSS10/RA2/NFI/INGO/17627,7/1/2021 12:08:39 PM,Internally Displaced People,2720,3060,5440,5780,17000,8480,8918,7199,8238,32835
20,South Sudan,2020,SSD-20/HSS10/RA2/NFI/INGO/17627,7/1/2021 12:08:39 PM,Overall,6800,7650,13600,14450,42500,13692,15564,12362,14701,56319
20,South Sudan,2020,SSD-20/HSS10/RA2/NFI/INGO/17627,7/1/2021 12:08:39 PM,Returnees,1700,1912,3400,3613,10625,0,0,0,0,0
20,South Sudan,2020,SSD-20/HSS10/RA2/NFI/NGO/17622,7/14/2021 9:58:08 AM,Host Communities,1852,3652,1152,1682,8338,1825,3652,1095,1460,8032
20,South Sudan,2020,SSD-20/HSS10/RA2/NFI/NGO/17622,7/14/2021 9:58:08 AM,Internally Displaced People,6070,11237,3776,5424,26507,5019,8030,3011,4015,20075
20,South Sudan,2020,SSD-20/HSS10/RA2/NFI/NGO/17622,7/14/2021 9:58:08 AM,Overall,9505,17508,5778,8409,41200,9125,15332,5475,7300,37232
20,South Sudan,2020,SSD-20/HSS10/RA2/NFI/NGO/17622,7/14/2021 9:58:08 AM,Returnees,1583,2619,850,1303,6355,2281,3650,1369,1825,9125
20,South Sudan,2020,SSD-20/HSS10/RA2/NFI/NGO/17638,8/3/2021 9:40:26 AM,Host Communities,3627,5441,403,604,10075,8559,10887,10367,12922,42735
20,South Sudan,2020,SSD-20/HSS10/RA2/NFI/NGO/17638,8/3/2021 9:40:26 AM,Internally Displaced People,9430,14145,1048,1572,26195,718,1068,995,569,3350
20,South Sudan,2020,SSD-20/HSS10/RA2/NFI/NGO/17638,8/3/2021 9:40:26 AM,Overall,14508,21762,1612,2418,40300,9277,11955,11362,13491,46085
20,South Sudan,2020,SSD-20/HSS10/RA2/NFI/NGO/17638,8/3/2021 9:40:26 AM,Returnees,1451,2176,161,242,4030,0,0,0,0,0
20,South Sudan,2020,SSD-20/HSS10/RA2/N-FSL/INGO/17626,8/4/2021 9:51:20 AM,Host Communities,800,900,1070,1231,4001,1238,1759,2051,2270,7318
20,South Sudan,2020,SSD-20/HSS10/RA2/N-FSL/INGO/17626,8/4/2021 9:51:20 AM,Internally Displaced People,1334,1868,2431,2698,8331,959,1365,1586,1757,5667
20,South Sudan,2020,SSD-20/HSS10/RA2/N-FSL/INGO/17626,8/4/2021 9:51:20 AM,Overall,2668,3335,4231,4766,15000,3723,5387,6220,6885,22215
20,South Sudan,2020,SSD-20/HSS10/RA2/N-FSL/INGO/17626,8/4/2021 9:51:20 AM,Returnees,534,567,730,837,2668,1526,2263,2583,2858,9230
20,South Sudan,2020,SSD-20/HSS10/RA2/P/INGO/17614,8/27/2021 7:34:05 AM,Host Communities,10,984,251,720,1965,2577,3567,1711,2319,10174
20,South Sudan,2020,SSD-20/HSS10/RA2/P/INGO/17614,8/27/2021 7:34:05 AM,Internally Displaced People,10,984,251,720,1965,2576,3568,1712,2319,10175
20,South Sudan,2020,SSD-20/HSS10/RA2/P/INGO/17614,8/27/2021 7:34:05 AM,Overall,20,2200,565,1615,4400,5153,7135,3423,4638,20349
20,South Sudan,2020,SSD-20/HSS10/RA2/P/INGO/17614,8/27/2021 7:34:05 AM,Returnees,0,232,63,175,470,0,0,0,0,0
20,South Sudan,2020,SSD-20/HSS10/RA2/P/NGO/17621,7/21/2021 8:25:17 AM,Host Communities,76,106,1754,2616,4552,173,350,2474,1944,4941
20,South Sudan,2020,SSD-20/HSS10/RA2/P/NGO/17621,7/21/2021 8:25:17 AM,Internally Displaced People,179,249,4094,6106,10628,404,818,5772,4535,11529
20,South Sudan,2020,SSD-20/HSS10/RA2/P/NGO/17621,7/21/2021 8:25:17 AM,Overall,255,355,5848,8722,15180,577,1168,8246,6479,16470
20,South Sudan,2020,SSD-20/HSS10/RA2/P/NGO/17628,5/26/2021 10:33:02 AM,Host Communities,600,1300,1200,1200,4300,650,1400,1300,1300,4650
20,South Sudan,2020,SSD-20/HSS10/RA2/P/NGO/17628,5/26/2021 10:33:02 AM,Internally Displaced People,600,800,700,1000,3100,770,850,750,1050,3420
20,South Sudan,2020,SSD-20/HSS10/RA2/P/NGO/17628,5/26/2021 10:33:02 AM,Other,50,50,0,0,100,50,50,0,0,100
20,South Sudan,2020,SSD-20/HSS10/RA2/P/NGO/17628,5/26/2021 10:33:02 AM,Overall,1250,2150,1900,2200,7500,1470,2300,2050,2350,8170
20,South Sudan,2020,SSD-20/HSS10/RA2/P-FSL/NGO/17646,9/22/2021 9:13:29 AM,Host Communities,6965,10506,7183,9977,34631,6915,10243,4264,6854,28276
20,South Sudan,2020,SSD-20/HSS10/RA2/P-FSL/NGO/17646,9/22/2021 9:13:29 AM,Internally Displaced People,1883,2839,1941,2697,9360,1909,2750,1903,2525,9087
20,South Sudan,2020,SSD-20/HSS10/RA2/P-FSL/NGO/17646,9/22/2021 9:13:29 AM,Overall,9318,14055,9609,13174,46156,9202,13633,6641,9864,39340
20,South Sudan,2020,SSD-20/HSS10/RA2/P-FSL/NGO/17646,9/22/2021 9:13:29 AM,Returnees,470,710,485,500,2165,378,640,474,485,1977
20,South Sudan,2020,SSD-20/HSS10/RA2/P-H/INGO/17636,11/23/2021 7:56:12 AM,Host Communities,2617,4307,911,1858,9693,2124,4284,2283,3033,11724
20,South Sudan,2020,SSD-20/HSS10/RA2/P-H/INGO/17636,11/23/2021 7:56:12 AM,Internally Displaced People,9787,14936,3245,6109,34077,3339,6834,3556,4805,18534
20,South Sudan,2020,SSD-20/HSS10/RA2/P-H/INGO/17636,11/23/2021 7:56:12 AM,Overall,12404,19243,4156,7967,43770,5463,11118,5839,7838,30258
20,South Sudan,2020,SSD-20/HSS10/RA2/P-N/INGO/17637,8/19/2021 11:10:26 AM,Host Communities,910,14060,11329,12107,38406,3803,23338,13455,14103,54699
20,South Sudan,2020,SSD-20/HSS10/RA2/P-N/INGO/17637,8/19/2021 11:10:26 AM,Internally Displaced People,610,4163,4202,4402,13377,458,6026,4003,4230,14717
20,South Sudan,2020,SSD-20/HSS10/RA2/P-N/INGO/17637,8/19/2021 11:10:26 AM,Overall,1620,18423,15931,16909,52883,4261,29364,17458,18333,69416
20,South Sudan,2020,SSD-20/HSS10/RA2/P-N/INGO/17637,8/19/2021 11:10:26 AM,Returnees,100,200,400,400,1100,0,0,0,0,0
20,South Sudan,2020,SSD-20/HSS10/RA2/WASH/INGO/17647,12/6/2021 11:33:13 AM,Host Communities,1146,1517,1628,1785,6076,2031,2070,2681,2687,9469
20,South Sudan,2020,SSD-20/HSS10/RA2/WASH/INGO/17647,12/6/2021 11:33:13 AM,Internally Displaced People,1647,3912,3697,4731,13987,1588,1527,1690,1696,6501
20,South Sudan,2020,SSD-20/HSS10/RA2/WASH/INGO/17647,12/6/2021 11:33:13 AM,Overall,2898,5567,5440,6644,20549,3657,3632,4412,4425,16126
20,South Sudan,2020,SSD-20/HSS10/RA2/WASH/INGO/17647,12/6/2021 11:33:13 AM,Returnees,105,138,115,128,486,38,35,41,42,156
20,South Sudan,2020,SSD-20/HSS10/RA2/WASH/NGO/17617,9/22/2021 9:12:13 AM,Host Communities,2800,4000,2400,3600,12800,6267,8183,6800,9083,30333
20,South Sudan,2020,SSD-20/HSS10/RA2/WASH/NGO/17617,9/22/2021 9:12:13 AM,Internally Displaced People,700,1400,800,1000,3900,8068,12884,9000,12384,42336
20,South Sudan,2020,SSD-20/HSS10/RA2/WASH/NGO/17617,9/22/2021 9:12:13 AM,Overall,3900,6150,3750,5200,19000,16352,23221,17551,23406,80530
20,South Sudan,2020,SSD-20/HSS10/RA2/WASH/NGO/17617,9/22/2021 9:12:13 AM,Returnees,400,750,550,600,2300,2017,2154,1751,1939,7861
20,South Sudan,2020,SSD-20/HSS10/RA2/WASH/NGO/17629,7/21/2021 2:54:08 PM,Host Communities,604,674,1136,1136,3550,604,674,1136,1136,3550
20,South Sudan,2020,SSD-20/HSS10/RA2/WASH/NGO/17629,7/21/2021 2:54:08 PM,Internally Displaced People,1220,1355,2300,2300,7175,1220,1355,2300,2300,7175
20,South Sudan,2020,SSD-20/HSS10/RA2/WASH/NGO/17629,7/21/2021 2:54:08 PM,Overall,2293,2551,4316,4316,13476,2293,2551,4316,4316,13476
20,South Sudan,2020,SSD-20/HSS10/RA2/WASH/NGO/17629,7/21/2021 2:54:08 PM,Refugees,124,138,232,232,726,124,138,232,232,726
20,South Sudan,2020,SSD-20/HSS10/RA2/WASH/NGO/17629,7/21/2021 2:54:08 PM,Returnees,345,384,648,648,2025,345,384,648,648,2025
20,South Sudan,2020,SSD-20/HSS10/RA2/WASH/NGO/17631,6/30/2021 12:56:56 PM,Host Communities,288,896,672,1344,3200,308,961,670,1440,3379
20,South Sudan,2020,SSD-20/HSS10/RA2/WASH/NGO/17631,6/30/2021 12:56:56 PM,Internally Displaced People,2592,8064,6048,12096,28800,4651,8816,8174,9807,31448
20,South Sudan,2020,SSD-20/HSS10/RA2/WASH/NGO/17631,6/30/2021 12:56:56 PM,Overall,2880,8960,6720,13440,32000,4959,9777,8844,11247,34827
20,South Sudan,2020,SSD-20/HSS10/RA2/WASH-FSL/INGO/17644,10/15/2021 6:49:10 AM,Host Communities,3486,7434,4032,6048,21000,4263,8777,4765,7272,25077
20,South Sudan,2020,SSD-20/HSS10/RA2/WASH-FSL/INGO/17644,10/15/2021 6:49:10 AM,Internally Displaced People,2439,5205,2822,4234,14700,2984,6144,3335,5091,17554
20,South Sudan,2020,SSD-20/HSS10/RA2/WASH-FSL/INGO/17644,10/15/2021 6:49:10 AM,Overall,6972,14868,8064,12096,42000,8526,17554,9529,14545,50154
20,South Sudan,2020,SSD-20/HSS10/RA2/WASH-FSL/INGO/17644,10/15/2021 6:49:10 AM,Returnees,1047,2229,1210,1814,6300,1279,2633,1429,2182,7523
20,South Sudan,2020,SSD-20/HSS10/RA2/WASH-NFI-FSL/NGO/17615,8/2/2021 10:38:43 AM,Host Communities,2000,3000,5000,5900,15900,2000,3000,5000,5900,15900
20,South Sudan,2020,SSD-20/HSS10/RA2/WASH-NFI-FSL/NGO/17615,8/2/2021 10:38:43 AM,Internally Displaced People,13000,14000,21000,22000,70000,13000,14000,21000,22000,70000
20,South Sudan,2020,SSD-20/HSS10/RA2/WASH-NFI-FSL/NGO/17615,8/2/2021 10:38:43 AM,Overall,15000,17000,26000,27900,85900,15000,17000,26000,27900,85900
20,South Sudan,2020,SSD-20/HSS10/RA3/FSL/INGO/18010,11/3/2021 12:06:28 PM,Host Communities,7298,7993,9383,10078,34752,16171,24001,29313,27589,97074
20,South Sudan,2020,SSD-20/HSS10/RA3/FSL/INGO/18010,11/3/2021 12:06:28 PM,Internally Displaced People,13227,14487,17007,18267,62988,2794,4148,5066,4768,16776
20,South Sudan,2020,SSD-20/HSS10/RA3/FSL/INGO/18010,11/3/2021 12:06:28 PM,Overall,22806,24978,29322,31494,108600,19545,29010,35431,33346,117332
20,South Sudan,2020,SSD-20/HSS10/RA3/FSL/INGO/18010,11/3/2021 12:06:28 PM,Returnees,2281,2498,2932,3149,10860,580,861,1052,989,3482
20,South Sudan,2020,SSD-20/HSS10/RA3/FSL/INGO/18030,9/22/2021 9:26:52 AM,Host Communities,8601,8601,15000,15000,47202,7110,9060,14300,16900,47370
20,South Sudan,2020,SSD-20/HSS10/RA3/FSL/INGO/18030,9/22/2021 9:26:52 AM,Internally Displaced People,6000,6000,7000,7000,26000,5200,7400,6300,7600,26500
20,South Sudan,2020,SSD-20/HSS10/RA3/FSL/INGO/18030,9/22/2021 9:26:52 AM,Overall,16601,16601,25000,25000,83202,16601,16601,25000,25000,83202
20,South Sudan,2020,SSD-20/HSS10/RA3/FSL/INGO/18030,9/22/2021 9:26:52 AM,Returnees,2000,2000,3000,3000,10000,4291,141,4400,500,9332
20,South Sudan,2020,SSD-20/HSS10/RA3/FSL/UN/18049,3/21/2022 11:58:07 AM,Host Communities,59100,98500,19700,19700,197000,59100,98500,19700,19700,197000
20,South Sudan,2020,SSD-20/HSS10/RA3/FSL/UN/18049,3/21/2022 11:58:07 AM,Internally Displaced People,24600,41000,8200,8200,82000,24600,41000,8200,8200,82000
20,South Sudan,2020,SSD-20/HSS10/RA3/FSL/UN/18049,3/21/2022 11:58:07 AM,Overall,90000,150000,30000,30000,300000,90000,150000,30000,30000,300000
20,South Sudan,2020,SSD-20/HSS10/RA3/FSL/UN/18049,3/21/2022 11:58:07 AM,Refugees,6300,10500,2100,2100,21000,6300,10500,2100,2100,21000
20,South Sudan,2020,SSD-20/HSS10/RA3/H/NGO/18006,11/2/2021 9:14:59 AM,Host Communities,1905,2896,1296,1524,7621,1937,3039,1472,1834,8282
20,South Sudan,2020,SSD-20/HSS10/RA3/H/NGO/18006,11/2/2021 9:14:59 AM,Internally Displaced People,636,965,432,508,2541,597,985,562,677,2821
20,South Sudan,2020,SSD-20/HSS10/RA3/H/NGO/18006,11/2/2021 9:14:59 AM,Overall,12703,19308,8638,10162,50811,13178,20205,11139,12947,57469
20,South Sudan,2020,SSD-20/HSS10/RA3/H/NGO/18006,11/2/2021 9:14:59 AM,Returnees,10162,15447,6910,8130,40649,10644,16181,9105,10436,46366
20,South Sudan,2020,SSD-20/HSS10/RA3/H/NGO/18011,1/31/2022 1:33:37 PM,Host Communities,3398,4836,2675,3578,14487,4624,10658,4630,5738,25650
20,South Sudan,2020,SSD-20/HSS10/RA3/H/NGO/18011,1/31/2022 1:33:37 PM,Internally Displaced People,5663,8060,4458,5965,24146,3952,7843,3455,3429,18679
20,South Sudan,2020,SSD-20/HSS10/RA3/H/NGO/18011,1/31/2022 1:33:37 PM,Overall,11326,16120,8915,11929,48290,11019,23716,10315,11486,56536
20,South Sudan,2020,SSD-20/HSS10/RA3/H/NGO/18011,1/31/2022 1:33:37 PM,Returnees,2265,3224,1782,2386,9657,2443,5215,2230,2319,12207
20,South Sudan,2020,SSD-20/HSS10/RA3/H/NGO/18025,11/26/2021 10:36:49 AM,Host Communities,1000,1830,1040,1480,5350,5902,10135,9350,11597,36984
20,South Sudan,2020,SSD-20/HSS10/RA3/H/NGO/18025,11/26/2021 10:36:49 AM,Internally Displaced People,1500,2745,1560,2220,8025,998,1713,1580,1960,6251
20,South Sudan,2020,SSD-20/HSS10/RA3/H/NGO/18025,11/26/2021 10:36:49 AM,Overall,5000,9150,5200,7400,26750,8313,14275,13169,16334,52091
20,South Sudan,2020,SSD-20/HSS10/RA3/H/NGO/18025,11/26/2021 10:36:49 AM,Returnees,2500,4575,2600,3700,13375,1413,2427,2239,2777,8856
20,South Sudan,2020,SSD-20/HSS10/RA3/H/NGO/18027,12/29/2021 7:18:04 AM,Host Communities,3532,7030,2382,3842,16786,3500,7210,2390,4200,17300
20,South Sudan,2020,SSD-20/HSS10/RA3/H/NGO/18027,12/29/2021 7:18:04 AM,Internally Displaced People,1250,2320,980,1600,6150,1200,2420,902,1704,6226
20,South Sudan,2020,SSD-20/HSS10/RA3/H/NGO/18027,12/29/2021 7:18:04 AM,Other,260,424,160,220,1064,220,456,152,231,1059
20,South Sudan,2020,SSD-20/HSS10/RA3/H/NGO/18027,12/29/2021 7:18:04 AM,Overall,5042,9774,3522,5662,24000,4920,10086,3444,6135,24585
20,South Sudan,2020,SSD-20/HSS10/RA3/H/UN/18021,11/25/2021 7:16:11 AM,Host Communities,4769,4964,1268,1319,12320,3727,4463,3699,6484,18373
20,South Sudan,2020,SSD-20/HSS10/RA3/H/UN/18021,11/25/2021 7:16:11 AM,Internally Displaced People,6070,6318,1613,1679,15680,2928,3507,2906,5095,14436
20,South Sudan,2020,SSD-20/HSS10/RA3/H/UN/18021,11/25/2021 7:16:11 AM,Overall,10839,11282,2881,2998,28000,6655,7970,6605,11579,32809
20,South Sudan,2020,SSD-20/HSS10/RA3/N/INGO/18024,10/25/2021 7:18:24 AM,Host Communities,360,13215,6615,6670,26860,434,21979,6786,7693,36892
20,South Sudan,2020,SSD-20/HSS10/RA3/N/INGO/18024,10/25/2021 7:18:24 AM,Overall,360,13215,6615,6670,26860,434,21979,6786,7693,36892
20,South Sudan,2020,SSD-20/HSS10/RA3/N/INGO/18028,10/18/2021 10:04:27 AM,Host Communities,0,6897,4027,3718,14642,0,6912,3492,4165,14569
20,South Sudan,2020,SSD-20/HSS10/RA3/N/INGO/18028,10/18/2021 10:04:27 AM,Overall,0,6897,4027,3718,14642,0,6912,3492,4165,14569
20,South Sudan,2020,SSD-20/HSS10/RA3/N-FSL/INGO/18020,11/2/2021 10:10:29 AM,Host Communities,7128,7840,9240,10982,35190,17036,21014,17208,23915,79173
20,South Sudan,2020,SSD-20/HSS10/RA3/N-FSL/INGO/18020,11/2/2021 10:10:29 AM,Internally Displaced People,11880,16262,21436,24078,73656,7000,10828,8882,11741,38451
20,South Sudan,2020,SSD-20/HSS10/RA3/N-FSL/INGO/18020,11/2/2021 10:10:29 AM,Overall,23760,29040,36960,42240,132000,25666,36380,27358,41415,130819
20,South Sudan,2020,SSD-20/HSS10/RA3/N-FSL/INGO/18020,11/2/2021 10:10:29 AM,Returnees,4752,4938,6284,7180,23154,1630,4538,1268,5759,13195
20,South Sudan,2020,SSD-20/HSS10/RA3/N-L/UN/18043,10/20/2021 7:25:09 AM,Host Communities,0,0,27732,30042,57774,0,0,27732,30042,57774
20,South Sudan,2020,SSD-20/HSS10/RA3/N-L/UN/18043,10/20/2021 7:25:09 AM,Other,240,60,0,0,300,296,75,0,0,371
20,South Sudan,2020,SSD-20/HSS10/RA3/N-L/UN/18043,10/20/2021 7:25:09 AM,Overall,240,60,27732,30042,58074,296,75,27732,30042,58145
20,South Sudan,2020,SSD-20/HSS10/RA3/P/INGO/18019,9/30/2021 10:30:53 AM,Host Communities,577,723,299,444,2043,1471,1343,749,576,4139
20,South Sudan,2020,SSD-20/HSS10/RA3/P/INGO/18019,9/30/2021 10:30:53 AM,Internally Displaced People,384,482,199,296,1361,205,154,44,28,431
20,South Sudan,2020,SSD-20/HSS10/RA3/P/INGO/18019,9/30/2021 10:30:53 AM,Overall,961,1205,498,740,3404,1676,1497,793,604,4570
20,South Sudan,2020,SSD-20/HSS10/RA3/P-FSL-H-N/INGO/18008,1/28/2022 12:15:44 PM,Host Communities,15731,29386,15364,21589,82070,20359,52914,9901,8735,91909
20,South Sudan,2020,SSD-20/HSS10/RA3/P-FSL-H-N/INGO/18008,1/28/2022 12:15:44 PM,Internally Displaced People,6743,12593,6585,9253,35174,14470,30972,6649,5446,57537
20,South Sudan,2020,SSD-20/HSS10/RA3/P-FSL-H-N/INGO/18008,1/28/2022 12:15:44 PM,Overall,22474,41979,21949,30842,117244,34829,83886,16550,14181,149446
20,South Sudan,2020,SSD-20/HSS10/RA3/P-N/INGO/18023,11/25/2021 7:17:04 AM,Host Communities,2186,10729,11189,11909,36013,4735,25553,18367,18981,67636
20,South Sudan,2020,SSD-20/HSS10/RA3/P-N/INGO/18023,11/25/2021 7:17:04 AM,Overall,2186,10729,11189,11909,36013,4735,25553,18367,18981,67636
20,South Sudan,2020,SSD-20/HSS10/RA3/WASH/UN/18018,11/12/2021 12:43:03 PM,Host Communities,10470,10591,7582,11474,40117,10115,11505,9444,12023,43087
20,South Sudan,2020,SSD-20/HSS10/RA3/WASH/UN/18018,11/12/2021 12:43:03 PM,Internally Displaced People,5773,5840,4181,6327,22121,7959,5766,4613,5814,24152
20,South Sudan,2020,SSD-20/HSS10/RA3/WASH/UN/18018,11/12/2021 12:43:03 PM,Overall,19183,19404,13891,21022,73500,20235,19640,16604,21595,78074
20,South Sudan,2020,SSD-20/HSS10/RA3/WASH/UN/18018,11/12/2021 12:43:03 PM,Returnees,2940,2973,2128,3221,11262,2161,2369,2547,3758,10835
20,South Sudan,2020,SSD-20/HSS10/SA1/CCCM/NGO/15293,8/31/2021 7:58:04 AM,Internally Displaced People,4200,6200,3400,5200,19000,1100,2000,1100,1350,5550
20,South Sudan,2020,SSD-20/HSS10/SA1/CCCM/NGO/15293,8/31/2021 7:58:04 AM,Overall,4200,6200,3400,5200,19000,1100,2000,1100,1350,5550
20,South Sudan,2020,SSD-20/HSS10/SA1/CCCM/NGO/15587,5/28/2021 8:01:08 AM,Internally Displaced People,4370,4370,5130,5130,19000,12920,13440,13885,14669,54914
20,South Sudan,2020,SSD-20/HSS10/SA1/CCCM/NGO/15587,5/28/2021 8:01:08 AM,Overall,4370,4370,5130,5130,19000,12920,13440,13885,14669,54914
20,South Sudan,2020,SSD-20/HSS10/SA1/CCCM-NFI-P/INGO/15235,9/1/2021 12:17:04 PM,Host Communities,3816,3626,4493,4632,16567,3816,3626,4493,4632,16567
20,South Sudan,2020,SSD-20/HSS10/SA1/CCCM-NFI-P/INGO/15235,9/1/2021 12:17:04 PM,Internally Displaced People,6262,7305,5568,4740,23875,9042,9863,7808,8959,35672
20,South Sudan,2020,SSD-20/HSS10/SA1/CCCM-NFI-P/INGO/15235,9/1/2021 12:17:04 PM,Overall,10078,10931,10061,9372,40442,12858,13489,12301,13591,52239
20,South Sudan,2020,SSD-20/HSS10/SA1/CCCM-NFI-P/INGO/15245,8/10/2021 6:57:51 AM,Host Communities,2566,3694,1415,2077,9752,3120,3546,4113,3404,14183
20,South Sudan,2020,SSD-20/HSS10/SA1/CCCM-NFI-P/INGO/15245,8/10/2021 6:57:51 AM,Internally Displaced People,3972,5720,2190,3214,15096,1751,3226,1936,2305,9218
20,South Sudan,2020,SSD-20/HSS10/SA1/CCCM-NFI-P/INGO/15245,8/10/2021 6:57:51 AM,Overall,8276,11916,4564,6697,31453,6550,8680,8262,7541,31033
20,South Sudan,2020,SSD-20/HSS10/SA1/CCCM-NFI-P/INGO/15245,8/10/2021 6:57:51 AM,Returnees,1738,2502,959,1406,6605,1679,1908,2213,1832,7632
20,South Sudan,2020,SSD-20/HSS10/SA1/CCCM-NFI-P/UN/15597,8/10/2021 7:14:35 AM,Internally Displaced People,5224,6286,5665,6224,23399,3305,4284,5900,6147,19636
20,South Sudan,2020,SSD-20/HSS10/SA1/CCCM-NFI-P/UN/15597,8/10/2021 7:14:35 AM,Overall,5804,6985,6295,6916,26000,5807,7164,9141,9007,31119
20,South Sudan,2020,SSD-20/HSS10/SA1/CCCM-NFI-P/UN/15597,8/10/2021 7:14:35 AM,Returnees,580,699,630,692,2601,2502,2880,3241,2860,11483
20,South Sudan,2020,SSD-20/HSS10/SA1/CCCM-P-NFI/INGO/15685,8/5/2021 7:39:33 AM,Host Communities,289,326,579,615,1809,1661,2044,2727,3820,10252
20,South Sudan,2020,SSD-20/HSS10/SA1/CCCM-P-NFI/INGO/15685,8/5/2021 7:39:33 AM,Internally Displaced People,1562,1758,3126,3321,9767,7846,7211,11768,10815,37640
20,South Sudan,2020,SSD-20/HSS10/SA1/CCCM-P-NFI/INGO/15685,8/5/2021 7:39:33 AM,Overall,2892,3255,5789,6150,18086,9507,9255,14495,14635,47892
20,South Sudan,2020,SSD-20/HSS10/SA1/CCCM-P-NFI/INGO/15685,8/5/2021 7:39:33 AM,Returnees,1041,1171,2084,2214,6510,0,0,0,0,0
20,South Sudan,2020,SSD-20/HSS10/SA1/CCS/INGO/15712,8/10/2021 6:46:41 AM,Other,116,263,0,0,379,116,258,0,0,374
20,South Sudan,2020,SSD-20/HSS10/SA1/CCS/INGO/15712,8/10/2021 6:46:41 AM,Overall,116,263,0,0,379,116,258,0,0,374
20,South Sudan,2020,SSD-20/HSS10/SA1/E-P/INGO/15505,12/2/2021 7:53:42 AM,Host Communities,530,608,1000,900,3038,621,598,1026,1100,3345
20,South Sudan,2020,SSD-20/HSS10/SA1/E-P/INGO/15505,12/2/2021 7:53:42 AM,Internally Displaced People,534,609,1200,1000,3343,602,579,1370,1150,3701
20,South Sudan,2020,SSD-20/HSS10/SA1/E-P/INGO/15505,12/2/2021 7:53:42 AM,Overall,1380,1720,2700,2300,8100,1633,1698,3027,2786,9144
20,South Sudan,2020,SSD-20/HSS10/SA1/E-P/INGO/15505,12/2/2021 7:53:42 AM,Returnees,316,503,500,400,1719,410,521,631,536,2098
20,South Sudan,2020,SSD-20/HSS10/SA1/E-P/INGO/15616,8/25/2021 7:05:05 AM,Host Communities,89,9,1756,490,2344,341,253,3381,2153,6128
20,South Sudan,2020,SSD-20/HSS10/SA1/E-P/INGO/15616,8/25/2021 7:05:05 AM,Internally Displaced People,230,32,4155,2398,6815,940,1081,12282,9817,24120
20,South Sudan,2020,SSD-20/HSS10/SA1/E-P/INGO/15616,8/25/2021 7:05:05 AM,Overall,319,41,6047,2938,9345,1281,1334,15737,11980,30332
20,South Sudan,2020,SSD-20/HSS10/SA1/E-P/INGO/15616,8/25/2021 7:05:05 AM,Returnees,0,0,136,50,186,0,0,74,10,84
20,South Sudan,2020,SSD-20/HSS10/SA1/E-P/INGO/15643,5/17/2021 9:05:32 AM,Host Communities,448,691,3803,2523,7465,384,1019,4218,2665,8286
20,South Sudan,2020,SSD-20/HSS10/SA1/E-P/INGO/15643,5/17/2021 9:05:32 AM,Internally Displaced People,10,10,332,308,660,13,17,351,311,692
20,South Sudan,2020,SSD-20/HSS10/SA1/E-P/INGO/15643,5/17/2021 9:05:32 AM,Overall,458,701,4135,2831,8125,397,1036,4569,2976,8978
20,South Sudan,2020,SSD-20/HSS10/SA1/E-P/INGO/15652,5/26/2021 10:36:44 AM,Host Communities,624,621,4744,3650,9639,936,1280,1350,1221,4787
20,South Sudan,2020,SSD-20/HSS10/SA1/E-P/INGO/15652,5/26/2021 10:36:44 AM,Internally Displaced People,325,326,2372,1962,4985,490,670,707,639,2506
20,South Sudan,2020,SSD-20/HSS10/SA1/E-P/INGO/15652,5/26/2021 10:36:44 AM,Overall,1000,998,7524,5843,15365,2100,2871,2929,2737,10637
20,South Sudan,2020,SSD-20/HSS10/SA1/E-P/INGO/15652,5/26/2021 10:36:44 AM,Returnees,51,51,408,231,741,674,921,872,877,3344
20,South Sudan,2020,SSD-20/HSS10/SA1/E-P/INGO/15663,9/6/2021 10:18:20 AM,Host Communities,89,35,1632,1251,3007,69,27,237,306,639
20,South Sudan,2020,SSD-20/HSS10/SA1/E-P/INGO/15663,9/6/2021 10:18:20 AM,Internally Displaced People,58,24,1101,837,2020,23,14,406,388,831
20,South Sudan,2020,SSD-20/HSS10/SA1/E-P/INGO/15663,9/6/2021 10:18:20 AM,Overall,175,69,3132,2373,5749,99,52,764,803,1718
20,South Sudan,2020,SSD-20/HSS10/SA1/E-P/INGO/15663,9/6/2021 10:18:20 AM,Returnees,28,10,399,285,722,7,11,121,109,248
20,South Sudan,2020,SSD-20/HSS10/SA1/E-P/INGO/15684,7/12/2021 2:03:29 PM,Host Communities,271,271,1854,1236,3632,1483,1548,1741,1678,6450
20,South Sudan,2020,SSD-20/HSS10/SA1/E-P/INGO/15684,7/12/2021 2:03:29 PM,Internally Displaced People,149,149,1024,682,2004,376,392,441,425,1634
20,South Sudan,2020,SSD-20/HSS10/SA1/E-P/INGO/15684,7/12/2021 2:03:29 PM,Overall,467,467,3198,2131,6263,2089,2180,2452,2363,9084
20,South Sudan,2020,SSD-20/HSS10/SA1/E-P/INGO/15684,7/12/2021 2:03:29 PM,Returnees,47,47,320,213,627,230,240,270,260,1000
20,South Sudan,2020,SSD-20/HSS10/SA1/E-P/NGO/15516,5/14/2021 12:01:28 PM,Host Communities,60,30,660,540,1290,73,17,685,516,1291
20,South Sudan,2020,SSD-20/HSS10/SA1/E-P/NGO/15516,5/14/2021 12:01:28 PM,Internally Displaced People,48,24,528,432,1032,58,14,548,412,1032
20,South Sudan,2020,SSD-20/HSS10/SA1/E-P/NGO/15516,5/14/2021 12:01:28 PM,Overall,120,60,1320,1080,2580,146,34,1370,1031,2581
20,South Sudan,2020,SSD-20/HSS10/SA1/E-P/NGO/15516,5/14/2021 12:01:28 PM,Returnees,12,6,132,108,258,15,3,137,103,258
20,South Sudan,2020,SSD-20/HSS10/SA1/E-P/NGO/15677,7/12/2021 2:04:53 PM,Host Communities,60,52,2016,1824,3952,160,214,1572,1682,3628
20,South Sudan,2020,SSD-20/HSS10/SA1/E-P/NGO/15677,7/12/2021 2:04:53 PM,Internally Displaced People,33,35,510,520,1098,62,91,617,622,1392
20,South Sudan,2020,SSD-20/HSS10/SA1/E-P/NGO/15677,7/12/2021 2:04:53 PM,Overall,103,97,3136,2894,6230,340,426,3055,3261,7082
20,South Sudan,2020,SSD-20/HSS10/SA1/E-P/NGO/15677,7/12/2021 2:04:53 PM,Returnees,10,10,610,550,1180,118,121,866,957,2062
20,South Sudan,2020,SSD-20/HSS10/SA1/FSL/INGO/15321,8/4/2021 9:13:23 AM,Host Communities,4000,4000,230,230,8460,8979,8793,550,558,18880
20,South Sudan,2020,SSD-20/HSS10/SA1/FSL/INGO/15321,8/4/2021 9:13:23 AM,Internally Displaced People,8000,8500,210,210,16920,2549,2712,80,82,5423
20,South Sudan,2020,SSD-20/HSS10/SA1/FSL/INGO/15321,8/4/2021 9:13:23 AM,Overall,12900,13500,940,860,28200,12971,13084,1308,1452,28815
20,South Sudan,2020,SSD-20/HSS10/SA1/FSL/INGO/15321,8/4/2021 9:13:23 AM,Returnees,900,1000,500,420,2820,1443,1579,678,812,4512
20,South Sudan,2020,SSD-20/HSS10/SA1/FSL/INGO/15513,11/2/2021 7:56:36 AM,Host Communities,2806,7824,4702,12028,27360,3358,7123,15909,19167,45557
20,South Sudan,2020,SSD-20/HSS10/SA1/FSL/INGO/15513,11/2/2021 7:56:36 AM,Internally Displaced People,5234,8810,7632,19364,41040,2892,5200,5181,12037,25310
20,South Sudan,2020,SSD-20/HSS10/SA1/FSL/INGO/15513,11/2/2021 7:56:36 AM,Overall,8040,16634,12334,31392,68400,6250,12323,21090,31204,70867
20,South Sudan,2020,SSD-20/HSS10/SA1/FSL/NGO/15474,8/9/2021 6:51:03 AM,Host Communities,6996,8556,780,948,17280,5748,6726,0,0,12474
20,South Sudan,2020,SSD-20/HSS10/SA1/FSL/NGO/15474,8/9/2021 6:51:03 AM,Internally Displaced People,2334,2850,258,318,5760,4368,11400,0,0,15768
20,South Sudan,2020,SSD-20/HSS10/SA1/FSL/NGO/15474,8/9/2021 6:51:03 AM,Overall,11664,14256,1296,1584,28800,10380,18420,0,0,28800
20,South Sudan,2020,SSD-20/HSS10/SA1/FSL/NGO/15474,8/9/2021 6:51:03 AM,Returnees,2334,2850,258,318,5760,264,294,0,0,558
20,South Sudan,2020,SSD-20/HSS10/SA1/FSL/NGO/15594,6/4/2021 12:18:55 PM,Host Communities,5160,7200,3000,1680,17040,2310,2284,3262,2301,10157
20,South Sudan,2020,SSD-20/HSS10/SA1/FSL/NGO/15594,6/4/2021 12:18:55 PM,Internally Displaced People,2322,3240,1350,756,7668,1896,1874,2676,1889,8335
20,South Sudan,2020,SSD-20/HSS10/SA1/FSL/NGO/15594,6/4/2021 12:18:55 PM,Overall,12900,18000,7500,4200,42600,9873,9759,13939,9836,43407
20,South Sudan,2020,SSD-20/HSS10/SA1/FSL/NGO/15594,6/4/2021 12:18:55 PM,Refugees,258,360,150,84,852,10,9,14,10,43
20,South Sudan,2020,SSD-20/HSS10/SA1/FSL/NGO/15594,6/4/2021 12:18:55 PM,Returnees,5160,7200,3000,1680,17040,5657,5592,7987,5636,24872
20,South Sudan,2020,SSD-20/HSS10/SA1/FSL/NGO/15636,6/15/2021 9:58:00 AM,Host Communities,3798,6174,756,1152,11880,4326,8358,240,72,12996
20,South Sudan,2020,SSD-20/HSS10/SA1/FSL/NGO/15636,6/15/2021 9:58:00 AM,Internally Displaced People,6330,10290,1260,1920,19800,4938,11232,474,102,16746
20,South Sudan,2020,SSD-20/HSS10/SA1/FSL/NGO/15636,6/15/2021 9:58:00 AM,Overall,12660,20580,2520,3840,39600,12348,26118,912,222,39600
20,South Sudan,2020,SSD-20/HSS10/SA1/FSL/NGO/15636,6/15/2021 9:58:00 AM,Returnees,2532,4116,504,768,7920,3084,6528,198,48,9858
20,South Sudan,2020,SSD-20/HSS10/SA1/FSL/NGO/15658,11/2/2021 8:01:51 AM,Host Communities,2800,2500,1500,2000,8800,2800,2500,1500,2000,8800
20,South Sudan,2020,SSD-20/HSS10/SA1/FSL/NGO/15658,11/2/2021 8:01:51 AM,Internally Displaced People,1000,1800,900,1000,4700,1000,1800,900,1000,4700
20,South Sudan,2020,SSD-20/HSS10/SA1/FSL/NGO/15658,11/2/2021 8:01:51 AM,Overall,8800,10800,4200,5000,28800,8800,10800,4200,5000,28800
20,South Sudan,2020,SSD-20/HSS10/SA1/FSL/NGO/15658,11/2/2021 8:01:51 AM,Returnees,5000,6500,1800,2000,15300,5000,6500,1800,2000,15300
20,South Sudan,2020,SSD-20/HSS10/SA1/FSL/NGO/15682,8/31/2021 8:08:17 AM,Host Communities,2000,2000,4000,4000,12000,1880,2210,580,1450,6120
20,South Sudan,2020,SSD-20/HSS10/SA1/FSL/NGO/15682,8/31/2021 8:08:17 AM,Internally Displaced People,2300,2300,3600,3600,11800,5230,6520,2340,2880,16970
20,South Sudan,2020,SSD-20/HSS10/SA1/FSL/NGO/15682,8/31/2021 8:08:17 AM,Overall,4700,4700,9400,9400,28200,8730,9930,4080,5460,28200
20,South Sudan,2020,SSD-20/HSS10/SA1/FSL/NGO/15682,8/31/2021 8:08:17 AM,Returnees,400,400,1800,1800,4400,1620,1200,1160,1130,5110
20,South Sudan,2020,SSD-20/HSS10/SA1/FSL/NGO/15696,6/8/2021 11:48:03 AM,Host Communities,5964,7668,2556,852,17040,8415,8515,2805,3649,23384
20,South Sudan,2020,SSD-20/HSS10/SA1/FSL/NGO/15696,6/8/2021 11:48:03 AM,Internally Displaced People,2682,3450,1152,384,7668,4578,4368,1216,2151,12313
20,South Sudan,2020,SSD-20/HSS10/SA1/FSL/NGO/15696,6/8/2021 11:48:03 AM,Overall,14910,19170,6390,2130,42600,19911,20017,6646,8878,55452
20,South Sudan,2020,SSD-20/HSS10/SA1/FSL/NGO/15696,6/8/2021 11:48:03 AM,Refugees,300,384,126,42,852,887,1107,280,242,2516
20,South Sudan,2020,SSD-20/HSS10/SA1/FSL/NGO/15696,6/8/2021 11:48:03 AM,Returnees,5964,7668,2556,852,17040,6031,6027,2345,2836,17239
20,South Sudan,2020,SSD-20/HSS10/SA1/H/INGO/15267,6/16/2021 9:04:14 PM,Host Communities,8977,8859,10863,10559,39258,9704,9179,10990,10805,40678
20,South Sudan,2020,SSD-20/HSS10/SA1/H/INGO/15267,6/16/2021 9:04:14 PM,Internally Displaced People,3168,3196,3706,3688,13758,3425,3312,3749,3774,14260
20,South Sudan,2020,SSD-20/HSS10/SA1/H/INGO/15267,6/16/2021 9:04:14 PM,Overall,12947,12798,15622,15214,56581,13996,13261,15804,15569,58630
20,South Sudan,2020,SSD-20/HSS10/SA1/H/INGO/15267,6/16/2021 9:04:14 PM,Returnees,802,743,1053,967,3565,867,770,1065,990,3692
20,South Sudan,2020,SSD-20/HSS10/SA1/H/NGO/15320,8/9/2021 7:10:28 AM,Host Communities,3380,3608,5178,5532,17698,2800,3701,4363,4869,15733
20,South Sudan,2020,SSD-20/HSS10/SA1/H/NGO/15320,8/9/2021 7:10:28 AM,Internally Displaced People,2406,2556,3616,3850,12428,1380,2483,1318,1513,6694
20,South Sudan,2020,SSD-20/HSS10/SA1/H/NGO/15320,8/9/2021 7:10:28 AM,Overall,6704,7123,10034,10685,34546,4561,6497,5992,6775,23825
20,South Sudan,2020,SSD-20/HSS10/SA1/H/NGO/15320,8/9/2021 7:10:28 AM,Returnees,918,959,1240,1303,4420,381,313,311,393,1398
20,South Sudan,2020,SSD-20/HSS10/SA1/H/NGO/15419,8/3/2021 6:37:48 AM,Host Communities,4445,5165,961,1442,12013,4579,5321,990,1485,12375
20,South Sudan,2020,SSD-20/HSS10/SA1/H/NGO/15419,8/3/2021 6:37:48 AM,Internally Displaced People,3951,4592,854,1281,10678,4070,4730,880,1320,11000
20,South Sudan,2020,SSD-20/HSS10/SA1/H/NGO/15419,8/3/2021 6:37:48 AM,Overall,9877,11479,2136,3203,26695,10175,11825,2201,3298,27499
20,South Sudan,2020,SSD-20/HSS10/SA1/H/NGO/15419,8/3/2021 6:37:48 AM,Returnees,1481,1722,321,480,4004,1526,1774,331,493,4124
20,South Sudan,2020,SSD-20/HSS10/SA1/H/NGO/15471,7/12/2021 12:09:26 PM,Host Communities,9746,10191,2630,2743,25310,5799,5815,2205,3214,17033
20,South Sudan,2020,SSD-20/HSS10/SA1/H/NGO/15471,7/12/2021 12:09:26 PM,Internally Displaced People,1229,1279,327,340,3175,619,577,523,420,2139
20,South Sudan,2020,SSD-20/HSS10/SA1/H/NGO/15471,7/12/2021 12:09:26 PM,Overall,12289,12790,3267,3400,31746,8587,8815,3444,4570,25416
20,South Sudan,2020,SSD-20/HSS10/SA1/H/NGO/15471,7/12/2021 12:09:26 PM,Returnees,1314,1320,310,317,3261,2169,2423,716,936,6244
20,South Sudan,2020,SSD-20/HSS10/SA1/H/NGO/15538,8/9/2021 7:21:09 AM,Host Communities,2288,6102,3204,3661,15255,4280,7524,3102,2949,17855
20,South Sudan,2020,SSD-20/HSS10/SA1/H/NGO/15538,8/9/2021 7:21:09 AM,Internally Displaced People,1373,3661,1922,2197,9153,2397,4213,1737,1651,9998
20,South Sudan,2020,SSD-20/HSS10/SA1/H/NGO/15538,8/9/2021 7:21:09 AM,Overall,4576,12204,6407,7323,30510,8560,15048,6204,5897,35709
20,South Sudan,2020,SSD-20/HSS10/SA1/H/NGO/15538,8/9/2021 7:21:09 AM,Returnees,915,2441,1281,1465,6102,1883,3311,1365,1297,7856
20,South Sudan,2020,SSD-20/HSS10/SA1/H/UN/15556,5/14/2021 10:50:17 AM,Host Communities,26474,31155,17842,20521,95992,45938,54889,46281,48055,195163
20,South Sudan,2020,SSD-20/HSS10/SA1/H/UN/15556,5/14/2021 10:50:17 AM,Overall,26474,31155,17842,20521,95992,45938,54889,46281,48055,195163
20,South Sudan,2020,SSD-20/HSS10/SA1/H-FSL-N-P-WASH/INGO/15671,10/12/2021 7:45:05 AM,Host Communities,11858,19837,6268,8647,46610,35166,75062,47967,36753,194948
20,South Sudan,2020,SSD-20/HSS10/SA1/H-FSL-N-P-WASH/INGO/15671,10/12/2021 7:45:05 AM,Internally Displaced People,3997,5147,2352,2957,14453,9610,15684,8858,9427,43579
20,South Sudan,2020,SSD-20/HSS10/SA1/H-FSL-N-P-WASH/INGO/15671,10/12/2021 7:45:05 AM,Overall,20852,31451,11444,14564,78311,51800,101183,64416,54590,271989
20,South Sudan,2020,SSD-20/HSS10/SA1/H-FSL-N-P-WASH/INGO/15671,10/12/2021 7:45:05 AM,Refugees,4997,6467,2824,2960,17248,7024,10437,7591,8410,33462
20,South Sudan,2020,SSD-20/HSS10/SA1/H-N-FSL-WASH-P/INGO/15174,10/4/2021 7:27:08 AM,Host Communities,11987,10972,17830,16459,57248,12140,12879,6675,7146,38840
20,South Sudan,2020,SSD-20/HSS10/SA1/H-N-FSL-WASH-P/INGO/15174,10/4/2021 7:27:08 AM,Internally Displaced People,1320,1218,1488,1374,5400,0,0,0,0,0
20,South Sudan,2020,SSD-20/HSS10/SA1/H-N-FSL-WASH-P/INGO/15174,10/4/2021 7:27:08 AM,Overall,13747,12596,19814,18291,64448,12140,12879,6675,7146,38840
20,South Sudan,2020,SSD-20/HSS10/SA1/H-N-FSL-WASH-P/INGO/15174,10/4/2021 7:27:08 AM,Returnees,440,406,496,458,1800,0,0,0,0,0
20,South Sudan,2020,SSD-20/HSS10/SA1/H-N-FSL-WASH-P/INGO/15445,10/4/2021 1:30:09 PM,Host Communities,6264,11780,17026,21325,56395,4071,10481,15728,19395,49675
20,South Sudan,2020,SSD-20/HSS10/SA1/H-N-FSL-WASH-P/INGO/15445,10/4/2021 1:30:09 PM,Internally Displaced People,1101,1836,3112,4014,10063,419,752,1879,2454,5504
20,South Sudan,2020,SSD-20/HSS10/SA1/H-N-FSL-WASH-P/INGO/15445,10/4/2021 1:30:09 PM,Overall,8283,15266,22818,28615,74982,4980,12212,19687,24244,61123
20,South Sudan,2020,SSD-20/HSS10/SA1/H-N-FSL-WASH-P/INGO/15445,10/4/2021 1:30:09 PM,Returnees,918,1650,2680,3276,8524,490,979,2080,2395,5944
20,South Sudan,2020,SSD-20/HSS10/SA1/H-N-FSL-WASH-P/INGO/15674,8/31/2021 7:59:39 AM,Host Communities,2981,3332,5610,5610,17533,4886,4784,10813,9176,29659
20,South Sudan,2020,SSD-20/HSS10/SA1/H-N-FSL-WASH-P/INGO/15674,8/31/2021 7:59:39 AM,Internally Displaced People,5400,6036,10167,10167,31770,2712,2656,6000,5092,16460
20,South Sudan,2020,SSD-20/HSS10/SA1/H-N-FSL-WASH-P/INGO/15674,8/31/2021 7:59:39 AM,Overall,9312,10409,17529,17529,54779,8779,8597,19427,16486,53289
20,South Sudan,2020,SSD-20/HSS10/SA1/H-N-FSL-WASH-P/INGO/15674,8/31/2021 7:59:39 AM,Returnees,931,1041,1752,1752,5476,1181,1157,2614,2218,7170
20,South Sudan,2020,SSD-20/HSS10/SA1/H-N-FSL-WASH-P/NGO/15609,5/18/2021 2:56:40 PM,Host Communities,2407,4394,1674,1988,10463,3100,5006,960,1050,10116
20,South Sudan,2020,SSD-20/HSS10/SA1/H-N-FSL-WASH-P/NGO/15609,5/18/2021 2:56:40 PM,Internally Displaced People,2707,4944,1883,2237,11771,3380,6100,1035,1500,12015
20,South Sudan,2020,SSD-20/HSS10/SA1/H-N-FSL-WASH-P/NGO/15609,5/18/2021 2:56:40 PM,Overall,6016,10986,4185,4971,26158,7548,13206,2395,3149,26298
20,South Sudan,2020,SSD-20/HSS10/SA1/H-N-FSL-WASH-P/NGO/15609,5/18/2021 2:56:40 PM,Returnees,902,1648,628,746,3924,1068,2100,400,599,4167
20,South Sudan,2020,SSD-20/HSS10/SA1/H-N-P-FSL-WASH/INGO/15383,9/21/2021 6:50:03 AM,Host Communities,23214,36069,24676,27438,111397,16462,26562,31556,36500,111080
20,South Sudan,2020,SSD-20/HSS10/SA1/H-N-P-FSL-WASH/INGO/15383,9/21/2021 6:50:03 AM,Internally Displaced People,2616,4364,4970,3890,15840,1828,2951,2123,2244,9146
20,South Sudan,2020,SSD-20/HSS10/SA1/H-N-P-FSL-WASH/INGO/15383,9/21/2021 6:50:03 AM,Overall,25830,40433,29646,31328,127237,18290,29513,33679,38744,120226
20,South Sudan,2020,SSD-20/HSS10/SA1/H-N-WASH-FSL-P/UN/15626,7/14/2021 7:33:15 AM,Host Communities,23157,26420,8895,6915,65387,18007,35447,15284,24251,92989
20,South Sudan,2020,SSD-20/HSS10/SA1/H-N-WASH-FSL-P/UN/15626,7/14/2021 7:33:15 AM,Internally Displaced People,1478,1686,568,442,4174,1714,2464,2878,3159,10215
20,South Sudan,2020,SSD-20/HSS10/SA1/H-N-WASH-FSL-P/UN/15626,7/14/2021 7:33:15 AM,Overall,24635,28106,9463,7357,69561,19721,37911,18162,27410,103204
20,South Sudan,2020,SSD-20/HSS10/SA1/L/UN/15619,5/14/2021 11:02:30 AM,Host Communities,20,20,20,20,80,23,22,22,22,89
20,South Sudan,2020,SSD-20/HSS10/SA1/L/UN/15619,5/14/2021 11:02:30 AM,Overall,20,20,20,20,80,23,22,22,22,89
20,South Sudan,2020,SSD-20/HSS10/SA1/N/INGO/15407,7/26/2021 7:36:47 AM,Host Communities,113,1023,1116,1161,3413,149,2627,1552,1762,6090
20,South Sudan,2020,SSD-20/HSS10/SA1/N/INGO/15407,7/26/2021 7:36:47 AM,Internally Displaced People,46,418,456,474,1394,61,1074,635,720,2490
20,South Sudan,2020,SSD-20/HSS10/SA1/N/INGO/15407,7/26/2021 7:36:47 AM,Overall,159,1441,1572,1635,4807,210,3701,2187,2482,8580
20,South Sudan,2020,SSD-20/HSS10/SA1/N/INGO/15526,10/4/2021 7:03:46 AM,Host Communities,200,4403,4788,5187,14578,202,4741,5571,6447,16961
20,South Sudan,2020,SSD-20/HSS10/SA1/N/INGO/15526,10/4/2021 7:03:46 AM,Internally Displaced People,144,1468,1596,1729,4937,145,1581,1856,2149,5731
20,South Sudan,2020,SSD-20/HSS10/SA1/N/INGO/15526,10/4/2021 7:03:46 AM,Overall,344,5871,6384,6916,19515,347,6322,7427,8596,22692
20,South Sudan,2020,SSD-20/HSS10/SA1/N/NGO/15219,8/3/2021 8:36:51 AM,Host Communities,0,313,725,982,2020,0,269,569,576,1414
20,South Sudan,2020,SSD-20/HSS10/SA1/N/NGO/15219,8/3/2021 8:36:51 AM,Internally Displaced People,0,134,76,89,299,0,959,927,1034,2920
20,South Sudan,2020,SSD-20/HSS10/SA1/N/NGO/15219,8/3/2021 8:36:51 AM,Overall,0,447,801,1071,2319,0,1228,1496,1610,4334
20,South Sudan,2020,SSD-20/HSS10/SA1/N/NGO/15373,5/19/2021 6:55:55 AM,Host Communities,168,639,872,940,2619,441,921,503,567,2432
20,South Sudan,2020,SSD-20/HSS10/SA1/N/NGO/15373,5/19/2021 6:55:55 AM,Internally Displaced People,70,266,364,392,1092,209,395,258,269,1131
20,South Sudan,2020,SSD-20/HSS10/SA1/N/NGO/15373,5/19/2021 6:55:55 AM,Overall,280,1065,1454,1567,4366,748,1555,921,989,4213
20,South Sudan,2020,SSD-20/HSS10/SA1/N/NGO/15373,5/19/2021 6:55:55 AM,Returnees,42,160,218,235,655,98,239,160,153,650
20,South Sudan,2020,SSD-20/HSS10/SA1/NFI/INGO/15167,5/28/2021 8:27:26 AM,Internally Displaced People,3840,4160,3840,4160,16000,3466,3588,3375,3599,14028
20,South Sudan,2020,SSD-20/HSS10/SA1/NFI/INGO/15167,5/28/2021 8:27:26 AM,Overall,4800,5200,4800,5200,20000,4808,5289,5128,5468,20693
20,South Sudan,2020,SSD-20/HSS10/SA1/NFI/INGO/15167,5/28/2021 8:27:26 AM,Returnees,960,1040,960,1040,4000,1342,1701,1753,1869,6665
20,South Sudan,2020,SSD-20/HSS10/SA1/NFI/INGO/15226,7/1/2021 8:09:29 AM,Internally Displaced People,12187,15095,16302,16282,59866,5013,7400,8079,8824,29316
20,South Sudan,2020,SSD-20/HSS10/SA1/NFI/INGO/15226,7/1/2021 8:09:29 AM,Overall,15595,18785,20608,20448,75436,6663,9101,10085,10958,36807
20,South Sudan,2020,SSD-20/HSS10/SA1/NFI/INGO/15226,7/1/2021 8:09:29 AM,Returnees,3408,3690,4306,4166,15570,1650,1701,2006,2134,7491
20,South Sudan,2020,SSD-20/HSS10/SA1/NFI/NGO/15462,5/14/2021 9:37:26 AM,Host Communities,241,482,562,722,2007,407,1220,610,1830,4067
20,South Sudan,2020,SSD-20/HSS10/SA1/NFI/NGO/15462,5/14/2021 9:37:26 AM,Internally Displaced People,1759,3518,4105,5278,14660,1937,5201,2440,7320,16898
20,South Sudan,2020,SSD-20/HSS10/SA1/NFI/NGO/15462,5/14/2021 9:37:26 AM,Overall,2000,4000,4667,6000,16667,2344,6421,3050,9150,20965
20,South Sudan,2020,SSD-20/HSS10/SA1/NFI/NGO/15520,5/11/2021 10:20:53 AM,Host Communities,300,1500,600,600,3000,629,3145,1258,1258,6290
20,South Sudan,2020,SSD-20/HSS10/SA1/NFI/NGO/15520,5/11/2021 10:20:53 AM,Internally Displaced People,1500,7500,3000,3000,15000,998,4989,1995,1996,9978
20,South Sudan,2020,SSD-20/HSS10/SA1/NFI/NGO/15520,5/11/2021 10:20:53 AM,Overall,2000,10000,4000,4000,20000,2170,10846,4337,4338,21691
20,South Sudan,2020,SSD-20/HSS10/SA1/NFI/NGO/15520,5/11/2021 10:20:53 AM,Returnees,200,1000,400,400,2000,543,2712,1084,1084,5423
20,South Sudan,2020,SSD-20/HSS10/SA1/NFI/NGO/15576,5/14/2021 12:06:08 PM,Host Communities,600,900,200,300,2000,800,1300,200,300,2600
20,South Sudan,2020,SSD-20/HSS10/SA1/NFI/NGO/15576,5/14/2021 12:06:08 PM,Internally Displaced People,5900,9100,1500,1000,17500,6100,9300,1500,1000,17900
20,South Sudan,2020,SSD-20/HSS10/SA1/NFI/NGO/15576,5/14/2021 12:06:08 PM,Overall,6500,10000,1700,1300,19500,6900,10600,1700,1300,20500
20,South Sudan,2020,SSD-20/HSS10/SA1/N-H-WASH-FSL-P/INGO/15484,10/4/2021 6:46:45 AM,Host Communities,9842,19684,25142,26171,80839,8879,15145,9760,11004,44788
20,South Sudan,2020,SSD-20/HSS10/SA1/N-H-WASH-FSL-P/INGO/15484,10/4/2021 6:46:45 AM,Internally Displaced People,2660,5320,6795,7074,21849,2400,4093,2638,2974,12105
20,South Sudan,2020,SSD-20/HSS10/SA1/N-H-WASH-FSL-P/INGO/15484,10/4/2021 6:46:45 AM,Overall,13300,26600,33976,35367,109243,11279,19238,12398,13978,56893
20,South Sudan,2020,SSD-20/HSS10/SA1/N-H-WASH-FSL-P/INGO/15484,10/4/2021 6:46:45 AM,Returnees,798,1596,2039,2122,6555,0,0,0,0,0
20,South Sudan,2020,SSD-20/HSS10/SA1/N-P-FSL-WASH-H/INGO/15357,5/20/2021 7:59:22 AM,Host Communities,4608,9097,4800,4992,23497,12690,16928,6088,7234,42940
20,South Sudan,2020,SSD-20/HSS10/SA1/N-P-FSL-WASH-H/INGO/15357,5/20/2021 7:59:22 AM,Internally Displaced People,1152,1700,3000,3500,9352,1256,2064,3013,3955,10288
20,South Sudan,2020,SSD-20/HSS10/SA1/N-P-FSL-WASH-H/INGO/15357,5/20/2021 7:59:22 AM,Overall,5760,10797,7800,8492,32849,13946,18992,9101,11189,53228
20,South Sudan,2020,SSD-20/HSS10/SA1/P/INGO/15338,8/25/2021 9:54:25 AM,Host Communities,40,617,9,386,1052,164,1687,102,833,2786
20,South Sudan,2020,SSD-20/HSS10/SA1/P/INGO/15338,8/25/2021 9:54:25 AM,Internally Displaced People,101,1544,22,963,2630,97,1004,60,499,1660
20,South Sudan,2020,SSD-20/HSS10/SA1/P/INGO/15338,8/25/2021 9:54:25 AM,Overall,202,3088,44,1926,5260,327,3361,203,1665,5556
20,South Sudan,2020,SSD-20/HSS10/SA1/P/INGO/15338,8/25/2021 9:54:25 AM,Returnees,61,927,13,577,1578,66,670,41,333,1110
20,South Sudan,2020,SSD-20/HSS10/SA1/P/INGO/15356,9/27/2021 11:58:23 AM,Host Communities,2000,2000,3600,3600,11200,3940,3963,5269,5021,18193
20,South Sudan,2020,SSD-20/HSS10/SA1/P/INGO/15356,9/27/2021 11:58:23 AM,Internally Displaced People,300,300,600,600,1800,874,663,749,624,2910
20,South Sudan,2020,SSD-20/HSS10/SA1/P/INGO/15356,9/27/2021 11:58:23 AM,Overall,2400,2400,4600,4600,14000,4825,4635,6023,5653,21136
20,South Sudan,2020,SSD-20/HSS10/SA1/P/INGO/15356,9/27/2021 11:58:23 AM,Returnees,100,100,400,400,1000,11,9,5,8,33
20,South Sudan,2020,SSD-20/HSS10/SA1/P/INGO/15376,8/4/2021 9:12:57 AM,Host Communities,1700,2100,2900,3300,10000,1430,1430,2859,2859,8578
20,South Sudan,2020,SSD-20/HSS10/SA1/P/INGO/15376,8/4/2021 9:12:57 AM,Overall,1700,2100,2900,3300,10000,1430,1430,2859,2859,8578
20,South Sudan,2020,SSD-20/HSS10/SA1/P/INGO/15390,5/17/2021 7:47:47 AM,Host Communities,100,200,0,0,300,180,230,0,0,410
20,South Sudan,2020,SSD-20/HSS10/SA1/P/INGO/15390,5/17/2021 7:47:47 AM,Internally Displaced People,140,280,0,0,420,80,250,0,0,330
20,South Sudan,2020,SSD-20/HSS10/SA1/P/INGO/15390,5/17/2021 7:47:47 AM,Overall,290,580,0,0,870,300,590,0,0,890
20,South Sudan,2020,SSD-20/HSS10/SA1/P/INGO/15390,5/17/2021 7:47:47 AM,Returnees,50,100,0,0,150,40,110,0,0,150
20,South Sudan,2020,SSD-20/HSS10/SA1/P/INGO/15497,5/17/2021 8:32:56 AM,Host Communities,191,254,116,168,729,1078,820,455,407,2760
20,South Sudan,2020,SSD-20/HSS10/SA1/P/INGO/15497,5/17/2021 8:32:56 AM,Internally Displaced People,478,636,290,420,1824,175,183,149,163,670
20,South Sudan,2020,SSD-20/HSS10/SA1/P/INGO/15497,5/17/2021 8:32:56 AM,Overall,956,1272,580,840,3648,1609,1220,686,634,4149
20,South Sudan,2020,SSD-20/HSS10/SA1/P/INGO/15497,5/17/2021 8:32:56 AM,Returnees,287,382,174,252,1095,356,217,82,64,719
20,South Sudan,2020,SSD-20/HSS10/SA1/P/NGO/15181,9/1/2021 12:38:42 PM,Host Communities,736,1825,368,736,3665,736,1825,368,736,3665
20,South Sudan,2020,SSD-20/HSS10/SA1/P/NGO/15181,9/1/2021 12:38:42 PM,Internally Displaced People,606,1515,302,606,3029,606,1515,302,606,3029
20,South Sudan,2020,SSD-20/HSS10/SA1/P/NGO/15181,9/1/2021 12:38:42 PM,Overall,1342,3340,670,1342,6694,1342,3340,670,1342,6694
20,South Sudan,2020,SSD-20/HSS10/SA1/P/NGO/15202,5/25/2021 7:01:43 AM,Host Communities,324,367,391,475,1557,615,620,843,1352,3430
20,South Sudan,2020,SSD-20/HSS10/SA1/P/NGO/15202,5/25/2021 7:01:43 AM,Internally Displaced People,770,948,1197,1384,4299,305,962,629,731,2627
20,South Sudan,2020,SSD-20/HSS10/SA1/P/NGO/15202,5/25/2021 7:01:43 AM,Overall,1306,1541,1933,2202,6982,1330,1995,1995,2992,8312
20,South Sudan,2020,SSD-20/HSS10/SA1/P/NGO/15202,5/25/2021 7:01:43 AM,Returnees,212,226,345,343,1126,410,413,523,909,2255
20,South Sudan,2020,SSD-20/HSS10/SA1/P/NGO/15249,8/9/2021 7:14:49 AM,Host Communities,3000,4200,1400,1400,10000,4522,7436,3497,3441,18896
20,South Sudan,2020,SSD-20/HSS10/SA1/P/NGO/15249,8/9/2021 7:14:49 AM,Internally Displaced People,1400,1800,800,800,4800,2400,2800,2000,2000,9200
20,South Sudan,2020,SSD-20/HSS10/SA1/P/NGO/15249,8/9/2021 7:14:49 AM,Overall,6000,8000,3000,3000,20000,8522,12236,6497,6441,33696
20,South Sudan,2020,SSD-20/HSS10/SA1/P/NGO/15249,8/9/2021 7:14:49 AM,Returnees,1600,2000,800,800,5200,1600,2000,1000,1000,5600
20,South Sudan,2020,SSD-20/HSS10/SA1/P/NGO/15298,7/27/2021 12:48:01 PM,Host Communities,625,638,1810,1810,4883,833,1208,1543,1443,5027
20,South Sudan,2020,SSD-20/HSS10/SA1/P/NGO/15298,7/27/2021 12:48:01 PM,Internally Displaced People,417,424,1207,1207,3255,555,805,1030,962,3352
20,South Sudan,2020,SSD-20/HSS10/SA1/P/NGO/15298,7/27/2021 12:48:01 PM,Overall,1488,1516,4310,4310,11624,1983,2876,3676,3435,11970
20,South Sudan,2020,SSD-20/HSS10/SA1/P/NGO/15298,7/27/2021 12:48:01 PM,Returnees,446,454,1293,1293,3486,595,863,1103,1030,3591
20,South Sudan,2020,SSD-20/HSS10/SA1/P/NGO/15528,8/26/2021 9:03:09 AM,Host Communities,170,1520,120,1000,2810,3232,10932,2260,11934,28358
20,South Sudan,2020,SSD-20/HSS10/SA1/P/NGO/15528,8/26/2021 9:03:09 AM,Internally Displaced People,100,400,80,600,1180,2108,5704,1250,6978,16040
20,South Sudan,2020,SSD-20/HSS10/SA1/P/NGO/15528,8/26/2021 9:03:09 AM,Overall,320,2480,260,1800,4860,6120,19436,4100,21424,51080
20,South Sudan,2020,SSD-20/HSS10/SA1/P/NGO/15528,8/26/2021 9:03:09 AM,Returnees,50,560,60,200,870,780,2800,590,2512,6682
20,South Sudan,2020,SSD-20/HSS10/SA1/P/NGO/15605,5/18/2021 1:47:47 PM,Host Communities,125,650,358,540,1673,401,967,267,460,2095
20,South Sudan,2020,SSD-20/HSS10/SA1/P/NGO/15605,5/18/2021 1:47:47 PM,Internally Displaced People,110,465,210,530,1315,264,679,215,528,1686
20,South Sudan,2020,SSD-20/HSS10/SA1/P/NGO/15605,5/18/2021 1:47:47 PM,Overall,320,1675,675,1196,3866,900,2000,592,1186,4678
20,South Sudan,2020,SSD-20/HSS10/SA1/P/NGO/15605,5/18/2021 1:47:47 PM,Returnees,85,560,107,126,878,235,354,110,198,897
20,South Sudan,2020,SSD-20/HSS10/SA1/WASH/INGO/15302,5/19/2021 6:50:19 AM,Host Communities,816,912,1536,1536,4800,1938,2166,3648,3648,11400
20,South Sudan,2020,SSD-20/HSS10/SA1/WASH/INGO/15302,5/19/2021 6:50:19 AM,Internally Displaced People,1479,1653,2784,2784,8700,3512,3926,6611,6611,20660
20,South Sudan,2020,SSD-20/HSS10/SA1/WASH/INGO/15302,5/19/2021 6:50:19 AM,Overall,2550,2850,4800,4800,15000,6056,6769,11399,11398,35622
20,South Sudan,2020,SSD-20/HSS10/SA1/WASH/INGO/15302,5/19/2021 6:50:19 AM,Returnees,255,285,480,480,1500,606,677,1140,1139,3562
20,South Sudan,2020,SSD-20/HSS10/SA1/WASH/INGO/15683,6/4/2021 1:52:30 PM,Host Communities,4224,4576,1056,1144,11000,3770,4766,7748,7535,23819
20,South Sudan,2020,SSD-20/HSS10/SA1/WASH/INGO/15683,6/4/2021 1:52:30 PM,Internally Displaced People,3168,3432,792,858,8250,729,923,1464,1403,4519
20,South Sudan,2020,SSD-20/HSS10/SA1/WASH/INGO/15683,6/4/2021 1:52:30 PM,Overall,10560,11440,2640,2860,27500,6091,7529,11971,11811,37402
20,South Sudan,2020,SSD-20/HSS10/SA1/WASH/INGO/15683,6/4/2021 1:52:30 PM,Returnees,3168,3432,792,858,8250,1592,1840,2759,2873,9064
20,South Sudan,2020,SSD-20/HSS10/SA1/WASH/NGO/15319,4/21/2021 11:37:42 AM,Host Communities,1430,1787,1931,2002,7150,1428,1558,1645,1698,6329
20,South Sudan,2020,SSD-20/HSS10/SA1/WASH/NGO/15319,4/21/2021 11:37:42 AM,Internally Displaced People,520,650,702,728,2600,867,973,1032,1115,3987
20,South Sudan,2020,SSD-20/HSS10/SA1/WASH/NGO/15319,4/21/2021 11:37:42 AM,Overall,2600,3249,3511,3640,13000,2966,3285,3459,3647,13357
20,South Sudan,2020,SSD-20/HSS10/SA1/WASH/NGO/15319,4/21/2021 11:37:42 AM,Returnees,650,812,878,910,3250,671,754,782,834,3041
20,South Sudan,2020,SSD-20/HSS10/SA1/WASH/NGO/15371,5/4/2021 8:20:40 AM,Host Communities,658,1222,1340,1833,5053,781,1442,1622,2162,6007
20,South Sudan,2020,SSD-20/HSS10/SA1/WASH/NGO/15371,5/4/2021 8:20:40 AM,Internally Displaced People,308,572,627,858,2365,366,675,759,1012,2812
20,South Sudan,2020,SSD-20/HSS10/SA1/WASH/NGO/15371,5/4/2021 8:20:40 AM,Other,56,104,113,156,429,66,123,138,184,511
20,South Sudan,2020,SSD-20/HSS10/SA1/WASH/NGO/15371,5/4/2021 8:20:40 AM,Overall,1400,2600,2850,3900,10750,1662,3068,3451,4599,12780
20,South Sudan,2020,SSD-20/HSS10/SA1/WASH/NGO/15371,5/4/2021 8:20:40 AM,Returnees,378,702,770,1053,2903,449,828,932,1241,3450
20,South Sudan,2020,SSD-20/HSS10/SA1/WASH/NGO/15586,5/31/2021 6:59:59 AM,Host Communities,4534,4984,4455,6107,20080,2111,3929,6853,7187,20080
20,South Sudan,2020,SSD-20/HSS10/SA1/WASH/NGO/15586,5/31/2021 6:59:59 AM,Internally Displaced People,3450,4634,4102,4320,16506,2319,2935,5522,5730,16506
20,South Sudan,2020,SSD-20/HSS10/SA1/WASH/NGO/15586,5/31/2021 6:59:59 AM,Overall,9214,11114,9957,12067,42352,5397,8313,14027,14614,42351
20,South Sudan,2020,SSD-20/HSS10/SA1/WASH/NGO/15586,5/31/2021 6:59:59 AM,Returnees,1230,1496,1400,1640,5766,967,1449,1652,1697,5765
20,South Sudan,2021,SSD-21/HSS10/RA1/CCCM-WASH-NFI/UN/20259,9/27/2022 8:10:34 AM,Host Communities,1429,1612,1719,1935,6695,4260,4573,5188,4992,19013
20,South Sudan,2021,SSD-21/HSS10/RA1/CCCM-WASH-NFI/UN/20259,9/27/2022 8:10:34 AM,Internally Displaced People,40733,42935,52972,57223,193863,61079,60653,75716,71894,269342
20,South Sudan,2021,SSD-21/HSS10/RA1/CCCM-WASH-NFI/UN/20259,9/27/2022 8:10:34 AM,Overall,44938,47643,58140,63051,213772,69536,69731,86019,81796,307082
20,South Sudan,2021,SSD-21/HSS10/RA1/CCCM-WASH-NFI/UN/20259,9/27/2022 8:10:34 AM,Returnees,2776,3096,3449,3893,13214,4197,4505,5115,4910,18727
20,South Sudan,2021,SSD-21/HSS10/RA1/E-P/INGO/20244,9/21/2022 2:28:21 PM,Host Communities,718,734,1495,1296,4243,768,1521,2051,1007,5347
20,South Sudan,2021,SSD-21/HSS10/RA1/E-P/INGO/20244,9/21/2022 2:28:21 PM,Internally Displaced People,1371,1392,2448,2722,7933,1663,2015,2804,4688,11170
20,South Sudan,2021,SSD-21/HSS10/RA1/E-P/INGO/20244,9/21/2022 2:28:21 PM,Overall,2089,2126,3943,4018,12176,2431,3536,4855,5695,16517
20,South Sudan,2021,SSD-21/HSS10/RA1/E-P/INGO/20253,8/18/2022 9:54:25 AM,Internally Displaced People,1236,1538,4866,5025,12665,1257,2181,5221,5649,14308
20,South Sudan,2021,SSD-21/HSS10/RA1/E-P/INGO/20253,8/18/2022 9:54:25 AM,Overall,1236,1538,4866,5025,12665,1257,2181,5221,5649,14308
20,South Sudan,2021,SSD-21/HSS10/RA1/FSL/NGO/20228,7/7/2022 11:16:30 AM,Host Communities,11544,18924,7260,7572,45300,7782,15018,14868,7734,45402
20,South Sudan,2021,SSD-21/HSS10/RA1/FSL/NGO/20228,7/7/2022 11:16:30 AM,Overall,11544,18924,7260,7572,45300,7782,15018,14868,7734,45402
20,South Sudan,2021,SSD-21/HSS10/RA1/FSL-E-WASH-N/INGO/20229,12/14/2022 1:29:49 PM,Host Communities,16078,22303,9482,10111,57974,15978,21300,8487,9181,54946
20,South Sudan,2021,SSD-21/HSS10/RA1/FSL-E-WASH-N/INGO/20229,12/14/2022 1:29:49 PM,Internally Displaced People,62605,73844,22025,23218,181692,18343,21533,22478,21667,84021
20,South Sudan,2021,SSD-21/HSS10/RA1/FSL-E-WASH-N/INGO/20229,12/14/2022 1:29:49 PM,Overall,78683,96147,31507,33329,239666,34321,42833,30965,30848,138967
20,South Sudan,2021,SSD-21/HSS10/RA1/H/INGO/20235,9/8/2022 9:12:56 AM,Host Communities,17657,16693,3891,3759,42000,2965,4178,4432,2909,14484
20,South Sudan,2021,SSD-21/HSS10/RA1/H/INGO/20235,9/8/2022 9:12:56 AM,Overall,17657,16693,3891,3759,42000,2965,4178,4432,2909,14484
20,South Sudan,2021,SSD-21/HSS10/RA1/H/INGO/20241,7/12/2022 6:37:42 AM,Internally Displaced People,12535,13080,14170,14715,54500,5718,8013,21160,27808,62699
20,South Sudan,2021,SSD-21/HSS10/RA1/H/INGO/20241,7/12/2022 6:37:42 AM,Overall,12535,13080,14170,14715,54500,5718,8013,21160,27808,62699
20,South Sudan,2021,SSD-21/HSS10/RA1/H/NGO/20222,7/6/2022 7:21:44 AM,Host Communities,3690,6150,6642,8118,24600,3463,5772,6232,7623,23090
20,South Sudan,2021,SSD-21/HSS10/RA1/H/NGO/20222,7/6/2022 7:21:44 AM,Internally Displaced People,4151,6919,7472,9133,27675,4493,7488,8087,9884,29952
20,South Sudan,2021,SSD-21/HSS10/RA1/H/NGO/20222,7/6/2022 7:21:44 AM,Other,33,27,25,15,100,41,34,28,20,123
20,South Sudan,2021,SSD-21/HSS10/RA1/H/NGO/20222,7/6/2022 7:21:44 AM,Overall,9258,15402,16630,20310,61600,9382,15602,16841,20576,62401
20,South Sudan,2021,SSD-21/HSS10/RA1/H/NGO/20222,7/6/2022 7:21:44 AM,Returnees,1384,2306,2491,3044,9225,1385,2308,2494,3049,9236
20,South Sudan,2021,SSD-21/HSS10/RA1/H/NGO/20225,7/18/2022 8:12:47 AM,Host Communities,2024,3542,2226,2328,10120,5372,6883,4832,5798,22885
20,South Sudan,2021,SSD-21/HSS10/RA1/H/NGO/20225,7/18/2022 8:12:47 AM,Internally Displaced People,8096,14168,8906,9310,40480,12535,16062,11277,13528,53402
20,South Sudan,2021,SSD-21/HSS10/RA1/H/NGO/20225,7/18/2022 8:12:47 AM,Overall,10120,17710,11132,11638,50600,17907,22945,16109,19326,76287
20,South Sudan,2021,SSD-21/HSS10/RA1/H/NGO/20250,8/8/2022 8:10:43 AM,Host Communities,2972,3076,2186,2166,10400,1449,1610,1735,1992,6786
20,South Sudan,2021,SSD-21/HSS10/RA1/H/NGO/20250,8/8/2022 8:10:43 AM,Internally Displaced People,4457,4613,3280,3250,15600,5798,6438,6938,7968,27142
20,South Sudan,2021,SSD-21/HSS10/RA1/H/NGO/20250,8/8/2022 8:10:43 AM,Overall,7429,7689,5466,5416,26000,7247,8048,8673,9960,33928
20,South Sudan,2021,SSD-21/HSS10/RA1/H/UN/20239,8/8/2022 8:13:57 AM,Host Communities,35200,34320,9680,8800,88000,27577,26183,9796,9403,72959
20,South Sudan,2021,SSD-21/HSS10/RA1/H/UN/20239,8/8/2022 8:13:57 AM,Internally Displaced People,52800,51480,14520,13200,132000,59868,57659,14607,14014,146148
20,South Sudan,2021,SSD-21/HSS10/RA1/H/UN/20239,8/8/2022 8:13:57 AM,Overall,88000,85800,24200,22000,220000,87445,83842,24403,23417,219107
20,South Sudan,2021,SSD-21/HSS10/RA1/H/UN/20270,7/29/2022 11:34:58 AM,Host Communities,820,2670,1000,1725,6215,315,2334,433,1475,4557
20,South Sudan,2021,SSD-21/HSS10/RA1/H/UN/20270,7/29/2022 11:34:58 AM,Internally Displaced People,1070,4980,1235,3000,10285,765,7796,987,3805,13353
20,South Sudan,2021,SSD-21/HSS10/RA1/H/UN/20270,7/29/2022 11:34:58 AM,Overall,1890,7650,2235,4725,16500,1080,10130,1420,5280,17910
20,South Sudan,2021,SSD-21/HSS10/RA1/H-FSL/NGO/20266,7/29/2022 11:41:41 AM,Host Communities,13172,16099,12454,11495,53220,13611,16914,13578,12798,56901
20,South Sudan,2021,SSD-21/HSS10/RA1/H-FSL/NGO/20266,7/29/2022 11:41:41 AM,Internally Displaced People,8781,10733,8302,7664,35480,9220,11547,9426,8967,39160
20,South Sudan,2021,SSD-21/HSS10/RA1/H-FSL/NGO/20266,7/29/2022 11:41:41 AM,Overall,21953,26832,20756,19159,88700,22831,28461,23004,21765,96061
20,South Sudan,2021,SSD-21/HSS10/RA1/H-P-WASH-N/INGO/20232,9/29/2022 9:57:47 AM,Host Communities,20785,29919,22569,25941,99214,9292,36461,24235,27885,97873
20,South Sudan,2021,SSD-21/HSS10/RA1/H-P-WASH-N/INGO/20232,9/29/2022 9:57:47 AM,Internally Displaced People,4041,5581,2282,2691,14595,3965,7242,3221,3469,17897
20,South Sudan,2021,SSD-21/HSS10/RA1/H-P-WASH-N/INGO/20232,9/29/2022 9:57:47 AM,Overall,24826,35500,24851,28632,113809,13257,43703,27456,31354,115770
20,South Sudan,2021,SSD-21/HSS10/RA1/L/UN/20223,7/15/2022 10:29:23 AM,Other,205,0,0,0,205,240,0,0,0,240
20,South Sudan,2021,SSD-21/HSS10/RA1/L/UN/20223,7/15/2022 10:29:23 AM,Overall,205,0,0,0,205,240,0,0,0,240
20,South Sudan,2021,SSD-21/HSS10/RA1/N/INGO/20267,6/28/2022 2:54:52 PM,Host Communities,4335,4002,1445,1334,11116,125,1012,1241,1431,3809
20,South Sudan,2021,SSD-21/HSS10/RA1/N/INGO/20267,6/28/2022 2:54:52 PM,Internally Displaced People,2364,2183,788,728,6063,229,1224,1353,1491,4297
20,South Sudan,2021,SSD-21/HSS10/RA1/N/INGO/20267,6/28/2022 2:54:52 PM,Overall,7881,7276,2627,2426,20210,416,2777,3169,3515,9877
20,South Sudan,2021,SSD-21/HSS10/RA1/N/INGO/20267,6/28/2022 2:54:52 PM,Returnees,1182,1091,394,364,3031,62,541,575,593,1771
20,South Sudan,2021,SSD-21/HSS10/RA1/NFI/INGO/20233,8/4/2022 9:10:32 AM,Host Communities,855,945,1305,1395,4500,1827,1970,2135,2411,8343
20,South Sudan,2021,SSD-21/HSS10/RA1/NFI/INGO/20233,8/4/2022 9:10:32 AM,Internally Displaced People,8170,9030,12470,13330,43000,9352,10334,11140,12309,43135
20,South Sudan,2021,SSD-21/HSS10/RA1/NFI/INGO/20233,8/4/2022 9:10:32 AM,Overall,9500,10500,14500,15500,50000,11344,12496,13449,14916,52205
20,South Sudan,2021,SSD-21/HSS10/RA1/NFI/INGO/20233,8/4/2022 9:10:32 AM,Returnees,475,525,725,775,2500,165,192,174,196,727
20,South Sudan,2021,SSD-21/HSS10/RA1/NFI/NGO/20234,7/18/2022 9:44:06 AM,Host Communities,132,132,155,155,574,385,526,561,649,2121
20,South Sudan,2021,SSD-21/HSS10/RA1/NFI/NGO/20234,7/18/2022 9:44:06 AM,Internally Displaced People,5158,5158,6055,6055,22426,3641,4733,5036,5838,19248
20,South Sudan,2021,SSD-21/HSS10/RA1/NFI/NGO/20234,7/18/2022 9:44:06 AM,Overall,5290,5290,6210,6210,23000,4026,5259,5597,6487,21369
20,South Sudan,2021,SSD-21/HSS10/RA1/NFI-FSL/NGO/20251,7/28/2022 10:05:05 AM,Host Communities,466,616,334,334,1750,525,587,627,694,2433
20,South Sudan,2021,SSD-21/HSS10/RA1/NFI-FSL/NGO/20251,7/28/2022 10:05:05 AM,Internally Displaced People,5300,5550,11200,11200,33250,8021,8976,9544,11408,37949
20,South Sudan,2021,SSD-21/HSS10/RA1/NFI-FSL/NGO/20251,7/28/2022 10:05:05 AM,Overall,5766,6166,11534,11534,35000,8546,9563,10171,12102,40382
20,South Sudan,2021,SSD-21/HSS10/RA1/NFI-WASH/NGO/20226,9/27/2022 8:25:23 AM,Host Communities,190,760,475,475,1900,436,544,542,624,2146
20,South Sudan,2021,SSD-21/HSS10/RA1/NFI-WASH/NGO/20226,9/27/2022 8:25:23 AM,Internally Displaced People,3610,14440,9025,9025,36100,8242,8948,11535,12463,41188
20,South Sudan,2021,SSD-21/HSS10/RA1/NFI-WASH/NGO/20226,9/27/2022 8:25:23 AM,Overall,3800,15200,9500,9500,38000,8678,9492,12077,13087,43334
20,South Sudan,2021,SSD-21/HSS10/RA1/P/NGO/20252,7/15/2022 4:00:10 PM,Host Communities,500,1500,500,1500,4000,600,1600,510,1600,4310
20,South Sudan,2021,SSD-21/HSS10/RA1/P/NGO/20252,7/15/2022 4:00:10 PM,Internally Displaced People,1500,4500,2000,3600,11600,1720,4800,2316,4000,12836
20,South Sudan,2021,SSD-21/HSS10/RA1/P/NGO/20252,7/15/2022 4:00:10 PM,Overall,2000,6000,2500,5100,15600,2320,6400,2826,5600,17146
20,South Sudan,2021,SSD-21/HSS10/RA1/P-CCCM/INGO/20257,7/28/2022 10:11:30 AM,Host Communities,420,560,500,520,2000,0,0,0,0,0
20,South Sudan,2021,SSD-21/HSS10/RA1/P-CCCM/INGO/20257,7/28/2022 10:11:30 AM,Internally Displaced People,7140,9520,8500,8840,34000,11944,11577,17652,17115,58288
20,South Sudan,2021,SSD-21/HSS10/RA1/P-CCCM/INGO/20257,7/28/2022 10:11:30 AM,Overall,7560,10080,9000,9360,36000,11944,11577,17652,17115,58288
20,South Sudan,2021,SSD-21/HSS10/RA1/P-WASH/INGO/20238,8/23/2022 1:58:58 PM,Host Communities,7000,9800,4200,7000,28000,14986,16766,7688,7906,47346
20,South Sudan,2021,SSD-21/HSS10/RA1/P-WASH/INGO/20238,8/23/2022 1:58:58 PM,Internally Displaced People,2875,4025,1725,2875,11500,6155,6886,3158,3247,19446
20,South Sudan,2021,SSD-21/HSS10/RA1/P-WASH/INGO/20238,8/23/2022 1:58:58 PM,Overall,12500,17500,7500,12500,50000,26761,29939,13729,14118,84547
20,South Sudan,2021,SSD-21/HSS10/RA1/P-WASH/INGO/20238,8/23/2022 1:58:58 PM,Returnees,2625,3675,1575,2625,10500,5620,6287,2883,2965,17755
20,South Sudan,2021,SSD-21/HSS10/RA1/WASH/INGO/20237,8/18/2022 9:02:28 AM,Internally Displaced People,5750,6000,6750,6500,25000,8264,8390,12584,12710,41948
20,South Sudan,2021,SSD-21/HSS10/RA1/WASH/INGO/20237,8/18/2022 9:02:28 AM,Overall,5750,6000,6750,6500,25000,8264,8390,12584,12710,41948
20,South Sudan,2021,SSD-21/HSS10/RA1/WASH/INGO/20247,1/23/2023 8:06:16 AM,Host Communities,2250,4500,6750,9000,22500,3913,4783,1104,2743,12543
20,South Sudan,2021,SSD-21/HSS10/RA1/WASH/INGO/20247,1/23/2023 8:06:16 AM,Internally Displaced People,750,1500,2250,3000,7500,9130,11160,2577,6398,29265
20,South Sudan,2021,SSD-21/HSS10/RA1/WASH/INGO/20247,1/23/2023 8:06:16 AM,Overall,3000,6000,9000,12000,30000,13043,15943,3681,9141,41808
20,South Sudan,2021,SSD-21/HSS10/RA1/WASH/INGO/20268,11/25/2022 7:18:14 AM,Host Communities,2457,2930,3843,3370,12600,3827,5392,5344,7338,21901
20,South Sudan,2021,SSD-21/HSS10/RA1/WASH/INGO/20268,11/25/2022 7:18:14 AM,Internally Displaced People,1053,1256,1647,1444,5400,1868,2538,2516,3447,10369
20,South Sudan,2021,SSD-21/HSS10/RA1/WASH/INGO/20268,11/25/2022 7:18:14 AM,Overall,3510,4186,5490,4814,18000,5695,7930,7860,10785,32270
20,South Sudan,2021,SSD-21/HSS10/RA1/WASH/NGO/20261,9/14/2022 9:46:24 AM,Host Communities,10211,15318,9399,11489,46417,10211,15318,9399,11489,46417
20,South Sudan,2021,SSD-21/HSS10/RA1/WASH/NGO/20261,9/14/2022 9:46:24 AM,Overall,10211,15318,9399,11489,46417,10211,15318,9399,11489,46417
20,South Sudan,2021,SSD-21/HSS10/RA1/WASH/UN/20224,11/21/2022 10:13:03 AM,Host Communities,4514,4925,5746,5335,20520,5200,5346,6492,6152,23190
20,South Sudan,2021,SSD-21/HSS10/RA1/WASH/UN/20224,11/21/2022 10:13:03 AM,Internally Displaced People,10534,11491,13406,12449,47880,12557,14117,14919,13803,55396
20,South Sudan,2021,SSD-21/HSS10/RA1/WASH/UN/20224,11/21/2022 10:13:03 AM,Overall,15048,16416,19152,17784,68400,17757,19463,21411,19955,78586
20,South Sudan,2021,SSD-21/HSS10/SA1/CCCM-H-NFI-WASH/UN/19490,12/1/2022 1:21:53 PM,Host Communities,805,1685,673,594,3757,32423,16876,21092,22607,92998
20,South Sudan,2021,SSD-21/HSS10/SA1/CCCM-H-NFI-WASH/UN/19490,12/1/2022 1:21:53 PM,Internally Displaced People,35996,58010,53070,53477,200553,109790,128961,119888,129764,488403
20,South Sudan,2021,SSD-21/HSS10/SA1/CCCM-H-NFI-WASH/UN/19490,12/1/2022 1:21:53 PM,Overall,36801,59695,53743,54071,204310,142213,145837,140980,152371,581401
20,South Sudan,2021,SSD-21/HSS10/SA1/CCCM-NFI/INGO/19466,12/15/2022 8:10:24 AM,Internally Displaced People,7636,8184,9045,9191,34056,7620,8365,9169,9375,34529
20,South Sudan,2021,SSD-21/HSS10/SA1/CCCM-NFI/INGO/19466,12/15/2022 8:10:24 AM,Overall,7636,8184,9045,9191,34056,7620,8365,9169,9375,34529
20,South Sudan,2021,SSD-21/HSS10/SA1/CCCM-NFI-P/INGO/19735,11/30/2022 8:06:56 AM,Host Communities,1217,1218,1218,1218,4871,1012,1135,305,603,3055
20,South Sudan,2021,SSD-21/HSS10/SA1/CCCM-NFI-P/INGO/19735,11/30/2022 8:06:56 AM,Internally Displaced People,8146,8455,9455,9815,35871,8841,9104,12641,11942,42528
20,South Sudan,2021,SSD-21/HSS10/SA1/CCCM-NFI-P/INGO/19735,11/30/2022 8:06:56 AM,Overall,9363,9673,10673,11033,40742,9853,10239,12946,12545,45583
20,South Sudan,2021,SSD-21/HSS10/SA1/CCCM-NFI-P-WASH/INGO/19723,11/18/2022 9:56:35 AM,Host Communities,918,882,918,882,3600,0,0,0,0,0
20,South Sudan,2021,SSD-21/HSS10/SA1/CCCM-NFI-P-WASH/INGO/19723,11/18/2022 9:56:35 AM,Internally Displaced People,11267,11981,11261,11585,46094,37843,42277,35308,37475,152903
20,South Sudan,2021,SSD-21/HSS10/SA1/CCCM-NFI-P-WASH/INGO/19723,11/18/2022 9:56:35 AM,Overall,12185,12863,12179,12467,49694,37843,42277,35308,37475,152903
20,South Sudan,2021,SSD-21/HSS10/SA1/CCCM-P-NFI-WASH/UN/19442,11/21/2022 7:25:26 AM,Host Communities,11667,11990,9136,13112,45905,9672,11784,11754,13740,46950
20,South Sudan,2021,SSD-21/HSS10/SA1/CCCM-P-NFI-WASH/UN/19442,11/21/2022 7:25:26 AM,Internally Displaced People,68405,84669,25482,33360,211916,25768,30895,29324,33576,119563
20,South Sudan,2021,SSD-21/HSS10/SA1/CCCM-P-NFI-WASH/UN/19442,11/21/2022 7:25:26 AM,Overall,84187,101013,38291,51308,274799,38306,46079,44492,51321,180198
20,South Sudan,2021,SSD-21/HSS10/SA1/CCCM-P-NFI-WASH/UN/19442,11/21/2022 7:25:26 AM,Returnees,4115,4354,3673,4836,16978,2866,3400,3414,4005,13685
20,South Sudan,2021,SSD-21/HSS10/SA1/CCS/INGO/19430,10/6/2022 7:47:22 AM,Host Communities,1114875,1176813,1362625,1300687,4955000,1114875,1176813,1362625,1300687,4955000
20,South Sudan,2021,SSD-21/HSS10/SA1/CCS/INGO/19430,10/6/2022 7:47:22 AM,Internally Displaced People,360000,380000,440000,420000,1600000,360000,380000,440000,420000,1600000
20,South Sudan,2021,SSD-21/HSS10/SA1/CCS/INGO/19430,10/6/2022 7:47:22 AM,Overall,1867500,1971251,2282500,2178749,8300000,1867500,1971251,2282500,2178749,8300000
20,South Sudan,2021,SSD-21/HSS10/SA1/CCS/INGO/19430,10/6/2022 7:47:22 AM,Refugees,69750,73625,85250,81375,310000,69750,73625,85250,81375,310000
20,South Sudan,2021,SSD-21/HSS10/SA1/CCS/INGO/19430,10/6/2022 7:47:22 AM,Returnees,322875,340813,394625,376687,1435000,322875,340813,394625,376687,1435000
20,South Sudan,2021,SSD-21/HSS10/SA1/E/INGO/19541,8/17/2022 12:50:13 PM,Internally Displaced People,446,94,7700,6300,14540,574,174,10895,6767,18410
20,South Sudan,2021,SSD-21/HSS10/SA1/E/INGO/19541,8/17/2022 12:50:13 PM,Overall,446,94,7700,6300,14540,574,174,10895,6767,18410
20,South Sudan,2021,SSD-21/HSS10/SA1/E/INGO/19569,3/6/2023 8:42:59 AM,Host Communities,226,93,4134,2918,7371,175,68,4729,3263,8235
20,South Sudan,2021,SSD-21/HSS10/SA1/E/INGO/19569,3/6/2023 8:42:59 AM,Internally Displaced People,59,25,1411,940,2435,59,25,1252,864,2200
20,South Sudan,2021,SSD-21/HSS10/SA1/E/INGO/19569,3/6/2023 8:42:59 AM,Overall,331,143,6955,4798,12227,262,114,6955,4798,12129
20,South Sudan,2021,SSD-21/HSS10/SA1/E/INGO/19569,3/6/2023 8:42:59 AM,Returnees,46,25,1410,940,2421,28,21,974,671,1694
20,South Sudan,2021,SSD-21/HSS10/SA1/E/NGO/19386,8/24/2022 7:39:39 AM,Host Communities,0,0,7505,3549,11054,703,419,3896,2222,7240
20,South Sudan,2021,SSD-21/HSS10/SA1/E/NGO/19386,8/24/2022 7:39:39 AM,Internally Displaced People,0,0,9790,5676,15466,264,187,4809,3791,9051
20,South Sudan,2021,SSD-21/HSS10/SA1/E/NGO/19386,8/24/2022 7:39:39 AM,Overall,0,0,19918,11082,31000,1078,681,10145,6886,18790
20,South Sudan,2021,SSD-21/HSS10/SA1/E/NGO/19386,8/24/2022 7:39:39 AM,Returnees,0,0,2623,1857,4480,111,75,1440,873,2499
20,South Sudan,2021,SSD-21/HSS10/SA1/E/NGO/19602,8/3/2022 10:40:13 AM,Host Communities,0,0,1362,1043,2405,66,30,1761,1243,3100
20,South Sudan,2021,SSD-21/HSS10/SA1/E/NGO/19602,8/3/2022 10:40:13 AM,Internally Displaced People,0,0,524,401,925,0,0,371,457,828
20,South Sudan,2021,SSD-21/HSS10/SA1/E/NGO/19602,8/3/2022 10:40:13 AM,Overall,0,0,2095,1605,3700,66,30,2365,1885,4346
20,South Sudan,2021,SSD-21/HSS10/SA1/E/NGO/19602,8/3/2022 10:40:13 AM,Returnees,0,0,209,161,370,0,0,233,185,418
20,South Sudan,2021,SSD-21/HSS10/SA1/E/NGO/19702,8/11/2022 6:43:04 AM,Host Communities,54,39,1404,1836,3333,78,256,2052,1103,3489
20,South Sudan,2021,SSD-21/HSS10/SA1/E/NGO/19702,8/11/2022 6:43:04 AM,Internally Displaced People,23,14,330,464,831,31,13,472,471,987
20,South Sudan,2021,SSD-21/HSS10/SA1/E/NGO/19702,8/11/2022 6:43:04 AM,Overall,89,61,1812,2412,4374,128,278,2663,1694,4763
20,South Sudan,2021,SSD-21/HSS10/SA1/E/NGO/19702,8/11/2022 6:43:04 AM,Returnees,12,8,78,112,210,19,9,139,120,287
20,South Sudan,2021,SSD-21/HSS10/SA1/E/NGO/19755,11/23/2022 1:15:56 PM,Internally Displaced People,1000,1000,4000,4000,10000,1850,1960,4316,2988,11114
20,South Sudan,2021,SSD-21/HSS10/SA1/E/NGO/19755,11/23/2022 1:15:56 PM,Overall,1000,1000,4000,4000,10000,1850,1960,4316,2988,11114
20,South Sudan,2021,SSD-21/HSS10/SA1/E-FSL-NFI/INGO/19710,9/15/2022 9:55:36 AM,Host Communities,10733,14889,5020,8051,38693,15052,34411,1669,2559,53691
20,South Sudan,2021,SSD-21/HSS10/SA1/E-FSL-NFI/INGO/19710,9/15/2022 9:55:36 AM,Internally Displaced People,2741,4712,2396,3064,12913,6080,10773,1061,1718,19632
20,South Sudan,2021,SSD-21/HSS10/SA1/E-FSL-NFI/INGO/19710,9/15/2022 9:55:36 AM,Overall,14633,21205,9024,12494,57356,26705,57268,2940,4547,91460
20,South Sudan,2021,SSD-21/HSS10/SA1/E-FSL-NFI/INGO/19710,9/15/2022 9:55:36 AM,Returnees,1159,1604,1608,1379,5750,5573,12084,210,270,18137
20,South Sudan,2021,SSD-21/HSS10/SA1/E-NFI-P-WASH-N/INGO/19403,11/2/2022 11:51:00 AM,Host Communities,13026,21066,17167,18053,69312,19018,24960,22546,25101,91625
20,South Sudan,2021,SSD-21/HSS10/SA1/E-NFI-P-WASH-N/INGO/19403,11/2/2022 11:51:00 AM,Internally Displaced People,8684,14044,11445,12035,46208,8704,15680,10899,13560,48843
20,South Sudan,2021,SSD-21/HSS10/SA1/E-NFI-P-WASH-N/INGO/19403,11/2/2022 11:51:00 AM,Overall,21710,35110,28612,30088,115520,27722,40640,33445,38661,140468
20,South Sudan,2021,SSD-21/HSS10/SA1/E-P/INGO/19405,11/15/2022 12:42:30 PM,Host Communities,290,290,610,560,1750,314,281,703,573,1871
20,South Sudan,2021,SSD-21/HSS10/SA1/E-P/INGO/19405,11/15/2022 12:42:30 PM,Internally Displaced People,2610,2610,5490,5040,15750,2700,2803,5555,6011,17069
20,South Sudan,2021,SSD-21/HSS10/SA1/E-P/INGO/19405,11/15/2022 12:42:30 PM,Overall,2900,2900,6100,5600,17500,3014,3084,6258,6584,18940
20,South Sudan,2021,SSD-21/HSS10/SA1/E-P/INGO/19598,11/21/2022 10:08:49 AM,Internally Displaced People,6374,6376,7100,5400,25250,4609,6465,7905,8249,27228
20,South Sudan,2021,SSD-21/HSS10/SA1/E-P/INGO/19598,11/21/2022 10:08:49 AM,Overall,6374,6376,7100,5400,25250,4609,6465,7905,8249,27228
20,South Sudan,2021,SSD-21/HSS10/SA1/FSL/INGO/19669,6/28/2022 2:50:16 PM,Host Communities,11592,12482,27271,25323,76668,11541,12829,27149,26029,77548
20,South Sudan,2021,SSD-21/HSS10/SA1/FSL/INGO/19669,6/28/2022 2:50:16 PM,Internally Displaced People,1647,1773,3875,3598,10893,5962,6573,14027,13336,39898
20,South Sudan,2021,SSD-21/HSS10/SA1/FSL/INGO/19669,6/28/2022 2:50:16 PM,Overall,16570,17842,38981,36197,109590,22777,25081,53582,50885,152325
20,South Sudan,2021,SSD-21/HSS10/SA1/FSL/INGO/19669,6/28/2022 2:50:16 PM,Returnees,3331,3587,7835,7276,22029,5274,5679,12406,11520,34879
20,South Sudan,2021,SSD-21/HSS10/SA1/FSL/NGO/19483,4/11/2022 7:19:02 AM,Host Communities,46968,62628,1116,1122,111834,14484,58212,1518,1884,76098
20,South Sudan,2021,SSD-21/HSS10/SA1/FSL/NGO/19483,4/11/2022 7:19:02 AM,Internally Displaced People,7920,10560,192,192,18864,10950,25338,1104,3114,40506
20,South Sudan,2021,SSD-21/HSS10/SA1/FSL/NGO/19483,4/11/2022 7:19:02 AM,Overall,56586,75450,1350,1356,134742,27396,90462,3174,5136,126168
20,South Sudan,2021,SSD-21/HSS10/SA1/FSL/NGO/19483,4/11/2022 7:19:02 AM,Returnees,1698,2262,42,42,4044,1962,6912,552,138,9564
20,South Sudan,2021,SSD-21/HSS10/SA1/FSL/UN/19736,6/20/2022 8:28:14 AM,Host Communities,24630,47658,10150,13450,95888,26668,69281,11612,12949,120510
20,South Sudan,2021,SSD-21/HSS10/SA1/FSL/UN/19736,6/20/2022 8:28:14 AM,Internally Displaced People,20437,34484,11945,17721,84587,12722,21886,7588,8834,51030
20,South Sudan,2021,SSD-21/HSS10/SA1/FSL/UN/19736,6/20/2022 8:28:14 AM,Overall,50685,91593,25948,35966,204192,41492,93767,21928,25012,182199
20,South Sudan,2021,SSD-21/HSS10/SA1/FSL/UN/19736,6/20/2022 8:28:14 AM,Returnees,5618,9451,3853,4795,23717,2102,2600,2728,3229,10659
20,South Sudan,2021,SSD-21/HSS10/SA1/FSL-H-N/INGO/19621,3/9/2023 10:54:21 AM,Host Communities,11639,23825,13484,12481,61429,10386,15944,12803,10233,49366
20,South Sudan,2021,SSD-21/HSS10/SA1/FSL-H-N/INGO/19621,3/9/2023 10:54:21 AM,Overall,19743,38017,19559,18629,95948,16539,24870,17973,15307,74689
20,South Sudan,2021,SSD-21/HSS10/SA1/FSL-H-N/INGO/19621,3/9/2023 10:54:21 AM,Returnees,8104,14192,6075,6148,34519,6153,8926,5170,5074,25323
20,South Sudan,2021,SSD-21/HSS10/SA1/FSL-P/INGO/19460,9/16/2022 9:56:11 AM,Host Communities,29661,30951,34819,33530,128961,23702,28467,47517,52180,151866
20,South Sudan,2021,SSD-21/HSS10/SA1/FSL-P/INGO/19460,9/16/2022 9:56:11 AM,Internally Displaced People,29661,30951,34819,33530,128961,19701,24314,37684,37925,119624
20,South Sudan,2021,SSD-21/HSS10/SA1/FSL-P/INGO/19460,9/16/2022 9:56:11 AM,Overall,59322,61902,69638,67060,257922,43403,52781,85201,90105,271490
20,South Sudan,2021,SSD-21/HSS10/SA1/H/INGO/19339,12/1/2022 8:37:51 AM,Host Communities,6775,8091,8814,9209,32889,8216,12277,5022,4899,30414
20,South Sudan,2021,SSD-21/HSS10/SA1/H/INGO/19339,12/1/2022 8:37:51 AM,Overall,6775,8091,8814,9209,32889,8216,12277,5022,4899,30414
20,South Sudan,2021,SSD-21/HSS10/SA1/H/INGO/19416,12/15/2022 9:12:47 AM,Host Communities,14533,15126,11891,12376,53926,11684,12117,9521,9953,43275
20,South Sudan,2021,SSD-21/HSS10/SA1/H/INGO/19416,12/15/2022 9:12:47 AM,Internally Displaced People,1515,1577,1240,1290,5622,4128,4280,3363,3517,15288
20,South Sudan,2021,SSD-21/HSS10/SA1/H/INGO/19416,12/15/2022 9:12:47 AM,Overall,16048,16703,13131,13666,59548,15812,16397,12884,13470,58563
20,South Sudan,2021,SSD-21/HSS10/SA1/H/INGO/19581,11/9/2022 7:36:02 AM,Internally Displaced People,31177,30323,38106,35597,135203,59620,57278,18696,18129,153723
20,South Sudan,2021,SSD-21/HSS10/SA1/H/INGO/19581,11/9/2022 7:36:02 AM,Overall,31177,30323,38106,35597,135203,59620,57278,18696,18129,153723
20,South Sudan,2021,SSD-21/HSS10/SA1/H/INGO/19691,11/15/2022 1:47:06 PM,Host Communities,1015,1032,825,926,3798,1409,4101,104,222,5836
20,South Sudan,2021,SSD-21/HSS10/SA1/H/INGO/19691,11/15/2022 1:47:06 PM,Internally Displaced People,1978,2151,2237,2237,8603,2736,7961,203,430,11330
20,South Sudan,2021,SSD-21/HSS10/SA1/H/INGO/19691,11/15/2022 1:47:06 PM,Overall,2993,3183,3062,3163,12401,4145,12062,307,652,17166
20,South Sudan,2021,SSD-21/HSS10/SA1/H/NGO/19389,11/21/2022 10:03:58 AM,Host Communities,1752,2229,1274,2707,7962,2288,3080,1496,1936,8800
20,South Sudan,2021,SSD-21/HSS10/SA1/H/NGO/19389,11/21/2022 10:03:58 AM,Internally Displaced People,4378,5573,3184,6767,19902,5721,7701,3741,4841,22004
20,South Sudan,2021,SSD-21/HSS10/SA1/H/NGO/19389,11/21/2022 10:03:58 AM,Overall,8758,11146,6369,13535,39808,11441,15401,7481,9681,44004
20,South Sudan,2021,SSD-21/HSS10/SA1/H/NGO/19389,11/21/2022 10:03:58 AM,Returnees,2628,3344,1911,4061,11944,3432,4620,2244,2904,13200
20,South Sudan,2021,SSD-21/HSS10/SA1/H/NGO/19450,10/25/2022 1:59:29 PM,Host Communities,5769,6141,3164,3536,18610,3421,5108,4312,6501,19342
20,South Sudan,2021,SSD-21/HSS10/SA1/H/NGO/19450,10/25/2022 1:59:29 PM,Internally Displaced People,8653,9212,4745,5303,27913,4957,6985,4733,7506,24181
20,South Sudan,2021,SSD-21/HSS10/SA1/H/NGO/19450,10/25/2022 1:59:29 PM,Overall,14422,15353,7909,8839,46523,8378,12093,9045,14007,43523
20,South Sudan,2021,SSD-21/HSS10/SA1/H/UN/19573,12/1/2022 9:49:40 AM,Host Communities,20643,25900,12301,15304,74148,16328,21563,17292,20642,75825
20,South Sudan,2021,SSD-21/HSS10/SA1/H/UN/19573,12/1/2022 9:49:40 AM,Internally Displaced People,1609,2019,958,1192,5778,3578,4810,3790,4525,16703
20,South Sudan,2021,SSD-21/HSS10/SA1/H/UN/19573,12/1/2022 9:49:40 AM,Overall,26809,33637,15975,19874,96295,21176,28114,22429,26775,98494
20,South Sudan,2021,SSD-21/HSS10/SA1/H/UN/19573,12/1/2022 9:49:40 AM,Returnees,4557,5718,2716,3378,16369,1270,1741,1347,1608,5966
20,South Sudan,2021,SSD-21/HSS10/SA1/H/UN/19674,2/8/2023 9:58:19 AM,Internally Displaced People,15408,12106,14223,11175,52912,9972,19207,11262,14449,54890
20,South Sudan,2021,SSD-21/HSS10/SA1/H/UN/19674,2/8/2023 9:58:19 AM,Overall,15408,12106,14223,11175,52912,9972,19207,11262,14449,54890
20,South Sudan,2021,SSD-21/HSS10/SA1/H-N/INGO/19302,12/2/2022 1:33:18 PM,Host Communities,224,427,848,951,2450,55,274,44,57,430
20,South Sudan,2021,SSD-21/HSS10/SA1/H-N/INGO/19302,12/2/2022 1:33:18 PM,Internally Displaced People,2019,5604,9654,10661,27938,4303,14734,4871,5311,29219
20,South Sudan,2021,SSD-21/HSS10/SA1/H-N/INGO/19302,12/2/2022 1:33:18 PM,Overall,2243,6031,10502,11612,30388,4358,15008,4915,5368,29649
20,South Sudan,2021,SSD-21/HSS10/SA1/H-N/INGO/19500,12/13/2022 2:15:45 PM,Internally Displaced People,9182,9187,13781,13786,45936,15854,30509,26871,31971,105205
20,South Sudan,2021,SSD-21/HSS10/SA1/H-N/INGO/19500,12/13/2022 2:15:45 PM,Overall,9182,9187,13781,13786,45936,15854,30509,26871,31971,105205
20,South Sudan,2021,SSD-21/HSS10/SA1/H-P/INGO/19451,12/2/2022 7:30:19 AM,Internally Displaced People,8418,12870,9019,11137,41444,12498,21365,8464,13905,56232
20,South Sudan,2021,SSD-21/HSS10/SA1/H-P/INGO/19451,12/2/2022 7:30:19 AM,Overall,8498,12930,9039,11157,41624,12806,21692,8809,14206,57513
20,South Sudan,2021,SSD-21/HSS10/SA1/H-P/INGO/19451,12/2/2022 7:30:19 AM,Returnees,80,60,20,20,180,308,327,345,301,1281
20,South Sudan,2021,SSD-21/HSS10/SA1/H-P/INGO/19454,12/2/2022 1:39:15 PM,Host Communities,9894,10720,14843,16080,51537,9151,18607,9765,7860,45383
20,South Sudan,2021,SSD-21/HSS10/SA1/H-P/INGO/19454,12/2/2022 1:39:15 PM,Internally Displaced People,2523,2733,3784,4099,13139,3876,2876,2100,3986,12838
20,South Sudan,2021,SSD-21/HSS10/SA1/H-P/INGO/19454,12/2/2022 1:39:15 PM,Overall,12613,13665,18921,20497,65696,13096,21570,11974,11984,58624
20,South Sudan,2021,SSD-21/HSS10/SA1/H-P/INGO/19454,12/2/2022 1:39:15 PM,Returnees,196,212,294,318,1020,69,87,109,138,403
20,South Sudan,2021,SSD-21/HSS10/SA1/H-P-E-N/INGO/19425,11/23/2022 12:37:32 PM,Host Communities,4282,7104,9228,8844,29458,6483,15104,10605,10859,43051
20,South Sudan,2021,SSD-21/HSS10/SA1/H-P-E-N/INGO/19425,11/23/2022 12:37:32 PM,Internally Displaced People,400,479,616,610,2105,1317,2109,1281,1053,5760
20,South Sudan,2021,SSD-21/HSS10/SA1/H-P-E-N/INGO/19425,11/23/2022 12:37:32 PM,Overall,10006,14150,17063,16594,57813,10994,21031,15887,16120,64032
20,South Sudan,2021,SSD-21/HSS10/SA1/H-P-E-N/INGO/19425,11/23/2022 12:37:32 PM,Returnees,5324,6567,7219,7140,26250,3194,3818,4001,4208,15221
20,South Sudan,2021,SSD-21/HSS10/SA1/H-P-NFI/NGO/19666,11/24/2022 1:09:49 PM,Host Communities,2940,5740,1960,3360,14000,3965,6000,2800,3000,15765
20,South Sudan,2021,SSD-21/HSS10/SA1/H-P-NFI/NGO/19666,11/24/2022 1:09:49 PM,Internally Displaced People,1092,2132,728,1248,5200,2970,4000,887,1000,8857
20,South Sudan,2021,SSD-21/HSS10/SA1/H-P-NFI/NGO/19666,11/24/2022 1:09:49 PM,Overall,4200,8200,2800,4800,20000,7256,10815,3887,4352,26310
20,South Sudan,2021,SSD-21/HSS10/SA1/H-P-NFI/NGO/19666,11/24/2022 1:09:49 PM,Returnees,168,328,112,192,800,321,815,200,352,1688
20,South Sudan,2021,SSD-21/HSS10/SA1/L/UN/19644,12/6/2022 12:55:47 PM,Host Communities,105267,105268,26064,26065,262664,105267,105268,26064,26065,262664
20,South Sudan,2021,SSD-21/HSS10/SA1/L/UN/19644,12/6/2022 12:55:47 PM,Overall,105267,105268,26064,26065,262664,105267,105268,26064,26065,262664
20,South Sudan,2021,SSD-21/HSS10/SA1/L-CCS/UN/19444,10/11/2022 10:38:00 AM,Other,300,0,0,0,300,305,0,0,0,305
20,South Sudan,2021,SSD-21/HSS10/SA1/L-CCS/UN/19444,10/11/2022 10:38:00 AM,Overall,300,0,0,0,300,305,0,0,0,305
20,South Sudan,2021,SSD-21/HSS10/SA1/N/INGO/19575,8/11/2022 10:14:53 AM,Host Communities,0,2098,1938,2017,6053,434,1745,1575,1763,5517
20,South Sudan,2021,SSD-21/HSS10/SA1/N/INGO/19575,8/11/2022 10:14:53 AM,Internally Displaced People,0,1010,918,956,2884,77,749,676,756,2258
20,South Sudan,2021,SSD-21/HSS10/SA1/N/INGO/19575,8/11/2022 10:14:53 AM,Overall,0,3108,2856,2973,8937,511,2494,2251,2519,7775
20,South Sudan,2021,SSD-21/HSS10/SA1/N/INGO/19722,9/29/2022 12:45:10 PM,Host Communities,627,627,836,836,2926,1490,2584,1383,1331,6788
20,South Sudan,2021,SSD-21/HSS10/SA1/N/INGO/19722,9/29/2022 12:45:10 PM,Internally Displaced People,418,418,627,627,2090,440,878,382,402,2102
20,South Sudan,2021,SSD-21/HSS10/SA1/N/INGO/19722,9/29/2022 12:45:10 PM,Overall,1254,1254,1675,1677,5860,2162,3914,2072,2053,10201
20,South Sudan,2021,SSD-21/HSS10/SA1/N/INGO/19722,9/29/2022 12:45:10 PM,Returnees,209,209,212,214,844,232,452,307,320,1311
20,South Sudan,2021,SSD-21/HSS10/SA1/NFI-P/NGO/19653,12/1/2022 1:29:04 PM,Host Communities,413,1650,1030,1032,4125,1174,2738,1754,1755,7421
20,South Sudan,2021,SSD-21/HSS10/SA1/NFI-P/NGO/19653,12/1/2022 1:29:04 PM,Internally Displaced People,1650,6601,4126,4126,16503,4050,12282,7759,7758,31849
20,South Sudan,2021,SSD-21/HSS10/SA1/NFI-P/NGO/19653,12/1/2022 1:29:04 PM,Overall,2750,11002,6874,6879,27505,6750,20470,12933,12933,53086
20,South Sudan,2021,SSD-21/HSS10/SA1/NFI-P/NGO/19653,12/1/2022 1:29:04 PM,Returnees,687,2751,1718,1721,6877,1526,5450,3420,3420,13816
20,South Sudan,2021,SSD-21/HSS10/SA1/NFI-P-WASH/INGO/19286,11/17/2022 1:50:08 PM,Host Communities,2440,2728,4594,4594,14356,6307,6716,6927,7712,27662
20,South Sudan,2021,SSD-21/HSS10/SA1/NFI-P-WASH/INGO/19286,11/17/2022 1:50:08 PM,Internally Displaced People,5124,5725,9645,9645,30139,13245,14102,14546,16193,58086
20,South Sudan,2021,SSD-21/HSS10/SA1/NFI-P-WASH/INGO/19286,11/17/2022 1:50:08 PM,Overall,8139,9090,15311,15311,47851,21024,22384,23090,25705,92203
20,South Sudan,2021,SSD-21/HSS10/SA1/NFI-P-WASH/INGO/19286,11/17/2022 1:50:08 PM,Returnees,575,637,1072,1072,3356,1472,1566,1617,1800,6455
20,South Sudan,2021,SSD-21/HSS10/SA1/NFI-WASH/INGO/19289,11/14/2022 1:44:15 PM,Host Communities,306,342,576,576,1800,1579,1164,3159,3356,9258
20,South Sudan,2021,SSD-21/HSS10/SA1/NFI-WASH/INGO/19289,11/14/2022 1:44:15 PM,Internally Displaced People,2754,3078,5184,5184,16200,4717,5919,9433,10023,30092
20,South Sudan,2021,SSD-21/HSS10/SA1/NFI-WASH/INGO/19289,11/14/2022 1:44:15 PM,Overall,3060,3420,5760,5760,18000,6296,7083,12592,13379,39350
20,South Sudan,2021,SSD-21/HSS10/SA1/NFI-WASH/INGO/19564,2/14/2023 2:28:42 PM,Internally Displaced People,12198,14154,15014,15120,56486,11432,13265,14071,14171,52939
20,South Sudan,2021,SSD-21/HSS10/SA1/NFI-WASH/INGO/19564,2/14/2023 2:28:42 PM,Overall,12198,14154,15014,15120,56486,11432,13265,14071,14171,52939
20,South Sudan,2021,SSD-21/HSS10/SA1/N-FSL/INGO/19372,11/4/2022 9:51:44 AM,Host Communities,8588,12305,12558,18925,52376,15105,17756,13603,15960,62424
20,South Sudan,2021,SSD-21/HSS10/SA1/N-FSL/INGO/19372,11/4/2022 9:51:44 AM,Internally Displaced People,1324,1898,1937,2918,8077,8354,8841,2518,3875,23588
20,South Sudan,2021,SSD-21/HSS10/SA1/N-FSL/INGO/19372,11/4/2022 9:51:44 AM,Overall,13652,19561,19963,30084,83260,25191,28440,18449,21357,93437
20,South Sudan,2021,SSD-21/HSS10/SA1/N-FSL/INGO/19372,11/4/2022 9:51:44 AM,Returnees,3740,5358,5468,8241,22807,1732,1843,2328,1522,7425
20,South Sudan,2021,SSD-21/HSS10/SA1/N-P/INGO/19689,11/3/2022 8:36:00 AM,Host Communities,332,16884,3051,3081,23348,2688,11447,7677,10150,31962
20,South Sudan,2021,SSD-21/HSS10/SA1/N-P/INGO/19689,11/3/2022 8:36:00 AM,Internally Displaced People,72,10775,1682,1754,14283,896,8164,1919,2537,13516
20,South Sudan,2021,SSD-21/HSS10/SA1/N-P/INGO/19689,11/3/2022 8:36:00 AM,Overall,404,27659,4733,4835,37631,3584,19611,9596,12687,45478
20,South Sudan,2021,SSD-21/HSS10/SA1/N-WASH-P/INGO/19489,11/24/2022 8:36:54 AM,Host Communities,5867,8721,476,793,15857,2564,3351,5248,5374,16537
20,South Sudan,2021,SSD-21/HSS10/SA1/N-WASH-P/INGO/19489,11/24/2022 8:36:54 AM,Internally Displaced People,3733,5550,303,504,10090,1631,2132,3341,3416,10520
20,South Sudan,2021,SSD-21/HSS10/SA1/N-WASH-P/INGO/19489,11/24/2022 8:36:54 AM,Overall,10667,15857,865,1441,28830,4661,6092,9537,9766,30056
20,South Sudan,2021,SSD-21/HSS10/SA1/N-WASH-P/INGO/19489,11/24/2022 8:36:54 AM,Returnees,1067,1586,86,144,2883,466,609,948,976,2999
20,South Sudan,2021,SSD-21/HSS10/SA1/P/INGO/19320,9/19/2022 6:51:43 AM,Host Communities,200,1000,60,400,1660,277,3424,114,522,4337
20,South Sudan,2021,SSD-21/HSS10/SA1/P/INGO/19320,9/19/2022 6:51:43 AM,Internally Displaced People,600,1850,250,1050,3750,469,983,461,765,2678
20,South Sudan,2021,SSD-21/HSS10/SA1/P/INGO/19320,9/19/2022 6:51:43 AM,Overall,1000,4050,400,2050,7500,746,4407,575,1287,7015
20,South Sudan,2021,SSD-21/HSS10/SA1/P/INGO/19320,9/19/2022 6:51:43 AM,Returnees,200,1200,90,600,2090,0,0,0,0,0
20,South Sudan,2021,SSD-21/HSS10/SA1/P/INGO/19455,11/3/2022 8:10:15 AM,Host Communities,912,2007,1277,1277,5473,1047,2698,864,1490,6099
20,South Sudan,2021,SSD-21/HSS10/SA1/P/INGO/19455,11/3/2022 8:10:15 AM,Internally Displaced People,250,550,350,350,1500,260,605,302,368,1535
20,South Sudan,2021,SSD-21/HSS10/SA1/P/INGO/19455,11/3/2022 8:10:15 AM,Overall,1250,2750,1750,1750,7500,1413,3635,1350,2066,8464
20,South Sudan,2021,SSD-21/HSS10/SA1/P/INGO/19455,11/3/2022 8:10:15 AM,Returnees,88,193,123,123,527,106,332,184,208,830
20,South Sudan,2021,SSD-21/HSS10/SA1/P/INGO/19458,11/25/2022 7:32:35 AM,Internally Displaced People,480,576,720,624,2400,1614,2123,2836,2564,9137
20,South Sudan,2021,SSD-21/HSS10/SA1/P/INGO/19458,11/25/2022 7:32:35 AM,Overall,480,576,720,624,2400,1614,2123,2836,2564,9137
20,South Sudan,2021,SSD-21/HSS10/SA1/P/INGO/19583,11/25/2022 8:19:21 AM,Host Communities,1471,1934,537,958,4900,2336,2164,1377,1131,7008
20,South Sudan,2021,SSD-21/HSS10/SA1/P/INGO/19583,11/25/2022 8:19:21 AM,Internally Displaced People,276,363,100,179,918,477,406,204,153,1240
20,South Sudan,2021,SSD-21/HSS10/SA1/P/INGO/19583,11/25/2022 8:19:21 AM,Overall,1839,2418,671,1197,6125,2860,2594,1585,1291,8330
20,South Sudan,2021,SSD-21/HSS10/SA1/P/INGO/19583,11/25/2022 8:19:21 AM,Returnees,92,121,34,60,307,47,24,4,7,82
20,South Sudan,2021,SSD-21/HSS10/SA1/P/INGO/19763,11/14/2022 12:56:38 PM,Host Communities,2000,2070,900,780,5750,5344,6001,2836,2135,16316
20,South Sudan,2021,SSD-21/HSS10/SA1/P/INGO/19763,11/14/2022 12:56:38 PM,Internally Displaced People,4142,4468,1320,1224,11154,8029,14439,5838,9138,37444
20,South Sudan,2021,SSD-21/HSS10/SA1/P/INGO/19763,11/14/2022 12:56:38 PM,Overall,8922,9309,3220,3004,24455,19801,29575,10737,13092,73205
20,South Sudan,2021,SSD-21/HSS10/SA1/P/INGO/19763,11/14/2022 12:56:38 PM,Returnees,2780,2771,1000,1000,7551,6428,9135,2063,1819,19445
20,South Sudan,2021,SSD-21/HSS10/SA1/P/NGO/19283,10/4/2022 7:54:23 AM,Host Communities,1000,1298,284,560,3142,1102,2051,610,822,4585
20,South Sudan,2021,SSD-21/HSS10/SA1/P/NGO/19283,10/4/2022 7:54:23 AM,Internally Displaced People,1700,1458,820,1200,5178,1700,1672,756,1231,5359
20,South Sudan,2021,SSD-21/HSS10/SA1/P/NGO/19283,10/4/2022 7:54:23 AM,Overall,3700,3756,1904,2640,12000,4364,5675,2064,2796,14899
20,South Sudan,2021,SSD-21/HSS10/SA1/P/NGO/19283,10/4/2022 7:54:23 AM,Returnees,1000,1000,800,880,3680,1562,1952,698,743,4955
20,South Sudan,2021,SSD-21/HSS10/SA1/P/NGO/19328,11/9/2022 9:55:23 AM,Internally Displaced People,333,1000,666,835,2834,210,298,1331,1456,3295
20,South Sudan,2021,SSD-21/HSS10/SA1/P/NGO/19328,11/9/2022 9:55:23 AM,Other,667,2000,1334,1665,5666,284,598,2666,2912,6460
20,South Sudan,2021,SSD-21/HSS10/SA1/P/NGO/19328,11/9/2022 9:55:23 AM,Overall,1000,3000,2000,2500,8500,494,896,3997,4368,9755
20,South Sudan,2021,SSD-21/HSS10/SA1/P/NGO/19576,11/21/2022 10:24:26 AM,Host Communities,800,1450,300,400,2950,800,1450,300,400,2950
20,South Sudan,2021,SSD-21/HSS10/SA1/P/NGO/19576,11/21/2022 10:24:26 AM,Internally Displaced People,1460,2000,1000,1500,5960,1460,2000,1200,1500,6160
20,South Sudan,2021,SSD-21/HSS10/SA1/P/NGO/19576,11/21/2022 10:24:26 AM,Overall,2360,3550,1370,1970,9250,2360,3550,1570,1970,9450
20,South Sudan,2021,SSD-21/HSS10/SA1/P/NGO/19576,11/21/2022 10:24:26 AM,Refugees,50,50,20,20,140,50,50,20,20,140
20,South Sudan,2021,SSD-21/HSS10/SA1/P/NGO/19576,11/21/2022 10:24:26 AM,Returnees,50,50,50,50,200,50,50,50,50,200
20,South Sudan,2021,SSD-21/HSS10/SA1/P/NGO/19676,11/21/2022 11:32:48 AM,Internally Displaced People,392,688,90,330,1500,821,958,94,345,2218
20,South Sudan,2021,SSD-21/HSS10/SA1/P/NGO/19676,11/21/2022 11:32:48 AM,Overall,392,688,90,330,1500,821,958,94,345,2218
20,South Sudan,2021,SSD-21/HSS10/SA1/P-CCCM/UN/19728,12/15/2022 7:17:23 AM,Internally Displaced People,15495,20474,16426,19492,71887,26600,33592,33953,36168,130313
20,South Sudan,2021,SSD-21/HSS10/SA1/P-CCCM/UN/19728,12/15/2022 7:17:23 AM,Overall,15495,20474,16426,19492,71887,26600,33592,33953,36168,130313
20,South Sudan,2021,SSD-21/HSS10/SA1/P-FSL/NGO/19526,11/17/2022 2:03:19 PM,Host Communities,2454,2454,3908,3908,12724,1300,1500,1850,1708,6358
20,South Sudan,2021,SSD-21/HSS10/SA1/P-FSL/NGO/19526,11/17/2022 2:03:19 PM,Internally Displaced People,6000,8000,3000,3000,20000,8771,10478,5345,6538,31132
20,South Sudan,2021,SSD-21/HSS10/SA1/P-FSL/NGO/19526,11/17/2022 2:03:19 PM,Overall,8454,10454,6908,6908,32724,10071,11978,7195,8246,37490
20,South Sudan,2021,SSD-21/HSS10/SA1/P-FSL/NGO/19753,11/21/2022 9:59:02 AM,Host Communities,6500,8109,4121,4780,23510,6709,7851,6975,4946,26481
20,South Sudan,2021,SSD-21/HSS10/SA1/P-FSL/NGO/19753,11/21/2022 9:59:02 AM,Internally Displaced People,1872,2027,5037,5842,14778,301,807,4720,3780,9608
20,South Sudan,2021,SSD-21/HSS10/SA1/P-FSL/NGO/19753,11/21/2022 9:59:02 AM,Overall,8372,10136,9158,10622,38288,7010,8658,11695,8726,36089
20,South Sudan,2021,SSD-21/HSS10/SA1/WASH/INGO/19464,8/19/2022 9:24:30 AM,Internally Displaced People,531,554,624,601,2310,531,539,808,815,2693
20,South Sudan,2021,SSD-21/HSS10/SA1/WASH/INGO/19464,8/19/2022 9:24:30 AM,Overall,531,554,624,601,2310,531,539,808,815,2693
20,South Sudan,2021,SSD-21/HSS10/SA1/WASH/INGO/19507,11/29/2022 8:58:26 AM,Host Communities,5579,6324,5761,7036,24700,6766,7891,7043,8965,30665
20,South Sudan,2021,SSD-21/HSS10/SA1/WASH/INGO/19507,11/29/2022 8:58:26 AM,Internally Displaced People,2179,2544,2268,2889,9880,3383,3946,3521,4481,15331
20,South Sudan,2021,SSD-21/HSS10/SA1/WASH/INGO/19507,11/29/2022 8:58:26 AM,Overall,8513,9748,8814,10925,38000,11277,13152,11738,14940,51107
20,South Sudan,2021,SSD-21/HSS10/SA1/WASH/INGO/19507,11/29/2022 8:58:26 AM,Returnees,755,880,785,1000,3420,1128,1315,1174,1494,5111
20,South Sudan,2021,SSD-21/HSS10/SA1/WASH/INGO/19709,2/14/2023 2:22:07 PM,Host Communities,801,836,941,906,3484,2677,2952,2844,3003,11476
20,South Sudan,2021,SSD-21/HSS10/SA1/WASH/INGO/19709,2/14/2023 2:22:07 PM,Internally Displaced People,20625,22200,23863,23994,90682,21131,23104,27086,29142,100463
20,South Sudan,2021,SSD-21/HSS10/SA1/WASH/INGO/19709,2/14/2023 2:22:07 PM,Overall,21426,23036,24804,24900,94166,23808,26056,29930,32145,111939
20,South Sudan,2021,SSD-21/HSS10/SA1/WASH/NGO/19420,9/21/2022 2:34:28 PM,Host Communities,1000,1500,1000,1200,4700,1235,1730,1480,1588,6033
20,South Sudan,2021,SSD-21/HSS10/SA1/WASH/NGO/19420,9/21/2022 2:34:28 PM,Internally Displaced People,5800,6600,7150,7950,27500,5750,7200,6930,8120,28000
20,South Sudan,2021,SSD-21/HSS10/SA1/WASH/NGO/19420,9/21/2022 2:34:28 PM,Overall,7500,9000,8750,9750,35000,7748,9929,9122,10440,37239
20,South Sudan,2021,SSD-21/HSS10/SA1/WASH/NGO/19420,9/21/2022 2:34:28 PM,Returnees,700,900,600,600,2800,763,999,712,732,3206
20,South Sudan,2021,SSD-21/HSS10/SA1/WASH/NGO/19471,10/27/2022 9:44:48 AM,Host Communities,1350,1350,1810,1990,6500,978,1024,1242,1439,4683
20,South Sudan,2021,SSD-21/HSS10/SA1/WASH/NGO/19471,10/27/2022 9:44:48 AM,Internally Displaced People,2620,2620,1962,2178,9380,1173,1229,1490,1726,5618
20,South Sudan,2021,SSD-21/HSS10/SA1/WASH/NGO/19471,10/27/2022 9:44:48 AM,Overall,4000,4000,3800,4200,16000,2173,2275,2759,3197,10404
20,South Sudan,2021,SSD-21/HSS10/SA1/WASH/NGO/19471,10/27/2022 9:44:48 AM,Returnees,30,30,28,32,120,22,22,27,32,103
20,South Sudan,2021,SSD-21/HSS10/SA1/WASH/NGO/19570,1/19/2023 9:18:49 AM,Host Communities,859,934,1346,1346,4485,2263,1895,2295,2036,8489
20,South Sudan,2021,SSD-21/HSS10/SA1/WASH/NGO/19570,1/19/2023 9:18:49 AM,Internally Displaced People,1320,1355,2450,2450,7575,2243,2894,3114,3356,11607
20,South Sudan,2021,SSD-21/HSS10/SA1/WASH/NGO/19570,1/19/2023 9:18:49 AM,Overall,2641,2825,4767,4767,15000,5568,5733,6467,6493,24261
20,South Sudan,2021,SSD-21/HSS10/SA1/WASH/NGO/19570,1/19/2023 9:18:49 AM,Refugees,120,152,326,326,924,90,65,108,86,349
20,South Sudan,2021,SSD-21/HSS10/SA1/WASH/NGO/19570,1/19/2023 9:18:49 AM,Returnees,342,384,645,645,2016,972,879,950,1015,3816
20,South Sudan,2021,SSD-21/HSS10/SA1/WASH/UN/19465,11/21/2022 8:48:12 AM,Internally Displaced People,6328,6367,9348,8838,30881,6328,6367,9348,8838,30881
20,South Sudan,2021,SSD-21/HSS10/SA1/WASH/UN/19465,11/21/2022 8:48:12 AM,Overall,6328,6367,9348,8838,30881,6328,6367,9348,8838,30881
20,South Sudan,2021,SSD-21/HSS10/SA1/WASH-N-E/INGO/19321,2/8/2023 6:31:06 AM,Host Communities,8550,14310,11437,14604,48901,14219,14977,8390,8217,45803
20,South Sudan,2021,SSD-21/HSS10/SA1/WASH-N-E/INGO/19321,2/8/2023 6:31:06 AM,Internally Displaced People,2458,3594,4379,4403,14834,4629,4845,2549,2894,14917
20,South Sudan,2021,SSD-21/HSS10/SA1/WASH-N-E/INGO/19321,2/8/2023 6:31:06 AM,Overall,15626,25146,21811,26342,88925,26788,28254,15687,16541,87270
20,South Sudan,2021,SSD-21/HSS10/SA1/WASH-N-E/INGO/19321,2/8/2023 6:31:06 AM,Returnees,4618,7242,5995,7335,25190,7940,8432,4748,5430,26550
20,South Sudan,2021,SSD-21/HSS10/SA1/WASH-P/NGO/19418,11/23/2022 9:04:07 AM,Host Communities,2851,6541,2181,5200,16773,3894,5632,3964,4974,18464
20,South Sudan,2021,SSD-21/HSS10/SA1/WASH-P/NGO/19418,11/23/2022 9:04:07 AM,Internally Displaced People,750,1727,1032,1373,4882,511,951,1054,2058,4574
20,South Sudan,2021,SSD-21/HSS10/SA1/WASH-P/NGO/19418,11/23/2022 9:04:07 AM,Overall,3601,8268,3213,6573,21655,4405,6583,5018,7032,23038
20,South Sudan,2022,SSD-22/HSS10/RA1/L/UN/21570,3/6/2023 8:25:28 AM,Other,80,0,0,0,80,68,0,0,0,68
20,South Sudan,2022,SSD-22/HSS10/RA1/L/UN/21570,3/6/2023 8:25:28 AM,Overall,80,0,0,0,80,68,0,0,0,68
20,South Sudan,2022,SSD-22/HSS10/RA2/L/UN/21787,4/5/2023 9:10:27 AM,Host Communities,36015,32883,45824,42278,157000,36010,32880,45830,42280,157000
20,South Sudan,2022,SSD-22/HSS10/RA2/L/UN/21787,4/5/2023 9:10:27 AM,Internally Displaced People,14452,13195,18388,16965,63000,14450,13200,18300,17050,63000
20,South Sudan,2022,SSD-22/HSS10/RA2/L/UN/21787,4/5/2023 9:10:27 AM,Overall,50467,46078,64212,59243,220000,50460,46080,64130,59330,220000
20,South Sudan,2022,SSD-22/HSS10/RA2/L/UN/21788,11/23/2022 8:19:30 AM,Host Communities,14452,13195,18388,16965,63000,24168,25517,27672,30456,107813
20,South Sudan,2022,SSD-22/HSS10/RA2/L/UN/21788,11/23/2022 8:19:30 AM,Internally Displaced People,36015,32883,45824,42278,157000,32491,32961,50935,46312,162699
20,South Sudan,2022,SSD-22/HSS10/RA2/L/UN/21788,11/23/2022 8:19:30 AM,Overall,50467,46078,64212,59243,220000,56659,58478,78607,76768,270512
20,South Sudan,2022,SSD-22/HSS10/RA4/H/INGO/22749,3/6/2023 8:16:38 AM,Host Communities,22794,24279,7879,9622,64574,10453,11349,3584,4480,29866
20,South Sudan,2022,SSD-22/HSS10/RA4/H/INGO/22749,3/6/2023 8:16:38 AM,Internally Displaced People,8918,9211,2834,3378,24341,4276,3993,1350,1688,11307
20,South Sudan,2022,SSD-22/HSS10/RA4/H/INGO/22749,3/6/2023 8:16:38 AM,Overall,31712,33490,10713,13000,88915,14729,15342,4934,6168,41173
20,South Sudan,2022,SSD-22/HSS10/RA5/CCCM-CCS/UN/23922,7/13/2023 1:10:05 PM,Internally Displaced People,8827,12221,12664,12288,46000,9229,12444,11515,11344,44532
20,South Sudan,2022,SSD-22/HSS10/RA5/CCCM-CCS/UN/23922,7/13/2023 1:10:05 PM,Overall,8827,12221,12664,12288,46000,9229,12444,11515,11344,44532
20,South Sudan,2022,SSD-22/HSS10/RA5/E/INGO/23899,10/13/2023 7:36:31 AM,Internally Displaced People,104,40,4002,3689,7835,94,23,1437,1413,2967
20,South Sudan,2022,SSD-22/HSS10/RA5/E/INGO/23899,10/13/2023 7:36:31 AM,Overall,104,40,4002,3689,7835,94,23,1437,1413,2967
20,South Sudan,2022,SSD-22/HSS10/RA5/FSL/INGO/23896,9/4/2023 8:21:56 AM,Internally Displaced People,3425,3708,4035,3832,15000,3427,3710,4038,3835,15010
20,South Sudan,2022,SSD-22/HSS10/RA5/FSL/INGO/23896,9/4/2023 8:21:56 AM,Overall,3425,3708,4035,3832,15000,3427,3710,4038,3835,15010
20,South Sudan,2022,SSD-22/HSS10/RA5/FSL/UN/23890,7/13/2023 1:29:00 PM,Host Communities,8742,9164,5881,4655,28442,8742,9164,5881,4655,28442
20,South Sudan,2022,SSD-22/HSS10/RA5/FSL/UN/23890,7/13/2023 1:29:00 PM,Internally Displaced People,7913,8312,5197,4136,25558,7913,8312,5197,4136,25558
20,South Sudan,2022,SSD-22/HSS10/RA5/FSL/UN/23890,7/13/2023 1:29:00 PM,Overall,16655,17476,11078,8791,54000,16655,17476,11078,8791,54000
20,South Sudan,2022,SSD-22/HSS10/RA5/H/NGO/23900,8/1/2023 9:32:36 AM,Host Communities,564,939,1014,1239,3756,740,1233,1332,1233,4538
20,South Sudan,2022,SSD-22/HSS10/RA5/H/NGO/23900,8/1/2023 9:32:36 AM,Internally Displaced People,939,1565,1690,2066,6260,996,1586,1712,2093,6387
20,South Sudan,2022,SSD-22/HSS10/RA5/H/NGO/23900,8/1/2023 9:32:36 AM,Other,67,83,62,38,250,170,193,103,166,632
20,South Sudan,2022,SSD-22/HSS10/RA5/H/NGO/23900,8/1/2023 9:32:36 AM,Overall,1908,3151,3374,4087,12520,2287,3646,3832,4329,14094
20,South Sudan,2022,SSD-22/HSS10/RA5/H/NGO/23900,8/1/2023 9:32:36 AM,Returnees,338,564,608,744,2254,381,634,685,837,2537
20,South Sudan,2022,SSD-22/HSS10/RA5/H/UN/23889,7/13/2023 1:26:15 PM,Host Communities,13406,12797,17668,17059,60930,13742,13142,17845,17238,61967
20,South Sudan,2022,SSD-22/HSS10/RA5/H/UN/23889,7/13/2023 1:26:15 PM,Internally Displaced People,7871,7511,10378,10024,35784,8216,7854,10625,10376,37071
20,South Sudan,2022,SSD-22/HSS10/RA5/H/UN/23889,7/13/2023 1:26:15 PM,Overall,21277,20308,28046,27083,96714,21958,20996,28470,27614,99038
20,South Sudan,2022,SSD-22/HSS10/RA5/NFI/UN/23923,7/24/2023 2:48:50 PM,Internally Displaced People,2629,2669,3022,3068,11388,2783,3309,2825,2987,11904
20,South Sudan,2022,SSD-22/HSS10/RA5/NFI/UN/23923,7/24/2023 2:48:50 PM,Overall,2629,2669,3022,3068,11388,2783,3309,2825,2987,11904
20,South Sudan,2022,SSD-22/HSS10/RA5/NFI-WASH/UN/23887,7/7/2023 2:05:44 PM,Internally Displaced People,9280,9422,10669,10829,40200,10044,10482,11130,12020,43676
20,South Sudan,2022,SSD-22/HSS10/RA5/NFI-WASH/UN/23887,7/7/2023 2:05:44 PM,Overall,9280,9422,10669,10829,40200,10044,10482,11130,12020,43676
20,South Sudan,2022,SSD-22/HSS10/RA5/N-FSL/UN/23888,7/5/2023 9:44:10 AM,Internally Displaced People,3375,5175,6525,7425,22500,3375,5175,6525,7425,22500
20,South Sudan,2022,SSD-22/HSS10/RA5/N-FSL/UN/23888,7/5/2023 9:44:10 AM,Overall,3375,5175,6525,7425,22500,3375,5175,6525,7425,22500
20,South Sudan,2022,SSD-22/HSS10/RA5/P/INGO/23893,7/15/2023 2:17:47 PM,Internally Displaced People,1000,1143,2500,2500,7143,940,2553,1932,2003,7428
20,South Sudan,2022,SSD-22/HSS10/RA5/P/INGO/23893,7/15/2023 2:17:47 PM,Overall,1000,1143,2500,2500,7143,940,2553,1932,2003,7428
20,South Sudan,2022,SSD-22/HSS10/RA5/P/INGO/23901,8/10/2023 7:43:49 AM,Host Communities,0,150,0,50,200,0,191,0,121,312
20,South Sudan,2022,SSD-22/HSS10/RA5/P/INGO/23901,8/10/2023 7:43:49 AM,Internally Displaced People,0,500,0,200,700,0,724,0,268,992
20,South Sudan,2022,SSD-22/HSS10/RA5/P/INGO/23901,8/10/2023 7:43:49 AM,Overall,0,650,0,250,900,0,915,0,389,1304
20,South Sudan,2022,SSD-22/HSS10/RA5/P/INGO/23919,8/28/2023 9:43:05 AM,Internally Displaced People,5376,7308,1848,2268,16800,3873,10479,3696,4997,23045
20,South Sudan,2022,SSD-22/HSS10/RA5/P/INGO/23919,8/28/2023 9:43:05 AM,Overall,5376,7308,1848,2268,16800,3873,10479,3696,4997,23045
20,South Sudan,2022,SSD-22/HSS10/RA5/WASH/INGO/23897,10/10/2023 12:47:17 PM,Host Communities,1100,1150,1223,1179,4652,60,158,150,162,530
20,South Sudan,2022,SSD-22/HSS10/RA5/WASH/INGO/23897,10/10/2023 12:47:17 PM,Internally Displaced People,2860,2990,3917,3781,13548,2746,6636,6139,6669,22190
20,South Sudan,2022,SSD-22/HSS10/RA5/WASH/INGO/23897,10/10/2023 12:47:17 PM,Overall,4400,4600,5600,5400,20000,2806,6794,6289,6831,22720
20,South Sudan,2022,SSD-22/HSS10/RA5/WASH/INGO/23897,10/10/2023 12:47:17 PM,Returnees,440,460,460,440,1800,0,0,0,0,0
20,South Sudan,2022,SSD-22/HSS10/RA5/WASH/UN/23936,7/7/2023 1:40:45 PM,Internally Displaced People,10528,13231,13516,13222,50497,8873,11342,11236,10964,42415
20,South Sudan,2022,SSD-22/HSS10/RA5/WASH/UN/23936,7/7/2023 1:40:45 PM,Overall,10528,13231,13516,13222,50497,8873,11342,11236,10964,42415
20,South Sudan,2022,SSD-22/HSS10/SA1/E/NGO/22962,9/13/2023 7:45:47 AM,Host Communities,29,17,3055,2499,5600,33,17,2901,2409,5360
20,South Sudan,2022,SSD-22/HSS10/SA1/E/NGO/22962,9/13/2023 7:45:47 AM,Internally Displaced People,11,6,1091,893,2001,11,6,1081,870,1968
20,South Sudan,2022,SSD-22/HSS10/SA1/E/NGO/22962,9/13/2023 7:45:47 AM,Overall,42,24,4364,3570,8000,46,24,4192,3458,7720
20,South Sudan,2022,SSD-22/HSS10/SA1/E/NGO/22962,9/13/2023 7:45:47 AM,Returnees,2,1,218,178,399,2,1,210,179,392
20,South Sudan,2022,SSD-22/HSS10/SA1/H-N/INGO/22851,10/10/2023 12:43:04 PM,Host Communities,3299,5512,7788,8841,25440,5568,14952,10178,11618,42316
20,South Sudan,2022,SSD-22/HSS10/SA1/H-N/INGO/22851,10/10/2023 12:43:04 PM,Internally Displaced People,712,778,986,1185,3661,1032,1411,635,811,3889
20,South Sudan,2022,SSD-22/HSS10/SA1/H-N/INGO/22851,10/10/2023 12:43:04 PM,Overall,4637,7005,9667,11096,32405,7508,17660,11388,13161,49717
20,South Sudan,2022,SSD-22/HSS10/SA1/H-N/INGO/22851,10/10/2023 12:43:04 PM,Returnees,626,715,893,1070,3304,908,1297,575,732,3512
20,South Sudan,2022,SSD-22/HSS10/SA1/P/INGO/22876,10/19/2023 8:38:52 AM,Host Communities,1574,3374,882,1895,7725,1321,3678,1063,2220,8282
20,South Sudan,2022,SSD-22/HSS10/SA1/P/INGO/22876,10/19/2023 8:38:52 AM,Internally Displaced People,328,1149,188,575,2240,379,1013,401,643,2436
20,South Sudan,2022,SSD-22/HSS10/SA1/P/INGO/22876,10/19/2023 8:38:52 AM,Overall,1902,4523,1070,2470,9965,1700,4691,1464,2863,10718
20,South Sudan,2022,SSD-22/HSS10/SA1/WASH/INGO/22801,7/7/2023 1:55:56 PM,Host Communities,2922,3188,3719,3453,13282,820,2120,956,1123,5019
20,South Sudan,2022,SSD-22/HSS10/SA1/WASH/INGO/22801,7/7/2023 1:55:56 PM,Internally Displaced People,5844,6375,7438,6906,26563,6857,13823,3943,7173,31796
20,South Sudan,2022,SSD-22/HSS10/SA1/WASH/INGO/22801,7/7/2023 1:55:56 PM,Overall,9740,10626,12397,11509,44272,7748,15991,4928,8313,36980
20,South Sudan,2022,SSD-22/HSS10/SA1/WASH/INGO/22801,7/7/2023 1:55:56 PM,Returnees,974,1063,1240,1150,4427,71,48,29,17,165
20,South Sudan,2022,SSD-22/HSS10/SA1/WASH-NFI/INGO/23023,10/5/2023 5:20:16 PM,Host Communities,2341,2445,2844,3057,10687,2156,2256,2778,3055,10245
20,South Sudan,2022,SSD-22/HSS10/SA1/WASH-NFI/INGO/23023,10/5/2023 5:20:16 PM,Internally Displaced People,9155,9620,11352,11909,42036,7925,7423,10995,11408,37751
20,South Sudan,2022,SSD-22/HSS10/SA1/WASH-NFI/INGO/23023,10/5/2023 5:20:16 PM,Overall,12372,13047,15231,16145,56795,10764,10363,14660,15515,51302
20,South Sudan,2022,SSD-22/HSS10/SA1/WASH-NFI/INGO/23023,10/5/2023 5:20:16 PM,Returnees,876,982,1035,1179,4072,683,684,887,1052,3306
19,South Sudan (UNDP),2015,SSD-15/HSS10/RA1/P/UN/492,10/13/2015 11:25:53 AM,Combatants and Ex-Combatants,0,0,2850,150,3000,0,0,1750,5,1755
19,South Sudan (UNDP),2015,SSD-15/HSS10/RA1/P/UN/492,10/13/2015 11:25:53 AM,Overall,0,0,2850,150,3000,0,0,1750,5,1755
19,South Sudan (UNDP),2015,SSD-15/HSS10/RA2/L/UN/502,2/8/2016 6:07:11 AM,Aid Agencies,23,0,0,0,23,23,0,0,0,23
19,South Sudan (UNDP),2015,SSD-15/HSS10/RA2/L/UN/502,2/8/2016 6:07:11 AM,Internally Displaced People,26900,20200,23400,16950,87450,26900,20200,23400,16950,87450
19,South Sudan (UNDP),2015,SSD-15/HSS10/RA2/L/UN/502,2/8/2016 6:07:11 AM,Overall,23,0,0,0,23,23,0,0,0,23
19,South Sudan (UNDP),2015,SSD-15/HSS10/RA2/L/UN/502,2/8/2016 6:07:11 AM,People in Host Communities,1800,2500,1000,1600,6900,1800,2500,1000,1600,6900
19,South Sudan (UNDP),2015,SSD-15/HSS10/RA2/L/UN/502,2/8/2016 6:07:11 AM,Refugee Returnees,2700,1950,800,1100,6550,2700,1950,800,1100,6550
19,South Sudan (UNDP),2015,SSD-15/HSS10/RA3/CCCM/INGO/659,9/9/2016 9:11:42 AM,Internally Displaced People,30881,62096,71584,72981,237542,30692,57517,66496,68388,223093
19,South Sudan (UNDP),2015,SSD-15/HSS10/RA3/CCCM/INGO/659,9/9/2016 9:11:42 AM,Overall,30881,62096,71584,72981,237542,30692,57517,66496,68388,223093
19,South Sudan (UNDP),2015,SSD-15/HSS10/RA3/L/UN/655,9/2/2016 9:32:00 AM,Aid Agencies,80,0,0,0,80,80,0,0,0,80
19,South Sudan (UNDP),2015,SSD-15/HSS10/RA3/L/UN/655,9/2/2016 9:32:00 AM,Overall,80,0,0,0,80,80,0,0,0,80
19,South Sudan (UNDP),2015,SSD-15/HSS10/RA3/L/UN/656,2/3/2016 11:55:56 AM,Aid Agencies,40,0,0,0,40,44,0,0,0,44
19,South Sudan (UNDP),2015,SSD-15/HSS10/RA3/L/UN/656,2/3/2016 11:55:56 AM,Overall,40,0,0,0,40,44,0,0,0,44
19,South Sudan (UNDP),2015,SSD-15/HSS10/RA3/L/UN/657,2/4/2016 1:16:49 PM,Aid Agencies,250,0,0,0,250,248,0,0,0,248
19,South Sudan (UNDP),2015,SSD-15/HSS10/RA3/L/UN/657,2/4/2016 1:16:49 PM,Overall,250,0,0,0,250,248,0,0,0,248
19,South Sudan (UNDP),2015,SSD-15/HSS10/RA4/E/INGO/668,9/16/2016 6:29:00 AM,Internally Displaced People,0,0,1400,700,2100,0,0,3216,2451,5667
19,South Sudan (UNDP),2015,SSD-15/HSS10/RA4/E/INGO/668,9/16/2016 6:29:00 AM,Overall,90,60,2800,1400,4350,193,97,23736,12851,36877
19,South Sudan (UNDP),2015,SSD-15/HSS10/RA4/E/INGO/668,9/16/2016 6:29:00 AM,People in Host Communities,0,0,1400,700,2100,0,0,20520,10400,30920
19,South Sudan (UNDP),2015,SSD-15/HSS10/RA4/E/INGO/668,9/16/2016 6:29:00 AM,"Trainers, Promoters, Caretakers, committee members, etc.",90,60,0,0,150,193,97,0,0,290
19,South Sudan (UNDP),2015,SSD-15/HSS10/RA4/H/INGO/662,10/31/2016 11:37:43 AM,Children under 5,0,0,2517,2353,4870,0,0,3538,3556,7094
19,South Sudan (UNDP),2015,SSD-15/HSS10/RA4/H/INGO/662,10/31/2016 11:37:43 AM,Internally Displaced People,1648,2759,2215,2291,8913,431,797,778,838,2844
19,South Sudan (UNDP),2015,SSD-15/HSS10/RA4/H/INGO/662,10/31/2016 11:37:43 AM,Overall,4119,6898,5537,5726,22280,3007,5554,5423,5838,19822
19,South Sudan (UNDP),2015,SSD-15/HSS10/RA4/H/INGO/662,10/31/2016 11:37:43 AM,People in Host Communities,2471,4139,3322,3436,13368,2576,4757,4645,5000,16978
19,South Sudan (UNDP),2015,SSD-15/HSS10/RA4/H/INGO/662,10/31/2016 11:37:43 AM,Pregnant and Lactating Women,0,686,0,0,686,0,401,0,0,401
19,South Sudan (UNDP),2015,SSD-15/HSS10/RA4/H/INGO/666,10/31/2016 12:06:46 PM,Overall,14242,19212,7460,6886,47800,42411,53014,25494,25488,146407
19,South Sudan (UNDP),2015,SSD-15/HSS10/RA4/H/NGO/661,10/31/2016 12:18:28 PM,Children under 5,0,0,1500,1510,3010,0,0,1503,1396,2899
19,South Sudan (UNDP),2015,SSD-15/HSS10/RA4/H/NGO/661,10/31/2016 12:18:28 PM,Overall,3000,3500,1500,1510,9510,1781,2418,1503,1396,7098
19,South Sudan (UNDP),2015,SSD-15/HSS10/RA4/MA/INGO/664,12/2/2016 11:32:04 AM,Internally Displaced People,1400,1855,2765,3220,9240,258,858,1772,1649,4537
19,South Sudan (UNDP),2015,SSD-15/HSS10/RA4/MA/INGO/664,12/2/2016 11:32:04 AM,Overall,2000,2650,3950,4600,13200,1985,3729,5369,5177,16260
19,South Sudan (UNDP),2015,SSD-15/HSS10/RA4/MA/INGO/664,12/2/2016 11:32:04 AM,People in Host Communities,600,795,1185,1380,3960,1727,2871,3597,3528,11723
19,South Sudan (UNDP),2015,SSD-15/HSS10/RA4/N/NGO/663,3/24/2017 12:28:51 PM,Children under 5,0,0,3920,4080,8000,0,0,3801,4200,8001
19,South Sudan (UNDP),2015,SSD-15/HSS10/RA4/N/NGO/663,3/24/2017 12:28:51 PM,Internally Displaced People,1000,1000,0,0,2000,1400,242,0,0,1642
19,South Sudan (UNDP),2015,SSD-15/HSS10/RA4/N/NGO/663,3/24/2017 12:28:51 PM,Overall,3000,5000,3920,4080,16000,2437,5372,3801,4200,15810
19,South Sudan (UNDP),2015,SSD-15/HSS10/RA4/N/NGO/663,3/24/2017 12:28:51 PM,People in Host Communities,500,3000,0,0,3500,1037,2800,0,0,3837
19,South Sudan (UNDP),2015,SSD-15/HSS10/RA4/N/NGO/663,3/24/2017 12:28:51 PM,Pregnant and Lactating Women,0,3500,0,0,3500,0,2330,0,0,2330
19,South Sudan (UNDP),2015,SSD-15/HSS10/RA4/P/INGO/665,3/15/2019 11:03:11 AM,Internally Displaced People,2441,2419,3132,2808,10800,1746,5000,1007,4858,12611
19,South Sudan (UNDP),2015,SSD-15/HSS10/RA4/P/INGO/665,3/15/2019 11:03:11 AM,Overall,4068,4032,5220,4680,18000,2726,6605,1807,6978,18116
19,South Sudan (UNDP),2015,SSD-15/HSS10/RA4/P/INGO/665,3/15/2019 11:03:11 AM,People in Host Communities,1627,1613,2088,1872,7200,980,1605,800,2120,5505
19,South Sudan (UNDP),2015,SSD-15/HSS10/RA4/WASH/INGO/667,12/8/2016 1:33:06 PM,Internally Displaced People,1577,2365,4928,4929,13799,2432,3962,4225,4834,15453
19,South Sudan (UNDP),2015,SSD-15/HSS10/RA4/WASH/INGO/667,12/8/2016 1:33:06 PM,Overall,2629,3943,8213,8215,23000,5404,8804,9389,10752,34349
19,South Sudan (UNDP),2015,SSD-15/HSS10/RA4/WASH/INGO/667,12/8/2016 1:33:06 PM,People in Host Communities,1052,1578,3285,3286,9201,2972,4842,5164,5914,18892
19,South Sudan (UNDP),2015,SSD-15/HSS10/RA5/CCCM/UN/669,12/2/2016 9:53:25 AM,Other,70,70,0,0,140,112,14,0,0,126
19,South Sudan (UNDP),2015,SSD-15/HSS10/RA5/CCCM/UN/669,12/2/2016 9:53:25 AM,Overall,70,70,0,0,140,112,14,0,0,126
19,South Sudan (UNDP),2015,SSD-15/HSS10/SA1/CCCM/UN/491,2/8/2016 6:43:53 AM,Internally Displaced People,5219,10719,13769,14011,43718,16806,34219,43026,43029,137080
19,South Sudan (UNDP),2015,SSD-15/HSS10/SA1/CCCM/UN/491,2/8/2016 6:43:53 AM,Overall,5219,10719,13769,14011,43718,16806,34219,43026,43029,137080
19,South Sudan (UNDP),2015,SSD-15/HSS10/SA2/CCCM/INGO/635,12/2/2016 9:52:12 AM,Internally Displaced People,0,0,0,0,0,8041,6966,7577,7697,30281
19,South Sudan (UNDP),2015,SSD-15/HSS10/SA2/CCCM/INGO/635,12/2/2016 9:52:12 AM,Overall,8315,6991,7731,7865,30902,8041,6966,7577,7697,30281
19,South Sudan (UNDP),2015,SSD-15/HSS10/SA2/CCCM/UN/518,9/2/2016 10:15:51 AM,Internally Displaced People,74928,74928,149856,168588,468300,89860,89860,179720,202190,561630
19,South Sudan (UNDP),2015,SSD-15/HSS10/SA2/CCCM/UN/518,9/2/2016 10:15:51 AM,Overall,74928,74928,149856,168588,468300,89860,89860,179720,202190,561630
19,South Sudan (UNDP),2015,SSD-15/HSS10/SA2/CCS/UN/618,9/9/2016 8:54:14 AM,Overall,40,40,0,20,100,0,0,0,0,0
19,South Sudan (UNDP),2015,SSD-15/HSS10/SA2/E/NGO/509,9/24/2016 6:03:15 PM,Internally Displaced People,0,0,1811,1452,3263,0,0,1811,1452,3263
19,South Sudan (UNDP),2015,SSD-15/HSS10/SA2/E/NGO/509,9/24/2016 6:03:15 PM,Other,0,0,1326,1303,2629,0,0,1326,1303,2629
19,South Sudan (UNDP),2015,SSD-15/HSS10/SA2/E/NGO/509,9/24/2016 6:03:15 PM,Overall,129,48,4387,3564,8128,129,48,4387,3564,8128
19,South Sudan (UNDP),2015,SSD-15/HSS10/SA2/E/NGO/509,9/24/2016 6:03:15 PM,People in Host Communities,0,0,1250,809,2059,0,0,1250,809,2059
19,South Sudan (UNDP),2015,SSD-15/HSS10/SA2/E/NGO/509,9/24/2016 6:03:15 PM,"Trainers, Promoters, Caretakers, committee members, etc.",129,48,0,0,177,129,48,0,0,177
19,South Sudan (UNDP),2015,SSD-15/HSS10/SA2/E/NGO/539,4/20/2016 8:41:18 AM,Internally Displaced People,33,27,1064,1211,2335,31,29,990,1285,2335
19,South Sudan (UNDP),2015,SSD-15/HSS10/SA2/E/NGO/539,4/20/2016 8:41:18 AM,Other,12,10,352,444,818,27,28,1023,1039,2117
19,South Sudan (UNDP),2015,SSD-15/HSS10/SA2/E/NGO/539,4/20/2016 8:41:18 AM,Overall,60,40,2415,2755,5270,75,25,2368,2802,5270
19,South Sudan (UNDP),2015,SSD-15/HSS10/SA2/E/NGO/539,4/20/2016 8:41:18 AM,People in Host Communities,30,25,962,1100,2117,13,9,355,441,818
19,South Sudan (UNDP),2015,SSD-15/HSS10/SA2/E/NGO/543,9/25/2016 11:00:15 AM,Internally Displaced People,33,43,1140,1000,2216,160,200,1380,1650,3390
19,South Sudan (UNDP),2015,SSD-15/HSS10/SA2/E/NGO/543,9/25/2016 11:00:15 AM,Overall,93,93,3140,3140,6466,460,550,4260,4676,9946
19,South Sudan (UNDP),2015,SSD-15/HSS10/SA2/E/NGO/543,9/25/2016 11:00:15 AM,People in Host Communities,60,50,2000,2140,4250,300,250,2880,3026,6456
19,South Sudan (UNDP),2015,SSD-15/HSS10/SA2/E/NGO/593,2/4/2016 7:43:12 AM,Children under 5,0,0,130,70,200,0,0,190,80,270
19,South Sudan (UNDP),2015,SSD-15/HSS10/SA2/E/NGO/593,2/4/2016 7:43:12 AM,Internally Displaced People,300,400,2000,2000,4700,75,14,2450,2885,5424
19,South Sudan (UNDP),2015,SSD-15/HSS10/SA2/E/NGO/593,2/4/2016 7:43:12 AM,Overall,400,600,2500,2500,6000,500,161,3750,3783,8194
19,South Sudan (UNDP),2015,SSD-15/HSS10/SA2/E/NGO/593,2/4/2016 7:43:12 AM,People in Host Communities,50,50,400,400,900,223,60,1100,818,2201
19,South Sudan (UNDP),2015,SSD-15/HSS10/SA2/E/NGO/593,2/4/2016 7:43:12 AM,"Trainers, Promoters, Caretakers, committee members, etc.",50,150,0,0,200,202,87,0,0,289
19,South Sudan (UNDP),2015,SSD-15/HSS10/SA2/E/NGO/603,4/20/2016 8:26:58 AM,Internally Displaced People,110,120,1810,1810,3850,0,0,0,0,0
19,South Sudan (UNDP),2015,SSD-15/HSS10/SA2/E/NGO/603,4/20/2016 8:26:58 AM,Overall,210,240,3610,3620,7680,174,171,8057,5381,13783
19,South Sudan (UNDP),2015,SSD-15/HSS10/SA2/E/NGO/603,4/20/2016 8:26:58 AM,People in Host Communities,100,120,1800,1810,3830,0,0,0,0,0
19,South Sudan (UNDP),2015,SSD-15/HSS10/SA2/FSL/INGO/510,9/26/2016 7:03:56 AM,Internally Displaced People,2248,9101,1235,2156,14740,832,2558,0,0,3390
19,South Sudan (UNDP),2015,SSD-15/HSS10/SA2/FSL/INGO/510,9/26/2016 7:03:56 AM,Overall,10488,19249,3885,6176,39798,23044,23044,28805,40327,115220
19,South Sudan (UNDP),2015,SSD-15/HSS10/SA2/FSL/INGO/510,9/26/2016 7:03:56 AM,People in Host Communities,8240,10148,2650,4020,25058,1597,4357,0,0,5954
19,South Sudan (UNDP),2015,SSD-15/HSS10/SA2/FSL/INGO/597,9/26/2016 7:00:31 AM,Internally Displaced People,2400,5160,600,2640,10800,1966,3587,1145,962,7660
19,South Sudan (UNDP),2015,SSD-15/HSS10/SA2/FSL/INGO/597,9/26/2016 7:00:31 AM,Overall,4000,8600,1000,4400,18000,4916,8967,2862,2405,19150
19,South Sudan (UNDP),2015,SSD-15/HSS10/SA2/FSL/INGO/597,9/26/2016 7:00:31 AM,People in Host Communities,1600,3440,400,1760,7200,2950,5380,1717,1443,11490
19,South Sudan (UNDP),2015,SSD-15/HSS10/SA2/FSL/INGO/638,1/14/2017 2:48:46 PM,Internally Displaced People,5000,10000,2000,2500,19500,4500,9000,1800,2250,17550
19,South Sudan (UNDP),2015,SSD-15/HSS10/SA2/FSL/INGO/638,1/14/2017 2:48:46 PM,Overall,15000,15000,3000,3000,36000,15000,15000,3000,3000,36000
19,South Sudan (UNDP),2015,SSD-15/HSS10/SA2/FSL/INGO/638,1/14/2017 2:48:46 PM,People in Host Communities,10000,5000,1000,500,16500,9000,4500,900,450,14850
19,South Sudan (UNDP),2015,SSD-15/HSS10/SA2/FSL/NGO/511,9/24/2016 7:50:11 PM,Internally Displaced People,17325,20475,0,0,37800,15000,17795,0,0,32795
19,South Sudan (UNDP),2015,SSD-15/HSS10/SA2/FSL/NGO/511,9/24/2016 7:50:11 PM,Other,11365,13565,0,0,24930,10017,11890,0,0,21907
19,South Sudan (UNDP),2015,SSD-15/HSS10/SA2/FSL/NGO/511,9/24/2016 7:50:11 PM,Overall,41425,48835,0,0,90260,35886,42468,0,0,78354
19,South Sudan (UNDP),2015,SSD-15/HSS10/SA2/FSL/NGO/511,9/24/2016 7:50:11 PM,People in Host Communities,12375,14625,0,0,27000,10694,12698,0,0,23392
19,South Sudan (UNDP),2015,SSD-15/HSS10/SA2/FSL/NGO/511,9/24/2016 7:50:11 PM,"Trainers, Promoters, Caretakers, committee members, etc.",175,85,0,0,260,175,85,0,0,260
19,South Sudan (UNDP),2015,SSD-15/HSS10/SA2/FSL/NGO/527,2/3/2016 12:21:20 PM,Internally Displaced People,3250,4250,0,0,7500,2750,4750,0,0,7500
19,South Sudan (UNDP),2015,SSD-15/HSS10/SA2/FSL/NGO/527,2/3/2016 12:21:20 PM,Overall,6500,8500,0,0,15000,6000,9000,0,0,15000
19,South Sudan (UNDP),2015,SSD-15/HSS10/SA2/FSL/NGO/527,2/3/2016 12:21:20 PM,People in Host Communities,3250,4250,0,0,7500,3250,4250,0,0,7500
19,South Sudan (UNDP),2015,SSD-15/HSS10/SA2/FSL/NGO/616,11/27/2016 9:59:31 AM,Internally Displaced People,4000,3000,1000,1000,9000,0,0,0,0,0
19,South Sudan (UNDP),2015,SSD-15/HSS10/SA2/FSL/NGO/616,11/27/2016 9:59:31 AM,Overall,7000,5000,1500,1500,15000,8592,4933,0,0,13525
19,South Sudan (UNDP),2015,SSD-15/HSS10/SA2/FSL/NGO/616,11/27/2016 9:59:31 AM,People in Host Communities,3000,2000,500,500,6000,8592,4933,0,0,13525
19,South Sudan (UNDP),2015,SSD-15/HSS10/SA2/FSL/NGO/640,11/29/2016 8:56:49 AM,Internally Displaced People,4000,5000,1500,1500,12000,4000,5000,1500,1500,12000
19,South Sudan (UNDP),2015,SSD-15/HSS10/SA2/FSL/NGO/640,11/29/2016 8:56:49 AM,Overall,6000,8000,2000,2000,18000,6000,8000,2000,2000,18000
19,South Sudan (UNDP),2015,SSD-15/HSS10/SA2/FSL/NGO/640,11/29/2016 8:56:49 AM,People in Host Communities,2000,3000,500,500,6000,2000,3000,500,500,6000
19,South Sudan (UNDP),2015,SSD-15/HSS10/SA2/FSL/UN/536,9/24/2016 8:16:12 PM,Internally Displaced People,5400,7200,2700,2700,18000,3390,4520,1695,1695,11300
19,South Sudan (UNDP),2015,SSD-15/HSS10/SA2/FSL/UN/536,9/24/2016 8:16:12 PM,Overall,9000,12000,4500,4500,30000,16950,22600,8475,8475,56500
19,South Sudan (UNDP),2015,SSD-15/HSS10/SA2/FSL/UN/536,9/24/2016 8:16:12 PM,People in Host Communities,3600,4800,1800,1800,12000,5086,6780,2542,2542,16950
19,South Sudan (UNDP),2015,SSD-15/HSS10/SA2/H/INGO/519,10/31/2016 12:30:16 PM,Internally Displaced People,960,1421,845,861,4087,1001,1523,567,1347,4438
19,South Sudan (UNDP),2015,SSD-15/HSS10/SA2/H/INGO/519,10/31/2016 12:30:16 PM,Overall,13727,20189,9464,10928,54308,14918,15929,11804,11914,54565
19,South Sudan (UNDP),2015,SSD-15/HSS10/SA2/H/INGO/519,10/31/2016 12:30:16 PM,People in Host Communities,13727,18768,6369,6598,45462,13917,1577,11237,10567,37298
19,South Sudan (UNDP),2015,SSD-15/HSS10/SA2/H/INGO/528,2/3/2016 2:42:47 PM,Children under 5,0,0,2169,2084,4253,0,0,4567,4837,9404
19,South Sudan (UNDP),2015,SSD-15/HSS10/SA2/H/INGO/528,2/3/2016 2:42:47 PM,Overall,7839,8159,2169,2084,20251,10979,14255,4567,4837,34638
19,South Sudan (UNDP),2015,SSD-15/HSS10/SA2/H/INGO/528,2/3/2016 2:42:47 PM,Pregnant and Lactating Women,0,1620,0,0,1620,0,98,0,0,98
19,South Sudan (UNDP),2015,SSD-15/HSS10/SA2/H/INGO/531,10/24/2018 1:12:10 PM,Children under 5,0,0,3871,4032,7903,0,0,5006,5693,10699
19,South Sudan (UNDP),2015,SSD-15/HSS10/SA2/H/INGO/531,10/24/2018 1:12:10 PM,Internally Displaced People,0,0,0,0,0,891,1203,670,710,3474
19,South Sudan (UNDP),2015,SSD-15/HSS10/SA2/H/INGO/531,10/24/2018 1:12:10 PM,Overall,7679,23079,3871,4032,38661,3405,4365,2038,2123,11931
19,South Sudan (UNDP),2015,SSD-15/HSS10/SA2/H/INGO/531,10/24/2018 1:12:10 PM,People in Host Communities,7679,19390,0,0,27069,3405,4365,3871,4302,15943
19,South Sudan (UNDP),2015,SSD-15/HSS10/SA2/H/INGO/531,10/24/2018 1:12:10 PM,Pregnant and Lactating Women,0,3689,0,0,3689,0,2123,0,0,2123
19,South Sudan (UNDP),2015,SSD-15/HSS10/SA2/H/INGO/620,2/3/2016 12:49:05 PM,Internally Displaced People,22361,21485,5944,5710,55500,30179,41898,15758,15538,103373
19,South Sudan (UNDP),2015,SSD-15/HSS10/SA2/H/INGO/620,2/3/2016 12:49:05 PM,Overall,22361,21485,5944,5710,55500,30179,41898,15758,15538,103373
19,South Sudan (UNDP),2015,SSD-15/HSS10/SA2/H/INGO/643,9/28/2016 6:27:03 AM,Overall,10551,15825,13187,13187,52750,24825,44686,16228,16393,102132
19,South Sudan (UNDP),2015,SSD-15/HSS10/SA2/H/NGO/504,9/28/2016 6:45:44 AM,Children under 5,0,0,12460,12460,24920,0,0,26746,27743,54489
19,South Sudan (UNDP),2015,SSD-15/HSS10/SA2/H/NGO/504,9/28/2016 6:45:44 AM,Internally Displaced People,6167,6167,6167,6167,24668,10759,14451,1090,1163,27463
19,South Sudan (UNDP),2015,SSD-15/HSS10/SA2/H/NGO/504,9/28/2016 6:45:44 AM,Overall,22400,29000,12460,12460,76320,32277,47405,30016,31232,140930
19,South Sudan (UNDP),2015,SSD-15/HSS10/SA2/H/NGO/504,9/28/2016 6:45:44 AM,People in Host Communities,6167,6167,6167,6167,24668,21518,29354,2180,2326,55378
19,South Sudan (UNDP),2015,SSD-15/HSS10/SA2/H/NGO/504,9/28/2016 6:45:44 AM,Pregnant and Lactating Women,0,2060,0,0,2060,0,3600,0,0,3600
19,South Sudan (UNDP),2015,SSD-15/HSS10/SA2/H/NGO/529,10/31/2016 12:37:51 PM,Children under 5,0,0,861,928,1789,0,0,870,921,1791
19,South Sudan (UNDP),2015,SSD-15/HSS10/SA2/H/NGO/529,10/31/2016 12:37:51 PM,Internally Displaced People,5478,14798,3228,2300,25804,3811,10019,3086,3675,20591
19,South Sudan (UNDP),2015,SSD-15/HSS10/SA2/H/NGO/529,10/31/2016 12:37:51 PM,Other,1827,3250,800,722,6599,2750,4926,1611,1684,10971
19,South Sudan (UNDP),2015,SSD-15/HSS10/SA2/H/NGO/529,10/31/2016 12:37:51 PM,Overall,10957,22809,5950,5650,45366,8818,18206,6497,7513,41034
19,South Sudan (UNDP),2015,SSD-15/HSS10/SA2/H/NGO/529,10/31/2016 12:37:51 PM,People in Host Communities,3652,4761,1061,1700,11174,2257,3261,930,1233,7681
19,South Sudan (UNDP),2015,SSD-15/HSS10/SA2/H/NGO/547,8/18/2021 10:01:57 AM,Internally Displaced People,1813,1745,510,445,4513,0,0,0,0,0
19,South Sudan (UNDP),2015,SSD-15/HSS10/SA2/H/NGO/547,8/18/2021 10:01:57 AM,Overall,3425,3290,910,875,8500,1200,2500,1000,950,5650
19,South Sudan (UNDP),2015,SSD-15/HSS10/SA2/H/NGO/547,8/18/2021 10:01:57 AM,People in Host Communities,1612,1545,400,430,3987,1200,2500,1000,950,5650
19,South Sudan (UNDP),2015,SSD-15/HSS10/SA2/H/NGO/548,2/3/2016 12:19:25 PM,Internally Displaced People,6480,7590,1253,1304,16627,4850,8300,1500,1450,16100
19,South Sudan (UNDP),2015,SSD-15/HSS10/SA2/H/NGO/548,2/3/2016 12:19:25 PM,Overall,16200,18974,3133,3261,41568,13250,18500,3600,3590,38940
19,South Sudan (UNDP),2015,SSD-15/HSS10/SA2/H/NGO/548,2/3/2016 12:19:25 PM,People in Host Communities,9720,11384,1880,1957,24941,8400,10200,2100,2140,22840
19,South Sudan (UNDP),2015,SSD-15/HSS10/SA2/H/NGO/549,9/28/2016 6:31:25 AM,Children under 5,0,0,12030,11543,23573,0,0,6020,5220,11240
19,South Sudan (UNDP),2015,SSD-15/HSS10/SA2/H/NGO/549,9/28/2016 6:31:25 AM,Overall,34920,39746,36940,37426,149032,12000,15000,6020,5220,38240
19,South Sudan (UNDP),2015,SSD-15/HSS10/SA2/H/NGO/549,9/28/2016 6:31:25 AM,Pregnant and Lactating Women,0,5444,0,0,5444,0,0,0,0,0
19,South Sudan (UNDP),2015,SSD-15/HSS10/SA2/H/NGO/596,2/4/2016 11:52:42 AM,Internally Displaced People,6307,17619,22814,24627,71367,8665,12812,14896,14287,50660
19,South Sudan (UNDP),2015,SSD-15/HSS10/SA2/H/NGO/596,2/4/2016 11:52:42 AM,Overall,6307,17619,22814,24627,71367,8665,12812,14896,14287,50660
19,South Sudan (UNDP),2015,SSD-15/HSS10/SA2/H/NGO/596,2/4/2016 11:52:42 AM,People in Host Communities,3215,4321,6754,7234,21524,1872,2345,4026,4521,12764
19,South Sudan (UNDP),2015,SSD-15/HSS10/SA2/H/UN/513,9/28/2016 6:32:09 AM,Internally Displaced People,39552,42848,10094,10506,103000,50581,67311,28971,27784,174647
19,South Sudan (UNDP),2015,SSD-15/HSS10/SA2/H/UN/513,9/28/2016 6:32:09 AM,Overall,39552,42848,10094,10506,103000,50581,67311,28971,27784,174647
19,South Sudan (UNDP),2015,SSD-15/HSS10/SA2/H/UN/523,2/3/2016 2:13:18 PM,Internally Displaced People,4000,25000,400,800,30200,4500,26500,500,900,32400
19,South Sudan (UNDP),2015,SSD-15/HSS10/SA2/H/UN/523,2/3/2016 2:13:18 PM,Overall,5000,30000,500,1000,36500,5100,30500,700,1200,37500
19,South Sudan (UNDP),2015,SSD-15/HSS10/SA2/H/UN/523,2/3/2016 2:13:18 PM,People in Host Communities,1000,5000,100,200,6300,600,4000,200,300,5100
19,South Sudan (UNDP),2015,SSD-15/HSS10/SA2/H/UN/570,10/31/2016 12:10:04 PM,Children under 5,15190,15810,0,0,31000,17150,16478,0,0,33628
19,South Sudan (UNDP),2015,SSD-15/HSS10/SA2/H/UN/570,10/31/2016 12:10:04 PM,Internally Displaced People,60690,58310,0,0,119000,0,0,0,0,0
19,South Sudan (UNDP),2015,SSD-15/HSS10/SA2/H/UN/570,10/31/2016 12:10:04 PM,Overall,73500,76500,0,0,150000,85753,82391,0,0,168144
19,South Sudan (UNDP),2015,SSD-15/HSS10/SA2/H/UN/651,9/28/2016 6:28:38 AM,Internally Displaced People,0,4000,23250,25480,52730,0,0,0,0,0
19,South Sudan (UNDP),2015,SSD-15/HSS10/SA2/H/UN/651,9/28/2016 6:28:38 AM,Overall,0,6800,39984,43316,90100,0,10083,36873,39945,86901
19,South Sudan (UNDP),2015,SSD-15/HSS10/SA2/H/UN/651,9/28/2016 6:28:38 AM,People in Host Communities,0,2800,16734,17836,37370,0,0,0,0,0
19,South Sudan (UNDP),2015,SSD-15/HSS10/SA2/L/UN/507,2/4/2016 1:28:35 PM,Aid Agencies,40,0,0,0,40,35,0,0,0,35
19,South Sudan (UNDP),2015,SSD-15/HSS10/SA2/L/UN/507,2/4/2016 1:28:35 PM,Overall,40,0,0,0,40,35,0,0,0,35
19,South Sudan (UNDP),2015,SSD-15/HSS10/SA2/L/UN/512,9/2/2016 10:09:35 AM,Aid Agencies,80,0,0,0,80,80,0,0,0,80
19,South Sudan (UNDP),2015,SSD-15/HSS10/SA2/L/UN/512,9/2/2016 10:09:35 AM,Overall,80,0,0,0,80,80,0,0,0,80
19,South Sudan (UNDP),2015,SSD-15/HSS10/SA2/L/UN/631,2/4/2016 1:58:46 PM,Aid Agencies,250,0,0,0,250,233,0,0,0,233
19,South Sudan (UNDP),2015,SSD-15/HSS10/SA2/L/UN/631,2/4/2016 1:58:46 PM,Overall,250,0,0,0,250,233,0,0,0,233
19,South Sudan (UNDP),2015,SSD-15/HSS10/SA2/N/INGO/514,8/1/2016 1:11:45 PM,Internally Displaced People,789,8657,5370,5505,20321,1305,10973,9434,9651,31363
19,South Sudan (UNDP),2015,SSD-15/HSS10/SA2/N/INGO/514,8/1/2016 1:11:45 PM,Overall,1052,11543,7160,7340,27095,1741,14631,12578,12868,41818
19,South Sudan (UNDP),2015,SSD-15/HSS10/SA2/N/INGO/514,8/1/2016 1:11:45 PM,People in Host Communities,263,2886,1790,1835,6774,436,3658,3144,3217,10455
19,South Sudan (UNDP),2015,SSD-15/HSS10/SA2/N/INGO/514,8/1/2016 1:11:45 PM,Pregnant and Lactating Women,0,5614,0,0,5614,0,6552,0,0,6552
19,South Sudan (UNDP),2015,SSD-15/HSS10/SA2/N/INGO/517,2/8/2016 1:09:47 PM,Internally Displaced People,7,289,501,616,1413,0,663,1467,1387,3517
19,South Sudan (UNDP),2015,SSD-15/HSS10/SA2/N/INGO/517,2/8/2016 1:09:47 PM,Overall,60,4139,7162,8807,20168,0,6637,14673,13871,35181
19,South Sudan (UNDP),2015,SSD-15/HSS10/SA2/N/INGO/517,2/8/2016 1:09:47 PM,People in Host Communities,53,3850,6661,8191,18755,0,5974,13206,12484,31664
19,South Sudan (UNDP),2015,SSD-15/HSS10/SA2/N/INGO/526,2/8/2016 1:11:05 PM,Internally Displaced People,68,5661,560,584,6873,342,4738,124,128,5332
19,South Sudan (UNDP),2015,SSD-15/HSS10/SA2/N/INGO/526,2/8/2016 1:11:05 PM,Overall,65,8706,428,445,9644,171,3957,96,99,4323
19,South Sudan (UNDP),2015,SSD-15/HSS10/SA2/N/INGO/526,2/8/2016 1:11:05 PM,People in Host Communities,58,3651,296,306,4311,0,0,0,0,0
19,South Sudan (UNDP),2015,SSD-15/HSS10/SA2/N/INGO/530,2/4/2016 12:07:08 PM,Internally Displaced People,0,889,1964,2044,4897,0,1141,4388,4567,10096
19,South Sudan (UNDP),2015,SSD-15/HSS10/SA2/N/INGO/530,2/4/2016 12:07:08 PM,Overall,214,2340,4986,5190,12730,119,2841,6543,6810,16313
19,South Sudan (UNDP),2015,SSD-15/HSS10/SA2/N/INGO/530,2/4/2016 12:07:08 PM,People in Host Communities,214,108,3022,3146,6490,119,700,1155,2243,4217
19,South Sudan (UNDP),2015,SSD-15/HSS10/SA2/N/INGO/530,2/4/2016 12:07:08 PM,Pregnant and Lactating Women,0,1343,0,0,1343,0,1841,0,0,1841
19,South Sudan (UNDP),2015,SSD-15/HSS10/SA2/N/INGO/583,2/14/2018 12:54:01 PM,Children under 5,0,0,37563,41148,78711,0,0,58378,63243,121621
19,South Sudan (UNDP),2015,SSD-15/HSS10/SA2/N/INGO/583,2/14/2018 12:54:01 PM,Internally Displaced People,506,2132,2629,2880,8147,743,8718,4086,4427,17974
19,South Sudan (UNDP),2015,SSD-15/HSS10/SA2/N/INGO/583,2/14/2018 12:54:01 PM,Overall,7231,30450,37563,41148,116392,10616,124548,58378,63243,256785
19,South Sudan (UNDP),2015,SSD-15/HSS10/SA2/N/INGO/583,2/14/2018 12:54:01 PM,People in Host Communities,6725,28318,34934,38268,108245,9873,115830,54292,58816,238811
19,South Sudan (UNDP),2015,SSD-15/HSS10/SA2/N/INGO/583,2/14/2018 12:54:01 PM,Pregnant and Lactating Women,0,4500,0,0,4500,0,1400,0,0,1400
19,South Sudan (UNDP),2015,SSD-15/HSS10/SA2/N/INGO/607,9/11/2016 1:30:35 PM,Internally Displaced People,70,1249,1448,1483,4250,0,1704,1943,1954,5601
19,South Sudan (UNDP),2015,SSD-15/HSS10/SA2/N/INGO/607,9/11/2016 1:30:35 PM,Overall,471,8325,9651,9886,28333,38,11362,12951,13023,37374
19,South Sudan (UNDP),2015,SSD-15/HSS10/SA2/N/INGO/607,9/11/2016 1:30:35 PM,People in Host Communities,400,7076,8204,8403,24083,38,9658,11008,11069,31773
19,South Sudan (UNDP),2015,SSD-15/HSS10/SA2/N/INGO/626,2/8/2016 1:12:12 PM,Internally Displaced People,66,760,2276,2466,5568,76,961,1581,1742,4360
19,South Sudan (UNDP),2015,SSD-15/HSS10/SA2/N/INGO/626,2/8/2016 1:12:12 PM,Overall,164,1900,5690,6164,13918,190,2402,3953,4354,10899
19,South Sudan (UNDP),2015,SSD-15/HSS10/SA2/N/INGO/626,2/8/2016 1:12:12 PM,People in Host Communities,98,1140,3414,3698,8350,114,1441,2372,2612,6539
19,South Sudan (UNDP),2015,SSD-15/HSS10/SA2/N/INGO/630,3/24/2017 12:22:25 PM,Internally Displaced People,212,16350,4226,3901,24689,726,19791,6087,6362,32966
19,South Sudan (UNDP),2015,SSD-15/HSS10/SA2/N/INGO/630,3/24/2017 12:22:25 PM,Overall,530,35705,10563,9751,56549,1101,46250,14403,15602,77356
19,South Sudan (UNDP),2015,SSD-15/HSS10/SA2/N/INGO/630,3/24/2017 12:22:25 PM,People in Host Communities,318,19355,6337,5850,31860,375,26459,8316,9240,44390
19,South Sudan (UNDP),2015,SSD-15/HSS10/SA2/N/INGO/642,2/4/2016 12:41:58 PM,Overall,328,8900,9337,9405,27970,7474,27729,27270,26680,89153
19,South Sudan (UNDP),2015,SSD-15/HSS10/SA2/N/INGO/642,2/4/2016 12:41:58 PM,People in Host Communities,328,8900,9337,9405,27970,7474,27729,27270,26680,89153
19,South Sudan (UNDP),2015,SSD-15/HSS10/SA2/N/INGO/654,9/11/2016 1:39:43 PM,Internally Displaced People,100,3971,11033,11066,26170,58,14328,10231,11017,35634
19,South Sudan (UNDP),2015,SSD-15/HSS10/SA2/N/INGO/654,9/11/2016 1:39:43 PM,Overall,100,3971,11033,11066,26170,58,14328,10231,11017,35634
19,South Sudan (UNDP),2015,SSD-15/HSS10/SA2/N/NGO/506,10/24/2016 12:25:36 PM,Children under 5,0,0,678,706,1384,0,0,6031,5718,11749
19,South Sudan (UNDP),2015,SSD-15/HSS10/SA2/N/NGO/506,10/24/2016 12:25:36 PM,Internally Displaced People,198,327,0,0,525,187,1316,0,0,1503
19,South Sudan (UNDP),2015,SSD-15/HSS10/SA2/N/NGO/506,10/24/2016 12:25:36 PM,Overall,482,1125,678,706,2991,401,6724,6031,5718,18874
19,South Sudan (UNDP),2015,SSD-15/HSS10/SA2/N/NGO/506,10/24/2016 12:25:36 PM,People in Host Communities,284,573,0,0,857,214,3285,0,0,3499
19,South Sudan (UNDP),2015,SSD-15/HSS10/SA2/N/NGO/506,10/24/2016 12:25:36 PM,Pregnant and Lactating Women,0,225,0,0,225,0,2123,0,0,2123
19,South Sudan (UNDP),2015,SSD-15/HSS10/SA2/N/NGO/545,2/4/2016 12:27:27 PM,Children under 5,0,0,0,0,0,0,0,3292,2344,5636
19,South Sudan (UNDP),2015,SSD-15/HSS10/SA2/N/NGO/545,2/4/2016 12:27:27 PM,Internally Displaced People,122,579,464,464,1629,183,2955,1317,938,5393
19,South Sudan (UNDP),2015,SSD-15/HSS10/SA2/N/NGO/545,2/4/2016 12:27:27 PM,Overall,372,1579,2010,2010,5971,457,7387,3292,2344,13480
19,South Sudan (UNDP),2015,SSD-15/HSS10/SA2/N/NGO/545,2/4/2016 12:27:27 PM,People in Host Communities,250,1000,1546,1546,4342,274,5876,1975,1406,9531
19,South Sudan (UNDP),2015,SSD-15/HSS10/SA2/N/NGO/545,2/4/2016 12:27:27 PM,Pregnant and Lactating Women,0,0,0,0,0,0,7387,0,0,7387
19,South Sudan (UNDP),2015,SSD-15/HSS10/SA2/N/NGO/575,9/28/2016 11:53:53 AM,Children under 5,0,0,7790,7618,15408,0,0,5391,6451,11842
19,South Sudan (UNDP),2015,SSD-15/HSS10/SA2/N/NGO/575,9/28/2016 11:53:53 AM,Internally Displaced People,355,355,300,340,1350,165,415,715,1200,2495
19,South Sudan (UNDP),2015,SSD-15/HSS10/SA2/N/NGO/575,9/28/2016 11:53:53 AM,Overall,1500,2368,7790,7618,19276,1376,1878,6351,6917,16522
19,South Sudan (UNDP),2015,SSD-15/HSS10/SA2/N/NGO/575,9/28/2016 11:53:53 AM,People in Host Communities,1000,200,125,125,1450,1211,618,923,1216,3968
19,South Sudan (UNDP),2015,SSD-15/HSS10/SA2/N/NGO/575,9/28/2016 11:53:53 AM,Pregnant and Lactating Women,0,3668,0,0,3668,0,2104,0,0,2104
19,South Sudan (UNDP),2015,SSD-15/HSS10/SA2/N/NGO/586,9/11/2016 1:54:14 PM,Children under 5,0,0,2665,2610,5275,0,0,3015,3596,6611
19,South Sudan (UNDP),2015,SSD-15/HSS10/SA2/N/NGO/586,9/11/2016 1:54:14 PM,Other,300,450,0,0,750,63,0,0,0,63
19,South Sudan (UNDP),2015,SSD-15/HSS10/SA2/N/NGO/586,9/11/2016 1:54:14 PM,Overall,300,1450,2665,2610,7025,63,583,3014,3596,7256
19,South Sudan (UNDP),2015,SSD-15/HSS10/SA2/N/NGO/586,9/11/2016 1:54:14 PM,Pregnant and Lactating Women,0,1000,0,0,1000,0,583,0,0,583
19,South Sudan (UNDP),2015,SSD-15/HSS10/SA2/NFI/INGO/609,9/23/2016 10:40:09 AM,Internally Displaced People,5400,5850,5400,5850,22500,7909,11130,9055,12070,40164
19,South Sudan (UNDP),2015,SSD-15/HSS10/SA2/NFI/INGO/609,9/23/2016 10:40:09 AM,Overall,6000,6500,6000,6500,25000,8788,12367,10061,13411,44627
19,South Sudan (UNDP),2015,SSD-15/HSS10/SA2/NFI/INGO/609,9/23/2016 10:40:09 AM,People in Host Communities,600,650,600,650,2500,879,1237,1006,1341,4463
19,South Sudan (UNDP),2015,SSD-15/HSS10/SA2/NFI/INGO/614,3/24/2017 6:11:08 AM,Internally Displaced People,8445,11825,3866,9649,33785,12839,12221,15269,15353,55682
19,South Sudan (UNDP),2015,SSD-15/HSS10/SA2/NFI/INGO/614,3/24/2017 6:11:08 AM,Overall,11007,15412,5040,12576,44035,15680,15383,18575,18700,68338
19,South Sudan (UNDP),2015,SSD-15/HSS10/SA2/NFI/INGO/614,3/24/2017 6:11:08 AM,People in Host Communities,2562,3587,1174,2927,10250,2841,3162,3306,3347,12656
19,South Sudan (UNDP),2015,SSD-15/HSS10/SA2/NFI/INGO/628,1/27/2016 3:32:12 PM,Internally Displaced People,3755,6627,5743,5965,22090,5000,6000,5000,6000,22000
19,South Sudan (UNDP),2015,SSD-15/HSS10/SA2/NFI/INGO/628,1/27/2016 3:32:12 PM,Overall,3755,6627,5743,5965,22090,5000,6000,5000,6000,22000
19,South Sudan (UNDP),2015,SSD-15/HSS10/SA2/NFI/INGO/652,2/4/2016 11:44:44 AM,Internally Displaced People,10300,14500,16900,16300,58000,16092,18453,7110,7726,49381
19,South Sudan (UNDP),2015,SSD-15/HSS10/SA2/NFI/INGO/652,2/4/2016 11:44:44 AM,Overall,10300,14500,16900,16300,58000,16092,18453,7110,7726,49381
19,South Sudan (UNDP),2015,SSD-15/HSS10/SA2/NFI/NGO/589,9/1/2016 5:15:27 PM,Other,45,60,38,55,198,0,0,0,0,0
19,South Sudan (UNDP),2015,SSD-15/HSS10/SA2/NFI/NGO/589,9/1/2016 5:15:27 PM,Overall,1200,1420,1140,1050,4810,3500,6220,4400,3800,17920
19,South Sudan (UNDP),2015,SSD-15/HSS10/SA2/NFI/NGO/589,9/1/2016 5:15:27 PM,Pregnant and Lactating Women,0,0,0,0,0,73,0,0,0,73
19,South Sudan (UNDP),2015,SSD-15/HSS10/SA2/NFI/UN/516,9/2/2016 8:42:08 AM,Internally Displaced People,7468,12447,20538,21782,62235,7842,13071,21567,22874,65354
19,South Sudan (UNDP),2015,SSD-15/HSS10/SA2/NFI/UN/516,9/2/2016 8:42:08 AM,Overall,8298,13830,22820,24202,69150,8714,14523,23963,25415,72615
19,South Sudan (UNDP),2015,SSD-15/HSS10/SA2/NFI/UN/516,9/2/2016 8:42:08 AM,People in Host Communities,830,1383,2282,2420,6915,872,1452,2396,2541,7261
19,South Sudan (UNDP),2015,SSD-15/HSS10/SA2/P/INGO/649,3/15/2019 11:07:32 AM,Internally Displaced People,1065,2271,1360,1367,6063,2300,3636,1887,1991,9814
19,South Sudan (UNDP),2015,SSD-15/HSS10/SA2/P/INGO/649,3/15/2019 11:07:32 AM,Overall,7100,15140,9070,9115,40425,3066,4848,2556,2654,13124
19,South Sudan (UNDP),2015,SSD-15/HSS10/SA2/P/INGO/649,3/15/2019 11:07:32 AM,People in Host Communities,6035,12869,7710,7748,34362,766,1212,669,663,3310
19,South Sudan (UNDP),2015,SSD-15/HSS10/SA2/P/NGO/566,3/18/2016 7:34:28 AM,Aid Agencies,0,0,0,0,0,7,4,0,0,11
19,South Sudan (UNDP),2015,SSD-15/HSS10/SA2/P/NGO/566,3/18/2016 7:34:28 AM,Internally Displaced People,30,600,250,250,1130,318,1236,289,817,2660
19,South Sudan (UNDP),2015,SSD-15/HSS10/SA2/P/NGO/566,3/18/2016 7:34:28 AM,Overall,150,850,350,350,1700,644,1646,534,1276,4100
19,South Sudan (UNDP),2015,SSD-15/HSS10/SA2/P/NGO/566,3/18/2016 7:34:28 AM,People in Host Communities,110,250,100,100,560,226,336,245,459,1266
19,South Sudan (UNDP),2015,SSD-15/HSS10/SA2/P/NGO/566,3/18/2016 7:34:28 AM,"Trainers, Promoters, Caretakers, committee members, etc.",0,0,0,0,0,93,70,0,0,163
19,South Sudan (UNDP),2015,SSD-15/HSS10/SA2/P/NGO/600,9/28/2016 12:20:59 PM,Internally Displaced People,0,0,183,201,384,0,0,183,201,384
19,South Sudan (UNDP),2015,SSD-15/HSS10/SA2/P/NGO/600,9/28/2016 12:20:59 PM,Overall,0,0,228,252,480,10,30,228,252,520
19,South Sudan (UNDP),2015,SSD-15/HSS10/SA2/P/NGO/600,9/28/2016 12:20:59 PM,People in Host Communities,0,0,45,51,96,10,30,45,51,136
19,South Sudan (UNDP),2015,SSD-15/HSS10/SA2/P/NGO/613,9/28/2016 12:21:49 PM,Internally Displaced People,0,0,1644,1596,3240,0,0,2160,1890,4050
19,South Sudan (UNDP),2015,SSD-15/HSS10/SA2/P/NGO/613,9/28/2016 12:21:49 PM,Overall,107,235,2740,2660,5742,120,290,3600,3150,7160
19,South Sudan (UNDP),2015,SSD-15/HSS10/SA2/P/NGO/613,9/28/2016 12:21:49 PM,People in Host Communities,0,0,1096,1064,2160,0,0,1440,1260,2700
19,South Sudan (UNDP),2015,SSD-15/HSS10/SA2/P/NGO/613,9/28/2016 12:21:49 PM,"Trainers, Promoters, Caretakers, committee members, etc.",107,235,0,0,342,120,290,0,0,410
19,South Sudan (UNDP),2015,SSD-15/HSS10/SA2/P/UN/608,3/18/2016 7:15:33 AM,Internally Displaced People,600,4000,1000,2400,8000,449,4900,960,3496,9805
19,South Sudan (UNDP),2015,SSD-15/HSS10/SA2/P/UN/608,3/18/2016 7:15:33 AM,Overall,600,4000,1000,2400,8000,449,4917,960,3496,9822
19,South Sudan (UNDP),2015,SSD-15/HSS10/SA2/P/UN/608,3/18/2016 7:15:33 AM,"Trainers, Promoters, Caretakers, committee members, etc.",45,55,0,0,100,45,55,0,0,100
19,South Sudan (UNDP),2015,SSD-15/HSS10/SA2/P/UN/619,9/28/2016 12:19:16 PM,Internally Displaced People,0,0,600,600,1200,0,0,1154,870,2024
19,South Sudan (UNDP),2015,SSD-15/HSS10/SA2/P/UN/619,9/28/2016 12:19:16 PM,Overall,0,0,600,600,1200,0,0,1154,870,2024
19,South Sudan (UNDP),2015,SSD-15/HSS10/SA2/P/UN/619,9/28/2016 12:19:16 PM,"Trainers, Promoters, Caretakers, committee members, etc.",100,100,0,0,200,125,110,0,0,235
19,South Sudan (UNDP),2015,SSD-15/HSS10/SA2/WASH/INGO/559,9/28/2016 3:41:38 PM,Overall,10625,10625,10200,11050,42500,9518,14669,13745,13745,51677
19,South Sudan (UNDP),2015,SSD-15/HSS10/SA2/WASH/INGO/579,9/28/2016 5:53:42 PM,Internally Displaced People,3666,3667,7333,7334,22000,431,1056,1080,1449,4016
19,South Sudan (UNDP),2015,SSD-15/HSS10/SA2/WASH/INGO/579,9/28/2016 5:53:42 PM,Overall,6666,6667,13333,13334,40000,8267,13672,11563,9716,43218
19,South Sudan (UNDP),2015,SSD-15/HSS10/SA2/WASH/INGO/579,9/28/2016 5:53:42 PM,People in Host Communities,4333,4334,8666,8667,26000,7836,12616,10483,8267,39202
19,South Sudan (UNDP),2015,SSD-15/HSS10/SA2/WASH/INGO/581,9/28/2016 6:04:35 PM,Internally Displaced People,3913,10565,11739,12913,39130,4936,14280,13963,14563,47742
19,South Sudan (UNDP),2015,SSD-15/HSS10/SA2/WASH/INGO/581,9/28/2016 6:04:35 PM,Overall,19999,26873,32622,33427,112921,29654,41434,43088,44972,159148
19,South Sudan (UNDP),2015,SSD-15/HSS10/SA2/WASH/INGO/581,9/28/2016 6:04:35 PM,People in Host Communities,16086,16308,20883,20514,73791,24718,27154,29125,30409,111406
19,South Sudan (UNDP),2015,SSD-15/HSS10/SA2/WASH/INGO/582,9/28/2016 12:25:00 PM,Internally Displaced People,900,1100,1400,1600,5000,1577,1882,761,1921,6141
19,South Sudan (UNDP),2015,SSD-15/HSS10/SA2/WASH/INGO/582,9/28/2016 12:25:00 PM,Overall,1800,2200,2800,3200,10000,3097,5516,1623,3906,14142
19,South Sudan (UNDP),2015,SSD-15/HSS10/SA2/WASH/INGO/582,9/28/2016 12:25:00 PM,People in Host Communities,900,1100,1400,1600,5000,1347,1368,774,1920,5409
19,South Sudan (UNDP),2015,SSD-15/HSS10/SA2/WASH/INGO/582,9/28/2016 12:25:00 PM,Pregnant and Lactating Women,0,550,0,0,550,0,2102,0,0,2102
19,South Sudan (UNDP),2015,SSD-15/HSS10/SA2/WASH/INGO/582,9/28/2016 12:25:00 PM,"Trainers, Promoters, Caretakers, committee members, etc.",24,12,15,15,66,173,164,88,65,490
19,South Sudan (UNDP),2015,SSD-15/HSS10/SA2/WASH/INGO/617,9/28/2016 3:50:24 PM,Internally Displaced People,268,321,514,771,1874,14939,14939,9959,9959,49796
19,South Sudan (UNDP),2015,SSD-15/HSS10/SA2/WASH/INGO/617,9/28/2016 3:50:24 PM,Overall,1786,2143,3428,5143,12500,4200,4200,3300,3300,15000
19,South Sudan (UNDP),2015,SSD-15/HSS10/SA2/WASH/INGO/617,9/28/2016 3:50:24 PM,People in Host Communities,1518,1822,2914,4372,10626,2636,2636,1758,1758,8788
19,South Sudan (UNDP),2015,SSD-15/HSS10/SA2/WASH/INGO/621,9/28/2016 12:25:36 PM,Internally Displaced People,3762,7726,9925,10099,31512,12783,15851,11249,11249,51132
19,South Sudan (UNDP),2015,SSD-15/HSS10/SA2/WASH/INGO/621,9/28/2016 12:25:36 PM,Overall,3762,7726,9925,10099,31512,12783,15851,11249,11249,51132
19,South Sudan (UNDP),2015,SSD-15/HSS10/SA2/WASH/INGO/632,9/28/2016 3:53:17 PM,Internally Displaced People,7800,7500,7800,6900,30000,3651,7434,5521,6015,22621
19,South Sudan (UNDP),2015,SSD-15/HSS10/SA2/WASH/INGO/632,9/28/2016 3:53:17 PM,Overall,15600,15000,15600,13800,60000,6680,13599,10101,11004,41384
19,South Sudan (UNDP),2015,SSD-15/HSS10/SA2/WASH/INGO/632,9/28/2016 3:53:17 PM,People in Host Communities,7800,7500,7800,6900,30000,3029,6165,4580,4989,18763
19,South Sudan (UNDP),2015,SSD-15/HSS10/SA2/WASH/NGO/515,12/8/2016 2:36:38 PM,Internally Displaced People,950,1200,1150,1160,4460,550,800,980,900,3230
19,South Sudan (UNDP),2015,SSD-15/HSS10/SA2/WASH/NGO/515,12/8/2016 2:36:38 PM,Overall,1500,2500,2000,2260,8260,1200,1800,1500,1980,6480
19,South Sudan (UNDP),2015,SSD-15/HSS10/SA2/WASH/NGO/515,12/8/2016 2:36:38 PM,People in Host Communities,700,1000,1050,1050,3800,800,976,820,1000,3596
19,South Sudan (UNDP),2015,SSD-15/HSS10/SA2/WASH/NGO/535,2/6/2016 10:16:16 AM,Internally Displaced People,2953,3371,3245,4448,14017,2409,2450,2379,2387,9625
19,South Sudan (UNDP),2015,SSD-15/HSS10/SA2/WASH/NGO/535,2/6/2016 10:16:16 AM,Overall,6152,6483,6762,8553,27950,8030,8165,7931,7957,32083
19,South Sudan (UNDP),2015,SSD-15/HSS10/SA2/WASH/NGO/535,2/6/2016 10:16:16 AM,People in Host Communities,3199,3112,3517,4105,13933,5621,5715,5552,5570,22458
19,South Sudan (UNDP),2015,SSD-15/HSS10/SA2/WASH/NGO/535,2/6/2016 10:16:16 AM,"Trainers, Promoters, Caretakers, committee members, etc.",140,140,0,0,280,94,200,0,0,294
19,South Sudan (UNDP),2015,SSD-15/HSS10/SA2/WASH/NGO/550,9/28/2016 3:55:50 PM,Internally Displaced People,1342,2230,989,1739,6300,1371,2127,987,1815,6300
19,South Sudan (UNDP),2015,SSD-15/HSS10/SA2/WASH/NGO/550,9/28/2016 3:55:50 PM,Other,703,1168,516,913,3300,701,1178,498,923,3300
19,South Sudan (UNDP),2015,SSD-15/HSS10/SA2/WASH/NGO/550,9/28/2016 3:55:50 PM,Overall,3195,5310,2355,4140,15000,3185,5298,2378,4139,15000
19,South Sudan (UNDP),2015,SSD-15/HSS10/SA2/WASH/NGO/550,9/28/2016 3:55:50 PM,People in Host Communities,1150,1912,848,1490,5400,1127,1933,839,1501,5400
19,South Sudan (UNDP),2015,SSD-15/HSS10/SA2/WASH/NGO/558,12/8/2016 2:39:55 PM,Internally Displaced People,4720,10680,4000,5600,25000,3021,6835,2560,3584,16000
19,South Sudan (UNDP),2015,SSD-15/HSS10/SA2/WASH/NGO/558,12/8/2016 2:39:55 PM,Overall,4720,10680,4000,5600,25000,3021,6835,2560,3584,16000
19,South Sudan (UNDP),2015,SSD-15/HSS10/SA2/WASH/NGO/605,2/6/2016 9:57:31 AM,Internally Displaced People,13236,15884,9530,14295,52945,13236,15884,9530,14295,52945
19,South Sudan (UNDP),2015,SSD-15/HSS10/SA2/WASH/NGO/605,2/6/2016 9:57:31 AM,Overall,13236,15884,9530,14295,52945,13236,15884,9530,14295,52945
19,South Sudan (UNDP),2015,SSD-15/HSS10/SA2/WASH/UN/520,9/28/2016 3:54:28 PM,Internally Displaced People,2054,6230,6920,7296,22500,2694,5389,6050,6355,20488
19,South Sudan (UNDP),2015,SSD-15/HSS10/SA2/WASH/UN/520,9/28/2016 3:54:28 PM,Overall,2739,8306,9227,9728,30000,3821,8175,9412,9945,31353
19,South Sudan (UNDP),2015,SSD-15/HSS10/SA2/WASH/UN/520,9/28/2016 3:54:28 PM,People in Host Communities,685,2076,2307,2432,7500,1127,2786,3362,3590,10865
19,South Sudan (UNDP),2015,SSD-15/HSS10/SA2/WASH/UN/598,9/28/2016 3:51:26 PM,Internally Displaced People,8499,8277,8867,9081,34724,8211,7948,8567,8774,33500
19,South Sudan (UNDP),2015,SSD-15/HSS10/SA2/WASH/UN/598,9/28/2016 3:51:26 PM,Overall,8499,8227,8867,9081,34674,8211,7948,8567,8774,33500
19,South Sudan (UNDP),2015,SSD-15/SA1/CCCM/INGO/161,2/8/2016 2:45:23 PM,Internally Displaced People,127000,128000,1000,1000,257000,127000,128000,1000,1000,257000
19,South Sudan (UNDP),2015,SSD-15/SA1/CCCM/INGO/161,2/8/2016 2:45:23 PM,Overall,177000,178000,2000,2000,359000,177000,178000,2000,2000,359000
19,South Sudan (UNDP),2015,SSD-15/SA1/CCCM/INGO/161,2/8/2016 2:45:23 PM,People in Host Communities,50000,50000,1000,1000,102000,50000,50000,1000,1000,102000
19,South Sudan (UNDP),2015,SSD-15/SA1/CCCM/INGO/281,9/7/2015 11:17:08 AM,Internally Displaced People,600,2417,1000,1000,5017,600,2417,1000,1000,5017
19,South Sudan (UNDP),2015,SSD-15/SA1/CCCM/INGO/281,9/7/2015 11:17:08 AM,Overall,600,2417,1000,1000,5017,600,2417,1000,1000,5017
19,South Sudan (UNDP),2015,SSD-15/SA1/CCCM/INGO/359,9/7/2015 11:15:57 AM,Aid Agencies,15,0,0,0,15,20,0,0,0,20
19,South Sudan (UNDP),2015,SSD-15/SA1/CCCM/INGO/359,9/7/2015 11:15:57 AM,Internally Displaced People,18564,31239,36952,40045,126800,33955,49877,7184,7162,98178
19,South Sudan (UNDP),2015,SSD-15/SA1/CCCM/INGO/359,9/7/2015 11:15:57 AM,Overall,18564,31239,36952,40045,126800,33955,49877,7184,7162,98178
19,South Sudan (UNDP),2015,SSD-15/SA1/CCCM/INGO/402,12/1/2015 11:36:09 AM,Internally Displaced People,3268,4883,4556,4690,17397,9000,12735,11250,11970,44955
19,South Sudan (UNDP),2015,SSD-15/SA1/CCCM/INGO/402,12/1/2015 11:36:09 AM,Overall,3303,4912,4567,4696,17478,9000,12735,11250,11970,44955
19,South Sudan (UNDP),2015,SSD-15/SA1/CCCM/NGO/192,9/7/2015 11:20:37 AM,Children under 5,0,0,600,870,1470,0,0,3800,3700,7500
19,South Sudan (UNDP),2015,SSD-15/SA1/CCCM/NGO/192,9/7/2015 11:20:37 AM,Overall,1000,2000,1500,2500,7000,1800,4000,3800,3700,13300
19,South Sudan (UNDP),2015,SSD-15/SA1/CCCM/NGO/192,9/7/2015 11:20:37 AM,Pregnant and Lactating Women,0,280,0,0,280,0,1000,0,0,1000
19,South Sudan (UNDP),2015,SSD-15/SA1/CCCM/UN/394,12/1/2015 10:44:40 AM,Internally Displaced People,99880,134838,134838,129844,499400,117623,158792,158792,152910,588117
19,South Sudan (UNDP),2015,SSD-15/SA1/CCCM/UN/394,12/1/2015 10:44:40 AM,Other,250,250,0,0,500,231,244,0,0,475
19,South Sudan (UNDP),2015,SSD-15/SA1/CCCM/UN/394,12/1/2015 10:44:40 AM,Overall,150180,202638,202338,194844,750000,157062,211967,211722,203880,784631
19,South Sudan (UNDP),2015,SSD-15/SA1/CCCM/UN/394,12/1/2015 10:44:40 AM,People in Host Communities,50000,67500,67500,65000,250000,39208,52931,52930,50970,196039
19,South Sudan (UNDP),2015,SSD-15/SA1/E/INGO/243,11/12/2015 10:09:48 AM,Internally Displaced People,89,45,900,1800,2834,56,24,1306,1220,2606
19,South Sudan (UNDP),2015,SSD-15/SA1/E/INGO/243,11/12/2015 10:09:48 AM,Overall,110,54,1360,2040,3564,94,40,2177,2034,4345
19,South Sudan (UNDP),2015,SSD-15/SA1/E/INGO/243,11/12/2015 10:09:48 AM,People in Host Communities,21,9,460,240,730,38,16,871,814,1739
19,South Sudan (UNDP),2015,SSD-15/SA1/E/INGO/265,10/13/2015 2:48:23 PM,Internally Displaced People,60,35,1200,700,1995,190,198,985,602,1975
19,South Sudan (UNDP),2015,SSD-15/SA1/E/INGO/265,2/8/2016 2:13:25 PM,Internally Displaced People,60,35,1200,700,1995,190,198,985,602,1975
19,South Sudan (UNDP),2015,SSD-15/SA1/E/INGO/265,10/13/2015 2:48:23 PM,Overall,135,75,2100,1400,3710,373,399,1601,997,3370
19,South Sudan (UNDP),2015,SSD-15/SA1/E/INGO/265,2/8/2016 2:13:25 PM,Overall,135,75,2100,1400,3710,373,399,1601,997,3370
19,South Sudan (UNDP),2015,SSD-15/SA1/E/INGO/265,10/13/2015 2:48:23 PM,People in Host Communities,75,40,900,700,1715,183,201,616,395,1395
19,South Sudan (UNDP),2015,SSD-15/SA1/E/INGO/265,2/8/2016 2:13:25 PM,People in Host Communities,75,40,900,700,1715,183,201,616,395,1395
19,South Sudan (UNDP),2015,SSD-15/SA1/E/INGO/282,11/25/2015 11:13:28 AM,Internally Displaced People,0,0,270,114,384,0,0,270,114,384
19,South Sudan (UNDP),2015,SSD-15/SA1/E/INGO/282,11/25/2015 11:13:28 AM,Overall,78,122,2212,1378,3790,78,122,2212,1378,3790
19,South Sudan (UNDP),2015,SSD-15/SA1/E/INGO/282,11/25/2015 11:13:28 AM,People in Host Communities,78,122,1942,1264,3406,78,122,1942,1264,3406
19,South Sudan (UNDP),2015,SSD-15/SA1/E/INGO/307,10/13/2015 2:58:15 PM,Internally Displaced People,835,464,515,282,2096,742,356,392,203,1693
19,South Sudan (UNDP),2015,SSD-15/SA1/E/INGO/307,10/13/2015 2:58:15 PM,Other,812,438,0,0,1250,503,495,0,0,998
19,South Sudan (UNDP),2015,SSD-15/SA1/E/INGO/307,10/13/2015 2:58:15 PM,Overall,1925,1056,699,376,4056,1620,1077,963,653,4313
19,South Sudan (UNDP),2015,SSD-15/SA1/E/INGO/307,10/13/2015 2:58:15 PM,People in Host Communities,278,154,94,184,710,375,226,571,450,1622
19,South Sudan (UNDP),2015,SSD-15/SA1/E/NGO/220,11/12/2015 12:04:23 PM,Children under 5,0,0,500,500,1000,0,0,536,379,915
19,South Sudan (UNDP),2015,SSD-15/SA1/E/NGO/220,11/12/2015 12:04:23 PM,Combatants and Ex-Combatants,500,500,0,0,1000,825,1,0,0,826
19,South Sudan (UNDP),2015,SSD-15/SA1/E/NGO/220,11/12/2015 12:04:23 PM,Overall,1000,1000,1000,1000,4000,1776,643,536,379,3334
19,South Sudan (UNDP),2015,SSD-15/SA1/E/NGO/220,11/12/2015 12:04:23 PM,Pregnant and Lactating Women,0,500,0,0,500,0,221,0,0,221
19,South Sudan (UNDP),2015,SSD-15/SA1/E/NGO/220,11/12/2015 12:04:23 PM,Refugee Returnees,1500,0,0,0,1500,951,421,0,0,1372
19,South Sudan (UNDP),2015,SSD-15/SA1/E/NGO/267,11/12/2015 8:56:52 AM,Children under 5,0,0,449,434,883,0,0,413,397,810
19,South Sudan (UNDP),2015,SSD-15/SA1/E/NGO/267,11/12/2015 8:56:52 AM,Internally Displaced People,107,98,3300,2065,5570,111,93,2956,1914,5074
19,South Sudan (UNDP),2015,SSD-15/SA1/E/NGO/267,11/12/2015 8:56:52 AM,Overall,188,158,4749,3980,9075,161,133,3942,2776,7012
19,South Sudan (UNDP),2015,SSD-15/SA1/E/NGO/267,11/12/2015 8:56:52 AM,People in Host Communities,41,30,1000,1481,2552,37,31,1013,997,2078
19,South Sudan (UNDP),2015,SSD-15/SA1/E/NGO/267,11/12/2015 8:56:52 AM,"Trainers, Promoters, Caretakers, committee members, etc.",188,158,32,32,410,136,123,28,23,310
19,South Sudan (UNDP),2015,SSD-15/SA1/E/NGO/268,11/12/2015 8:18:32 AM,Children under 5,0,0,200,200,400,0,0,73,38,111
19,South Sudan (UNDP),2015,SSD-15/SA1/E/NGO/268,11/12/2015 8:18:32 AM,Internally Displaced People,140,60,1300,1300,2800,96,53,1433,822,2404
19,South Sudan (UNDP),2015,SSD-15/SA1/E/NGO/268,11/12/2015 8:18:32 AM,Overall,200,75,1500,1500,3275,280,100,2208,1446,4034
19,South Sudan (UNDP),2015,SSD-15/SA1/E/NGO/268,11/12/2015 8:18:32 AM,People in Host Communities,50,10,0,0,60,121,31,702,586,1440
19,South Sudan (UNDP),2015,SSD-15/SA1/E/NGO/268,11/12/2015 8:18:32 AM,"Trainers, Promoters, Caretakers, committee members, etc.",10,5,0,0,15,63,16,0,0,79
19,South Sudan (UNDP),2015,SSD-15/SA1/E/NGO/339,12/1/2015 2:07:20 PM,Internally Displaced People,15,15,700,885,1615,15,15,1057,528,1615
19,South Sudan (UNDP),2015,SSD-15/SA1/E/NGO/339,12/1/2015 2:07:20 PM,Other,10,10,400,200,620,10,10,500,100,620
19,South Sudan (UNDP),2015,SSD-15/SA1/E/NGO/339,12/1/2015 2:07:20 PM,Overall,40,40,2175,2102,4357,50,30,2918,1359,4357
19,South Sudan (UNDP),2015,SSD-15/SA1/E/NGO/339,12/1/2015 2:07:20 PM,People in Host Communities,15,15,1075,1015,2120,15,15,1359,731,2120
19,South Sudan (UNDP),2015,SSD-15/SA1/E/UN/287,2/8/2016 1:32:51 PM,Internally Displaced People,336,182,22851,15241,38610,414,225,28189,18801,47629
19,South Sudan (UNDP),2015,SSD-15/SA1/E/UN/287,2/8/2016 1:32:51 PM,Overall,480,260,32730,21830,55300,516,286,42725,22903,66430
19,South Sudan (UNDP),2015,SSD-15/SA1/E/UN/287,2/8/2016 1:32:51 PM,People in Host Communities,96,52,6606,4406,11160,95,51,6513,4344,11003
19,South Sudan (UNDP),2015,SSD-15/SA1/E/UN/287,2/8/2016 1:32:51 PM,Refugee Returnees,48,26,3273,2183,5530,68,37,4615,3078,7798
19,South Sudan (UNDP),2015,SSD-15/SA1/E/UN/293,2/2/2016 12:26:33 PM,Internally Displaced People,100,40,4000,3000,7140,35,16,512,94,657
19,South Sudan (UNDP),2015,SSD-15/SA1/E/UN/293,2/2/2016 12:26:33 PM,Overall,140,60,4680,3120,8000,108,29,3260,1666,5063
19,South Sudan (UNDP),2015,SSD-15/SA1/E/UN/293,2/2/2016 12:26:33 PM,People in Host Communities,40,20,680,120,860,73,13,2748,1572,4406
19,South Sudan (UNDP),2015,SSD-15/SA1/ETC/UN/251,2/4/2016 2:14:34 PM,Aid Agencies,150,0,0,0,150,0,0,0,0,0
19,South Sudan (UNDP),2015,SSD-15/SA1/ETC/UN/251,2/4/2016 2:14:34 PM,Overall,1,0,0,0,1,0,0,0,0,0
19,South Sudan (UNDP),2015,SSD-15/SA1/FSL/INGO/233,9/8/2016 8:03:25 AM,Internally Displaced People,10046,6427,11477,6119,34069,5306,4741,6530,4225,20802
19,South Sudan (UNDP),2015,SSD-15/SA1/FSL/INGO/233,9/8/2016 8:03:25 AM,Overall,30443,35704,44144,26040,136331,20213,16824,25829,23205,86071
19,South Sudan (UNDP),2015,SSD-15/SA1/FSL/INGO/233,9/8/2016 8:03:25 AM,"Trainers, Promoters, Caretakers, committee members, etc.",50,10,0,0,60,53,7,0,0,60
19,South Sudan (UNDP),2015,SSD-15/SA1/FSL/INGO/242,1/26/2017 9:22:39 AM,Internally Displaced People,3927,3653,6993,6427,21000,2853,2654,5081,4670,15258
19,South Sudan (UNDP),2015,SSD-15/SA1/FSL/INGO/242,1/26/2017 9:22:39 AM,Overall,7854,7306,13986,12854,42000,6705,10125,10233,10119,37182
19,South Sudan (UNDP),2015,SSD-15/SA1/FSL/INGO/242,1/26/2017 9:22:39 AM,People in Host Communities,3927,3653,6993,6427,21000,4100,3815,7300,6709,21924
19,South Sudan (UNDP),2015,SSD-15/SA1/FSL/INGO/275,2/4/2016 11:37:09 AM,Internally Displaced People,372,400,315,292,1379,651,610,585,656,2502
19,South Sudan (UNDP),2015,SSD-15/SA1/FSL/INGO/275,2/4/2016 11:37:09 AM,Overall,13830,14854,11720,10818,51222,13379,14007,12049,12040,51475
19,South Sudan (UNDP),2015,SSD-15/SA1/FSL/INGO/275,2/4/2016 11:37:09 AM,People in Host Communities,13458,14454,11404,10526,49842,12728,13397,11464,11384,48973
19,South Sudan (UNDP),2015,SSD-15/SA1/FSL/INGO/310,10/13/2015 3:10:46 PM,Internally Displaced People,585,465,0,0,1050,565,485,0,0,1050
19,South Sudan (UNDP),2015,SSD-15/SA1/FSL/INGO/310,10/13/2015 3:10:46 PM,Overall,780,620,0,0,1400,754,646,0,0,1400
19,South Sudan (UNDP),2015,SSD-15/SA1/FSL/INGO/310,10/13/2015 3:10:46 PM,People in Host Communities,195,155,0,0,350,189,161,0,0,350
19,South Sudan (UNDP),2015,SSD-15/SA1/FSL/INGO/396,2/8/2016 1:02:33 PM,Internally Displaced People,2341,1099,562,436,4438,2151,621,302,170,3244
19,South Sudan (UNDP),2015,SSD-15/SA1/FSL/INGO/396,2/8/2016 1:02:33 PM,Overall,7804,3662,1872,1452,14790,7171,2070,1006,567,10814
19,South Sudan (UNDP),2015,SSD-15/SA1/FSL/INGO/396,2/8/2016 1:02:33 PM,Pastoralists,5463,2563,1310,1016,10352,5019,1449,704,397,7569
19,South Sudan (UNDP),2015,SSD-15/SA1/FSL/NGO/210,2/4/2016 11:24:28 AM,Internally Displaced People,4000,8000,2500,3000,17500,5290,5438,0,0,10728
19,South Sudan (UNDP),2015,SSD-15/SA1/FSL/NGO/210,2/4/2016 11:24:28 AM,Overall,10000,15000,4000,6000,35000,16784,8985,0,0,25769
19,South Sudan (UNDP),2015,SSD-15/SA1/FSL/NGO/210,2/4/2016 11:24:28 AM,People in Host Communities,6000,7000,200,2500,15700,5290,5890,0,0,11180
19,South Sudan (UNDP),2015,SSD-15/SA1/FSL/NGO/423,2/4/2016 11:26:00 AM,Internally Displaced People,4286,4748,1758,3034,13826,3653,4900,2416,2991,13960
19,South Sudan (UNDP),2015,SSD-15/SA1/FSL/NGO/423,2/4/2016 11:26:00 AM,Overall,5272,9496,3515,4069,22352,5184,9531,3532,4418,22665
19,South Sudan (UNDP),2015,SSD-15/SA1/FSL/NGO/423,2/4/2016 11:26:00 AM,People in Host Communities,2389,4723,876,538,8526,1531,4631,1116,1427,8705
19,South Sudan (UNDP),2015,SSD-15/SA1/FSL/UN/147,8/1/2016 1:08:37 PM,Internally Displaced People,16687,18992,0,0,35679,0,0,0,0,0
19,South Sudan (UNDP),2015,SSD-15/SA1/FSL/UN/147,8/1/2016 1:08:37 PM,Other,5000,5000,0,0,10000,0,0,0,0,0
19,South Sudan (UNDP),2015,SSD-15/SA1/FSL/UN/147,8/1/2016 1:08:37 PM,Overall,38375,42983,0,0,81358,144072,132989,149613,121907,548581
19,South Sudan (UNDP),2015,SSD-15/SA1/FSL/UN/147,8/1/2016 1:08:37 PM,People in Host Communities,16687,18992,0,0,35679,0,0,0,0,0
19,South Sudan (UNDP),2015,SSD-15/SA1/FSL/UN/244,2/8/2016 1:03:14 PM,Internally Displaced People,10884,24987,25569,32560,94000,6237,17469,22707,24523,70936
19,South Sudan (UNDP),2015,SSD-15/SA1/FSL/UN/244,2/8/2016 1:03:14 PM,Overall,10884,24987,25569,32560,94000,6237,17469,22707,24523,70936
19,South Sudan (UNDP),2015,SSD-15/SA1/H/INGO/166,9/16/2015 7:31:37 AM,Internally Displaced People,1552,2328,835,1252,5967,1025,1538,552,827,3942
19,South Sudan (UNDP),2015,SSD-15/SA1/H/INGO/166,11/23/2015 6:58:33 AM,Internally Displaced People,1552,2328,835,1252,5967,1967,3295,2645,2735,10642
19,South Sudan (UNDP),2015,SSD-15/SA1/H/INGO/166,9/16/2015 7:31:37 AM,Overall,5174,7661,2786,4279,19900,3417,5126,1833,2759,13135
19,South Sudan (UNDP),2015,SSD-15/SA1/H/INGO/166,11/23/2015 6:58:33 AM,Overall,5174,7661,2786,4279,19900,4919,8238,6612,6838,26607
19,South Sudan (UNDP),2015,SSD-15/SA1/H/INGO/166,9/16/2015 7:31:37 AM,People in Host Communities,3622,5433,1940,2925,13920,2392,3588,1281,1932,9193
19,South Sudan (UNDP),2015,SSD-15/SA1/H/INGO/166,11/23/2015 6:58:33 AM,People in Host Communities,3622,5433,1940,2925,13920,2951,4943,3967,4103,15964
19,South Sudan (UNDP),2015,SSD-15/SA1/H/INGO/216,9/16/2015 8:07:29 AM,Internally Displaced People,8552,11973,6842,6842,34209,12214,17109,10651,9879,49853
19,South Sudan (UNDP),2015,SSD-15/SA1/H/INGO/216,9/16/2015 8:07:29 AM,Overall,24434,34208,19547,19547,97736,42561,55193,24087,26386,148227
19,South Sudan (UNDP),2015,SSD-15/SA1/H/INGO/216,9/16/2015 8:07:29 AM,People in Host Communities,15882,22235,12706,12706,63529,30347,38084,13436,16507,98374
19,South Sudan (UNDP),2015,SSD-15/SA1/H/INGO/314,10/13/2015 2:52:43 PM,Internally Displaced People,3332,3204,3332,2947,12815,19925,19143,8521,8186,55775
19,South Sudan (UNDP),2015,SSD-15/SA1/H/INGO/314,10/13/2015 2:52:43 PM,Overall,3332,3204,3332,2947,12815,19925,19143,8521,8186,55775
19,South Sudan (UNDP),2015,SSD-15/SA1/H/INGO/322,9/9/2015 6:46:22 AM,Combatants and Ex-Combatants,500,0,0,0,500,58,0,0,0,58
19,South Sudan (UNDP),2015,SSD-15/SA1/H/INGO/322,9/9/2015 6:46:22 AM,Internally Displaced People,15447,60651,10639,10228,96965,161220,57162,12418,13115,243915
19,South Sudan (UNDP),2015,SSD-15/SA1/H/INGO/322,9/9/2015 6:46:22 AM,Overall,157470,60651,10639,10228,238988,161220,57162,12418,13115,243915
19,South Sudan (UNDP),2015,SSD-15/SA1/H/INGO/369,9/14/2015 2:37:29 PM,Overall,10551,15825,13187,13187,52750,43878,54274,15103,15082,128337
19,South Sudan (UNDP),2015,SSD-15/SA1/H/INGO/390,9/16/2015 9:09:27 AM,Internally Displaced People,3500,5400,2500,1600,13000,3647,4959,2345,1597,12548
19,South Sudan (UNDP),2015,SSD-15/SA1/H/INGO/390,9/16/2015 9:09:27 AM,Overall,7500,11800,5200,3800,28300,5380,7184,4983,3776,21323
19,South Sudan (UNDP),2015,SSD-15/SA1/H/INGO/390,9/16/2015 9:09:27 AM,People in Host Communities,4000,6400,2700,2200,15300,4300,5938,2344,2187,14769
19,South Sudan (UNDP),2015,SSD-15/SA1/H/INGO/391,1/28/2016 7:42:56 AM,Internally Displaced People,1501,1563,399,415,3878,853,1539,450,513,3355
19,South Sudan (UNDP),2015,SSD-15/SA1/H/INGO/391,1/28/2016 7:42:56 AM,Overall,12542,13054,3401,3539,32536,3146,4343,1584,1649,10722
19,South Sudan (UNDP),2015,SSD-15/SA1/H/INGO/391,1/28/2016 7:42:56 AM,People in Host Communities,11041,11491,3002,3124,28658,2293,2803,1134,1137,7367
19,South Sudan (UNDP),2015,SSD-15/SA1/H/INGO/411,9/16/2015 8:25:07 AM,Overall,3447,7589,4500,4815,20351,2362,2711,1235,1170,7478
19,South Sudan (UNDP),2015,SSD-15/SA1/H/NGO/167,11/23/2015 7:19:54 AM,Children under 5,0,0,6000,6000,12000,0,0,5272,5388,10660
19,South Sudan (UNDP),2015,SSD-15/SA1/H/NGO/167,11/23/2015 7:19:54 AM,Internally Displaced People,8000,34000,1000,760,43760,7139,14230,4270,4083,29722
19,South Sudan (UNDP),2015,SSD-15/SA1/H/NGO/167,11/23/2015 7:19:54 AM,Other,11480,25000,820,700,38000,548,840,335,333,2056
19,South Sudan (UNDP),2015,SSD-15/SA1/H/NGO/167,11/23/2015 7:19:54 AM,Overall,21480,81800,8670,8050,120000,16106,41818,5754,5911,69589
19,South Sudan (UNDP),2015,SSD-15/SA1/H/NGO/167,11/23/2015 7:19:54 AM,People in Host Communities,2000,23000,650,590,26240,2350,19764,1147,1490,24751
19,South Sudan (UNDP),2015,SSD-15/SA1/H/NGO/223,9/15/2015 8:56:15 AM,Children under 5,0,0,12460,12460,24920,0,0,9910,10050,19960
19,South Sudan (UNDP),2015,SSD-15/SA1/H/NGO/223,9/15/2015 8:56:15 AM,Internally Displaced People,6167,6167,6167,6167,24668,4300,5100,3200,4405,17005
19,South Sudan (UNDP),2015,SSD-15/SA1/H/NGO/223,9/15/2015 8:56:15 AM,Overall,22400,29000,12460,12460,76320,19300,18960,9950,10080,58290
19,South Sudan (UNDP),2015,SSD-15/SA1/H/NGO/223,9/15/2015 8:56:15 AM,People in Host Communities,6167,6167,6167,6167,24668,5100,6710,4005,3900,19715
19,South Sudan (UNDP),2015,SSD-15/SA1/H/NGO/223,9/15/2015 8:56:15 AM,Pregnant and Lactating Women,0,2060,0,0,2060,0,1610,0,0,1610
19,South Sudan (UNDP),2015,SSD-15/SA1/H/NGO/234,9/16/2015 7:50:40 AM,Children under 5,0,0,0,0,0,0,0,8750,8750,17500
19,South Sudan (UNDP),2015,SSD-15/SA1/H/NGO/234,9/16/2015 7:50:40 AM,Overall,20864,27126,29400,29580,106970,12550,12550,8750,8750,42600
19,South Sudan (UNDP),2015,SSD-15/SA1/H/NGO/245,9/9/2015 6:12:20 AM,Children under 5,0,0,6250,6250,12500,0,0,7023,7323,14346
19,South Sudan (UNDP),2015,SSD-15/SA1/H/NGO/245,9/9/2015 6:12:20 AM,Overall,8792,16956,19468,17584,62800,10084,16846,7023,7323,41276
19,South Sudan (UNDP),2015,SSD-15/SA1/H/NGO/245,9/9/2015 6:12:20 AM,People in Host Communities,8792,16956,0,0,25748,10084,16846,0,0,26930
19,South Sudan (UNDP),2015,SSD-15/SA1/H/NGO/245,9/9/2015 6:12:20 AM,Pregnant and Lactating Women,0,2512,0,0,2512,0,698,0,0,698
19,South Sudan (UNDP),2015,SSD-15/SA1/H/NGO/341,9/9/2015 6:42:29 AM,Internally Displaced People,5892,6785,2726,2726,18129,3539,7936,1948,4157,17580
19,South Sudan (UNDP),2015,SSD-15/SA1/H/NGO/341,9/9/2015 6:42:29 AM,Overall,19640,22615,9087,9087,60429,16850,23600,7800,10200,58450
19,South Sudan (UNDP),2015,SSD-15/SA1/H/NGO/341,9/9/2015 6:42:29 AM,People in Host Communities,13748,15830,6361,6361,42300,13311,15664,5852,6043,40870
19,South Sudan (UNDP),2015,SSD-15/SA1/H/NGO/346,9/16/2015 9:21:41 AM,Internally Displaced People,16920,32900,22310,21870,94000,17625,29782,24650,23461,95518
19,South Sudan (UNDP),2015,SSD-15/SA1/H/NGO/346,9/16/2015 9:21:41 AM,Overall,16920,32900,22310,21870,94000,18330,29782,26990,25052,100154
19,South Sudan (UNDP),2015,SSD-15/SA1/H/NGO/346,9/16/2015 9:21:41 AM,People in Host Communities,0,0,0,0,0,705,0,2340,1591,4636
19,South Sudan (UNDP),2015,SSD-15/SA1/H/UN/195,9/9/2015 5:59:04 AM,Internally Displaced People,0,28204,259819,270424,558447,0,43896,229100,238452,511448
19,South Sudan (UNDP),2015,SSD-15/SA1/H/UN/195,9/9/2015 5:59:04 AM,Overall,0,59639,549402,571826,1180867,0,98820,484446,504219,1087485
19,South Sudan (UNDP),2015,SSD-15/SA1/H/UN/195,9/9/2015 5:59:04 AM,People in Host Communities,0,31435,289583,301402,622420,0,48924,255346,265767,570037
19,South Sudan (UNDP),2015,SSD-15/SA1/H/UN/255,9/14/2015 12:28:04 PM,Children under 5,27896,26803,0,0,54699,16779,23452,0,0,40231
19,South Sudan (UNDP),2015,SSD-15/SA1/H/UN/255,9/14/2015 12:28:04 PM,Internally Displaced People,31451,31457,0,0,62908,61222,46897,0,0,108119
19,South Sudan (UNDP),2015,SSD-15/SA1/H/UN/255,9/14/2015 12:28:04 PM,Overall,31457,30223,27896,26803,116379,69436,65442,61556,70896,267330
19,South Sudan (UNDP),2015,SSD-15/SA1/H/UN/255,9/14/2015 12:28:04 PM,People in Host Communities,0,0,0,0,0,78031,78013,0,0,156044
19,South Sudan (UNDP),2015,SSD-15/SA1/H/UN/356,10/13/2015 2:59:58 PM,Children under 5,0,0,11631,11175,22806,0,0,9566,11234,20800
19,South Sudan (UNDP),2015,SSD-15/SA1/H/UN/356,10/13/2015 2:59:58 PM,Internally Displaced People,29355,28203,0,0,57558,28796,27685,0,0,56481
19,South Sudan (UNDP),2015,SSD-15/SA1/H/UN/356,10/13/2015 2:59:58 PM,Overall,29355,28203,26031,25011,108600,26700,27584,24536,23567,102387
19,South Sudan (UNDP),2015,SSD-15/SA1/H/UN/356,10/13/2015 2:59:58 PM,People in Host Communities,14400,13836,0,0,28236,1234,13456,0,0,14690
19,South Sudan (UNDP),2015,SSD-15/SA1/H/UN/387,2/4/2016 9:37:30 AM,Internally Displaced People,34251,35648,8389,9086,87374,45753,158659,120286,44277,368975
19,South Sudan (UNDP),2015,SSD-15/SA1/H/UN/387,2/4/2016 9:37:30 AM,Overall,34251,35648,8389,9086,87374,45753,158659,120286,44277,368975
19,South Sudan (UNDP),2015,SSD-15/SA1/H/UN/426,10/13/2015 3:01:48 PM,Internally Displaced People,80000,300000,40000,50000,470000,82000,301000,45000,49100,477100
19,South Sudan (UNDP),2015,SSD-15/SA1/H/UN/426,10/13/2015 3:01:48 PM,Other,10000,100000,5000,5000,120000,6100,99000,8100,20800,134000
19,South Sudan (UNDP),2015,SSD-15/SA1/H/UN/426,10/13/2015 3:01:48 PM,Overall,100000,420000,50000,60000,630000,97200,421000,58000,75000,651200
19,South Sudan (UNDP),2015,SSD-15/SA1/H/UN/426,10/13/2015 3:01:48 PM,Refugee Returnees,10000,20000,5000,5000,40000,9100,21000,4900,5100,40100
19,South Sudan (UNDP),2015,SSD-15/SA1/L/UN/291,2/8/2016 6:30:00 AM,Aid Agencies,23,0,0,0,23,23,0,0,0,23
19,South Sudan (UNDP),2015,SSD-15/SA1/L/UN/291,2/8/2016 6:30:00 AM,Internally Displaced People,29600,20200,23400,16950,90150,29600,20200,23400,16950,90150
19,South Sudan (UNDP),2015,SSD-15/SA1/L/UN/291,2/8/2016 6:30:00 AM,Overall,23,0,0,0,23,23,0,0,0,23
19,South Sudan (UNDP),2015,SSD-15/SA1/L/UN/291,2/8/2016 6:30:00 AM,People in Host Communities,1800,2500,1000,1600,6900,1800,2500,1000,1600,6900
19,South Sudan (UNDP),2015,SSD-15/SA1/L/UN/291,2/8/2016 6:30:00 AM,Refugee Returnees,2700,1950,800,1100,6550,2700,1950,800,1100,6550
19,South Sudan (UNDP),2015,SSD-15/SA1/L/UN/320,2/4/2016 1:09:17 PM,Aid Agencies,80,0,0,0,80,80,0,0,0,80
19,South Sudan (UNDP),2015,SSD-15/SA1/N/INGO/338,2/8/2016 1:13:16 PM,Children under 5,0,0,2894,2672,5566,0,0,1058,1218,2276
19,South Sudan (UNDP),2015,SSD-15/SA1/N/INGO/338,2/8/2016 1:13:16 PM,Internally Displaced People,50,111,724,666,1551,10,20,1292,1391,2713
19,South Sudan (UNDP),2015,SSD-15/SA1/N/INGO/338,2/8/2016 1:13:16 PM,Overall,50,1110,3340,3618,8118,10,405,1058,1218,2691
19,South Sudan (UNDP),2015,SSD-15/SA1/N/INGO/338,2/8/2016 1:13:16 PM,Pregnant and Lactating Women,0,999,0,0,999,0,405,0,0,405
19,South Sudan (UNDP),2015,SSD-15/SA1/N/INGO/345,11/10/2015 5:51:22 AM,Overall,525,21085,28250,28250,78110,1323,13070,6686,6330,27409
19,South Sudan (UNDP),2015,SSD-15/SA1/N/INGO/362,2/8/2016 1:14:17 PM,Internally Displaced People,20,1099,2475,2475,6069,2100,3595,1816,1150,8661
19,South Sudan (UNDP),2015,SSD-15/SA1/N/INGO/362,2/8/2016 1:14:17 PM,Overall,30,1456,3300,3300,8086,765,2552,2028,1456,6801
19,South Sudan (UNDP),2015,SSD-15/SA1/N/INGO/362,2/8/2016 1:14:17 PM,People in Host Communities,10,367,825,825,2027,300,2004,212,306,2822
19,South Sudan (UNDP),2015,SSD-15/SA1/N/INGO/365,2/3/2016 1:04:51 PM,Children under 5,0,0,220,880,1100,0,0,5656,5557,11213
19,South Sudan (UNDP),2015,SSD-15/SA1/N/INGO/365,2/3/2016 1:04:51 PM,Internally Displaced People,146,583,10606,11039,22374,1416,5492,3756,3690,14354
19,South Sudan (UNDP),2015,SSD-15/SA1/N/INGO/365,2/3/2016 1:04:51 PM,Overall,220,880,15999,16652,33751,2132,8271,5656,5557,21616
19,South Sudan (UNDP),2015,SSD-15/SA1/N/INGO/365,2/3/2016 1:04:51 PM,People in Host Communities,74,297,5393,5613,11377,716,2779,1900,1867,7262
19,South Sudan (UNDP),2015,SSD-15/SA1/N/INGO/365,2/3/2016 1:04:51 PM,Pregnant and Lactating Women,0,666,0,0,666,0,3228,0,0,3228
19,South Sudan (UNDP),2015,SSD-15/SA1/N/INGO/368,11/10/2015 5:40:43 AM,Internally Displaced People,3037,928,2474,2681,9120,665,7575,2211,2395,12846
19,South Sudan (UNDP),2015,SSD-15/SA1/N/INGO/368,11/10/2015 5:40:43 AM,Overall,7440,29260,34470,32198,103368,5542,63131,31579,34210,134462
19,South Sudan (UNDP),2015,SSD-15/SA1/N/INGO/368,11/10/2015 5:40:43 AM,People in Host Communities,6512,26223,31789,29724,94248,4877,55555,29369,31815,121616
19,South Sudan (UNDP),2015,SSD-15/SA1/N/INGO/379,2/4/2016 12:42:57 PM,Internally Displaced People,482,397,918,1035,2832,23,945,1150,1168,3286
19,South Sudan (UNDP),2015,SSD-15/SA1/N/INGO/379,2/4/2016 12:42:57 PM,Overall,3195,2667,6117,6897,18876,155,6351,7664,7784,21954
19,South Sudan (UNDP),2015,SSD-15/SA1/N/INGO/379,2/4/2016 12:42:57 PM,People in Host Communities,2728,2246,5868,5203,16045,132,5348,7352,5782,18614
19,South Sudan (UNDP),2015,SSD-15/SA1/N/INGO/392,1/29/2016 12:55:42 PM,Internally Displaced People,220,20154,5320,3522,29216,352,12978,8220,6948,28498
19,South Sudan (UNDP),2015,SSD-15/SA1/N/INGO/392,1/29/2016 12:55:42 PM,Overall,560,39504,14570,11842,66476,865,27903,18506,18534,65808
19,South Sudan (UNDP),2015,SSD-15/SA1/N/INGO/392,1/29/2016 12:55:42 PM,People in Host Communities,340,19450,9250,8320,37360,513,14925,10286,11586,37310
19,South Sudan (UNDP),2015,SSD-15/SA1/N/NGO/250,1/29/2016 12:49:01 PM,Children under 5,0,0,4746,4747,9493,0,0,8494,6719,15213
19,South Sudan (UNDP),2015,SSD-15/SA1/N/NGO/250,1/29/2016 12:49:01 PM,Internally Displaced People,964,2250,0,0,3214,930,1351,0,0,2281
19,South Sudan (UNDP),2015,SSD-15/SA1/N/NGO/250,1/29/2016 12:49:01 PM,Overall,1928,4500,4746,4746,15920,2246,5822,8494,6719,23281
19,South Sudan (UNDP),2015,SSD-15/SA1/N/NGO/250,1/29/2016 12:49:01 PM,People in Host Communities,964,1887,0,0,2851,1316,2057,0,0,3373
19,South Sudan (UNDP),2015,SSD-15/SA1/N/NGO/250,1/29/2016 12:49:01 PM,Pregnant and Lactating Women,0,364,0,0,364,0,2414,0,0,2414
19,South Sudan (UNDP),2015,SSD-15/SA1/N/NGO/342,11/10/2015 5:44:33 AM,Internally Displaced People,370,1659,2314,2402,6745,1022,1296,5140,4975,12433
19,South Sudan (UNDP),2015,SSD-15/SA1/N/NGO/342,11/10/2015 5:44:33 AM,Overall,1234,5530,7713,8008,22485,2556,3240,12852,12439,31087
19,South Sudan (UNDP),2015,SSD-15/SA1/N/NGO/342,11/10/2015 5:44:33 AM,People in Host Communities,864,3871,5399,5606,15740,1534,1944,7712,7464,18654
19,South Sudan (UNDP),2015,SSD-15/SA1/N/UN/214,2/4/2016 12:00:46 PM,Children under 5,0,0,8204,10260,18464,0,0,8200,10264,18464
19,South Sudan (UNDP),2015,SSD-15/SA1/N/UN/214,2/4/2016 12:00:46 PM,Internally Displaced People,0,0,2633,4035,6668,0,0,2619,4040,6659
19,South Sudan (UNDP),2015,SSD-15/SA1/N/UN/214,2/4/2016 12:00:46 PM,Overall,0,0,8204,10260,18464,0,0,8200,10264,18464
19,South Sudan (UNDP),2015,SSD-15/SA1/N/UN/214,2/4/2016 12:00:46 PM,People in Host Communities,0,0,5571,6225,11796,0,0,5581,6224,11805
19,South Sudan (UNDP),2015,SSD-15/SA1/N/UN/256,11/10/2015 5:42:37 AM,Children under 5,0,0,10669,11105,21774,0,0,10769,11005,21774
19,South Sudan (UNDP),2015,SSD-15/SA1/N/UN/256,11/10/2015 5:42:37 AM,Overall,0,0,10669,11105,21774,0,0,10769,11005,21774
19,South Sudan (UNDP),2015,SSD-15/SA1/N/UN/303,2/4/2016 11:01:35 AM,Overall,0,21334,0,0,21334,0,26165,0,0,26165
19,South Sudan (UNDP),2015,SSD-15/SA1/N/UN/303,2/4/2016 11:01:35 AM,Pregnant and Lactating Women,0,21334,0,0,21334,0,26165,0,0,26165
19,South Sudan (UNDP),2015,SSD-15/SA1/N/UN/374,11/10/2015 5:41:05 AM,Children under 5,0,0,95625,91875,187500,0,0,88362,85464,173826
19,South Sudan (UNDP),2015,SSD-15/SA1/N/UN/374,11/10/2015 5:41:05 AM,Overall,0,75000,95625,91875,262500,0,77910,88362,85464,251736
19,South Sudan (UNDP),2015,SSD-15/SA1/N/UN/374,11/10/2015 5:41:05 AM,Pregnant and Lactating Women,0,75000,0,0,75000,0,77910,0,0,77910
19,South Sudan (UNDP),2015,SSD-15/SA1/NFI/INGO/222,12/3/2015 10:45:50 AM,Internally Displaced People,8363,11709,3828,9554,33454,6299,8168,9874,11167,35508
19,South Sudan (UNDP),2015,SSD-15/SA1/NFI/INGO/222,12/3/2015 10:45:50 AM,Overall,10454,14636,4785,11943,41818,6299,8168,9874,11167,35508
19,South Sudan (UNDP),2015,SSD-15/SA1/NFI/INGO/222,12/3/2015 10:45:50 AM,People in Host Communities,2091,2927,957,2389,8364,0,0,0,0,0
19,South Sudan (UNDP),2015,SSD-15/SA1/NFI/INGO/294,12/1/2015 10:40:46 AM,Internally Displaced People,5400,12600,9000,9000,36000,6722,12064,6722,12063,37571
19,South Sudan (UNDP),2015,SSD-15/SA1/NFI/INGO/294,12/1/2015 10:40:46 AM,Overall,6000,14000,10000,10000,40000,6722,12058,6722,12059,37561
19,South Sudan (UNDP),2015,SSD-15/SA1/NFI/INGO/294,12/1/2015 10:40:46 AM,People in Host Communities,600,1400,1000,1000,4000,0,0,0,0,0
19,South Sudan (UNDP),2015,SSD-15/SA1/NFI/INGO/308,2/3/2016 12:46:17 PM,Internally Displaced People,15190,19784,3798,4946,43718,19702,25331,5067,6192,56292
19,South Sudan (UNDP),2015,SSD-15/SA1/NFI/INGO/308,2/3/2016 12:46:17 PM,Overall,15190,19784,3798,4946,43718,19702,25331,5067,6192,56292
19,South Sudan (UNDP),2015,SSD-15/SA1/NFI/INGO/321,2/5/2016 9:27:43 AM,Overall,5400,8100,6750,6750,27000,20009,25878,802,2127,48816
19,South Sudan (UNDP),2015,SSD-15/SA1/NFI/NGO/300,9/1/2016 3:23:31 PM,Internally Displaced People,7200,10300,8000,12000,37500,2100,3300,2500,2700,10600
19,South Sudan (UNDP),2015,SSD-15/SA1/NFI/NGO/300,9/1/2016 3:23:31 PM,Other,60,100,80,120,360,0,0,0,0,0
19,South Sudan (UNDP),2015,SSD-15/SA1/NFI/NGO/300,9/1/2016 3:23:31 PM,Overall,1200,2300,2000,2000,7500,2100,3300,2500,2700,10600
19,South Sudan (UNDP),2015,SSD-15/SA1/NFI/UN/326,2/4/2016 11:43:31 AM,Internally Displaced People,26115,43525,71815,76165,217620,28211,47020,77581,82282,235094
19,South Sudan (UNDP),2015,SSD-15/SA1/NFI/UN/326,2/4/2016 11:43:31 AM,Overall,28080,46805,77220,81895,234000,30334,50560,83420,88476,252790
19,South Sudan (UNDP),2015,SSD-15/SA1/NFI/UN/326,2/4/2016 11:43:31 AM,People in Host Communities,1965,3280,5405,5730,16380,1974,3293,5430,5759,16456
19,South Sudan (UNDP),2015,SSD-15/SA1/NFI/UN/336,2/4/2016 11:42:32 AM,Internally Displaced People,3260,7607,10143,15215,36225,3260,7607,10143,15215,36225
19,South Sudan (UNDP),2015,SSD-15/SA1/NFI/UN/336,2/4/2016 11:42:32 AM,Overall,3622,8453,11270,16905,40250,3622,8453,11270,16905,40250
19,South Sudan (UNDP),2015,SSD-15/SA1/NFI/UN/336,2/4/2016 11:42:32 AM,People in Host Communities,362,845,1127,1691,4025,362,845,1127,1691,4025
19,South Sudan (UNDP),2015,SSD-15/SA1/P/INGO/157,9/16/2015 7:37:14 AM,Children under 5,0,0,9000,11000,20000,0,0,22613,24868,47481
19,South Sudan (UNDP),2015,SSD-15/SA1/P/INGO/157,9/16/2015 7:37:14 AM,Internally Displaced People,12000,40000,20000,20000,92000,68724,79677,47784,49996,246181
19,South Sudan (UNDP),2015,SSD-15/SA1/P/INGO/157,9/16/2015 7:37:14 AM,Overall,13000,44500,21500,25000,104000,77689,90071,54019,56518,278297
19,South Sudan (UNDP),2015,SSD-15/SA1/P/INGO/157,9/16/2015 7:37:14 AM,People in Host Communities,1000,4500,1500,5000,12000,8965,10394,6234,6522,32115
19,South Sudan (UNDP),2015,SSD-15/SA1/P/INGO/157,9/16/2015 7:37:14 AM,Pregnant and Lactating Women,0,5000,0,0,5000,0,10120,0,0,10120
19,South Sudan (UNDP),2015,SSD-15/SA1/P/INGO/316,2/3/2016 11:50:51 AM,Internally Displaced People,900,1510,1625,1070,5105,0,0,0,0,0
19,South Sudan (UNDP),2015,SSD-15/SA1/P/INGO/316,2/3/2016 11:50:51 AM,Overall,1034,2101,1870,1580,6585,1332,7320,5437,8557,22646
19,South Sudan (UNDP),2015,SSD-15/SA1/P/INGO/316,2/3/2016 11:50:51 AM,People in Host Communities,134,591,510,245,1480,1332,7320,5437,8557,22646
19,South Sudan (UNDP),2015,SSD-15/SA1/P/INGO/324,2/3/2016 12:41:08 PM,Children under 5,0,0,350,350,700,0,0,486,472,958
19,South Sudan (UNDP),2015,SSD-15/SA1/P/INGO/324,2/3/2016 12:41:08 PM,Internally Displaced People,1080,1080,1620,1620,5400,572,1363,1625,1392,4952
19,South Sudan (UNDP),2015,SSD-15/SA1/P/INGO/324,2/3/2016 12:41:08 PM,Overall,1200,1200,1800,1800,6000,715,1704,2032,1740,6191
19,South Sudan (UNDP),2015,SSD-15/SA1/P/INGO/324,2/3/2016 12:41:08 PM,People in Host Communities,120,120,180,180,600,143,341,407,348,1239
19,South Sudan (UNDP),2015,SSD-15/SA1/P/INGO/324,2/3/2016 12:41:08 PM,"Trainers, Promoters, Caretakers, committee members, etc.",182,435,0,0,617,220,450,0,0,670
19,South Sudan (UNDP),2015,SSD-15/SA1/P/INGO/385,10/13/2015 11:11:12 AM,Internally Displaced People,1272,1602,2184,2733,7791,1865,1794,2060,1213,6932
19,South Sudan (UNDP),2015,SSD-15/SA1/P/INGO/385,10/13/2015 11:11:12 AM,Overall,1590,2002,2730,3416,9738,2243,2331,2575,1516,8665
19,South Sudan (UNDP),2015,SSD-15/SA1/P/INGO/385,10/13/2015 11:11:12 AM,People in Host Communities,318,400,546,683,1947,449,466,515,303,1733
19,South Sudan (UNDP),2015,SSD-15/SA1/P/INGO/400,2/3/2016 12:01:29 PM,Internally Displaced People,400,400,35,35,870,56,165,9,2,232
19,South Sudan (UNDP),2015,SSD-15/SA1/P/INGO/400,2/3/2016 12:01:29 PM,Other,80,40,0,0,120,98,83,0,0,181
19,South Sudan (UNDP),2015,SSD-15/SA1/P/INGO/400,2/3/2016 12:01:29 PM,Overall,680,640,50,50,1420,584,794,148,132,1658
19,South Sudan (UNDP),2015,SSD-15/SA1/P/INGO/400,2/3/2016 12:01:29 PM,People in Host Communities,200,200,15,15,430,430,546,139,130,1245
19,South Sudan (UNDP),2015,SSD-15/SA1/P/INGO/419,2/3/2016 1:36:35 PM,Internally Displaced People,385,224,177,159,945,174,127,204,114,619
19,South Sudan (UNDP),2015,SSD-15/SA1/P/INGO/419,2/3/2016 1:36:35 PM,Overall,1285,745,530,590,3150,870,636,1020,572,3098
19,South Sudan (UNDP),2015,SSD-15/SA1/P/INGO/419,2/3/2016 1:36:35 PM,People in Host Communities,900,521,413,371,2205,696,509,816,458,2479
19,South Sudan (UNDP),2015,SSD-15/SA1/P/NGO/191,2/5/2016 6:16:13 AM,Internally Displaced People,2000,2050,2150,2150,8350,2107,2297,2659,2363,9426
19,South Sudan (UNDP),2015,SSD-15/SA1/P/NGO/191,2/5/2016 6:16:13 AM,Overall,3000,4500,3750,3750,15000,3359,5338,4715,4750,18162
19,South Sudan (UNDP),2015,SSD-15/SA1/P/NGO/191,2/5/2016 6:16:13 AM,People in Host Communities,1400,1450,1425,1425,5700,1637,1910,2102,1595,7244
19,South Sudan (UNDP),2015,SSD-15/SA1/P/NGO/191,2/5/2016 6:16:13 AM,"Trainers, Promoters, Caretakers, committee members, etc.",200,250,250,250,950,185,279,350,463,1277
19,South Sudan (UNDP),2015,SSD-15/SA1/P/NGO/235,10/13/2015 11:28:31 AM,Aid Agencies,15,15,0,0,30,11,11,0,0,22
19,South Sudan (UNDP),2015,SSD-15/SA1/P/NGO/235,10/13/2015 11:28:31 AM,Internally Displaced People,500,4000,500,1500,6500,1000,7000,1500,2700,12200
19,South Sudan (UNDP),2015,SSD-15/SA1/P/NGO/235,10/13/2015 11:28:31 AM,Overall,1045,5045,1000,2000,9090,2030,11600,2500,4800,20930
19,South Sudan (UNDP),2015,SSD-15/SA1/P/NGO/235,10/13/2015 11:28:31 AM,People in Host Communities,500,1000,500,500,2500,1030,4600,1000,2100,8730
19,South Sudan (UNDP),2015,SSD-15/SA1/P/NGO/235,10/13/2015 11:28:31 AM,"Trainers, Promoters, Caretakers, committee members, etc.",30,30,0,0,60,30,30,0,0,60
19,South Sudan (UNDP),2015,SSD-15/SA1/P/NGO/262,4/14/2016 6:50:00 AM,Internally Displaced People,0,0,2238,2184,4422,0,0,12275,10941,23216
19,South Sudan (UNDP),2015,SSD-15/SA1/P/NGO/262,4/14/2016 6:50:00 AM,Overall,255,566,3730,3640,8191,1090,2798,22732,20262,46882
19,South Sudan (UNDP),2015,SSD-15/SA1/P/NGO/262,4/14/2016 6:50:00 AM,People in Host Communities,0,0,1492,1456,2948,0,0,10457,9321,19778
19,South Sudan (UNDP),2015,SSD-15/SA1/P/NGO/262,4/14/2016 6:50:00 AM,"Trainers, Promoters, Caretakers, committee members, etc.",255,566,0,0,821,1090,2798,0,0,3888
19,South Sudan (UNDP),2015,SSD-15/SA1/P/NGO/272,3/23/2016 12:52:38 PM,Internally Displaced People,819,3117,487,924,5347,1050,2148,2286,2398,7882
19,South Sudan (UNDP),2015,SSD-15/SA1/P/NGO/272,3/23/2016 12:52:38 PM,Other,0,0,50,150,200,7,48,571,924,1550
19,South Sudan (UNDP),2015,SSD-15/SA1/P/NGO/272,3/23/2016 12:52:38 PM,Overall,921,1200,3355,4595,10071,1722,3383,3959,4646,13710
19,South Sudan (UNDP),2015,SSD-15/SA1/P/NGO/272,3/23/2016 12:52:38 PM,People in Host Communities,541,1050,586,498,2675,620,1149,1067,1254,4090
19,South Sudan (UNDP),2015,SSD-15/SA1/P/NGO/272,3/23/2016 12:52:38 PM,"Trainers, Promoters, Caretakers, committee members, etc.",80,60,50,50,240,45,38,35,70,188
19,South Sudan (UNDP),2015,SSD-15/SA1/P/NGO/292,2/4/2016 6:29:06 AM,Internally Displaced People,720,6960,1142,1142,9964,457,7859,674,1214,10204
19,South Sudan (UNDP),2015,SSD-15/SA1/P/NGO/292,2/4/2016 6:29:06 AM,Other,24,434,19,133,610,0,0,0,0,0
19,South Sudan (UNDP),2015,SSD-15/SA1/P/NGO/292,2/4/2016 6:29:06 AM,Overall,1200,21600,3336,3336,29472,1499,21540,1726,3037,27802
19,South Sudan (UNDP),2015,SSD-15/SA1/P/NGO/292,2/4/2016 6:29:06 AM,People in Host Communities,456,2208,627,627,3918,342,3023,489,732,4586
19,South Sudan (UNDP),2015,SSD-15/SA1/P/NGO/292,2/4/2016 6:29:06 AM,"Trainers, Promoters, Caretakers, committee members, etc.",60,60,20,20,160,244,62,10,10,326
19,South Sudan (UNDP),2015,SSD-15/SA1/P/UN/288,9/8/2015 1:56:34 PM,Internally Displaced People,250,500,250,375,1375,216,585,86,227,1114
19,South Sudan (UNDP),2015,SSD-15/SA1/P/UN/288,9/8/2015 1:56:34 PM,Overall,500,1000,500,750,2750,641,1589,248,551,3029
19,South Sudan (UNDP),2015,SSD-15/SA1/P/UN/288,9/8/2015 1:56:34 PM,People in Host Communities,250,500,250,375,1375,425,1004,162,324,1915
19,South Sudan (UNDP),2015,SSD-15/SA1/P/UN/377,9/16/2015 6:22:28 AM,Internally Displaced People,0,0,11225,11225,22450,0,0,11225,11225,22450
19,South Sudan (UNDP),2015,SSD-15/SA1/P/UN/377,9/16/2015 6:22:28 AM,Overall,0,0,13225,13225,26450,0,0,13225,13225,26450
19,South Sudan (UNDP),2015,SSD-15/SA1/P/UN/377,9/16/2015 6:22:28 AM,People in Host Communities,0,0,2000,2000,4000,0,0,2000,2000,4000
19,South Sudan (UNDP),2015,SSD-15/SA1/P/UN/389,2/3/2016 12:52:01 PM,Internally Displaced People,63000,59850,94500,97650,315000,37000,35150,55500,57350,185000
19,South Sudan (UNDP),2015,SSD-15/SA1/P/UN/389,2/3/2016 12:52:01 PM,Overall,0,31160,0,50840,82000,475,29688,2494,26719,59376
19,South Sudan (UNDP),2015,SSD-15/SA1/P/UN/420,9/8/2015 1:54:02 PM,Internally Displaced People,0,2000,0,3000,5000,0,1690,0,3320,5010
19,South Sudan (UNDP),2015,SSD-15/SA1/P/UN/420,9/8/2015 1:54:02 PM,Overall,0,2400,0,3600,6000,0,2150,0,3700,5850
19,South Sudan (UNDP),2015,SSD-15/SA1/P/UN/420,9/8/2015 1:54:02 PM,People in Host Communities,0,400,0,600,1000,0,460,0,380,840
19,South Sudan (UNDP),2015,SSD-15/SA1/WASH/INGO/204,9/16/2015 7:39:57 AM,Internally Displaced People,8050,8400,9100,9450,35000,8573,8946,9692,10065,37276
19,South Sudan (UNDP),2015,SSD-15/SA1/WASH/INGO/204,9/16/2015 7:39:57 AM,Overall,8050,8400,9100,9450,35000,8573,8946,9692,10065,37276
19,South Sudan (UNDP),2015,SSD-15/SA1/WASH/INGO/331,10/15/2015 3:26:32 PM,Internally Displaced People,3570,5250,6510,5670,21000,772,2145,2917,2476,8310
19,South Sudan (UNDP),2015,SSD-15/SA1/WASH/INGO/331,10/15/2015 3:26:32 PM,Overall,3570,5250,6510,5670,21000,772,2145,2917,2476,8310
19,South Sudan (UNDP),2015,SSD-15/SA1/WASH/INGO/373,10/15/2015 3:30:10 PM,Internally Displaced People,10596,11479,13404,14521,50000,5760,6240,4435,2774,19209
19,South Sudan (UNDP),2015,SSD-15/SA1/WASH/INGO/373,10/15/2015 3:30:10 PM,Overall,21192,22958,26808,29042,100000,29725,41338,18232,22527,111822
19,South Sudan (UNDP),2015,SSD-15/SA1/WASH/INGO/373,10/15/2015 3:30:10 PM,People in Host Communities,10596,11479,13404,14521,50000,23965,35098,13797,19753,92613
19,South Sudan (UNDP),2015,SSD-15/SA1/WASH/INGO/375,1/28/2016 7:38:16 AM,Internally Displaced People,12400,13200,6800,7600,40000,0,0,0,0,0
19,South Sudan (UNDP),2015,SSD-15/SA1/WASH/INGO/375,1/28/2016 7:38:16 AM,Overall,24800,26400,13600,15200,80000,30080,33653,48234,45088,157055
19,South Sudan (UNDP),2015,SSD-15/SA1/WASH/INGO/375,1/28/2016 7:38:16 AM,People in Host Communities,12400,13200,6800,7600,40000,0,0,0,0,0
19,South Sudan (UNDP),2015,SSD-15/SA1/WASH/NGO/188,10/15/2015 2:52:30 PM,Internally Displaced People,1300,4000,1500,2500,9300,1800,3600,2400,4200,12000
19,South Sudan (UNDP),2015,SSD-15/SA1/WASH/NGO/188,10/15/2015 2:52:30 PM,Overall,2300,6200,3500,4575,16575,2563,6153,3393,7683,19792
19,South Sudan (UNDP),2015,SSD-15/SA1/WASH/NGO/188,10/15/2015 2:52:30 PM,People in Host Communities,1000,2200,2000,2077,7277,763,2553,1100,3483,7899
19,South Sudan (UNDP),2015,SSD-15/SA1/WASH/NGO/188,10/15/2015 2:52:30 PM,"Trainers, Promoters, Caretakers, committee members, etc.",225,225,0,0,450,250,250,0,0,500
19,South Sudan (UNDP),2015,SSD-15/SA1/WASH/NGO/199,10/15/2015 3:22:31 PM,Children under 5,0,0,1450,1450,2900,0,0,950,1200,2150
19,South Sudan (UNDP),2015,SSD-15/SA1/WASH/NGO/199,10/15/2015 3:22:31 PM,Internally Displaced People,1500,5500,1500,3000,11500,1360,3740,1317,2380,8797
19,South Sudan (UNDP),2015,SSD-15/SA1/WASH/NGO/199,10/15/2015 3:22:31 PM,Overall,4000,11000,5000,7000,27000,3160,8690,3950,5530,21330
19,South Sudan (UNDP),2015,SSD-15/SA1/WASH/NGO/199,10/15/2015 3:22:31 PM,People in Host Communities,2400,5400,2000,2500,12300,1710,4880,1600,1920,10110
19,South Sudan (UNDP),2015,SSD-15/SA1/WASH/NGO/199,10/15/2015 3:22:31 PM,"Trainers, Promoters, Caretakers, committee members, etc.",100,100,50,50,300,90,70,83,30,273
19,South Sudan (UNDP),2015,SSD-15/SA1/WASH/NGO/226,2/6/2016 9:30:19 AM,Internally Displaced People,13236,15884,9530,14295,52945,13236,15884,9530,14295,52945
19,South Sudan (UNDP),2015,SSD-15/SA1/WASH/NGO/226,2/6/2016 9:30:19 AM,Overall,13236,15884,9530,14295,52945,13236,15884,9530,14295,52945
19,South Sudan (UNDP),2015,SSD-15/SA1/WASH/NGO/298,2/6/2016 10:05:16 AM,Internally Displaced People,500,1000,1000,1000,3500,1160,2050,2190,2580,7980
19,South Sudan (UNDP),2015,SSD-15/SA1/WASH/NGO/298,2/6/2016 10:05:16 AM,Overall,2000,4000,5320,4680,16000,3090,5900,6689,6821,22500
19,South Sudan (UNDP),2015,SSD-15/SA1/WASH/NGO/298,2/6/2016 10:05:16 AM,People in Host Communities,1500,3000,4320,3680,12500,1750,3800,3980,4990,14520
19,South Sudan (UNDP),2015,SSD-15/SA1/WASH/UN/305,2/6/2016 10:09:43 AM,Internally Displaced People,9372,10595,10188,10595,40750,14700,16600,16100,16600,64000
19,South Sudan (UNDP),2015,SSD-15/SA1/WASH/UN/305,2/6/2016 10:09:43 AM,Overall,12822,14495,13938,14495,55750,19200,21700,20900,21700,83500
19,South Sudan (UNDP),2015,SSD-15/SA1/WASH/UN/305,2/6/2016 10:09:43 AM,People in Host Communities,3450,3900,3750,3900,15000,4500,5100,4800,5100,19500
19,South Sudan (UNDP),2015,SSD-15/SA1/WASH/UN/323,2/6/2016 9:38:18 AM,Internally Displaced People,29100,32900,31600,32900,126500,26425,30325,28375,29350,114475
19,South Sudan (UNDP),2015,SSD-15/SA1/WASH/UN/323,2/6/2016 9:38:18 AM,Other,3230,3650,3520,3650,14050,3450,4050,3750,3900,15150
19,South Sudan (UNDP),2015,SSD-15/SA1/WASH/UN/323,2/6/2016 9:38:18 AM,Overall,35560,40200,38640,40200,154600,34500,40500,37500,39000,151500
19,South Sudan (UNDP),2015,SSD-15/SA1/WASH/UN/323,2/6/2016 9:38:18 AM,People in Host Communities,3230,3650,3520,3650,14050,4625,6125,5375,5750,21875
19,South Sudan (UNDP),2015,SSD-15/SA1/WASH/UN/332,2/6/2016 9:45:30 AM,Internally Displaced People,3777,5037,4497,4676,17987,11108,14815,13227,13753,52903
19,South Sudan (UNDP),2015,SSD-15/SA1/WASH/UN/332,2/6/2016 9:45:30 AM,Other,284,245,220,230,979,835,721,647,676,2879
19,South Sudan (UNDP),2015,SSD-15/SA1/WASH/UN/332,2/6/2016 9:45:30 AM,Overall,12531,16708,14919,15516,59674,36857,49142,43879,45636,175514
19,South Sudan (UNDP),2015,SSD-15/SA1/WASH/UN/332,2/6/2016 9:45:30 AM,People in Host Communities,7578,10237,9140,9506,36461,22289,30109,26884,27959,107241
19,South Sudan (UNDP),2015,SSD-15/SA1/WASH/UN/332,2/6/2016 9:45:30 AM,Refugee Returnees,892,1189,1062,1104,4247,2623,3497,3124,3247,12491
19,South Sudan (UNDP),2015,SSD-15/SA1/WASH/UN/398,2/6/2016 9:08:49 AM,Internally Displaced People,1879,5697,6329,6673,20578,2275,6568,7304,7721,23868
19,South Sudan (UNDP),2015,SSD-15/SA1/WASH/UN/398,2/6/2016 9:08:49 AM,Overall,1879,5697,6329,6673,20578,2275,6568,7304,7721,23868
19,South Sudan (UNDP),2016,SSD-16/HSS10/HF-DC/CCS/UN/884,5/30/2019 11:48:00 AM,Aid Agencies,60,0,0,0,60,0,0,0,0,0
19,South Sudan (UNDP),2016,SSD-16/HSS10/HF-DC/CCS/UN/884,5/30/2019 11:48:00 AM,Overall,60,0,0,0,60,67,0,0,0,67
19,South Sudan (UNDP),2016,SSD-16/HSS10/RA 2/E/UN/4437,8/3/2017 6:07:13 PM,Children under 5,0,0,1800,1200,3000,0,0,1800,1200,3000
19,South Sudan (UNDP),2016,SSD-16/HSS10/RA 2/E/UN/4437,8/3/2017 6:07:13 PM,Internally Displaced People,168,72,5856,3504,9600,168,72,5856,3504,9600
19,South Sudan (UNDP),2016,SSD-16/HSS10/RA 2/E/UN/4437,8/3/2017 6:07:13 PM,Overall,210,90,9120,6080,15500,210,90,9120,6080,15500
19,South Sudan (UNDP),2016,SSD-16/HSS10/RA 2/E/UN/4437,8/3/2017 6:07:13 PM,People in Host Communities,42,18,1464,1376,2900,42,18,1464,1376,2900
19,South Sudan (UNDP),2016,SSD-16/HSS10/RA 2/FSL/UN/4438,5/29/2018 5:46:43 AM,Internally Displaced People,3648,5472,3648,5472,18240,3648,5472,3648,5472,18240
19,South Sudan (UNDP),2016,SSD-16/HSS10/RA 2/FSL/UN/4438,5/29/2018 5:46:43 AM,Overall,9120,13680,9120,13680,45600,9120,13680,9120,13680,45600
19,South Sudan (UNDP),2016,SSD-16/HSS10/RA 2/FSL/UN/4438,5/29/2018 5:46:43 AM,People in Host Communities,3648,5472,3648,5472,18240,3648,5472,3648,5472,18240
19,South Sudan (UNDP),2016,SSD-16/HSS10/RA 2/FSL/UN/4438,5/29/2018 5:46:43 AM,Refugee Returnees,1824,2736,1824,2736,9120,1824,2736,1824,2736,9120
19,South Sudan (UNDP),2016,SSD-16/HSS10/RA 2/H/UN/4439,12/11/2017 1:46:57 PM,Internally Displaced People,34971,34852,40945,44357,155125,0,16660,55833,58111,130604
19,South Sudan (UNDP),2016,SSD-16/HSS10/RA 2/H/UN/4439,12/11/2017 1:46:57 PM,Overall,49959,49789,58493,63368,221609,0,27601,93055,96853,217509
19,South Sudan (UNDP),2016,SSD-16/HSS10/RA 2/H/UN/4439,12/11/2017 1:46:57 PM,People in Host Communities,14987,14936,17547,19010,66480,0,8280,27916,29055,65251
19,South Sudan (UNDP),2016,SSD-16/HSS10/RA 2/H/UN/4440,7/31/2018 7:43:20 PM,Internally Displaced People,45000,56000,48000,75000,224000,42800,56800,47000,76500,223100
19,South Sudan (UNDP),2016,SSD-16/HSS10/RA 2/H/UN/4440,7/31/2018 7:43:20 PM,Overall,55400,69250,60940,91410,277000,54800,71300,59000,94000,279100
19,South Sudan (UNDP),2016,SSD-16/HSS10/RA 2/H/UN/4440,7/31/2018 7:43:20 PM,People in Host Communities,10400,13250,12940,16410,53000,12000,14500,12000,17500,56000
19,South Sudan (UNDP),2016,SSD-16/HSS10/RA 2/H/UN/4441,7/31/2018 7:48:31 PM,Internally Displaced People,76500,73500,0,0,150000,0,0,0,0,0
19,South Sudan (UNDP),2016,SSD-16/HSS10/RA 2/H/UN/4441,7/31/2018 7:48:31 PM,Overall,76500,73500,0,0,150000,76500,73500,0,0,150000
19,South Sudan (UNDP),2016,SSD-16/HSS10/RA 2/N/UN/4442,8/9/2018 7:20:33 AM,Children under 5,0,0,4872,5071,9943,0,0,4872,5071,9943
19,South Sudan (UNDP),2016,SSD-16/HSS10/RA 2/N/UN/4442,8/9/2018 7:20:33 AM,Overall,0,0,4872,5071,9943,0,0,4872,5071,9943
19,South Sudan (UNDP),2016,SSD-16/HSS10/RA 2/N/UN/4443,8/15/2017 7:40:56 PM,Children under 5,0,0,20020,20837,40857,0,0,16258,16598,32856
19,South Sudan (UNDP),2016,SSD-16/HSS10/RA 2/N/UN/4443,8/15/2017 7:40:56 PM,Overall,0,0,20020,20837,40857,0,0,16258,16598,32856
19,South Sudan (UNDP),2016,SSD-16/HSS10/RA 2/NFI/UN/4453,6/19/2018 10:14:28 AM,Children under 5,0,0,14655,14655,29310,0,0,11574,12883,24457
19,South Sudan (UNDP),2016,SSD-16/HSS10/RA 2/NFI/UN/4453,6/19/2018 10:14:28 AM,Internally Displaced People,16748,24563,18840,22189,82340,21268,24955,21857,24252,92332
19,South Sudan (UNDP),2016,SSD-16/HSS10/RA 2/NFI/UN/4453,6/19/2018 10:14:28 AM,Overall,16748,24563,33495,36844,111650,26902,31565,27647,30676,116790
19,South Sudan (UNDP),2016,SSD-16/HSS10/RA 2/P/UN/4444,8/4/2017 2:49:58 PM,Internally Displaced People,0,15000,0,13500,28500,0,15296,0,13500,28796
19,South Sudan (UNDP),2016,SSD-16/HSS10/RA 2/P/UN/4444,8/4/2017 2:49:58 PM,Overall,0,15000,0,13500,28500,0,15296,0,13204,28500
19,South Sudan (UNDP),2016,SSD-16/HSS10/RA 2/P/UN/4445,1/5/2018 1:37:28 PM,Internally Displaced People,0,0,11375,11375,22750,0,0,20053,12127,32180
19,South Sudan (UNDP),2016,SSD-16/HSS10/RA 2/P/UN/4445,1/5/2018 1:37:28 PM,Overall,0,0,16250,16250,32500,0,0,25053,16027,41080
19,South Sudan (UNDP),2016,SSD-16/HSS10/RA 2/P/UN/4445,1/5/2018 1:37:28 PM,People in Host Communities,0,0,4875,4875,9750,0,0,5000,3900,8900
19,South Sudan (UNDP),2016,SSD-16/HSS10/RA 2/WASH/UN/4446,9/7/2017 12:36:17 PM,Internally Displaced People,8400,50400,19600,61600,140000,2230,13380,5204,16354,37168
19,South Sudan (UNDP),2016,SSD-16/HSS10/RA 2/WASH/UN/4446,9/7/2017 12:36:17 PM,Overall,8400,50400,19600,61600,140000,6573,39439,15338,48204,109554
19,South Sudan (UNDP),2016,SSD-16/HSS10/RA 2/WASH/UN/4447,9/7/2017 12:02:39 PM,Internally Displaced People,13800,15600,15000,15600,60000,14476,16364,15734,16364,62938
19,South Sudan (UNDP),2016,SSD-16/HSS10/RA 2/WASH/UN/4447,9/7/2017 12:02:39 PM,Overall,25300,28600,27500,28600,110000,26539,30000,28847,30000,115386
19,South Sudan (UNDP),2016,SSD-16/HSS10/RA 2/WASH/UN/4447,9/7/2017 12:02:39 PM,People in Host Communities,11500,13000,12500,13000,50000,12063,13636,13113,13636,52448
19,South Sudan (UNDP),2016,SSD-16/HSS10/RA1/E/INGO/3165,6/29/2017 8:45:33 AM,Overall,16,7,1200,800,2023,111,49,1886,2001,4047
19,South Sudan (UNDP),2016,SSD-16/HSS10/RA1/H/UN/3156,3/21/2017 9:55:06 AM,Internally Displaced People,16781,17167,4428,4609,42985,24059,28098,20015,43046,115218
19,South Sudan (UNDP),2016,SSD-16/HSS10/RA1/H/UN/3156,3/21/2017 9:55:06 AM,Overall,16806,17192,4428,4609,43035,24059,28098,20015,43046,115218
19,South Sudan (UNDP),2016,SSD-16/HSS10/RA1/H/UN/3156,3/21/2017 9:55:06 AM,"Trainers, Promoters, Caretakers, committee members, etc.",25,25,0,0,50,0,0,0,0,0
19,South Sudan (UNDP),2016,SSD-16/HSS10/RA1/H/UN/3161,1/19/2017 8:55:53 AM,Overall,17400,21750,0,20000,59150,17500,21000,3000,20500,62000
19,South Sudan (UNDP),2016,SSD-16/HSS10/RA1/H/UN/3162,7/21/2017 11:34:40 AM,Children under 5,0,0,6426,6174,12600,0,0,7189,6782,13971
19,South Sudan (UNDP),2016,SSD-16/HSS10/RA1/H/UN/3162,7/21/2017 11:34:40 AM,Overall,0,3000,14382,13818,31200,0,3404,19982,17484,40870
19,South Sudan (UNDP),2016,SSD-16/HSS10/RA1/H/UN/3162,7/21/2017 11:34:40 AM,Pregnant and Lactating Women,0,3000,0,0,3000,0,3373,0,0,3373
19,South Sudan (UNDP),2016,SSD-16/HSS10/RA1/H/UN/3166,1/24/2018 10:04:16 AM,Children under 5,0,0,15435,19065,34500,0,0,12345,17904,30249
19,South Sudan (UNDP),2016,SSD-16/HSS10/RA1/H/UN/3166,1/24/2018 10:04:16 AM,Other,23205,22295,0,0,45500,21390,22295,0,0,43685
19,South Sudan (UNDP),2016,SSD-16/HSS10/RA1/H/UN/3166,1/24/2018 10:04:16 AM,Overall,23205,22295,15435,19065,80000,21390,19765,12345,17904,71404
19,South Sudan (UNDP),2016,SSD-16/HSS10/RA1/N/NGO/3163,2/2/2017 5:29:18 AM,Children under 5,0,0,10400,9600,20000,0,0,7106,6611,13717
19,South Sudan (UNDP),2016,SSD-16/HSS10/RA1/N/NGO/3163,2/2/2017 5:29:18 AM,Internally Displaced People,7000,2000,0,0,9000,2199,2000,0,0,4199
19,South Sudan (UNDP),2016,SSD-16/HSS10/RA1/N/NGO/3163,2/2/2017 5:29:18 AM,Overall,7000,10000,10400,9600,37000,2199,11000,7106,6611,26916
19,South Sudan (UNDP),2016,SSD-16/HSS10/RA1/N/NGO/3163,2/2/2017 5:29:18 AM,Pregnant and Lactating Women,0,8000,0,0,8000,0,9000,0,0,9000
19,South Sudan (UNDP),2016,SSD-16/HSS10/RA1/N/UN/3157,4/28/2017 9:58:44 AM,Children under 5,0,0,1123,1217,2340,0,0,2452,2765,5217
19,South Sudan (UNDP),2016,SSD-16/HSS10/RA1/N/UN/3157,4/28/2017 9:58:44 AM,Overall,0,1880,1123,1217,4220,0,2613,2452,2765,7830
19,South Sudan (UNDP),2016,SSD-16/HSS10/RA1/N/UN/3157,4/28/2017 9:58:44 AM,Pregnant and Lactating Women,0,1880,0,0,1880,0,2613,0,0,2613
19,South Sudan (UNDP),2016,SSD-16/HSS10/RA1/NFI/UN/3150,3/24/2017 11:50:54 AM,Internally Displaced People,20458,22164,20458,18884,81964,25662,30581,25662,25020,106925
19,South Sudan (UNDP),2016,SSD-16/HSS10/RA1/NFI/UN/3150,3/24/2017 11:50:54 AM,Overall,20458,22164,20458,18884,81964,25662,30581,25662,25020,106925
19,South Sudan (UNDP),2016,SSD-16/HSS10/RA1/P/INGO/3160,1/9/2017 12:04:19 PM,Overall,600,3800,900,2800,8100,1851,4730,2028,3739,12348
19,South Sudan (UNDP),2016,SSD-16/HSS10/RA1/P/UN/3155,1/3/2018 8:49:16 AM,Internally Displaced People,8580,10663,5000,5400,29643,15368,16722,6125,6029,44244
19,South Sudan (UNDP),2016,SSD-16/HSS10/RA1/P/UN/3155,1/3/2018 8:49:16 AM,Overall,8580,10663,5000,5400,29643,15368,16722,6125,6029,44244
19,South Sudan (UNDP),2016,SSD-16/HSS10/RA1/WASH/INGO/3164,9/7/2017 1:56:30 PM,Internally Displaced People,9216,20800,4792,5192,40000,9887,13104,16809,18209,58009
19,South Sudan (UNDP),2016,SSD-16/HSS10/RA1/WASH/INGO/3164,9/7/2017 1:56:30 PM,Overall,9216,20800,4792,5192,40000,9887,13104,16809,18209,58009
19,South Sudan (UNDP),2016,SSD-16/HSS10/SA1/CCCM/INGO/722,2/1/2017 8:23:02 AM,Internally Displaced People,15660,27976,29508,31311,104455,15660,27976,29508,31311,104455
19,South Sudan (UNDP),2016,SSD-16/HSS10/SA1/CCCM/INGO/722,2/1/2017 8:23:02 AM,Overall,15660,27976,29508,31311,104455,15660,27976,29508,31311,104455
19,South Sudan (UNDP),2016,SSD-16/HSS10/SA1/CCCM/INGO/786,1/9/2017 8:27:12 AM,Children under 5,0,0,2384,2331,4715,0,0,2100,1890,3990
19,South Sudan (UNDP),2016,SSD-16/HSS10/SA1/CCCM/INGO/786,1/9/2017 8:27:12 AM,Internally Displaced People,7920,6835,5308,5498,25561,4370,5190,4900,5580,20040
19,South Sudan (UNDP),2016,SSD-16/HSS10/SA1/CCCM/INGO/786,1/9/2017 8:27:12 AM,Overall,7920,6835,7692,7829,30276,4370,5190,4900,5580,20040
19,South Sudan (UNDP),2016,SSD-16/HSS10/SA1/CCCM/INGO/880,6/10/2017 7:52:10 PM,Internally Displaced People,7920,6835,7692,7829,30276,9005,10200,11018,10627,40850
19,South Sudan (UNDP),2016,SSD-16/HSS10/SA1/CCCM/INGO/880,6/10/2017 7:52:10 PM,Overall,7920,6835,7692,7829,30276,9005,10200,11018,10627,40850
19,South Sudan (UNDP),2016,SSD-16/HSS10/SA1/CCCM/INGO/881,2/1/2017 8:24:33 AM,Internally Displaced People,18760,27086,26914,27939,100699,18760,27086,26914,27939,100699
19,South Sudan (UNDP),2016,SSD-16/HSS10/SA1/CCCM/INGO/881,2/1/2017 8:24:33 AM,Overall,18760,27086,26914,27939,100699,18760,27086,26914,27939,100699
19,South Sudan (UNDP),2016,SSD-16/HSS10/SA1/E/INGO/788,9/29/2016 9:59:00 AM,Internally Displaced People,131,87,2854,1914,4986,47,31,1703,1919,3700
19,South Sudan (UNDP),2016,SSD-16/HSS10/SA1/E/INGO/788,9/29/2016 9:59:00 AM,Overall,175,117,4096,2754,7142,359,135,5483,4836,10813
19,South Sudan (UNDP),2016,SSD-16/HSS10/SA1/E/INGO/788,9/29/2016 9:59:00 AM,People in Host Communities,44,30,1242,840,2156,312,104,3780,2917,7113
19,South Sudan (UNDP),2016,SSD-16/HSS10/SA1/E/INGO/797,9/24/2016 2:33:13 PM,Internally Displaced People,300,100,600,1000,2000,64,12,1572,864,2512
19,South Sudan (UNDP),2016,SSD-16/HSS10/SA1/E/INGO/797,9/24/2016 2:33:13 PM,Overall,1000,550,2000,2200,5750,164,56,4176,1864,6260
19,South Sudan (UNDP),2016,SSD-16/HSS10/SA1/E/INGO/797,9/24/2016 2:33:13 PM,People in Host Communities,350,250,400,400,1400,45,18,1012,500,1575
19,South Sudan (UNDP),2016,SSD-16/HSS10/SA1/E/INGO/797,9/24/2016 2:33:13 PM,Refugee Returnees,350,200,1000,800,2350,55,26,1592,500,2173
19,South Sudan (UNDP),2016,SSD-16/HSS10/SA1/E/INGO/862,2/6/2017 1:26:59 PM,Internally Displaced People,655,928,3768,3749,9100,2100,2350,3230,1519,9199
19,South Sudan (UNDP),2016,SSD-16/HSS10/SA1/E/INGO/862,2/6/2017 1:26:59 PM,Overall,909,1054,4139,4121,10223,3301,3060,5110,1706,13177
19,South Sudan (UNDP),2016,SSD-16/HSS10/SA1/E/INGO/862,2/6/2017 1:26:59 PM,People in Host Communities,65,92,371,372,900,900,650,1870,187,3607
19,South Sudan (UNDP),2016,SSD-16/HSS10/SA1/E/INGO/862,2/6/2017 1:26:59 PM,"Trainers, Promoters, Caretakers, committee members, etc.",189,34,0,0,223,301,60,0,0,361
19,South Sudan (UNDP),2016,SSD-16/HSS10/SA1/E/INGO/875,2/8/2017 1:30:12 PM,Internally Displaced People,18,5,180,80,283,5,0,30,6,41
19,South Sudan (UNDP),2016,SSD-16/HSS10/SA1/E/INGO/875,2/8/2017 1:30:12 PM,Overall,40,14,1740,1160,2954,52,2,1697,989,2740
19,South Sudan (UNDP),2016,SSD-16/HSS10/SA1/E/INGO/875,2/8/2017 1:30:12 PM,People in Host Communities,22,9,1560,1080,2671,47,2,1667,983,2699
19,South Sudan (UNDP),2016,SSD-16/HSS10/SA1/E/NGO/673,9/24/2016 5:44:19 PM,Internally Displaced People,149,185,383,373,1090,132,165,321,364,982
19,South Sudan (UNDP),2016,SSD-16/HSS10/SA1/E/NGO/673,9/24/2016 5:44:19 PM,Overall,785,974,2016,1959,5734,643,753,1865,1653,4914
19,South Sudan (UNDP),2016,SSD-16/HSS10/SA1/E/NGO/673,9/24/2016 5:44:19 PM,Pastoralists,112,138,288,280,818,43,84,254,274,655
19,South Sudan (UNDP),2016,SSD-16/HSS10/SA1/E/NGO/673,9/24/2016 5:44:19 PM,People in Host Communities,448,556,1151,1119,3274,354,530,1132,1089,3105
19,South Sudan (UNDP),2016,SSD-16/HSS10/SA1/E/NGO/673,9/24/2016 5:44:19 PM,"Trainers, Promoters, Caretakers, committee members, etc.",75,93,192,187,547,63,75,182,174,494
19,South Sudan (UNDP),2016,SSD-16/HSS10/SA1/E/NGO/695,9/24/2016 4:29:31 PM,Children under 5,0,0,200,300,500,0,0,200,300,500
19,South Sudan (UNDP),2016,SSD-16/HSS10/SA1/E/NGO/695,9/24/2016 4:29:31 PM,Internally Displaced People,0,0,600,750,1350,0,0,600,750,1350
19,South Sudan (UNDP),2016,SSD-16/HSS10/SA1/E/NGO/695,9/24/2016 4:29:31 PM,Overall,77,48,1500,1850,3475,110,15,1500,1850,3475
19,South Sudan (UNDP),2016,SSD-16/HSS10/SA1/E/NGO/695,9/24/2016 4:29:31 PM,People in Host Communities,0,0,700,800,1500,0,0,700,800,1500
19,South Sudan (UNDP),2016,SSD-16/HSS10/SA1/E/NGO/695,9/24/2016 4:29:31 PM,"Trainers, Promoters, Caretakers, committee members, etc.",77,48,0,0,125,110,15,0,0,125
19,South Sudan (UNDP),2016,SSD-16/HSS10/SA1/E/NGO/715,9/2/2016 9:01:18 AM,Internally Displaced People,220,210,1305,1305,3040,0,0,0,0,0
19,South Sudan (UNDP),2016,SSD-16/HSS10/SA1/E/NGO/715,9/2/2016 9:01:18 AM,Overall,470,520,4610,4620,10220,184,153,4812,4466,9615
19,South Sudan (UNDP),2016,SSD-16/HSS10/SA1/E/NGO/715,9/2/2016 9:01:18 AM,People in Host Communities,250,310,3305,3315,7180,0,0,0,0,0
19,South Sudan (UNDP),2016,SSD-16/HSS10/SA1/E/NGO/724,12/20/2016 12:26:49 PM,Combatants and Ex-Combatants,200,300,200,0,700,300,0,250,0,550
19,South Sudan (UNDP),2016,SSD-16/HSS10/SA1/E/NGO/724,12/20/2016 12:26:49 PM,Internally Displaced People,500,1000,800,1400,3700,680,1510,1820,2050,6060
19,South Sudan (UNDP),2016,SSD-16/HSS10/SA1/E/NGO/724,12/20/2016 12:26:49 PM,Overall,1000,2000,1500,2000,6500,1750,2600,3800,4000,12150
19,South Sudan (UNDP),2016,SSD-16/HSS10/SA1/E/NGO/724,12/20/2016 12:26:49 PM,People in Host Communities,300,700,500,600,2100,745,1065,1730,1950,5490
19,South Sudan (UNDP),2016,SSD-16/HSS10/SA1/E/NGO/724,12/20/2016 12:26:49 PM,"Trainers, Promoters, Caretakers, committee members, etc.",0,0,0,0,0,25,25,0,0,50
19,South Sudan (UNDP),2016,SSD-16/HSS10/SA1/E/NGO/848,9/9/2016 6:55:28 AM,Children under 5,0,0,500,500,1000,0,0,181,194,375
19,South Sudan (UNDP),2016,SSD-16/HSS10/SA1/E/NGO/848,9/9/2016 6:55:28 AM,Internally Displaced People,350,400,1500,1750,4000,14,2,576,568,1160
19,South Sudan (UNDP),2016,SSD-16/HSS10/SA1/E/NGO/848,9/9/2016 6:55:28 AM,Overall,350,650,1850,2150,5000,94,14,4022,3978,8108
19,South Sudan (UNDP),2016,SSD-16/HSS10/SA1/E/NGO/848,9/9/2016 6:55:28 AM,People in Host Communities,100,150,350,400,1000,80,12,3263,3216,6571
19,South Sudan (UNDP),2016,SSD-16/HSS10/SA1/E/NGO/848,9/9/2016 6:55:28 AM,Pregnant and Lactating Women,0,55,0,0,55,0,0,0,0,0
19,South Sudan (UNDP),2016,SSD-16/HSS10/SA1/E/UN/807,1/18/2017 7:54:16 AM,Children under 5,0,0,3000,2000,5000,0,0,3000,2000,5000
19,South Sudan (UNDP),2016,SSD-16/HSS10/SA1/E/UN/807,1/18/2017 7:54:16 AM,Internally Displaced People,150,50,6000,4000,10200,150,50,6000,4000,10200
19,South Sudan (UNDP),2016,SSD-16/HSS10/SA1/E/UN/807,1/18/2017 7:54:16 AM,Overall,150,50,12000,8000,20200,150,50,12000,8000,20200
19,South Sudan (UNDP),2016,SSD-16/HSS10/SA1/E/UN/807,1/18/2017 7:54:16 AM,People in Host Communities,0,0,3000,2000,5000,0,0,3000,2000,5000
19,South Sudan (UNDP),2016,SSD-16/HSS10/SA1/ETC/UN/785,2/1/2017 7:23:22 AM,Aid Agencies,120,0,0,0,120,120,0,0,0,120
19,South Sudan (UNDP),2016,SSD-16/HSS10/SA1/ETC/UN/785,2/1/2017 7:23:22 AM,Overall,120,0,0,0,120,120,0,0,0,120
19,South Sudan (UNDP),2016,SSD-16/HSS10/SA1/ETC/UN/882,10/27/2021 12:26:45 PM,Aid Agencies,120,0,0,0,120,300,0,0,0,300
19,South Sudan (UNDP),2016,SSD-16/HSS10/SA1/ETC/UN/882,10/27/2021 12:26:45 PM,Overall,120,0,0,0,120,300,0,0,0,300
19,South Sudan (UNDP),2016,SSD-16/HSS10/SA1/FSL/INGO/702,9/26/2016 6:06:04 AM,Internally Displaced People,2950,3050,2950,3050,12000,782,1218,4187,5813,12000
19,South Sudan (UNDP),2016,SSD-16/HSS10/SA1/FSL/INGO/702,9/26/2016 6:06:04 AM,Overall,7375,7625,7375,7625,30000,1955,3045,10161,14839,30000
19,South Sudan (UNDP),2016,SSD-16/HSS10/SA1/FSL/INGO/702,9/26/2016 6:06:04 AM,People in Host Communities,4425,4575,4425,4575,18000,1173,1827,5974,9026,18000
19,South Sudan (UNDP),2016,SSD-16/HSS10/SA1/FSL/INGO/728,1/14/2017 2:54:10 PM,Internally Displaced People,4000,4500,0,0,8500,1347,2045,0,0,3392
19,South Sudan (UNDP),2016,SSD-16/HSS10/SA1/FSL/INGO/728,1/14/2017 2:54:10 PM,Overall,4600,5250,0,0,9850,4316,5019,0,0,9335
19,South Sudan (UNDP),2016,SSD-16/HSS10/SA1/FSL/INGO/728,1/14/2017 2:54:10 PM,People in Host Communities,600,750,0,0,1350,2937,2693,0,0,5630
19,South Sudan (UNDP),2016,SSD-16/HSS10/SA1/FSL/INGO/739,1/16/2017 7:35:25 AM,Internally Displaced People,1500,2400,0,0,3900,1971,1022,0,0,2993
19,South Sudan (UNDP),2016,SSD-16/HSS10/SA1/FSL/INGO/739,1/16/2017 7:35:25 AM,Overall,2000,3000,0,0,5000,3077,1916,0,0,4993
19,South Sudan (UNDP),2016,SSD-16/HSS10/SA1/FSL/INGO/739,1/16/2017 7:35:25 AM,People in Host Communities,500,400,0,0,900,1106,894,0,0,2000
19,South Sudan (UNDP),2016,SSD-16/HSS10/SA1/FSL/INGO/739,1/16/2017 7:35:25 AM,Pregnant and Lactating Women,0,200,0,0,200,0,399,0,0,399
19,South Sudan (UNDP),2016,SSD-16/HSS10/SA1/FSL/INGO/759,12/16/2016 9:28:00 AM,Internally Displaced People,5600,6500,8500,8900,29500,5100,6100,5600,5700,22500
19,South Sudan (UNDP),2016,SSD-16/HSS10/SA1/FSL/INGO/759,12/16/2016 9:28:00 AM,Overall,16000,18200,25000,26000,85200,12500,14600,16800,18600,62500
19,South Sudan (UNDP),2016,SSD-16/HSS10/SA1/FSL/INGO/759,12/16/2016 9:28:00 AM,People in Host Communities,4400,4700,7800,8100,25000,4200,5800,4900,5600,20500
19,South Sudan (UNDP),2016,SSD-16/HSS10/SA1/FSL/INGO/759,12/16/2016 9:28:00 AM,Refugee Returnees,6000,7000,8700,9000,30700,4700,4300,5000,5500,19500
19,South Sudan (UNDP),2016,SSD-16/HSS10/SA1/FSL/INGO/839,1/12/2017 1:15:14 PM,Internally Displaced People,1848,2152,462,538,5000,4916,5027,214,164,10321
19,South Sudan (UNDP),2016,SSD-16/HSS10/SA1/FSL/INGO/839,1/12/2017 1:15:14 PM,Overall,3696,4704,924,1176,10500,9831,10579,428,328,21166
19,South Sudan (UNDP),2016,SSD-16/HSS10/SA1/FSL/INGO/839,1/12/2017 1:15:14 PM,People in Host Communities,1848,2152,462,538,5000,4915,5232,214,164,10525
19,South Sudan (UNDP),2016,SSD-16/HSS10/SA1/FSL/INGO/839,1/12/2017 1:15:14 PM,Pregnant and Lactating Women,0,500,0,0,500,0,320,0,0,320
19,South Sudan (UNDP),2016,SSD-16/HSS10/SA1/FSL/INGO/843,9/26/2016 6:40:07 AM,Internally Displaced People,145,432,432,648,1657,722,2152,2152,3228,8254
19,South Sudan (UNDP),2016,SSD-16/HSS10/SA1/FSL/INGO/843,9/26/2016 6:40:07 AM,Overall,1440,2160,2160,3240,9000,7174,10761,10761,16141,44837
19,South Sudan (UNDP),2016,SSD-16/HSS10/SA1/FSL/INGO/843,9/26/2016 6:40:07 AM,People in Host Communities,1295,1728,1728,2592,7343,6452,8609,8609,12913,36583
19,South Sudan (UNDP),2016,SSD-16/HSS10/SA1/FSL/INGO/859,2/1/2017 8:49:38 AM,Internally Displaced People,7028,2398,949,700,11075,20512,22439,21408,21758,86117
19,South Sudan (UNDP),2016,SSD-16/HSS10/SA1/FSL/INGO/859,2/1/2017 8:49:38 AM,Overall,10040,4140,1355,1000,16535,29304,32057,30584,31084,123029
19,South Sudan (UNDP),2016,SSD-16/HSS10/SA1/FSL/INGO/859,2/1/2017 8:49:38 AM,People in Host Communities,3012,1742,406,300,5460,8792,9618,9176,9326,36912
19,South Sudan (UNDP),2016,SSD-16/HSS10/SA1/FSL/INGO/865,2/1/2017 9:25:29 AM,Internally Displaced People,9800,7000,0,0,16800,2753,4867,0,0,7620
19,South Sudan (UNDP),2016,SSD-16/HSS10/SA1/FSL/INGO/865,2/1/2017 9:25:29 AM,Overall,26800,20000,0,0,46800,17322,29466,0,0,46788
19,South Sudan (UNDP),2016,SSD-16/HSS10/SA1/FSL/INGO/865,2/1/2017 9:25:29 AM,People in Host Communities,17000,13000,0,0,30000,0,0,0,0,0
19,South Sudan (UNDP),2016,SSD-16/HSS10/SA1/FSL/NGO/783,9/25/2016 12:30:07 PM,Internally Displaced People,2400,3600,0,0,6000,2500,3500,0,0,6000
19,South Sudan (UNDP),2016,SSD-16/HSS10/SA1/FSL/NGO/783,9/25/2016 12:30:07 PM,Overall,4800,7200,0,0,12000,5000,7000,0,0,12000
19,South Sudan (UNDP),2016,SSD-16/HSS10/SA1/FSL/NGO/783,9/25/2016 12:30:07 PM,People in Host Communities,2400,3600,0,0,6000,2500,3500,0,0,6000
19,South Sudan (UNDP),2016,SSD-16/HSS10/SA1/FSL/UN/706,2/1/2017 7:33:27 AM,Internally Displaced People,10000,15000,10000,10000,45000,13208,19372,12107,12107,56794
19,South Sudan (UNDP),2016,SSD-16/HSS10/SA1/FSL/UN/706,2/1/2017 7:33:27 AM,Overall,50000,70000,50000,50000,220000,66041,88055,60538,60538,275172
19,South Sudan (UNDP),2016,SSD-16/HSS10/SA1/FSL/UN/706,2/1/2017 7:33:27 AM,Pastoralists,10000,10000,10000,10000,40000,13208,12327,12107,12107,49749
19,South Sudan (UNDP),2016,SSD-16/HSS10/SA1/FSL/UN/706,2/1/2017 7:33:27 AM,People in Host Communities,30000,45000,30000,30000,135000,39625,56335,36323,36323,168606
19,South Sudan (UNDP),2016,SSD-16/HSS10/SA1/H/INGO/678,9/27/2016 12:42:47 PM,Children under 5,0,0,0,0,0,0,0,6277,5553,11830
19,South Sudan (UNDP),2016,SSD-16/HSS10/SA1/H/INGO/678,9/27/2016 12:42:47 PM,Internally Displaced People,11700,11250,11700,10350,45000,15380,14788,9103,8052,47323
19,South Sudan (UNDP),2016,SSD-16/HSS10/SA1/H/INGO/678,9/27/2016 12:42:47 PM,Overall,11700,11250,11700,10350,45000,15380,14788,15380,13605,59153
19,South Sudan (UNDP),2016,SSD-16/HSS10/SA1/H/INGO/731,9/29/2016 9:57:04 AM,Children under 5,0,0,6666,6938,13604,0,0,6510,6776,13286
19,South Sudan (UNDP),2016,SSD-16/HSS10/SA1/H/INGO/731,9/29/2016 9:57:04 AM,Internally Displaced People,11298,11759,0,0,23057,0,0,0,0,0
19,South Sudan (UNDP),2016,SSD-16/HSS10/SA1/H/INGO/731,9/29/2016 9:57:04 AM,Overall,25077,26101,6666,6938,64782,9865,10267,6510,6776,33418
19,South Sudan (UNDP),2016,SSD-16/HSS10/SA1/H/INGO/731,9/29/2016 9:57:04 AM,Pregnant and Lactating Women,0,5182,0,0,5182,0,2464,0,0,2464
19,South Sudan (UNDP),2016,SSD-16/HSS10/SA1/H/INGO/738,1/7/2017 11:26:33 AM,Children under 5,0,0,0,0,0,0,0,39177,42550,81727
19,South Sudan (UNDP),2016,SSD-16/HSS10/SA1/H/INGO/738,1/7/2017 11:26:33 AM,Internally Displaced People,5603,11207,2230,2230,21270,22935,31846,2231,2171,59183
19,South Sudan (UNDP),2016,SSD-16/HSS10/SA1/H/INGO/738,1/7/2017 11:26:33 AM,Overall,21066,42134,8400,8400,80000,38910,59847,39177,42550,180484
19,South Sudan (UNDP),2016,SSD-16/HSS10/SA1/H/INGO/738,1/7/2017 11:26:33 AM,People in Host Communities,15463,30927,6170,6170,58730,15975,28001,36946,40379,121301
19,South Sudan (UNDP),2016,SSD-16/HSS10/SA1/H/INGO/738,1/7/2017 11:26:33 AM,Pregnant and Lactating Women,0,0,0,0,0,0,14439,0,0,14439
19,South Sudan (UNDP),2016,SSD-16/HSS10/SA1/H/INGO/775,9/28/2016 6:33:56 PM,Children under 5,0,0,0,0,0,0,0,5519,7076,12595
19,South Sudan (UNDP),2016,SSD-16/HSS10/SA1/H/INGO/775,9/28/2016 6:33:56 PM,Internally Displaced People,14391,12063,13756,12698,52908,12627,10756,12159,11224,46766
19,South Sudan (UNDP),2016,SSD-16/HSS10/SA1/H/INGO/775,9/28/2016 6:33:56 PM,Overall,26165,21933,25011,23087,96196,25863,29635,14150,15383,85031
19,South Sudan (UNDP),2016,SSD-16/HSS10/SA1/H/INGO/775,9/28/2016 6:33:56 PM,People in Host Communities,11774,9870,11255,10389,43288,11862,9949,11097,5357,38265
19,South Sudan (UNDP),2016,SSD-16/HSS10/SA1/H/INGO/775,9/28/2016 6:33:56 PM,Pregnant and Lactating Women,0,0,0,0,0,0,10372,0,0,10372
19,South Sudan (UNDP),2016,SSD-16/HSS10/SA1/H/INGO/784,1/26/2017 10:03:02 AM,Internally Displaced People,26901,33701,7074,6801,74477,0,0,0,0,0
19,South Sudan (UNDP),2016,SSD-16/HSS10/SA1/H/INGO/784,1/26/2017 10:03:02 AM,Overall,43182,43059,7074,6801,100116,25623,44064,15628,14075,99390
19,South Sudan (UNDP),2016,SSD-16/HSS10/SA1/H/INGO/817,1/19/2017 9:33:32 AM,Children under 5,0,0,4863,5020,9883,0,0,18072,17582,35654
19,South Sudan (UNDP),2016,SSD-16/HSS10/SA1/H/INGO/817,1/19/2017 9:33:32 AM,Internally Displaced People,4765,14862,2977,3073,25677,9574,14124,5750,8691,38139
19,South Sudan (UNDP),2016,SSD-16/HSS10/SA1/H/INGO/817,1/19/2017 9:33:32 AM,Overall,19059,30023,9923,10243,69248,35596,40114,18072,17582,111364
19,South Sudan (UNDP),2016,SSD-16/HSS10/SA1/H/INGO/817,1/19/2017 9:33:32 AM,People in Host Communities,14294,9928,2083,2150,28455,8124,11046,4780,6173,30123
19,South Sudan (UNDP),2016,SSD-16/HSS10/SA1/H/INGO/817,1/19/2017 9:33:32 AM,Pregnant and Lactating Women,0,5233,0,0,5233,0,7453,0,0,7453
19,South Sudan (UNDP),2016,SSD-16/HSS10/SA1/H/INGO/829,2/1/2017 12:07:24 PM,Other,11670,18856,9976,8168,48670,15779,24670,11934,9764,62147
19,South Sudan (UNDP),2016,SSD-16/HSS10/SA1/H/INGO/829,2/1/2017 12:07:24 PM,Overall,11670,18856,9976,8168,48670,15779,24670,11934,9764,62147
19,South Sudan (UNDP),2016,SSD-16/HSS10/SA1/H/NGO/693,10/31/2016 8:54:58 AM,Children under 5,0,0,861,928,1789,0,0,3275,4198,7473
19,South Sudan (UNDP),2016,SSD-16/HSS10/SA1/H/NGO/693,10/31/2016 8:54:58 AM,Internally Displaced People,5478,14798,3228,2300,25804,2123,3536,3868,4572,14099
19,South Sudan (UNDP),2016,SSD-16/HSS10/SA1/H/NGO/693,10/31/2016 8:54:58 AM,Other,1827,3250,800,722,6599,725,1232,624,429,3010
19,South Sudan (UNDP),2016,SSD-16/HSS10/SA1/H/NGO/693,10/31/2016 8:54:58 AM,Overall,10957,22809,5950,5650,45366,4444,7162,3899,6339,21844
19,South Sudan (UNDP),2016,SSD-16/HSS10/SA1/H/NGO/693,10/31/2016 8:54:58 AM,People in Host Communities,3652,4761,1061,1700,11174,1596,2394,1341,1712,7043
19,South Sudan (UNDP),2016,SSD-16/HSS10/SA1/H/NGO/766,10/31/2016 7:55:45 AM,Internally Displaced People,4740,5191,1320,1280,12531,2994,4363,1459,1684,10500
19,South Sudan (UNDP),2016,SSD-16/HSS10/SA1/H/NGO/766,10/31/2016 7:55:45 AM,Overall,23700,28300,6600,6400,65000,14970,21814,7297,8418,52499
19,South Sudan (UNDP),2016,SSD-16/HSS10/SA1/H/NGO/766,10/31/2016 7:55:45 AM,People in Host Communities,18960,20718,5280,5120,50078,11976,17451,5838,6734,41999
19,South Sudan (UNDP),2016,SSD-16/HSS10/SA1/H/NGO/766,10/31/2016 7:55:45 AM,Pregnant and Lactating Women,0,2391,0,0,2391,0,2100,0,0,2100
19,South Sudan (UNDP),2016,SSD-16/HSS10/SA1/H/NGO/773,1/16/2017 2:30:32 PM,Children under 5,0,0,6413,7140,13553,0,0,8225,9895,18120
19,South Sudan (UNDP),2016,SSD-16/HSS10/SA1/H/NGO/773,1/16/2017 2:30:32 PM,Internally Displaced People,7571,23987,15463,22452,69473,6340,15136,15875,16245,53596
19,South Sudan (UNDP),2016,SSD-16/HSS10/SA1/H/NGO/773,1/16/2017 2:30:32 PM,Overall,8872,31544,24644,33518,98578,7571,18592,18994,19701,64858
19,South Sudan (UNDP),2016,SSD-16/HSS10/SA1/H/NGO/773,1/16/2017 2:30:32 PM,People in Host Communities,1301,4103,2768,3926,12098,1231,3456,3119,3456,11262
19,South Sudan (UNDP),2016,SSD-16/HSS10/SA1/H/NGO/773,1/16/2017 2:30:32 PM,Pregnant and Lactating Women,0,3454,0,0,3454,0,2824,0,0,2824
19,South Sudan (UNDP),2016,SSD-16/HSS10/SA1/H/NGO/815,9/26/2016 11:34:39 AM,Children under 5,0,0,5332,3861,9193,0,0,5816,6346,12162
19,South Sudan (UNDP),2016,SSD-16/HSS10/SA1/H/NGO/815,9/26/2016 11:34:39 AM,Internally Displaced People,7955,10059,3813,3167,24994,3760,4128,1745,1904,11537
19,South Sudan (UNDP),2016,SSD-16/HSS10/SA1/H/NGO/815,9/26/2016 11:34:39 AM,Overall,11700,20328,12120,12042,56190,12534,14139,5816,6346,38835
19,South Sudan (UNDP),2016,SSD-16/HSS10/SA1/H/NGO/815,9/26/2016 11:34:39 AM,People in Host Communities,3745,5111,2975,4781,16612,8774,9653,4071,4442,26940
19,South Sudan (UNDP),2016,SSD-16/HSS10/SA1/H/NGO/815,9/26/2016 11:34:39 AM,Pregnant and Lactating Women,0,1680,0,233,1913,0,375,0,0,375
19,South Sudan (UNDP),2016,SSD-16/HSS10/SA1/H/UN/685,12/8/2016 2:09:10 PM,Children under 5,0,0,2208,2297,4505,0,0,102850,112880,215730
19,South Sudan (UNDP),2016,SSD-16/HSS10/SA1/H/UN/685,12/8/2016 2:09:10 PM,Internally Displaced People,15592,15918,2208,2297,36015,19363,34446,14996,13942,82747
19,South Sudan (UNDP),2016,SSD-16/HSS10/SA1/H/UN/685,12/8/2016 2:09:10 PM,Overall,33183,34537,6797,7074,81591,33707,66501,102850,112880,315938
19,South Sudan (UNDP),2016,SSD-16/HSS10/SA1/H/UN/685,12/8/2016 2:09:10 PM,People in Host Communities,17591,17835,2381,2480,40287,0,0,72855,75832,148687
19,South Sudan (UNDP),2016,SSD-16/HSS10/SA1/H/UN/685,12/8/2016 2:09:10 PM,Pregnant and Lactating Women,0,784,0,0,784,0,9478,0,1619,11097
19,South Sudan (UNDP),2016,SSD-16/HSS10/SA1/H/UN/750,9/8/2017 1:54:43 PM,Internally Displaced People,25300,23400,20000,19250,87950,58029,62084,27390,28504,176007
19,South Sudan (UNDP),2016,SSD-16/HSS10/SA1/H/UN/750,9/8/2017 1:54:43 PM,Overall,35000,31000,30000,29000,125000,71641,76648,33816,35191,217296
19,South Sudan (UNDP),2016,SSD-16/HSS10/SA1/H/UN/750,9/8/2017 1:54:43 PM,People in Host Communities,9700,7600,10000,9750,37050,13612,14564,6426,6687,41289
19,South Sudan (UNDP),2016,SSD-16/HSS10/SA1/H/UN/806,1/19/2017 9:07:36 AM,Children under 5,0,0,15435,19065,34500,0,0,19992,20808,40800
19,South Sudan (UNDP),2016,SSD-16/HSS10/SA1/H/UN/806,1/19/2017 9:07:36 AM,Internally Displaced People,61065,54435,0,0,115500,74163,73390,0,0,147553
19,South Sudan (UNDP),2016,SSD-16/HSS10/SA1/H/UN/806,1/19/2017 9:07:36 AM,Overall,61065,54435,15435,19065,150000,74163,73390,19992,20808,188353
19,South Sudan (UNDP),2016,SSD-16/HSS10/SA1/L/UN/686,12/2/2016 12:18:16 PM,Aid Agencies,80,0,0,0,80,0,0,0,58,58
19,South Sudan (UNDP),2016,SSD-16/HSS10/SA1/L/UN/686,12/2/2016 12:18:16 PM,Overall,80,0,0,0,80,0,0,0,58,58
19,South Sudan (UNDP),2016,SSD-16/HSS10/SA1/L/UN/688,6/29/2016 7:37:02 AM,Aid Agencies,250,0,0,0,250,222,0,0,0,222
19,South Sudan (UNDP),2016,SSD-16/HSS10/SA1/L/UN/688,6/29/2016 7:37:02 AM,Overall,14000,0,0,0,14000,19066,0,0,0,19066
19,South Sudan (UNDP),2016,SSD-16/HSS10/SA1/L/UN/754,6/29/2016 7:47:44 AM,Aid Agencies,80,0,0,0,80,77,0,0,0,77
19,South Sudan (UNDP),2016,SSD-16/HSS10/SA1/L/UN/754,6/29/2016 7:47:44 AM,Overall,80,0,0,0,80,77,0,0,0,77
19,South Sudan (UNDP),2016,SSD-16/HSS10/SA1/L/UN/780,12/16/2016 9:28:49 AM,Aid Agencies,80,0,0,0,80,87,0,0,0,87
19,South Sudan (UNDP),2016,SSD-16/HSS10/SA1/L/UN/780,12/16/2016 9:28:49 AM,Overall,80,0,0,0,80,87,0,0,0,87
19,South Sudan (UNDP),2016,SSD-16/HSS10/SA1/N/INGO/704,9/11/2016 11:44:56 AM,Children under 5,0,0,2067,2152,4219,0,0,2022,1984,4006
19,South Sudan (UNDP),2016,SSD-16/HSS10/SA1/N/INGO/704,9/11/2016 11:44:56 AM,Internally Displaced People,35,0,0,0,35,104,346,708,694,1852
19,South Sudan (UNDP),2016,SSD-16/HSS10/SA1/N/INGO/704,9/11/2016 11:44:56 AM,Overall,100,857,2067,2152,5176,298,990,2022,1984,5294
19,South Sudan (UNDP),2016,SSD-16/HSS10/SA1/N/INGO/704,9/11/2016 11:44:56 AM,People in Host Communities,65,0,0,0,65,194,644,1314,1290,3442
19,South Sudan (UNDP),2016,SSD-16/HSS10/SA1/N/INGO/704,9/11/2016 11:44:56 AM,Pregnant and Lactating Women,0,857,0,0,857,0,990,0,0,990
19,South Sudan (UNDP),2016,SSD-16/HSS10/SA1/N/INGO/733,10/24/2016 12:21:19 PM,Children under 5,0,0,520,541,1061,0,0,757,835,1592
19,South Sudan (UNDP),2016,SSD-16/HSS10/SA1/N/INGO/733,10/24/2016 12:21:19 PM,Internally Displaced People,0,63,134,140,337,0,72,189,209,470
19,South Sudan (UNDP),2016,SSD-16/HSS10/SA1/N/INGO/733,10/24/2016 12:21:19 PM,Overall,0,313,670,698,1681,0,288,757,835,1880
19,South Sudan (UNDP),2016,SSD-16/HSS10/SA1/N/INGO/733,10/24/2016 12:21:19 PM,People in Host Communities,0,250,536,558,1344,0,216,568,626,1410
19,South Sudan (UNDP),2016,SSD-16/HSS10/SA1/N/INGO/733,10/24/2016 12:21:19 PM,Pregnant and Lactating Women,0,313,0,0,313,0,288,0,0,288
19,South Sudan (UNDP),2016,SSD-16/HSS10/SA1/N/INGO/795,1/12/2017 7:40:46 AM,Children under 5,0,0,5252,5466,10718,0,0,9883,10326,20209
19,South Sudan (UNDP),2016,SSD-16/HSS10/SA1/N/INGO/795,1/12/2017 7:40:46 AM,Internally Displaced People,0,200,0,0,200,0,12801,0,0,12801
19,South Sudan (UNDP),2016,SSD-16/HSS10/SA1/N/INGO/795,1/12/2017 7:40:46 AM,Overall,60,866,11002,11451,23379,133,2528,9883,10326,22870
19,South Sudan (UNDP),2016,SSD-16/HSS10/SA1/N/INGO/795,1/12/2017 7:40:46 AM,Pregnant and Lactating Women,0,626,0,0,626,0,4884,0,0,4884
19,South Sudan (UNDP),2016,SSD-16/HSS10/SA1/N/INGO/795,1/12/2017 7:40:46 AM,"Trainers, Promoters, Caretakers, committee members, etc.",60,40,0,0,100,133,2560,0,0,2693
19,South Sudan (UNDP),2016,SSD-16/HSS10/SA1/N/INGO/810,2/3/2017 1:13:49 PM,Children under 5,0,0,2576,2715,5291,0,0,1720,1913,3633
19,South Sudan (UNDP),2016,SSD-16/HSS10/SA1/N/INGO/810,2/3/2017 1:13:49 PM,Internally Displaced People,0,1008,0,0,1008,0,0,1038,1073,2111
19,South Sudan (UNDP),2016,SSD-16/HSS10/SA1/N/INGO/810,2/3/2017 1:13:49 PM,Other,5,5,0,0,10,5,0,0,0,5
19,South Sudan (UNDP),2016,SSD-16/HSS10/SA1/N/INGO/810,2/3/2017 1:13:49 PM,Overall,5,1013,2576,2715,6309,5,363,1720,1913,4001
19,South Sudan (UNDP),2016,SSD-16/HSS10/SA1/N/INGO/811,1/12/2017 7:33:18 AM,Children under 5,0,0,6667,6941,13608,0,0,4712,4338,9050
19,South Sudan (UNDP),2016,SSD-16/HSS10/SA1/N/INGO/811,1/12/2017 7:33:18 AM,Overall,10,6867,6667,6941,20485,1,5619,4712,4338,14670
19,South Sudan (UNDP),2016,SSD-16/HSS10/SA1/N/INGO/811,1/12/2017 7:33:18 AM,Pregnant and Lactating Women,0,4214,0,0,4214,0,5590,0,0,5590
19,South Sudan (UNDP),2016,SSD-16/HSS10/SA1/N/INGO/811,1/12/2017 7:33:18 AM,"Trainers, Promoters, Caretakers, committee members, etc.",10,10,0,0,20,1,29,0,0,30
19,South Sudan (UNDP),2016,SSD-16/HSS10/SA1/N/INGO/823,1/12/2017 2:08:01 PM,Children under 5,0,0,1193,1241,2434,0,0,520,781,1301
19,South Sudan (UNDP),2016,SSD-16/HSS10/SA1/N/INGO/823,1/12/2017 2:08:01 PM,Internally Displaced People,1781,898,1193,1241,5113,0,0,0,0,0
19,South Sudan (UNDP),2016,SSD-16/HSS10/SA1/N/INGO/823,1/12/2017 2:08:01 PM,Overall,0,898,1193,1241,3332,0,931,520,781,2232
19,South Sudan (UNDP),2016,SSD-16/HSS10/SA1/N/INGO/823,1/12/2017 2:08:01 PM,People in Host Communities,5819,5716,2465,3672,17672,0,0,0,0,0
19,South Sudan (UNDP),2016,SSD-16/HSS10/SA1/N/INGO/823,1/12/2017 2:08:01 PM,Pregnant and Lactating Women,0,860,0,0,860,0,931,0,0,931
19,South Sudan (UNDP),2016,SSD-16/HSS10/SA1/N/INGO/825,1/5/2017 8:51:14 AM,Children under 5,0,0,0,0,0,0,0,10451,12853,23304
19,South Sudan (UNDP),2016,SSD-16/HSS10/SA1/N/INGO/825,1/5/2017 8:51:14 AM,Internally Displaced People,308,5437,4744,5140,15629,1238,12568,4181,5502,23489
19,South Sudan (UNDP),2016,SSD-16/HSS10/SA1/N/INGO/825,1/5/2017 8:51:14 AM,Overall,640,11326,9884,10708,32558,1821,27461,10451,12853,52586
19,South Sudan (UNDP),2016,SSD-16/HSS10/SA1/N/INGO/825,1/5/2017 8:51:14 AM,People in Host Communities,332,5889,5140,5568,16929,583,14893,6270,7351,29097
19,South Sudan (UNDP),2016,SSD-16/HSS10/SA1/N/INGO/825,1/5/2017 8:51:14 AM,Pregnant and Lactating Women,0,0,0,0,0,0,5620,0,0,5620
19,South Sudan (UNDP),2016,SSD-16/HSS10/SA1/N/INGO/847,2/8/2017 5:49:55 AM,Children under 5,0,0,30948,33527,64475,0,0,31857,33981,65838
19,South Sudan (UNDP),2016,SSD-16/HSS10/SA1/N/INGO/847,2/8/2017 5:49:55 AM,Internally Displaced People,367,1975,2166,2347,6855,678,5729,2230,2378,11015
19,South Sudan (UNDP),2016,SSD-16/HSS10/SA1/N/INGO/847,2/8/2017 5:49:55 AM,Overall,5244,28218,30948,33527,97937,9685,81842,31857,33981,157365
19,South Sudan (UNDP),2016,SSD-16/HSS10/SA1/N/INGO/847,2/8/2017 5:49:55 AM,People in Host Communities,4877,26243,28782,31180,91082,9007,76113,29627,31603,146350
19,South Sudan (UNDP),2016,SSD-16/HSS10/SA1/N/INGO/847,2/8/2017 5:49:55 AM,Pregnant and Lactating Women,0,18000,0,0,18000,0,17638,0,0,17638
19,South Sudan (UNDP),2016,SSD-16/HSS10/SA1/N/INGO/869,1/5/2017 9:09:32 AM,Children under 5,0,0,5472,5696,11168,0,0,5814,6657,12471
19,South Sudan (UNDP),2016,SSD-16/HSS10/SA1/N/INGO/869,1/5/2017 9:09:32 AM,Other,416,0,0,0,416,0,0,0,0,0
19,South Sudan (UNDP),2016,SSD-16/HSS10/SA1/N/INGO/869,1/5/2017 9:09:32 AM,Overall,416,4158,5472,5696,15742,3076,4614,5814,6657,20161
19,South Sudan (UNDP),2016,SSD-16/HSS10/SA1/N/INGO/869,1/5/2017 9:09:32 AM,Pregnant and Lactating Women,0,4158,0,0,4158,0,4614,0,0,4614
19,South Sudan (UNDP),2016,SSD-16/HSS10/SA1/N/NGO/675,1/16/2017 8:48:40 AM,Children under 5,0,0,880,780,1660,0,0,7349,6732,14081
19,South Sudan (UNDP),2016,SSD-16/HSS10/SA1/N/NGO/675,1/16/2017 8:48:40 AM,Internally Displaced People,200,203,0,0,403,195,1931,0,0,2126
19,South Sudan (UNDP),2016,SSD-16/HSS10/SA1/N/NGO/675,1/16/2017 8:48:40 AM,Overall,500,1351,880,780,3511,444,4972,7349,6732,19497
19,South Sudan (UNDP),2016,SSD-16/HSS10/SA1/N/NGO/675,1/16/2017 8:48:40 AM,People in Host Communities,300,338,0,0,638,249,2124,0,0,2373
19,South Sudan (UNDP),2016,SSD-16/HSS10/SA1/N/NGO/675,1/16/2017 8:48:40 AM,Pregnant and Lactating Women,0,810,0,0,810,0,917,0,0,917
19,South Sudan (UNDP),2016,SSD-16/HSS10/SA1/N/NGO/713,1/9/2017 7:38:53 AM,Internally Displaced People,75,434,542,565,1616,15,360,547,569,1491
19,South Sudan (UNDP),2016,SSD-16/HSS10/SA1/N/NGO/713,1/9/2017 7:38:53 AM,Overall,150,869,1085,1130,3234,40,783,1094,1139,3056
19,South Sudan (UNDP),2016,SSD-16/HSS10/SA1/N/NGO/713,1/9/2017 7:38:53 AM,People in Host Communities,75,435,543,565,1618,25,423,547,570,1565
19,South Sudan (UNDP),2016,SSD-16/HSS10/SA1/N/NGO/736,9/28/2016 11:52:12 AM,Children under 5,0,0,1097,1335,2432,0,0,1099,1292,2391
19,South Sudan (UNDP),2016,SSD-16/HSS10/SA1/N/NGO/736,9/28/2016 11:52:12 AM,Internally Displaced People,2000,1328,459,486,4273,1618,732,555,828,3733
19,South Sudan (UNDP),2016,SSD-16/HSS10/SA1/N/NGO/736,9/28/2016 11:52:12 AM,Overall,3000,5300,2860,3640,14800,2998,3238,2960,3940,13136
19,South Sudan (UNDP),2016,SSD-16/HSS10/SA1/N/NGO/736,9/28/2016 11:52:12 AM,People in Host Communities,1000,1300,1304,1819,5423,1380,1017,1306,1820,5523
19,South Sudan (UNDP),2016,SSD-16/HSS10/SA1/N/NGO/736,9/28/2016 11:52:12 AM,Pregnant and Lactating Women,0,2300,0,0,2300,0,1472,0,0,1472
19,South Sudan (UNDP),2016,SSD-16/HSS10/SA1/N/NGO/771,9/11/2016 2:25:53 PM,Children under 5,0,0,1782,1791,3573,0,0,5224,5345,10569
19,South Sudan (UNDP),2016,SSD-16/HSS10/SA1/N/NGO/771,9/11/2016 2:25:53 PM,Internally Displaced People,245,1149,763,731,2888,85,762,2090,2138,5075
19,South Sudan (UNDP),2016,SSD-16/HSS10/SA1/N/NGO/771,9/11/2016 2:25:53 PM,Overall,612,5476,3636,3654,13378,212,1904,5224,5345,12685
19,South Sudan (UNDP),2016,SSD-16/HSS10/SA1/N/NGO/771,9/11/2016 2:25:53 PM,People in Host Communities,367,1697,1091,1132,4287,127,1142,3134,3207,7610
19,South Sudan (UNDP),2016,SSD-16/HSS10/SA1/N/NGO/771,9/11/2016 2:25:53 PM,Pregnant and Lactating Women,0,2630,0,0,2630,0,1904,0,0,1904
19,South Sudan (UNDP),2016,SSD-16/HSS10/SA1/N/UN/711,1/12/2017 7:36:22 AM,Children under 5,0,0,44019,44905,88924,0,0,29959,31182,61141
19,South Sudan (UNDP),2016,SSD-16/HSS10/SA1/N/UN/711,1/12/2017 7:36:22 AM,Internally Displaced People,0,14528,8305,12454,35287,0,0,0,0,0
19,South Sudan (UNDP),2016,SSD-16/HSS10/SA1/N/UN/711,1/12/2017 7:36:22 AM,Overall,12010,22500,53190,58649,146349,0,32750,29959,31182,93891
19,South Sudan (UNDP),2016,SSD-16/HSS10/SA1/N/UN/711,1/12/2017 7:36:22 AM,People in Host Communities,3904,1779,866,1290,7839,4900,5101,0,0,10001
19,South Sudan (UNDP),2016,SSD-16/HSS10/SA1/N/UN/711,1/12/2017 7:36:22 AM,Pregnant and Lactating Women,0,6193,0,0,6193,0,32750,0,0,32750
19,South Sudan (UNDP),2016,SSD-16/HSS10/SA1/N/UN/721,10/24/2016 12:15:50 PM,Children under 5,0,0,5635,5865,11500,0,0,7057,7645,14702
19,South Sudan (UNDP),2016,SSD-16/HSS10/SA1/N/UN/721,10/24/2016 12:15:50 PM,Overall,0,0,5635,5865,11500,0,0,7057,7645,14702
19,South Sudan (UNDP),2016,SSD-16/HSS10/SA1/N/UN/767,9/11/2016 11:32:32 AM,Overall,0,9725,0,0,9725,0,7756,0,0,7756
19,South Sudan (UNDP),2016,SSD-16/HSS10/SA1/N/UN/767,9/11/2016 11:32:32 AM,Pregnant and Lactating Women,0,9725,0,0,9725,0,7756,0,0,7756
19,South Sudan (UNDP),2016,SSD-16/HSS10/SA1/NFI/INGO/712,1/7/2017 3:07:51 PM,Internally Displaced People,4950,7425,6187,6187,24749,0,0,0,0,0
19,South Sudan (UNDP),2016,SSD-16/HSS10/SA1/NFI/INGO/712,1/7/2017 3:07:51 PM,Overall,6600,9900,8250,8250,33000,35309,46218,13114,12206,106847
19,South Sudan (UNDP),2016,SSD-16/HSS10/SA1/NFI/INGO/712,1/7/2017 3:07:51 PM,People in Host Communities,1650,2475,2062,2063,8250,0,0,0,0,0
19,South Sudan (UNDP),2016,SSD-16/HSS10/SA1/NFI/INGO/725,1/7/2017 3:04:33 PM,Children under 5,0,0,0,0,0,0,0,1333,1384,2717
19,South Sudan (UNDP),2016,SSD-16/HSS10/SA1/NFI/INGO/725,1/7/2017 3:04:33 PM,Internally Displaced People,2662,4776,4526,4526,16490,3556,4823,4444,4616,17439
19,South Sudan (UNDP),2016,SSD-16/HSS10/SA1/NFI/INGO/725,1/7/2017 3:04:33 PM,Overall,2662,4776,4526,4526,16490,3556,4823,4444,4616,17439
19,South Sudan (UNDP),2016,SSD-16/HSS10/SA1/NFI/INGO/763,1/13/2017 9:04:03 AM,Internally Displaced People,2000,1600,1300,1360,6260,0,0,0,0,0
19,South Sudan (UNDP),2016,SSD-16/HSS10/SA1/NFI/INGO/763,1/13/2017 9:04:03 AM,Overall,2000,1600,1300,1360,6260,3000,2000,500,300,5800
19,South Sudan (UNDP),2016,SSD-16/HSS10/SA1/NFI/INGO/776,1/7/2017 2:46:45 PM,Internally Displaced People,5040,5460,5040,5460,21000,3502,4639,4299,5024,17464
19,South Sudan (UNDP),2016,SSD-16/HSS10/SA1/NFI/INGO/776,1/7/2017 2:46:45 PM,Overall,7200,7800,7200,7800,30000,8575,9753,8843,10060,37231
19,South Sudan (UNDP),2016,SSD-16/HSS10/SA1/NFI/INGO/776,1/7/2017 2:46:45 PM,People in Host Communities,720,780,720,780,3000,959,1128,1281,1336,4704
19,South Sudan (UNDP),2016,SSD-16/HSS10/SA1/NFI/INGO/776,1/7/2017 2:46:45 PM,Refugee Returnees,1440,1560,1440,1560,6000,4114,3986,3263,3700,15063
19,South Sudan (UNDP),2016,SSD-16/HSS10/SA1/NFI/INGO/812,1/7/2017 3:18:50 PM,Internally Displaced People,24000,29760,21120,21120,96000,24200,26449,14058,13963,78670
19,South Sudan (UNDP),2016,SSD-16/HSS10/SA1/NFI/INGO/812,1/7/2017 3:18:50 PM,Overall,24000,29760,21120,21120,96000,24200,26449,14058,13963,78670
19,South Sudan (UNDP),2016,SSD-16/HSS10/SA1/NFI/INGO/828,1/11/2017 5:44:51 AM,Internally Displaced People,7200,8000,7600,8400,31200,8264,8143,6307,8159,30873
19,South Sudan (UNDP),2016,SSD-16/HSS10/SA1/NFI/INGO/828,1/11/2017 5:44:51 AM,Overall,9000,10000,9500,10500,39000,13135,13363,11030,13059,50587
19,South Sudan (UNDP),2016,SSD-16/HSS10/SA1/NFI/INGO/828,1/11/2017 5:44:51 AM,People in Host Communities,1800,2000,1900,2100,7800,4871,5222,4723,4900,19716
19,South Sudan (UNDP),2016,SSD-16/HSS10/SA1/NFI/INGO/831,1/11/2017 6:24:38 AM,Children under 5,0,0,1369,1288,2657,0,0,1767,1662,3429
19,South Sudan (UNDP),2016,SSD-16/HSS10/SA1/NFI/INGO/831,1/11/2017 6:24:38 AM,Internally Displaced People,10163,9739,6496,6650,33048,13701,12568,8970,8582,43821
19,South Sudan (UNDP),2016,SSD-16/HSS10/SA1/NFI/INGO/831,1/11/2017 6:24:38 AM,Overall,12718,13172,9538,9993,45421,10808,16601,15667,15541,58617
19,South Sudan (UNDP),2016,SSD-16/HSS10/SA1/NFI/INGO/831,1/11/2017 6:24:38 AM,People in Host Communities,2555,2343,1673,1600,8171,3297,3024,2159,2065,10545
19,South Sudan (UNDP),2016,SSD-16/HSS10/SA1/NFI/INGO/831,1/11/2017 6:24:38 AM,Pregnant and Lactating Women,0,636,0,0,636,0,821,0,0,821
19,South Sudan (UNDP),2016,SSD-16/HSS10/SA1/NFI/NGO/694,1/26/2017 9:19:19 AM,Children under 5,0,0,690,900,1590,0,0,690,900,1590
19,South Sudan (UNDP),2016,SSD-16/HSS10/SA1/NFI/NGO/694,1/26/2017 9:19:19 AM,Internally Displaced People,3200,4200,2700,2800,12900,2980,4060,2590,2650,12280
19,South Sudan (UNDP),2016,SSD-16/HSS10/SA1/NFI/NGO/694,1/26/2017 9:19:19 AM,Overall,3670,4880,4150,4570,17270,3670,4880,4150,4570,17270
19,South Sudan (UNDP),2016,SSD-16/HSS10/SA1/NFI/NGO/694,1/26/2017 9:19:19 AM,People in Host Communities,470,680,760,870,2780,690,820,870,1020,3400
19,South Sudan (UNDP),2016,SSD-16/HSS10/SA1/NFI/NGO/765,1/19/2017 11:12:38 AM,Internally Displaced People,6000,9000,3000,3000,21000,4800,7700,4400,4600,21500
19,South Sudan (UNDP),2016,SSD-16/HSS10/SA1/NFI/NGO/765,1/19/2017 11:12:38 AM,Overall,8000,12000,5000,5000,30000,4800,7700,4400,4600,21500
19,South Sudan (UNDP),2016,SSD-16/HSS10/SA1/NFI/NGO/765,1/19/2017 11:12:38 AM,People in Host Communities,500,800,1300,1300,3900,0,0,0,0,0
19,South Sudan (UNDP),2016,SSD-16/HSS10/SA1/NFI/NGO/765,1/19/2017 11:12:38 AM,Pregnant and Lactating Women,0,1600,0,0,1600,0,0,0,0,0
19,South Sudan (UNDP),2016,SSD-16/HSS10/SA1/NFI/UN/687,7/13/2017 11:15:04 AM,Children under 5,0,0,4500,4950,9450,0,0,4556,5012,9568
19,South Sudan (UNDP),2016,SSD-16/HSS10/SA1/NFI/UN/687,7/13/2017 11:15:04 AM,Internally Displaced People,4500,6600,4500,4950,20550,4556,6682,4556,5011,20805
19,South Sudan (UNDP),2016,SSD-16/HSS10/SA1/NFI/UN/687,7/13/2017 11:15:04 AM,Overall,4500,6600,9000,9900,30000,4556,6682,9112,10023,30373
19,South Sudan (UNDP),2016,SSD-16/HSS10/SA1/NFI/UN/709,1/11/2017 5:42:57 AM,Internally Displaced People,21250,22950,19550,21250,85000,18167,19681,22204,24054,84106
19,South Sudan (UNDP),2016,SSD-16/HSS10/SA1/NFI/UN/709,1/11/2017 5:42:57 AM,Overall,25000,27000,23000,25000,100000,21373,23154,26122,28299,98948
19,South Sudan (UNDP),2016,SSD-16/HSS10/SA1/NFI/UN/709,1/11/2017 5:42:57 AM,People in Host Communities,3750,4050,3450,3750,15000,3206,3473,3918,4245,14842
19,South Sudan (UNDP),2016,SSD-16/HSS10/SA1/P/INGO/755,5/2/2017 7:19:48 AM,Internally Displaced People,865,1150,1725,2015,5755,903,1402,1566,1435,5306
19,South Sudan (UNDP),2016,SSD-16/HSS10/SA1/P/INGO/755,5/2/2017 7:19:48 AM,Overall,1725,2300,3450,4025,11500,2505,3821,4318,4166,14810
19,South Sudan (UNDP),2016,SSD-16/HSS10/SA1/P/INGO/755,5/2/2017 7:19:48 AM,People in Host Communities,860,1150,1725,2010,5745,1602,2419,2752,2731,9504
19,South Sudan (UNDP),2016,SSD-16/HSS10/SA1/P/INGO/778,9/28/2016 12:03:58 PM,Internally Displaced People,4538,12000,1829,7930,26297,8547,16749,1911,8896,36103
19,South Sudan (UNDP),2016,SSD-16/HSS10/SA1/P/INGO/778,9/28/2016 12:03:58 PM,Overall,4776,12631,1912,8360,27679,8997,17631,2012,9360,38000
19,South Sudan (UNDP),2016,SSD-16/HSS10/SA1/P/INGO/778,9/28/2016 12:03:58 PM,People in Host Communities,238,631,83,430,1382,450,882,101,468,1901
19,South Sudan (UNDP),2016,SSD-16/HSS10/SA1/P/INGO/850,9/28/2016 12:02:57 PM,Overall,1237,9673,645,5000,16555,2865,14435,3566,11615,32481
19,South Sudan (UNDP),2016,SSD-16/HSS10/SA1/P/NGO/748,12/22/2016 9:10:33 AM,Internally Displaced People,250,2250,300,500,3300,500,3200,400,1500,5600
19,South Sudan (UNDP),2016,SSD-16/HSS10/SA1/P/NGO/748,12/22/2016 9:10:33 AM,Overall,500,3400,500,1000,5400,900,5400,800,2500,9600
19,South Sudan (UNDP),2016,SSD-16/HSS10/SA1/P/NGO/748,12/22/2016 9:10:33 AM,People in Host Communities,200,1100,200,500,2000,400,2200,400,1000,4000
19,South Sudan (UNDP),2016,SSD-16/HSS10/SA1/P/NGO/748,12/22/2016 9:10:33 AM,"Trainers, Promoters, Caretakers, committee members, etc.",50,50,0,0,100,50,50,0,0,100
19,South Sudan (UNDP),2016,SSD-16/HSS10/SA1/P/NGO/774,9/28/2016 12:04:48 PM,Internally Displaced People,166,1940,200,900,3206,180,751,266,403,1600
19,South Sudan (UNDP),2016,SSD-16/HSS10/SA1/P/NGO/774,9/28/2016 12:04:48 PM,Overall,300,3000,300,1400,5000,858,2255,776,1255,5144
19,South Sudan (UNDP),2016,SSD-16/HSS10/SA1/P/NGO/774,9/28/2016 12:04:48 PM,People in Host Communities,110,1000,100,500,1710,553,1377,510,852,3292
19,South Sudan (UNDP),2016,SSD-16/HSS10/SA1/P/NGO/774,9/28/2016 12:04:48 PM,"Trainers, Promoters, Caretakers, committee members, etc.",23,35,0,0,58,125,127,0,0,252
19,South Sudan (UNDP),2016,SSD-16/HSS10/SA1/P/NGO/824,2/3/2017 7:41:21 AM,Internally Displaced People,6,23,321,412,762,53,58,1271,1192,2574
19,South Sudan (UNDP),2016,SSD-16/HSS10/SA1/P/NGO/824,2/3/2017 7:41:21 AM,Overall,14,41,661,842,1558,53,58,1271,1192,2574
19,South Sudan (UNDP),2016,SSD-16/HSS10/SA1/P/NGO/824,2/3/2017 7:41:21 AM,"Trainers, Promoters, Caretakers, committee members, etc.",8,18,340,430,796,16,11,652,376,1055
19,South Sudan (UNDP),2016,SSD-16/HSS10/SA1/P/NGO/853,1/18/2017 9:00:50 AM,Internally Displaced People,100,120,300,300,820,83,128,495,363,1069
19,South Sudan (UNDP),2016,SSD-16/HSS10/SA1/P/NGO/853,1/18/2017 9:00:50 AM,Overall,150,170,485,485,1290,214,138,688,593,1633
19,South Sudan (UNDP),2016,SSD-16/HSS10/SA1/P/NGO/853,1/18/2017 9:00:50 AM,People in Host Communities,50,50,185,185,470,58,83,193,230,564
19,South Sudan (UNDP),2016,SSD-16/HSS10/SA1/P/UN/672,1/9/2017 2:04:02 PM,Internally Displaced People,10,5000,0,3500,8510,10,6500,0,4000,10510
19,South Sudan (UNDP),2016,SSD-16/HSS10/SA1/P/UN/672,1/9/2017 2:04:02 PM,Overall,45,5075,0,3500,8620,45,6575,0,4000,10620
19,South Sudan (UNDP),2016,SSD-16/HSS10/SA1/P/UN/672,1/9/2017 2:04:02 PM,People in Host Communities,35,75,0,0,110,35,75,0,0,110
19,South Sudan (UNDP),2016,SSD-16/HSS10/SA1/P/UN/732,12/22/2016 12:13:52 PM,Internally Displaced People,75,75,700,800,1650,107,93,2186,2081,4467
19,South Sudan (UNDP),2016,SSD-16/HSS10/SA1/P/UN/732,12/22/2016 12:13:52 PM,Overall,100,100,700,800,1700,143,124,2186,2081,4534
19,South Sudan (UNDP),2016,SSD-16/HSS10/SA1/P/UN/732,12/22/2016 12:13:52 PM,People in Host Communities,25,25,0,0,50,36,31,0,0,67
19,South Sudan (UNDP),2016,SSD-16/HSS10/SA1/P/UN/842,2/6/2017 8:42:58 AM,Internally Displaced People,1595,2698,1666,1525,7484,1864,3559,1578,1351,8352
19,South Sudan (UNDP),2016,SSD-16/HSS10/SA1/P/UN/842,2/6/2017 8:42:58 AM,Overall,1595,2698,1666,1525,7484,1864,3559,1578,1351,8352
19,South Sudan (UNDP),2016,SSD-16/HSS10/SA1/WASH/INGO/679,12/8/2016 2:11:24 PM,Overall,5900,11800,5400,6900,30000,2458,4917,2250,2875,12500
19,South Sudan (UNDP),2016,SSD-16/HSS10/SA1/WASH/INGO/701,9/28/2016 12:23:51 PM,Internally Displaced People,438,474,744,744,2400,0,0,0,0,0
19,South Sudan (UNDP),2016,SSD-16/HSS10/SA1/WASH/INGO/701,9/28/2016 12:23:51 PM,Overall,1459,1581,2480,2480,8000,3939,4061,0,0,8000
19,South Sudan (UNDP),2016,SSD-16/HSS10/SA1/WASH/INGO/701,9/28/2016 12:23:51 PM,People in Host Communities,1021,1107,1736,1736,5600,0,0,0,0,0
19,South Sudan (UNDP),2016,SSD-16/HSS10/SA1/WASH/INGO/737,12/8/2016 2:08:09 PM,Children under 5,0,0,2000,2000,4000,0,0,4240,4270,8510
19,South Sudan (UNDP),2016,SSD-16/HSS10/SA1/WASH/INGO/737,12/8/2016 2:08:09 PM,Internally Displaced People,2000,2000,2000,2000,8000,3700,4200,4600,4300,16800
19,South Sudan (UNDP),2016,SSD-16/HSS10/SA1/WASH/INGO/737,12/8/2016 2:08:09 PM,Overall,6000,7000,6000,6000,25000,10751,20210,11809,12660,55430
19,South Sudan (UNDP),2016,SSD-16/HSS10/SA1/WASH/INGO/737,12/8/2016 2:08:09 PM,People in Host Communities,4000,4000,2000,2000,12000,5050,7760,6458,5092,24360
19,South Sudan (UNDP),2016,SSD-16/HSS10/SA1/WASH/INGO/737,12/8/2016 2:08:09 PM,Pregnant and Lactating Women,0,1000,0,0,1000,0,5760,0,0,5760
19,South Sudan (UNDP),2016,SSD-16/HSS10/SA1/WASH/INGO/747,9/28/2016 3:48:12 PM,Children under 5,0,0,619,645,1264,0,0,539,561,1100
19,South Sudan (UNDP),2016,SSD-16/HSS10/SA1/WASH/INGO/747,9/28/2016 3:48:12 PM,Internally Displaced People,1207,1257,949,987,4400,960,1000,755,785,3500
19,South Sudan (UNDP),2016,SSD-16/HSS10/SA1/WASH/INGO/747,9/28/2016 3:48:12 PM,Overall,1652,1719,1298,1351,6020,1438,1497,1130,1176,5241
19,South Sudan (UNDP),2016,SSD-16/HSS10/SA1/WASH/INGO/747,9/28/2016 3:48:12 PM,People in Host Communities,444,463,349,364,1620,477,497,375,390,1739
19,South Sudan (UNDP),2016,SSD-16/HSS10/SA1/WASH/INGO/747,9/28/2016 3:48:12 PM,Pregnant and Lactating Women,0,482,0,0,482,0,419,0,0,419
19,South Sudan (UNDP),2016,SSD-16/HSS10/SA1/WASH/INGO/751,12/8/2016 2:01:38 PM,Children under 5,0,0,1356,1268,2624,0,0,1356,1268,2624
19,South Sudan (UNDP),2016,SSD-16/HSS10/SA1/WASH/INGO/751,12/8/2016 2:01:38 PM,Overall,6197,5183,4638,4415,20433,6197,5183,4638,4415,20433
19,South Sudan (UNDP),2016,SSD-16/HSS10/SA1/WASH/INGO/792,1/12/2017 6:27:02 AM,Children under 5,0,0,1500,1500,3000,0,0,1792,1719,3511
19,South Sudan (UNDP),2016,SSD-16/HSS10/SA1/WASH/INGO/792,1/12/2017 6:27:02 AM,Internally Displaced People,750,1050,450,750,3000,1094,1041,665,646,3446
19,South Sudan (UNDP),2016,SSD-16/HSS10/SA1/WASH/INGO/792,1/12/2017 6:27:02 AM,Overall,5500,7700,4800,7000,25000,7293,6938,4432,4309,22972
19,South Sudan (UNDP),2016,SSD-16/HSS10/SA1/WASH/INGO/792,1/12/2017 6:27:02 AM,People in Host Communities,4750,6650,2850,4750,19000,6199,5897,3767,3663,19526
19,South Sudan (UNDP),2016,SSD-16/HSS10/SA1/WASH/INGO/804,2/8/2017 8:58:48 AM,Children under 5,0,0,290,268,558,0,0,301,379,680
19,South Sudan (UNDP),2016,SSD-16/HSS10/SA1/WASH/INGO/804,2/8/2017 8:58:48 AM,Internally Displaced People,850,2372,605,558,4385,837,2538,625,816,4816
19,South Sudan (UNDP),2016,SSD-16/HSS10/SA1/WASH/INGO/804,2/8/2017 8:58:48 AM,Overall,916,3254,1248,1152,6570,908,3517,1208,1522,7155
19,South Sudan (UNDP),2016,SSD-16/HSS10/SA1/WASH/INGO/804,2/8/2017 8:58:48 AM,People in Host Communities,66,228,353,326,973,71,247,282,327,927
19,South Sudan (UNDP),2016,SSD-16/HSS10/SA1/WASH/INGO/804,2/8/2017 8:58:48 AM,Pregnant and Lactating Women,0,654,0,0,654,0,732,0,0,732
19,South Sudan (UNDP),2016,SSD-16/HSS10/SA1/WASH/INGO/827,12/8/2016 2:40:38 PM,Internally Displaced People,2112,2112,2976,2400,9600,3450,3450,3795,3105,13800
19,South Sudan (UNDP),2016,SSD-16/HSS10/SA1/WASH/INGO/827,12/8/2016 2:40:38 PM,Overall,2112,2112,2976,2400,9600,3450,3450,3795,3105,13800
19,South Sudan (UNDP),2016,SSD-16/HSS10/SA1/WASH/INGO/845,12/8/2016 1:35:35 PM,Children under 5,0,0,1049,1137,2186,0,0,2426,2488,4914
19,South Sudan (UNDP),2016,SSD-16/HSS10/SA1/WASH/INGO/845,12/8/2016 1:35:35 PM,Internally Displaced People,1902,6111,1338,1449,10800,0,0,0,0,0
19,South Sudan (UNDP),2016,SSD-16/HSS10/SA1/WASH/INGO/845,12/8/2016 1:35:35 PM,Overall,6402,12111,3498,3789,25800,12147,15684,11593,10177,49601
19,South Sudan (UNDP),2016,SSD-16/HSS10/SA1/WASH/INGO/870,2/8/2017 10:02:43 AM,Internally Displaced People,5686,6161,5112,5541,22500,4529,7247,5953,7419,25148
19,South Sudan (UNDP),2016,SSD-16/HSS10/SA1/WASH/INGO/870,2/8/2017 10:02:43 AM,Overall,18954,20536,17042,18468,75000,15100,24159,19847,24728,83834
19,South Sudan (UNDP),2016,SSD-16/HSS10/SA1/WASH/NGO/671,1/19/2017 8:12:29 AM,Children under 5,0,0,1200,1600,2800,0,0,1400,1430,2830
19,South Sudan (UNDP),2016,SSD-16/HSS10/SA1/WASH/NGO/671,1/19/2017 8:12:29 AM,Internally Displaced People,1000,2450,1100,1077,5627,540,620,740,810,2710
19,South Sudan (UNDP),2016,SSD-16/HSS10/SA1/WASH/NGO/671,1/19/2017 8:12:29 AM,Overall,6500,9600,4200,4700,25000,5100,5800,4300,4400,19600
19,South Sudan (UNDP),2016,SSD-16/HSS10/SA1/WASH/NGO/671,1/19/2017 8:12:29 AM,People in Host Communities,3500,7110,1877,2000,14487,4260,3880,3560,1590,13290
19,South Sudan (UNDP),2016,SSD-16/HSS10/SA1/WASH/NGO/671,1/19/2017 8:12:29 AM,"Trainers, Promoters, Caretakers, committee members, etc.",40,40,23,23,126,126,0,0,0,126
19,South Sudan (UNDP),2016,SSD-16/HSS10/SA1/WASH/NGO/683,12/8/2016 1:34:30 PM,Children under 5,0,0,2500,6100,8600,0,0,4600,4806,9406
19,South Sudan (UNDP),2016,SSD-16/HSS10/SA1/WASH/NGO/683,12/8/2016 1:34:30 PM,Internally Displaced People,1207,3158,0,0,4365,2366,2938,0,0,5304
19,South Sudan (UNDP),2016,SSD-16/HSS10/SA1/WASH/NGO/683,12/8/2016 1:34:30 PM,Overall,2415,7015,2500,6100,18030,4732,7018,4600,4806,21156
19,South Sudan (UNDP),2016,SSD-16/HSS10/SA1/WASH/NGO/683,12/8/2016 1:34:30 PM,People in Host Communities,1208,3157,0,0,4365,2366,2937,0,0,5303
19,South Sudan (UNDP),2016,SSD-16/HSS10/SA1/WASH/NGO/683,12/8/2016 1:34:30 PM,Pregnant and Lactating Women,0,700,0,0,700,0,1143,0,0,1143
19,South Sudan (UNDP),2016,SSD-16/HSS10/SA1/WASH/NGO/690,12/8/2016 2:07:21 PM,Internally Displaced People,2700,2952,2550,2600,10802,2448,3078,2728,2650,10904
19,South Sudan (UNDP),2016,SSD-16/HSS10/SA1/WASH/NGO/690,12/8/2016 2:07:21 PM,Overall,3200,3552,2900,3100,12752,3169,3705,3075,3251,13200
19,South Sudan (UNDP),2016,SSD-16/HSS10/SA1/WASH/NGO/690,12/8/2016 2:07:21 PM,People in Host Communities,500,600,350,500,1950,721,629,347,601,2298
19,South Sudan (UNDP),2016,SSD-16/HSS10/SA1/WASH/NGO/692,2/2/2017 7:38:29 AM,Internally Displaced People,6200,10850,6200,7750,31000,7800,13650,7800,9750,39000
19,South Sudan (UNDP),2016,SSD-16/HSS10/SA1/WASH/NGO/692,2/2/2017 7:38:29 AM,Overall,6200,10850,6200,7750,31000,7800,13650,7800,9750,39000
19,South Sudan (UNDP),2016,SSD-16/HSS10/SA1/WASH/NGO/698,11/8/2016 8:05:48 AM,Internally Displaced People,1583,1793,1711,1787,6874,1962,2722,1896,2722,9302
19,South Sudan (UNDP),2016,SSD-16/HSS10/SA1/WASH/NGO/698,11/8/2016 8:05:48 AM,Overall,5822,6627,5706,6327,24482,6540,9073,6320,7539,29472
19,South Sudan (UNDP),2016,SSD-16/HSS10/SA1/WASH/NGO/698,11/8/2016 8:05:48 AM,People in Host Communities,3694,4185,3995,4171,16045,4578,6349,4424,5277,20628
19,South Sudan (UNDP),2016,SSD-16/HSS10/SA1/WASH/NGO/698,11/8/2016 8:05:48 AM,"Trainers, Promoters, Caretakers, committee members, etc.",20,30,0,0,50,20,40,0,0,60
19,South Sudan (UNDP),2016,SSD-16/HSS10/SA1/WASH/NGO/761,1/16/2017 1:20:39 PM,Children under 5,0,0,250,350,600,0,0,1786,1010,2796
19,South Sudan (UNDP),2016,SSD-16/HSS10/SA1/WASH/NGO/761,1/16/2017 1:20:39 PM,Internally Displaced People,1150,1265,975,1200,4590,1250,1130,1017,737,4134
19,South Sudan (UNDP),2016,SSD-16/HSS10/SA1/WASH/NGO/761,1/16/2017 1:20:39 PM,Overall,2050,2475,2075,2400,9000,3234,2826,5642,4987,16689
19,South Sudan (UNDP),2016,SSD-16/HSS10/SA1/WASH/NGO/761,1/16/2017 1:20:39 PM,People in Host Communities,900,1000,850,850,3600,1965,1496,2839,3259,9559
19,South Sudan (UNDP),2016,SSD-16/HSS10/SA1/WASH/NGO/761,1/16/2017 1:20:39 PM,Pregnant and Lactating Women,0,210,0,0,210,0,200,0,0,200
19,South Sudan (UNDP),2016,SSD-16/HSS10/SA1/WASH/NGO/779,1/19/2017 7:38:26 AM,Internally Displaced People,492,627,1025,700,2844,1025,1499,1209,1464,5197
19,South Sudan (UNDP),2016,SSD-16/HSS10/SA1/WASH/NGO/779,1/19/2017 7:38:26 AM,Other,160,323,0,0,483,0,0,0,0,0
19,South Sudan (UNDP),2016,SSD-16/HSS10/SA1/WASH/NGO/779,1/19/2017 7:38:26 AM,Overall,1125,2000,2875,2000,8000,2032,3687,3029,3402,12150
19,South Sudan (UNDP),2016,SSD-16/HSS10/SA1/WASH/NGO/779,1/19/2017 7:38:26 AM,People in Host Communities,473,1050,1025,975,3523,1007,2188,1820,1938,6953
19,South Sudan (UNDP),2016,SSD-16/HSS10/SA1/WASH/UN/794,12/8/2016 1:40:43 PM,Overall,4412,30416,9761,18411,63000,13981,96384,30932,58342,199639
19,South Sudan (UNDP),2016,SSD-16/HSS10/SA1/WASH/UN/813,12/8/2016 1:38:50 PM,Internally Displaced People,16400,18600,18000,18600,71600,18500,19200,18900,19200,75800
19,South Sudan (UNDP),2016,SSD-16/HSS10/SA1/WASH/UN/813,12/8/2016 1:38:50 PM,Other,2400,2700,2600,2700,10400,4100,4800,4500,4800,18200
19,South Sudan (UNDP),2016,SSD-16/HSS10/SA1/WASH/UN/813,12/8/2016 1:38:50 PM,Overall,21800,24700,23800,24700,95000,27800,30000,29100,30000,116900
19,South Sudan (UNDP),2016,SSD-16/HSS10/SA1/WASH/UN/813,12/8/2016 1:38:50 PM,People in Host Communities,3000,3400,3200,3400,13000,5200,6000,5700,6000,22900
19,South Sudan (UNDP),2016,SSD-16/HSS10/SA1/WASH/UN/814,1/12/2017 6:28:21 AM,Internally Displaced People,2048,2925,2340,2438,9751,1785,2550,2040,2125,8500
19,South Sudan (UNDP),2016,SSD-16/HSS10/SA1/WASH/UN/814,1/12/2017 6:28:21 AM,Overall,6825,9750,7800,8125,32500,7035,10050,8040,8375,33500
19,South Sudan (UNDP),2016,SSD-16/HSS10/SA1/WASH/UN/814,1/12/2017 6:28:21 AM,People in Host Communities,4777,6825,5460,5687,22749,5250,7500,6000,6250,25000
19,South Sudan (UNDP),2016,SSD-16/HSS10/SA2/CCCM/INGO/3469,7/7/2017 8:43:38 AM,Overall,7731,16179,17800,18473,60183,14083,16476,11247,13430,55236
19,South Sudan (UNDP),2016,SSD-16/HSS10/SA2/E/INGO/3413,5/2/2017 7:26:16 AM,Internally Displaced People,82,26,2165,1365,3638,83,44,5543,2567,8237
19,South Sudan (UNDP),2016,SSD-16/HSS10/SA2/E/INGO/3413,5/2/2017 7:26:16 AM,Overall,150,50,5530,3530,9260,179,99,7800,4776,12854
19,South Sudan (UNDP),2016,SSD-16/HSS10/SA2/E/INGO/3413,5/2/2017 7:26:16 AM,People in Host Communities,68,24,3365,2165,5622,96,53,2166,2162,4477
19,South Sudan (UNDP),2016,SSD-16/HSS10/SA2/E/INGO/3596,7/4/2017 11:23:26 AM,Children under 5,0,0,800,960,1760,0,0,574,678,1252
19,South Sudan (UNDP),2016,SSD-16/HSS10/SA2/E/INGO/3596,7/4/2017 11:23:26 AM,Internally Displaced People,855,875,1586,854,4170,254,543,786,647,2230
19,South Sudan (UNDP),2016,SSD-16/HSS10/SA2/E/INGO/3596,7/4/2017 11:23:26 AM,Overall,1910,1941,6851,4279,14981,924,1512,4560,2012,9008
19,South Sudan (UNDP),2016,SSD-16/HSS10/SA2/E/INGO/3596,7/4/2017 11:23:26 AM,People in Host Communities,875,966,4465,2465,8771,349,745,2774,1542,5410
19,South Sudan (UNDP),2016,SSD-16/HSS10/SA2/E/INGO/3596,7/4/2017 11:23:26 AM,"Trainers, Promoters, Caretakers, committee members, etc.",180,100,0,0,280,87,29,0,0,116
19,South Sudan (UNDP),2016,SSD-16/HSS10/SA2/E/INGO/3601,6/7/2018 6:03:07 AM,Internally Displaced People,30,8,288,152,478,82,24,2940,1960,5006
19,South Sudan (UNDP),2016,SSD-16/HSS10/SA2/E/INGO/3601,6/7/2018 6:03:07 AM,Overall,82,24,2940,1960,5006,235,136,3430,1456,5257
19,South Sudan (UNDP),2016,SSD-16/HSS10/SA2/E/INGO/3601,6/7/2018 6:03:07 AM,People in Host Communities,52,16,2652,1808,4528,470,272,6860,2912,10514
19,South Sudan (UNDP),2016,SSD-16/HSS10/SA2/E/NGO/3402,9/6/2017 11:29:37 AM,Children under 5,0,0,1400,1400,2800,0,0,546,467,1013
19,South Sudan (UNDP),2016,SSD-16/HSS10/SA2/E/NGO/3402,9/6/2017 11:29:37 AM,Internally Displaced People,25,25,1750,1750,3550,45,20,2130,1987,4182
19,South Sudan (UNDP),2016,SSD-16/HSS10/SA2/E/NGO/3402,9/6/2017 11:29:37 AM,Overall,100,100,4900,4900,10000,190,80,4806,4441,9517
19,South Sudan (UNDP),2016,SSD-16/HSS10/SA2/E/NGO/3402,9/6/2017 11:29:37 AM,People in Host Communities,25,25,1750,1750,3550,50,20,2130,1987,4187
19,South Sudan (UNDP),2016,SSD-16/HSS10/SA2/E/NGO/3402,9/6/2017 11:29:37 AM,"Trainers, Promoters, Caretakers, committee members, etc.",50,50,0,0,100,95,40,0,0,135
19,South Sudan (UNDP),2016,SSD-16/HSS10/SA2/E/NGO/3426,5/9/2017 2:00:16 PM,Internally Displaced People,0,0,2800,3339,6139,190,220,3342,2807,6559
19,South Sudan (UNDP),2016,SSD-16/HSS10/SA2/E/NGO/3426,5/9/2017 2:00:16 PM,Overall,0,0,5600,6678,12278,480,361,6684,5614,13139
19,South Sudan (UNDP),2016,SSD-16/HSS10/SA2/E/NGO/3426,5/9/2017 2:00:16 PM,People in Host Communities,0,0,2800,3339,6139,290,141,3342,2807,6580
19,South Sudan (UNDP),2016,SSD-16/HSS10/SA2/E/NGO/3443,4/25/2017 5:55:33 AM,Internally Displaced People,80,40,676,611,1407,74,36,547,578,1235
19,South Sudan (UNDP),2016,SSD-16/HSS10/SA2/E/NGO/3443,4/25/2017 5:55:33 AM,Overall,191,104,4245,2980,7520,175,85,4245,2980,7485
19,South Sudan (UNDP),2016,SSD-16/HSS10/SA2/E/NGO/3443,4/25/2017 5:55:33 AM,Pastoralists,0,0,1004,788,1792,0,0,956,678,1634
19,South Sudan (UNDP),2016,SSD-16/HSS10/SA2/E/NGO/3443,4/25/2017 5:55:33 AM,People in Host Communities,100,60,2565,1581,4306,93,54,2453,1485,4085
19,South Sudan (UNDP),2016,SSD-16/HSS10/SA2/E/NGO/3443,4/25/2017 5:55:33 AM,"Trainers, Promoters, Caretakers, committee members, etc.",11,4,0,0,15,11,4,0,0,15
19,South Sudan (UNDP),2016,SSD-16/HSS10/SA2/E/NGO/3540,5/9/2017 10:06:40 AM,Internally Displaced People,64,42,1090,1135,2331,64,42,2066,1125,3297
19,South Sudan (UNDP),2016,SSD-16/HSS10/SA2/E/NGO/3540,5/9/2017 10:06:40 AM,Overall,120,80,2058,2142,4400,120,80,5378,2538,8116
19,South Sudan (UNDP),2016,SSD-16/HSS10/SA2/E/NGO/3540,5/9/2017 10:06:40 AM,People in Host Communities,56,38,968,1007,2069,56,38,3312,1413,4819
19,South Sudan (UNDP),2016,SSD-16/HSS10/SA2/E/UN/3585,5/9/2017 10:02:56 AM,Internally Displaced People,210,100,10000,7000,17310,210,100,10000,7000,17310
19,South Sudan (UNDP),2016,SSD-16/HSS10/SA2/E/UN/3585,5/9/2017 10:02:56 AM,Overall,310,140,15000,10000,25450,310,140,15000,10000,25450
19,South Sudan (UNDP),2016,SSD-16/HSS10/SA2/E/UN/3585,5/9/2017 10:02:56 AM,People in Host Communities,100,40,5000,3000,8140,100,40,5000,3000,8140
19,South Sudan (UNDP),2016,SSD-16/HSS10/SA2/FSL/INGO/3408,5/12/2017 6:57:59 AM,Internally Displaced People,3500,3500,8000,8000,23000,6029,8560,12117,10103,36809
19,South Sudan (UNDP),2016,SSD-16/HSS10/SA2/FSL/INGO/3408,5/12/2017 6:57:59 AM,Other,500,500,1000,1000,3000,1978,1445,4450,5619,13492
19,South Sudan (UNDP),2016,SSD-16/HSS10/SA2/FSL/INGO/3408,5/12/2017 6:57:59 AM,Overall,5000,5000,10000,10000,30000,14327,16515,23896,28873,83611
19,South Sudan (UNDP),2016,SSD-16/HSS10/SA2/FSL/INGO/3408,5/12/2017 6:57:59 AM,People in Host Communities,1000,1000,1000,1000,4000,6320,6510,7329,13151,33310
19,South Sudan (UNDP),2016,SSD-16/HSS10/SA2/FSL/INGO/3554,5/2/2017 8:41:13 AM,Internally Displaced People,420,850,1035,1853,4158,396,801,976,1746,3919
19,South Sudan (UNDP),2016,SSD-16/HSS10/SA2/FSL/INGO/3554,5/2/2017 8:41:13 AM,Overall,4200,8500,10353,18527,41580,3958,8011,9757,17460,39186
19,South Sudan (UNDP),2016,SSD-16/HSS10/SA2/FSL/INGO/3554,5/2/2017 8:41:13 AM,People in Host Communities,3780,7650,9318,16674,37422,3562,7210,8781,15714,35267
19,South Sudan (UNDP),2016,SSD-16/HSS10/SA2/FSL/INGO/3591,5/9/2017 9:33:53 AM,Overall,3430,3430,3570,3570,14000,3430,3430,3570,3570,14000
19,South Sudan (UNDP),2016,SSD-16/HSS10/SA2/FSL/INGO/3591,5/9/2017 9:33:53 AM,People in Host Communities,3430,3430,3570,3570,14000,3430,3430,3570,3570,14000
19,South Sudan (UNDP),2016,SSD-16/HSS10/SA2/FSL/INGO/3620,5/9/2017 9:17:42 AM,Overall,3780,5220,0,0,9000,2050,6950,0,0,9000
19,South Sudan (UNDP),2016,SSD-16/HSS10/SA2/FSL/INGO/3620,5/9/2017 9:17:42 AM,People in Host Communities,3780,5220,0,0,9000,2050,6950,0,0,9000
19,South Sudan (UNDP),2016,SSD-16/HSS10/SA2/FSL/NGO/3539,2/3/2017 12:39:47 PM,Internally Displaced People,615,630,105,150,1500,845,680,0,0,1525
19,South Sudan (UNDP),2016,SSD-16/HSS10/SA2/FSL/NGO/3539,2/3/2017 12:39:47 PM,Overall,2050,2100,350,500,5000,2650,2350,0,0,5000
19,South Sudan (UNDP),2016,SSD-16/HSS10/SA2/FSL/NGO/3539,2/3/2017 12:39:47 PM,People in Host Communities,1025,1050,175,250,2500,1325,1150,0,0,2475
19,South Sudan (UNDP),2016,SSD-16/HSS10/SA2/FSL/NGO/3539,2/3/2017 12:39:47 PM,Refugee Returnees,410,420,70,100,1000,480,520,0,0,1000
19,South Sudan (UNDP),2016,SSD-16/HSS10/SA2/FSL/NGO/3555,4/28/2017 12:05:55 PM,Internally Displaced People,2059,3089,4266,5296,14710,2059,3089,4266,5296,14710
19,South Sudan (UNDP),2016,SSD-16/HSS10/SA2/FSL/NGO/3555,4/28/2017 12:05:55 PM,Overall,13731,20596,28442,35307,98076,13731,20596,28442,35307,98076
19,South Sudan (UNDP),2016,SSD-16/HSS10/SA2/FSL/NGO/3555,4/28/2017 12:05:55 PM,Pastoralists,2746,4119,5688,7061,19614,2746,4119,5688,7061,19614
19,South Sudan (UNDP),2016,SSD-16/HSS10/SA2/FSL/NGO/3555,4/28/2017 12:05:55 PM,People in Host Communities,8239,12358,17066,21185,58848,8239,12358,17066,21185,58848
19,South Sudan (UNDP),2016,SSD-16/HSS10/SA2/FSL/NGO/3555,4/28/2017 12:05:55 PM,Refugee Returnees,687,1030,1422,1765,4904,687,1030,1422,1765,4904
19,South Sudan (UNDP),2016,SSD-16/HSS10/SA2/FSL/NGO/3575,9/11/2017 10:22:45 AM,Internally Displaced People,6000,12000,3000,10000,31000,6000,12000,3000,10000,31000
19,South Sudan (UNDP),2016,SSD-16/HSS10/SA2/FSL/NGO/3575,9/11/2017 10:22:45 AM,Overall,22000,36000,14000,27000,99000,22000,36000,14000,27000,99000
19,South Sudan (UNDP),2016,SSD-16/HSS10/SA2/FSL/NGO/3575,9/11/2017 10:22:45 AM,Pastoralists,8000,0,8000,2000,18000,8000,0,8000,2000,18000
19,South Sudan (UNDP),2016,SSD-16/HSS10/SA2/FSL/NGO/3575,9/11/2017 10:22:45 AM,People in Host Communities,8000,20000,3000,12000,43000,8000,20000,3000,12000,43000
19,South Sudan (UNDP),2016,SSD-16/HSS10/SA2/FSL/NGO/3575,9/11/2017 10:22:45 AM,Pregnant and Lactating Women,0,4000,0,3000,7000,0,4000,0,3000,7000
19,South Sudan (UNDP),2016,SSD-16/HSS10/SA2/FSL/UN/3775,8/15/2017 9:44:12 AM,Internally Displaced People,20000,20000,50000,50000,140000,30000,30000,75000,75000,210000
19,South Sudan (UNDP),2016,SSD-16/HSS10/SA2/FSL/UN/3775,8/15/2017 9:44:12 AM,Overall,50000,50000,125000,125000,350000,50000,50000,125000,125000,350000
19,South Sudan (UNDP),2016,SSD-16/HSS10/SA2/FSL/UN/3775,8/15/2017 9:44:12 AM,People in Host Communities,10000,10000,25000,25000,70000,0,0,0,0,0
19,South Sudan (UNDP),2016,SSD-16/HSS10/SA2/FSL/UN/3775,8/15/2017 9:44:12 AM,Refugee Returnees,20000,20000,50000,50000,140000,20000,20000,50000,50000,140000
19,South Sudan (UNDP),2016,SSD-16/HSS10/SA2/H/INGO/3493,7/21/2017 9:52:37 AM,Children under 5,0,0,3000,3500,6500,0,0,2712,3187,5899
19,South Sudan (UNDP),2016,SSD-16/HSS10/SA2/H/INGO/3493,7/21/2017 9:52:37 AM,Internally Displaced People,2000,2500,1500,1600,7600,4858,6328,1421,1488,14095
19,South Sudan (UNDP),2016,SSD-16/HSS10/SA2/H/INGO/3493,7/21/2017 9:52:37 AM,Overall,5605,4936,6464,7003,24008,9343,12656,6457,7083,35539
19,South Sudan (UNDP),2016,SSD-16/HSS10/SA2/H/INGO/3493,7/21/2017 9:52:37 AM,People in Host Communities,800,700,1000,1200,3700,4485,4303,2324,2408,13520
19,South Sudan (UNDP),2016,SSD-16/HSS10/SA2/H/INGO/3493,7/21/2017 9:52:37 AM,Pregnant and Lactating Women,0,900,0,0,900,0,972,0,0,972
19,South Sudan (UNDP),2016,SSD-16/HSS10/SA2/H/INGO/3569,5/29/2017 12:59:19 PM,Children under 5,0,0,1769,2346,4115,0,0,2315,2957,5272
19,South Sudan (UNDP),2016,SSD-16/HSS10/SA2/H/INGO/3569,5/29/2017 12:59:19 PM,Internally Displaced People,1037,1374,0,0,2411,1028,1916,0,0,2944
19,South Sudan (UNDP),2016,SSD-16/HSS10/SA2/H/INGO/3569,5/29/2017 12:59:19 PM,Overall,8639,11452,1769,2346,24206,4991,7036,2315,2957,17299
19,South Sudan (UNDP),2016,SSD-16/HSS10/SA2/H/INGO/3569,5/29/2017 12:59:19 PM,People in Host Communities,7602,10078,0,0,17680,3963,5120,0,0,9083
19,South Sudan (UNDP),2016,SSD-16/HSS10/SA2/H/INGO/3588,9/8/2017 12:32:13 PM,Overall,28271,29425,31880,33181,122757,28217,29425,31880,33181,122703
19,South Sudan (UNDP),2016,SSD-16/HSS10/SA2/H/INGO/3589,9/8/2017 2:21:33 PM,Children under 5,0,0,13044,10673,23717,0,0,27728,25899,53627
19,South Sudan (UNDP),2016,SSD-16/HSS10/SA2/H/INGO/3589,9/8/2017 2:21:33 PM,Other,10516,15779,0,0,26295,6916,10798,0,0,17714
19,South Sudan (UNDP),2016,SSD-16/HSS10/SA2/H/INGO/3589,9/8/2017 2:21:33 PM,Overall,10516,16269,13044,10673,50502,6916,11967,27728,25899,72510
19,South Sudan (UNDP),2016,SSD-16/HSS10/SA2/H/INGO/3589,9/8/2017 2:21:33 PM,Pregnant and Lactating Women,0,490,0,0,490,0,1169,0,0,1169
19,South Sudan (UNDP),2016,SSD-16/HSS10/SA2/H/INGO/3595,7/21/2017 7:24:44 AM,Internally Displaced People,2346,4693,945,945,8929,1452,2629,697,711,5489
19,South Sudan (UNDP),2016,SSD-16/HSS10/SA2/H/INGO/3595,7/21/2017 7:24:44 AM,Overall,11732,23463,4725,4725,44645,8482,15351,4068,4152,32053
19,South Sudan (UNDP),2016,SSD-16/HSS10/SA2/H/INGO/3595,7/21/2017 7:24:44 AM,People in Host Communities,9386,18770,3780,3780,35716,7030,12722,3372,3441,26565
19,South Sudan (UNDP),2016,SSD-16/HSS10/SA2/H/INGO/3628,9/8/2017 1:14:53 PM,Children under 5,0,0,22645,23545,46190,0,0,22645,24551,47196
19,South Sudan (UNDP),2016,SSD-16/HSS10/SA2/H/INGO/3628,9/8/2017 1:14:53 PM,Internally Displaced People,500,900,2800,2800,7000,0,0,0,0,0
19,South Sudan (UNDP),2016,SSD-16/HSS10/SA2/H/INGO/3628,9/8/2017 1:14:53 PM,Overall,32630,44690,25445,26345,129110,30792,42521,23995,24551,121859
19,South Sudan (UNDP),2016,SSD-16/HSS10/SA2/H/INGO/3628,9/8/2017 1:14:53 PM,Pregnant and Lactating Women,0,10410,0,0,10410,0,10410,0,0,10410
19,South Sudan (UNDP),2016,SSD-16/HSS10/SA2/H/INGO/3628,9/8/2017 1:14:53 PM,"Trainers, Promoters, Caretakers, committee members, etc.",83,37,0,0,120,83,37,0,0,120
19,South Sudan (UNDP),2016,SSD-16/HSS10/SA2/H/NGO/3410,7/21/2017 12:11:04 PM,Internally Displaced People,3000,3620,1400,1500,9520,2500,3600,1260,1450,8810
19,South Sudan (UNDP),2016,SSD-16/HSS10/SA2/H/NGO/3410,7/21/2017 12:11:04 PM,Overall,15000,20000,7000,7500,49500,12500,18000,6300,7250,44050
19,South Sudan (UNDP),2016,SSD-16/HSS10/SA2/H/NGO/3410,7/21/2017 12:11:04 PM,People in Host Communities,12000,14480,5600,6000,38080,10000,14480,5040,5800,35320
19,South Sudan (UNDP),2016,SSD-16/HSS10/SA2/H/NGO/3410,7/21/2017 12:11:04 PM,Pregnant and Lactating Women,0,1900,0,0,1900,0,1762,0,0,1762
19,South Sudan (UNDP),2016,SSD-16/HSS10/SA2/H/NGO/3417,9/8/2017 12:53:10 PM,Children under 5,0,0,6000,6000,12000,0,0,3853,4128,7981
19,South Sudan (UNDP),2016,SSD-16/HSS10/SA2/H/NGO/3417,9/8/2017 12:53:10 PM,Internally Displaced People,11480,34000,1000,760,47240,7569,11972,789,732,21062
19,South Sudan (UNDP),2016,SSD-16/HSS10/SA2/H/NGO/3417,9/8/2017 12:53:10 PM,Other,2000,25000,820,700,28520,727,2883,394,478,4482
19,South Sudan (UNDP),2016,SSD-16/HSS10/SA2/H/NGO/3417,9/8/2017 12:53:10 PM,Overall,21480,82000,8470,8050,120000,9070,24282,7652,6874,47878
19,South Sudan (UNDP),2016,SSD-16/HSS10/SA2/H/NGO/3417,9/8/2017 12:53:10 PM,People in Host Communities,8000,23000,650,590,32240,4722,9654,409,568,15353
19,South Sudan (UNDP),2016,SSD-16/HSS10/SA2/H/NGO/3441,7/21/2017 7:42:17 AM,Internally Displaced People,9594,1014,1491,1533,13632,6692,88557,1711,1631,98591
19,South Sudan (UNDP),2016,SSD-16/HSS10/SA2/H/NGO/3441,7/21/2017 7:42:17 AM,Overall,15990,19228,2485,2555,40258,11154,16553,2852,2718,33277
19,South Sudan (UNDP),2016,SSD-16/HSS10/SA2/H/NGO/3441,7/21/2017 7:42:17 AM,People in Host Communities,6396,7076,994,1022,15488,4462,6125,1141,1087,12815
19,South Sudan (UNDP),2016,SSD-16/HSS10/SA2/H/NGO/3441,7/21/2017 7:42:17 AM,Pregnant and Lactating Women,0,1538,0,0,1538,0,1871,0,0,1871
19,South Sudan (UNDP),2016,SSD-16/HSS10/SA2/H/NGO/3455,2/3/2017 6:33:04 AM,Children under 5,0,0,2537,2830,5367,0,0,9554,9109,18663
19,South Sudan (UNDP),2016,SSD-16/HSS10/SA2/H/NGO/3455,2/3/2017 6:33:04 AM,Internally Displaced People,19985,22383,17762,19810,79940,20450,24784,20117,27320,92671
19,South Sudan (UNDP),2016,SSD-16/HSS10/SA2/H/NGO/3455,2/3/2017 6:33:04 AM,Overall,28550,31976,25374,28300,114200,28449,32624,25317,32802,119192
19,South Sudan (UNDP),2016,SSD-16/HSS10/SA2/H/NGO/3455,2/3/2017 6:33:04 AM,People in Host Communities,8565,6395,5075,5660,25695,7999,7840,5200,5482,26521
19,South Sudan (UNDP),2016,SSD-16/HSS10/SA2/H/NGO/3455,2/3/2017 6:33:04 AM,Pregnant and Lactating Women,0,3198,0,0,3198,0,2575,0,0,2575
19,South Sudan (UNDP),2016,SSD-16/HSS10/SA2/H/NGO/3462,11/14/2017 10:37:05 AM,Children under 5,0,0,2618,4230,6848,0,0,2823,3280,6103
19,South Sudan (UNDP),2016,SSD-16/HSS10/SA2/H/NGO/3462,11/14/2017 10:37:05 AM,Internally Displaced People,5200,6115,3720,3300,18335,4810,5173,2912,3236,16131
19,South Sudan (UNDP),2016,SSD-16/HSS10/SA2/H/NGO/3462,11/14/2017 10:37:05 AM,Overall,9836,10746,9124,12617,42323,8446,12490,2493,2542,25971
19,South Sudan (UNDP),2016,SSD-16/HSS10/SA2/H/NGO/3462,11/14/2017 10:37:05 AM,People in Host Communities,4636,4281,2786,5087,16790,3116,3135,2903,3338,12492
19,South Sudan (UNDP),2016,SSD-16/HSS10/SA2/H/NGO/3462,11/14/2017 10:37:05 AM,Pregnant and Lactating Women,0,350,0,0,350,0,186,0,0,186
19,South Sudan (UNDP),2016,SSD-16/HSS10/SA2/H/UN/3445,9/15/2017 1:05:22 PM,Internally Displaced People,15400,18000,20000,35000,88400,15500,18500,21000,34000,89000
19,South Sudan (UNDP),2016,SSD-16/HSS10/SA2/H/UN/3445,9/15/2017 1:05:22 PM,Overall,30400,38000,37620,45980,152000,30500,39000,37500,46000,153000
19,South Sudan (UNDP),2016,SSD-16/HSS10/SA2/H/UN/3445,9/15/2017 1:05:22 PM,People in Host Communities,15000,16580,17620,10980,60180,15000,16500,16500,12000,60000
19,South Sudan (UNDP),2016,SSD-16/HSS10/SA2/H/UN/3445,9/15/2017 1:05:22 PM,Pregnant and Lactating Women,0,3420,0,0,3420,0,4000,0,0,4000
19,South Sudan (UNDP),2016,SSD-16/HSS10/SA2/H/UN/3560,7/21/2017 7:05:09 AM,Internally Displaced People,38584,35616,34216,31584,140000,38584,35616,34216,31584,140000
19,South Sudan (UNDP),2016,SSD-16/HSS10/SA2/H/UN/3560,7/21/2017 7:05:09 AM,Overall,55120,50880,48880,45120,200000,55120,50880,48880,45120,200000
19,South Sudan (UNDP),2016,SSD-16/HSS10/SA2/H/UN/3560,7/21/2017 7:05:09 AM,People in Host Communities,16536,15264,14664,13536,60000,16536,15264,14664,13536,60000
19,South Sudan (UNDP),2016,SSD-16/HSS10/SA2/H/UN/3570,7/21/2017 9:18:49 AM,Internally Displaced People,29774,31517,13809,16258,91358,40931,61397,28337,26763,157428
19,South Sudan (UNDP),2016,SSD-16/HSS10/SA2/H/UN/3570,7/21/2017 9:18:49 AM,Overall,29784,31527,13809,16258,91378,40931,61397,28337,26763,157428
19,South Sudan (UNDP),2016,SSD-16/HSS10/SA2/H/UN/3570,7/21/2017 9:18:49 AM,"Trainers, Promoters, Caretakers, committee members, etc.",10,10,0,0,20,12,19,0,0,31
19,South Sudan (UNDP),2016,SSD-16/HSS10/SA2/H/UN/3636,9/11/2017 7:42:26 AM,Internally Displaced People,78540,75460,7464,7173,168637,73450,65065,4676,6980,150171
19,South Sudan (UNDP),2016,SSD-16/HSS10/SA2/H/UN/3636,9/11/2017 7:42:26 AM,Overall,78540,75460,7464,7173,168637,73450,65065,4676,6980,150171
19,South Sudan (UNDP),2016,SSD-16/HSS10/SA2/L/UN/3479,1/5/2017 11:38:36 AM,Aid Agencies,250,0,0,0,250,234,0,0,0,234
19,South Sudan (UNDP),2016,SSD-16/HSS10/SA2/L/UN/3479,1/5/2017 11:38:36 AM,Overall,6000,0,0,0,6000,5786,0,0,0,5786
19,South Sudan (UNDP),2016,SSD-16/HSS10/SA2/L/UN/3517,7/11/2017 11:53:40 AM,Aid Agencies,0,80,0,0,80,0,84,0,0,84
19,South Sudan (UNDP),2016,SSD-16/HSS10/SA2/L/UN/3517,7/11/2017 11:53:40 AM,Overall,0,80,0,0,80,0,84,0,0,84
19,South Sudan (UNDP),2016,SSD-16/HSS10/SA2/N/INGO/3458,9/26/2017 6:48:16 AM,Children under 5,0,0,7000,7219,14219,0,0,4369,5170,9539
19,South Sudan (UNDP),2016,SSD-16/HSS10/SA2/N/INGO/3458,9/26/2017 6:48:16 AM,Overall,400,6391,7000,7219,21010,381,3331,4369,5170,13251
19,South Sudan (UNDP),2016,SSD-16/HSS10/SA2/N/INGO/3458,9/26/2017 6:48:16 AM,Pregnant and Lactating Women,0,6391,0,0,6391,0,3331,0,0,3331
19,South Sudan (UNDP),2016,SSD-16/HSS10/SA2/N/INGO/3458,9/26/2017 6:48:16 AM,"Trainers, Promoters, Caretakers, committee members, etc.",400,0,0,0,400,381,0,0,0,381
19,South Sudan (UNDP),2016,SSD-16/HSS10/SA2/N/INGO/3558,8/15/2017 7:45:53 PM,Children under 5,0,0,0,0,0,0,0,13237,13880,27117
19,South Sudan (UNDP),2016,SSD-16/HSS10/SA2/N/INGO/3558,8/15/2017 7:45:53 PM,Internally Displaced People,325,4550,11529,12340,28744,113,4794,7367,6130,18404
19,South Sudan (UNDP),2016,SSD-16/HSS10/SA2/N/INGO/3558,8/15/2017 7:45:53 PM,Overall,460,6415,13021,13891,33787,306,9829,13237,13880,37252
19,South Sudan (UNDP),2016,SSD-16/HSS10/SA2/N/INGO/3558,8/15/2017 7:45:53 PM,People in Host Communities,135,1865,1492,1551,5043,193,5035,5870,7750,18848
19,South Sudan (UNDP),2016,SSD-16/HSS10/SA2/N/INGO/3558,8/15/2017 7:45:53 PM,Pregnant and Lactating Women,0,0,0,0,0,0,9829,0,0,9829
19,South Sudan (UNDP),2016,SSD-16/HSS10/SA2/N/INGO/3573,7/4/2017 1:57:46 PM,Children under 5,0,0,14660,19490,34150,0,0,17953,19468,37421
19,South Sudan (UNDP),2016,SSD-16/HSS10/SA2/N/INGO/3573,7/4/2017 1:57:46 PM,Internally Displaced People,0,1525,0,0,1525,0,1525,0,0,1525
19,South Sudan (UNDP),2016,SSD-16/HSS10/SA2/N/INGO/3573,7/4/2017 1:57:46 PM,Overall,0,16427,14690,19521,50638,0,0,17982,19588,37570
19,South Sudan (UNDP),2016,SSD-16/HSS10/SA2/N/INGO/3573,7/4/2017 1:57:46 PM,People in Host Communities,0,11180,0,0,11180,0,11180,0,0,11180
19,South Sudan (UNDP),2016,SSD-16/HSS10/SA2/N/INGO/3573,7/4/2017 1:57:46 PM,Pregnant and Lactating Women,0,3722,0,0,3722,0,3722,0,0,3722
19,South Sudan (UNDP),2016,SSD-16/HSS10/SA2/N/INGO/3597,8/15/2017 8:02:25 PM,Children under 5,0,0,0,0,0,0,0,18148,18148,36296
19,South Sudan (UNDP),2016,SSD-16/HSS10/SA2/N/INGO/3597,8/15/2017 8:02:25 PM,Internally Displaced People,0,1200,2900,2900,7000,0,0,0,0,0
19,South Sudan (UNDP),2016,SSD-16/HSS10/SA2/N/INGO/3597,8/15/2017 8:02:25 PM,Overall,1511,31190,31595,31595,95891,1791,19159,18148,18148,57246
19,South Sudan (UNDP),2016,SSD-16/HSS10/SA2/N/INGO/3597,8/15/2017 8:02:25 PM,People in Host Communities,1511,29990,28695,28695,88891,1791,19159,18148,18148,57246
19,South Sudan (UNDP),2016,SSD-16/HSS10/SA2/N/INGO/3597,8/15/2017 8:02:25 PM,Pregnant and Lactating Women,0,0,0,0,0,0,12532,0,0,12532
19,South Sudan (UNDP),2016,SSD-16/HSS10/SA2/N/INGO/3603,9/26/2017 6:44:29 AM,Internally Displaced People,80,3973,4813,4624,13490,133,2757,2013,2035,6938
19,South Sudan (UNDP),2016,SSD-16/HSS10/SA2/N/INGO/3603,9/26/2017 6:44:29 AM,Overall,530,26489,32085,30826,89930,843,17516,11357,11470,41186
19,South Sudan (UNDP),2016,SSD-16/HSS10/SA2/N/INGO/3603,9/26/2017 6:44:29 AM,People in Host Communities,450,22516,27272,26202,76440,710,14759,9344,9435,34248
19,South Sudan (UNDP),2016,SSD-16/HSS10/SA2/N/INGO/3604,8/15/2017 8:22:25 PM,Overall,0,0,12111,12889,25000,0,0,28987,29845,58832
19,South Sudan (UNDP),2016,SSD-16/HSS10/SA2/N/INGO/3604,8/15/2017 8:22:25 PM,People in Host Communities,0,0,12111,12889,25000,0,0,28987,29845,58832
19,South Sudan (UNDP),2016,SSD-16/HSS10/SA2/N/INGO/3617,5/12/2017 8:21:11 AM,Internally Displaced People,19,483,714,774,1990,19,624,844,821,2308
19,South Sudan (UNDP),2016,SSD-16/HSS10/SA2/N/INGO/3617,5/12/2017 8:21:11 AM,Overall,108,2742,4059,4397,11306,100,3354,4538,4414,12406
19,South Sudan (UNDP),2016,SSD-16/HSS10/SA2/N/INGO/3617,5/12/2017 8:21:11 AM,People in Host Communities,89,2259,3345,3623,9316,81,2730,3694,3593,10098
19,South Sudan (UNDP),2016,SSD-16/HSS10/SA2/N/INGO/3631,5/2/2017 8:25:34 AM,Children under 5,0,0,14342,14928,29270,0,0,16274,16311,32585
19,South Sudan (UNDP),2016,SSD-16/HSS10/SA2/N/INGO/3631,5/2/2017 8:25:34 AM,Other,1300,0,0,0,1300,1243,0,0,0,1243
19,South Sudan (UNDP),2016,SSD-16/HSS10/SA2/N/INGO/3631,5/2/2017 8:25:34 AM,Overall,1500,12324,14342,14928,43094,1350,22662,16174,16311,56497
19,South Sudan (UNDP),2016,SSD-16/HSS10/SA2/N/INGO/3631,5/2/2017 8:25:34 AM,Pregnant and Lactating Women,0,12219,0,0,12219,0,22338,0,0,22338
19,South Sudan (UNDP),2016,SSD-16/HSS10/SA2/N/INGO/3631,5/2/2017 8:25:34 AM,"Trainers, Promoters, Caretakers, committee members, etc.",200,105,0,0,305,107,324,0,0,431
19,South Sudan (UNDP),2016,SSD-16/HSS10/SA2/N/NGO/3429,7/4/2017 2:54:19 PM,Children under 5,0,0,2505,2055,4560,0,0,12805,12785,25590
19,South Sudan (UNDP),2016,SSD-16/HSS10/SA2/N/NGO/3429,7/4/2017 2:54:19 PM,Overall,197,4336,2505,2055,9093,292,9456,12805,12785,35338
19,South Sudan (UNDP),2016,SSD-16/HSS10/SA2/N/NGO/3429,7/4/2017 2:54:19 PM,Pregnant and Lactating Women,0,4326,0,0,4326,0,9453,0,0,9453
19,South Sudan (UNDP),2016,SSD-16/HSS10/SA2/N/NGO/3429,7/4/2017 2:54:19 PM,"Trainers, Promoters, Caretakers, committee members, etc.",197,10,0,0,207,292,3,0,0,295
19,South Sudan (UNDP),2016,SSD-16/HSS10/SA2/N/NGO/3461,5/12/2017 8:26:28 AM,Children under 5,0,0,2000,2000,4000,0,0,1392,1499,2891
19,South Sudan (UNDP),2016,SSD-16/HSS10/SA2/N/NGO/3461,5/12/2017 8:26:28 AM,Internally Displaced People,1000,750,750,1200,3700,692,700,526,1183,3101
19,South Sudan (UNDP),2016,SSD-16/HSS10/SA2/N/NGO/3461,5/12/2017 8:26:28 AM,Overall,2500,1500,3500,4200,11700,1955,1603,2590,3465,9613
19,South Sudan (UNDP),2016,SSD-16/HSS10/SA2/N/NGO/3461,5/12/2017 8:26:28 AM,People in Host Communities,1500,750,750,1000,4000,1263,900,673,1098,3934
19,South Sudan (UNDP),2016,SSD-16/HSS10/SA2/N/NGO/3481,5/12/2017 8:24:21 AM,Children under 5,0,0,15479,15530,31009,0,0,23516,23540,47056
19,South Sudan (UNDP),2016,SSD-16/HSS10/SA2/N/NGO/3481,5/12/2017 8:24:21 AM,Internally Displaced People,232,1954,0,0,2186,235,3376,0,0,3611
19,South Sudan (UNDP),2016,SSD-16/HSS10/SA2/N/NGO/3481,5/12/2017 8:24:21 AM,Overall,498,6075,15479,15530,37582,539,8326,23516,23540,55921
19,South Sudan (UNDP),2016,SSD-16/HSS10/SA2/N/NGO/3481,5/12/2017 8:24:21 AM,People in Host Communities,266,2572,0,0,2838,304,4264,0,0,4568
19,South Sudan (UNDP),2016,SSD-16/HSS10/SA2/N/NGO/3481,5/12/2017 8:24:21 AM,Pregnant and Lactating Women,0,1549,0,0,1549,0,686,0,0,686
19,South Sudan (UNDP),2016,SSD-16/HSS10/SA2/N/UN/3594,3/24/2017 12:41:49 PM,Children under 5,0,0,588,612,1200,0,0,3505,4200,7705
19,South Sudan (UNDP),2016,SSD-16/HSS10/SA2/N/UN/3594,3/24/2017 12:41:49 PM,Overall,0,0,588,612,1200,0,0,3505,4200,7705
19,South Sudan (UNDP),2016,SSD-16/HSS10/SA2/NFI/INGO/3411,4/3/2017 1:56:11 PM,Internally Displaced People,8225,9090,7867,8818,34000,6300,8027,10795,10957,36079
19,South Sudan (UNDP),2016,SSD-16/HSS10/SA2/NFI/INGO/3411,4/3/2017 1:56:11 PM,Other,960,1040,960,1040,4000,1599,1782,1605,1873,6859
19,South Sudan (UNDP),2016,SSD-16/HSS10/SA2/NFI/INGO/3411,4/3/2017 1:56:11 PM,Overall,10145,11170,9787,10898,42000,8612,10602,13685,14132,47031
19,South Sudan (UNDP),2016,SSD-16/HSS10/SA2/NFI/INGO/3411,4/3/2017 1:56:11 PM,People in Host Communities,960,1040,960,1040,4000,713,793,1285,1302,4093
19,South Sudan (UNDP),2016,SSD-16/HSS10/SA2/NFI/INGO/3449,7/11/2017 2:26:25 PM,Internally Displaced People,7632,10052,12785,13800,44269,16564,19343,22326,22703,80936
19,South Sudan (UNDP),2016,SSD-16/HSS10/SA2/NFI/INGO/3449,7/11/2017 2:26:25 PM,Overall,10332,14252,15985,17032,57601,18586,23707,25221,26020,93534
19,South Sudan (UNDP),2016,SSD-16/HSS10/SA2/NFI/INGO/3449,7/11/2017 2:26:25 PM,People in Host Communities,2000,3200,2000,2132,9332,1495,2550,1983,2048,8076
19,South Sudan (UNDP),2016,SSD-16/HSS10/SA2/NFI/INGO/3449,7/11/2017 2:26:25 PM,Refugee Returnees,700,1000,1200,1100,4000,509,1814,912,1269,4504
19,South Sudan (UNDP),2016,SSD-16/HSS10/SA2/NFI/INGO/3459,7/11/2017 1:30:23 PM,Overall,14695,14188,11148,10641,50672,18399,18073,15860,16069,68401
19,South Sudan (UNDP),2016,SSD-16/HSS10/SA2/NFI/INGO/3508,2/9/2018 1:21:18 PM,Internally Displaced People,450,1000,1800,1800,5050,206,291,596,895,1988
19,South Sudan (UNDP),2016,SSD-16/HSS10/SA2/NFI/INGO/3508,2/9/2018 1:21:18 PM,Overall,600,1200,2400,2600,6800,206,334,618,1002,2160
19,South Sudan (UNDP),2016,SSD-16/HSS10/SA2/NFI/INGO/3508,2/9/2018 1:21:18 PM,People in Host Communities,150,200,600,800,1750,0,43,52,77,172
19,South Sudan (UNDP),2016,SSD-16/HSS10/SA2/NFI/INGO/3538,5/5/2017 6:22:33 AM,Internally Displaced People,2450,2450,2550,2550,10000,2174,1571,4347,3143,11235
19,South Sudan (UNDP),2016,SSD-16/HSS10/SA2/NFI/INGO/3538,5/5/2017 6:22:33 AM,Overall,4900,4900,5100,5100,20000,6520,4714,13040,9429,33703
19,South Sudan (UNDP),2016,SSD-16/HSS10/SA2/NFI/INGO/3538,5/5/2017 6:22:33 AM,People in Host Communities,2450,2450,2550,2550,10000,4346,3143,8693,6286,22468
19,South Sudan (UNDP),2016,SSD-16/HSS10/SA2/NFI/NGO/3453,5/2/2017 8:32:00 AM,Internally Displaced People,8000,11000,9000,9000,37000,14230,17516,0,0,31746
19,South Sudan (UNDP),2016,SSD-16/HSS10/SA2/NFI/NGO/3453,5/2/2017 8:32:00 AM,Overall,8000,11000,9000,9000,37000,14230,17516,0,0,31746
19,South Sudan (UNDP),2016,SSD-16/HSS10/SA2/NFI/NGO/3599,7/13/2017 10:05:30 AM,Internally Displaced People,3200,10700,2800,6300,23000,6511,9766,4340,6511,27128
19,South Sudan (UNDP),2016,SSD-16/HSS10/SA2/NFI/NGO/3599,7/13/2017 10:05:30 AM,Overall,5000,12500,4000,8500,30000,8766,12649,6510,8767,36692
19,South Sudan (UNDP),2016,SSD-16/HSS10/SA2/NFI/NGO/3599,7/13/2017 10:05:30 AM,People in Host Communities,1800,1800,1200,2200,7000,3255,4883,2170,3256,13564
19,South Sudan (UNDP),2016,SSD-16/HSS10/SA2/NFI/UN/3544,7/11/2017 2:08:21 PM,Internally Displaced People,18000,26400,36000,39600,120000,21588,26713,36110,40127,124538
19,South Sudan (UNDP),2016,SSD-16/HSS10/SA2/NFI/UN/3544,7/11/2017 2:08:21 PM,Overall,18000,26400,36000,39600,120000,21588,26713,36110,40127,124538
19,South Sudan (UNDP),2016,SSD-16/HSS10/SA2/NFI/UN/3547,11/9/2017 2:37:09 PM,Internally Displaced People,5400,7920,10800,11880,36000,19053,27944,38106,41917,127020
19,South Sudan (UNDP),2016,SSD-16/HSS10/SA2/NFI/UN/3547,11/9/2017 2:37:09 PM,Overall,5400,7920,10800,11880,36000,19053,27944,38106,41917,127020
19,South Sudan (UNDP),2016,SSD-16/HSS10/SA2/P/INGO/3414,5/29/2017 8:20:48 AM,Children under 5,0,0,1250,1250,2500,0,0,2500,2500,5000
19,South Sudan (UNDP),2016,SSD-16/HSS10/SA2/P/INGO/3414,5/29/2017 8:20:48 AM,Internally Displaced People,100,200,750,750,1800,100,100,1000,1000,2200
19,South Sudan (UNDP),2016,SSD-16/HSS10/SA2/P/INGO/3414,5/29/2017 8:20:48 AM,Overall,100,200,2000,2000,4300,100,200,3500,3500,7300
19,South Sudan (UNDP),2016,SSD-16/HSS10/SA2/P/INGO/3456,11/14/2017 9:28:52 AM,Internally Displaced People,476,950,476,950,2852,691,726,856,1212,3485
19,South Sudan (UNDP),2016,SSD-16/HSS10/SA2/P/INGO/3456,11/14/2017 9:28:52 AM,Overall,500,1000,500,1000,3000,727,764,901,1276,3668
19,South Sudan (UNDP),2016,SSD-16/HSS10/SA2/P/INGO/3456,11/14/2017 9:28:52 AM,People in Host Communities,24,50,24,50,148,36,38,45,64,183
19,South Sudan (UNDP),2016,SSD-16/HSS10/SA2/P/INGO/3514,10/18/2017 7:59:25 AM,Internally Displaced People,532,650,241,203,1626,467,782,102,62,1413
19,South Sudan (UNDP),2016,SSD-16/HSS10/SA2/P/INGO/3514,10/18/2017 7:59:25 AM,Overall,736,900,322,271,2229,868,1098,163,110,2239
19,South Sudan (UNDP),2016,SSD-16/HSS10/SA2/P/INGO/3514,10/18/2017 7:59:25 AM,People in Host Communities,177,217,81,68,543,159,205,61,48,473
19,South Sudan (UNDP),2016,SSD-16/HSS10/SA2/P/INGO/3514,10/18/2017 7:59:25 AM,"Trainers, Promoters, Caretakers, committee members, etc.",27,33,0,0,60,242,111,0,0,353
19,South Sudan (UNDP),2016,SSD-16/HSS10/SA2/P/INGO/3593,9/19/2017 2:07:40 PM,Overall,2474,4489,6973,10469,24405,1860,3460,2629,2864,10813
19,South Sudan (UNDP),2016,SSD-16/HSS10/SA2/P/INGO/3593,9/19/2017 2:07:40 PM,Pregnant and Lactating Women,0,1500,0,0,1500,0,0,0,0,0
19,South Sudan (UNDP),2016,SSD-16/HSS10/SA2/P/INGO/3593,9/19/2017 2:07:40 PM,"Trainers, Promoters, Caretakers, committee members, etc.",56,141,16,32,245,78,146,28,32,284
19,South Sudan (UNDP),2016,SSD-16/HSS10/SA2/P/INGO/3653,1/15/2018 3:25:52 PM,Internally Displaced People,65,500,155,280,1000,792,1084,651,884,3411
19,South Sudan (UNDP),2016,SSD-16/HSS10/SA2/P/INGO/3653,1/15/2018 3:25:52 PM,Other,15,60,15,85,175,0,15,6,0,21
19,South Sudan (UNDP),2016,SSD-16/HSS10/SA2/P/INGO/3653,1/15/2018 3:25:52 PM,Overall,80,560,170,365,1175,792,1099,657,884,3432
19,South Sudan (UNDP),2016,SSD-16/HSS10/SA2/P/INGO/3719,9/28/2017 9:08:36 AM,Aid Agencies,50,50,0,0,100,54,51,0,0,105
19,South Sudan (UNDP),2016,SSD-16/HSS10/SA2/P/INGO/3719,9/28/2017 9:08:36 AM,Internally Displaced People,950,650,1000,650,3250,2046,1546,2181,1588,7361
19,South Sudan (UNDP),2016,SSD-16/HSS10/SA2/P/INGO/3719,9/28/2017 9:08:36 AM,Overall,3000,2000,3000,2000,10000,3811,4307,5361,4964,18443
19,South Sudan (UNDP),2016,SSD-16/HSS10/SA2/P/INGO/3719,9/28/2017 9:08:36 AM,People in Host Communities,1000,650,1000,650,3300,2332,1975,3614,2879,10800
19,South Sudan (UNDP),2016,SSD-16/HSS10/SA2/P/INGO/3719,9/28/2017 9:08:36 AM,Refugee Returnees,1000,650,1000,700,3350,0,0,0,0,0
19,South Sudan (UNDP),2016,SSD-16/HSS10/SA2/P/NGO/3427,6/6/2017 12:22:50 PM,Internally Displaced People,350,700,1200,1200,3450,557,2460,2445,3042,8504
19,South Sudan (UNDP),2016,SSD-16/HSS10/SA2/P/NGO/3427,6/6/2017 12:22:50 PM,Overall,350,700,1200,1200,3450,557,2460,2445,3042,8504
19,South Sudan (UNDP),2016,SSD-16/HSS10/SA2/P/NGO/3447,9/19/2017 12:14:14 PM,Internally Displaced People,200,570,340,400,1510,144,1309,314,445,2212
19,South Sudan (UNDP),2016,SSD-16/HSS10/SA2/P/NGO/3447,9/19/2017 12:14:14 PM,Overall,371,810,490,591,2262,345,2370,584,764,4063
19,South Sudan (UNDP),2016,SSD-16/HSS10/SA2/P/NGO/3447,9/19/2017 12:14:14 PM,People in Host Communities,141,170,150,191,652,201,1061,270,319,1851
19,South Sudan (UNDP),2016,SSD-16/HSS10/SA2/P/NGO/3447,9/19/2017 12:14:14 PM,"Trainers, Promoters, Caretakers, committee members, etc.",30,70,0,0,100,18,72,0,0,90
19,South Sudan (UNDP),2016,SSD-16/HSS10/SA2/P/NGO/3450,7/13/2017 6:42:52 PM,Internally Displaced People,1050,1200,1175,1175,4600,799,1477,1339,1272,4887
19,South Sudan (UNDP),2016,SSD-16/HSS10/SA2/P/NGO/3450,7/13/2017 6:42:52 PM,Other,50,50,50,50,200,0,0,0,0,0
19,South Sudan (UNDP),2016,SSD-16/HSS10/SA2/P/NGO/3450,7/13/2017 6:42:52 PM,Overall,2000,2500,2550,2550,9600,1872,3007,2827,2586,10292
19,South Sudan (UNDP),2016,SSD-16/HSS10/SA2/P/NGO/3450,7/13/2017 6:42:52 PM,People in Host Communities,750,1100,1075,1075,4000,922,1480,1139,985,4526
19,South Sudan (UNDP),2016,SSD-16/HSS10/SA2/P/NGO/3450,7/13/2017 6:42:52 PM,"Trainers, Promoters, Caretakers, committee members, etc.",150,150,250,250,800,150,150,257,250,807
19,South Sudan (UNDP),2016,SSD-16/HSS10/SA2/P/NGO/3537,7/13/2017 2:37:31 PM,Internally Displaced People,40,70,960,960,2030,40,73,2463,3439,6015
19,South Sudan (UNDP),2016,SSD-16/HSS10/SA2/P/NGO/3537,7/13/2017 2:37:31 PM,Overall,40,70,960,960,2030,40,73,2463,3439,6015
19,South Sudan (UNDP),2016,SSD-16/HSS10/SA2/P/NGO/3572,10/3/2017 7:52:34 AM,Children under 5,0,0,2537,2830,5367,0,0,2537,2830,5367
19,South Sudan (UNDP),2016,SSD-16/HSS10/SA2/P/NGO/3572,10/3/2017 7:52:34 AM,Other,8565,6395,5075,5660,25695,0,0,0,0,0
19,South Sudan (UNDP),2016,SSD-16/HSS10/SA2/P/NGO/3572,10/3/2017 7:52:34 AM,Overall,28550,31976,25374,28300,114200,19985,27179,17761,25470,90395
19,South Sudan (UNDP),2016,SSD-16/HSS10/SA2/P/NGO/3572,10/3/2017 7:52:34 AM,People in Host Communities,19985,22383,17762,19810,79940,18986,4701,2309,12573,38569
19,South Sudan (UNDP),2016,SSD-16/HSS10/SA2/P/NGO/3572,10/3/2017 7:52:34 AM,Pregnant and Lactating Women,0,3198,0,0,3198,0,3198,0,0,3198
19,South Sudan (UNDP),2016,SSD-16/HSS10/SA2/P/UN/3495,3/24/2017 1:22:33 PM,Aid Agencies,10,0,0,20,30,0,0,0,0,0
19,South Sudan (UNDP),2016,SSD-16/HSS10/SA2/P/UN/3495,3/24/2017 1:22:33 PM,Internally Displaced People,0,2250,0,2250,4500,0,0,0,0,0
19,South Sudan (UNDP),2016,SSD-16/HSS10/SA2/P/UN/3495,3/24/2017 1:22:33 PM,Overall,10,2520,0,2500,5030,10,2550,0,2470,5030
19,South Sudan (UNDP),2016,SSD-16/HSS10/SA2/P/UN/3576,5/2/2017 6:49:38 AM,Aid Agencies,100,120,0,0,220,124,109,0,0,233
19,South Sudan (UNDP),2016,SSD-16/HSS10/SA2/P/UN/3576,5/2/2017 6:49:38 AM,Internally Displaced People,0,19000,0,26000,45000,0,19000,0,26000,45000
19,South Sudan (UNDP),2016,SSD-16/HSS10/SA2/P/UN/3576,5/2/2017 6:49:38 AM,Overall,100,19120,0,26000,45220,124,19109,0,26000,45233
19,South Sudan (UNDP),2016,SSD-16/HSS10/SA2/P/UN/3635,8/29/2017 9:22:13 AM,Internally Displaced People,700,3500,3600,3600,11400,1583,2911,21953,24465,50912
19,South Sudan (UNDP),2016,SSD-16/HSS10/SA2/P/UN/3635,8/29/2017 9:22:13 AM,Overall,1000,5000,4625,4625,15250,2261,4159,31361,34950,72731
19,South Sudan (UNDP),2016,SSD-16/HSS10/SA2/P/UN/3635,8/29/2017 9:22:13 AM,People in Host Communities,300,1500,1025,1025,3850,673,1248,9408,10485,21814
19,South Sudan (UNDP),2016,SSD-16/HSS10/SA2/WASH/INGO/3574,5/29/2017 9:22:13 AM,Internally Displaced People,750,1050,450,750,3000,855,1197,513,855,3420
19,South Sudan (UNDP),2016,SSD-16/HSS10/SA2/WASH/INGO/3574,5/29/2017 9:22:13 AM,Overall,5375,7525,3225,5375,21500,3886,4054,7324,7543,22807
19,South Sudan (UNDP),2016,SSD-16/HSS10/SA2/WASH/INGO/3574,5/29/2017 9:22:13 AM,People in Host Communities,4625,6475,2775,4625,18500,3031,2857,6811,6688,19387
19,South Sudan (UNDP),2016,SSD-16/HSS10/SA2/WASH/INGO/3586,7/25/2017 9:18:49 AM,Children under 5,0,0,3877,4036,7913,0,0,7449,7843,15292
19,South Sudan (UNDP),2016,SSD-16/HSS10/SA2/WASH/INGO/3586,7/25/2017 9:18:49 AM,Other,11959,10404,13090,14157,49610,10932,13878,11538,12376,48724
19,South Sudan (UNDP),2016,SSD-16/HSS10/SA2/WASH/INGO/3586,7/25/2017 9:18:49 AM,Overall,12025,13128,18864,20168,64185,11004,16556,18987,20219,66766
19,South Sudan (UNDP),2016,SSD-16/HSS10/SA2/WASH/INGO/3586,7/25/2017 9:18:49 AM,Pregnant and Lactating Women,0,1609,0,0,1609,0,2555,0,0,2555
19,South Sudan (UNDP),2016,SSD-16/HSS10/SA2/WASH/INGO/3586,7/25/2017 9:18:49 AM,"Trainers, Promoters, Caretakers, committee members, etc.",66,310,0,0,376,72,123,0,0,195
19,South Sudan (UNDP),2016,SSD-16/HSS10/SA2/WASH/INGO/3600,6/7/2017 7:55:38 AM,Children under 5,0,0,364,336,700,0,0,438,391,829
19,South Sudan (UNDP),2016,SSD-16/HSS10/SA2/WASH/INGO/3600,6/7/2017 7:55:38 AM,Internally Displaced People,1147,3254,1196,1104,6701,1107,1419,1936,1141,5603
19,South Sudan (UNDP),2016,SSD-16/HSS10/SA2/WASH/INGO/3600,6/7/2017 7:55:38 AM,Overall,1147,4068,1560,1440,8215,2024,3029,2232,2531,9816
19,South Sudan (UNDP),2016,SSD-16/HSS10/SA2/WASH/INGO/3600,6/7/2017 7:55:38 AM,Pregnant and Lactating Women,0,814,0,0,814,0,918,0,0,918
19,South Sudan (UNDP),2016,SSD-16/HSS10/SA2/WASH/INGO/3618,9/7/2017 9:56:08 AM,Internally Displaced People,5287,4422,3957,3767,17433,5287,4422,3957,3767,17433
19,South Sudan (UNDP),2016,SSD-16/HSS10/SA2/WASH/INGO/3618,9/7/2017 9:56:08 AM,Overall,6197,5183,4638,4415,20433,6197,5183,4638,4415,20433
19,South Sudan (UNDP),2016,SSD-16/HSS10/SA2/WASH/INGO/3618,9/7/2017 9:56:08 AM,People in Host Communities,910,761,681,648,3000,910,761,681,648,3000
19,South Sudan (UNDP),2016,SSD-16/HSS10/SA2/WASH/INGO/3622,9/7/2017 1:10:18 PM,Overall,1967,3933,1800,2300,10000,5031,20155,4599,5877,35662
19,South Sudan (UNDP),2016,SSD-16/HSS10/SA2/WASH/INGO/3633,9/7/2017 1:34:10 PM,Internally Displaced People,990,1530,3240,3240,9000,1122,1734,3672,3672,10200
19,South Sudan (UNDP),2016,SSD-16/HSS10/SA2/WASH/INGO/3633,9/7/2017 1:34:10 PM,Overall,1650,2550,5400,5400,15000,4078,8426,6763,7463,26730
19,South Sudan (UNDP),2016,SSD-16/HSS10/SA2/WASH/INGO/3633,9/7/2017 1:34:10 PM,People in Host Communities,660,1020,2160,2160,6000,2956,6692,3091,3791,16530
19,South Sudan (UNDP),2016,SSD-16/HSS10/SA2/WASH/NGO/3395,4/24/2017 7:14:31 AM,Internally Displaced People,1183,1539,1179,1524,5425,1405,1715,1448,1838,6406
19,South Sudan (UNDP),2016,SSD-16/HSS10/SA2/WASH/NGO/3395,4/24/2017 7:14:31 AM,Overall,3943,5130,3929,5080,18082,4682,5718,4826,6127,21353
19,South Sudan (UNDP),2016,SSD-16/HSS10/SA2/WASH/NGO/3395,4/24/2017 7:14:31 AM,People in Host Communities,2760,3591,2750,3556,12657,3277,4003,3378,4289,14947
19,South Sudan (UNDP),2016,SSD-16/HSS10/SA2/WASH/NGO/3431,5/4/2017 5:45:20 AM,Children under 5,0,0,5000,4500,9500,0,0,5000,5000,10000
19,South Sudan (UNDP),2016,SSD-16/HSS10/SA2/WASH/NGO/3431,5/4/2017 5:45:20 AM,Overall,4500,12000,5000,4500,26000,4500,12000,5000,4500,26000
19,South Sudan (UNDP),2016,SSD-16/HSS10/SA2/WASH/NGO/3431,5/4/2017 5:45:20 AM,People in Host Communities,3950,11000,0,0,14950,3950,11000,0,0,14950
19,South Sudan (UNDP),2016,SSD-16/HSS10/SA2/WASH/NGO/3431,5/4/2017 5:45:20 AM,Pregnant and Lactating Women,0,200,0,0,200,0,0,0,0,0
19,South Sudan (UNDP),2016,SSD-16/HSS10/SA2/WASH/NGO/3431,5/4/2017 5:45:20 AM,"Trainers, Promoters, Caretakers, committee members, etc.",150,200,0,0,350,150,200,0,0,350
19,South Sudan (UNDP),2016,SSD-16/HSS10/SA2/WASH/NGO/3437,5/12/2017 8:45:34 AM,Internally Displaced People,10259,17953,10260,12824,51296,8050,11200,7088,8662,35000
19,South Sudan (UNDP),2016,SSD-16/HSS10/SA2/WASH/NGO/3437,5/12/2017 8:45:34 AM,Overall,10259,17953,10260,12824,51296,8050,11200,7088,8662,35000
19,South Sudan (UNDP),2016,SSD-16/HSS10/SA2/WASH/NGO/3442,5/3/2017 2:28:49 PM,Internally Displaced People,1874,2625,1127,1874,7500,1953,3108,1301,1902,8264
19,South Sudan (UNDP),2016,SSD-16/HSS10/SA2/WASH/NGO/3442,5/3/2017 2:28:49 PM,Other,150,210,90,150,600,125,168,72,121,486
19,South Sudan (UNDP),2016,SSD-16/HSS10/SA2/WASH/NGO/3442,5/3/2017 2:28:49 PM,Overall,3750,5252,2248,3750,15000,3914,5620,2602,3814,15950
19,South Sudan (UNDP),2016,SSD-16/HSS10/SA2/WASH/NGO/3442,5/3/2017 2:28:49 PM,People in Host Communities,1688,2364,1010,1688,6750,1798,2291,1208,1753,7050
19,South Sudan (UNDP),2016,SSD-16/HSS10/SA2/WASH/NGO/3442,5/3/2017 2:28:49 PM,"Trainers, Promoters, Caretakers, committee members, etc.",38,53,21,38,150,38,53,21,38,150
19,South Sudan (UNDP),2016,SSD-16/HSS10/SA2/WASH/NGO/3457,9/8/2017 10:21:40 AM,Children under 5,0,0,500,500,1000,0,0,1500,2380,3880
19,South Sudan (UNDP),2016,SSD-16/HSS10/SA2/WASH/NGO/3457,9/8/2017 10:21:40 AM,Internally Displaced People,2000,2500,3500,4500,12500,1840,2690,2930,3150,10610
19,South Sudan (UNDP),2016,SSD-16/HSS10/SA2/WASH/NGO/3457,9/8/2017 10:21:40 AM,Overall,3000,4000,5000,6000,18000,3390,5940,7700,7242,24272
19,South Sudan (UNDP),2016,SSD-16/HSS10/SA2/WASH/NGO/3457,9/8/2017 10:21:40 AM,People in Host Communities,1000,1000,1000,1000,4000,1550,2290,3270,1712,8822
19,South Sudan (UNDP),2016,SSD-16/HSS10/SA2/WASH/NGO/3457,9/8/2017 10:21:40 AM,Pregnant and Lactating Women,0,500,0,0,500,0,960,0,0,960
19,South Sudan (UNDP),2016,SSD-16/HSS10/SA2/WASH/NGO/3471,9/8/2017 12:39:29 PM,Internally Displaced People,1100,1950,3000,2275,8325,1123,1992,3013,2497,8625
19,South Sudan (UNDP),2016,SSD-16/HSS10/SA2/WASH/NGO/3471,9/8/2017 12:39:29 PM,Overall,2250,4000,5750,4000,16000,2336,4126,5732,4424,16618
19,South Sudan (UNDP),2016,SSD-16/HSS10/SA2/WASH/NGO/3471,9/8/2017 12:39:29 PM,People in Host Communities,1150,2050,2750,1725,7675,1187,2105,2676,2025,7993
19,South Sudan (UNDP),2016,SSD-16/HSS10/SA2/WASH/NGO/3472,4/24/2017 6:58:58 AM,Children under 5,0,0,260,263,523,0,0,271,347,618
19,South Sudan (UNDP),2016,SSD-16/HSS10/SA2/WASH/NGO/3472,4/24/2017 6:58:58 AM,Internally Displaced People,450,620,530,580,2180,572,1861,119,179,2731
19,South Sudan (UNDP),2016,SSD-16/HSS10/SA2/WASH/NGO/3472,4/24/2017 6:58:58 AM,Overall,1200,1700,1500,1600,6000,1634,4401,531,730,7296
19,South Sudan (UNDP),2016,SSD-16/HSS10/SA2/WASH/NGO/3472,4/24/2017 6:58:58 AM,People in Host Communities,736,1064,700,750,3250,1048,2530,125,197,3900
19,South Sudan (UNDP),2016,SSD-16/HSS10/SA2/WASH/NGO/3472,4/24/2017 6:58:58 AM,"Trainers, Promoters, Caretakers, committee members, etc.",14,16,10,7,47,14,10,16,7,47
19,South Sudan (UNDP),2016,SSD-16/HSS10/SA2/WASH/NGO/3583,6/7/2017 2:26:53 PM,Children under 5,0,0,200,100,300,0,0,200,100,300
19,South Sudan (UNDP),2016,SSD-16/HSS10/SA2/WASH/NGO/3583,6/7/2017 2:26:53 PM,Internally Displaced People,4000,5000,1000,800,10800,4000,5000,1000,800,10800
19,South Sudan (UNDP),2016,SSD-16/HSS10/SA2/WASH/NGO/3583,6/7/2017 2:26:53 PM,Overall,5000,7000,1800,1200,15000,5000,7000,1800,1200,15000
19,South Sudan (UNDP),2016,SSD-16/HSS10/SA2/WASH/NGO/3583,6/7/2017 2:26:53 PM,People in Host Communities,1000,2000,600,300,3900,1000,2000,600,300,3900
19,South Sudan (UNDP),2016,SSD-16/HSS10/SA2/WASH/NGO/3627,2/8/2017 1:15:30 PM,Internally Displaced People,3350,4280,3050,3200,13880,1521,2050,1940,2688,8199
19,South Sudan (UNDP),2016,SSD-16/HSS10/SA2/WASH/NGO/3627,2/8/2017 1:15:30 PM,Overall,4800,5350,4200,4994,19344,2510,3350,3120,3980,12960
19,South Sudan (UNDP),2016,SSD-16/HSS10/SA2/WASH/NGO/3627,2/8/2017 1:15:30 PM,People in Host Communities,1450,1070,1150,1794,5464,989,1346,1180,1292,4807
19,South Sudan (UNDP),2016,SSD-16/HSS10/SA2/WASH/UN/3520,7/25/2017 6:33:06 AM,Internally Displaced People,7721,53228,17081,32220,110250,14496,99937,32070,60494,206997
19,South Sudan (UNDP),2016,SSD-16/HSS10/SA2/WASH/UN/3520,7/25/2017 6:33:06 AM,Overall,7721,53228,17081,32220,110250,14496,99937,32070,60494,206997
19,South Sudan (UNDP),2016,SSD-16/HSS10/SA2/WASH/UN/3638,5/11/2017 10:39:45 AM,Children under 5,0,0,11897,13173,25070,0,0,9279,12875,22154
19,South Sudan (UNDP),2016,SSD-16/HSS10/SA2/WASH/UN/3638,5/11/2017 10:39:45 AM,Overall,7900,10710,19907,21483,60000,9785,16995,11845,32208,70833
19,South Sudan (UNDP),2016,SSD-16/HSS10/SA2/WASH/UN/3638,5/11/2017 10:39:45 AM,People in Host Communities,7900,6710,8010,8310,30930,9785,6285,2566,19333,37969
19,South Sudan (UNDP),2016,SSD-16/HSS10/SA2/WASH/UN/3638,5/11/2017 10:39:45 AM,Pregnant and Lactating Women,0,4000,0,0,4000,0,10710,0,0,10710
19,South Sudan (UNDP),2016,SSD-16/HSS10/SA2/WASH/UN/3640,5/11/2017 10:36:58 AM,Internally Displaced People,20875,25000,22625,25000,93500,23500,27200,25100,27200,103000
19,South Sudan (UNDP),2016,SSD-16/HSS10/SA2/WASH/UN/3640,5/11/2017 10:36:58 AM,Other,6750,10000,8250,10000,35000,7400,10250,9200,10250,37100
19,South Sudan (UNDP),2016,SSD-16/HSS10/SA2/WASH/UN/3640,5/11/2017 10:36:58 AM,Overall,37750,50000,43250,50000,181000,42200,52050,46700,52050,193000
19,South Sudan (UNDP),2016,SSD-16/HSS10/SA2/WASH/UN/3640,5/11/2017 10:36:58 AM,People in Host Communities,10125,15000,12375,15000,52500,11300,14600,12400,14600,52900
19,South Sudan (UNDP),2017,SSD-17/HSS10/HF-DC/CCS/UN/4902,2/7/2020 6:09:44 AM,Overall,60,0,0,0,60,67,0,0,0,67
19,South Sudan (UNDP),2017,SSD-17/HSS10/HF-DC/CCS/UN/7122,2/7/2020 6:09:22 AM,Overall,60,0,0,0,60,67,0,0,0,67
19,South Sudan (UNDP),2017,SSD-17/HSS10/RA1/E/UN/7638,12/11/2018 12:21:40 PM,Internally Displaced People,0,0,15000,10000,25000,560,240,15000,10000,25800
19,South Sudan (UNDP),2017,SSD-17/HSS10/RA1/E/UN/7638,12/11/2018 12:21:40 PM,Overall,560,240,18000,12000,30800,560,240,18000,12000,30800
19,South Sudan (UNDP),2017,SSD-17/HSS10/RA1/E/UN/7638,12/11/2018 12:21:40 PM,People in Host Communities,0,0,3000,2000,5000,0,0,3000,2000,5000
19,South Sudan (UNDP),2017,SSD-17/HSS10/RA1/E/UN/7638,12/11/2018 12:21:40 PM,"Trainers, Promoters, Caretakers, committee members, etc.",560,240,0,0,800,0,0,0,0,0
19,South Sudan (UNDP),2017,SSD-17/HSS10/RA1/FSL/UN/7639,4/17/2019 11:38:51 AM,Internally Displaced People,11162,16744,11162,16744,55812,12559,18838,12559,18838,62794
19,South Sudan (UNDP),2017,SSD-17/HSS10/RA1/FSL/UN/7639,4/17/2019 11:38:51 AM,Overall,27906,41859,27906,41859,139530,27906,41859,27906,41859,139530
19,South Sudan (UNDP),2017,SSD-17/HSS10/RA1/FSL/UN/7639,4/17/2019 11:38:51 AM,People in Host Communities,11162,16744,11162,16744,55812,9768,14650,9768,14650,48836
19,South Sudan (UNDP),2017,SSD-17/HSS10/RA1/FSL/UN/7639,4/17/2019 11:38:51 AM,Refugee Returnees,5582,8371,5582,8371,27906,5580,8371,5580,8371,27902
19,South Sudan (UNDP),2017,SSD-17/HSS10/RA1/H/UN/7621,7/31/2018 7:33:26 PM,Internally Displaced People,0,17748,97685,101672,217105,0,12894,150429,175324,338647
19,South Sudan (UNDP),2017,SSD-17/HSS10/RA1/H/UN/7621,7/31/2018 7:33:26 PM,Overall,0,17748,97685,101672,217105,0,12894,150429,175324,338647
19,South Sudan (UNDP),2017,SSD-17/HSS10/RA1/H/UN/7624,7/26/2018 5:36:52 AM,Internally Displaced People,9000,29304,1000,5000,44304,11185,60332,1006,6361,78884
19,South Sudan (UNDP),2017,SSD-17/HSS10/RA1/H/UN/7624,7/26/2018 5:36:52 AM,Overall,9000,60304,1000,5000,75304,11044,60741,789,6311,78885
19,South Sudan (UNDP),2017,SSD-17/HSS10/RA1/H/UN/7624,7/26/2018 5:36:52 AM,Pregnant and Lactating Women,0,31000,0,0,31000,0,0,0,0,0
19,South Sudan (UNDP),2017,SSD-17/HSS10/RA1/H/UN/7625,6/20/2019 9:15:02 AM,Internally Displaced People,12000,14400,3000,3600,33000,32000,38000,15000,16000,101000
19,South Sudan (UNDP),2017,SSD-17/HSS10/RA1/H/UN/7625,6/20/2019 9:15:02 AM,Overall,12000,14400,3000,3600,33000,32000,38000,15000,16000,101000
19,South Sudan (UNDP),2017,SSD-17/HSS10/RA1/N/UN/7627,8/8/2019 6:31:43 AM,Children under 5,0,0,3866,4012,7878,0,0,4825,5022,9847
19,South Sudan (UNDP),2017,SSD-17/HSS10/RA1/N/UN/7627,8/8/2019 6:31:43 AM,Overall,0,0,3866,4012,7878,0,0,4826,5022,9848
19,South Sudan (UNDP),2017,SSD-17/HSS10/RA1/N/UN/7642,10/27/2021 12:21:22 PM,Children under 5,0,0,0,0,0,0,0,8676,10324,19000
19,South Sudan (UNDP),2017,SSD-17/HSS10/RA1/N/UN/7642,10/27/2021 12:21:22 PM,Overall,0,0,9179,9554,18733,0,0,8676,10324,19000
19,South Sudan (UNDP),2017,SSD-17/HSS10/RA1/NFI/UN/7641,2/2/2019 4:51:53 PM,Internally Displaced People,21321,25016,21911,24312,92560,21321,25016,21912,24312,92561
19,South Sudan (UNDP),2017,SSD-17/HSS10/RA1/NFI/UN/7641,2/2/2019 4:51:53 PM,Overall,21321,25016,21911,24312,92560,21321,25016,21911,24312,92560
19,South Sudan (UNDP),2017,SSD-17/HSS10/RA1/P/UN/7629,10/9/2018 1:49:49 PM,Internally Displaced People,0,6000,0,3000,9000,0,10143,0,4857,15000
19,South Sudan (UNDP),2017,SSD-17/HSS10/RA1/P/UN/7629,10/9/2018 1:49:49 PM,Overall,0,11000,0,4000,15000,0,10143,0,4857,15000
19,South Sudan (UNDP),2017,SSD-17/HSS10/RA1/P/UN/7629,10/9/2018 1:49:49 PM,People in Host Communities,0,2000,0,1000,3000,0,0,0,0,0
19,South Sudan (UNDP),2017,SSD-17/HSS10/RA1/P/UN/7629,10/9/2018 1:49:49 PM,Pregnant and Lactating Women,0,3000,0,0,3000,0,0,0,0,0
19,South Sudan (UNDP),2017,SSD-17/HSS10/RA1/P/UN/7640,6/23/2019 5:00:46 PM,Internally Displaced People,0,0,34423,30280,64703,0,0,46391,42399,88790
19,South Sudan (UNDP),2017,SSD-17/HSS10/RA1/P/UN/7640,6/23/2019 5:00:46 PM,Overall,0,0,39215,32085,71300,0,0,44430,40795,85225
19,South Sudan (UNDP),2017,SSD-17/HSS10/RA1/P/UN/7640,6/23/2019 5:00:46 PM,People in Host Communities,0,0,4792,1805,6597,0,0,0,0,0
19,South Sudan (UNDP),2017,SSD-17/HSS10/RA1/WASH/UN/7626,11/5/2018 9:59:02 AM,Internally Displaced People,10570,12408,12919,15165,51062,11215,12818,13511,15862,53406
19,South Sudan (UNDP),2017,SSD-17/HSS10/RA1/WASH/UN/7626,11/5/2018 9:59:02 AM,Overall,18543,21768,22665,26607,89583,19060,22374,23296,27349,92079
19,South Sudan (UNDP),2017,SSD-17/HSS10/RA1/WASH/UN/7630,9/4/2018 7:24:22 AM,Internally Displaced People,12420,15120,12960,13500,54000,9300,16000,13806,16185,55291
19,South Sudan (UNDP),2017,SSD-17/HSS10/RA1/WASH/UN/7630,9/4/2018 7:24:22 AM,Overall,20700,25200,21600,22500,90000,20500,25500,22000,24000,92000
19,South Sudan (UNDP),2017,SSD-17/HSS10/RA1/WASH/UN/7630,9/4/2018 7:24:22 AM,People in Host Communities,8280,10080,8640,9000,36000,7100,9400,9954,10255,36709
19,South Sudan (UNDP),2017,SSD-17/HSS10/SA1/CCCM/INGO/5080,2/13/2018 1:52:17 PM,Internally Displaced People,5621,8042,8462,8434,30559,5314,7062,6793,6737,25906
19,South Sudan (UNDP),2017,SSD-17/HSS10/SA1/CCCM/INGO/5080,2/13/2018 1:52:17 PM,Overall,5621,8042,8462,8434,30559,5314,7062,6793,6737,25906
19,South Sudan (UNDP),2017,SSD-17/HSS10/SA1/CCCM/INGO/5088,2/9/2018 4:13:02 PM,Internally Displaced People,9346,14019,0,0,23365,18966,19482,0,0,38448
19,South Sudan (UNDP),2017,SSD-17/HSS10/SA1/CCCM/INGO/5088,2/9/2018 4:13:02 PM,Overall,9346,14019,0,0,23365,18966,19482,0,0,38448
19,South Sudan (UNDP),2017,SSD-17/HSS10/SA1/CCCM/INGO/5222,2/13/2018 2:47:03 PM,Internally Displaced People,11098,14544,12265,14549,52456,6193,8535,9028,9795,33551
19,South Sudan (UNDP),2017,SSD-17/HSS10/SA1/CCCM/INGO/5222,2/13/2018 2:47:03 PM,Overall,11098,14544,12265,14549,52456,6196,8535,9028,9795,33554
19,South Sudan (UNDP),2017,SSD-17/HSS10/SA1/E/INGO/5082,2/15/2018 6:15:21 AM,Internally Displaced People,157,156,1678,1372,3363,98,38,525,516,1177
19,South Sudan (UNDP),2017,SSD-17/HSS10/SA1/E/INGO/5082,2/15/2018 6:15:21 AM,Overall,314,312,3355,2745,6726,313,187,4492,3633,8625
19,South Sudan (UNDP),2017,SSD-17/HSS10/SA1/E/INGO/5082,2/15/2018 6:15:21 AM,People in Host Communities,157,156,1677,1373,3363,215,149,3967,3117,7448
19,South Sudan (UNDP),2017,SSD-17/HSS10/SA1/E/INGO/5095,12/13/2017 8:36:29 AM,Internally Displaced People,80,300,1300,1400,3080,54,73,751,752,1630
19,South Sudan (UNDP),2017,SSD-17/HSS10/SA1/E/INGO/5095,12/13/2017 8:36:29 AM,Overall,100,500,1900,2100,4600,98,133,3369,1857,5457
19,South Sudan (UNDP),2017,SSD-17/HSS10/SA1/E/INGO/5095,12/13/2017 8:36:29 AM,People in Host Communities,20,200,600,700,1520,44,60,2618,1105,3827
19,South Sudan (UNDP),2017,SSD-17/HSS10/SA1/E/INGO/5158,12/13/2017 8:34:39 AM,Children under 5,0,0,1870,1530,3400,0,0,1870,1530,3400
19,South Sudan (UNDP),2017,SSD-17/HSS10/SA1/E/INGO/5158,12/13/2017 8:34:39 AM,Internally Displaced People,750,875,1870,988,4483,750,865,1870,988,4473
19,South Sudan (UNDP),2017,SSD-17/HSS10/SA1/E/INGO/5158,12/13/2017 8:34:39 AM,Overall,1591,1855,6950,4416,14812,1591,1855,6950,4354,14750
19,South Sudan (UNDP),2017,SSD-17/HSS10/SA1/E/INGO/5158,12/13/2017 8:34:39 AM,People in Host Communities,643,850,3210,1898,6601,643,840,3210,1836,6529
19,South Sudan (UNDP),2017,SSD-17/HSS10/SA1/E/INGO/5158,12/13/2017 8:34:39 AM,"Trainers, Promoters, Caretakers, committee members, etc.",198,130,0,0,328,198,150,0,0,348
19,South Sudan (UNDP),2017,SSD-17/HSS10/SA1/E/NGO/5073,12/13/2017 8:39:04 AM,Internally Displaced People,14,10,1260,840,2124,14,10,1631,820,2475
19,South Sudan (UNDP),2017,SSD-17/HSS10/SA1/E/NGO/5073,12/13/2017 8:39:04 AM,Overall,24,16,2100,1400,3540,24,16,4749,1893,6682
19,South Sudan (UNDP),2017,SSD-17/HSS10/SA1/E/NGO/5073,12/13/2017 8:39:04 AM,People in Host Communities,10,6,840,560,1416,10,6,3118,1073,4207
19,South Sudan (UNDP),2017,SSD-17/HSS10/SA1/FSL/INGO/5060,1/15/2018 5:47:58 AM,Internally Displaced People,2000,2000,3000,3000,10000,3450,4500,3200,2500,13650
19,South Sudan (UNDP),2017,SSD-17/HSS10/SA1/FSL/INGO/5060,1/15/2018 5:47:58 AM,Other,200,200,800,800,2000,936,1260,1200,1312,4708
19,South Sudan (UNDP),2017,SSD-17/HSS10/SA1/FSL/INGO/5060,1/15/2018 5:47:58 AM,Overall,3200,3200,5800,5800,18000,11106,12510,5940,6012,35568
19,South Sudan (UNDP),2017,SSD-17/HSS10/SA1/FSL/INGO/5060,1/15/2018 5:47:58 AM,People in Host Communities,1000,1000,2000,2000,6000,6720,6750,1540,2200,17210
19,South Sudan (UNDP),2017,SSD-17/HSS10/SA1/FSL/INGO/5103,2/14/2018 3:30:30 PM,Overall,4062,6324,234,180,10800,4062,6324,234,180,10800
19,South Sudan (UNDP),2017,SSD-17/HSS10/SA1/FSL/INGO/5103,2/14/2018 3:30:30 PM,People in Host Communities,4062,6324,234,180,10800,4062,6324,234,180,10800
19,South Sudan (UNDP),2017,SSD-17/HSS10/SA1/FSL/INGO/5228,12/13/2017 9:07:27 AM,Overall,5221,5657,5435,5887,22200,5221,5657,5435,5887,22200
19,South Sudan (UNDP),2017,SSD-17/HSS10/SA1/FSL/INGO/5228,12/13/2017 9:07:27 AM,People in Host Communities,5221,5657,5435,5887,22200,5221,5657,5435,5887,22200
19,South Sudan (UNDP),2017,SSD-17/HSS10/SA1/FSL/NGO/5113,1/15/2018 5:44:18 AM,Internally Displaced People,750,750,2000,2000,5500,1680,2640,3960,5920,14200
19,South Sudan (UNDP),2017,SSD-17/HSS10/SA1/FSL/NGO/5113,1/15/2018 5:44:18 AM,Other,250,250,500,500,1500,112,228,70,88,498
19,South Sudan (UNDP),2017,SSD-17/HSS10/SA1/FSL/NGO/5113,1/15/2018 5:44:18 AM,Overall,1500,1500,3000,3000,9000,2400,3600,4800,7272,18072
19,South Sudan (UNDP),2017,SSD-17/HSS10/SA1/FSL/NGO/5113,1/15/2018 5:44:18 AM,People in Host Communities,500,500,500,500,2000,608,732,770,1264,3374
19,South Sudan (UNDP),2017,SSD-17/HSS10/SA1/FSL/NGO/5116,12/4/2017 4:51:28 PM,Internally Displaced People,1800,2600,200,200,4800,600,1200,0,0,1800
19,South Sudan (UNDP),2017,SSD-17/HSS10/SA1/FSL/NGO/5116,12/4/2017 4:51:28 PM,Overall,4500,6500,500,500,12000,4056,7944,0,0,12000
19,South Sudan (UNDP),2017,SSD-17/HSS10/SA1/FSL/NGO/5116,12/4/2017 4:51:28 PM,People in Host Communities,2250,3250,250,250,6000,3456,6744,0,0,10200
19,South Sudan (UNDP),2017,SSD-17/HSS10/SA1/FSL/NGO/5116,12/4/2017 4:51:28 PM,Refugee Returnees,450,650,50,50,1200,0,0,0,0,0
19,South Sudan (UNDP),2017,SSD-17/HSS10/SA1/FSL/NGO/5164,12/13/2017 9:04:09 AM,Internally Displaced People,1920,4680,2400,5400,14400,2020,4480,2700,5000,14200
19,South Sudan (UNDP),2017,SSD-17/HSS10/SA1/FSL/NGO/5164,12/13/2017 9:04:09 AM,Overall,3200,7800,4000,9000,24000,3500,7500,4500,8500,24000
19,South Sudan (UNDP),2017,SSD-17/HSS10/SA1/FSL/NGO/5164,12/13/2017 9:04:09 AM,People in Host Communities,1280,3120,1600,3600,9600,1480,3020,1800,3500,9800
19,South Sudan (UNDP),2017,SSD-17/HSS10/SA1/FSL/NGO/5230,11/14/2017 11:46:44 AM,Internally Displaced People,4500,7500,1500,1500,15000,3548,11187,1460,1832,18027
19,South Sudan (UNDP),2017,SSD-17/HSS10/SA1/FSL/NGO/5230,11/14/2017 11:46:44 AM,Overall,9000,15000,3000,3000,30000,5978,18022,2437,3563,30000
19,South Sudan (UNDP),2017,SSD-17/HSS10/SA1/FSL/NGO/5230,11/14/2017 11:46:44 AM,People in Host Communities,2700,4500,900,900,9000,2152,6387,781,1674,10994
19,South Sudan (UNDP),2017,SSD-17/HSS10/SA1/FSL/NGO/5230,11/14/2017 11:46:44 AM,Refugee Returnees,180,300,60,60,600,278,448,196,57,979
19,South Sudan (UNDP),2017,SSD-17/HSS10/SA1/FSL/NGO/5239,10/3/2017 9:01:48 AM,Internally Displaced People,2810,3951,878,1141,8780,2810,3951,878,1141,8780
19,South Sudan (UNDP),2017,SSD-17/HSS10/SA1/FSL/NGO/5239,10/3/2017 9:01:48 AM,Overall,5760,8100,1800,2340,18000,5760,8100,1800,2340,18000
19,South Sudan (UNDP),2017,SSD-17/HSS10/SA1/FSL/NGO/5239,10/3/2017 9:01:48 AM,People in Host Communities,2388,3359,746,970,7463,2388,3359,746,970,7463
19,South Sudan (UNDP),2017,SSD-17/HSS10/SA1/FSL/NGO/5239,10/3/2017 9:01:48 AM,Refugee Returnees,562,790,176,229,1757,562,790,176,229,1757
19,South Sudan (UNDP),2017,SSD-17/HSS10/SA1/FSL/NGO/5243,12/13/2017 9:01:51 AM,Internally Displaced People,1000,2000,800,900,4700,1000,2000,800,900,4700
19,South Sudan (UNDP),2017,SSD-17/HSS10/SA1/FSL/NGO/5243,12/13/2017 9:01:51 AM,Overall,3400,8000,3400,3200,18000,3400,8000,3400,3200,18000
19,South Sudan (UNDP),2017,SSD-17/HSS10/SA1/FSL/NGO/5243,12/13/2017 9:01:51 AM,People in Host Communities,2400,5200,2600,1800,12000,2400,5200,2600,1800,12000
19,South Sudan (UNDP),2017,SSD-17/HSS10/SA1/FSL/NGO/5243,12/13/2017 9:01:51 AM,Pregnant and Lactating Women,0,800,0,500,1300,0,800,0,500,1300
19,South Sudan (UNDP),2017,SSD-17/HSS10/SA1/FSL/NGO/5259,2/14/2018 3:08:36 PM,Internally Displaced People,720,960,96,144,1920,0,0,0,0,0
19,South Sudan (UNDP),2017,SSD-17/HSS10/SA1/FSL/NGO/5259,2/14/2018 3:08:36 PM,Overall,1800,2400,240,360,4800,200,320,120,160,800
19,South Sudan (UNDP),2017,SSD-17/HSS10/SA1/FSL/NGO/5259,2/14/2018 3:08:36 PM,People in Host Communities,1080,1440,144,216,2880,0,0,0,0,0
19,South Sudan (UNDP),2017,SSD-17/HSS10/SA1/H/INGO/5079,12/4/2017 5:08:24 PM,Internally Displaced People,14550,15144,3867,4025,37586,3945,4318,2854,2938,14055
19,South Sudan (UNDP),2017,SSD-17/HSS10/SA1/H/INGO/5079,12/4/2017 5:08:24 PM,Other,2568,2672,683,711,6634,626,443,644,661,2374
19,South Sudan (UNDP),2017,SSD-17/HSS10/SA1/H/INGO/5079,12/4/2017 5:08:24 PM,Overall,17118,17816,9340,10118,54392,4571,4761,34876,37783,81991
19,South Sudan (UNDP),2017,SSD-17/HSS10/SA1/H/INGO/5089,12/12/2017 8:42:59 AM,Internally Displaced People,1394,3253,3704,4013,12364,2934,6102,3267,3912,16215
19,South Sudan (UNDP),2017,SSD-17/HSS10/SA1/H/INGO/5089,12/12/2017 8:42:59 AM,Overall,3077,4936,6387,6919,21319,7544,14007,5912,6771,34234
19,South Sudan (UNDP),2017,SSD-17/HSS10/SA1/H/INGO/5089,12/12/2017 8:42:59 AM,People in Host Communities,1683,1683,2683,2906,8955,4610,7905,2645,2859,18019
19,South Sudan (UNDP),2017,SSD-17/HSS10/SA1/H/INGO/5105,12/4/2017 4:21:21 PM,Internally Displaced People,3788,5904,5486,6113,21291,0,0,0,0,0
19,South Sudan (UNDP),2017,SSD-17/HSS10/SA1/H/INGO/5105,12/4/2017 4:21:21 PM,Overall,12627,19681,18286,20377,70971,31507,32794,10250,10669,85220
19,South Sudan (UNDP),2017,SSD-17/HSS10/SA1/H/INGO/5105,12/4/2017 4:21:21 PM,People in Host Communities,8839,13777,12800,14264,49680,31507,32794,10250,10669,85220
19,South Sudan (UNDP),2017,SSD-17/HSS10/SA1/H/INGO/5117,2/9/2018 1:04:37 PM,Internally Displaced People,1791,2761,595,595,5742,689,1074,227,273,2263
19,South Sudan (UNDP),2017,SSD-17/HSS10/SA1/H/INGO/5117,2/9/2018 1:04:37 PM,Overall,4479,6792,1488,1488,14247,4596,7189,1491,1829,15105
19,South Sudan (UNDP),2017,SSD-17/HSS10/SA1/H/INGO/5117,2/9/2018 1:04:37 PM,People in Host Communities,2688,4031,893,893,8505,3907,6115,1264,1556,12842
19,South Sudan (UNDP),2017,SSD-17/HSS10/SA1/H/INGO/5174,2/15/2018 8:31:04 AM,Children under 5,0,0,277,287,564,0,0,1384,1407,2791
19,South Sudan (UNDP),2017,SSD-17/HSS10/SA1/H/INGO/5174,2/15/2018 8:31:04 AM,Internally Displaced People,26,66,10,10,112,60,80,32,30,202
19,South Sudan (UNDP),2017,SSD-17/HSS10/SA1/H/INGO/5174,2/15/2018 8:31:04 AM,Overall,3473,4387,465,493,8818,2790,3845,1384,1407,9426
19,South Sudan (UNDP),2017,SSD-17/HSS10/SA1/H/INGO/5174,2/15/2018 8:31:04 AM,People in Host Communities,501,1095,178,196,1970,2730,3765,1352,1377,9224
19,South Sudan (UNDP),2017,SSD-17/HSS10/SA1/H/INGO/5174,2/15/2018 8:31:04 AM,Pregnant and Lactating Women,0,160,0,0,160,0,362,0,0,362
19,South Sudan (UNDP),2017,SSD-17/HSS10/SA1/H/INGO/5263,2/15/2018 8:32:56 AM,Children under 5,0,0,549,650,1199,0,0,749,816,1565
19,South Sudan (UNDP),2017,SSD-17/HSS10/SA1/H/INGO/5263,2/15/2018 8:32:56 AM,Internally Displaced People,748,650,0,0,1398,181,2408,0,0,2589
19,South Sudan (UNDP),2017,SSD-17/HSS10/SA1/H/INGO/5263,2/15/2018 8:32:56 AM,Overall,1324,1493,549,650,4016,416,5644,749,816,7625
19,South Sudan (UNDP),2017,SSD-17/HSS10/SA1/H/INGO/5263,2/15/2018 8:32:56 AM,People in Host Communities,576,543,0,0,1119,235,2883,0,0,3118
19,South Sudan (UNDP),2017,SSD-17/HSS10/SA1/H/INGO/5263,2/15/2018 8:32:56 AM,Pregnant and Lactating Women,0,300,0,0,300,0,353,0,0,353
19,South Sudan (UNDP),2017,SSD-17/HSS10/SA1/H/NGO/5097,12/11/2017 1:21:42 PM,Children under 5,0,0,120,180,300,0,0,623,1101,1724
19,South Sudan (UNDP),2017,SSD-17/HSS10/SA1/H/NGO/5097,12/11/2017 1:21:42 PM,Internally Displaced People,320,480,160,240,1200,382,649,250,426,1707
19,South Sudan (UNDP),2017,SSD-17/HSS10/SA1/H/NGO/5097,12/11/2017 1:21:42 PM,Other,320,480,40,60,900,120,536,210,311,1177
19,South Sudan (UNDP),2017,SSD-17/HSS10/SA1/H/NGO/5097,12/11/2017 1:21:42 PM,Overall,800,1200,400,600,3000,956,1622,1208,2051,5837
19,South Sudan (UNDP),2017,SSD-17/HSS10/SA1/H/NGO/5097,12/11/2017 1:21:42 PM,People in Host Communities,160,240,80,120,600,454,437,125,213,1229
19,South Sudan (UNDP),2017,SSD-17/HSS10/SA1/H/NGO/5098,10/18/2017 8:35:06 AM,Internally Displaced People,400,700,500,690,2290,732,867,720,789,3108
19,South Sudan (UNDP),2017,SSD-17/HSS10/SA1/H/NGO/5098,10/18/2017 8:35:06 AM,Overall,1100,2380,2220,2720,8420,20653,16524,7753,7023,51953
19,South Sudan (UNDP),2017,SSD-17/HSS10/SA1/H/NGO/5098,10/18/2017 8:35:06 AM,People in Host Communities,700,1200,1120,1430,4450,19921,14861,7033,6234,48049
19,South Sudan (UNDP),2017,SSD-17/HSS10/SA1/H/NGO/5098,10/18/2017 8:35:06 AM,Pregnant and Lactating Women,0,480,0,0,480,0,796,0,0,796
19,South Sudan (UNDP),2017,SSD-17/HSS10/SA1/H/NGO/5107,12/20/2017 8:36:58 AM,Internally Displaced People,1396,1638,2048,2552,7634,2152,2127,2017,2099,8395
19,South Sudan (UNDP),2017,SSD-17/HSS10/SA1/H/NGO/5107,12/20/2017 8:36:58 AM,Overall,13955,17645,3696,4704,40000,10761,11201,10085,10497,42544
19,South Sudan (UNDP),2017,SSD-17/HSS10/SA1/H/NGO/5107,12/20/2017 8:36:58 AM,People in Host Communities,12559,14743,1648,2152,31102,8609,8691,8068,8398,33766
19,South Sudan (UNDP),2017,SSD-17/HSS10/SA1/H/NGO/5107,12/20/2017 8:36:58 AM,Pregnant and Lactating Women,0,1264,0,0,1264,0,336,0,0,336
19,South Sudan (UNDP),2017,SSD-17/HSS10/SA1/H/NGO/5125,12/13/2017 9:10:52 AM,Children under 5,0,0,351,446,797,0,0,285,392,677
19,South Sudan (UNDP),2017,SSD-17/HSS10/SA1/H/NGO/5125,12/13/2017 9:10:52 AM,Internally Displaced People,430,440,400,414,1684,390,410,374,398,1572
19,South Sudan (UNDP),2017,SSD-17/HSS10/SA1/H/NGO/5125,12/13/2017 9:10:52 AM,Overall,780,890,1003,1120,3793,678,725,896,937,3236
19,South Sudan (UNDP),2017,SSD-17/HSS10/SA1/H/NGO/5125,12/13/2017 9:10:52 AM,People in Host Communities,350,300,252,260,1162,288,259,208,218,973
19,South Sudan (UNDP),2017,SSD-17/HSS10/SA1/H/NGO/5125,12/13/2017 9:10:52 AM,Pregnant and Lactating Women,0,150,0,0,150,0,57,0,0,57
19,South Sudan (UNDP),2017,SSD-17/HSS10/SA1/H/NGO/5157,12/20/2017 7:53:10 AM,Children under 5,0,0,1534,1700,3234,0,0,1647,2100,3747
19,South Sudan (UNDP),2017,SSD-17/HSS10/SA1/H/NGO/5157,12/20/2017 7:53:10 AM,Internally Displaced People,1822,2773,0,0,4595,2241,3144,1200,1250,7835
19,South Sudan (UNDP),2017,SSD-17/HSS10/SA1/H/NGO/5157,12/20/2017 7:53:10 AM,Overall,4556,6883,1534,1700,14673,4975,7574,1647,2100,16296
19,South Sudan (UNDP),2017,SSD-17/HSS10/SA1/H/NGO/5157,12/20/2017 7:53:10 AM,People in Host Communities,2734,3860,0,0,6594,2734,4430,447,850,8461
19,South Sudan (UNDP),2017,SSD-17/HSS10/SA1/H/NGO/5157,12/20/2017 7:53:10 AM,Pregnant and Lactating Women,0,250,0,0,250,0,360,0,0,360
19,South Sudan (UNDP),2017,SSD-17/HSS10/SA1/H/NGO/5180,12/13/2017 9:12:46 AM,Other,445,752,922,788,2907,0,0,0,0,0
19,South Sudan (UNDP),2017,SSD-17/HSS10/SA1/H/NGO/5180,12/13/2017 9:12:46 AM,Overall,962,1974,2371,2182,7489,878,1770,2270,1438,6356
19,South Sudan (UNDP),2017,SSD-17/HSS10/SA1/H/NGO/5180,12/13/2017 9:12:46 AM,People in Host Communities,517,1222,1449,1394,4582,0,0,0,0,0
19,South Sudan (UNDP),2017,SSD-17/HSS10/SA1/H/NGO/5191,2/28/2018 7:14:35 AM,Internally Displaced People,110,200,400,309,1019,792,3041,3494,4005,11332
19,South Sudan (UNDP),2017,SSD-17/HSS10/SA1/H/NGO/5191,2/28/2018 7:14:35 AM,Overall,500,1631,2100,2291,6522,1186,4160,4577,4992,14915
19,South Sudan (UNDP),2017,SSD-17/HSS10/SA1/H/NGO/5191,2/28/2018 7:14:35 AM,People in Host Communities,390,1431,1700,1982,5503,394,1119,1083,987,3583
19,South Sudan (UNDP),2017,SSD-17/HSS10/SA1/H/NGO/5261,2/15/2018 8:28:58 AM,Overall,9258,5401,8545,13885,37089,8760,5210,8320,13010,35300
19,South Sudan (UNDP),2017,SSD-17/HSS10/SA1/H/NGO/5261,2/15/2018 8:28:58 AM,People in Host Communities,9258,5401,8545,13885,37089,8760,5210,8320,13010,35300
19,South Sudan (UNDP),2017,SSD-17/HSS10/SA1/H/NGO/5262,2/14/2018 3:05:48 PM,Children under 5,0,0,501,797,1298,0,0,670,825,1495
19,South Sudan (UNDP),2017,SSD-17/HSS10/SA1/H/NGO/5262,2/14/2018 3:05:48 PM,Internally Displaced People,448,2296,890,1473,5107,936,2451,912,1479,5778
19,South Sudan (UNDP),2017,SSD-17/HSS10/SA1/H/NGO/5262,2/14/2018 3:05:48 PM,Overall,1025,2933,1827,3793,9578,1609,3455,2150,3888,11102
19,South Sudan (UNDP),2017,SSD-17/HSS10/SA1/H/NGO/5262,2/14/2018 3:05:48 PM,People in Host Communities,577,637,436,1523,3173,673,1004,568,1584,3829
19,South Sudan (UNDP),2017,SSD-17/HSS10/SA1/H/UN/5093,12/4/2017 5:11:56 PM,Children under 5,0,0,3801,3957,7758,0,0,3801,939,4740
19,South Sudan (UNDP),2017,SSD-17/HSS10/SA1/H/UN/5093,12/4/2017 5:11:56 PM,Internally Displaced People,8838,11704,2317,1822,24681,5619,9567,4787,4529,24502
19,South Sudan (UNDP),2017,SSD-17/HSS10/SA1/H/UN/5093,12/4/2017 5:11:56 PM,Overall,10086,15128,6982,6595,38791,5619,9567,4787,4529,24502
19,South Sudan (UNDP),2017,SSD-17/HSS10/SA1/H/UN/5093,12/4/2017 5:11:56 PM,People in Host Communities,1248,1872,864,816,4800,1301,1409,867,6263,9840
19,South Sudan (UNDP),2017,SSD-17/HSS10/SA1/H/UN/5093,12/4/2017 5:11:56 PM,Pregnant and Lactating Women,0,1552,0,0,1552,0,5121,0,0,5121
19,South Sudan (UNDP),2017,SSD-17/HSS10/SA1/H/UN/5190,7/26/2018 5:41:01 AM,Internally Displaced People,8073,8746,7756,8403,32978,379,5036,15370,16330,37115
19,South Sudan (UNDP),2017,SSD-17/HSS10/SA1/H/UN/5190,7/26/2018 5:41:01 AM,Overall,11533,12494,11081,12004,47112,572,8498,22481,23309,54860
19,South Sudan (UNDP),2017,SSD-17/HSS10/SA1/H/UN/5190,7/26/2018 5:41:01 AM,People in Host Communities,3460,3748,3325,3601,14134,193,3462,7111,6979,17745
19,South Sudan (UNDP),2017,SSD-17/HSS10/SA1/H/UN/5232,2/6/2018 12:57:51 PM,Children under 5,0,0,3675,3825,7500,0,0,41908,52731,94639
19,South Sudan (UNDP),2017,SSD-17/HSS10/SA1/H/UN/5232,2/6/2018 12:57:51 PM,Internally Displaced People,48693,40723,0,0,89416,29471,37284,0,0,66755
19,South Sudan (UNDP),2017,SSD-17/HSS10/SA1/H/UN/5232,2/6/2018 12:57:51 PM,Overall,48693,45936,3675,3825,102129,29471,37284,41908,52731,161394
19,South Sudan (UNDP),2017,SSD-17/HSS10/SA1/H/UN/5232,2/6/2018 12:57:51 PM,Pregnant and Lactating Women,0,5213,0,0,5213,0,0,0,0,0
19,South Sudan (UNDP),2017,SSD-17/HSS10/SA1/L/UN/5061,10/2/2017 12:02:34 PM,Aid Agencies,240,0,0,0,240,272,0,0,0,272
19,South Sudan (UNDP),2017,SSD-17/HSS10/SA1/L/UN/5061,10/2/2017 12:02:34 PM,Overall,240,0,0,0,240,0,0,0,0,0
19,South Sudan (UNDP),2017,SSD-17/HSS10/SA1/L/UN/5087,7/11/2017 12:46:13 PM,Overall,40,0,0,0,40,20,0,0,0,20
19,South Sudan (UNDP),2017,SSD-17/HSS10/SA1/L/UN/5108,11/14/2017 9:14:19 AM,Aid Agencies,40,40,0,0,80,0,0,0,89,89
19,South Sudan (UNDP),2017,SSD-17/HSS10/SA1/L/UN/5108,11/14/2017 9:14:19 AM,Overall,40,40,0,0,80,0,0,0,89,89
19,South Sudan (UNDP),2017,SSD-17/HSS10/SA1/L/UN/5559,5/3/2018 6:11:41 AM,Overall,240,0,0,0,240,274,0,0,0,274
19,South Sudan (UNDP),2017,SSD-17/HSS10/SA1/N/INGO/5076,2/12/2018 8:35:47 AM,Children under 5,0,0,8199,8533,16732,0,0,5037,5185,10222
19,South Sudan (UNDP),2017,SSD-17/HSS10/SA1/N/INGO/5076,2/12/2018 8:35:47 AM,Overall,0,2152,8199,8533,18884,0,6307,3536,3966,13809
19,South Sudan (UNDP),2017,SSD-17/HSS10/SA1/N/INGO/5076,2/12/2018 8:35:47 AM,Pregnant and Lactating Women,0,2152,0,0,2152,0,6307,0,0,6307
19,South Sudan (UNDP),2017,SSD-17/HSS10/SA1/N/INGO/5090,2/12/2018 9:05:36 AM,Children under 5,0,0,5373,5970,11343,0,0,665,657,1322
19,South Sudan (UNDP),2017,SSD-17/HSS10/SA1/N/INGO/5090,2/12/2018 9:05:36 AM,Overall,0,2624,5373,5970,13967,0,1323,665,657,2645
19,South Sudan (UNDP),2017,SSD-17/HSS10/SA1/N/INGO/5090,2/12/2018 9:05:36 AM,Pregnant and Lactating Women,0,2624,0,0,2624,0,1323,0,0,1323
19,South Sudan (UNDP),2017,SSD-17/HSS10/SA1/N/INGO/5104,1/17/2018 7:43:08 AM,Children under 5,0,0,2955,4350,7305,5,0,0,0,5
19,South Sudan (UNDP),2017,SSD-17/HSS10/SA1/N/INGO/5104,1/17/2018 7:43:08 AM,Internally Displaced People,5,0,0,0,5,0,0,0,0,0
19,South Sudan (UNDP),2017,SSD-17/HSS10/SA1/N/INGO/5104,1/17/2018 7:43:08 AM,Overall,8,3070,3990,5742,12810,8,3070,3990,5742,12810
19,South Sudan (UNDP),2017,SSD-17/HSS10/SA1/N/INGO/5104,1/17/2018 7:43:08 AM,People in Host Communities,3,0,0,0,3,3,0,3990,5742,9735
19,South Sudan (UNDP),2017,SSD-17/HSS10/SA1/N/INGO/5104,1/17/2018 7:43:08 AM,Pregnant and Lactating Women,0,2275,0,0,2275,0,3070,0,0,3070
19,South Sudan (UNDP),2017,SSD-17/HSS10/SA1/N/INGO/5119,2/13/2018 12:48:36 PM,Children under 5,0,0,8391,8734,17125,0,0,10604,8267,18871
19,South Sudan (UNDP),2017,SSD-17/HSS10/SA1/N/INGO/5119,2/13/2018 12:48:36 PM,Overall,0,7897,8391,8734,25022,0,6117,10604,8267,24988
19,South Sudan (UNDP),2017,SSD-17/HSS10/SA1/N/INGO/5119,2/13/2018 12:48:36 PM,Pregnant and Lactating Women,0,7897,0,0,7897,0,6117,0,0,6117
19,South Sudan (UNDP),2017,SSD-17/HSS10/SA1/N/INGO/5266,1/16/2018 9:08:52 AM,Children under 5,0,0,3435,3709,7144,0,0,2472,2777,5249
19,South Sudan (UNDP),2017,SSD-17/HSS10/SA1/N/INGO/5266,1/16/2018 9:08:52 AM,Internally Displaced People,42,386,0,0,428,32,238,0,0,270
19,South Sudan (UNDP),2017,SSD-17/HSS10/SA1/N/INGO/5266,1/16/2018 9:08:52 AM,Overall,602,7824,3435,3709,15570,1059,7946,2472,2777,14254
19,South Sudan (UNDP),2017,SSD-17/HSS10/SA1/N/INGO/5266,1/16/2018 9:08:52 AM,People in Host Communities,560,5125,0,0,5685,1027,6391,0,0,7418
19,South Sudan (UNDP),2017,SSD-17/HSS10/SA1/N/INGO/5266,1/16/2018 9:08:52 AM,Pregnant and Lactating Women,0,2313,0,0,2313,0,1317,0,0,1317
19,South Sudan (UNDP),2017,SSD-17/HSS10/SA1/N/INGO/5268,2/14/2018 12:29:57 PM,Children under 5,0,0,8428,8772,17200,0,0,9270,9210,18480
19,South Sudan (UNDP),2017,SSD-17/HSS10/SA1/N/INGO/5268,2/14/2018 12:29:57 PM,Internally Displaced People,150,0,0,0,150,0,2048,2781,2763,7592
19,South Sudan (UNDP),2017,SSD-17/HSS10/SA1/N/INGO/5268,2/14/2018 12:29:57 PM,Overall,370,6937,8428,8772,24507,136,6827,9270,9210,25443
19,South Sudan (UNDP),2017,SSD-17/HSS10/SA1/N/INGO/5268,2/14/2018 12:29:57 PM,People in Host Communities,220,0,0,0,220,136,4779,6489,6447,17851
19,South Sudan (UNDP),2017,SSD-17/HSS10/SA1/N/INGO/5268,2/14/2018 12:29:57 PM,Pregnant and Lactating Women,0,6937,0,0,6937,0,6827,0,0,6827
19,South Sudan (UNDP),2017,SSD-17/HSS10/SA1/N/INGO/5276,4/4/2018 12:52:10 PM,Children under 5,0,0,9781,10928,20709,0,0,11064,12728,23792
19,South Sudan (UNDP),2017,SSD-17/HSS10/SA1/N/INGO/5276,4/4/2018 12:52:10 PM,Internally Displaced People,350,1225,0,0,1575,330,3225,0,0,3555
19,South Sudan (UNDP),2017,SSD-17/HSS10/SA1/N/INGO/5276,4/4/2018 12:52:10 PM,Overall,1000,5000,9781,10928,26709,942,11469,11064,12728,36203
19,South Sudan (UNDP),2017,SSD-17/HSS10/SA1/N/INGO/5276,4/4/2018 12:52:10 PM,People in Host Communities,650,2183,0,0,2833,612,5747,0,0,6359
19,South Sudan (UNDP),2017,SSD-17/HSS10/SA1/N/INGO/5276,4/4/2018 12:52:10 PM,Pregnant and Lactating Women,0,1592,0,0,1592,0,2497,0,0,2497
19,South Sudan (UNDP),2017,SSD-17/HSS10/SA1/N/NGO/5121,3/22/2018 11:56:09 AM,Children under 5,0,0,3200,3500,6700,0,0,2750,3082,5832
19,South Sudan (UNDP),2017,SSD-17/HSS10/SA1/N/NGO/5121,3/22/2018 11:56:09 AM,Internally Displaced People,2000,2450,2023,2873,9346,1900,2500,2748,3082,10230
19,South Sudan (UNDP),2017,SSD-17/HSS10/SA1/N/NGO/5121,3/22/2018 11:56:09 AM,Overall,3901,4900,8246,9246,26293,3901,4900,8246,9246,26293
19,South Sudan (UNDP),2017,SSD-17/HSS10/SA1/N/NGO/5121,3/22/2018 11:56:09 AM,People in Host Communities,1700,2450,3023,2873,10046,1901,2500,2748,3082,10231
19,South Sudan (UNDP),2017,SSD-17/HSS10/SA1/N/NGO/5155,2/12/2018 7:19:21 AM,Children under 5,0,0,3922,3512,7434,0,0,3044,2874,5918
19,South Sudan (UNDP),2017,SSD-17/HSS10/SA1/N/NGO/5155,2/12/2018 7:19:21 AM,Overall,0,3382,3922,3512,10816,0,3753,3044,2874,9671
19,South Sudan (UNDP),2017,SSD-17/HSS10/SA1/N/NGO/5155,2/12/2018 7:19:21 AM,Pregnant and Lactating Women,0,3382,0,0,3382,0,3182,0,0,3182
19,South Sudan (UNDP),2017,SSD-17/HSS10/SA1/N/NGO/5177,1/17/2018 1:26:29 PM,Children under 5,0,0,2000,2000,4000,0,0,3009,2974,5983
19,South Sudan (UNDP),2017,SSD-17/HSS10/SA1/N/NGO/5177,1/17/2018 1:26:29 PM,Internally Displaced People,200,0,0,0,200,28,0,0,0,28
19,South Sudan (UNDP),2017,SSD-17/HSS10/SA1/N/NGO/5177,1/17/2018 1:26:29 PM,Overall,600,3000,2000,2000,7600,168,2133,3009,2974,8284
19,South Sudan (UNDP),2017,SSD-17/HSS10/SA1/N/NGO/5177,1/17/2018 1:26:29 PM,People in Host Communities,400,0,0,0,400,150,0,0,0,150
19,South Sudan (UNDP),2017,SSD-17/HSS10/SA1/N/NGO/5177,1/17/2018 1:26:29 PM,Pregnant and Lactating Women,0,3000,0,0,3000,0,3123,0,0,3123
19,South Sudan (UNDP),2017,SSD-17/HSS10/SA1/N/UN/5173,7/26/2018 5:50:41 AM,Children under 5,0,0,1191,1239,2430,0,0,1228,1378,2606
19,South Sudan (UNDP),2017,SSD-17/HSS10/SA1/N/UN/5173,7/26/2018 5:50:41 AM,Overall,0,97300,1191,1239,99730,0,106542,1250,1301,109093
19,South Sudan (UNDP),2017,SSD-17/HSS10/SA1/N/UN/5173,7/26/2018 5:50:41 AM,Pregnant and Lactating Women,0,97300,0,0,97300,0,106543,0,0,106543
19,South Sudan (UNDP),2017,SSD-17/HSS10/SA1/N/UN/5283,6/18/2018 6:57:28 AM,Children under 5,0,0,19600,20400,40000,0,0,7952,8336,16288
19,South Sudan (UNDP),2017,SSD-17/HSS10/SA1/N/UN/5283,6/18/2018 6:57:28 AM,Overall,0,4000,19600,20400,44000,0,6544,7952,8336,22832
19,South Sudan (UNDP),2017,SSD-17/HSS10/SA1/N/UN/5283,6/18/2018 6:57:28 AM,Pregnant and Lactating Women,0,4000,0,0,4000,0,6544,0,0,6544
19,South Sudan (UNDP),2017,SSD-17/HSS10/SA1/NFI/INGO/5138,5/24/2018 12:56:21 PM,Internally Displaced People,9602,11305,19219,19961,60087,9807,13023,11992,13351,48173
19,South Sudan (UNDP),2017,SSD-17/HSS10/SA1/NFI/INGO/5138,5/24/2018 12:56:21 PM,Overall,9602,11305,19219,19961,60087,15901,18662,15467,17671,67701
19,South Sudan (UNDP),2017,SSD-17/HSS10/SA1/NFI/INGO/5223,2/12/2018 1:40:03 PM,Internally Displaced People,8225,9090,7867,8818,34000,9533,11058,13885,14739,49215
19,South Sudan (UNDP),2017,SSD-17/HSS10/SA1/NFI/INGO/5223,2/12/2018 1:40:03 PM,Other,960,1040,960,1040,4000,0,0,0,0,0
19,South Sudan (UNDP),2017,SSD-17/HSS10/SA1/NFI/INGO/5223,2/12/2018 1:40:03 PM,Overall,10145,11170,9787,10898,42000,9566,11096,13927,14784,49373
19,South Sudan (UNDP),2017,SSD-17/HSS10/SA1/NFI/INGO/5223,2/12/2018 1:40:03 PM,People in Host Communities,960,1040,960,1040,4000,33,38,42,45,158
19,South Sudan (UNDP),2017,SSD-17/HSS10/SA1/NFI/INGO/5238,6/5/2018 5:39:57 AM,Internally Displaced People,14147,13659,10732,10244,48782,16463,18224,19394,22150,76231
19,South Sudan (UNDP),2017,SSD-17/HSS10/SA1/NFI/INGO/5238,6/5/2018 5:39:57 AM,Overall,14147,13659,10732,10244,48782,16463,18224,19394,22150,76231
19,South Sudan (UNDP),2017,SSD-17/HSS10/SA1/NFI/INGO/5260,3/12/2019 12:13:09 PM,Internally Displaced People,0,0,0,0,0,1300,1645,1897,1121,5963
19,South Sudan (UNDP),2017,SSD-17/HSS10/SA1/NFI/INGO/5260,3/12/2019 12:13:09 PM,Overall,3700,3700,3800,3800,15000,2004,2307,2674,1967,8952
19,South Sudan (UNDP),2017,SSD-17/HSS10/SA1/NFI/INGO/5260,3/12/2019 12:13:09 PM,People in Host Communities,3700,3700,3800,3800,15000,704,662,777,846,2989
19,South Sudan (UNDP),2017,SSD-17/HSS10/SA1/NFI/NGO/5058,11/9/2017 12:48:31 PM,Internally Displaced People,7200,10800,4800,7200,30000,5236,6458,0,0,11694
19,South Sudan (UNDP),2017,SSD-17/HSS10/SA1/NFI/NGO/5058,11/9/2017 12:48:31 PM,Overall,7200,10800,4800,7200,30000,5236,6458,0,0,11694
19,South Sudan (UNDP),2017,SSD-17/HSS10/SA1/NFI/NGO/5184,5/28/2018 8:51:31 AM,Internally Displaced People,1077,1120,710,833,3740,582,849,1358,1981,4770
19,South Sudan (UNDP),2017,SSD-17/HSS10/SA1/NFI/NGO/5184,5/28/2018 8:51:31 AM,Overall,1395,1447,1005,1153,5000,832,1213,1940,2830,6815
19,South Sudan (UNDP),2017,SSD-17/HSS10/SA1/NFI/NGO/5184,5/28/2018 8:51:31 AM,People in Host Communities,298,302,280,300,1180,208,303,485,708,1704
19,South Sudan (UNDP),2017,SSD-17/HSS10/SA1/NFI/NGO/5184,5/28/2018 8:51:31 AM,Refugee Returnees,20,25,15,20,80,42,61,97,141,341
19,South Sudan (UNDP),2017,SSD-17/HSS10/SA1/NFI/NGO/5224,3/29/2018 11:24:37 AM,Internally Displaced People,3349,4816,2218,4121,14504,2574,3196,3724,3861,13355
19,South Sudan (UNDP),2017,SSD-17/HSS10/SA1/NFI/NGO/5224,3/29/2018 11:24:37 AM,Overall,4632,6588,3118,5662,20000,3511,3793,4446,4937,16687
19,South Sudan (UNDP),2017,SSD-17/HSS10/SA1/NFI/NGO/5224,3/29/2018 11:24:37 AM,People in Host Communities,1283,1772,900,1541,5496,937,597,722,1076,3332
19,South Sudan (UNDP),2017,SSD-17/HSS10/SA1/P/INGO/5086,2/9/2018 11:41:27 AM,Internally Displaced People,480,640,960,1120,3200,591,799,1226,1471,4087
19,South Sudan (UNDP),2017,SSD-17/HSS10/SA1/P/INGO/5086,2/9/2018 11:41:27 AM,Overall,1200,1600,2400,2800,8000,2058,4761,4769,4683,16271
19,South Sudan (UNDP),2017,SSD-17/HSS10/SA1/P/INGO/5086,2/9/2018 11:41:27 AM,People in Host Communities,720,960,1440,1680,4800,1467,3962,3543,3212,12184
19,South Sudan (UNDP),2017,SSD-17/HSS10/SA1/P/INGO/5096,2/14/2018 9:43:09 AM,Aid Agencies,13,10,0,0,23,22,16,0,0,38
19,South Sudan (UNDP),2017,SSD-17/HSS10/SA1/P/INGO/5096,2/14/2018 9:43:09 AM,Internally Displaced People,100,50,1575,1575,3300,896,1099,1883,1911,5789
19,South Sudan (UNDP),2017,SSD-17/HSS10/SA1/P/INGO/5096,2/14/2018 9:43:09 AM,Overall,113,60,1575,1575,3323,918,1115,1883,1911,5827
19,South Sudan (UNDP),2017,SSD-17/HSS10/SA1/P/INGO/5122,1/10/2018 7:50:17 AM,Internally Displaced People,660,960,1419,1904,4943,1937,1419,1600,2656,7612
19,South Sudan (UNDP),2017,SSD-17/HSS10/SA1/P/INGO/5122,1/10/2018 7:50:17 AM,Overall,1100,1600,2366,3174,8240,3292,2405,2843,4619,13159
19,South Sudan (UNDP),2017,SSD-17/HSS10/SA1/P/INGO/5122,1/10/2018 7:50:17 AM,People in Host Communities,440,640,947,1270,3297,1355,986,1243,1963,5547
19,South Sudan (UNDP),2017,SSD-17/HSS10/SA1/P/INGO/5147,2/12/2018 6:02:57 AM,Internally Displaced People,770,6560,481,1332,9143,45,591,75,436,1147
19,South Sudan (UNDP),2017,SSD-17/HSS10/SA1/P/INGO/5147,2/12/2018 6:02:57 AM,Overall,1282,10933,801,2220,15236,226,2957,376,2178,5737
19,South Sudan (UNDP),2017,SSD-17/HSS10/SA1/P/INGO/5147,2/12/2018 6:02:57 AM,People in Host Communities,512,4373,320,888,6093,181,2366,301,1742,4590
19,South Sudan (UNDP),2017,SSD-17/HSS10/SA1/P/INGO/5235,4/9/2018 7:45:08 AM,Internally Displaced People,167,368,542,732,1809,735,1383,546,921,3585
19,South Sudan (UNDP),2017,SSD-17/HSS10/SA1/P/INGO/5235,4/9/2018 7:45:08 AM,Overall,742,1484,2226,2968,7420,3098,5796,2218,3724,14836
19,South Sudan (UNDP),2017,SSD-17/HSS10/SA1/P/INGO/5235,4/9/2018 7:45:08 AM,People in Host Communities,501,1105,1624,2196,5426,2199,4149,1636,2762,10746
19,South Sudan (UNDP),2017,SSD-17/HSS10/SA1/P/INGO/5235,4/9/2018 7:45:08 AM,"Trainers, Promoters, Caretakers, committee members, etc.",74,11,60,40,185,164,264,36,41,505
19,South Sudan (UNDP),2017,SSD-17/HSS10/SA1/P/NGO/5064,2/5/2018 9:14:13 AM,Internally Displaced People,400,800,1500,1500,4200,389,732,1490,1489,4100
19,South Sudan (UNDP),2017,SSD-17/HSS10/SA1/P/NGO/5064,2/5/2018 9:14:13 AM,Overall,1000,1500,3000,3000,8500,986,1467,2876,2688,8017
19,South Sudan (UNDP),2017,SSD-17/HSS10/SA1/P/NGO/5064,2/5/2018 9:14:13 AM,People in Host Communities,500,600,1400,1400,3900,465,564,1226,1310,3565
19,South Sudan (UNDP),2017,SSD-17/HSS10/SA1/P/NGO/5064,2/5/2018 9:14:13 AM,"Trainers, Promoters, Caretakers, committee members, etc.",100,100,100,100,400,87,86,92,87,352
19,South Sudan (UNDP),2017,SSD-17/HSS10/SA1/P/NGO/5137,1/15/2018 6:29:23 PM,Internally Displaced People,65,75,1900,1900,3940,756,1693,2302,2895,7646
19,South Sudan (UNDP),2017,SSD-17/HSS10/SA1/P/NGO/5137,1/15/2018 6:29:23 PM,Overall,65,75,1900,1900,3940,756,1693,2302,2895,7646
19,South Sudan (UNDP),2017,SSD-17/HSS10/SA1/P/NGO/5206,1/17/2018 1:53:33 PM,Internally Displaced People,700,800,345,445,2290,715,1010,600,782,3107
19,South Sudan (UNDP),2017,SSD-17/HSS10/SA1/P/NGO/5206,1/17/2018 1:53:33 PM,Other,250,260,0,0,510,320,421,0,0,741
19,South Sudan (UNDP),2017,SSD-17/HSS10/SA1/P/NGO/5206,1/17/2018 1:53:33 PM,Overall,1350,1870,350,450,4020,1560,2430,609,789,5388
19,South Sudan (UNDP),2017,SSD-17/HSS10/SA1/P/NGO/5206,1/17/2018 1:53:33 PM,People in Host Communities,380,800,0,0,1180,490,980,0,0,1470
19,South Sudan (UNDP),2017,SSD-17/HSS10/SA1/P/NGO/5206,1/17/2018 1:53:33 PM,"Trainers, Promoters, Caretakers, committee members, etc.",20,10,5,5,40,35,19,9,7,70
19,South Sudan (UNDP),2017,SSD-17/HSS10/SA1/P/UN/5236,2/6/2018 1:10:55 PM,Internally Displaced People,50,150,2300,2750,5250,50,150,18901,11335,30436
19,South Sudan (UNDP),2017,SSD-17/HSS10/SA1/P/UN/5236,2/6/2018 1:10:55 PM,Overall,100,250,2300,2750,5400,100,250,18901,11335,30586
19,South Sudan (UNDP),2017,SSD-17/HSS10/SA1/P/UN/5236,2/6/2018 1:10:55 PM,People in Host Communities,50,100,0,0,150,50,100,0,0,150
19,South Sudan (UNDP),2017,SSD-17/HSS10/SA1/WASH/INGO/5063,2/13/2018 1:19:55 PM,Internally Displaced People,1196,1248,80,138,2662,575,798,293,405,2071
19,South Sudan (UNDP),2017,SSD-17/HSS10/SA1/WASH/INGO/5063,2/13/2018 1:19:55 PM,Overall,12217,13235,5236,5672,36360,8220,11402,4183,5794,29599
19,South Sudan (UNDP),2017,SSD-17/HSS10/SA1/WASH/INGO/5063,2/13/2018 1:19:55 PM,People in Host Communities,10384,11249,4450,4821,30904,7398,10262,3765,5215,26640
19,South Sudan (UNDP),2017,SSD-17/HSS10/SA1/WASH/INGO/5063,2/13/2018 1:19:55 PM,Refugee Returnees,637,738,706,713,2794,247,342,125,174,888
19,South Sudan (UNDP),2017,SSD-17/HSS10/SA1/WASH/INGO/5132,2/9/2018 1:46:16 PM,Overall,10000,12000,23500,24500,70000,9980,13313,22795,23133,69221
19,South Sudan (UNDP),2017,SSD-17/HSS10/SA1/WASH/INGO/5156,2/9/2018 6:01:02 PM,Internally Displaced People,2400,3520,2500,4780,13200,2679,3846,2762,5023,14310
19,South Sudan (UNDP),2017,SSD-17/HSS10/SA1/WASH/INGO/5156,2/9/2018 6:01:02 PM,Overall,6020,8800,6240,11840,32900,6697,9616,6906,12558,35777
19,South Sudan (UNDP),2017,SSD-17/HSS10/SA1/WASH/INGO/5156,2/9/2018 6:01:02 PM,People in Host Communities,3620,5280,3740,7060,19700,4018,5770,4144,7535,21467
19,South Sudan (UNDP),2017,SSD-17/HSS10/SA1/WASH/INGO/5203,2/27/2018 8:29:29 AM,Internally Displaced People,728,757,1477,1537,4499,670,680,1477,1500,4327
19,South Sudan (UNDP),2017,SSD-17/HSS10/SA1/WASH/INGO/5203,2/27/2018 8:29:29 AM,Overall,1455,1515,2955,3075,9000,1170,1380,2600,2650,7800
19,South Sudan (UNDP),2017,SSD-17/HSS10/SA1/WASH/INGO/5203,2/27/2018 8:29:29 AM,People in Host Communities,727,758,1478,1538,4501,500,700,1123,1150,3473
19,South Sudan (UNDP),2017,SSD-17/HSS10/SA1/WASH/INGO/5216,2/15/2018 9:52:15 AM,Children under 5,0,0,840,1400,2240,0,0,927,1545,2472
19,South Sudan (UNDP),2017,SSD-17/HSS10/SA1/WASH/INGO/5216,2/15/2018 9:52:15 AM,Internally Displaced People,700,882,336,560,2478,772,973,372,618,2735
19,South Sudan (UNDP),2017,SSD-17/HSS10/SA1/WASH/INGO/5216,2/15/2018 9:52:15 AM,Overall,7000,9800,4200,7000,28000,11301,11565,3739,4335,30940
19,South Sudan (UNDP),2017,SSD-17/HSS10/SA1/WASH/INGO/5216,2/15/2018 9:52:15 AM,People in Host Communities,6300,7938,3024,5040,22302,6953,8763,3335,5562,24613
19,South Sudan (UNDP),2017,SSD-17/HSS10/SA1/WASH/INGO/5216,2/15/2018 9:52:15 AM,Pregnant and Lactating Women,0,980,0,0,980,0,1082,0,0,1082
19,South Sudan (UNDP),2017,SSD-17/HSS10/SA1/WASH/INGO/5233,1/2/2018 8:52:26 AM,Children under 5,0,0,1143,1646,2789,0,0,1854,1516,3370
19,South Sudan (UNDP),2017,SSD-17/HSS10/SA1/WASH/INGO/5233,1/2/2018 8:52:26 AM,Internally Displaced People,1171,1397,991,946,4505,996,1549,1908,965,5418
19,South Sudan (UNDP),2017,SSD-17/HSS10/SA1/WASH/INGO/5233,1/2/2018 8:52:26 AM,Overall,4629,5951,5060,5385,21025,4297,6531,5886,5299,22013
19,South Sudan (UNDP),2017,SSD-17/HSS10/SA1/WASH/INGO/5233,1/2/2018 8:52:26 AM,People in Host Communities,3458,4125,2926,2793,13302,3301,4587,2124,2818,12830
19,South Sudan (UNDP),2017,SSD-17/HSS10/SA1/WASH/INGO/5233,1/2/2018 8:52:26 AM,Pregnant and Lactating Women,0,429,0,0,429,0,395,0,0,395
19,South Sudan (UNDP),2017,SSD-17/HSS10/SA1/WASH/INGO/5234,5/28/2018 4:26:30 PM,Children under 5,0,0,1145,1168,2313,632,881,1332,1379,4224
19,South Sudan (UNDP),2017,SSD-17/HSS10/SA1/WASH/INGO/5234,5/28/2018 4:26:30 PM,Internally Displaced People,3137,3035,5040,5140,16352,993,1196,2005,2338,6532
19,South Sudan (UNDP),2017,SSD-17/HSS10/SA1/WASH/INGO/5234,5/28/2018 4:26:30 PM,Overall,4091,4150,7329,7430,23000,3752,4787,7626,8444,24609
19,South Sudan (UNDP),2017,SSD-17/HSS10/SA1/WASH/INGO/5234,5/28/2018 4:26:30 PM,People in Host Communities,954,838,1144,1122,4058,2127,2710,4289,4727,13853
19,South Sudan (UNDP),2017,SSD-17/HSS10/SA1/WASH/INGO/5234,5/28/2018 4:26:30 PM,Pregnant and Lactating Women,0,277,0,0,277,0,0,0,0,0
19,South Sudan (UNDP),2017,SSD-17/HSS10/SA1/WASH/INGO/5253,2/12/2018 10:58:00 AM,Internally Displaced People,2650,2550,2620,2650,10470,3550,4450,3180,3350,14530
19,South Sudan (UNDP),2017,SSD-17/HSS10/SA1/WASH/INGO/5253,2/12/2018 10:58:00 AM,Overall,3100,3500,2900,3000,12500,3100,3500,2900,3000,12500
19,South Sudan (UNDP),2017,SSD-17/HSS10/SA1/WASH/INGO/5253,2/12/2018 10:58:00 AM,People in Host Communities,450,950,280,350,2030,450,950,280,350,2030
19,South Sudan (UNDP),2017,SSD-17/HSS10/SA1/WASH/INGO/5253,2/12/2018 10:58:00 AM,"Trainers, Promoters, Caretakers, committee members, etc.",0,0,0,0,0,25,10,0,0,35
19,South Sudan (UNDP),2017,SSD-17/HSS10/SA1/WASH/NGO/5056,1/2/2018 8:29:31 AM,Children under 5,0,0,500,800,1300,0,0,500,800,1300
19,South Sudan (UNDP),2017,SSD-17/HSS10/SA1/WASH/NGO/5056,1/2/2018 8:29:31 AM,Internally Displaced People,2000,3000,3500,4000,12500,2200,3900,4200,4400,14700
19,South Sudan (UNDP),2017,SSD-17/HSS10/SA1/WASH/NGO/5056,1/2/2018 8:29:31 AM,Overall,3000,6000,5000,7000,21000,3200,7000,5700,7500,23400
19,South Sudan (UNDP),2017,SSD-17/HSS10/SA1/WASH/NGO/5056,1/2/2018 8:29:31 AM,People in Host Communities,1000,2000,1000,2200,6200,1000,2400,1000,2300,6700
19,South Sudan (UNDP),2017,SSD-17/HSS10/SA1/WASH/NGO/5056,1/2/2018 8:29:31 AM,Pregnant and Lactating Women,0,1000,0,0,1000,0,700,0,0,700
19,South Sudan (UNDP),2017,SSD-17/HSS10/SA1/WASH/NGO/5059,1/15/2018 10:48:24 AM,Internally Displaced People,500,1000,400,800,2700,988,1300,800,1200,4288
19,South Sudan (UNDP),2017,SSD-17/HSS10/SA1/WASH/NGO/5059,1/15/2018 10:48:24 AM,Overall,900,1600,800,1200,4500,1744,2000,1482,1709,6935
19,South Sudan (UNDP),2017,SSD-17/HSS10/SA1/WASH/NGO/5059,1/15/2018 10:48:24 AM,People in Host Communities,400,600,400,400,1800,756,700,682,500,2638
19,South Sudan (UNDP),2017,SSD-17/HSS10/SA1/WASH/NGO/5065,2/8/2018 8:04:47 AM,Internally Displaced People,1126,1600,2200,2176,7102,1178,1751,2674,2611,8214
19,South Sudan (UNDP),2017,SSD-17/HSS10/SA1/WASH/NGO/5065,2/8/2018 8:04:47 AM,Overall,2250,4000,5400,4350,16000,2350,4276,5900,4860,17386
19,South Sudan (UNDP),2017,SSD-17/HSS10/SA1/WASH/NGO/5065,2/8/2018 8:04:47 AM,People in Host Communities,1124,2400,3200,2174,8898,1168,2444,3284,2276,9172
19,South Sudan (UNDP),2017,SSD-17/HSS10/SA1/WASH/NGO/5071,2/12/2018 3:44:07 PM,Internally Displaced People,878,1603,688,1217,4386,1900,3168,1809,3040,9917
19,South Sudan (UNDP),2017,SSD-17/HSS10/SA1/WASH/NGO/5071,2/12/2018 3:44:07 PM,Other,451,859,367,649,2326,1261,1818,1432,2010,6521
19,South Sudan (UNDP),2017,SSD-17/HSS10/SA1/WASH/NGO/5071,2/12/2018 3:44:07 PM,Overall,2110,3854,1638,2898,10500,5163,7790,5107,8112,26172
19,South Sudan (UNDP),2017,SSD-17/HSS10/SA1/WASH/NGO/5071,2/12/2018 3:44:07 PM,People in Host Communities,751,1372,583,1032,3738,2002,2804,1816,3062,9684
19,South Sudan (UNDP),2017,SSD-17/HSS10/SA1/WASH/NGO/5071,2/12/2018 3:44:07 PM,"Trainers, Promoters, Caretakers, committee members, etc.",30,20,0,0,50,30,20,0,0,50
19,South Sudan (UNDP),2017,SSD-17/HSS10/SA1/WASH/NGO/5078,1/15/2018 7:47:28 AM,Internally Displaced People,1667,2177,1591,2146,7581,1827,2174,1816,2092,7909
19,South Sudan (UNDP),2017,SSD-17/HSS10/SA1/WASH/NGO/5078,1/15/2018 7:47:28 AM,Overall,5558,7257,5305,7152,25272,6091,7249,6051,6974,26365
19,South Sudan (UNDP),2017,SSD-17/HSS10/SA1/WASH/NGO/5078,1/15/2018 7:47:28 AM,People in Host Communities,3891,5080,3714,5006,17691,4264,5074,4236,4882,18456
19,South Sudan (UNDP),2017,SSD-17/HSS10/SA1/WASH/NGO/5109,1/28/2018 1:03:45 PM,Children under 5,0,0,560,600,1160,0,0,620,740,1360
19,South Sudan (UNDP),2017,SSD-17/HSS10/SA1/WASH/NGO/5109,1/28/2018 1:03:45 PM,Internally Displaced People,828,1274,680,830,3612,920,1282,724,854,3780
19,South Sudan (UNDP),2017,SSD-17/HSS10/SA1/WASH/NGO/5109,1/28/2018 1:03:45 PM,Overall,1912,2578,2100,2410,9000,2061,2622,2199,2555,9437
19,South Sudan (UNDP),2017,SSD-17/HSS10/SA1/WASH/NGO/5109,1/28/2018 1:03:45 PM,People in Host Communities,1062,1276,833,950,4121,1073,1276,833,950,4132
19,South Sudan (UNDP),2017,SSD-17/HSS10/SA1/WASH/NGO/5109,1/28/2018 1:03:45 PM,"Trainers, Promoters, Caretakers, committee members, etc.",22,28,27,30,107,68,64,22,11,165
19,South Sudan (UNDP),2017,SSD-17/HSS10/SA1/WASH/NGO/5185,2/6/2018 2:59:23 PM,Children under 5,0,0,2015,3004,5019,0,0,2012,3750,5762
19,South Sudan (UNDP),2017,SSD-17/HSS10/SA1/WASH/NGO/5185,2/6/2018 2:59:23 PM,Overall,3121,3860,2015,3004,12000,3400,4000,1900,3700,13000
19,South Sudan (UNDP),2017,SSD-17/HSS10/SA1/WASH/NGO/5185,2/6/2018 2:59:23 PM,People in Host Communities,3106,3570,0,0,6676,3467,3449,0,0,6916
19,South Sudan (UNDP),2017,SSD-17/HSS10/SA1/WASH/NGO/5185,2/6/2018 2:59:23 PM,Pregnant and Lactating Women,0,150,0,0,150,0,278,0,0,278
19,South Sudan (UNDP),2017,SSD-17/HSS10/SA1/WASH/NGO/5185,2/6/2018 2:59:23 PM,"Trainers, Promoters, Caretakers, committee members, etc.",15,14,0,0,29,20,24,0,0,44
19,South Sudan (UNDP),2017,SSD-17/HSS10/SA1/WASH/NGO/5215,2/12/2018 11:06:21 AM,Other,30,30,50,50,160,0,0,0,0,0
19,South Sudan (UNDP),2017,SSD-17/HSS10/SA1/WASH/NGO/5215,2/12/2018 11:06:21 AM,Overall,7000,9000,6500,7500,30000,8655,11128,8033,9278,37094
19,South Sudan (UNDP),2017,SSD-17/HSS10/SA1/WASH/NGO/5215,2/12/2018 11:06:21 AM,People in Host Communities,6920,8920,6410,7410,29660,8570,11124,8017,9277,36988
19,South Sudan (UNDP),2017,SSD-17/HSS10/SA1/WASH/NGO/5215,2/12/2018 11:06:21 AM,"Trainers, Promoters, Caretakers, committee members, etc.",50,50,40,40,180,85,4,17,0,106
19,South Sudan (UNDP),2017,SSD-17/HSS10/SA1/WASH/UN/5196,1/12/2018 12:00:41 PM,Internally Displaced People,700,1300,1000,1300,4300,794,1475,1134,1475,4878
19,South Sudan (UNDP),2017,SSD-17/HSS10/SA1/WASH/UN/5196,1/12/2018 12:00:41 PM,Overall,5400,6800,6000,6800,25000,6483,8164,7204,7794,29645
19,South Sudan (UNDP),2017,SSD-17/HSS10/SA1/WASH/UN/5196,1/12/2018 12:00:41 PM,People in Host Communities,4700,5500,5000,5500,20700,5689,6689,6070,6319,24767
19,South Sudan (UNDP),2017,SSD-17/HSS10/SA2/CCCM/INGO/6880,6/13/2018 7:01:14 AM,Internally Displaced People,2400,2700,3200,3800,12100,2235,1950,2078,2207,8470
19,South Sudan (UNDP),2017,SSD-17/HSS10/SA2/CCCM/INGO/6880,6/13/2018 7:01:14 AM,Overall,2600,3000,3900,4500,14000,2311,2028,2186,2299,8824
19,South Sudan (UNDP),2017,SSD-17/HSS10/SA2/CCCM/INGO/6880,6/13/2018 7:01:14 AM,People in Host Communities,200,300,700,700,1900,76,78,108,92,354
19,South Sudan (UNDP),2017,SSD-17/HSS10/SA2/CCS/UN/6463,11/21/2019 9:34:10 AM,Aid Agencies,41,0,0,0,41,67,0,0,0,67
19,South Sudan (UNDP),2017,SSD-17/HSS10/SA2/CCS/UN/6463,11/21/2019 9:34:10 AM,Overall,41,0,0,0,41,67,0,0,0,67
19,South Sudan (UNDP),2017,SSD-17/HSS10/SA2/E/INGO/6451,8/1/2018 9:27:36 AM,Overall,324,139,6746,3612,10821,220,237,6241,6085,12783
19,South Sudan (UNDP),2017,SSD-17/HSS10/SA2/E/INGO/6451,8/1/2018 9:27:36 AM,People in Host Communities,0,0,6746,3612,10358,0,0,6241,6085,12326
19,South Sudan (UNDP),2017,SSD-17/HSS10/SA2/E/INGO/6451,8/1/2018 9:27:36 AM,"Trainers, Promoters, Caretakers, committee members, etc.",324,139,0,0,463,220,237,0,0,457
19,South Sudan (UNDP),2017,SSD-17/HSS10/SA2/E/INGO/6571,8/1/2018 6:23:21 AM,Internally Displaced People,200,200,6810,3421,10631,200,225,5434,3333,9192
19,South Sudan (UNDP),2017,SSD-17/HSS10/SA2/E/INGO/6571,8/1/2018 6:23:21 AM,Overall,390,400,10901,6621,18312,390,450,9906,6976,17722
19,South Sudan (UNDP),2017,SSD-17/HSS10/SA2/E/INGO/6571,8/1/2018 6:23:21 AM,People in Host Communities,190,200,4091,3200,7681,190,225,4472,3643,8530
19,South Sudan (UNDP),2017,SSD-17/HSS10/SA2/E/INGO/6577,8/1/2018 6:29:59 AM,Other,0,0,4222,3232,7454,0,0,3803,3134,6937
19,South Sudan (UNDP),2017,SSD-17/HSS10/SA2/E/INGO/6577,8/1/2018 6:29:59 AM,Overall,206,101,4222,3232,7761,197,99,3803,3134,7233
19,South Sudan (UNDP),2017,SSD-17/HSS10/SA2/E/INGO/6577,8/1/2018 6:29:59 AM,"Trainers, Promoters, Caretakers, committee members, etc.",206,101,0,0,307,197,99,0,0,296
19,South Sudan (UNDP),2017,SSD-17/HSS10/SA2/E/NGO/6439,8/1/2018 6:26:21 AM,Internally Displaced People,50,22,4464,2736,7272,202,86,5745,2829,8862
19,South Sudan (UNDP),2017,SSD-17/HSS10/SA2/E/NGO/6439,8/1/2018 6:26:21 AM,Overall,342,146,7440,4560,12488,342,146,9737,4795,15020
19,South Sudan (UNDP),2017,SSD-17/HSS10/SA2/E/NGO/6439,8/1/2018 6:26:21 AM,People in Host Communities,34,14,2976,1824,4848,140,60,3992,1966,6158
19,South Sudan (UNDP),2017,SSD-17/HSS10/SA2/E/NGO/6439,8/1/2018 6:26:21 AM,"Trainers, Promoters, Caretakers, committee members, etc.",258,110,0,0,368,0,0,0,0,0
19,South Sudan (UNDP),2017,SSD-17/HSS10/SA2/E/NGO/6567,8/9/2018 7:10:27 AM,Internally Displaced People,140,60,2600,1400,4200,140,60,3205,2062,5467
19,South Sudan (UNDP),2017,SSD-17/HSS10/SA2/E/NGO/6567,8/9/2018 7:10:27 AM,Overall,320,160,5600,3200,9280,320,160,8015,5153,13648
19,South Sudan (UNDP),2017,SSD-17/HSS10/SA2/E/NGO/6567,8/9/2018 7:10:27 AM,People in Host Communities,160,80,2800,1600,4640,160,80,4008,2577,6825
19,South Sudan (UNDP),2017,SSD-17/HSS10/SA2/E/NGO/6567,8/9/2018 7:10:27 AM,Refugee Returnees,20,20,200,200,440,20,20,802,514,1356
19,South Sudan (UNDP),2017,SSD-17/HSS10/SA2/E/NGO/6572,7/3/2018 6:37:28 AM,Internally Displaced People,300,300,2800,1500,4900,244,98,2766,2495,5603
19,South Sudan (UNDP),2017,SSD-17/HSS10/SA2/E/NGO/6572,7/3/2018 6:37:28 AM,Other,100,100,500,500,1200,64,46,1570,1461,3141
19,South Sudan (UNDP),2017,SSD-17/HSS10/SA2/E/NGO/6572,7/3/2018 6:37:28 AM,Overall,500,500,4800,3200,9000,419,209,5235,4345,10208
19,South Sudan (UNDP),2017,SSD-17/HSS10/SA2/E/NGO/6572,7/3/2018 6:37:28 AM,People in Host Communities,100,100,1500,1200,2900,111,65,899,389,1464
19,South Sudan (UNDP),2017,SSD-17/HSS10/SA2/FSL/NGO/6441,5/3/2018 6:35:49 AM,Internally Displaced People,19270,12847,1014,677,33808,12194,18009,517,829,31549
19,South Sudan (UNDP),2017,SSD-17/HSS10/SA2/FSL/NGO/6441,5/3/2018 6:35:49 AM,Other,2126,1417,112,74,3729,1684,1819,68,83,3654
19,South Sudan (UNDP),2017,SSD-17/HSS10/SA2/FSL/NGO/6441,5/3/2018 6:35:49 AM,Overall,45885,30590,2415,1610,80500,35623,41622,1505,1750,80500
19,South Sudan (UNDP),2017,SSD-17/HSS10/SA2/FSL/NGO/6441,5/3/2018 6:35:49 AM,People in Host Communities,24319,16213,1280,853,42665,21603,21647,916,833,44999
19,South Sudan (UNDP),2017,SSD-17/HSS10/SA2/FSL/NGO/6441,5/3/2018 6:35:49 AM,"Trainers, Promoters, Caretakers, committee members, etc.",170,113,9,6,298,142,147,4,5,298
19,South Sudan (UNDP),2017,SSD-17/HSS10/SA2/FSL/NGO/6454,5/3/2018 6:33:50 AM,Internally Displaced People,6300,10500,2100,2100,21000,7704,11904,3774,4842,28224
19,South Sudan (UNDP),2017,SSD-17/HSS10/SA2/FSL/NGO/6454,5/3/2018 6:33:50 AM,Overall,12600,21000,4200,4200,42000,14052,17118,4512,6318,42000
19,South Sudan (UNDP),2017,SSD-17/HSS10/SA2/FSL/NGO/6454,5/3/2018 6:33:50 AM,People in Host Communities,3780,6300,1260,1260,12600,2076,336,222,1254,3888
19,South Sudan (UNDP),2017,SSD-17/HSS10/SA2/FSL/NGO/6454,5/3/2018 6:33:50 AM,Refugee Returnees,2520,4200,840,840,8400,4272,4878,516,222,9888
19,South Sudan (UNDP),2017,SSD-17/HSS10/SA2/FSL/NGO/6490,5/3/2018 6:13:25 AM,Internally Displaced People,3648,5472,5472,8208,22800,3648,5482,5350,8354,22834
19,South Sudan (UNDP),2017,SSD-17/HSS10/SA2/FSL/NGO/6490,5/3/2018 6:13:25 AM,Overall,9120,13680,13680,20520,57000,9100,13700,13500,20720,57020
19,South Sudan (UNDP),2017,SSD-17/HSS10/SA2/FSL/NGO/6490,5/3/2018 6:13:25 AM,People in Host Communities,5472,8208,8208,12312,34200,5452,8218,8150,12366,34186
19,South Sudan (UNDP),2017,SSD-17/HSS10/SA2/FSL/NGO/6500,2/14/2018 3:28:20 PM,Internally Displaced People,2878,3902,894,990,8664,2878,3902,894,990,8664
19,South Sudan (UNDP),2017,SSD-17/HSS10/SA2/FSL/NGO/6500,2/14/2018 3:28:20 PM,Overall,8035,8555,2136,2274,21000,8035,8555,2136,2274,21000
19,South Sudan (UNDP),2017,SSD-17/HSS10/SA2/FSL/NGO/6500,2/14/2018 3:28:20 PM,People in Host Communities,5157,4653,1242,1284,12336,5157,4653,1242,1284,12336
19,South Sudan (UNDP),2017,SSD-17/HSS10/SA2/FSL/NGO/6547,5/29/2018 5:25:43 AM,Internally Displaced People,5130,6680,3780,4250,19840,4130,6680,3780,4250,18840
19,South Sudan (UNDP),2017,SSD-17/HSS10/SA2/FSL/NGO/6547,5/29/2018 5:25:43 AM,Overall,11400,16700,8400,8500,45000,11400,16700,8400,8500,45000
19,South Sudan (UNDP),2017,SSD-17/HSS10/SA2/FSL/NGO/6547,5/29/2018 5:25:43 AM,People in Host Communities,6270,10020,4620,4250,25160,6270,10020,4620,4250,25160
19,South Sudan (UNDP),2017,SSD-17/HSS10/SA2/FSL/NGO/6559,5/3/2018 6:34:41 AM,Internally Displaced People,2000,2000,4000,4000,12000,1380,1750,5050,4550,12730
19,South Sudan (UNDP),2017,SSD-17/HSS10/SA2/FSL/NGO/6559,5/3/2018 6:34:41 AM,Other,800,800,1600,1600,4800,490,360,1115,2040,4005
19,South Sudan (UNDP),2017,SSD-17/HSS10/SA2/FSL/NGO/6559,5/3/2018 6:34:41 AM,Overall,4000,4000,8000,8000,24000,2620,3210,8200,9970,24000
19,South Sudan (UNDP),2017,SSD-17/HSS10/SA2/FSL/NGO/6559,5/3/2018 6:34:41 AM,People in Host Communities,1200,1200,2400,2400,7200,750,1100,2035,3380,7265
19,South Sudan (UNDP),2017,SSD-17/HSS10/SA2/FSL/NGO/6581,4/4/2018 9:49:22 AM,Internally Displaced People,748,780,1039,1072,3639,748,780,1039,1072,3639
19,South Sudan (UNDP),2017,SSD-17/HSS10/SA2/FSL/NGO/6581,4/4/2018 9:49:22 AM,Overall,3690,3852,5148,5310,18000,3690,3852,5148,5310,18000
19,South Sudan (UNDP),2017,SSD-17/HSS10/SA2/FSL/NGO/6581,4/4/2018 9:49:22 AM,People in Host Communities,2364,2482,3390,3502,11738,2364,2482,3390,3502,11738
19,South Sudan (UNDP),2017,SSD-17/HSS10/SA2/FSL/NGO/6581,4/4/2018 9:49:22 AM,Refugee Returnees,578,590,719,736,2623,578,590,719,736,2623
19,South Sudan (UNDP),2017,SSD-17/HSS10/SA2/FSL/UN/6590,9/12/2018 7:00:01 AM,Internally Displaced People,31896,47844,31896,47844,159480,0,0,0,0,0
19,South Sudan (UNDP),2017,SSD-17/HSS10/SA2/FSL/UN/6590,9/12/2018 7:00:01 AM,Overall,53160,79740,53160,79740,265800,0,0,0,0,0
19,South Sudan (UNDP),2017,SSD-17/HSS10/SA2/FSL/UN/6590,9/12/2018 7:00:01 AM,People in Host Communities,21264,31896,21264,31896,106320,0,0,0,0,0
19,South Sudan (UNDP),2017,SSD-17/HSS10/SA2/H/INGO/6450,7/31/2018 7:41:50 PM,Internally Displaced People,3194,3325,734,795,8048,1352,2128,587,813,4880
19,South Sudan (UNDP),2017,SSD-17/HSS10/SA2/H/INGO/6450,7/31/2018 7:41:50 PM,Overall,7985,8312,1835,1988,20120,7742,8931,2441,3694,22808
19,South Sudan (UNDP),2017,SSD-17/HSS10/SA2/H/INGO/6450,7/31/2018 7:41:50 PM,People in Host Communities,4791,4987,1101,1193,12072,6390,6803,1854,2881,17928
19,South Sudan (UNDP),2017,SSD-17/HSS10/SA2/H/INGO/6456,5/29/2018 5:30:39 AM,Internally Displaced People,1275,1327,339,353,3294,1289,1348,620,659,3916
19,South Sudan (UNDP),2017,SSD-17/HSS10/SA2/H/INGO/6456,5/29/2018 5:30:39 AM,Other,2974,3095,790,823,7682,3006,3145,1448,1537,9136
19,South Sudan (UNDP),2017,SSD-17/HSS10/SA2/H/INGO/6456,5/29/2018 5:30:39 AM,Overall,4249,4422,1129,1176,10976,4295,4493,2068,2196,13052
19,South Sudan (UNDP),2017,SSD-17/HSS10/SA2/H/INGO/6479,7/31/2018 7:46:59 PM,Overall,3105,3620,864,900,8489,1160,2007,1067,1390,5624
19,South Sudan (UNDP),2017,SSD-17/HSS10/SA2/H/INGO/6499,2/28/2018 7:06:02 AM,Children under 5,0,0,6963,6963,13926,0,0,7087,7142,14229
19,South Sudan (UNDP),2017,SSD-17/HSS10/SA2/H/INGO/6499,2/28/2018 7:06:02 AM,Overall,13884,19130,6963,6963,46940,14178,19587,7087,7142,47994
19,South Sudan (UNDP),2017,SSD-17/HSS10/SA2/H/INGO/6499,2/28/2018 7:06:02 AM,People in Host Communities,13646,16678,0,0,30324,13878,17261,0,0,31139
19,South Sudan (UNDP),2017,SSD-17/HSS10/SA2/H/INGO/6499,2/28/2018 7:06:02 AM,Pregnant and Lactating Women,0,2350,0,0,2350,0,2218,0,0,2218
19,South Sudan (UNDP),2017,SSD-17/HSS10/SA2/H/INGO/6499,2/28/2018 7:06:02 AM,"Trainers, Promoters, Caretakers, committee members, etc.",238,102,0,0,340,316,127,0,0,443
19,South Sudan (UNDP),2017,SSD-17/HSS10/SA2/H/INGO/6508,10/24/2018 12:57:09 PM,Children under 5,0,0,10462,11334,21796,0,0,10462,11334,21796
19,South Sudan (UNDP),2017,SSD-17/HSS10/SA2/H/INGO/6508,10/24/2018 12:57:09 PM,Other,23472,25428,0,0,48900,23472,25428,0,0,48900
19,South Sudan (UNDP),2017,SSD-17/HSS10/SA2/H/INGO/6508,10/24/2018 12:57:09 PM,Overall,39357,42637,10462,11334,103790,14969,19645,12432,13516,60562
19,South Sudan (UNDP),2017,SSD-17/HSS10/SA2/H/INGO/6508,10/24/2018 12:57:09 PM,Pregnant and Lactating Women,0,8303,0,0,8303,0,8303,0,0,8303
19,South Sudan (UNDP),2017,SSD-17/HSS10/SA2/H/INGO/6508,10/24/2018 12:57:09 PM,"Trainers, Promoters, Caretakers, committee members, etc.",239,259,0,0,498,239,259,0,0,498
19,South Sudan (UNDP),2017,SSD-17/HSS10/SA2/H/INGO/6556,1/21/2019 5:27:09 AM,Internally Displaced People,5033,5239,3720,3872,17864,500,520,460,520,2000
19,South Sudan (UNDP),2017,SSD-17/HSS10/SA2/H/INGO/6556,1/21/2019 5:27:09 AM,Overall,17142,17842,19331,20120,74435,8575,7037,8660,12220,36492
19,South Sudan (UNDP),2017,SSD-17/HSS10/SA2/H/INGO/6556,1/21/2019 5:27:09 AM,People in Host Communities,12109,12603,15611,16248,56571,8623,8968,7933,8968,34492
19,South Sudan (UNDP),2017,SSD-17/HSS10/SA2/H/NGO/6442,7/31/2018 7:40:23 PM,Internally Displaced People,2070,2760,966,1104,6900,4620,6159,2156,2466,15401
19,South Sudan (UNDP),2017,SSD-17/HSS10/SA2/H/NGO/6442,7/31/2018 7:40:23 PM,Other,345,460,161,184,1150,770,1026,359,411,2566
19,South Sudan (UNDP),2017,SSD-17/HSS10/SA2/H/NGO/6442,7/31/2018 7:40:23 PM,Overall,3450,4600,1610,1840,11500,7700,10265,3593,4110,25668
19,South Sudan (UNDP),2017,SSD-17/HSS10/SA2/H/NGO/6442,7/31/2018 7:40:23 PM,People in Host Communities,1035,1380,483,552,3450,2310,3080,1078,1233,7701
19,South Sudan (UNDP),2017,SSD-17/HSS10/SA2/H/NGO/6449,2/28/2018 7:00:27 AM,Children under 5,0,0,1412,1500,2912,0,0,1234,1753,2987
19,South Sudan (UNDP),2017,SSD-17/HSS10/SA2/H/NGO/6449,2/28/2018 7:00:27 AM,Internally Displaced People,6888,24000,2320,1934,35142,6888,18345,2101,1856,29190
19,South Sudan (UNDP),2017,SSD-17/HSS10/SA2/H/NGO/6449,2/28/2018 7:00:27 AM,Other,1985,3000,250,156,5391,853,1259,234,178,2524
19,South Sudan (UNDP),2017,SSD-17/HSS10/SA2/H/NGO/6449,2/28/2018 7:00:27 AM,Overall,12888,50000,5082,4830,72800,10196,27076,5723,4942,47937
19,South Sudan (UNDP),2017,SSD-17/HSS10/SA2/H/NGO/6449,2/28/2018 7:00:27 AM,People in Host Communities,4015,23000,1100,1240,29355,2455,7472,2154,1155,13236
19,South Sudan (UNDP),2017,SSD-17/HSS10/SA2/H/NGO/6461,7/31/2018 7:44:43 PM,Children under 5,0,0,1146,1277,2423,0,0,1099,1152,2251
19,South Sudan (UNDP),2017,SSD-17/HSS10/SA2/H/NGO/6461,7/31/2018 7:44:43 PM,Internally Displaced People,1400,1500,1100,1200,5200,1133,1460,1056,1088,4737
19,South Sudan (UNDP),2017,SSD-17/HSS10/SA2/H/NGO/6461,7/31/2018 7:44:43 PM,Overall,2284,2781,3046,3427,11538,1470,2390,2712,2921,9493
19,South Sudan (UNDP),2017,SSD-17/HSS10/SA2/H/NGO/6461,7/31/2018 7:44:43 PM,People in Host Communities,884,820,800,950,3454,570,617,415,520,2122
19,South Sudan (UNDP),2017,SSD-17/HSS10/SA2/H/NGO/6461,7/31/2018 7:44:43 PM,Pregnant and Lactating Women,0,461,0,0,461,0,383,0,0,383
19,South Sudan (UNDP),2017,SSD-17/HSS10/SA2/H/NGO/6467,5/29/2018 5:43:37 AM,Children under 5,0,0,4000,4500,8500,0,0,3814,4214,8028
19,South Sudan (UNDP),2017,SSD-17/HSS10/SA2/H/NGO/6467,5/29/2018 5:43:37 AM,Internally Displaced People,4000,4000,0,0,8000,3070,4000,0,0,7070
19,South Sudan (UNDP),2017,SSD-17/HSS10/SA2/H/NGO/6467,5/29/2018 5:43:37 AM,Overall,7000,7500,4000,4500,23000,6243,7242,3814,4214,21513
19,South Sudan (UNDP),2017,SSD-17/HSS10/SA2/H/NGO/6467,5/29/2018 5:43:37 AM,People in Host Communities,3000,2500,0,0,5500,2878,3092,0,0,5970
19,South Sudan (UNDP),2017,SSD-17/HSS10/SA2/H/NGO/6467,5/29/2018 5:43:37 AM,Pregnant and Lactating Women,0,1000,0,0,1000,0,947,0,0,947
19,South Sudan (UNDP),2017,SSD-17/HSS10/SA2/H/NGO/6471,7/31/2018 7:45:50 PM,Children under 5,0,0,970,1240,2210,0,0,1684,1376,3060
19,South Sudan (UNDP),2017,SSD-17/HSS10/SA2/H/NGO/6471,7/31/2018 7:45:50 PM,Internally Displaced People,2580,1580,1040,1530,6730,2654,1657,1865,1654,7830
19,South Sudan (UNDP),2017,SSD-17/HSS10/SA2/H/NGO/6471,7/31/2018 7:45:50 PM,Overall,3750,5252,2248,3750,15000,3978,5875,4317,4150,18320
19,South Sudan (UNDP),2017,SSD-17/HSS10/SA2/H/NGO/6471,7/31/2018 7:45:50 PM,People in Host Communities,1170,3092,238,980,5480,1324,3456,768,1120,6668
19,South Sudan (UNDP),2017,SSD-17/HSS10/SA2/H/NGO/6471,7/31/2018 7:45:50 PM,Pregnant and Lactating Women,0,580,0,0,580,0,762,0,0,762
19,South Sudan (UNDP),2017,SSD-17/HSS10/SA2/H/NGO/6472,7/31/2018 7:38:47 PM,Children under 5,0,0,2584,2585,5169,0,0,2801,2910,5711
19,South Sudan (UNDP),2017,SSD-17/HSS10/SA2/H/NGO/6472,7/31/2018 7:38:47 PM,Internally Displaced People,3734,3721,0,0,7455,4261,5921,0,0,10182
19,South Sudan (UNDP),2017,SSD-17/HSS10/SA2/H/NGO/6472,7/31/2018 7:38:47 PM,Overall,9334,10112,2584,2585,24615,10219,12107,2801,2910,28037
19,South Sudan (UNDP),2017,SSD-17/HSS10/SA2/H/NGO/6472,7/31/2018 7:38:47 PM,People in Host Communities,5600,5582,0,0,11182,5958,5184,0,0,11142
19,South Sudan (UNDP),2017,SSD-17/HSS10/SA2/H/NGO/6472,7/31/2018 7:38:47 PM,Pregnant and Lactating Women,0,809,0,0,809,0,1002,0,0,1002
19,South Sudan (UNDP),2017,SSD-17/HSS10/SA2/H/NGO/6474,2/28/2018 7:04:07 AM,Internally Displaced People,500,400,400,700,2000,784,1043,1658,1944,5429
19,South Sudan (UNDP),2017,SSD-17/HSS10/SA2/H/NGO/6474,2/28/2018 7:04:07 AM,Overall,2000,3200,2000,2800,10000,4527,6526,6377,8899,26329
19,South Sudan (UNDP),2017,SSD-17/HSS10/SA2/H/NGO/6474,2/28/2018 7:04:07 AM,Pastoralists,600,1000,1100,1000,3700,1649,2241,1556,2861,8307
19,South Sudan (UNDP),2017,SSD-17/HSS10/SA2/H/NGO/6474,2/28/2018 7:04:07 AM,People in Host Communities,500,1400,500,1100,3500,2095,2378,3163,4093,11729
19,South Sudan (UNDP),2017,SSD-17/HSS10/SA2/H/NGO/6474,2/28/2018 7:04:07 AM,Pregnant and Lactating Women,400,400,0,0,800,0,864,0,0,864
19,South Sudan (UNDP),2017,SSD-17/HSS10/SA2/H/NGO/6482,5/29/2018 5:35:36 AM,Internally Displaced People,900,1000,700,500,3100,963,1331,292,403,2989
19,South Sudan (UNDP),2017,SSD-17/HSS10/SA2/H/NGO/6482,5/29/2018 5:35:36 AM,Overall,1920,2450,1580,1742,7692,1600,2209,425,588,4822
19,South Sudan (UNDP),2017,SSD-17/HSS10/SA2/H/NGO/6482,5/29/2018 5:35:36 AM,People in Host Communities,1020,1450,880,1242,4592,520,718,248,343,1829
19,South Sudan (UNDP),2017,SSD-17/HSS10/SA2/H/NGO/6507,7/31/2018 7:38:19 PM,Internally Displaced People,800,1100,640,920,3460,2876,3813,764,1013,8466
19,South Sudan (UNDP),2017,SSD-17/HSS10/SA2/H/NGO/6507,7/31/2018 7:38:19 PM,Overall,3500,5900,3200,3900,16500,111569,117038,29657,31085,289349
19,South Sudan (UNDP),2017,SSD-17/HSS10/SA2/H/NGO/6507,7/31/2018 7:38:19 PM,People in Host Communities,2700,4500,2560,2980,12740,108693,113129,28893,30072,280787
19,South Sudan (UNDP),2017,SSD-17/HSS10/SA2/H/NGO/6507,7/31/2018 7:38:19 PM,Pregnant and Lactating Women,0,300,0,0,300,0,96,0,0,96
19,South Sudan (UNDP),2017,SSD-17/HSS10/SA2/H/UN/6489,7/31/2018 7:37:01 PM,Internally Displaced People,4000,15000,3000,4000,26000,3105,24946,1423,2929,32403
19,South Sudan (UNDP),2017,SSD-17/HSS10/SA2/H/UN/6489,7/31/2018 7:37:01 PM,Overall,5000,20000,4000,5000,34000,4890,21990,3500,5800,36180
19,South Sudan (UNDP),2017,SSD-17/HSS10/SA2/H/UN/6489,7/31/2018 7:37:01 PM,People in Host Communities,1000,2000,1000,1000,5000,0,0,0,0,0
19,South Sudan (UNDP),2017,SSD-17/HSS10/SA2/H/UN/6489,7/31/2018 7:37:01 PM,Pregnant and Lactating Women,0,3000,0,0,3000,0,3799,0,0,3799
19,South Sudan (UNDP),2017,SSD-17/HSS10/SA2/H/UN/6521,7/27/2018 1:32:24 PM,Internally Displaced People,500,500,0,0,1000,0,0,0,0,0
19,South Sudan (UNDP),2017,SSD-17/HSS10/SA2/H/UN/6521,7/27/2018 1:32:24 PM,Overall,6000,6000,1500,1500,15000,6000,6000,1500,1500,15000
19,South Sudan (UNDP),2017,SSD-17/HSS10/SA2/H/UN/6521,7/27/2018 1:32:24 PM,People in Host Communities,5500,5500,1500,1500,14000,0,0,0,0,0
19,South Sudan (UNDP),2017,SSD-17/HSS10/SA2/H/UN/6580,4/4/2018 8:48:16 AM,Children under 5,0,0,2152,2318,4470,0,0,20411,28967,49378
19,South Sudan (UNDP),2017,SSD-17/HSS10/SA2/H/UN/6580,4/4/2018 8:48:16 AM,Internally Displaced People,4754,5873,3376,3732,17735,10343,20781,28335,20205,79664
19,South Sudan (UNDP),2017,SSD-17/HSS10/SA2/H/UN/6580,4/4/2018 8:48:16 AM,Overall,10071,12377,10759,11586,44793,32928,49386,102053,144835,329202
19,South Sudan (UNDP),2017,SSD-17/HSS10/SA2/H/UN/6580,4/4/2018 8:48:16 AM,Pastoralists,3321,3930,3421,3239,13911,10112,11882,18325,33474,73793
19,South Sudan (UNDP),2017,SSD-17/HSS10/SA2/H/UN/6580,4/4/2018 8:48:16 AM,People in Host Communities,1996,2574,1810,2297,8677,12473,16723,34982,62189,126367
19,South Sudan (UNDP),2017,SSD-17/HSS10/SA2/L/UN/6457,2/14/2018 3:37:59 PM,Overall,240,0,0,0,240,274,0,0,0,274
19,South Sudan (UNDP),2017,SSD-17/HSS10/SA2/L/UN/6525,11/14/2017 8:37:22 AM,Overall,30,0,0,0,30,23,0,0,0,23
19,South Sudan (UNDP),2017,SSD-17/HSS10/SA2/L/UN/6536,5/3/2018 6:14:53 AM,Aid Agencies,40,40,0,0,80,0,0,0,0,0
19,South Sudan (UNDP),2017,SSD-17/HSS10/SA2/L/UN/6536,5/3/2018 6:14:53 AM,Overall,40,40,0,0,80,40,40,0,0,80
19,South Sudan (UNDP),2017,SSD-17/HSS10/SA2/N/INGO/6495,4/10/2018 8:05:23 AM,Children under 5,0,0,1344,1456,2800,0,0,1099,1225,2324
19,South Sudan (UNDP),2017,SSD-17/HSS10/SA2/N/INGO/6495,4/10/2018 8:05:23 AM,Overall,0,955,1344,1456,3755,0,853,1099,1225,3177
19,South Sudan (UNDP),2017,SSD-17/HSS10/SA2/N/INGO/6495,4/10/2018 8:05:23 AM,Pregnant and Lactating Women,0,955,0,0,955,0,853,0,0,853
19,South Sudan (UNDP),2017,SSD-17/HSS10/SA2/N/INGO/6509,5/18/2018 7:28:44 AM,Children under 5,0,8653,17277,18717,44647,0,0,70532,79348,149880
19,South Sudan (UNDP),2017,SSD-17/HSS10/SA2/N/INGO/6509,5/18/2018 7:28:44 AM,Internally Displaced People,0,3324,0,0,3324,0,11926,0,0,11926
19,South Sudan (UNDP),2017,SSD-17/HSS10/SA2/N/INGO/6509,5/18/2018 7:28:44 AM,Overall,300,15155,17277,18717,51449,341,27108,35266,39674,102389
19,South Sudan (UNDP),2017,SSD-17/HSS10/SA2/N/INGO/6509,5/18/2018 7:28:44 AM,People in Host Communities,0,2578,0,0,2578,0,40968,0,0,40968
19,South Sudan (UNDP),2017,SSD-17/HSS10/SA2/N/INGO/6509,5/18/2018 7:28:44 AM,"Trainers, Promoters, Caretakers, committee members, etc.",300,600,0,0,900,682,1322,0,0,2004
19,South Sudan (UNDP),2017,SSD-17/HSS10/SA2/N/INGO/6534,8/9/2018 9:59:44 AM,Children under 5,0,0,3741,4055,7796,0,0,14053,11627,25680
19,South Sudan (UNDP),2017,SSD-17/HSS10/SA2/N/INGO/6534,8/9/2018 9:59:44 AM,Overall,0,2936,3741,4055,10732,0,2091,14053,11627,27771
19,South Sudan (UNDP),2017,SSD-17/HSS10/SA2/N/INGO/6534,8/9/2018 9:59:44 AM,Pregnant and Lactating Women,0,2936,0,0,2936,0,2091,0,0,2091
19,South Sudan (UNDP),2017,SSD-17/HSS10/SA2/N/INGO/6542,3/12/2019 1:49:58 PM,Children under 5,0,0,949,1028,1977,0,0,0,0,0
19,South Sudan (UNDP),2017,SSD-17/HSS10/SA2/N/INGO/6542,3/12/2019 1:49:58 PM,Internally Displaced People,0,883,593,642,2118,0,0,0,0,0
19,South Sudan (UNDP),2017,SSD-17/HSS10/SA2/N/INGO/6542,3/12/2019 1:49:58 PM,Overall,0,4203,2374,2571,9148,0,0,0,0,0
19,South Sudan (UNDP),2017,SSD-17/HSS10/SA2/N/INGO/6542,3/12/2019 1:49:58 PM,People in Host Communities,0,1639,832,901,3372,0,0,0,0,0
19,South Sudan (UNDP),2017,SSD-17/HSS10/SA2/N/INGO/6542,3/12/2019 1:49:58 PM,Pregnant and Lactating Women,0,1681,0,0,1681,0,0,0,0,0
19,South Sudan (UNDP),2017,SSD-17/HSS10/SA2/N/INGO/6557,4/10/2018 11:19:14 AM,Children under 5,0,0,6439,6701,13140,0,0,8892,9750,18642
19,South Sudan (UNDP),2017,SSD-17/HSS10/SA2/N/INGO/6557,4/10/2018 11:19:14 AM,Internally Displaced People,150,750,0,0,900,32,689,0,0,721
19,South Sudan (UNDP),2017,SSD-17/HSS10/SA2/N/INGO/6557,4/10/2018 11:19:14 AM,Overall,400,5533,6439,6701,19073,267,6905,8892,9750,25814
19,South Sudan (UNDP),2017,SSD-17/HSS10/SA2/N/INGO/6557,4/10/2018 11:19:14 AM,People in Host Communities,250,4783,0,0,5033,235,6216,0,0,6451
19,South Sudan (UNDP),2017,SSD-17/HSS10/SA2/N/NGO/6460,6/5/2018 8:17:15 AM,Children under 5,0,0,1980,2020,4000,0,0,2000,2250,4250
19,South Sudan (UNDP),2017,SSD-17/HSS10/SA2/N/NGO/6460,6/5/2018 8:17:15 AM,Internally Displaced People,250,500,0,0,750,280,796,0,0,1076
19,South Sudan (UNDP),2017,SSD-17/HSS10/SA2/N/NGO/6460,6/5/2018 8:17:15 AM,Overall,600,1500,1980,2020,6100,579,1587,2000,2250,6416
19,South Sudan (UNDP),2017,SSD-17/HSS10/SA2/N/NGO/6460,6/5/2018 8:17:15 AM,People in Host Communities,250,100,0,0,350,299,391,0,0,690
19,South Sudan (UNDP),2017,SSD-17/HSS10/SA2/N/NGO/6460,6/5/2018 8:17:15 AM,Pregnant and Lactating Women,0,400,0,0,400,0,400,0,0,400
19,South Sudan (UNDP),2017,SSD-17/HSS10/SA2/N/NGO/6478,4/5/2018 7:10:00 AM,Children under 5,0,0,5009,6783,11792,0,0,3235,4600,7835
19,South Sudan (UNDP),2017,SSD-17/HSS10/SA2/N/NGO/6478,4/5/2018 7:10:00 AM,Internally Displaced People,8000,9600,0,0,17600,7151,8950,0,0,16101
19,South Sudan (UNDP),2017,SSD-17/HSS10/SA2/N/NGO/6478,4/5/2018 7:10:00 AM,Overall,24131,26140,5009,6783,62063,19651,22314,3235,4600,49800
19,South Sudan (UNDP),2017,SSD-17/HSS10/SA2/N/NGO/6478,4/5/2018 7:10:00 AM,People in Host Communities,16131,11575,0,0,27706,12500,8399,0,0,20899
19,South Sudan (UNDP),2017,SSD-17/HSS10/SA2/N/NGO/6478,4/5/2018 7:10:00 AM,Pregnant and Lactating Women,0,4965,0,0,4965,0,4965,0,0,4965
19,South Sudan (UNDP),2017,SSD-17/HSS10/SA2/N/NGO/6501,4/10/2018 11:31:28 AM,Children under 5,0,0,10122,10122,20244,0,0,11960,11900,23860
19,South Sudan (UNDP),2017,SSD-17/HSS10/SA2/N/NGO/6501,4/10/2018 11:31:28 AM,Internally Displaced People,98,215,0,0,313,202,230,0,0,432
19,South Sudan (UNDP),2017,SSD-17/HSS10/SA2/N/NGO/6501,4/10/2018 11:31:28 AM,Overall,308,1191,10122,10122,21743,352,1348,11960,11900,25560
19,South Sudan (UNDP),2017,SSD-17/HSS10/SA2/N/NGO/6501,4/10/2018 11:31:28 AM,People in Host Communities,210,396,0,0,606,150,308,0,0,458
19,South Sudan (UNDP),2017,SSD-17/HSS10/SA2/N/NGO/6501,4/10/2018 11:31:28 AM,Pregnant and Lactating Women,0,580,0,0,580,0,810,0,0,810
19,South Sudan (UNDP),2017,SSD-17/HSS10/SA2/N/NGO/6518,4/12/2018 9:16:58 AM,Children under 5,0,0,4000,4000,8000,0,0,2714,3196,5910
19,South Sudan (UNDP),2017,SSD-17/HSS10/SA2/N/NGO/6518,4/12/2018 9:16:58 AM,Internally Displaced People,100,0,0,0,100,132,0,0,0,132
19,South Sudan (UNDP),2017,SSD-17/HSS10/SA2/N/NGO/6518,4/12/2018 9:16:58 AM,Overall,200,2800,4000,4000,11000,252,2404,2714,3196,8566
19,South Sudan (UNDP),2017,SSD-17/HSS10/SA2/N/NGO/6518,4/12/2018 9:16:58 AM,People in Host Communities,100,0,0,0,100,120,0,0,0,120
19,South Sudan (UNDP),2017,SSD-17/HSS10/SA2/N/NGO/6518,4/12/2018 9:16:58 AM,Pregnant and Lactating Women,0,2800,0,0,2800,0,2404,0,0,2404
19,South Sudan (UNDP),2017,SSD-17/HSS10/SA2/N/NGO/6596,5/15/2018 11:39:09 AM,Children under 5,0,0,819,888,1707,0,0,1227,1289,2516
19,South Sudan (UNDP),2017,SSD-17/HSS10/SA2/N/NGO/6596,5/15/2018 11:39:09 AM,Internally Displaced People,2927,5834,3083,3340,15184,1770,5469,2861,3600,13700
19,South Sudan (UNDP),2017,SSD-17/HSS10/SA2/N/NGO/6596,5/15/2018 11:39:09 AM,Overall,2927,6341,3902,4228,17398,1770,5469,2861,3600,13700
19,South Sudan (UNDP),2017,SSD-17/HSS10/SA2/N/NGO/6596,5/15/2018 11:39:09 AM,Pregnant and Lactating Women,0,507,0,0,507,0,888,0,0,888
19,South Sudan (UNDP),2017,SSD-17/HSS10/SA2/N/UN/6587,8/9/2018 10:12:46 AM,Children under 5,0,0,13123,13659,26782,0,0,28943,32077,61020
19,South Sudan (UNDP),2017,SSD-17/HSS10/SA2/N/UN/6587,8/9/2018 10:12:46 AM,Overall,0,7672,13123,13659,34454,0,46302,28943,32077,107322
19,South Sudan (UNDP),2017,SSD-17/HSS10/SA2/N/UN/6587,8/9/2018 10:12:46 AM,Pregnant and Lactating Women,0,7672,0,0,7672,0,46302,0,0,46302
19,South Sudan (UNDP),2017,SSD-17/HSS10/SA2/NFI/INGO/6446,2/14/2018 12:38:11 PM,Internally Displaced People,1387,2314,3818,4048,11567,3521,3705,2087,2271,11584
19,South Sudan (UNDP),2017,SSD-17/HSS10/SA2/NFI/INGO/6446,2/14/2018 12:38:11 PM,Overall,1542,2571,4242,4498,12853,3676,3962,2511,2721,12870
19,South Sudan (UNDP),2017,SSD-17/HSS10/SA2/NFI/INGO/6446,2/14/2018 12:38:11 PM,People in Host Communities,155,257,424,450,1286,155,257,424,450,1286
19,South Sudan (UNDP),2017,SSD-17/HSS10/SA2/NFI/INGO/6512,6/19/2018 10:35:36 AM,Internally Displaced People,4100,7900,8900,9100,30000,0,0,0,0,0
19,South Sudan (UNDP),2017,SSD-17/HSS10/SA2/NFI/INGO/6512,6/19/2018 10:35:36 AM,Overall,4100,7900,8900,9100,30000,0,0,0,0,0
19,South Sudan (UNDP),2017,SSD-17/HSS10/SA2/NFI/INGO/6555,5/22/2018 8:04:46 AM,Internally Displaced People,11777,11371,8935,8528,40611,9394,10526,7166,8505,35591
19,South Sudan (UNDP),2017,SSD-17/HSS10/SA2/NFI/INGO/6555,5/22/2018 8:04:46 AM,Overall,11777,11371,8935,8528,40611,14268,16231,12811,15346,58656
19,South Sudan (UNDP),2017,SSD-17/HSS10/SA2/NFI/INGO/6568,7/24/2018 7:35:11 AM,Internally Displaced People,8225,9090,7867,8818,34000,11053,16225,15138,16690,59106
19,South Sudan (UNDP),2017,SSD-17/HSS10/SA2/NFI/INGO/6568,7/24/2018 7:35:11 AM,Other,960,1040,960,1040,4000,120,174,150,101,545
19,South Sudan (UNDP),2017,SSD-17/HSS10/SA2/NFI/INGO/6568,7/24/2018 7:35:11 AM,Overall,10433,11482,10075,11210,43200,12773,18420,17479,19057,67729
19,South Sudan (UNDP),2017,SSD-17/HSS10/SA2/NFI/INGO/6568,7/24/2018 7:35:11 AM,People in Host Communities,1248,1352,1248,1352,5200,1600,2021,2191,2266,8078
19,South Sudan (UNDP),2017,SSD-17/HSS10/SA2/NFI/NGO/6438,3/29/2018 11:55:35 AM,Internally Displaced People,5200,7800,0,0,13000,5188,5095,0,0,10283
19,South Sudan (UNDP),2017,SSD-17/HSS10/SA2/NFI/NGO/6438,3/29/2018 11:55:35 AM,Overall,5200,7800,0,0,13000,5188,5095,0,0,10283
19,South Sudan (UNDP),2017,SSD-17/HSS10/SA2/NFI/NGO/6470,8/8/2018 7:21:42 AM,Children under 5,0,0,464,974,1438,0,0,232,365,597
19,South Sudan (UNDP),2017,SSD-17/HSS10/SA2/NFI/NGO/6470,8/8/2018 7:21:42 AM,Internally Displaced People,1391,3245,1854,2782,9272,4268,6829,2561,3414,17072
19,South Sudan (UNDP),2017,SSD-17/HSS10/SA2/NFI/NGO/6470,8/8/2018 7:21:42 AM,Other,595,580,331,218,1724,410,332,103,374,1219
19,South Sudan (UNDP),2017,SSD-17/HSS10/SA2/NFI/NGO/6470,8/8/2018 7:21:42 AM,Overall,1986,4636,2649,3974,13245,1002,3526,8575,9660,22763
19,South Sudan (UNDP),2017,SSD-17/HSS10/SA2/NFI/NGO/6470,8/8/2018 7:21:42 AM,Pregnant and Lactating Women,0,811,0,0,811,0,3528,165,182,3875
19,South Sudan (UNDP),2017,SSD-17/HSS10/SA2/NFI/NGO/6486,4/9/2018 6:33:04 AM,Internally Displaced People,1920,2900,1625,3315,9760,1057,4276,1139,2084,8556
19,South Sudan (UNDP),2017,SSD-17/HSS10/SA2/NFI/NGO/6486,4/9/2018 6:33:04 AM,Overall,3200,4200,2500,5100,15000,2275,5201,1331,3125,11932
19,South Sudan (UNDP),2017,SSD-17/HSS10/SA2/NFI/NGO/6486,4/9/2018 6:33:04 AM,People in Host Communities,1280,1300,875,1785,5240,1218,925,192,1041,3376
19,South Sudan (UNDP),2017,SSD-17/HSS10/SA2/NFI/NGO/6494,6/4/2018 4:05:45 PM,Internally Displaced People,700,1000,700,817,3217,1103,1066,1163,1035,4367
19,South Sudan (UNDP),2017,SSD-17/HSS10/SA2/NFI/NGO/6494,6/4/2018 4:05:45 PM,Overall,1000,1783,1000,1217,5000,1669,2078,2015,2020,7782
19,South Sudan (UNDP),2017,SSD-17/HSS10/SA2/NFI/NGO/6494,6/4/2018 4:05:45 PM,People in Host Communities,300,500,300,300,1400,566,1009,855,985,3415
19,South Sudan (UNDP),2017,SSD-17/HSS10/SA2/NFI/NGO/6494,6/4/2018 4:05:45 PM,Pregnant and Lactating Women,0,283,0,100,383,0,0,0,0,0
19,South Sudan (UNDP),2017,SSD-17/HSS10/SA2/NFI/NGO/6504,3/29/2018 11:36:00 AM,Children under 5,0,0,102,148,250,0,0,953,1023,1976
19,South Sudan (UNDP),2017,SSD-17/HSS10/SA2/NFI/NGO/6504,3/29/2018 11:36:00 AM,Internally Displaced People,295,1377,520,740,2932,504,4535,2418,2620,10077
19,South Sudan (UNDP),2017,SSD-17/HSS10/SA2/NFI/NGO/6504,3/29/2018 11:36:00 AM,Overall,738,3443,1721,2295,8197,561,6024,3162,3425,13172
19,South Sudan (UNDP),2017,SSD-17/HSS10/SA2/NFI/NGO/6504,3/29/2018 11:36:00 AM,People in Host Communities,443,1916,1099,1407,4865,51,450,240,261,1002
19,South Sudan (UNDP),2017,SSD-17/HSS10/SA2/NFI/NGO/6504,3/29/2018 11:36:00 AM,Pregnant and Lactating Women,0,150,0,0,150,0,117,0,0,117
19,South Sudan (UNDP),2017,SSD-17/HSS10/SA2/NFI/UN/6539,1/29/2019 8:11:41 AM,Internally Displaced People,25078,34483,47022,50157,156740,25080,34483,47020,50157,156740
19,South Sudan (UNDP),2017,SSD-17/HSS10/SA2/NFI/UN/6539,1/29/2019 8:11:41 AM,Overall,25078,34483,47022,50157,156740,25080,34483,47020,50157,156740
19,South Sudan (UNDP),2017,SSD-17/HSS10/SA2/P/INGO/6452,6/5/2018 7:18:30 AM,Internally Displaced People,120,584,168,216,1088,80,65,6,1,152
19,South Sudan (UNDP),2017,SSD-17/HSS10/SA2/P/INGO/6452,6/5/2018 7:18:30 AM,Overall,150,730,210,270,1360,94,77,6,1,178
19,South Sudan (UNDP),2017,SSD-17/HSS10/SA2/P/INGO/6452,6/5/2018 7:18:30 AM,People in Host Communities,30,146,42,54,272,14,12,0,0,26
19,South Sudan (UNDP),2017,SSD-17/HSS10/SA2/P/INGO/6492,10/9/2018 1:59:15 PM,Internally Displaced People,457,939,1495,1990,4881,1259,4992,414,1526,8191
19,South Sudan (UNDP),2017,SSD-17/HSS10/SA2/P/INGO/6492,10/9/2018 1:59:15 PM,Overall,628,1257,1884,2513,6282,1716,6404,517,1908,10545
19,South Sudan (UNDP),2017,SSD-17/HSS10/SA2/P/INGO/6492,10/9/2018 1:59:15 PM,People in Host Communities,114,235,374,498,1221,323,1263,103,382,2071
19,South Sudan (UNDP),2017,SSD-17/HSS10/SA2/P/INGO/6492,10/9/2018 1:59:15 PM,"Trainers, Promoters, Caretakers, committee members, etc.",57,83,15,25,180,134,149,0,0,283
19,South Sudan (UNDP),2017,SSD-17/HSS10/SA2/P/INGO/6502,5/11/2018 11:19:36 AM,Internally Displaced People,260,1500,270,850,2880,1089,3791,503,1513,6896
19,South Sudan (UNDP),2017,SSD-17/HSS10/SA2/P/INGO/6502,5/11/2018 11:19:36 AM,Overall,495,2780,515,1580,5370,1785,6189,988,2040,11002
19,South Sudan (UNDP),2017,SSD-17/HSS10/SA2/P/INGO/6502,5/11/2018 11:19:36 AM,People in Host Communities,235,1280,245,720,2480,696,2405,485,520,4106
19,South Sudan (UNDP),2017,SSD-17/HSS10/SA2/P/INGO/6550,5/11/2018 9:06:51 AM,Combatants and Ex-Combatants,200,100,150,50,500,151,22,133,45,351
19,South Sudan (UNDP),2017,SSD-17/HSS10/SA2/P/INGO/6550,5/11/2018 9:06:51 AM,Internally Displaced People,600,600,3000,3000,7200,145,192,3499,2288,6124
19,South Sudan (UNDP),2017,SSD-17/HSS10/SA2/P/INGO/6550,5/11/2018 9:06:51 AM,Other,200,300,1850,1950,4300,160,122,2183,1567,4032
19,South Sudan (UNDP),2017,SSD-17/HSS10/SA2/P/INGO/6550,5/11/2018 9:06:51 AM,Overall,1000,1000,5000,5000,12000,456,336,5815,3900,10507
19,South Sudan (UNDP),2017,SSD-17/HSS10/SA2/P/INGO/6574,6/6/2018 10:46:37 AM,Children under 5,0,0,200,200,400,0,0,21,34,55
19,South Sudan (UNDP),2017,SSD-17/HSS10/SA2/P/INGO/6574,6/6/2018 10:46:37 AM,Internally Displaced People,40,40,700,700,1480,205,568,1820,2567,5160
19,South Sudan (UNDP),2017,SSD-17/HSS10/SA2/P/INGO/6574,6/6/2018 10:46:37 AM,Overall,70,70,1500,1500,3140,205,568,2383,3434,6590
19,South Sudan (UNDP),2017,SSD-17/HSS10/SA2/P/INGO/6574,6/6/2018 10:46:37 AM,People in Host Communities,30,30,600,600,1260,0,40,514,821,1375
19,South Sudan (UNDP),2017,SSD-17/HSS10/SA2/P/INGO/6598,4/11/2018 6:26:00 AM,Internally Displaced People,150,1300,650,975,3075,914,356,85,150,1505
19,South Sudan (UNDP),2017,SSD-17/HSS10/SA2/P/INGO/6598,4/11/2018 6:26:00 AM,Overall,650,2600,1300,1950,6500,3366,5061,2554,3358,14339
19,South Sudan (UNDP),2017,SSD-17/HSS10/SA2/P/INGO/6598,4/11/2018 6:26:00 AM,People in Host Communities,400,1300,650,975,3325,2452,4628,2469,3208,12757
19,South Sudan (UNDP),2017,SSD-17/HSS10/SA2/P/INGO/6598,4/11/2018 6:26:00 AM,Pregnant and Lactating Women,0,0,0,0,0,0,77,0,0,77
19,South Sudan (UNDP),2017,SSD-17/HSS10/SA2/P/INGO/6604,10/9/2018 1:52:46 PM,Aid Agencies,410,410,0,0,820,289,168,0,0,457
19,South Sudan (UNDP),2017,SSD-17/HSS10/SA2/P/INGO/6604,10/9/2018 1:52:46 PM,Internally Displaced People,475,505,580,580,2140,276,420,147,191,1034
19,South Sudan (UNDP),2017,SSD-17/HSS10/SA2/P/INGO/6604,10/9/2018 1:52:46 PM,Overall,1591,1781,2138,1908,7418,1377,1735,1616,1605,6333
19,South Sudan (UNDP),2017,SSD-17/HSS10/SA2/P/INGO/6604,10/9/2018 1:52:46 PM,People in Host Communities,487,607,1208,978,3280,812,1122,1469,1439,4842
19,South Sudan (UNDP),2017,SSD-17/HSS10/SA2/P/INGO/6604,10/9/2018 1:52:46 PM,Refugee Returnees,219,259,350,350,1178,0,0,0,0,0
19,South Sudan (UNDP),2017,SSD-17/HSS10/SA2/P/NGO/6491,5/11/2018 11:42:40 AM,Internally Displaced People,400,800,1500,1500,4200,448,805,1699,1291,4243
19,South Sudan (UNDP),2017,SSD-17/HSS10/SA2/P/NGO/6491,5/11/2018 11:42:40 AM,Overall,1000,1500,3000,3000,8500,1199,1901,3960,3012,10072
19,South Sudan (UNDP),2017,SSD-17/HSS10/SA2/P/NGO/6491,5/11/2018 11:42:40 AM,People in Host Communities,500,600,1400,1400,3900,574,1028,2139,1658,5399
19,South Sudan (UNDP),2017,SSD-17/HSS10/SA2/P/NGO/6491,5/11/2018 11:42:40 AM,"Trainers, Promoters, Caretakers, committee members, etc.",100,100,100,100,400,168,77,122,63,430
19,South Sudan (UNDP),2017,SSD-17/HSS10/SA2/P/NGO/6493,4/9/2018 8:17:47 AM,Internally Displaced People,90,100,1060,1360,2610,46,4,1120,1300,2470
19,South Sudan (UNDP),2017,SSD-17/HSS10/SA2/P/NGO/6493,4/9/2018 8:17:47 AM,Overall,150,200,1460,1760,3570,63,9,1340,1580,2992
19,South Sudan (UNDP),2017,SSD-17/HSS10/SA2/P/NGO/6493,4/9/2018 8:17:47 AM,People in Host Communities,60,100,400,400,960,17,5,220,280,522
19,South Sudan (UNDP),2017,SSD-17/HSS10/SA2/P/NGO/6517,4/12/2018 8:58:49 AM,Internally Displaced People,0,0,6085,6085,12170,0,0,6062,6132,12194
19,South Sudan (UNDP),2017,SSD-17/HSS10/SA2/P/NGO/6517,4/12/2018 8:58:49 AM,Overall,100,140,6085,6085,12410,161,248,6062,6132,12603
19,South Sudan (UNDP),2017,SSD-17/HSS10/SA2/P/NGO/6517,4/12/2018 8:58:49 AM,"Trainers, Promoters, Caretakers, committee members, etc.",100,140,0,0,240,161,248,0,0,409
19,South Sudan (UNDP),2017,SSD-17/HSS10/SA2/P/NGO/6537,4/4/2018 10:27:41 AM,Internally Displaced People,100,500,420,550,1570,109,746,398,458,1711
19,South Sudan (UNDP),2017,SSD-17/HSS10/SA2/P/NGO/6537,4/4/2018 10:27:41 AM,Overall,167,871,620,912,2570,231,1524,763,954,3472
19,South Sudan (UNDP),2017,SSD-17/HSS10/SA2/P/NGO/6537,4/4/2018 10:27:41 AM,People in Host Communities,60,348,200,362,970,116,757,365,496,1734
19,South Sudan (UNDP),2017,SSD-17/HSS10/SA2/P/NGO/6537,4/4/2018 10:27:41 AM,"Trainers, Promoters, Caretakers, committee members, etc.",7,23,0,0,30,6,21,0,0,27
19,South Sudan (UNDP),2017,SSD-17/HSS10/SA2/P/NGO/6544,2/14/2018 11:06:00 AM,Children under 5,0,0,800,700,1500,0,0,526,597,1123
19,South Sudan (UNDP),2017,SSD-17/HSS10/SA2/P/NGO/6544,2/14/2018 11:06:00 AM,Internally Displaced People,150,350,1200,950,2650,179,478,1543,1081,3281
19,South Sudan (UNDP),2017,SSD-17/HSS10/SA2/P/NGO/6544,2/14/2018 11:06:00 AM,Overall,266,766,5000,4500,10532,579,1365,4606,3580,10130
19,South Sudan (UNDP),2017,SSD-17/HSS10/SA2/P/NGO/6544,2/14/2018 11:06:00 AM,People in Host Communities,100,400,3000,2850,6350,344,831,2537,1902,5614
19,South Sudan (UNDP),2017,SSD-17/HSS10/SA2/P/NGO/6544,2/14/2018 11:06:00 AM,"Trainers, Promoters, Caretakers, committee members, etc.",16,16,0,0,32,56,56,0,0,112
19,South Sudan (UNDP),2017,SSD-17/HSS10/SA2/P/NGO/6546,4/9/2018 8:46:54 AM,Internally Displaced People,250,250,950,950,2400,245,268,986,971,2470
19,South Sudan (UNDP),2017,SSD-17/HSS10/SA2/P/NGO/6546,4/9/2018 8:46:54 AM,Other,30,30,50,50,160,35,35,63,80,213
19,South Sudan (UNDP),2017,SSD-17/HSS10/SA2/P/NGO/6546,4/9/2018 8:46:54 AM,Overall,550,550,1500,1500,4100,562,676,1748,1889,4875
19,South Sudan (UNDP),2017,SSD-17/HSS10/SA2/P/NGO/6546,4/9/2018 8:46:54 AM,People in Host Communities,150,150,450,450,1200,157,251,639,755,1802
19,South Sudan (UNDP),2017,SSD-17/HSS10/SA2/P/NGO/6546,4/9/2018 8:46:54 AM,"Trainers, Promoters, Caretakers, committee members, etc.",120,120,50,50,340,125,122,60,83,390
19,South Sudan (UNDP),2017,SSD-17/HSS10/SA2/P/NGO/6573,4/11/2018 6:08:01 AM,Internally Displaced People,600,1500,500,1000,3600,650,1950,600,1100,4300
19,South Sudan (UNDP),2017,SSD-17/HSS10/SA2/P/NGO/6573,4/11/2018 6:08:01 AM,Overall,1000,2500,1000,1500,6000,1100,3000,1000,1800,6900
19,South Sudan (UNDP),2017,SSD-17/HSS10/SA2/P/NGO/6573,4/11/2018 6:08:01 AM,People in Host Communities,350,950,500,500,2300,400,1000,400,700,2500
19,South Sudan (UNDP),2017,SSD-17/HSS10/SA2/P/NGO/6573,4/11/2018 6:08:01 AM,"Trainers, Promoters, Caretakers, committee members, etc.",50,50,0,0,100,50,50,0,0,100
19,South Sudan (UNDP),2017,SSD-17/HSS10/SA2/P/NGO/6584,4/11/2018 7:12:26 AM,Internally Displaced People,800,900,600,650,2950,867,1037,713,655,3272
19,South Sudan (UNDP),2017,SSD-17/HSS10/SA2/P/NGO/6584,4/11/2018 7:12:26 AM,Overall,1100,1500,700,700,4000,1290,1650,760,815,4515
19,South Sudan (UNDP),2017,SSD-17/HSS10/SA2/P/NGO/6584,4/11/2018 7:12:26 AM,People in Host Communities,200,400,0,0,600,235,490,0,0,725
19,South Sudan (UNDP),2017,SSD-17/HSS10/SA2/P/NGO/6584,4/11/2018 7:12:26 AM,"Trainers, Promoters, Caretakers, committee members, etc.",100,200,100,50,450,150,201,110,57,518
19,South Sudan (UNDP),2017,SSD-17/HSS10/SA2/P/UN/6515,10/9/2018 2:01:55 PM,Internally Displaced People,0,3000,0,1000,4000,0,3430,0,1430,4860
19,South Sudan (UNDP),2017,SSD-17/HSS10/SA2/P/UN/6515,10/9/2018 2:01:55 PM,Overall,0,5000,0,2000,7000,0,5114,0,1926,7040
19,South Sudan (UNDP),2017,SSD-17/HSS10/SA2/P/UN/6515,10/9/2018 2:01:55 PM,People in Host Communities,0,1000,0,1000,2000,0,1083,0,496,1579
19,South Sudan (UNDP),2017,SSD-17/HSS10/SA2/P/UN/6515,10/9/2018 2:01:55 PM,Pregnant and Lactating Women,0,1000,0,0,1000,0,601,0,0,601
19,South Sudan (UNDP),2017,SSD-17/HSS10/SA2/P/UN/6554,6/6/2018 11:02:46 AM,Internally Displaced People,400,1150,2400,2600,6550,2304,2081,7676,6752,18813
19,South Sudan (UNDP),2017,SSD-17/HSS10/SA2/P/UN/6554,6/6/2018 11:02:46 AM,Overall,500,1250,2400,2600,6750,2422,2383,7676,6752,19233
19,South Sudan (UNDP),2017,SSD-17/HSS10/SA2/P/UN/6554,6/6/2018 11:02:46 AM,People in Host Communities,100,100,0,0,200,120,300,0,0,420
19,South Sudan (UNDP),2017,SSD-17/HSS10/SA2/WASH/INGO/6480,9/5/2018 11:56:00 AM,Children under 5,0,0,704,1056,1760,0,0,1682,3594,5276
19,South Sudan (UNDP),2017,SSD-17/HSS10/SA2/WASH/INGO/6480,9/5/2018 11:56:00 AM,Internally Displaced People,625,875,375,625,2500,811,1232,811,788,3642
19,South Sudan (UNDP),2017,SSD-17/HSS10/SA2/WASH/INGO/6480,9/5/2018 11:56:00 AM,Overall,5500,7700,3300,5500,22000,9478,8325,5637,5833,29273
19,South Sudan (UNDP),2017,SSD-17/HSS10/SA2/WASH/INGO/6503,10/29/2018 1:45:16 PM,Internally Displaced People,1790,2840,2750,3850,11230,1728,2592,2600,3880,10800
19,South Sudan (UNDP),2017,SSD-17/HSS10/SA2/WASH/INGO/6503,10/29/2018 1:45:16 PM,Overall,2550,4650,3800,5500,16500,2888,4332,4324,6487,18031
19,South Sudan (UNDP),2017,SSD-17/HSS10/SA2/WASH/INGO/6503,10/29/2018 1:45:16 PM,People in Host Communities,756,1713,1042,1636,5147,1152,1728,1728,2592,7200
19,South Sudan (UNDP),2017,SSD-17/HSS10/SA2/WASH/INGO/6503,10/29/2018 1:45:16 PM,"Trainers, Promoters, Caretakers, committee members, etc.",4,7,8,14,33,8,12,4,7,31
19,South Sudan (UNDP),2017,SSD-17/HSS10/SA2/WASH/INGO/6519,5/25/2018 10:29:09 AM,Overall,11760,12740,12240,13260,50000,16923,21409,9142,14716,62190
19,South Sudan (UNDP),2017,SSD-17/HSS10/SA2/WASH/INGO/6527,11/15/2018 6:51:45 AM,Internally Displaced People,461,249,683,660,2053,550,587,685,678,2500
19,South Sudan (UNDP),2017,SSD-17/HSS10/SA2/WASH/INGO/6527,11/15/2018 6:51:45 AM,Overall,2240,2660,4620,4480,14000,3801,4383,3679,5261,17124
19,South Sudan (UNDP),2017,SSD-17/HSS10/SA2/WASH/INGO/6535,5/25/2018 11:04:16 AM,Children under 5,0,0,1043,1236,2279,0,0,1854,1516,3370
19,South Sudan (UNDP),2017,SSD-17/HSS10/SA2/WASH/INGO/6535,5/25/2018 11:04:16 AM,Internally Displaced People,1071,1288,788,836,3983,496,1049,1908,965,4418
19,South Sudan (UNDP),2017,SSD-17/HSS10/SA2/WASH/INGO/6535,5/25/2018 11:04:16 AM,Overall,4023,5238,4339,4710,18310,3797,5531,5886,5299,20513
19,South Sudan (UNDP),2017,SSD-17/HSS10/SA2/WASH/INGO/6535,5/25/2018 11:04:16 AM,People in Host Communities,2952,3625,2508,2638,11723,3301,4087,2124,2818,12330
19,South Sudan (UNDP),2017,SSD-17/HSS10/SA2/WASH/INGO/6535,5/25/2018 11:04:16 AM,Pregnant and Lactating Women,0,325,0,0,325,0,395,0,0,395
19,South Sudan (UNDP),2017,SSD-17/HSS10/SA2/WASH/NGO/6440,5/25/2018 10:32:19 AM,Internally Displaced People,2520,6720,4200,3360,16800,5754,9159,11083,11444,37440
19,South Sudan (UNDP),2017,SSD-17/HSS10/SA2/WASH/NGO/6440,5/25/2018 10:32:19 AM,Other,1320,3520,2200,1760,8800,1060,1561,1810,1849,6280
19,South Sudan (UNDP),2017,SSD-17/HSS10/SA2/WASH/NGO/6440,5/25/2018 10:32:19 AM,Overall,6000,16000,10000,8000,40000,9592,15852,18335,18498,62277
19,South Sudan (UNDP),2017,SSD-17/HSS10/SA2/WASH/NGO/6440,5/25/2018 10:32:19 AM,People in Host Communities,2160,5760,3600,2880,14400,2878,4687,5542,5450,18557
19,South Sudan (UNDP),2017,SSD-17/HSS10/SA2/WASH/NGO/6444,3/29/2018 12:00:38 PM,Children under 5,0,0,800,1569,2369,0,0,1400,2000,3400
19,South Sudan (UNDP),2017,SSD-17/HSS10/SA2/WASH/NGO/6444,3/29/2018 12:00:38 PM,Overall,3200,4500,1253,2169,11122,3390,5200,2000,3610,14200
19,South Sudan (UNDP),2017,SSD-17/HSS10/SA2/WASH/NGO/6444,3/29/2018 12:00:38 PM,People in Host Communities,2690,3490,453,600,7233,3182,3677,600,1610,9069
19,South Sudan (UNDP),2017,SSD-17/HSS10/SA2/WASH/NGO/6444,3/29/2018 12:00:38 PM,Pregnant and Lactating Women,0,410,0,0,410,0,1451,0,0,1451
19,South Sudan (UNDP),2017,SSD-17/HSS10/SA2/WASH/NGO/6444,3/29/2018 12:00:38 PM,"Trainers, Promoters, Caretakers, committee members, etc.",510,600,0,0,1110,208,72,0,0,280
19,South Sudan (UNDP),2017,SSD-17/HSS10/SA2/WASH/NGO/6445,3/22/2018 7:16:18 AM,Internally Displaced People,1498,1987,1463,1604,6552,1911,2308,1323,1610,7152
19,South Sudan (UNDP),2017,SSD-17/HSS10/SA2/WASH/NGO/6445,3/22/2018 7:16:18 AM,Overall,4995,6623,4877,5605,22100,6370,7693,4411,5368,23842
19,South Sudan (UNDP),2017,SSD-17/HSS10/SA2/WASH/NGO/6445,3/22/2018 7:16:18 AM,People in Host Communities,3497,4636,3414,3743,15290,4459,5385,3088,3758,16690
19,South Sudan (UNDP),2017,SSD-17/HSS10/SA2/WASH/NGO/6468,3/23/2018 12:47:34 PM,Internally Displaced People,1100,2000,1000,1000,5100,1749,2310,2119,1800,7978
19,South Sudan (UNDP),2017,SSD-17/HSS10/SA2/WASH/NGO/6468,3/23/2018 12:47:34 PM,Overall,2100,3400,1500,1663,8663,2973,3555,2649,3106,12283
19,South Sudan (UNDP),2017,SSD-17/HSS10/SA2/WASH/NGO/6468,3/23/2018 12:47:34 PM,People in Host Communities,1000,1400,500,663,3563,1224,1245,530,1306,4305
19,South Sudan (UNDP),2017,SSD-17/HSS10/SA2/WASH/NGO/6483,3/23/2018 2:57:43 PM,Internally Displaced People,2630,8700,3500,4500,19330,3210,9760,4580,5100,22650
19,South Sudan (UNDP),2017,SSD-17/HSS10/SA2/WASH/NGO/6483,3/23/2018 2:57:43 PM,Overall,4460,12355,5800,7900,30515,5110,13815,7240,9050,35215
19,South Sudan (UNDP),2017,SSD-17/HSS10/SA2/WASH/NGO/6483,3/23/2018 2:57:43 PM,People in Host Communities,1830,3655,2300,3400,11185,1900,4055,2660,3950,12565
19,South Sudan (UNDP),2017,SSD-17/HSS10/SA2/WASH/NGO/6513,3/29/2018 11:40:17 AM,Internally Displaced People,1250,1875,0,0,3125,1566,1559,0,0,3125
19,South Sudan (UNDP),2017,SSD-17/HSS10/SA2/WASH/NGO/6513,3/29/2018 11:40:17 AM,Overall,1250,1875,0,0,3125,1566,1559,0,0,3125
19,South Sudan (UNDP),2017,SSD-17/HSS10/SA2/WASH/NGO/6545,2/23/2018 7:12:37 AM,Internally Displaced People,4000,5000,4000,5000,18000,9212,6506,8989,12675,37382
19,South Sudan (UNDP),2017,SSD-17/HSS10/SA2/WASH/NGO/6545,2/23/2018 7:12:37 AM,Overall,5000,7000,6000,7000,25000,12423,13621,12647,16444,55135
19,South Sudan (UNDP),2017,SSD-17/HSS10/SA2/WASH/NGO/6545,2/23/2018 7:12:37 AM,People in Host Communities,1000,2000,2000,2000,7000,3211,7115,3658,3769,17753
19,South Sudan (UNDP),2017,SSD-17/HSS10/SA2/WASH/NGO/6593,2/16/2018 11:59:43 AM,Internally Displaced People,819,1209,367,274,2669,1020,1500,480,320,3320
19,South Sudan (UNDP),2017,SSD-17/HSS10/SA2/WASH/NGO/6593,2/16/2018 11:59:43 AM,Overall,2340,3760,1507,1046,8653,2640,4060,1800,1280,9780
19,South Sudan (UNDP),2017,SSD-17/HSS10/SA2/WASH/NGO/6593,2/16/2018 11:59:43 AM,People in Host Communities,1121,2011,980,644,4756,1280,2289,1064,780,5413
19,South Sudan (UNDP),2017,SSD-17/HSS10/SA2/WASH/NGO/6593,2/16/2018 11:59:43 AM,Refugee Returnees,388,528,156,128,1200,440,540,140,110,1230
19,South Sudan (UNDP),2017,SSD-17/HSS10/SA2/WASH/NGO/6593,2/16/2018 11:59:43 AM,"Trainers, Promoters, Caretakers, committee members, etc.",12,12,0,0,24,12,4,0,0,16
19,South Sudan (UNDP),2017,SSD-17/HSS10/SA2/WASH/UN/6462,3/23/2018 9:05:49 AM,Overall,28500,49500,34500,37500,150000,28500,49500,34500,37500,150000
19,South Sudan (UNDP),2017,SSD-17/HSS10/SA2/WASH/UN/6462,3/23/2018 9:05:49 AM,Pastoralists,5700,9900,6900,7500,30000,8979,15594,10869,11814,47256
19,South Sudan (UNDP),2017,SSD-17/HSS10/SA2/WASH/UN/6462,3/23/2018 9:05:49 AM,People in Host Communities,22800,39600,27600,30000,120000,19952,34652,24152,26252,105008
19,South Sudan (UNDP),2017,SSD-17/HSS10/SA2/WASH/UN/6465,4/5/2018 9:39:52 AM,Overall,7500,45000,17500,55000,125000,8104,48620,18907,59423,135054
19,South Sudan (UNDP),2018,SSD-18/HSS10/RA1/H/INGO/11268,11/6/2019 5:55:43 AM,Overall,45435,47305,12079,12572,117391,226786,130568,23824,22913,404091
19,South Sudan (UNDP),2018,SSD-18/HSS10/RA1/H/INGO/11297,11/17/2020 9:41:35 AM,Overall,350,150,0,0,500,353,154,0,0,507
19,South Sudan (UNDP),2018,SSD-18/HSS10/RA1/H/INGO/11427,12/5/2019 11:04:07 AM,Internally Displaced People,1200,1000,350,480,3030,0,0,0,0,0
19,South Sudan (UNDP),2018,SSD-18/HSS10/RA1/H/INGO/11427,12/5/2019 11:04:07 AM,Other,3800,2700,1300,1220,9020,16250,21558,8550,8550,54908
19,South Sudan (UNDP),2018,SSD-18/HSS10/RA1/H/INGO/11427,12/5/2019 11:04:07 AM,Overall,18500,22000,8641,9600,58741,16250,21558,8550,8550,54908
19,South Sudan (UNDP),2018,SSD-18/HSS10/RA1/H/NGO/11428,11/5/2019 8:39:55 AM,Internally Displaced People,949,945,304,302,2500,0,0,0,0,0
19,South Sudan (UNDP),2018,SSD-18/HSS10/RA1/H/NGO/11428,11/5/2019 8:39:55 AM,Other,0,0,0,0,0,7478,7952,3093,3268,21791
19,South Sudan (UNDP),2018,SSD-18/HSS10/RA1/H/NGO/11428,11/5/2019 8:39:55 AM,Overall,3797,3779,1215,1209,10000,7478,7952,3093,3268,21791
19,South Sudan (UNDP),2018,SSD-18/HSS10/RA1/L/UN/11248,6/20/2019 9:14:32 AM,Other,6,6,6,6,24,0,0,0,0,0
19,South Sudan (UNDP),2018,SSD-18/HSS10/RA1/L/UN/11248,6/20/2019 9:14:32 AM,Overall,6,6,6,6,24,6,6,6,6,24
19,South Sudan (UNDP),2018,SSD-18/HSS10/SA1/CCCM/NGO/7921,3/28/2019 6:18:32 AM,Internally Displaced People,4123,9065,6163,8137,27488,4123,9065,6618,8162,27968
19,South Sudan (UNDP),2018,SSD-18/HSS10/SA1/CCCM/NGO/7921,3/28/2019 6:18:32 AM,Overall,7733,17000,11559,15261,51553,7736,17235,11568,15679,52218
19,South Sudan (UNDP),2018,SSD-18/HSS10/SA1/CCCM/NGO/7921,3/28/2019 6:18:32 AM,People in Host Communities,3610,7935,5396,7124,24065,3635,7935,5446,7234,24250
19,South Sudan (UNDP),2018,SSD-18/HSS10/SA1/CCCM/NGO/8266,5/27/2019 2:11:53 PM,Internally Displaced People,3062,3576,4338,4946,15922,3737,5265,6283,7215,22500
19,South Sudan (UNDP),2018,SSD-18/HSS10/SA1/CCCM/NGO/8266,5/27/2019 2:11:53 PM,Overall,3062,3576,4338,4946,15922,3737,5265,6283,7215,22500
19,South Sudan (UNDP),2018,SSD-18/HSS10/SA1/CCCM/UN/7890,4/24/2019 1:38:22 PM,Internally Displaced People,5254,6760,6265,6138,24417,4981,6679,5935,5748,23343
19,South Sudan (UNDP),2018,SSD-18/HSS10/SA1/CCCM/UN/7890,4/24/2019 1:38:22 PM,Overall,5254,6760,6265,6138,24417,4981,6679,5935,5748,23343
19,South Sudan (UNDP),2018,SSD-18/HSS10/SA1/E/INGO/7954,1/22/2019 9:20:58 AM,Internally Displaced People,75,60,1098,732,1965,52,62,1679,964,2757
19,South Sudan (UNDP),2018,SSD-18/HSS10/SA1/E/INGO/7954,1/22/2019 9:20:58 AM,Overall,251,201,3660,2440,6552,150,177,4796,2756,7879
19,South Sudan (UNDP),2018,SSD-18/HSS10/SA1/E/INGO/7954,1/22/2019 9:20:58 AM,People in Host Communities,176,141,2562,1708,4587,97,115,3118,1792,5122
19,South Sudan (UNDP),2018,SSD-18/HSS10/SA1/E/INGO/7997,4/10/2019 5:29:14 AM,Internally Displaced People,260,111,1725,844,2940,0,0,0,0,0
19,South Sudan (UNDP),2018,SSD-18/HSS10/SA1/E/INGO/7997,4/10/2019 5:29:14 AM,Overall,371,159,2464,1206,4200,385,215,3349,2110,6059
19,South Sudan (UNDP),2018,SSD-18/HSS10/SA1/E/INGO/7997,4/10/2019 5:29:14 AM,People in Host Communities,111,48,739,362,1260,385,215,3349,2110,6059
19,South Sudan (UNDP),2018,SSD-18/HSS10/SA1/E/INGO/8126,2/1/2019 6:12:51 AM,Children under 5,0,0,1288,1100,2388,0,0,416,486,902
19,South Sudan (UNDP),2018,SSD-18/HSS10/SA1/E/INGO/8126,2/1/2019 6:12:51 AM,Internally Displaced People,100,50,685,480,1315,0,0,3627,1213,4840
19,South Sudan (UNDP),2018,SSD-18/HSS10/SA1/E/INGO/8126,2/1/2019 6:12:51 AM,Overall,205,75,3323,2845,6448,180,100,6460,3570,10310
19,South Sudan (UNDP),2018,SSD-18/HSS10/SA1/E/INGO/8126,2/1/2019 6:12:51 AM,People in Host Communities,95,15,1350,1265,2725,0,0,2417,1871,4288
19,South Sudan (UNDP),2018,SSD-18/HSS10/SA1/E/INGO/8126,2/1/2019 6:12:51 AM,"Trainers, Promoters, Caretakers, committee members, etc.",10,10,0,0,20,180,100,0,0,280
19,South Sudan (UNDP),2018,SSD-18/HSS10/SA1/E/INGO/8191,2/4/2019 5:29:32 AM,Internally Displaced People,1000,900,300,300,2500,3050,902,610,600,5162
19,South Sudan (UNDP),2018,SSD-18/HSS10/SA1/E/INGO/8191,2/4/2019 5:29:32 AM,Overall,1580,1420,500,500,4000,3790,1287,950,1023,7050
19,South Sudan (UNDP),2018,SSD-18/HSS10/SA1/E/INGO/8191,2/4/2019 5:29:32 AM,People in Host Communities,580,520,200,200,1500,740,385,340,423,1888
19,South Sudan (UNDP),2018,SSD-18/HSS10/SA1/E/NGO/7880,1/29/2019 8:03:46 AM,Internally Displaced People,0,0,2817,1728,4545,168,120,3718,2157,6163
19,South Sudan (UNDP),2018,SSD-18/HSS10/SA1/E/NGO/7880,1/29/2019 8:03:46 AM,Overall,173,214,6259,3841,10487,611,495,9295,5891,16292
19,South Sudan (UNDP),2018,SSD-18/HSS10/SA1/E/NGO/7880,1/29/2019 8:03:46 AM,People in Host Communities,0,0,3442,2113,5555,251,180,5577,3734,9742
19,South Sudan (UNDP),2018,SSD-18/HSS10/SA1/E/NGO/7880,1/29/2019 8:03:46 AM,"Trainers, Promoters, Caretakers, committee members, etc.",173,214,0,0,387,192,195,0,0,387
19,South Sudan (UNDP),2018,SSD-18/HSS10/SA1/E/NGO/8036,1/30/2019 12:15:47 PM,Internally Displaced People,40,35,1900,1640,3615,54,28,1043,991,2116
19,South Sudan (UNDP),2018,SSD-18/HSS10/SA1/E/NGO/8036,1/30/2019 12:15:47 PM,Overall,75,55,2860,2140,5130,92,44,1746,1451,3333
19,South Sudan (UNDP),2018,SSD-18/HSS10/SA1/E/NGO/8036,1/30/2019 12:15:47 PM,People in Host Communities,35,20,960,500,1515,38,16,703,460,1217
19,South Sudan (UNDP),2018,SSD-18/HSS10/SA1/E/NGO/8144,1/29/2019 8:56:26 AM,Internally Displaced People,100,40,1900,1000,3040,120,60,2426,1280,3886
19,South Sudan (UNDP),2018,SSD-18/HSS10/SA1/E/NGO/8144,1/29/2019 8:56:26 AM,Overall,240,120,4200,2400,6960,240,120,4850,2559,7769
19,South Sudan (UNDP),2018,SSD-18/HSS10/SA1/E/NGO/8144,1/29/2019 8:56:26 AM,People in Host Communities,120,60,2100,1200,3480,96,48,1940,1023,3107
19,South Sudan (UNDP),2018,SSD-18/HSS10/SA1/E/NGO/8144,1/29/2019 8:56:26 AM,Refugee Returnees,20,20,200,200,440,24,12,485,255,776
19,South Sudan (UNDP),2018,SSD-18/HSS10/SA1/FSL/INGO/7965,11/15/2018 1:00:29 PM,Internally Displaced People,1500,1500,4500,4500,12000,4122,11200,950,1900,18172
19,South Sudan (UNDP),2018,SSD-18/HSS10/SA1/FSL/INGO/7965,11/15/2018 1:00:29 PM,Other,500,500,1000,1000,3000,411,234,64,54,763
19,South Sudan (UNDP),2018,SSD-18/HSS10/SA1/FSL/INGO/7965,11/15/2018 1:00:29 PM,Overall,3000,3000,7500,7500,21000,5538,12384,1074,2004,21000
19,South Sudan (UNDP),2018,SSD-18/HSS10/SA1/FSL/INGO/7965,11/15/2018 1:00:29 PM,People in Host Communities,1000,1000,2000,2000,6000,1005,950,60,50,2065
19,South Sudan (UNDP),2018,SSD-18/HSS10/SA1/FSL/INGO/8008,1/21/2019 5:25:31 AM,Internally Displaced People,2453,2400,1973,1905,8731,463,550,955,926,2894
19,South Sudan (UNDP),2018,SSD-18/HSS10/SA1/FSL/INGO/8008,1/21/2019 5:25:31 AM,Overall,8177,8003,6576,6344,29100,4631,5498,9549,9260,28938
19,South Sudan (UNDP),2018,SSD-18/HSS10/SA1/FSL/INGO/8008,1/21/2019 5:25:31 AM,People in Host Communities,4907,4803,3946,3802,17458,4029,4783,8308,8056,25176
19,South Sudan (UNDP),2018,SSD-18/HSS10/SA1/FSL/INGO/8008,1/21/2019 5:25:31 AM,Refugee Returnees,817,800,657,637,2911,139,165,286,278,868
19,South Sudan (UNDP),2018,SSD-18/HSS10/SA1/FSL/INGO/8190,11/15/2018 1:38:17 PM,Internally Displaced People,0,0,0,0,0,3600,10614,18,108,14340
19,South Sudan (UNDP),2018,SSD-18/HSS10/SA1/FSL/INGO/8190,11/15/2018 1:38:17 PM,Overall,9384,10170,3126,3390,26070,7938,18036,18,108,26100
19,South Sudan (UNDP),2018,SSD-18/HSS10/SA1/FSL/INGO/8255,11/15/2018 1:37:22 PM,Internally Displaced People,1175,2190,295,540,4200,0,0,0,0,0
19,South Sudan (UNDP),2018,SSD-18/HSS10/SA1/FSL/INGO/8255,11/15/2018 1:37:22 PM,Overall,21840,40560,5460,10140,78000,35100,42900,0,0,78000
19,South Sudan (UNDP),2018,SSD-18/HSS10/SA1/FSL/INGO/8255,11/15/2018 1:37:22 PM,People in Host Communities,20665,38370,5165,9600,73800,35100,42900,0,0,78000
19,South Sudan (UNDP),2018,SSD-18/HSS10/SA1/FSL/NGO/7929,11/15/2018 12:57:30 PM,Internally Displaced People,6390,10650,2130,2130,21300,5826,18487,384,592,25289
19,South Sudan (UNDP),2018,SSD-18/HSS10/SA1/FSL/NGO/7929,11/15/2018 12:57:30 PM,Overall,12780,21300,4260,4260,42600,9120,29028,762,1890,40800
19,South Sudan (UNDP),2018,SSD-18/HSS10/SA1/FSL/NGO/7929,11/15/2018 12:57:30 PM,People in Host Communities,3834,6390,1278,1278,12780,2580,4658,256,809,8303
19,South Sudan (UNDP),2018,SSD-18/HSS10/SA1/FSL/NGO/7929,11/15/2018 12:57:30 PM,Refugee Returnees,2556,4260,852,852,8520,2382,5873,122,489,8866
19,South Sudan (UNDP),2018,SSD-18/HSS10/SA1/FSL/NGO/7947,11/15/2018 12:58:26 PM,Internally Displaced People,1500,8000,1500,1700,12700,300,900,300,400,1900
19,South Sudan (UNDP),2018,SSD-18/HSS10/SA1/FSL/NGO/7947,11/15/2018 12:58:26 PM,Overall,3500,11300,3000,3200,21000,3500,11300,3000,3200,21000
19,South Sudan (UNDP),2018,SSD-18/HSS10/SA1/FSL/NGO/7947,11/15/2018 12:58:26 PM,People in Host Communities,1200,2100,1000,700,5000,270,550,250,300,1370
19,South Sudan (UNDP),2018,SSD-18/HSS10/SA1/FSL/NGO/7947,11/15/2018 12:58:26 PM,Refugee Returnees,800,1200,500,600,3100,380,650,300,400,1730
19,South Sudan (UNDP),2018,SSD-18/HSS10/SA1/FSL/NGO/8046,11/15/2018 1:36:26 PM,Internally Displaced People,2612,3917,3917,5876,16322,3142,3912,3913,5484,16451
19,South Sudan (UNDP),2018,SSD-18/HSS10/SA1/FSL/NGO/8046,11/15/2018 1:36:26 PM,Overall,6528,9792,9792,14688,40800,7028,9802,9788,14284,40902
19,South Sudan (UNDP),2018,SSD-18/HSS10/SA1/FSL/NGO/8046,11/15/2018 1:36:26 PM,People in Host Communities,3916,5875,5875,8812,24478,3886,5890,5875,8800,24451
19,South Sudan (UNDP),2018,SSD-18/HSS10/SA1/FSL/NGO/8069,11/15/2018 1:40:06 PM,Internally Displaced People,710,1050,70,45,1875,710,1050,70,45,1875
19,South Sudan (UNDP),2018,SSD-18/HSS10/SA1/FSL/NGO/8069,11/15/2018 1:40:06 PM,Overall,1268,2012,135,85,3500,1268,2012,135,85,3500
19,South Sudan (UNDP),2018,SSD-18/HSS10/SA1/FSL/NGO/8069,11/15/2018 1:40:06 PM,People in Host Communities,558,962,65,40,1625,558,962,65,40,1625
19,South Sudan (UNDP),2018,SSD-18/HSS10/SA1/FSL/NGO/8089,11/15/2018 1:02:19 PM,Internally Displaced People,2500,2500,5000,5000,15000,3300,3145,7200,8100,21745
19,South Sudan (UNDP),2018,SSD-18/HSS10/SA1/FSL/NGO/8089,11/15/2018 1:02:19 PM,Other,500,500,1500,1500,4000,250,505,1250,700,2705
19,South Sudan (UNDP),2018,SSD-18/HSS10/SA1/FSL/NGO/8089,11/15/2018 1:02:19 PM,Overall,4000,4000,9500,9500,27000,4000,4000,9500,9500,27000
19,South Sudan (UNDP),2018,SSD-18/HSS10/SA1/FSL/NGO/8089,11/15/2018 1:02:19 PM,People in Host Communities,1000,1000,3000,3000,8000,450,350,1050,700,2550
19,South Sudan (UNDP),2018,SSD-18/HSS10/SA1/FSL/NGO/8252,11/15/2018 1:38:47 PM,Internally Displaced People,1296,1361,1879,1944,6480,1296,1361,1879,1944,6480
19,South Sudan (UNDP),2018,SSD-18/HSS10/SA1/FSL/NGO/8252,11/15/2018 1:38:47 PM,Overall,6480,6804,9396,9720,32400,6480,6804,9396,9720,32400
19,South Sudan (UNDP),2018,SSD-18/HSS10/SA1/FSL/NGO/8252,11/15/2018 1:38:47 PM,People in Host Communities,4212,4422,6108,6318,21060,4212,4422,6108,6318,21060
19,South Sudan (UNDP),2018,SSD-18/HSS10/SA1/FSL/NGO/8252,11/15/2018 1:38:47 PM,Refugee Returnees,972,1021,1409,1458,4860,972,1021,1409,1458,4860
19,South Sudan (UNDP),2018,SSD-18/HSS10/SA1/FSL/NGO/8259,11/15/2018 1:03:25 PM,Internally Displaced People,3000,4000,1500,1500,10000,3000,4000,1500,1500,10000
19,South Sudan (UNDP),2018,SSD-18/HSS10/SA1/FSL/NGO/8259,11/15/2018 1:03:25 PM,Overall,6000,9000,3000,3000,21000,6000,9000,3000,3000,21000
19,South Sudan (UNDP),2018,SSD-18/HSS10/SA1/FSL/NGO/8259,11/15/2018 1:03:25 PM,People in Host Communities,2000,3000,1000,1000,7000,2000,3000,1000,1000,7000
19,South Sudan (UNDP),2018,SSD-18/HSS10/SA1/FSL/NGO/8259,11/15/2018 1:03:25 PM,Refugee Returnees,1000,2000,500,500,4000,1000,2000,500,500,4000
19,South Sudan (UNDP),2018,SSD-18/HSS10/SA1/FSL/NGO/8300,4/10/2019 5:48:46 AM,Internally Displaced People,13000,14000,6000,6000,39000,11707,15912,7400,8698,43717
19,South Sudan (UNDP),2018,SSD-18/HSS10/SA1/FSL/NGO/8300,4/10/2019 5:48:46 AM,Other,2000,1000,1000,1000,5000,1582,2210,1000,1208,6000
19,South Sudan (UNDP),2018,SSD-18/HSS10/SA1/FSL/NGO/8300,4/10/2019 5:48:46 AM,Overall,20000,20000,10000,10000,60000,15820,22100,10000,12080,60000
19,South Sudan (UNDP),2018,SSD-18/HSS10/SA1/FSL/NGO/8300,4/10/2019 5:48:46 AM,People in Host Communities,5000,4000,3000,2500,14500,2531,3536,1600,1932,9599
19,South Sudan (UNDP),2018,SSD-18/HSS10/SA1/FSL/NGO/8300,4/10/2019 5:48:46 AM,Pregnant and Lactating Women,0,1000,0,500,1500,0,442,0,242,684
19,South Sudan (UNDP),2018,SSD-18/HSS10/SA1/H/INGO/7924,6/20/2019 8:40:32 AM,Children under 5,0,0,1302,1412,2714,0,0,165,221,386
19,South Sudan (UNDP),2018,SSD-18/HSS10/SA1/H/INGO/7924,6/20/2019 8:40:32 AM,Overall,3864,4130,3075,3217,14286,4083,6544,6354,7703,24684
19,South Sudan (UNDP),2018,SSD-18/HSS10/SA1/H/INGO/7924,6/20/2019 8:40:32 AM,Pastoralists,2220,2243,1300,1320,7083,4083,6544,6354,7703,24684
19,South Sudan (UNDP),2018,SSD-18/HSS10/SA1/H/INGO/7924,6/20/2019 8:40:32 AM,People in Host Communities,1644,1887,473,485,4489,1020,1636,1589,1926,6171
19,South Sudan (UNDP),2018,SSD-18/HSS10/SA1/H/INGO/7941,12/12/2018 8:15:58 AM,Children under 5,0,0,7373,7987,15360,0,0,5512,5657,11169
19,South Sudan (UNDP),2018,SSD-18/HSS10/SA1/H/INGO/7941,12/12/2018 8:15:58 AM,Overall,1511,1971,7929,8589,20000,3500,4798,5512,5657,19467
19,South Sudan (UNDP),2018,SSD-18/HSS10/SA1/H/INGO/7941,12/12/2018 8:15:58 AM,People in Host Communities,1395,1509,556,602,4062,3466,4545,0,0,8011
19,South Sudan (UNDP),2018,SSD-18/HSS10/SA1/H/INGO/7941,12/12/2018 8:15:58 AM,Pregnant and Lactating Women,0,336,0,0,336,0,192,0,0,192
19,South Sudan (UNDP),2018,SSD-18/HSS10/SA1/H/INGO/7941,12/12/2018 8:15:58 AM,"Trainers, Promoters, Caretakers, committee members, etc.",116,126,0,0,242,34,61,0,0,95
19,South Sudan (UNDP),2018,SSD-18/HSS10/SA1/H/INGO/8099,1/21/2019 5:30:43 AM,Internally Displaced People,2738,3348,1200,1286,8572,2765,3122,2107,2151,10145
19,South Sudan (UNDP),2018,SSD-18/HSS10/SA1/H/INGO/8099,1/21/2019 5:30:43 AM,Overall,4564,5579,2000,2143,14286,4767,5383,3632,3709,17491
19,South Sudan (UNDP),2018,SSD-18/HSS10/SA1/H/INGO/8099,1/21/2019 5:30:43 AM,People in Host Communities,1826,2231,800,857,5714,2002,2261,1525,1558,7346
19,South Sudan (UNDP),2018,SSD-18/HSS10/SA1/H/INGO/8205,11/15/2018 1:39:21 PM,Overall,16286,17571,4286,4714,42857,27969,31804,13570,13064,86407
19,South Sudan (UNDP),2018,SSD-18/HSS10/SA1/H/NGO/7883,11/15/2018 12:56:24 PM,Internally Displaced People,1929,3200,2800,2500,10429,3392,6714,8953,6522,25581
19,South Sudan (UNDP),2018,SSD-18/HSS10/SA1/H/NGO/7883,11/15/2018 12:56:24 PM,Overall,3429,5000,6000,7000,21429,4723,6888,10266,9081,30958
19,South Sudan (UNDP),2018,SSD-18/HSS10/SA1/H/NGO/7883,11/15/2018 12:56:24 PM,People in Host Communities,1500,1800,3200,4500,11000,4140,5031,8499,8403,26073
19,South Sudan (UNDP),2018,SSD-18/HSS10/SA1/H/NGO/7931,12/12/2018 8:15:17 AM,Children under 5,0,0,1929,2929,4858,0,0,3293,4692,7985
19,South Sudan (UNDP),2018,SSD-18/HSS10/SA1/H/NGO/7931,12/12/2018 8:15:17 AM,Internally Displaced People,5919,10232,0,0,16151,3148,8920,0,0,12068
19,South Sudan (UNDP),2018,SSD-18/HSS10/SA1/H/NGO/7931,12/12/2018 8:15:17 AM,Overall,7042,12386,1929,2929,24286,5019,9311,3193,4692,22215
19,South Sudan (UNDP),2018,SSD-18/HSS10/SA1/H/NGO/7931,12/12/2018 8:15:17 AM,Pastoralists,300,500,0,0,800,184,202,0,0,386
19,South Sudan (UNDP),2018,SSD-18/HSS10/SA1/H/NGO/7931,12/12/2018 8:15:17 AM,People in Host Communities,823,1654,0,0,2477,595,1181,0,0,1776
19,South Sudan (UNDP),2018,SSD-18/HSS10/SA1/H/NGO/7976,12/12/2018 8:16:35 AM,Children under 5,0,0,449,494,943,0,0,1738,1915,3653
19,South Sudan (UNDP),2018,SSD-18/HSS10/SA1/H/NGO/7976,12/12/2018 8:16:35 AM,Other,7,5,0,0,12,0,0,0,0,0
19,South Sudan (UNDP),2018,SSD-18/HSS10/SA1/H/NGO/7976,12/12/2018 8:16:35 AM,Overall,2700,3727,3738,4121,14286,3042,4199,4212,4643,16096
19,South Sudan (UNDP),2018,SSD-18/HSS10/SA1/H/NGO/7976,12/12/2018 8:16:35 AM,People in Host Communities,2693,3722,3289,3627,13331,3042,4199,2386,2633,12260
19,South Sudan (UNDP),2018,SSD-18/HSS10/SA1/H/NGO/7977,1/21/2019 5:27:55 AM,Children under 5,0,0,700,1449,2149,0,0,600,948,1548
19,South Sudan (UNDP),2018,SSD-18/HSS10/SA1/H/NGO/7977,1/21/2019 5:27:55 AM,Internally Displaced People,4080,4800,1100,1451,11431,3310,4200,2921,3040,13471
19,South Sudan (UNDP),2018,SSD-18/HSS10/SA1/H/NGO/7977,1/21/2019 5:27:55 AM,Overall,6800,8000,2000,3200,20000,5592,7755,4581,5827,23755
19,South Sudan (UNDP),2018,SSD-18/HSS10/SA1/H/NGO/7977,1/21/2019 5:27:55 AM,People in Host Communities,2720,2400,200,300,5620,2282,3468,1060,1839,8649
19,South Sudan (UNDP),2018,SSD-18/HSS10/SA1/H/NGO/7977,1/21/2019 5:27:55 AM,Pregnant and Lactating Women,0,800,0,0,800,0,87,0,0,87
19,South Sudan (UNDP),2018,SSD-18/HSS10/SA1/H/NGO/7979,11/15/2018 1:35:36 PM,Children under 5,0,0,6000,6014,12014,0,0,4355,5127,9482
19,South Sudan (UNDP),2018,SSD-18/HSS10/SA1/H/NGO/7979,11/15/2018 1:35:36 PM,Internally Displaced People,4000,4472,0,0,8472,4187,3993,0,0,8180
19,South Sudan (UNDP),2018,SSD-18/HSS10/SA1/H/NGO/7979,11/15/2018 1:35:36 PM,Overall,6200,7500,6000,6014,25714,6422,8332,4355,5127,24236
19,South Sudan (UNDP),2018,SSD-18/HSS10/SA1/H/NGO/7979,11/15/2018 1:35:36 PM,People in Host Communities,2200,2000,0,0,4200,2235,3698,0,0,5933
19,South Sudan (UNDP),2018,SSD-18/HSS10/SA1/H/NGO/7979,11/15/2018 1:35:36 PM,Pregnant and Lactating Women,0,1028,0,0,1028,0,641,0,0,641
19,South Sudan (UNDP),2018,SSD-18/HSS10/SA1/H/NGO/7985,11/15/2018 1:01:34 PM,Internally Displaced People,800,1100,640,920,3460,17693,22011,5203,6820,51727
19,South Sudan (UNDP),2018,SSD-18/HSS10/SA1/H/NGO/7985,11/15/2018 1:01:34 PM,Overall,5530,5756,1470,1530,14286,19567,26555,5956,8193,60271
19,South Sudan (UNDP),2018,SSD-18/HSS10/SA1/H/NGO/7985,11/15/2018 1:01:34 PM,People in Host Communities,4730,4013,830,610,10183,1874,2194,753,1373,6194
19,South Sudan (UNDP),2018,SSD-18/HSS10/SA1/H/NGO/7985,11/15/2018 1:01:34 PM,Pregnant and Lactating Women,0,643,0,0,643,0,2350,0,0,2350
19,South Sudan (UNDP),2018,SSD-18/HSS10/SA1/H/NGO/8049,1/21/2019 5:26:09 AM,Internally Displaced People,2520,2623,735,765,6643,1578,1710,1710,1852,6850
19,South Sudan (UNDP),2018,SSD-18/HSS10/SA1/H/NGO/8049,1/21/2019 5:26:09 AM,Overall,13825,14389,3675,3825,35714,7891,8549,8549,9261,34250
19,South Sudan (UNDP),2018,SSD-18/HSS10/SA1/H/NGO/8049,1/21/2019 5:26:09 AM,People in Host Communities,11305,11766,2940,3060,29071,14204,15388,15388,16670,61650
19,South Sudan (UNDP),2018,SSD-18/HSS10/SA1/H/NGO/8064,12/12/2018 8:17:17 AM,Internally Displaced People,4000,5300,4100,4100,17500,2160,3662,2561,4721,13104
19,South Sudan (UNDP),2018,SSD-18/HSS10/SA1/H/NGO/8064,12/12/2018 8:17:17 AM,Overall,9000,9750,8960,8907,36617,8195,10966,5825,7076,32062
19,South Sudan (UNDP),2018,SSD-18/HSS10/SA1/H/NGO/8064,12/12/2018 8:17:17 AM,People in Host Communities,5000,4450,4860,4807,19117,4322,5090,4401,5145,18958
19,South Sudan (UNDP),2018,SSD-18/HSS10/SA1/H/NGO/8081,1/21/2019 5:26:39 AM,Internally Displaced People,500,1000,1200,1300,4000,1563,1744,248,479,4034
19,South Sudan (UNDP),2018,SSD-18/HSS10/SA1/H/NGO/8081,1/21/2019 5:26:39 AM,Overall,2143,3572,3857,4714,14286,4885,6120,1255,2100,14360
19,South Sudan (UNDP),2018,SSD-18/HSS10/SA1/H/NGO/8081,1/21/2019 5:26:39 AM,People in Host Communities,1643,2572,2657,3414,10286,3322,4376,1007,1621,10326
19,South Sudan (UNDP),2018,SSD-18/HSS10/SA1/H/NGO/8137,1/21/2019 5:30:06 AM,Children under 5,0,0,0,0,0,0,0,1831,1848,3679
19,South Sudan (UNDP),2018,SSD-18/HSS10/SA1/H/NGO/8137,1/21/2019 5:30:06 AM,Internally Displaced People,636,657,300,316,1909,608,709,29,443,1789
19,South Sudan (UNDP),2018,SSD-18/HSS10/SA1/H/NGO/8137,1/21/2019 5:30:06 AM,Overall,6636,6907,1764,1836,17143,6504,6483,2858,2842,18687
19,South Sudan (UNDP),2018,SSD-18/HSS10/SA1/H/NGO/8137,1/21/2019 5:30:06 AM,People in Host Communities,6000,6250,1464,1520,15234,4509,4405,2605,1700,13219
19,South Sudan (UNDP),2018,SSD-18/HSS10/SA1/H/NGO/8157,12/12/2018 8:17:51 AM,Children under 5,0,0,2141,2144,4285,0,0,2475,3144,5619
19,South Sudan (UNDP),2018,SSD-18/HSS10/SA1/H/NGO/8157,12/12/2018 8:17:51 AM,Internally Displaced People,7406,6480,0,0,13886,650,6345,0,0,6995
19,South Sudan (UNDP),2018,SSD-18/HSS10/SA1/H/NGO/8157,12/12/2018 8:17:51 AM,Overall,8229,8915,2141,2144,21429,7980,9255,2475,3144,22854
19,South Sudan (UNDP),2018,SSD-18/HSS10/SA1/H/NGO/8157,12/12/2018 8:17:51 AM,People in Host Communities,823,720,0,0,1543,780,810,0,0,1590
19,South Sudan (UNDP),2018,SSD-18/HSS10/SA1/H/NGO/8157,12/12/2018 8:17:51 AM,Pregnant and Lactating Women,0,1715,0,0,1715,0,2100,0,0,2100
19,South Sudan (UNDP),2018,SSD-18/HSS10/SA1/H/NGO/8169,1/21/2019 5:29:31 AM,Children under 5,0,0,1379,1437,2816,0,0,2896,3111,6007
19,South Sudan (UNDP),2018,SSD-18/HSS10/SA1/H/NGO/8169,1/21/2019 5:29:31 AM,Internally Displaced People,2584,7464,2319,2810,15177,613,910,417,664,2604
19,South Sudan (UNDP),2018,SSD-18/HSS10/SA1/H/NGO/8169,1/21/2019 5:29:31 AM,Overall,3230,12440,4628,5416,25714,5786,8268,6774,7650,28478
19,South Sudan (UNDP),2018,SSD-18/HSS10/SA1/H/NGO/8169,1/21/2019 5:29:31 AM,People in Host Communities,646,4976,930,1169,7721,5173,7358,4583,5117,22231
19,South Sudan (UNDP),2018,SSD-18/HSS10/SA1/H/NGO/8301,1/21/2019 5:29:13 AM,Children under 5,0,0,1327,1530,2857,0,0,2812,3117,5929
19,South Sudan (UNDP),2018,SSD-18/HSS10/SA1/H/NGO/8301,1/21/2019 5:29:13 AM,Internally Displaced People,2336,2907,793,821,6857,2852,3132,1390,1536,8910
19,South Sudan (UNDP),2018,SSD-18/HSS10/SA1/H/NGO/8301,1/21/2019 5:29:13 AM,Overall,3893,4845,2649,2899,14286,4264,5693,3196,3420,16573
19,South Sudan (UNDP),2018,SSD-18/HSS10/SA1/H/NGO/8301,1/21/2019 5:29:13 AM,People in Host Communities,1557,938,529,548,3572,2193,3011,1238,1302,7744
19,South Sudan (UNDP),2018,SSD-18/HSS10/SA1/H/NGO/8301,1/21/2019 5:29:13 AM,Pregnant and Lactating Women,0,1000,0,0,1000,0,1393,0,0,1393
19,South Sudan (UNDP),2018,SSD-18/HSS10/SA1/H/UN/7897,12/12/2018 8:13:58 AM,Overall,8286,8857,5428,6000,28571,0,0,0,0,0
19,South Sudan (UNDP),2018,SSD-18/HSS10/SA1/H/UN/8088,1/21/2019 5:28:50 AM,Internally Displaced People,40290,38710,10710,10290,100000,14010,17076,5190,5937,42213
19,South Sudan (UNDP),2018,SSD-18/HSS10/SA1/H/UN/8088,1/21/2019 5:28:50 AM,Overall,40290,38710,10710,10290,100000,66436,82500,34650,37500,221086
19,South Sudan (UNDP),2018,SSD-18/HSS10/SA1/H/UN/8121,10/11/2018 7:40:17 AM,Children under 5,0,0,1430,1550,2980,0,0,4025,3458,7483
19,South Sudan (UNDP),2018,SSD-18/HSS10/SA1/H/UN/8121,10/11/2018 7:40:17 AM,Internally Displaced People,250,410,4798,5321,10779,2871,3503,3128,3497,12999
19,South Sudan (UNDP),2018,SSD-18/HSS10/SA1/H/UN/8121,10/11/2018 7:40:17 AM,Overall,450,2450,11871,13800,28571,5503,7807,11158,10051,34519
19,South Sudan (UNDP),2018,SSD-18/HSS10/SA1/H/UN/8121,10/11/2018 7:40:17 AM,People in Host Communities,200,900,5643,6929,13672,2632,2841,4005,3096,12574
19,South Sudan (UNDP),2018,SSD-18/HSS10/SA1/H/UN/8121,10/11/2018 7:40:17 AM,Pregnant and Lactating Women,0,1140,0,0,1140,0,1463,0,0,1463
19,South Sudan (UNDP),2018,SSD-18/HSS10/SA1/L/UN/7900,12/12/2018 8:14:33 AM,Aid Agencies,20,20,20,20,80,0,0,0,0,0
19,South Sudan (UNDP),2018,SSD-18/HSS10/SA1/L/UN/7900,12/12/2018 8:14:33 AM,Overall,20,20,20,20,80,42,40,0,0,82
19,South Sudan (UNDP),2018,SSD-18/HSS10/SA1/L/UN/7904,10/9/2018 7:58:26 AM,Aid Agencies,271,0,0,0,271,0,0,0,0,0
19,South Sudan (UNDP),2018,SSD-18/HSS10/SA1/L/UN/7904,10/9/2018 7:58:26 AM,Overall,271,0,0,0,271,287,0,0,0,287
19,South Sudan (UNDP),2018,SSD-18/HSS10/SA1/N/INGO/7917,12/10/2018 6:35:34 AM,Children under 5,0,0,5834,6073,11907,0,0,5969,7365,13334
19,South Sudan (UNDP),2018,SSD-18/HSS10/SA1/N/INGO/7917,12/10/2018 6:35:34 AM,Overall,0,4339,5834,6073,16246,0,7110,5969,7365,20444
19,South Sudan (UNDP),2018,SSD-18/HSS10/SA1/N/INGO/7917,12/10/2018 6:35:34 AM,Pregnant and Lactating Women,0,4339,0,0,4339,0,7110,0,0,7110
19,South Sudan (UNDP),2018,SSD-18/HSS10/SA1/N/INGO/7978,12/5/2018 9:03:32 AM,Children under 5,0,0,13746,14308,28054,0,0,22378,25707,48085
19,South Sudan (UNDP),2018,SSD-18/HSS10/SA1/N/INGO/7978,12/5/2018 9:03:32 AM,Overall,1018,9861,13746,14308,38933,34,23136,22378,25707,71255
19,South Sudan (UNDP),2018,SSD-18/HSS10/SA1/N/INGO/7978,12/5/2018 9:03:32 AM,People in Host Communities,983,0,0,0,983,0,0,0,0,0
19,South Sudan (UNDP),2018,SSD-18/HSS10/SA1/N/INGO/7978,12/5/2018 9:03:32 AM,Pregnant and Lactating Women,0,9826,0,0,9826,0,23100,0,0,23100
19,South Sudan (UNDP),2018,SSD-18/HSS10/SA1/N/INGO/7978,12/5/2018 9:03:32 AM,"Trainers, Promoters, Caretakers, committee members, etc.",35,35,0,0,70,34,36,0,0,70
19,South Sudan (UNDP),2018,SSD-18/HSS10/SA1/N/INGO/8074,6/3/2019 7:05:32 AM,Children under 5,0,0,3934,4094,8028,0,0,7834,7490,15324
19,South Sudan (UNDP),2018,SSD-18/HSS10/SA1/N/INGO/8074,6/3/2019 7:05:32 AM,Other,364,0,0,0,364,0,0,0,0,0
19,South Sudan (UNDP),2018,SSD-18/HSS10/SA1/N/INGO/8074,6/3/2019 7:05:32 AM,Overall,400,4998,3934,4094,13426,36,8740,7834,7490,24100
19,South Sudan (UNDP),2018,SSD-18/HSS10/SA1/N/INGO/8074,6/3/2019 7:05:32 AM,Pregnant and Lactating Women,0,4950,0,0,4950,0,8740,0,0,8740
19,South Sudan (UNDP),2018,SSD-18/HSS10/SA1/N/INGO/8074,6/3/2019 7:05:32 AM,"Trainers, Promoters, Caretakers, committee members, etc.",36,48,0,0,84,36,0,0,0,36
19,South Sudan (UNDP),2018,SSD-18/HSS10/SA1/N/INGO/8114,1/29/2019 9:36:36 AM,Children under 5,0,0,2345,2541,4886,0,0,1797,2655,4452
19,South Sudan (UNDP),2018,SSD-18/HSS10/SA1/N/INGO/8114,1/29/2019 9:36:36 AM,Overall,0,2582,2345,2541,7468,28,5253,1797,2655,9733
19,South Sudan (UNDP),2018,SSD-18/HSS10/SA1/N/INGO/8114,1/29/2019 9:36:36 AM,Pregnant and Lactating Women,0,2582,0,0,2582,28,5253,0,0,5281
19,South Sudan (UNDP),2018,SSD-18/HSS10/SA1/N/NGO/7911,12/18/2018 12:08:52 PM,Children under 5,0,0,40,60,100,0,0,20,14,34
19,South Sudan (UNDP),2018,SSD-18/HSS10/SA1/N/NGO/7911,12/18/2018 12:08:52 PM,Other,208,20,0,0,228,180,0,0,0,180
19,South Sudan (UNDP),2018,SSD-18/HSS10/SA1/N/NGO/7911,12/18/2018 12:08:52 PM,Overall,208,740,40,60,1048,180,870,20,14,1084
19,South Sudan (UNDP),2018,SSD-18/HSS10/SA1/N/NGO/7911,12/18/2018 12:08:52 PM,Pregnant and Lactating Women,0,720,0,0,720,0,870,0,0,870
19,South Sudan (UNDP),2018,SSD-18/HSS10/SA1/N/NGO/7926,12/18/2018 11:34:40 AM,Children under 5,0,0,2729,2947,5676,0,0,3389,3242,6631
19,South Sudan (UNDP),2018,SSD-18/HSS10/SA1/N/NGO/7926,12/18/2018 11:34:40 AM,Internally Displaced People,1301,1800,2146,1639,6886,1300,1859,2446,1739,7344
19,South Sudan (UNDP),2018,SSD-18/HSS10/SA1/N/NGO/7926,12/18/2018 11:34:40 AM,Overall,2601,3600,6946,7946,21093,2600,3691,8206,8441,22938
19,South Sudan (UNDP),2018,SSD-18/HSS10/SA1/N/NGO/7926,12/18/2018 11:34:40 AM,People in Host Communities,1300,1800,2071,3360,8531,1300,1832,2371,3460,8963
19,South Sudan (UNDP),2018,SSD-18/HSS10/SA1/N/NGO/7944,12/7/2018 11:33:29 AM,Children under 5,0,0,1892,1892,3784,0,0,2608,2932,5540
19,South Sudan (UNDP),2018,SSD-18/HSS10/SA1/N/NGO/7944,12/7/2018 11:33:29 AM,Internally Displaced People,342,0,0,0,342,277,0,0,0,277
19,South Sudan (UNDP),2018,SSD-18/HSS10/SA1/N/NGO/7944,12/7/2018 11:33:29 AM,Overall,342,2038,1892,1892,6164,277,2329,2608,2932,8146
19,South Sudan (UNDP),2018,SSD-18/HSS10/SA1/N/NGO/7944,12/7/2018 11:33:29 AM,Pregnant and Lactating Women,0,2038,0,0,2038,0,2329,0,0,2329
19,South Sudan (UNDP),2018,SSD-18/HSS10/SA1/N/NGO/8289,12/18/2018 11:47:49 AM,Children under 5,0,0,3439,3439,6878,0,0,20953,20402,41355
19,South Sudan (UNDP),2018,SSD-18/HSS10/SA1/N/NGO/8289,12/18/2018 11:47:49 AM,Internally Displaced People,0,4561,3439,3439,11439,0,15288,5734,6756,27778
19,South Sudan (UNDP),2018,SSD-18/HSS10/SA1/N/NGO/8289,12/18/2018 11:47:49 AM,Overall,0,9122,6878,6878,22878,0,31440,26687,27158,85285
19,South Sudan (UNDP),2018,SSD-18/HSS10/SA1/N/NGO/8289,12/18/2018 11:47:49 AM,Pregnant and Lactating Women,0,4561,0,0,4561,0,14489,0,0,14489
19,South Sudan (UNDP),2018,SSD-18/HSS10/SA1/N/UN/8176,12/5/2019 1:08:49 PM,Children under 5,0,0,964,1004,1968,0,0,897,919,1816
19,South Sudan (UNDP),2018,SSD-18/HSS10/SA1/N/UN/8176,12/5/2019 1:08:49 PM,Other,3000,0,0,0,3000,1435,0,0,0,1435
19,South Sudan (UNDP),2018,SSD-18/HSS10/SA1/N/UN/8176,12/5/2019 1:08:49 PM,Overall,3000,29000,964,1004,33968,1435,21720,897,919,24971
19,South Sudan (UNDP),2018,SSD-18/HSS10/SA1/N/UN/8176,12/5/2019 1:08:49 PM,Pregnant and Lactating Women,0,29000,0,0,29000,0,21720,0,0,21720
19,South Sudan (UNDP),2018,SSD-18/HSS10/SA1/N/UN/8178,1/29/2019 9:37:13 AM,Children under 5,0,0,2257,2447,4704,0,0,25411,26411,51822
19,South Sudan (UNDP),2018,SSD-18/HSS10/SA1/N/UN/8178,1/29/2019 9:37:13 AM,Overall,754,4030,2257,2447,9488,153,3874,25416,26416,55859
19,South Sudan (UNDP),2018,SSD-18/HSS10/SA1/N/UN/8178,1/29/2019 9:37:13 AM,"Trainers, Promoters, Caretakers, committee members, etc.",754,4030,0,0,4784,169,3868,0,0,4037
19,South Sudan (UNDP),2018,SSD-18/HSS10/SA1/N/UN/8314,10/27/2021 12:09:07 PM,Children under 5,0,0,5443,5897,11340,0,0,38426,39838,78264
19,South Sudan (UNDP),2018,SSD-18/HSS10/SA1/N/UN/8314,10/27/2021 12:09:07 PM,Other,0,4987,0,0,4987,0,28064,0,0,28064
19,South Sudan (UNDP),2018,SSD-18/HSS10/SA1/N/UN/8314,10/27/2021 12:09:07 PM,Overall,0,4987,5443,5897,16327,0,28064,38426,39838,106328
19,South Sudan (UNDP),2018,SSD-18/HSS10/SA1/NFI/INGO/7919,1/30/2019 5:56:53 AM,Internally Displaced People,2000,3000,2000,3000,10000,2046,2234,1892,2061,8233
19,South Sudan (UNDP),2018,SSD-18/HSS10/SA1/NFI/INGO/7919,1/30/2019 5:56:53 AM,Overall,2000,3000,2000,3000,10000,2046,2234,1892,2061,8233
19,South Sudan (UNDP),2018,SSD-18/HSS10/SA1/NFI/INGO/7937,1/30/2019 5:59:19 AM,Internally Displaced People,1800,1950,1800,1950,7500,3428,4333,3782,4386,15929
19,South Sudan (UNDP),2018,SSD-18/HSS10/SA1/NFI/INGO/7937,1/30/2019 5:59:19 AM,Overall,1800,1950,1800,1950,7500,3428,4333,3782,4386,15929
19,South Sudan (UNDP),2018,SSD-18/HSS10/SA1/NFI/INGO/7953,1/29/2019 6:42:30 PM,Internally Displaced People,1999,1921,2999,2881,9800,4519,4793,4466,5545,19323
19,South Sudan (UNDP),2018,SSD-18/HSS10/SA1/NFI/INGO/7953,1/29/2019 6:42:30 PM,Overall,2856,2744,4284,4116,14000,4519,4793,4466,5545,19323
19,South Sudan (UNDP),2018,SSD-18/HSS10/SA1/NFI/INGO/7953,1/29/2019 6:42:30 PM,People in Host Communities,857,823,1285,1235,4200,0,0,0,0,0
19,South Sudan (UNDP),2018,SSD-18/HSS10/SA1/NFI/INGO/8009,1/30/2019 6:08:36 AM,Internally Displaced People,6148,5936,4664,4452,21200,8568,9198,6997,8455,33218
19,South Sudan (UNDP),2018,SSD-18/HSS10/SA1/NFI/INGO/8009,1/30/2019 6:08:36 AM,Other,1537,1484,1166,1113,5300,1956,1981,901,1101,5939
19,South Sudan (UNDP),2018,SSD-18/HSS10/SA1/NFI/INGO/8009,1/30/2019 6:08:36 AM,Overall,7685,7420,5830,5565,26500,10524,11179,7898,9556,39157
19,South Sudan (UNDP),2018,SSD-18/HSS10/SA1/NFI/INGO/8035,1/30/2019 6:10:14 AM,Internally Displaced People,1650,1870,3520,3960,11000,6553,8464,8443,10677,34137
19,South Sudan (UNDP),2018,SSD-18/HSS10/SA1/NFI/INGO/8035,1/30/2019 6:10:14 AM,Overall,3000,3400,6400,7200,20000,6553,8462,8442,10680,34137
19,South Sudan (UNDP),2018,SSD-18/HSS10/SA1/NFI/INGO/8035,1/30/2019 6:10:14 AM,Refugee Returnees,1350,1530,2880,3240,9000,0,0,0,0,0
19,South Sudan (UNDP),2018,SSD-18/HSS10/SA1/NFI/INGO/8220,3/12/2019 12:28:19 PM,Internally Displaced People,974,1015,1015,1055,4059,4605,7308,4948,4648,21509
19,South Sudan (UNDP),2018,SSD-18/HSS10/SA1/NFI/INGO/8220,3/12/2019 12:28:19 PM,Overall,1948,2030,2030,2110,8118,6700,11000,7000,5789,30489
19,South Sudan (UNDP),2018,SSD-18/HSS10/SA1/NFI/INGO/8220,3/12/2019 12:28:19 PM,People in Host Communities,974,1015,1015,1055,4059,1152,1802,1237,1162,5353
19,South Sudan (UNDP),2018,SSD-18/HSS10/SA1/NFI/INGO/8258,1/30/2019 10:41:35 AM,Internally Displaced People,3035,4150,2650,2620,12455,358,400,506,503,1767
19,South Sudan (UNDP),2018,SSD-18/HSS10/SA1/NFI/INGO/8258,1/30/2019 10:41:35 AM,Other,250,200,100,120,670,247,276,397,354,1274
19,South Sudan (UNDP),2018,SSD-18/HSS10/SA1/NFI/INGO/8258,1/30/2019 10:41:35 AM,Overall,3885,4900,3300,3300,15385,6336,7319,8232,8443,30330
19,South Sudan (UNDP),2018,SSD-18/HSS10/SA1/NFI/INGO/8258,1/30/2019 10:41:35 AM,People in Host Communities,600,550,550,560,2260,348,390,561,500,1799
19,South Sudan (UNDP),2018,SSD-18/HSS10/SA1/NFI/NGO/7916,1/30/2019 5:41:58 AM,Internally Displaced People,1136,1533,64,96,2829,928,1104,4,61,2097
19,South Sudan (UNDP),2018,SSD-18/HSS10/SA1/NFI/NGO/7916,1/30/2019 5:41:58 AM,Overall,1500,2129,80,120,3829,1505,2190,31,103,3829
19,South Sudan (UNDP),2018,SSD-18/HSS10/SA1/NFI/NGO/7916,1/30/2019 5:41:58 AM,People in Host Communities,248,406,11,16,681,246,400,6,10,662
19,South Sudan (UNDP),2018,SSD-18/HSS10/SA1/NFI/NGO/7916,1/30/2019 5:41:58 AM,Refugee Returnees,116,190,5,8,319,331,686,21,32,1070
19,South Sudan (UNDP),2018,SSD-18/HSS10/SA1/NFI/NGO/7988,1/30/2019 6:03:13 AM,Internally Displaced People,2158,3238,0,0,5396,7326,5483,0,0,12809
19,South Sudan (UNDP),2018,SSD-18/HSS10/SA1/NFI/NGO/7988,1/30/2019 6:03:13 AM,Overall,3454,7339,0,0,10793,7474,7263,0,0,14737
19,South Sudan (UNDP),2018,SSD-18/HSS10/SA1/NFI/NGO/7988,1/30/2019 6:03:13 AM,People in Host Communities,432,647,0,0,1079,148,147,0,0,295
19,South Sudan (UNDP),2018,SSD-18/HSS10/SA1/NFI/NGO/7988,1/30/2019 6:03:13 AM,Pregnant and Lactating Women,0,2159,0,0,2159,0,1633,0,0,1633
19,South Sudan (UNDP),2018,SSD-18/HSS10/SA1/NFI/NGO/7988,1/30/2019 6:03:13 AM,Refugee Returnees,864,1295,0,0,2159,0,0,0,0,0
19,South Sudan (UNDP),2018,SSD-18/HSS10/SA1/NFI/NGO/7998,1/29/2019 7:07:10 PM,Children under 5,0,0,1234,1345,2579,0,0,295,490,785
19,South Sudan (UNDP),2018,SSD-18/HSS10/SA1/NFI/NGO/7998,1/29/2019 7:07:10 PM,Internally Displaced People,1838,2246,1781,1093,6958,4086,6332,1051,1243,12712
19,South Sudan (UNDP),2018,SSD-18/HSS10/SA1/NFI/NGO/7998,1/29/2019 7:07:10 PM,Other,787,161,194,1484,2626,1081,1123,433,507,3144
19,South Sudan (UNDP),2018,SSD-18/HSS10/SA1/NFI/NGO/7998,1/29/2019 7:07:10 PM,Overall,2625,3209,3209,3922,12965,5167,8028,1779,2240,17214
19,South Sudan (UNDP),2018,SSD-18/HSS10/SA1/NFI/NGO/7998,1/29/2019 7:07:10 PM,Pregnant and Lactating Women,0,802,0,0,802,0,573,0,0,573
19,South Sudan (UNDP),2018,SSD-18/HSS10/SA1/NFI/NGO/8078,1/30/2019 10:34:01 AM,Internally Displaced People,1064,1104,967,947,4082,1530,1525,2555,2391,8001
19,South Sudan (UNDP),2018,SSD-18/HSS10/SA1/NFI/NGO/8078,1/30/2019 10:34:01 AM,Overall,1716,2028,1404,1352,6500,1609,1577,2596,2417,8199
19,South Sudan (UNDP),2018,SSD-18/HSS10/SA1/NFI/NGO/8078,1/30/2019 10:34:01 AM,Refugee Returnees,652,924,437,405,2418,79,52,41,26,198
19,South Sudan (UNDP),2018,SSD-18/HSS10/SA1/NFI/NGO/8094,1/30/2019 6:18:39 AM,Internally Displaced People,466,1399,1398,1398,4661,628,1158,1289,1414,4489
19,South Sudan (UNDP),2018,SSD-18/HSS10/SA1/NFI/NGO/8094,1/30/2019 6:18:39 AM,Overall,466,1399,1398,1398,4661,628,1158,1289,1414,4489
19,South Sudan (UNDP),2018,SSD-18/HSS10/SA1/NFI/NGO/8110,2/1/2019 10:00:06 AM,Internally Displaced People,824,3160,924,2050,6958,931,5446,736,2429,9542
19,South Sudan (UNDP),2018,SSD-18/HSS10/SA1/NFI/NGO/8110,2/1/2019 10:00:06 AM,Overall,1250,4370,1410,2970,10000,2591,5385,2174,3258,13408
19,South Sudan (UNDP),2018,SSD-18/HSS10/SA1/NFI/NGO/8110,2/1/2019 10:00:06 AM,People in Host Communities,258,690,330,670,1948,263,949,388,658,2258
19,South Sudan (UNDP),2018,SSD-18/HSS10/SA1/NFI/NGO/8110,2/1/2019 10:00:06 AM,Refugee Returnees,168,520,156,250,1094,261,715,225,407,1608
19,South Sudan (UNDP),2018,SSD-18/HSS10/SA1/P/INGO/7987,1/29/2019 9:03:23 PM,Aid Agencies,6,10,0,0,16,0,0,0,0,0
19,South Sudan (UNDP),2018,SSD-18/HSS10/SA1/P/INGO/7987,1/29/2019 9:03:23 PM,Overall,120,160,1940,1940,4160,242,236,3037,2390,5905
19,South Sudan (UNDP),2018,SSD-18/HSS10/SA1/P/INGO/7987,1/29/2019 9:03:23 PM,"Trainers, Promoters, Caretakers, committee members, etc.",30,70,0,0,100,0,0,0,0,0
19,South Sudan (UNDP),2018,SSD-18/HSS10/SA1/P/INGO/8101,1/27/2019 3:58:38 PM,Internally Displaced People,213,340,85,170,808,440,710,170,370,1690
19,South Sudan (UNDP),2018,SSD-18/HSS10/SA1/P/INGO/8101,1/27/2019 3:58:38 PM,Overall,250,400,100,200,950,359,764,439,426,1988
19,South Sudan (UNDP),2018,SSD-18/HSS10/SA1/P/INGO/8101,1/27/2019 3:58:38 PM,People in Host Communities,37,60,15,30,142,78,125,30,65,298
19,South Sudan (UNDP),2018,SSD-18/HSS10/SA1/P/INGO/8108,1/24/2019 1:55:58 PM,Internally Displaced People,720,960,1440,1680,4800,651,948,1013,981,3593
19,South Sudan (UNDP),2018,SSD-18/HSS10/SA1/P/INGO/8108,1/24/2019 1:55:58 PM,Overall,900,1200,1800,2100,6000,1028,1298,1671,1621,5618
19,South Sudan (UNDP),2018,SSD-18/HSS10/SA1/P/INGO/8108,1/24/2019 1:55:58 PM,People in Host Communities,180,240,360,420,1200,377,350,658,640,2025
19,South Sudan (UNDP),2018,SSD-18/HSS10/SA1/P/INGO/8129,1/24/2019 6:55:10 PM,Internally Displaced People,70,165,30,30,295,282,714,13,13,1022
19,South Sudan (UNDP),2018,SSD-18/HSS10/SA1/P/INGO/8129,1/24/2019 6:55:10 PM,Overall,200,500,100,100,900,453,1024,13,15,1505
19,South Sudan (UNDP),2018,SSD-18/HSS10/SA1/P/INGO/8129,1/24/2019 6:55:10 PM,People in Host Communities,60,170,40,40,310,1,2,0,0,3
19,South Sudan (UNDP),2018,SSD-18/HSS10/SA1/P/INGO/8129,1/24/2019 6:55:10 PM,Refugee Returnees,70,165,30,30,295,170,308,0,3,481
19,South Sudan (UNDP),2018,SSD-18/HSS10/SA1/P/INGO/8152,1/14/2019 5:50:30 PM,Internally Displaced People,260,605,130,235,1230,458,1363,951,1015,3787
19,South Sudan (UNDP),2018,SSD-18/HSS10/SA1/P/INGO/8152,1/14/2019 5:50:30 PM,Overall,520,1255,260,470,2505,611,2272,1079,1977,5939
19,South Sudan (UNDP),2018,SSD-18/HSS10/SA1/P/INGO/8152,1/14/2019 5:50:30 PM,People in Host Communities,260,650,130,235,1275,153,909,128,962,2152
19,South Sudan (UNDP),2018,SSD-18/HSS10/SA1/P/INGO/8182,1/24/2019 7:08:34 PM,Overall,870,3480,1740,2610,8700,791,8478,680,4403,14352
19,South Sudan (UNDP),2018,SSD-18/HSS10/SA1/P/INGO/8184,1/29/2019 7:14:14 PM,Internally Displaced People,400,800,300,500,2000,0,0,0,0,0
19,South Sudan (UNDP),2018,SSD-18/HSS10/SA1/P/INGO/8184,1/29/2019 7:14:14 PM,Overall,800,1600,600,1000,4000,5050,8767,2226,4345,20388
19,South Sudan (UNDP),2018,SSD-18/HSS10/SA1/P/INGO/8184,1/29/2019 7:14:14 PM,People in Host Communities,400,800,300,500,2000,0,0,0,0,0
19,South Sudan (UNDP),2018,SSD-18/HSS10/SA1/P/NGO/7948,1/29/2019 9:23:57 PM,Internally Displaced People,30,75,150,180,435,45,232,221,471,969
19,South Sudan (UNDP),2018,SSD-18/HSS10/SA1/P/NGO/7948,1/29/2019 9:23:57 PM,Overall,70,265,300,430,1065,119,509,457,941,2026
19,South Sudan (UNDP),2018,SSD-18/HSS10/SA1/P/NGO/7948,1/29/2019 9:23:57 PM,People in Host Communities,20,150,150,250,570,42,239,236,470,987
19,South Sudan (UNDP),2018,SSD-18/HSS10/SA1/P/NGO/7948,1/29/2019 9:23:57 PM,"Trainers, Promoters, Caretakers, committee members, etc.",20,40,0,0,60,32,38,0,0,70
19,South Sudan (UNDP),2018,SSD-18/HSS10/SA1/P/NGO/7980,1/29/2019 7:34:44 PM,Internally Displaced People,500,1000,1600,1600,4700,538,1100,1208,1633,4479
19,South Sudan (UNDP),2018,SSD-18/HSS10/SA1/P/NGO/7980,1/29/2019 7:34:44 PM,Overall,1400,2000,3300,3300,10000,1542,2199,2700,3405,9846
19,South Sudan (UNDP),2018,SSD-18/HSS10/SA1/P/NGO/7980,1/29/2019 7:34:44 PM,People in Host Communities,700,800,1500,1500,4500,772,879,1216,1531,4398
19,South Sudan (UNDP),2018,SSD-18/HSS10/SA1/P/NGO/7980,1/29/2019 7:34:44 PM,"Trainers, Promoters, Caretakers, committee members, etc.",200,200,200,200,800,232,220,276,241,969
19,South Sudan (UNDP),2018,SSD-18/HSS10/SA1/P/NGO/8060,1/24/2019 11:37:07 AM,Internally Displaced People,100,650,170,300,1220,410,1100,220,300,2030
19,South Sudan (UNDP),2018,SSD-18/HSS10/SA1/P/NGO/8060,1/24/2019 11:37:07 AM,Overall,220,1150,250,380,2000,557,1503,300,869,3229
19,South Sudan (UNDP),2018,SSD-18/HSS10/SA1/P/NGO/8060,1/24/2019 11:37:07 AM,People in Host Communities,70,350,0,0,420,203,411,190,205,1009
19,South Sudan (UNDP),2018,SSD-18/HSS10/SA1/P/NGO/8060,1/24/2019 11:37:07 AM,"Trainers, Promoters, Caretakers, committee members, etc.",50,150,80,80,360,120,70,0,0,190
19,South Sudan (UNDP),2018,SSD-18/HSS10/SA1/P/NGO/8072,1/16/2019 11:14:47 AM,Internally Displaced People,141,340,131,227,839,96,218,60,275,649
19,South Sudan (UNDP),2018,SSD-18/HSS10/SA1/P/NGO/8072,1/16/2019 11:14:47 AM,Overall,410,750,415,645,2220,447,981,453,804,2685
19,South Sudan (UNDP),2018,SSD-18/HSS10/SA1/P/NGO/8072,1/16/2019 11:14:47 AM,People in Host Communities,259,382,274,408,1323,287,672,369,408,1736
19,South Sudan (UNDP),2018,SSD-18/HSS10/SA1/P/NGO/8072,1/16/2019 11:14:47 AM,"Trainers, Promoters, Caretakers, committee members, etc.",10,28,10,10,58,64,91,24,121,300
19,South Sudan (UNDP),2018,SSD-18/HSS10/SA1/P/NGO/8090,1/29/2019 8:50:59 AM,Internally Displaced People,188,563,468,656,1875,770,1042,899,1373,4084
19,South Sudan (UNDP),2018,SSD-18/HSS10/SA1/P/NGO/8090,1/29/2019 8:50:59 AM,Overall,541,1096,1076,2207,4920,1353,1644,1488,1881,6366
19,South Sudan (UNDP),2018,SSD-18/HSS10/SA1/P/NGO/8090,1/29/2019 8:50:59 AM,People in Host Communities,338,513,593,1531,2975,543,565,589,508,2205
19,South Sudan (UNDP),2018,SSD-18/HSS10/SA1/P/NGO/8090,1/29/2019 8:50:59 AM,"Trainers, Promoters, Caretakers, committee members, etc.",15,20,15,20,70,40,37,0,0,77
19,South Sudan (UNDP),2018,SSD-18/HSS10/SA1/P/NGO/8092,1/30/2019 1:22:10 PM,Internally Displaced People,0,0,3700,3700,7400,0,0,3166,4330,7496
19,South Sudan (UNDP),2018,SSD-18/HSS10/SA1/P/NGO/8092,1/30/2019 1:22:10 PM,Overall,800,800,3700,3700,9000,723,559,2919,3659,7860
19,South Sudan (UNDP),2018,SSD-18/HSS10/SA1/P/NGO/8092,1/30/2019 1:22:10 PM,"Trainers, Promoters, Caretakers, committee members, etc.",800,800,0,0,1600,774,508,0,0,1282
19,South Sudan (UNDP),2018,SSD-18/HSS10/SA1/P/NGO/8096,1/30/2019 5:58:41 PM,Internally Displaced People,400,400,650,650,2100,435,415,796,703,2349
19,South Sudan (UNDP),2018,SSD-18/HSS10/SA1/P/NGO/8096,1/30/2019 5:58:41 PM,Other,80,80,40,40,240,80,80,40,40,240
19,South Sudan (UNDP),2018,SSD-18/HSS10/SA1/P/NGO/8096,1/30/2019 5:58:41 PM,Overall,800,800,1200,1200,4000,835,815,1346,1253,4249
19,South Sudan (UNDP),2018,SSD-18/HSS10/SA1/P/NGO/8096,1/30/2019 5:58:41 PM,People in Host Communities,220,220,470,470,1380,220,220,470,470,1380
19,South Sudan (UNDP),2018,SSD-18/HSS10/SA1/P/NGO/8096,1/30/2019 5:58:41 PM,"Trainers, Promoters, Caretakers, committee members, etc.",100,100,40,40,280,100,100,40,40,280
19,South Sudan (UNDP),2018,SSD-18/HSS10/SA1/P/NGO/8113,1/29/2019 7:45:19 PM,Internally Displaced People,300,500,200,200,1200,200,670,190,480,1540
19,South Sudan (UNDP),2018,SSD-18/HSS10/SA1/P/NGO/8113,1/29/2019 7:45:19 PM,Other,130,105,80,80,395,0,0,0,0,0
19,South Sudan (UNDP),2018,SSD-18/HSS10/SA1/P/NGO/8113,1/29/2019 7:45:19 PM,Overall,630,855,385,450,2320,790,2425,820,1352,5387
19,South Sudan (UNDP),2018,SSD-18/HSS10/SA1/P/NGO/8113,1/29/2019 7:45:19 PM,People in Host Communities,200,250,105,150,705,590,1755,630,872,3847
19,South Sudan (UNDP),2018,SSD-18/HSS10/SA1/P/NGO/8179,1/29/2019 7:11:26 PM,Internally Displaced People,100,1400,100,300,1900,24,1100,40,355,1519
19,South Sudan (UNDP),2018,SSD-18/HSS10/SA1/P/NGO/8179,1/29/2019 7:11:26 PM,Overall,200,2000,200,600,3000,88,2280,70,655,3093
19,South Sudan (UNDP),2018,SSD-18/HSS10/SA1/P/NGO/8179,1/29/2019 7:11:26 PM,People in Host Communities,50,550,100,300,1000,34,1140,30,300,1504
19,South Sudan (UNDP),2018,SSD-18/HSS10/SA1/P/NGO/8179,1/29/2019 7:11:26 PM,"Trainers, Promoters, Caretakers, committee members, etc.",50,50,0,0,100,30,40,0,0,70
19,South Sudan (UNDP),2018,SSD-18/HSS10/SA1/P/NGO/8204,1/29/2019 8:46:10 PM,Internally Displaced People,60,60,1180,1180,2480,35,36,1540,1368,2979
19,South Sudan (UNDP),2018,SSD-18/HSS10/SA1/P/NGO/8204,1/29/2019 8:46:10 PM,Overall,100,120,1950,1950,4120,35,36,2038,1925,4034
19,South Sudan (UNDP),2018,SSD-18/HSS10/SA1/P/NGO/8204,1/29/2019 8:46:10 PM,People in Host Communities,40,60,770,770,1640,0,0,498,557,1055
19,South Sudan (UNDP),2018,SSD-18/HSS10/SA1/P/NGO/8241,1/24/2019 11:37:38 AM,Internally Displaced People,150,400,150,250,950,70,437,23,350,880
19,South Sudan (UNDP),2018,SSD-18/HSS10/SA1/P/NGO/8241,1/24/2019 11:37:38 AM,Overall,300,700,250,400,1650,149,837,38,671,1695
19,South Sudan (UNDP),2018,SSD-18/HSS10/SA1/P/NGO/8241,1/24/2019 11:37:38 AM,People in Host Communities,150,300,100,150,700,79,400,15,321,815
19,South Sudan (UNDP),2018,SSD-18/HSS10/SA1/P/NGO/8256,2/2/2019 4:58:51 PM,Internally Displaced People,41,62,388,486,977,688,892,1293,1577,4450
19,South Sudan (UNDP),2018,SSD-18/HSS10/SA1/P/NGO/8256,2/2/2019 4:58:51 PM,Overall,41,62,388,486,977,688,892,1293,1577,4450
19,South Sudan (UNDP),2018,SSD-18/HSS10/SA1/P/NGO/8306,1/29/2019 8:26:00 PM,Internally Displaced People,200,1500,300,1000,3000,240,1870,256,1220,3586
19,South Sudan (UNDP),2018,SSD-18/HSS10/SA1/P/NGO/8306,1/29/2019 8:26:00 PM,Other,50,50,0,0,100,20,25,25,40,110
19,South Sudan (UNDP),2018,SSD-18/HSS10/SA1/P/NGO/8306,1/29/2019 8:26:00 PM,Overall,500,2500,500,1500,5000,537,2780,612,1850,5779
19,South Sudan (UNDP),2018,SSD-18/HSS10/SA1/P/NGO/8306,1/29/2019 8:26:00 PM,People in Host Communities,250,950,200,500,1900,277,885,331,590,2083
19,South Sudan (UNDP),2018,SSD-18/HSS10/SA1/WASH/INGO/7915,12/11/2018 7:42:38 AM,Internally Displaced People,1600,2000,3100,3300,10000,1587,2063,2143,2143,7936
19,South Sudan (UNDP),2018,SSD-18/HSS10/SA1/WASH/INGO/7915,12/11/2018 7:42:38 AM,Overall,3200,4000,6200,6600,20000,5347,6761,7156,7188,26452
19,South Sudan (UNDP),2018,SSD-18/HSS10/SA1/WASH/INGO/7915,12/11/2018 7:42:38 AM,People in Host Communities,1600,2000,3100,3300,10000,3703,4814,4999,4999,18515
19,South Sudan (UNDP),2018,SSD-18/HSS10/SA1/WASH/INGO/8118,1/22/2019 8:01:57 AM,Internally Displaced People,3663,4398,3755,4666,16482,5909,8397,7153,9641,31100
19,South Sudan (UNDP),2018,SSD-18/HSS10/SA1/WASH/INGO/8118,1/22/2019 8:01:57 AM,Overall,6105,7330,6258,7777,27470,5909,8397,7153,9641,31100
19,South Sudan (UNDP),2018,SSD-18/HSS10/SA1/WASH/INGO/8118,1/22/2019 8:01:57 AM,People in Host Communities,1831,2199,1877,2333,8240,0,0,0,0,0
19,South Sudan (UNDP),2018,SSD-18/HSS10/SA1/WASH/INGO/8118,1/22/2019 8:01:57 AM,Refugee Returnees,611,733,626,778,2748,0,0,0,0,0
19,South Sudan (UNDP),2018,SSD-18/HSS10/SA1/WASH/INGO/8146,12/11/2018 7:05:36 AM,Internally Displaced People,533,512,768,737,2550,586,648,918,892,3044
19,South Sudan (UNDP),2018,SSD-18/HSS10/SA1/WASH/INGO/8146,12/11/2018 7:05:36 AM,Other,2603,2501,3746,3600,12450,2860,3163,4480,4356,14859
19,South Sudan (UNDP),2018,SSD-18/HSS10/SA1/WASH/INGO/8146,12/11/2018 7:05:36 AM,Overall,3136,3013,4514,4337,15000,3446,3811,5398,5248,17903
19,South Sudan (UNDP),2018,SSD-18/HSS10/SA1/WASH/INGO/8212,1/18/2019 1:50:11 PM,Children under 5,0,0,1043,1236,2279,0,0,0,0,0
19,South Sudan (UNDP),2018,SSD-18/HSS10/SA1/WASH/INGO/8212,1/18/2019 1:50:11 PM,Internally Displaced People,1071,1288,788,836,3983,0,0,0,0,0
19,South Sudan (UNDP),2018,SSD-18/HSS10/SA1/WASH/INGO/8212,1/18/2019 1:50:11 PM,Overall,4023,5238,4339,4710,18310,5559,5734,4574,3510,19377
19,South Sudan (UNDP),2018,SSD-18/HSS10/SA1/WASH/INGO/8212,1/18/2019 1:50:11 PM,People in Host Communities,2952,3625,2508,2638,11723,0,0,0,0,0
19,South Sudan (UNDP),2018,SSD-18/HSS10/SA1/WASH/INGO/8212,1/18/2019 1:50:11 PM,Pregnant and Lactating Women,0,325,0,0,325,0,0,0,0,0
19,South Sudan (UNDP),2018,SSD-18/HSS10/SA1/WASH/NGO/7881,12/11/2018 7:17:18 AM,Internally Displaced People,1500,3000,3000,2000,9500,2275,3408,2501,3178,11362
19,South Sudan (UNDP),2018,SSD-18/HSS10/SA1/WASH/NGO/7881,12/11/2018 7:17:18 AM,Other,500,500,500,1000,2500,399,597,440,557,1993
19,South Sudan (UNDP),2018,SSD-18/HSS10/SA1/WASH/NGO/7881,12/11/2018 7:17:18 AM,Overall,3000,4500,4500,6000,18000,3989,5981,4388,5576,19934
19,South Sudan (UNDP),2018,SSD-18/HSS10/SA1/WASH/NGO/7881,12/11/2018 7:17:18 AM,People in Host Communities,1000,1000,1000,3000,6000,1315,1976,1447,1841,6579
19,South Sudan (UNDP),2018,SSD-18/HSS10/SA1/WASH/NGO/7892,11/27/2018 8:42:22 AM,Internally Displaced People,2000,2500,2700,3550,10750,2112,2489,2698,3472,10771
19,South Sudan (UNDP),2018,SSD-18/HSS10/SA1/WASH/NGO/7892,11/27/2018 8:42:22 AM,Overall,2500,4000,3500,5000,15000,2557,3992,3493,4958,15000
19,South Sudan (UNDP),2018,SSD-18/HSS10/SA1/WASH/NGO/7892,11/27/2018 8:42:22 AM,People in Host Communities,500,1500,800,1450,4250,445,1503,795,1486,4229
19,South Sudan (UNDP),2018,SSD-18/HSS10/SA1/WASH/NGO/7893,12/11/2018 7:20:15 AM,Internally Displaced People,294,630,1569,1822,4315,308,448,1008,1036,2800
19,South Sudan (UNDP),2018,SSD-18/HSS10/SA1/WASH/NGO/7893,12/11/2018 7:20:15 AM,Overall,840,1800,4440,4920,12000,1408,2048,4608,4736,12800
19,South Sudan (UNDP),2018,SSD-18/HSS10/SA1/WASH/NGO/7893,12/11/2018 7:20:15 AM,People in Host Communities,456,1009,2635,2846,6946,983,1430,3218,3307,8938
19,South Sudan (UNDP),2018,SSD-18/HSS10/SA1/WASH/NGO/7893,12/11/2018 7:20:15 AM,Refugee Returnees,42,90,230,246,608,101,148,331,340,920
19,South Sudan (UNDP),2018,SSD-18/HSS10/SA1/WASH/NGO/7893,12/11/2018 7:20:15 AM,"Trainers, Promoters, Caretakers, committee members, etc.",45,71,6,6,128,54,58,15,15,142
19,South Sudan (UNDP),2018,SSD-18/HSS10/SA1/WASH/NGO/7894,12/11/2018 7:24:46 AM,Children under 5,0,0,500,500,1000,0,0,485,518,1003
19,South Sudan (UNDP),2018,SSD-18/HSS10/SA1/WASH/NGO/7894,12/11/2018 7:24:46 AM,Internally Displaced People,2596,3501,2454,2649,11200,1854,1812,1575,1769,7010
19,South Sudan (UNDP),2018,SSD-18/HSS10/SA1/WASH/NGO/7894,12/11/2018 7:24:46 AM,Overall,3994,5386,4160,4460,18000,3836,3714,4343,4552,16445
19,South Sudan (UNDP),2018,SSD-18/HSS10/SA1/WASH/NGO/7894,12/11/2018 7:24:46 AM,People in Host Communities,1398,1885,1206,1311,5800,1982,1902,2283,2265,8432
19,South Sudan (UNDP),2018,SSD-18/HSS10/SA1/WASH/NGO/7981,12/11/2018 7:47:40 AM,Internally Displaced People,1124,1600,2130,2300,7154,581,1790,1127,1670,5168
19,South Sudan (UNDP),2018,SSD-18/HSS10/SA1/WASH/NGO/7981,12/11/2018 7:47:40 AM,Overall,2250,4000,4350,5400,16000,3356,4528,4262,5608,17754
19,South Sudan (UNDP),2018,SSD-18/HSS10/SA1/WASH/NGO/7981,12/11/2018 7:47:40 AM,People in Host Communities,1126,2400,2220,3100,8846,2775,2738,3135,3938,12586
19,South Sudan (UNDP),2018,SSD-18/HSS10/SA1/WASH/NGO/7984,1/14/2019 5:18:49 AM,Children under 5,0,0,1764,1836,3600,0,0,1842,1848,3690
19,South Sudan (UNDP),2018,SSD-18/HSS10/SA1/WASH/NGO/7984,1/14/2019 5:18:49 AM,Internally Displaced People,1251,1314,1878,1887,6330,1767,1926,1992,1975,7660
19,South Sudan (UNDP),2018,SSD-18/HSS10/SA1/WASH/NGO/7984,1/14/2019 5:18:49 AM,Overall,4170,4380,6259,6291,21100,6112,6765,8411,8533,29821
19,South Sudan (UNDP),2018,SSD-18/HSS10/SA1/WASH/NGO/7984,1/14/2019 5:18:49 AM,People in Host Communities,2919,3066,2617,2568,11170,4257,4726,4699,4598,18280
19,South Sudan (UNDP),2018,SSD-18/HSS10/SA1/WASH/NGO/7984,1/14/2019 5:18:49 AM,"Trainers, Promoters, Caretakers, committee members, etc.",0,0,0,0,0,88,115,0,0,203
19,South Sudan (UNDP),2018,SSD-18/HSS10/SA1/WASH/NGO/8005,12/11/2018 7:55:12 AM,Children under 5,0,0,131,197,328,0,0,0,0,0
19,South Sudan (UNDP),2018,SSD-18/HSS10/SA1/WASH/NGO/8005,12/11/2018 7:55:12 AM,Internally Displaced People,788,1181,525,787,3281,991,2902,793,1136,5822
19,South Sudan (UNDP),2018,SSD-18/HSS10/SA1/WASH/NGO/8005,12/11/2018 7:55:12 AM,Overall,1182,3084,919,1378,6563,1107,3345,863,1248,6563
19,South Sudan (UNDP),2018,SSD-18/HSS10/SA1/WASH/NGO/8005,12/11/2018 7:55:12 AM,Pregnant and Lactating Women,0,1313,0,0,1313,0,123,0,0,123
19,South Sudan (UNDP),2018,SSD-18/HSS10/SA1/WASH/NGO/8005,12/11/2018 7:55:12 AM,Refugee Returnees,394,590,263,394,1641,116,320,70,112,618
19,South Sudan (UNDP),2018,SSD-18/HSS10/SA1/WASH/NGO/8189,1/16/2019 8:18:10 AM,Internally Displaced People,0,0,0,0,0,1090,1800,1250,1315,5455
19,South Sudan (UNDP),2018,SSD-18/HSS10/SA1/WASH/NGO/8189,1/16/2019 8:18:10 AM,Overall,6400,7100,4500,5500,23500,7400,10100,8500,8615,34615
19,South Sudan (UNDP),2018,SSD-18/HSS10/SA1/WASH/NGO/8189,1/16/2019 8:18:10 AM,People in Host Communities,6350,7050,4470,5470,23340,7000,8000,7000,7000,29000
19,South Sudan (UNDP),2018,SSD-18/HSS10/SA1/WASH/NGO/8189,1/16/2019 8:18:10 AM,"Trainers, Promoters, Caretakers, committee members, etc.",50,50,30,30,160,160,0,0,0,160
19,South Sudan (UNDP),2018,SSD-18/HSS10/SA1/WASH/NGO/8238,11/27/2018 10:45:37 AM,Children under 5,0,0,800,1200,2000,0,0,954,1394,2348
19,South Sudan (UNDP),2018,SSD-18/HSS10/SA1/WASH/NGO/8238,11/27/2018 10:45:37 AM,Internally Displaced People,1700,3200,1000,1500,7400,1245,1948,1850,2200,7243
19,South Sudan (UNDP),2018,SSD-18/HSS10/SA1/WASH/NGO/8238,11/27/2018 10:45:37 AM,Overall,2100,5200,2500,3700,13500,2320,3835,4731,5062,15948
19,South Sudan (UNDP),2018,SSD-18/HSS10/SA1/WASH/NGO/8238,11/27/2018 10:45:37 AM,People in Host Communities,400,2000,700,1000,4100,1075,1887,1927,1468,6357
19,South Sudan (UNDP),2018,SSD-18/HSS10/SA1/WASH/UN/8174,2/13/2019 12:47:36 PM,Children under 5,0,0,2257,2447,4704,0,0,1202,1455,2657
19,South Sudan (UNDP),2018,SSD-18/HSS10/SA1/WASH/UN/8174,2/13/2019 12:47:36 PM,Overall,0,0,2257,2447,4704,72,71,1203,1455,2801
19,South Sudan (UNDP),2018,SSD-18/HSS10/SA1/WASH/UN/8174,2/13/2019 12:47:36 PM,"Trainers, Promoters, Caretakers, committee members, etc.",0,0,0,0,0,72,71,0,0,143
19,South Sudan (UNDP),2018,SSD-18/HSS10/SA2/CCCM/INGO/9776,7/23/2019 8:38:13 PM,Internally Displaced People,1800,2850,5100,5250,15000,849,1080,1538,1845,5312
19,South Sudan (UNDP),2018,SSD-18/HSS10/SA2/CCCM/INGO/9776,7/23/2019 8:38:13 PM,Overall,1800,2850,5100,5250,15000,6167,7598,9816,11322,34903
19,South Sudan (UNDP),2018,SSD-18/HSS10/SA2/CCCM/INGO/9780,5/24/2019 11:51:01 AM,Internally Displaced People,5000,6000,2500,2500,16000,6091,10348,5573,5683,27695
19,South Sudan (UNDP),2018,SSD-18/HSS10/SA2/CCCM/INGO/9780,5/24/2019 11:51:01 AM,Overall,5000,6000,2500,2500,16000,6091,10348,5573,5683,27695
19,South Sudan (UNDP),2018,SSD-18/HSS10/SA2/CCCM/INGO/9963,7/24/2019 6:13:14 AM,Internally Displaced People,16401,18372,18766,18025,71564,36969,40289,0,0,77258
19,South Sudan (UNDP),2018,SSD-18/HSS10/SA2/CCCM/INGO/9963,7/24/2019 6:13:14 AM,Overall,16401,18372,18766,18025,71564,36939,40289,0,0,77228
19,South Sudan (UNDP),2018,SSD-18/HSS10/SA2/CCCM/NGO/9918,7/4/2019 7:03:12 AM,Internally Displaced People,5853,9668,6345,8134,30000,5024,3301,6866,6227,21418
19,South Sudan (UNDP),2018,SSD-18/HSS10/SA2/CCCM/NGO/9918,7/4/2019 7:03:12 AM,Overall,5853,9668,6345,8134,30000,7325,5883,8211,8581,30000
19,South Sudan (UNDP),2018,SSD-18/HSS10/SA2/CCCM/NGO/9918,7/4/2019 7:03:12 AM,People in Host Communities,0,0,0,0,0,2301,2582,1345,2354,8582
19,South Sudan (UNDP),2018,SSD-18/HSS10/SA2/E/INGO/9810,9/27/2019 12:09:13 PM,Internally Displaced People,548,294,4974,2678,8494,268,107,2100,1660,4135
19,South Sudan (UNDP),2018,SSD-18/HSS10/SA2/E/INGO/9810,9/27/2019 12:09:13 PM,Overall,685,367,6217,3348,10617,766,292,6370,3903,11331
19,South Sudan (UNDP),2018,SSD-18/HSS10/SA2/E/INGO/9810,9/27/2019 12:09:13 PM,People in Host Communities,137,73,1243,670,2123,506,185,4400,2243,7334
19,South Sudan (UNDP),2018,SSD-18/HSS10/SA2/E/INGO/9832,7/15/2019 9:41:15 AM,Children under 5,0,0,890,950,1840,0,0,763,491,1254
19,South Sudan (UNDP),2018,SSD-18/HSS10/SA2/E/INGO/9832,7/15/2019 9:41:15 AM,Internally Displaced People,150,350,1250,960,2710,212,432,1776,1631,4051
19,South Sudan (UNDP),2018,SSD-18/HSS10/SA2/E/INGO/9832,7/15/2019 9:41:15 AM,Overall,510,820,3160,2797,7287,560,912,5245,4040,10757
19,South Sudan (UNDP),2018,SSD-18/HSS10/SA2/E/INGO/9832,7/15/2019 9:41:15 AM,People in Host Communities,250,330,1020,887,2487,256,470,2715,1918,5359
19,South Sudan (UNDP),2018,SSD-18/HSS10/SA2/E/INGO/9832,7/15/2019 9:41:15 AM,"Trainers, Promoters, Caretakers, committee members, etc.",100,140,0,0,240,92,1,0,0,93
19,South Sudan (UNDP),2018,SSD-18/HSS10/SA2/E/INGO/9889,7/15/2019 9:35:29 AM,Internally Displaced People,860,990,2200,2200,6250,3800,3250,4960,6105,18115
19,South Sudan (UNDP),2018,SSD-18/HSS10/SA2/E/INGO/9889,7/15/2019 9:35:29 AM,Overall,1890,1810,2800,2800,9300,6094,4690,8663,8874,28321
19,South Sudan (UNDP),2018,SSD-18/HSS10/SA2/E/INGO/9889,7/15/2019 9:35:29 AM,People in Host Communities,1030,820,600,600,3050,2294,1440,3703,2769,10206
19,South Sudan (UNDP),2018,SSD-18/HSS10/SA2/E/NGO/9795,6/20/2019 11:21:43 AM,Internally Displaced People,14,12,611,916,1553,70,60,2442,3662,6234
19,South Sudan (UNDP),2018,SSD-18/HSS10/SA2/E/NGO/9795,6/20/2019 11:21:43 AM,Overall,70,60,2442,3662,6234,131,27,4308,3219,7685
19,South Sudan (UNDP),2018,SSD-18/HSS10/SA2/E/NGO/9795,6/20/2019 11:21:43 AM,People in Host Communities,56,48,1831,2746,4681,131,27,4308,3129,7595
19,South Sudan (UNDP),2018,SSD-18/HSS10/SA2/E/NGO/9796,7/15/2019 9:33:59 AM,Internally Displaced People,0,0,3568,2583,6151,0,0,3416,1754,5170
19,South Sudan (UNDP),2018,SSD-18/HSS10/SA2/E/NGO/9796,7/15/2019 9:33:59 AM,Overall,182,218,6151,4454,11005,182,218,8106,4127,12633
19,South Sudan (UNDP),2018,SSD-18/HSS10/SA2/E/NGO/9796,7/15/2019 9:33:59 AM,People in Host Communities,0,0,2583,1871,4454,0,0,4690,2373,7063
19,South Sudan (UNDP),2018,SSD-18/HSS10/SA2/E/NGO/9796,7/15/2019 9:33:59 AM,"Trainers, Promoters, Caretakers, committee members, etc.",182,218,0,0,400,182,218,0,0,400
19,South Sudan (UNDP),2018,SSD-18/HSS10/SA2/E/NGO/9959,10/2/2019 5:41:39 AM,Internally Displaced People,150,70,2376,1408,4004,187,88,4204,3788,8267
19,South Sudan (UNDP),2018,SSD-18/HSS10/SA2/E/NGO/9959,10/2/2019 5:41:39 AM,Overall,374,176,5940,3520,10010,374,176,8704,7349,16603
19,South Sudan (UNDP),2018,SSD-18/HSS10/SA2/E/NGO/9959,10/2/2019 5:41:39 AM,People in Host Communities,187,88,2970,1760,5005,150,70,3600,2825,6645
19,South Sudan (UNDP),2018,SSD-18/HSS10/SA2/E/NGO/9959,10/2/2019 5:41:39 AM,Refugee Returnees,37,18,594,352,1001,37,18,900,736,1691
19,South Sudan (UNDP),2018,SSD-18/HSS10/SA2/FSL/INGO/10046,4/10/2019 5:26:41 AM,Children under 5,0,0,3095,2985,6080,0,0,0,0,0
19,South Sudan (UNDP),2018,SSD-18/HSS10/SA2/FSL/INGO/10046,4/10/2019 5:26:41 AM,Other,353,287,0,0,640,0,0,0,0,0
19,South Sudan (UNDP),2018,SSD-18/HSS10/SA2/FSL/INGO/10046,4/10/2019 5:26:41 AM,Overall,3864,5795,8900,13439,31998,3320,6212,8524,12617,30673
19,South Sudan (UNDP),2018,SSD-18/HSS10/SA2/FSL/INGO/10046,4/10/2019 5:26:41 AM,People in Host Communities,3511,5508,5805,10454,25278,0,0,0,0,0
19,South Sudan (UNDP),2018,SSD-18/HSS10/SA2/FSL/INGO/9996,5/21/2019 11:46:35 AM,Internally Displaced People,3442,4207,3442,4207,15298,1578,2066,1578,2066,7288
19,South Sudan (UNDP),2018,SSD-18/HSS10/SA2/FSL/INGO/9996,5/21/2019 11:46:35 AM,Overall,11475,14025,11475,14025,51000,11051,14449,11052,14448,51000
19,South Sudan (UNDP),2018,SSD-18/HSS10/SA2/FSL/INGO/9996,5/21/2019 11:46:35 AM,People in Host Communities,8033,9818,8033,9818,35702,9472,12384,9472,12384,43712
19,South Sudan (UNDP),2018,SSD-18/HSS10/SA2/FSL/NGO/10015,4/10/2019 5:47:34 AM,Internally Displaced People,3456,5184,4224,6336,19200,3400,5340,4424,6436,19600
19,South Sudan (UNDP),2018,SSD-18/HSS10/SA2/FSL/NGO/10015,4/10/2019 5:47:34 AM,Overall,8640,12960,10560,15840,48000,8400,13300,10860,15940,48500
19,South Sudan (UNDP),2018,SSD-18/HSS10/SA2/FSL/NGO/10015,4/10/2019 5:47:34 AM,People in Host Communities,5184,7776,6336,9504,28800,5000,7960,6436,9504,28900
19,South Sudan (UNDP),2018,SSD-18/HSS10/SA2/FSL/NGO/10077,4/10/2019 5:26:03 AM,Internally Displaced People,1280,1344,1856,1920,6400,1280,1344,1856,1920,6400
19,South Sudan (UNDP),2018,SSD-18/HSS10/SA2/FSL/NGO/10077,4/10/2019 5:26:03 AM,Overall,6400,6720,9279,9599,31998,6400,6720,9279,9599,31998
19,South Sudan (UNDP),2018,SSD-18/HSS10/SA2/FSL/NGO/10077,4/10/2019 5:26:03 AM,People in Host Communities,4160,4369,6032,6238,20799,4160,4368,6031,6239,20798
19,South Sudan (UNDP),2018,SSD-18/HSS10/SA2/FSL/NGO/10077,4/10/2019 5:26:03 AM,Refugee Returnees,960,1007,1391,1441,4799,960,1008,1440,1392,4800
19,South Sudan (UNDP),2018,SSD-18/HSS10/SA2/FSL/NGO/9789,4/10/2019 5:44:43 AM,Internally Displaced People,2814,5098,150,222,8284,614,1257,0,0,1871
19,South Sudan (UNDP),2018,SSD-18/HSS10/SA2/FSL/NGO/9789,4/10/2019 5:44:43 AM,Overall,14064,21090,738,1110,37002,6486,30516,0,0,37002
19,South Sudan (UNDP),2018,SSD-18/HSS10/SA2/FSL/NGO/9789,4/10/2019 5:44:43 AM,People in Host Communities,10548,15816,552,834,27750,5872,29259,0,0,35131
19,South Sudan (UNDP),2018,SSD-18/HSS10/SA2/FSL/NGO/9789,4/10/2019 5:44:43 AM,Refugee Returnees,702,176,36,54,968,0,0,0,0,0
19,South Sudan (UNDP),2018,SSD-18/HSS10/SA2/FSL/NGO/9830,4/10/2019 5:45:13 AM,Internally Displaced People,1740,3300,1200,900,7140,320,639,960,1281,3200
19,South Sudan (UNDP),2018,SSD-18/HSS10/SA2/FSL/NGO/9830,4/10/2019 5:45:13 AM,Overall,4800,10800,3000,2400,21000,2070,4440,6210,8280,21000
19,South Sudan (UNDP),2018,SSD-18/HSS10/SA2/FSL/NGO/9830,4/10/2019 5:45:13 AM,People in Host Communities,1680,3000,600,600,5880,882,1764,2646,3527,8819
19,South Sudan (UNDP),2018,SSD-18/HSS10/SA2/FSL/NGO/9830,4/10/2019 5:45:13 AM,Pregnant and Lactating Women,0,300,0,0,300,0,300,0,0,300
19,South Sudan (UNDP),2018,SSD-18/HSS10/SA2/FSL/NGO/9830,4/10/2019 5:45:13 AM,Refugee Returnees,1380,4200,1200,900,7680,868,1737,2604,3472,8681
19,South Sudan (UNDP),2018,SSD-18/HSS10/SA2/FSL/NGO/9903,4/10/2019 5:45:44 AM,Internally Displaced People,6000,8000,5000,7000,26000,6000,8000,5000,7000,26000
19,South Sudan (UNDP),2018,SSD-18/HSS10/SA2/FSL/NGO/9903,4/10/2019 5:45:44 AM,Other,200,400,100,50,750,200,400,100,50,750
19,South Sudan (UNDP),2018,SSD-18/HSS10/SA2/FSL/NGO/9903,4/10/2019 5:45:44 AM,Overall,8000,12000,7000,9000,36000,8000,12000,7000,9000,36000
19,South Sudan (UNDP),2018,SSD-18/HSS10/SA2/FSL/NGO/9903,4/10/2019 5:45:44 AM,People in Host Communities,1800,3600,1900,1950,9250,1800,3600,1900,1950,9250
19,South Sudan (UNDP),2018,SSD-18/HSS10/SA2/FSL/NGO/9920,4/10/2019 5:46:16 AM,Internally Displaced People,8400,12900,1980,2700,25980,8436,17643,2145,957,29181
19,South Sudan (UNDP),2018,SSD-18/HSS10/SA2/FSL/NGO/9920,4/10/2019 5:46:16 AM,Overall,16800,25800,4002,5400,52002,18180,28428,4254,1740,52602
19,South Sudan (UNDP),2018,SSD-18/HSS10/SA2/FSL/NGO/9920,4/10/2019 5:46:16 AM,People in Host Communities,5040,7740,1200,1620,15600,8324,8238,112,660,17334
19,South Sudan (UNDP),2018,SSD-18/HSS10/SA2/FSL/NGO/9920,4/10/2019 5:46:16 AM,Refugee Returnees,3360,5160,822,1080,10422,1420,2547,987,123,5077
19,South Sudan (UNDP),2018,SSD-18/HSS10/SA2/FSL/NGO/9966,4/10/2019 5:46:56 AM,Internally Displaced People,3000,4000,1500,1500,10000,3000,4000,1500,1500,10000
19,South Sudan (UNDP),2018,SSD-18/HSS10/SA2/FSL/NGO/9966,4/10/2019 5:46:56 AM,Overall,6000,9000,3000,3000,21000,6000,9000,3000,3000,21000
19,South Sudan (UNDP),2018,SSD-18/HSS10/SA2/FSL/NGO/9966,4/10/2019 5:46:56 AM,People in Host Communities,2000,3000,1000,1000,7000,2000,3000,1000,1000,7000
19,South Sudan (UNDP),2018,SSD-18/HSS10/SA2/FSL/NGO/9966,4/10/2019 5:46:56 AM,Refugee Returnees,1000,2000,500,500,4000,1000,2000,500,500,4000
19,South Sudan (UNDP),2018,SSD-18/HSS10/SA2/FSL/UN/10025,7/5/2019 11:32:26 AM,Internally Displaced People,4400,6600,4400,6600,22000,0,0,0,0,0
19,South Sudan (UNDP),2018,SSD-18/HSS10/SA2/FSL/UN/10025,7/5/2019 11:32:26 AM,Overall,11000,16500,11000,16500,55000,11000,16500,11000,16500,55000
19,South Sudan (UNDP),2018,SSD-18/HSS10/SA2/FSL/UN/10025,7/5/2019 11:32:26 AM,People in Host Communities,4400,6600,4400,6600,22000,0,0,0,0,0
19,South Sudan (UNDP),2018,SSD-18/HSS10/SA2/FSL/UN/10025,7/5/2019 11:32:26 AM,Refugee Returnees,2200,3300,2200,3300,11000,0,0,0,0,0
19,South Sudan (UNDP),2018,SSD-18/HSS10/SA2/H/INGO/10080,6/20/2019 6:13:53 AM,Children under 5,0,0,3561,2897,6458,0,0,17509,17392,34901
19,South Sudan (UNDP),2018,SSD-18/HSS10/SA2/H/INGO/10080,6/20/2019 6:13:53 AM,Internally Displaced People,12936,14218,0,0,27154,29178,33908,0,0,63086
19,South Sudan (UNDP),2018,SSD-18/HSS10/SA2/H/INGO/10080,6/20/2019 6:13:53 AM,Overall,18748,20311,5088,4139,48286,29692,34911,17509,17392,99504
19,South Sudan (UNDP),2018,SSD-18/HSS10/SA2/H/INGO/10080,6/20/2019 6:13:53 AM,People in Host Communities,5812,6093,1526,1242,14673,514,1003,0,0,1517
19,South Sudan (UNDP),2018,SSD-18/HSS10/SA2/H/INGO/9782,6/20/2019 10:37:15 AM,Internally Displaced People,5200,5200,1300,1300,13000,3473,3179,462,846,7960
19,South Sudan (UNDP),2018,SSD-18/HSS10/SA2/H/INGO/9782,6/20/2019 10:37:15 AM,Overall,10400,10400,2600,2600,26000,746,958,282,298,2284
19,South Sudan (UNDP),2018,SSD-18/HSS10/SA2/H/INGO/9782,6/20/2019 10:37:15 AM,People in Host Communities,5200,5200,1300,1300,13000,1787,3569,1230,942,7528
19,South Sudan (UNDP),2018,SSD-18/HSS10/SA2/H/INGO/9787,10/21/2019 1:52:03 PM,Children under 5,0,0,3530,3530,7060,0,0,1288,1410,2698
19,South Sudan (UNDP),2018,SSD-18/HSS10/SA2/H/INGO/9787,10/21/2019 1:52:03 PM,Overall,3888,7267,7309,7309,25773,1513,2535,644,705,5397
19,South Sudan (UNDP),2018,SSD-18/HSS10/SA2/H/INGO/9787,10/21/2019 1:52:03 PM,People in Host Communities,0,0,0,0,0,3026,5070,1288,1410,10794
19,South Sudan (UNDP),2018,SSD-18/HSS10/SA2/H/INGO/9787,10/21/2019 1:52:03 PM,Pregnant and Lactating Women,0,6361,0,0,6361,0,552,0,0,552
19,South Sudan (UNDP),2018,SSD-18/HSS10/SA2/H/INGO/9873,10/21/2019 1:52:15 PM,Internally Displaced People,7513,7819,1997,2079,19408,0,0,0,0,0
19,South Sudan (UNDP),2018,SSD-18/HSS10/SA2/H/INGO/9873,10/21/2019 1:52:15 PM,Overall,9977,10383,2652,2761,25773,2794,3401,4124,5815,16134
19,South Sudan (UNDP),2018,SSD-18/HSS10/SA2/H/INGO/9873,10/21/2019 1:52:15 PM,People in Host Communities,2464,2564,655,682,6365,0,0,0,0,0
19,South Sudan (UNDP),2018,SSD-18/HSS10/SA2/H/INGO/9890,7/15/2019 9:42:22 AM,Internally Displaced People,10229,10647,2400,2497,25773,8428,10908,3669,3697,26702
19,South Sudan (UNDP),2018,SSD-18/HSS10/SA2/H/INGO/9890,7/15/2019 9:42:22 AM,Overall,10229,10647,2400,2497,25773,8428,10908,3669,3697,26702
19,South Sudan (UNDP),2018,SSD-18/HSS10/SA2/H/INGO/9921,2/6/2020 10:49:41 AM,Internally Displaced People,5025,5443,7231,7834,25533,12119,14063,3256,4554,33992
19,South Sudan (UNDP),2018,SSD-18/HSS10/SA2/H/INGO/9921,2/6/2020 10:49:41 AM,Overall,6281,6804,9038,9792,31915,17313,20090,4650,6506,48559
19,South Sudan (UNDP),2018,SSD-18/HSS10/SA2/H/INGO/9921,2/6/2020 10:49:41 AM,People in Host Communities,1256,1361,1807,1958,6382,5194,6027,1394,1952,14567
19,South Sudan (UNDP),2018,SSD-18/HSS10/SA2/H/INGO/9953,6/20/2019 10:40:00 AM,Children under 5,0,0,4851,5378,10229,0,0,0,0,0
19,South Sudan (UNDP),2018,SSD-18/HSS10/SA2/H/INGO/9953,6/20/2019 10:40:00 AM,Other,7700,8388,0,0,16088,11142,15145,0,0,26287
19,South Sudan (UNDP),2018,SSD-18/HSS10/SA2/H/INGO/9953,6/20/2019 10:40:00 AM,Overall,7700,8388,4851,5378,26317,10806,14662,11230,11111,47809
19,South Sudan (UNDP),2018,SSD-18/HSS10/SA2/H/NGO/10030,6/20/2019 6:17:17 AM,Internally Displaced People,424,1670,945,1056,4095,1468,2316,1297,1619,6700
19,South Sudan (UNDP),2018,SSD-18/HSS10/SA2/H/NGO/10030,6/20/2019 6:17:17 AM,Overall,684,2735,1558,1862,6839,2446,3860,2162,2698,11166
19,South Sudan (UNDP),2018,SSD-18/HSS10/SA2/H/NGO/10030,6/20/2019 6:17:17 AM,People in Host Communities,260,1065,613,806,2744,612,965,541,674,2792
19,South Sudan (UNDP),2018,SSD-18/HSS10/SA2/H/NGO/10030,6/20/2019 6:17:17 AM,Refugee Returnees,0,0,0,0,0,367,579,324,405,1675
19,South Sudan (UNDP),2018,SSD-18/HSS10/SA2/H/NGO/10032,6/20/2019 6:17:56 AM,Internally Displaced People,507,533,250,259,1549,0,0,0,0,0
19,South Sudan (UNDP),2018,SSD-18/HSS10/SA2/H/NGO/10032,6/20/2019 6:17:56 AM,Overall,2881,2963,633,695,7172,7156,7693,5503,5961,26313
19,South Sudan (UNDP),2018,SSD-18/HSS10/SA2/H/NGO/10032,6/20/2019 6:17:56 AM,Pastoralists,759,767,158,170,1854,2988,2178,509,972,6647
19,South Sudan (UNDP),2018,SSD-18/HSS10/SA2/H/NGO/10032,6/20/2019 6:17:56 AM,People in Host Communities,1615,1613,225,266,3719,4168,5515,4994,4989,19666
19,South Sudan (UNDP),2018,SSD-18/HSS10/SA2/H/NGO/9790,6/20/2019 10:37:55 AM,Internally Displaced People,21,80,420,310,831,0,0,0,0,0
19,South Sudan (UNDP),2018,SSD-18/HSS10/SA2/H/NGO/9790,6/20/2019 10:37:55 AM,Overall,1619,3520,3885,3946,12970,1746,3956,2464,3738,11904
19,South Sudan (UNDP),2018,SSD-18/HSS10/SA2/H/NGO/9790,6/20/2019 10:37:55 AM,People in Host Communities,1598,3440,3465,3636,12139,0,0,0,0,0
19,South Sudan (UNDP),2018,SSD-18/HSS10/SA2/H/NGO/9798,6/20/2019 10:38:33 AM,Internally Displaced People,1440,2022,2464,2905,8831,1327,1990,2255,2653,8225
19,South Sudan (UNDP),2018,SSD-18/HSS10/SA2/H/NGO/9798,6/20/2019 10:38:33 AM,Overall,2117,2974,3623,4272,12986,1951,2926,3414,3901,12192
19,South Sudan (UNDP),2018,SSD-18/HSS10/SA2/H/NGO/9798,6/20/2019 10:38:33 AM,People in Host Communities,677,952,1159,1367,4155,624,936,1159,1248,3967
19,South Sudan (UNDP),2018,SSD-18/HSS10/SA2/H/NGO/9820,6/20/2019 6:49:38 AM,Internally Displaced People,1122,1171,1094,1256,4643,1350,1951,1004,1056,5361
19,South Sudan (UNDP),2018,SSD-18/HSS10/SA2/H/NGO/9820,6/20/2019 6:49:38 AM,Overall,11389,11711,10962,12611,46673,13494,19505,10042,10568,53609
19,South Sudan (UNDP),2018,SSD-18/HSS10/SA2/H/NGO/9820,6/20/2019 6:49:38 AM,People in Host Communities,10258,10450,9868,11354,41930,12144,17554,9038,9512,48248
19,South Sudan (UNDP),2018,SSD-18/HSS10/SA2/H/NGO/9824,6/20/2019 6:50:31 AM,Children under 5,0,0,693,762,1455,0,0,2017,2961,4978
19,South Sudan (UNDP),2018,SSD-18/HSS10/SA2/H/NGO/9824,6/20/2019 6:50:31 AM,Internally Displaced People,1163,1709,2262,2250,7384,3717,4774,2017,2961,13469
19,South Sudan (UNDP),2018,SSD-18/HSS10/SA2/H/NGO/9824,6/20/2019 6:50:31 AM,Overall,2363,2809,3832,3882,12886,3717,4774,2017,2961,13469
19,South Sudan (UNDP),2018,SSD-18/HSS10/SA2/H/NGO/9824,6/20/2019 6:50:31 AM,People in Host Communities,1200,1100,857,870,4027,0,0,0,0,0
19,South Sudan (UNDP),2018,SSD-18/HSS10/SA2/H/NGO/9836,6/20/2019 8:41:09 AM,Children under 5,0,0,1600,1600,3200,0,0,1472,1757,3229
19,South Sudan (UNDP),2018,SSD-18/HSS10/SA2/H/NGO/9836,6/20/2019 8:41:09 AM,Internally Displaced People,4605,8526,0,0,13131,4760,9440,0,0,14200
19,South Sudan (UNDP),2018,SSD-18/HSS10/SA2/H/NGO/9836,6/20/2019 8:41:09 AM,Overall,5565,10263,1736,1736,19300,5950,11800,1840,1910,21500
19,South Sudan (UNDP),2018,SSD-18/HSS10/SA2/H/NGO/9836,6/20/2019 8:41:09 AM,People in Host Communities,960,960,134,136,2190,1190,1285,368,153,2996
19,South Sudan (UNDP),2018,SSD-18/HSS10/SA2/H/NGO/9836,6/20/2019 8:41:09 AM,Pregnant and Lactating Women,0,777,0,0,777,0,1075,0,0,1075
19,South Sudan (UNDP),2018,SSD-18/HSS10/SA2/H/NGO/9869,6/20/2019 10:39:20 AM,Children under 5,0,0,759,790,1549,0,0,2955,3143,6098
19,South Sudan (UNDP),2018,SSD-18/HSS10/SA2/H/NGO/9869,6/20/2019 10:39:20 AM,Internally Displaced People,349,379,542,565,1835,491,659,443,472,2065
19,South Sudan (UNDP),2018,SSD-18/HSS10/SA2/H/NGO/9869,6/20/2019 10:39:20 AM,Overall,2491,2689,3779,3927,12886,3271,4391,2955,3143,13760
19,South Sudan (UNDP),2018,SSD-18/HSS10/SA2/H/NGO/9869,6/20/2019 10:39:20 AM,People in Host Communities,2142,1820,2478,2572,9012,2780,3182,2512,2671,11145
19,South Sudan (UNDP),2018,SSD-18/HSS10/SA2/H/NGO/9869,6/20/2019 10:39:20 AM,Pregnant and Lactating Women,0,490,0,0,490,0,550,0,0,550
19,South Sudan (UNDP),2018,SSD-18/HSS10/SA2/H/NGO/9910,6/20/2019 8:43:33 AM,Children under 5,0,0,377,851,1228,0,0,436,439,875
19,South Sudan (UNDP),2018,SSD-18/HSS10/SA2/H/NGO/9910,6/20/2019 8:43:33 AM,Internally Displaced People,2498,2938,635,906,6977,2097,3075,846,1030,7048
19,South Sudan (UNDP),2018,SSD-18/HSS10/SA2/H/NGO/9910,6/20/2019 8:43:33 AM,Overall,4156,4923,1474,2334,12887,3496,4013,1984,2022,11515
19,South Sudan (UNDP),2018,SSD-18/HSS10/SA2/H/NGO/9910,6/20/2019 8:43:33 AM,People in Host Communities,1658,1443,462,577,4140,1399,706,702,553,3360
19,South Sudan (UNDP),2018,SSD-18/HSS10/SA2/H/NGO/9910,6/20/2019 8:43:33 AM,Pregnant and Lactating Women,0,542,0,0,542,0,232,0,0,232
19,South Sudan (UNDP),2018,SSD-18/HSS10/SA2/H/NGO/9954,1/23/2020 9:35:53 PM,Children under 5,0,0,1232,1335,2567,0,0,0,0,0
19,South Sudan (UNDP),2018,SSD-18/HSS10/SA2/H/NGO/9954,1/23/2020 9:35:53 PM,Internally Displaced People,2875,2679,2463,2668,10685,0,0,0,0,0
19,South Sudan (UNDP),2018,SSD-18/HSS10/SA2/H/NGO/9954,1/23/2020 9:35:53 PM,Overall,5684,6157,6158,6671,24670,5563,6121,5772,6175,23631
19,South Sudan (UNDP),2018,SSD-18/HSS10/SA2/H/NGO/9954,1/23/2020 9:35:53 PM,People in Host Communities,2809,3080,2463,2668,11020,0,0,0,0,0
19,South Sudan (UNDP),2018,SSD-18/HSS10/SA2/H/NGO/9954,1/23/2020 9:35:53 PM,Pregnant and Lactating Women,0,398,0,0,398,0,0,0,0,0
19,South Sudan (UNDP),2018,SSD-18/HSS10/SA2/H/NGO/9981,6/20/2019 10:40:49 AM,Internally Displaced People,2000,2904,600,800,6304,1065,1573,962,1534,5134
19,South Sudan (UNDP),2018,SSD-18/HSS10/SA2/H/NGO/9981,6/20/2019 10:40:49 AM,Overall,4275,5904,1138,1569,12886,2090,3067,1862,2609,9628
19,South Sudan (UNDP),2018,SSD-18/HSS10/SA2/H/NGO/9981,6/20/2019 10:40:49 AM,People in Host Communities,2275,3000,538,769,6582,1025,1494,900,1075,4494
19,South Sudan (UNDP),2018,SSD-18/HSS10/SA2/H/UN/10071,6/20/2019 10:41:36 AM,Children under 5,0,0,125,126,251,0,0,0,0,0
19,South Sudan (UNDP),2018,SSD-18/HSS10/SA2/H/UN/10071,6/20/2019 10:41:36 AM,Internally Displaced People,14791,15011,8480,8572,46854,5739,13391,14347,14317,47794
19,South Sudan (UNDP),2018,SSD-18/HSS10/SA2/H/UN/10071,6/20/2019 10:41:36 AM,Overall,14821,15036,8605,8698,47160,5739,13391,14347,14347,47824
19,South Sudan (UNDP),2018,SSD-18/HSS10/SA2/H/UN/10071,6/20/2019 10:41:36 AM,"Trainers, Promoters, Caretakers, committee members, etc.",30,25,0,0,55,0,0,0,0,0
19,South Sudan (UNDP),2018,SSD-18/HSS10/SA2/H/UN/9860,10/14/2020 6:41:45 PM,Internally Displaced People,0,14006,0,3502,17508,0,15186,0,2441,17627
19,South Sudan (UNDP),2018,SSD-18/HSS10/SA2/H/UN/9860,10/14/2020 6:41:45 PM,Overall,0,17508,0,4377,21885,0,18500,0,3811,22311
19,South Sudan (UNDP),2018,SSD-18/HSS10/SA2/H/UN/9860,10/14/2020 6:41:45 PM,People in Host Communities,0,3502,0,875,4377,0,3314,0,1370,4684
19,South Sudan (UNDP),2018,SSD-18/HSS10/SA2/H/UN/9932,6/20/2019 8:41:57 AM,Children under 5,0,0,36024,39927,75951,0,0,75139,91960,167099
19,South Sudan (UNDP),2018,SSD-18/HSS10/SA2/H/UN/9932,6/20/2019 8:41:57 AM,Internally Displaced People,0,923,52311,63017,116251,0,3715,57680,41132,102527
19,South Sudan (UNDP),2018,SSD-18/HSS10/SA2/H/UN/9932,6/20/2019 8:41:57 AM,Overall,0,3154,143690,155072,301916,0,9785,145191,157287,312263
19,South Sudan (UNDP),2018,SSD-18/HSS10/SA2/H/UN/9932,6/20/2019 8:41:57 AM,People in Host Communities,0,503,55355,52128,107986,0,4978,11423,12144,28545
19,South Sudan (UNDP),2018,SSD-18/HSS10/SA2/H/UN/9932,6/20/2019 8:41:57 AM,Pregnant and Lactating Women,0,1728,0,0,1728,0,1092,0,0,1092
19,South Sudan (UNDP),2018,SSD-18/HSS10/SA2/H/UN/9933,6/20/2019 10:42:35 AM,Children under 5,0,0,4670,5750,10420,0,765,6726,8005,15496
19,South Sudan (UNDP),2018,SSD-18/HSS10/SA2/H/UN/9933,6/20/2019 10:42:35 AM,Internally Displaced People,1550,987,4228,4184,10949,1323,6520,3965,2788,14596
19,South Sudan (UNDP),2018,SSD-18/HSS10/SA2/H/UN/9933,6/20/2019 10:42:35 AM,Overall,2750,4500,13680,14820,35750,2174,12725,14797,15703,45399
19,South Sudan (UNDP),2018,SSD-18/HSS10/SA2/H/UN/9933,6/20/2019 10:42:35 AM,People in Host Communities,1200,898,4782,4886,11766,547,4651,3795,4512,13505
19,South Sudan (UNDP),2018,SSD-18/HSS10/SA2/H/UN/9933,6/20/2019 10:42:35 AM,Pregnant and Lactating Women,0,2615,0,0,2615,304,789,311,398,1802
19,South Sudan (UNDP),2018,SSD-18/HSS10/SA2/H/UN/9934,6/20/2019 8:42:47 AM,Internally Displaced People,183162,187859,46965,51661,469647,202475,208690,52375,55392,518932
19,South Sudan (UNDP),2018,SSD-18/HSS10/SA2/H/UN/9934,6/20/2019 8:42:47 AM,Overall,261660,268370,67093,73802,670925,228778,234644,58661,64527,586610
19,South Sudan (UNDP),2018,SSD-18/HSS10/SA2/H/UN/9934,6/20/2019 8:42:47 AM,People in Host Communities,78498,80511,20128,22141,201278,35976,36894,9228,10143,92241
19,South Sudan (UNDP),2018,SSD-18/HSS10/SA2/H/UN/9935,7/22/2019 1:59:40 PM,Internally Displaced People,60348,61896,15474,17021,154739,65448,68148,17037,18740,169373
19,South Sudan (UNDP),2018,SSD-18/HSS10/SA2/H/UN/9935,7/22/2019 1:59:40 PM,Overall,86212,88422,22106,24316,221056,18508,71291,17823,19605,127227
19,South Sudan (UNDP),2018,SSD-18/HSS10/SA2/H/UN/9935,7/22/2019 1:59:40 PM,People in Host Communities,25864,26526,6632,7295,66317,3061,3145,787,863,7856
19,South Sudan (UNDP),2018,SSD-18/HSS10/SA2/L/UN/10026,4/10/2019 5:48:12 AM,Aid Agencies,20,20,20,20,80,0,0,0,0,0
19,South Sudan (UNDP),2018,SSD-18/HSS10/SA2/L/UN/10026,4/10/2019 5:48:12 AM,Overall,20,20,20,20,80,0,0,39,40,79
19,South Sudan (UNDP),2018,SSD-18/HSS10/SA2/N/INGO/10040,6/3/2019 7:23:39 AM,Children under 5,0,0,8900,9648,18548,0,0,10068,13834,23902
19,South Sudan (UNDP),2018,SSD-18/HSS10/SA2/N/INGO/10040,6/3/2019 7:23:39 AM,Internally Displaced People,1223,1490,0,0,2713,15,0,0,0,15
19,South Sudan (UNDP),2018,SSD-18/HSS10/SA2/N/INGO/10040,6/3/2019 7:23:39 AM,Overall,1593,6359,8900,9648,26500,36,9815,10068,10829,30748
19,South Sudan (UNDP),2018,SSD-18/HSS10/SA2/N/INGO/10040,6/3/2019 7:23:39 AM,People in Host Communities,370,956,0,0,1326,21,0,0,0,21
19,South Sudan (UNDP),2018,SSD-18/HSS10/SA2/N/INGO/10040,6/3/2019 7:23:39 AM,Pregnant and Lactating Women,0,3913,0,0,3913,0,9815,0,0,9815
19,South Sudan (UNDP),2018,SSD-18/HSS10/SA2/N/INGO/10070,8/6/2019 10:51:15 AM,Children under 5,0,0,577,805,1382,0,0,660,766,1426
19,South Sudan (UNDP),2018,SSD-18/HSS10/SA2/N/INGO/10070,8/6/2019 10:51:15 AM,Internally Displaced People,654,1534,301,452,2941,0,2016,0,0,2016
19,South Sudan (UNDP),2018,SSD-18/HSS10/SA2/N/INGO/10070,8/6/2019 10:51:15 AM,Overall,2450,4247,1290,1881,9868,1426,4708,2016,12,8162
19,South Sudan (UNDP),2018,SSD-18/HSS10/SA2/N/INGO/10070,8/6/2019 10:51:15 AM,People in Host Communities,1787,2677,412,624,5500,416,1880,1880,532,4708
19,South Sudan (UNDP),2018,SSD-18/HSS10/SA2/N/INGO/10070,8/6/2019 10:51:15 AM,"Trainers, Promoters, Caretakers, committee members, etc.",9,36,0,0,45,2,10,0,0,12
19,South Sudan (UNDP),2018,SSD-18/HSS10/SA2/N/INGO/9774,3/26/2019 7:58:16 AM,Children under 5,0,0,2410,2520,4930,0,0,834,1029,1863
19,South Sudan (UNDP),2018,SSD-18/HSS10/SA2/N/INGO/9774,3/26/2019 7:58:16 AM,Internally Displaced People,0,552,233,253,1038,455,1232,0,0,1687
19,South Sudan (UNDP),2018,SSD-18/HSS10/SA2/N/INGO/9774,3/26/2019 7:58:16 AM,Overall,0,3845,3497,3682,11024,1125,8050,834,1029,11038
19,South Sudan (UNDP),2018,SSD-18/HSS10/SA2/N/INGO/9774,3/26/2019 7:58:16 AM,People in Host Communities,0,1643,854,909,3406,670,2550,0,0,3220
19,South Sudan (UNDP),2018,SSD-18/HSS10/SA2/N/INGO/9774,3/26/2019 7:58:16 AM,Pregnant and Lactating Women,0,1650,0,0,1650,0,4268,0,0,4268
19,South Sudan (UNDP),2018,SSD-18/HSS10/SA2/N/INGO/9825,8/6/2019 11:23:56 AM,Children under 5,0,0,17257,18695,35952,0,0,17723,19138,36861
19,South Sudan (UNDP),2018,SSD-18/HSS10/SA2/N/INGO/9825,8/6/2019 11:23:56 AM,Overall,1627,17323,17257,18695,54902,308,30235,17723,19138,67404
19,South Sudan (UNDP),2018,SSD-18/HSS10/SA2/N/INGO/9825,8/6/2019 11:23:56 AM,People in Host Communities,1577,0,0,0,1577,308,0,0,0,308
19,South Sudan (UNDP),2018,SSD-18/HSS10/SA2/N/INGO/9825,8/6/2019 11:23:56 AM,Pregnant and Lactating Women,0,15773,0,0,15773,0,30235,0,0,30235
19,South Sudan (UNDP),2018,SSD-18/HSS10/SA2/N/INGO/9825,8/6/2019 11:23:56 AM,"Trainers, Promoters, Caretakers, committee members, etc.",50,1550,0,0,1600,0,0,0,0,0
19,South Sudan (UNDP),2018,SSD-18/HSS10/SA2/N/INGO/9827,7/3/2019 12:10:48 PM,Internally Displaced People,5,300,534,579,1418,0,0,0,0,0
19,South Sudan (UNDP),2018,SSD-18/HSS10/SA2/N/INGO/9827,7/3/2019 12:10:48 PM,Overall,16,1000,1781,1929,4726,76,2457,1583,1678,5794
19,South Sudan (UNDP),2018,SSD-18/HSS10/SA2/N/INGO/9827,7/3/2019 12:10:48 PM,People in Host Communities,11,700,1247,1350,3308,76,2457,1583,1678,5794
19,South Sudan (UNDP),2018,SSD-18/HSS10/SA2/N/INGO/9833,9/30/2019 11:46:31 AM,Internally Displaced People,0,915,1069,1104,3088,0,619,577,654,1850
19,South Sudan (UNDP),2018,SSD-18/HSS10/SA2/N/INGO/9833,9/30/2019 11:46:31 AM,Overall,0,15248,17817,18397,51462,0,10308,9619,10894,30821
19,South Sudan (UNDP),2018,SSD-18/HSS10/SA2/N/INGO/9833,9/30/2019 11:46:31 AM,People in Host Communities,0,14333,16748,17293,48374,0,9689,9042,10240,28971
19,South Sudan (UNDP),2018,SSD-18/HSS10/SA2/N/INGO/9847,7/1/2019 9:23:51 AM,Children under 5,0,0,1386,1442,2828,0,0,16011,15442,31453
19,South Sudan (UNDP),2018,SSD-18/HSS10/SA2/N/INGO/9847,7/1/2019 9:23:51 AM,Internally Displaced People,2,1476,730,759,2967,80,3838,5939,5841,15698
19,South Sudan (UNDP),2018,SSD-18/HSS10/SA2/N/INGO/9847,7/1/2019 9:23:51 AM,Overall,21,14762,7295,7592,29670,1652,58622,26629,26279,113182
19,South Sudan (UNDP),2018,SSD-18/HSS10/SA2/N/INGO/9847,7/1/2019 9:23:51 AM,Pregnant and Lactating Women,0,1624,0,0,1624,0,5002,0,0,5002
19,South Sudan (UNDP),2018,SSD-18/HSS10/SA2/N/INGO/9902,8/6/2019 11:27:16 AM,Children under 5,0,0,8371,6850,15221,0,0,17602,19068,36670
19,South Sudan (UNDP),2018,SSD-18/HSS10/SA2/N/INGO/9902,8/6/2019 11:27:16 AM,Overall,37,3632,8371,6850,18890,630,18643,17602,19068,55943
19,South Sudan (UNDP),2018,SSD-18/HSS10/SA2/N/INGO/9902,8/6/2019 11:27:16 AM,Pregnant and Lactating Women,0,3600,0,0,3600,0,18618,0,0,18618
19,South Sudan (UNDP),2018,SSD-18/HSS10/SA2/N/INGO/9902,8/6/2019 11:27:16 AM,"Trainers, Promoters, Caretakers, committee members, etc.",37,32,0,0,69,630,25,0,0,655
19,South Sudan (UNDP),2018,SSD-18/HSS10/SA2/N/INGO/9944,6/3/2019 7:18:10 AM,Children under 5,0,0,2426,2526,4952,0,1416,2426,2526,6368
19,South Sudan (UNDP),2018,SSD-18/HSS10/SA2/N/INGO/9944,6/3/2019 7:18:10 AM,Overall,0,708,2426,2526,5660,0,4217,5100,4570,13887
19,South Sudan (UNDP),2018,SSD-18/HSS10/SA2/N/INGO/9944,6/3/2019 7:18:10 AM,Pregnant and Lactating Women,0,708,0,0,708,0,4217,5100,4570,13887
19,South Sudan (UNDP),2018,SSD-18/HSS10/SA2/N/INGO/9955,8/6/2019 10:53:36 AM,Children under 5,0,0,3545,3845,7390,0,0,0,0,0
19,South Sudan (UNDP),2018,SSD-18/HSS10/SA2/N/INGO/9955,8/6/2019 10:53:36 AM,Overall,0,602,3545,3845,7992,39,2819,4233,4300,11391
19,South Sudan (UNDP),2018,SSD-18/HSS10/SA2/N/INGO/9955,8/6/2019 10:53:36 AM,Pregnant and Lactating Women,0,602,0,0,602,0,6513,0,0,6513
19,South Sudan (UNDP),2018,SSD-18/HSS10/SA2/N/INGO/9965,8/6/2019 10:47:55 AM,Children under 5,0,0,8278,8278,16556,0,0,8110,9695,17805
19,South Sudan (UNDP),2018,SSD-18/HSS10/SA2/N/INGO/9965,8/6/2019 10:47:55 AM,Internally Displaced People,1155,1333,0,0,2488,1130,1260,0,0,2390
19,South Sudan (UNDP),2018,SSD-18/HSS10/SA2/N/INGO/9965,8/6/2019 10:47:55 AM,Overall,3500,7200,8278,8278,27256,2988,6428,8110,9695,27221
19,South Sudan (UNDP),2018,SSD-18/HSS10/SA2/N/INGO/9965,8/6/2019 10:47:55 AM,People in Host Communities,2345,3111,0,0,5456,1868,2481,0,0,4349
19,South Sudan (UNDP),2018,SSD-18/HSS10/SA2/N/INGO/9965,8/6/2019 10:47:55 AM,Pregnant and Lactating Women,0,2756,0,0,2756,0,2677,0,0,2677
19,South Sudan (UNDP),2018,SSD-18/HSS10/SA2/N/NGO/10057,6/3/2019 7:00:37 AM,Children under 5,0,0,3622,3623,7245,0,0,5455,6076,11531
19,South Sudan (UNDP),2018,SSD-18/HSS10/SA2/N/NGO/10057,6/3/2019 7:00:37 AM,Overall,160,3600,3622,3623,11005,42,5518,5455,6076,17091
19,South Sudan (UNDP),2018,SSD-18/HSS10/SA2/N/NGO/10057,6/3/2019 7:00:37 AM,Pregnant and Lactating Women,160,1600,0,0,1760,0,5518,0,0,5518
19,South Sudan (UNDP),2018,SSD-18/HSS10/SA2/N/NGO/9773,8/8/2019 6:47:49 AM,Children under 5,0,0,1997,1997,3994,0,0,3365,3621,6986
19,South Sudan (UNDP),2018,SSD-18/HSS10/SA2/N/NGO/9773,8/8/2019 6:47:49 AM,Internally Displaced People,420,0,0,0,420,475,0,0,0,475
19,South Sudan (UNDP),2018,SSD-18/HSS10/SA2/N/NGO/9773,8/8/2019 6:47:49 AM,Overall,420,2721,1997,1997,7135,475,3144,3365,3621,10605
19,South Sudan (UNDP),2018,SSD-18/HSS10/SA2/N/NGO/9773,8/8/2019 6:47:49 AM,Pregnant and Lactating Women,0,2721,0,0,2721,0,3144,0,0,3144
19,South Sudan (UNDP),2018,SSD-18/HSS10/SA2/N/NGO/9870,8/8/2019 1:19:45 PM,Children under 5,0,0,2811,3047,5858,0,0,3115,3243,6358
19,South Sudan (UNDP),2018,SSD-18/HSS10/SA2/N/NGO/9870,8/8/2019 1:19:45 PM,Internally Displaced People,1251,2150,2180,1664,7245,1021,2270,2416,1929,7636
19,South Sudan (UNDP),2018,SSD-18/HSS10/SA2/N/NGO/9870,8/8/2019 1:19:45 PM,Overall,2501,7700,7096,8096,25393,2537,8061,7791,8849,27238
19,South Sudan (UNDP),2018,SSD-18/HSS10/SA2/N/NGO/9870,8/8/2019 1:19:45 PM,People in Host Communities,1250,2150,2105,3385,8890,1516,2270,2509,3429,9724
19,South Sudan (UNDP),2018,SSD-18/HSS10/SA2/N/NGO/9870,8/8/2019 1:19:45 PM,Pregnant and Lactating Women,0,3400,0,0,3400,0,3521,0,0,3521
19,South Sudan (UNDP),2018,SSD-18/HSS10/SA2/N/NGO/9891,7/4/2019 6:31:35 AM,Children under 5,0,0,2880,2423,5303,0,0,990,802,1792
19,South Sudan (UNDP),2018,SSD-18/HSS10/SA2/N/NGO/9891,7/4/2019 6:31:35 AM,Overall,0,4490,2880,2423,9793,0,4192,2005,1905,8102
19,South Sudan (UNDP),2018,SSD-18/HSS10/SA2/N/NGO/9891,7/4/2019 6:31:35 AM,Pregnant and Lactating Women,0,4490,0,0,4490,530,2392,0,0,2922
19,South Sudan (UNDP),2018,SSD-18/HSS10/SA2/N/NGO/9951,8/7/2019 8:21:48 AM,Children under 5,0,0,1428,2142,3570,0,0,1080,1364,2444
19,South Sudan (UNDP),2018,SSD-18/HSS10/SA2/N/NGO/9951,8/7/2019 8:21:48 AM,Other,500,0,0,0,500,600,0,0,0,600
19,South Sudan (UNDP),2018,SSD-18/HSS10/SA2/N/NGO/9951,8/7/2019 8:21:48 AM,Overall,530,1018,1428,2142,5118,630,3055,1080,1364,6129
19,South Sudan (UNDP),2018,SSD-18/HSS10/SA2/N/NGO/9951,8/7/2019 8:21:48 AM,Pregnant and Lactating Women,0,1000,0,0,1000,0,3055,0,0,3055
19,South Sudan (UNDP),2018,SSD-18/HSS10/SA2/N/NGO/9951,8/7/2019 8:21:48 AM,"Trainers, Promoters, Caretakers, committee members, etc.",30,18,0,0,48,30,18,0,0,48
19,South Sudan (UNDP),2018,SSD-18/HSS10/SA2/N/UN/10045,6/7/2019 6:05:22 AM,Children under 5,0,0,18598,18598,37196,0,0,17806,17810,35616
19,South Sudan (UNDP),2018,SSD-18/HSS10/SA2/N/UN/10045,6/7/2019 6:05:22 AM,Overall,370,3521,18598,18598,41087,370,3521,17802,17802,39495
19,South Sudan (UNDP),2018,SSD-18/HSS10/SA2/N/UN/10045,6/7/2019 6:05:22 AM,"Trainers, Promoters, Caretakers, committee members, etc.",370,3521,0,0,3891,360,3519,0,0,3879
19,South Sudan (UNDP),2018,SSD-18/HSS10/SA2/N/UN/9848,11/20/2019 1:04:26 PM,Children under 5,0,0,36750,38250,75000,0,0,34735,32826,67561
19,South Sudan (UNDP),2018,SSD-18/HSS10/SA2/N/UN/9848,11/20/2019 1:04:26 PM,Overall,0,34000,36750,38250,109000,0,36820,34735,32826,104381
19,South Sudan (UNDP),2018,SSD-18/HSS10/SA2/N/UN/9848,11/20/2019 1:04:26 PM,Pregnant and Lactating Women,0,34000,0,0,34000,0,36820,0,0,36820
19,South Sudan (UNDP),2018,SSD-18/HSS10/SA2/NFI/INGO/10038,7/4/2019 8:17:52 AM,Internally Displaced People,1680,1820,1680,1820,7000,8734,8893,7644,7183,32454
19,South Sudan (UNDP),2018,SSD-18/HSS10/SA2/NFI/INGO/10038,7/4/2019 8:17:52 AM,Overall,3360,3640,3360,3640,14000,15635,15725,13875,12912,58147
19,South Sudan (UNDP),2018,SSD-18/HSS10/SA2/NFI/INGO/10038,7/4/2019 8:17:52 AM,People in Host Communities,340,360,340,360,1400,5264,5195,4743,4385,19587
19,South Sudan (UNDP),2018,SSD-18/HSS10/SA2/NFI/INGO/10038,7/4/2019 8:17:52 AM,Refugee Returnees,1340,1460,1340,1460,5600,1637,1637,1487,1344,6105
19,South Sudan (UNDP),2018,SSD-18/HSS10/SA2/NFI/INGO/10041,5/27/2019 7:26:01 AM,Internally Displaced People,1201,3968,2267,3204,10640,3909,4104,3931,4256,16200
19,South Sudan (UNDP),2018,SSD-18/HSS10/SA2/NFI/INGO/10041,5/27/2019 7:26:01 AM,Other,486,634,648,972,2740,2553,2951,1924,2271,9699
19,South Sudan (UNDP),2018,SSD-18/HSS10/SA2/NFI/INGO/10041,5/27/2019 7:26:01 AM,Overall,1930,5169,3239,4662,15000,6060,6641,6527,7280,26508
19,South Sudan (UNDP),2018,SSD-18/HSS10/SA2/NFI/INGO/10041,5/27/2019 7:26:01 AM,People in Host Communities,243,567,324,486,1620,141,173,129,166,609
19,South Sudan (UNDP),2018,SSD-18/HSS10/SA2/NFI/INGO/10087,4/27/2019 2:16:03 PM,Internally Displaced People,1680,3360,1680,1680,8400,4587,3073,5544,4746,17950
19,South Sudan (UNDP),2018,SSD-18/HSS10/SA2/NFI/INGO/10087,4/27/2019 2:16:03 PM,Overall,2800,5600,2800,2800,14000,4587,3073,5544,4746,17950
19,South Sudan (UNDP),2018,SSD-18/HSS10/SA2/NFI/INGO/10087,4/27/2019 2:16:03 PM,People in Host Communities,560,1120,560,560,2800,0,0,0,0,0
19,South Sudan (UNDP),2018,SSD-18/HSS10/SA2/NFI/INGO/10087,4/27/2019 2:16:03 PM,Refugee Returnees,560,1120,560,560,2800,0,0,0,0,0
19,South Sudan (UNDP),2018,SSD-18/HSS10/SA2/NFI/INGO/9771,7/4/2019 11:32:33 AM,Internally Displaced People,2265,2783,2718,2734,10500,3260,4204,2990,2985,13439
19,South Sudan (UNDP),2018,SSD-18/HSS10/SA2/NFI/INGO/9771,7/4/2019 11:32:33 AM,Overall,3020,3711,3624,3645,14000,9056,11862,8177,7989,37084
19,South Sudan (UNDP),2018,SSD-18/HSS10/SA2/NFI/INGO/9771,7/4/2019 11:32:33 AM,People in Host Communities,755,928,906,911,3500,5796,7658,5187,5004,23645
19,South Sudan (UNDP),2018,SSD-18/HSS10/SA2/NFI/INGO/9784,6/3/2019 10:11:26 AM,Internally Displaced People,1197,1710,2736,2907,8550,3550,5555,4091,9037,22233
19,South Sudan (UNDP),2018,SSD-18/HSS10/SA2/NFI/INGO/9784,6/3/2019 10:11:26 AM,Overall,2668,3812,6100,6480,19060,4645,7124,5370,11542,28681
19,South Sudan (UNDP),2018,SSD-18/HSS10/SA2/NFI/INGO/9784,6/3/2019 10:11:26 AM,Refugee Returnees,1471,2102,3364,3573,10510,1095,1569,1279,2505,6448
19,South Sudan (UNDP),2018,SSD-18/HSS10/SA2/NFI/INGO/9874,5/30/2019 11:19:39 AM,Internally Displaced People,4530,4693,3398,3561,16182,1871,2002,1845,2313,8031
19,South Sudan (UNDP),2018,SSD-18/HSS10/SA2/NFI/INGO/9874,5/30/2019 11:19:39 AM,Overall,5663,5866,4247,4451,20227,8833,9183,6113,6907,31036
19,South Sudan (UNDP),2018,SSD-18/HSS10/SA2/NFI/INGO/9874,5/30/2019 11:19:39 AM,Refugee Returnees,1133,1173,849,890,4045,6962,7181,4268,4594,23005
19,South Sudan (UNDP),2018,SSD-18/HSS10/SA2/NFI/INGO/9938,6/3/2019 9:51:36 AM,Internally Displaced People,2540,2644,3810,3966,12960,5958,5691,5319,5469,22437
19,South Sudan (UNDP),2018,SSD-18/HSS10/SA2/NFI/INGO/9938,6/3/2019 9:51:36 AM,Overall,3136,3264,4704,4896,16000,5958,5691,5319,5469,22437
19,South Sudan (UNDP),2018,SSD-18/HSS10/SA2/NFI/INGO/9938,6/3/2019 9:51:36 AM,People in Host Communities,596,620,894,930,3040,0,0,0,0,0
19,South Sudan (UNDP),2018,SSD-18/HSS10/SA2/NFI/NGO/10056,5/24/2019 12:43:55 PM,Internally Displaced People,432,1296,1296,1296,4320,560,1680,1680,1680,5600
19,South Sudan (UNDP),2018,SSD-18/HSS10/SA2/NFI/NGO/10056,5/24/2019 12:43:55 PM,Overall,700,2100,2100,2100,7000,1092,3277,3276,3276,10921
19,South Sudan (UNDP),2018,SSD-18/HSS10/SA2/NFI/NGO/10056,5/24/2019 12:43:55 PM,People in Host Communities,108,324,324,324,1080,392,1177,1176,1176,3921
19,South Sudan (UNDP),2018,SSD-18/HSS10/SA2/NFI/NGO/10056,5/24/2019 12:43:55 PM,Refugee Returnees,160,480,480,480,1600,140,420,420,420,1400
19,South Sudan (UNDP),2018,SSD-18/HSS10/SA2/NFI/NGO/9783,7/4/2019 11:37:49 AM,Children under 5,0,0,0,0,0,0,0,254,315,569
19,South Sudan (UNDP),2018,SSD-18/HSS10/SA2/NFI/NGO/9783,7/4/2019 11:37:49 AM,Internally Displaced People,2340,3510,780,1170,7800,1810,1948,333,406,4497
19,South Sudan (UNDP),2018,SSD-18/HSS10/SA2/NFI/NGO/9783,7/4/2019 11:37:49 AM,Other,48,72,32,48,200,223,311,129,187,850
19,South Sudan (UNDP),2018,SSD-18/HSS10/SA2/NFI/NGO/9783,7/4/2019 11:37:49 AM,Overall,2388,3582,812,1218,8000,2399,3598,800,1199,7996
19,South Sudan (UNDP),2018,SSD-18/HSS10/SA2/NFI/NGO/9783,7/4/2019 11:37:49 AM,Pregnant and Lactating Women,0,0,0,0,0,0,2080,0,0,2080
19,South Sudan (UNDP),2018,SSD-18/HSS10/SA2/NFI/NGO/9859,5/24/2019 1:56:05 PM,Internally Displaced People,1463,2195,975,1463,6096,6127,941,376,1430,8874
19,South Sudan (UNDP),2018,SSD-18/HSS10/SA2/NFI/NGO/9859,5/24/2019 1:56:05 PM,Overall,2250,3377,1500,2251,9378,8167,1249,501,1905,11822
19,South Sudan (UNDP),2018,SSD-18/HSS10/SA2/NFI/NGO/9859,5/24/2019 1:56:05 PM,People in Host Communities,225,338,150,225,938,816,123,50,190,1179
19,South Sudan (UNDP),2018,SSD-18/HSS10/SA2/NFI/NGO/9859,5/24/2019 1:56:05 PM,Refugee Returnees,562,844,375,563,2344,1224,185,75,285,1769
19,South Sudan (UNDP),2018,SSD-18/HSS10/SA2/NFI/NGO/9924,4/27/2019 2:26:07 PM,Internally Displaced People,290,432,346,515,1583,1172,2155,1105,2246,6678
19,South Sudan (UNDP),2018,SSD-18/HSS10/SA2/NFI/NGO/9924,4/27/2019 2:26:07 PM,Overall,953,3321,1079,1647,7000,3247,7554,1453,3047,15301
19,South Sudan (UNDP),2018,SSD-18/HSS10/SA2/NFI/NGO/9924,4/27/2019 2:26:07 PM,People in Host Communities,113,296,58,429,896,425,649,351,452,1877
19,South Sudan (UNDP),2018,SSD-18/HSS10/SA2/NFI/NGO/9924,4/27/2019 2:26:07 PM,Refugee Returnees,550,2593,675,703,4521,1135,2892,748,1971,6746
19,South Sudan (UNDP),2018,SSD-18/HSS10/SA2/P/INGO/10009,7/29/2019 1:50:39 PM,Internally Displaced People,1000,5500,6000,6000,18500,2000,3734,3819,4170,13723
19,South Sudan (UNDP),2018,SSD-18/HSS10/SA2/P/INGO/10009,7/29/2019 1:50:39 PM,Overall,2000,7000,7000,7000,23000,2000,3734,3819,4170,13723
19,South Sudan (UNDP),2018,SSD-18/HSS10/SA2/P/INGO/10009,7/29/2019 1:50:39 PM,People in Host Communities,1000,1500,1000,1000,4500,0,0,0,0,0
19,South Sudan (UNDP),2018,SSD-18/HSS10/SA2/P/INGO/10034,7/25/2019 7:47:34 AM,Internally Displaced People,1800,5460,1800,2625,11685,3560,5397,1560,2615,13132
19,South Sudan (UNDP),2018,SSD-18/HSS10/SA2/P/INGO/10034,7/25/2019 7:47:34 AM,Overall,2250,6510,2250,3990,15000,5110,8466,2115,3688,19379
19,South Sudan (UNDP),2018,SSD-18/HSS10/SA2/P/INGO/10034,7/25/2019 7:47:34 AM,People in Host Communities,450,1050,450,1050,3000,1550,3069,555,1073,6247
19,South Sudan (UNDP),2018,SSD-18/HSS10/SA2/P/INGO/10072,7/20/2019 2:47:38 PM,Internally Displaced People,149,1351,733,2702,4935,330,650,100,180,1260
19,South Sudan (UNDP),2018,SSD-18/HSS10/SA2/P/INGO/10072,7/20/2019 2:47:38 PM,Overall,378,3397,1843,6768,12386,580,2680,2600,2880,8740
19,South Sudan (UNDP),2018,SSD-18/HSS10/SA2/P/INGO/10072,7/20/2019 2:47:38 PM,People in Host Communities,223,2026,1100,4052,7401,580,2680,2600,2880,8740
19,South Sudan (UNDP),2018,SSD-18/HSS10/SA2/P/INGO/10072,7/20/2019 2:47:38 PM,"Trainers, Promoters, Caretakers, committee members, etc.",6,20,10,14,50,0,0,0,0,0
19,South Sudan (UNDP),2018,SSD-18/HSS10/SA2/P/INGO/9792,7/9/2019 7:25:08 AM,Internally Displaced People,2105,4213,2105,2105,10528,3927,4276,3049,3640,14892
19,South Sudan (UNDP),2018,SSD-18/HSS10/SA2/P/INGO/9792,7/9/2019 7:25:08 AM,Overall,2632,5264,2632,2632,13160,4030,4341,3051,3644,15066
19,South Sudan (UNDP),2018,SSD-18/HSS10/SA2/P/INGO/9792,7/9/2019 7:25:08 AM,People in Host Communities,527,1051,527,527,2632,103,65,2,4,174
19,South Sudan (UNDP),2018,SSD-18/HSS10/SA2/P/INGO/9840,5/22/2019 11:43:07 AM,Internally Displaced People,36,764,36,500,1336,218,2073,187,707,3185
19,South Sudan (UNDP),2018,SSD-18/HSS10/SA2/P/INGO/9840,5/22/2019 11:43:07 AM,Overall,120,2548,120,1666,4454,1638,4584,1359,2779,10360
19,South Sudan (UNDP),2018,SSD-18/HSS10/SA2/P/INGO/9840,5/22/2019 11:43:07 AM,People in Host Communities,84,1784,84,1166,3118,1330,2511,1172,1972,6985
19,South Sudan (UNDP),2018,SSD-18/HSS10/SA2/P/INGO/9896,7/8/2019 1:30:20 PM,Aid Agencies,10,10,0,0,20,0,0,0,0,0
19,South Sudan (UNDP),2018,SSD-18/HSS10/SA2/P/INGO/9896,7/8/2019 1:30:20 PM,Internally Displaced People,1423,2018,790,790,5021,0,0,0,0,0
19,South Sudan (UNDP),2018,SSD-18/HSS10/SA2/P/INGO/9896,7/8/2019 1:30:20 PM,Overall,1680,2380,930,930,5920,252,188,104,81,625
19,South Sudan (UNDP),2018,SSD-18/HSS10/SA2/P/INGO/9896,7/8/2019 1:30:20 PM,People in Host Communities,247,352,140,140,879,0,0,0,0,0
19,South Sudan (UNDP),2018,SSD-18/HSS10/SA2/P/INGO/9897,7/8/2019 1:29:34 PM,Internally Displaced People,2359,2673,561,655,6248,2833,3394,1520,1691,9438
19,South Sudan (UNDP),2018,SSD-18/HSS10/SA2/P/INGO/9897,7/8/2019 1:29:34 PM,Overall,2775,3145,660,770,7350,3371,4089,1831,2037,11328
19,South Sudan (UNDP),2018,SSD-18/HSS10/SA2/P/INGO/9897,7/8/2019 1:29:34 PM,People in Host Communities,416,472,99,115,1102,537,695,311,346,1889
19,South Sudan (UNDP),2018,SSD-18/HSS10/SA2/P/INGO/9900,6/25/2019 6:41:50 PM,Internally Displaced People,700,3038,1261,2103,7102,872,6637,934,2540,10983
19,South Sudan (UNDP),2018,SSD-18/HSS10/SA2/P/INGO/9900,6/25/2019 6:41:50 PM,Overall,1241,4139,1861,3103,10344,1947,5371,2653,3526,13497
19,South Sudan (UNDP),2018,SSD-18/HSS10/SA2/P/INGO/9900,6/25/2019 6:41:50 PM,People in Host Communities,541,1101,600,1000,3242,222,735,208,1349,2514
19,South Sudan (UNDP),2018,SSD-18/HSS10/SA2/P/INGO/9939,7/22/2019 2:07:27 PM,Internally Displaced People,458,502,765,743,2468,0,0,0,0,0
19,South Sudan (UNDP),2018,SSD-18/HSS10/SA2/P/INGO/9939,7/22/2019 2:07:27 PM,Overall,1830,2008,3058,2972,9868,1180,963,4624,4596,11363
19,South Sudan (UNDP),2018,SSD-18/HSS10/SA2/P/INGO/9939,7/22/2019 2:07:27 PM,"Trainers, Promoters, Caretakers, committee members, etc.",118,92,18,12,240,1180,963,4624,4596,11363
19,South Sudan (UNDP),2018,SSD-18/HSS10/SA2/P/INGO/9946,8/12/2019 8:23:12 AM,Internally Displaced People,1920,2560,3480,4480,12440,2177,3828,5110,5147,16262
19,South Sudan (UNDP),2018,SSD-18/HSS10/SA2/P/INGO/9946,8/12/2019 8:23:12 AM,Overall,2400,3200,4800,5600,16000,3110,5468,7299,7353,23230
19,South Sudan (UNDP),2018,SSD-18/HSS10/SA2/P/INGO/9946,8/12/2019 8:23:12 AM,People in Host Communities,480,640,960,1120,3200,933,1640,2189,2206,6968
19,South Sudan (UNDP),2018,SSD-18/HSS10/SA2/P/INGO/9987,7/26/2019 9:51:14 AM,Children under 5,0,0,400,400,800,0,0,634,468,1102
19,South Sudan (UNDP),2018,SSD-18/HSS10/SA2/P/INGO/9987,7/26/2019 9:51:14 AM,Combatants and Ex-Combatants,50,0,50,0,100,0,0,4,1,5
19,South Sudan (UNDP),2018,SSD-18/HSS10/SA2/P/INGO/9987,7/26/2019 9:51:14 AM,Internally Displaced People,400,550,700,700,2350,440,605,770,740,2555
19,South Sudan (UNDP),2018,SSD-18/HSS10/SA2/P/INGO/9987,7/26/2019 9:51:14 AM,Other,100,200,350,400,1050,83,220,385,440,1128
19,South Sudan (UNDP),2018,SSD-18/HSS10/SA2/P/INGO/9987,7/26/2019 9:51:14 AM,Overall,550,750,1500,1500,4300,538,718,2116,1563,4935
19,South Sudan (UNDP),2018,SSD-18/HSS10/SA2/P/INGO/9997,7/24/2019 6:36:51 AM,Internally Displaced People,875,1225,875,1225,4200,3732,4250,3669,3335,14986
19,South Sudan (UNDP),2018,SSD-18/HSS10/SA2/P/INGO/9997,7/24/2019 6:36:51 AM,Overall,1250,1750,1250,1750,6000,5473,6168,5031,4747,21419
19,South Sudan (UNDP),2018,SSD-18/HSS10/SA2/P/INGO/9997,7/24/2019 6:36:51 AM,People in Host Communities,375,525,375,525,1800,1741,1918,1332,1382,6373
19,South Sudan (UNDP),2018,SSD-18/HSS10/SA2/P/NGO/10005,7/25/2019 8:11:52 AM,Internally Displaced People,263,790,268,732,2053,230,550,270,100,1150
19,South Sudan (UNDP),2018,SSD-18/HSS10/SA2/P/NGO/10005,7/25/2019 8:11:52 AM,Overall,507,1264,504,1225,3500,495,1248,551,231,2525
19,South Sudan (UNDP),2018,SSD-18/HSS10/SA2/P/NGO/10005,7/25/2019 8:11:52 AM,People in Host Communities,238,464,236,454,1392,97,201,86,67,451
19,South Sudan (UNDP),2018,SSD-18/HSS10/SA2/P/NGO/10005,7/25/2019 8:11:52 AM,"Trainers, Promoters, Caretakers, committee members, etc.",6,6,0,0,12,6,6,0,0,12
19,South Sudan (UNDP),2018,SSD-18/HSS10/SA2/P/NGO/10020,7/20/2019 5:57:24 AM,Internally Displaced People,0,1060,270,1490,2820,0,1622,302,1382,3306
19,South Sudan (UNDP),2018,SSD-18/HSS10/SA2/P/NGO/10020,7/20/2019 5:57:24 AM,Overall,0,1300,400,2300,4000,0,2116,432,2541,5089
19,South Sudan (UNDP),2018,SSD-18/HSS10/SA2/P/NGO/10020,7/20/2019 5:57:24 AM,People in Host Communities,0,200,100,700,1000,0,444,105,1134,1683
19,South Sudan (UNDP),2018,SSD-18/HSS10/SA2/P/NGO/10020,7/20/2019 5:57:24 AM,"Trainers, Promoters, Caretakers, committee members, etc.",0,40,30,10,80,0,50,25,25,100
19,South Sudan (UNDP),2018,SSD-18/HSS10/SA2/P/NGO/10043,7/23/2019 8:45:48 AM,Internally Displaced People,400,400,1200,1200,3200,421,489,1471,1423,3804
19,South Sudan (UNDP),2018,SSD-18/HSS10/SA2/P/NGO/10043,7/23/2019 8:45:48 AM,Other,50,50,0,0,100,0,0,0,0,0
19,South Sudan (UNDP),2018,SSD-18/HSS10/SA2/P/NGO/10043,7/23/2019 8:45:48 AM,Overall,800,800,2200,2200,6000,803,912,2657,2355,6727
19,South Sudan (UNDP),2018,SSD-18/HSS10/SA2/P/NGO/10043,7/23/2019 8:45:48 AM,People in Host Communities,300,300,975,975,2550,317,342,1023,1091,2773
19,South Sudan (UNDP),2018,SSD-18/HSS10/SA2/P/NGO/10043,7/23/2019 8:45:48 AM,"Trainers, Promoters, Caretakers, committee members, etc.",50,50,25,25,150,50,50,25,25,150
19,South Sudan (UNDP),2018,SSD-18/HSS10/SA2/P/NGO/10073,4/10/2019 5:39:25 AM,Internally Displaced People,2000,2000,3000,3000,10000,187,447,223,278,1135
19,South Sudan (UNDP),2018,SSD-18/HSS10/SA2/P/NGO/10073,4/10/2019 5:39:25 AM,Overall,5060,5540,6560,6040,23200,4623,6219,6664,6626,24132
19,South Sudan (UNDP),2018,SSD-18/HSS10/SA2/P/NGO/10073,4/10/2019 5:39:25 AM,People in Host Communities,3000,3500,3500,3000,13000,4311,5651,6326,6241,22529
19,South Sudan (UNDP),2018,SSD-18/HSS10/SA2/P/NGO/10073,4/10/2019 5:39:25 AM,Refugee Returnees,0,0,0,0,0,40,106,50,72,268
19,South Sudan (UNDP),2018,SSD-18/HSS10/SA2/P/NGO/10073,4/10/2019 5:39:25 AM,"Trainers, Promoters, Caretakers, committee members, etc.",60,40,60,40,200,85,15,65,35,200
19,South Sudan (UNDP),2018,SSD-18/HSS10/SA2/P/NGO/9769,7/8/2019 10:35:02 AM,Internally Displaced People,2115,3414,1482,1264,8275,2160,3471,1521,1322,8474
19,South Sudan (UNDP),2018,SSD-18/HSS10/SA2/P/NGO/9769,7/8/2019 10:35:02 AM,Overall,3008,4780,2116,2520,12424,3008,4780,2116,2520,12424
19,South Sudan (UNDP),2018,SSD-18/HSS10/SA2/P/NGO/9769,7/8/2019 10:35:02 AM,People in Host Communities,893,1366,634,1056,3949,894,1366,634,1056,3950
19,South Sudan (UNDP),2018,SSD-18/HSS10/SA2/P/NGO/9770,7/27/2019 6:39:21 AM,Internally Displaced People,0,1100,0,200,1300,0,1100,0,200,1300
19,South Sudan (UNDP),2018,SSD-18/HSS10/SA2/P/NGO/9770,7/27/2019 6:39:21 AM,Overall,0,3200,0,1200,4400,0,3200,0,1200,4400
19,South Sudan (UNDP),2018,SSD-18/HSS10/SA2/P/NGO/9770,7/27/2019 6:39:21 AM,People in Host Communities,0,2100,0,1000,3100,0,2100,0,1000,3100
19,South Sudan (UNDP),2018,SSD-18/HSS10/SA2/P/NGO/9772,7/7/2019 6:30:38 PM,Internally Displaced People,550,1300,440,700,2990,800,1600,600,1100,4100
19,South Sudan (UNDP),2018,SSD-18/HSS10/SA2/P/NGO/9772,7/7/2019 6:30:38 PM,Overall,800,2300,700,1200,5000,1401,3536,1009,2200,8146
19,South Sudan (UNDP),2018,SSD-18/HSS10/SA2/P/NGO/9772,7/7/2019 6:30:38 PM,People in Host Communities,150,900,160,400,1610,400,1600,300,900,3200
19,South Sudan (UNDP),2018,SSD-18/HSS10/SA2/P/NGO/9772,7/7/2019 6:30:38 PM,"Trainers, Promoters, Caretakers, committee members, etc.",100,100,100,100,400,201,336,109,200,846
19,South Sudan (UNDP),2018,SSD-18/HSS10/SA2/P/NGO/9777,7/24/2019 9:11:58 AM,Internally Displaced People,78,108,1260,1260,2706,35,28,1158,980,2201
19,South Sudan (UNDP),2018,SSD-18/HSS10/SA2/P/NGO/9777,7/24/2019 9:11:58 AM,Overall,130,180,2100,2100,4510,55,46,1793,1408,3302
19,South Sudan (UNDP),2018,SSD-18/HSS10/SA2/P/NGO/9777,7/24/2019 9:11:58 AM,People in Host Communities,52,72,840,840,1804,20,18,635,428,1101
19,South Sudan (UNDP),2018,SSD-18/HSS10/SA2/P/NGO/9804,7/7/2019 6:22:09 PM,Aid Agencies,7,8,0,0,15,7,7,0,0,14
19,South Sudan (UNDP),2018,SSD-18/HSS10/SA2/P/NGO/9804,7/7/2019 6:22:09 PM,Internally Displaced People,200,1000,200,600,2000,505,1159,258,599,2521
19,South Sudan (UNDP),2018,SSD-18/HSS10/SA2/P/NGO/9804,7/7/2019 6:22:09 PM,Overall,459,1651,400,1176,3686,843,1933,432,999,4207
19,South Sudan (UNDP),2018,SSD-18/HSS10/SA2/P/NGO/9804,7/7/2019 6:22:09 PM,People in Host Communities,242,633,200,576,1651,338,774,174,400,1686
19,South Sudan (UNDP),2018,SSD-18/HSS10/SA2/P/NGO/9804,7/7/2019 6:22:09 PM,"Trainers, Promoters, Caretakers, committee members, etc.",10,10,0,0,20,13,12,0,0,25
19,South Sudan (UNDP),2018,SSD-18/HSS10/SA2/P/NGO/9834,7/26/2019 10:02:22 AM,Internally Displaced People,275,330,200,250,1055,923,1913,589,1091,4516
19,South Sudan (UNDP),2018,SSD-18/HSS10/SA2/P/NGO/9834,7/26/2019 10:02:22 AM,Overall,1200,2200,800,1900,6100,1357,2891,1130,1967,7345
19,South Sudan (UNDP),2018,SSD-18/HSS10/SA2/P/NGO/9834,7/26/2019 10:02:22 AM,People in Host Communities,700,1400,500,1290,3890,1773,4034,1027,2710,9544
19,South Sudan (UNDP),2018,SSD-18/HSS10/SA2/P/NGO/9834,7/26/2019 10:02:22 AM,Pregnant and Lactating Women,0,150,0,150,300,0,302,0,0,302
19,South Sudan (UNDP),2018,SSD-18/HSS10/SA2/P/NGO/9834,7/26/2019 10:02:22 AM,"Trainers, Promoters, Caretakers, committee members, etc.",225,320,100,210,855,59,112,0,0,171
19,South Sudan (UNDP),2018,SSD-18/HSS10/SA2/P/NGO/9842,7/25/2019 2:02:22 PM,Internally Displaced People,20,1900,10,100,2030,20,1900,10,100,2030
19,South Sudan (UNDP),2018,SSD-18/HSS10/SA2/P/NGO/9842,7/25/2019 2:02:22 PM,Overall,50,2750,10,200,3010,50,2750,10,200,3010
19,South Sudan (UNDP),2018,SSD-18/HSS10/SA2/P/NGO/9842,7/25/2019 2:02:22 PM,People in Host Communities,15,500,0,50,565,15,500,0,50,565
19,South Sudan (UNDP),2018,SSD-18/HSS10/SA2/P/NGO/9842,7/25/2019 2:02:22 PM,Refugee Returnees,15,350,0,50,415,15,350,0,50,415
19,South Sudan (UNDP),2018,SSD-18/HSS10/SA2/P/NGO/9849,7/22/2019 2:53:50 PM,Internally Displaced People,650,1200,1800,1800,5450,650,1189,1956,1647,5442
19,South Sudan (UNDP),2018,SSD-18/HSS10/SA2/P/NGO/9849,7/22/2019 2:53:50 PM,Overall,1800,2500,3800,3800,11900,1807,2479,4163,3507,11956
19,South Sudan (UNDP),2018,SSD-18/HSS10/SA2/P/NGO/9849,7/22/2019 2:53:50 PM,People in Host Communities,850,1000,1700,1700,5250,855,991,1874,1577,5297
19,South Sudan (UNDP),2018,SSD-18/HSS10/SA2/P/NGO/9849,7/22/2019 2:53:50 PM,"Trainers, Promoters, Caretakers, committee members, etc.",300,300,300,300,1200,302,299,333,283,1217
19,South Sudan (UNDP),2018,SSD-18/HSS10/SA2/P/NGO/9861,4/9/2019 1:58:38 PM,Internally Displaced People,759,1300,2109,2047,6215,1073,1288,910,1122,4393
19,South Sudan (UNDP),2018,SSD-18/HSS10/SA2/P/NGO/9861,4/9/2019 1:58:38 PM,Other,0,0,0,0,0,631,682,624,622,2559
19,South Sudan (UNDP),2018,SSD-18/HSS10/SA2/P/NGO/9861,4/9/2019 1:58:38 PM,Overall,1074,2293,3368,3343,10078,2518,3325,3128,3507,12478
19,South Sudan (UNDP),2018,SSD-18/HSS10/SA2/P/NGO/9861,4/9/2019 1:58:38 PM,People in Host Communities,275,953,1259,1296,3783,775,1334,1582,1755,5446
19,South Sudan (UNDP),2018,SSD-18/HSS10/SA2/P/NGO/9861,4/9/2019 1:58:38 PM,"Trainers, Promoters, Caretakers, committee members, etc.",40,40,0,0,80,39,21,12,8,80
19,South Sudan (UNDP),2018,SSD-18/HSS10/SA2/P/NGO/9919,7/26/2019 9:54:17 AM,Overall,700,1480,420,900,3500,1335,3662,780,2362,8139
19,South Sudan (UNDP),2018,SSD-18/HSS10/SA2/P/NGO/9919,7/26/2019 9:54:17 AM,People in Host Communities,400,980,220,600,2200,678,2427,515,1382,5002
19,South Sudan (UNDP),2018,SSD-18/HSS10/SA2/P/NGO/9919,7/26/2019 9:54:17 AM,Refugee Returnees,300,500,200,300,1300,657,1235,265,980,3137
19,South Sudan (UNDP),2018,SSD-18/HSS10/SA2/P/NGO/9979,7/20/2019 6:13:06 AM,Internally Displaced People,200,1500,250,500,2450,200,1800,100,1000,3100
19,South Sudan (UNDP),2018,SSD-18/HSS10/SA2/P/NGO/9979,7/20/2019 6:13:06 AM,Overall,500,2200,500,1000,4200,400,2600,200,1600,4800
19,South Sudan (UNDP),2018,SSD-18/HSS10/SA2/P/NGO/9979,7/20/2019 6:13:06 AM,People in Host Communities,250,650,250,500,1650,150,750,100,600,1600
19,South Sudan (UNDP),2018,SSD-18/HSS10/SA2/P/NGO/9979,7/20/2019 6:13:06 AM,"Trainers, Promoters, Caretakers, committee members, etc.",50,50,0,0,100,50,50,0,0,100
19,South Sudan (UNDP),2018,SSD-18/HSS10/SA2/P/NGO/9982,7/20/2019 4:08:08 PM,Internally Displaced People,0,0,2466,2684,5150,0,0,2787,2287,5074
19,South Sudan (UNDP),2018,SSD-18/HSS10/SA2/P/NGO/9982,7/20/2019 4:08:08 PM,Overall,430,420,2466,2684,6000,433,347,2787,2287,5854
19,South Sudan (UNDP),2018,SSD-18/HSS10/SA2/P/NGO/9982,7/20/2019 4:08:08 PM,"Trainers, Promoters, Caretakers, committee members, etc.",430,420,0,0,850,433,347,0,0,780
19,South Sudan (UNDP),2018,SSD-18/HSS10/SA2/P/NGO/9983,8/5/2019 6:36:52 PM,Internally Displaced People,1200,2500,500,800,5000,0,0,0,0,0
19,South Sudan (UNDP),2018,SSD-18/HSS10/SA2/P/NGO/9983,8/5/2019 6:36:52 PM,Overall,2100,3900,900,1400,8300,3686,4217,1387,1438,10728
19,South Sudan (UNDP),2018,SSD-18/HSS10/SA2/P/NGO/9983,8/5/2019 6:36:52 PM,People in Host Communities,500,800,200,300,1800,0,0,0,0,0
19,South Sudan (UNDP),2018,SSD-18/HSS10/SA2/P/NGO/9983,8/5/2019 6:36:52 PM,Refugee Returnees,400,600,200,300,1500,0,0,0,0,0
19,South Sudan (UNDP),2018,SSD-18/HSS10/SA2/P/UN/9812,11/16/2020 7:32:39 AM,Internally Displaced People,3948,4452,6909,7791,23100,7660,13584,9814,7691,38749
19,South Sudan (UNDP),2018,SSD-18/HSS10/SA2/P/UN/9812,11/16/2020 7:32:39 AM,Overall,5640,6360,9870,11130,33000,10944,19406,14021,10985,55356
19,South Sudan (UNDP),2018,SSD-18/HSS10/SA2/P/UN/9812,11/16/2020 7:32:39 AM,People in Host Communities,1692,1908,2961,3339,9900,3284,5822,4207,3294,16607
19,South Sudan (UNDP),2018,SSD-18/HSS10/SA2/WASH/INGO/9841,6/3/2019 7:31:08 AM,Internally Displaced People,595,665,1120,1120,3500,618,692,1164,1166,3640
19,South Sudan (UNDP),2018,SSD-18/HSS10/SA2/WASH/INGO/9841,6/3/2019 7:31:08 AM,Overall,3400,3800,6400,6400,20000,3775,4514,6096,6416,20801
19,South Sudan (UNDP),2018,SSD-18/HSS10/SA2/WASH/INGO/9841,6/3/2019 7:31:08 AM,People in Host Communities,1615,1805,3040,3040,9500,1679,1877,3162,3162,9880
19,South Sudan (UNDP),2018,SSD-18/HSS10/SA2/WASH/INGO/9841,6/3/2019 7:31:08 AM,Refugee Returnees,1190,1330,2240,2240,7000,1238,1383,2329,2330,7280
19,South Sudan (UNDP),2018,SSD-18/HSS10/SA2/WASH/INGO/9989,6/3/2019 7:36:54 AM,Internally Displaced People,1733,2082,1777,2208,7800,2700,3076,2398,2710,10884
19,South Sudan (UNDP),2018,SSD-18/HSS10/SA2/WASH/INGO/9989,6/3/2019 7:36:54 AM,Overall,8667,10407,8885,11041,39000,10802,12314,9590,10840,43546
19,South Sudan (UNDP),2018,SSD-18/HSS10/SA2/WASH/INGO/9989,6/3/2019 7:36:54 AM,People in Host Communities,6934,8325,7108,8833,31200,8102,9238,7192,8130,32662
19,South Sudan (UNDP),2018,SSD-18/HSS10/SA2/WASH/NGO/10014,5/15/2019 6:30:37 AM,Internally Displaced People,1095,730,57,38,1920,1912,2520,671,681,5784
19,South Sudan (UNDP),2018,SSD-18/HSS10/SA2/WASH/NGO/10014,5/15/2019 6:30:37 AM,Other,273,182,15,10,480,463,1079,399,559,2500
19,South Sudan (UNDP),2018,SSD-18/HSS10/SA2/WASH/NGO/10014,5/15/2019 6:30:37 AM,Overall,9120,6080,480,320,16000,10231,9812,2011,2351,24405
19,South Sudan (UNDP),2018,SSD-18/HSS10/SA2/WASH/NGO/10014,5/15/2019 6:30:37 AM,People in Host Communities,7752,5168,408,272,13600,7856,6213,941,1111,16121
19,South Sudan (UNDP),2018,SSD-18/HSS10/SA2/WASH/NGO/10039,4/11/2019 7:41:25 AM,Internally Displaced People,1200,1200,2500,2500,7400,2020,3350,5060,7100,17530
19,South Sudan (UNDP),2018,SSD-18/HSS10/SA2/WASH/NGO/10039,4/11/2019 7:41:25 AM,Other,300,300,500,500,1600,350,254,422,656,1682
19,South Sudan (UNDP),2018,SSD-18/HSS10/SA2/WASH/NGO/10039,4/11/2019 7:41:25 AM,Overall,2000,2000,4000,4000,12000,3420,5004,7232,10956,26612
19,South Sudan (UNDP),2018,SSD-18/HSS10/SA2/WASH/NGO/10039,4/11/2019 7:41:25 AM,People in Host Communities,500,500,1000,1000,3000,1050,1400,1750,3200,7400
19,South Sudan (UNDP),2018,SSD-18/HSS10/SA2/WASH/NGO/10081,4/10/2019 6:21:22 AM,Children under 5,0,0,300,300,600,0,0,21,39,60
19,South Sudan (UNDP),2018,SSD-18/HSS10/SA2/WASH/NGO/10081,4/10/2019 6:21:22 AM,Overall,2100,3500,3100,2600,11300,2250,3680,3220,2850,12000
19,South Sudan (UNDP),2018,SSD-18/HSS10/SA2/WASH/NGO/10081,4/10/2019 6:21:22 AM,People in Host Communities,2100,3500,2800,2300,10700,2221,3679,2840,3200,11940
19,South Sudan (UNDP),2018,SSD-18/HSS10/SA2/WASH/NGO/10099,4/11/2019 7:37:59 AM,Internally Displaced People,2500,2500,5000,5000,15000,1230,2210,4600,6500,14540
19,South Sudan (UNDP),2018,SSD-18/HSS10/SA2/WASH/NGO/10099,4/11/2019 7:37:59 AM,Other,500,500,1000,1000,3000,1090,890,1700,830,4510
19,South Sudan (UNDP),2018,SSD-18/HSS10/SA2/WASH/NGO/10099,4/11/2019 7:37:59 AM,Overall,4000,4000,8000,8000,24000,3650,4650,9660,10230,28190
19,South Sudan (UNDP),2018,SSD-18/HSS10/SA2/WASH/NGO/10099,4/11/2019 7:37:59 AM,People in Host Communities,1000,1000,2000,2000,6000,1330,1550,3360,2900,9140
19,South Sudan (UNDP),2018,SSD-18/HSS10/SA2/WASH/NGO/9786,4/11/2019 1:43:38 PM,Children under 5,0,0,1028,1425,2453,0,0,319,344,663
19,South Sudan (UNDP),2018,SSD-18/HSS10/SA2/WASH/NGO/9786,4/11/2019 1:43:38 PM,Internally Displaced People,3192,4629,2893,3198,13912,2664,2695,3555,3371,12285
19,South Sudan (UNDP),2018,SSD-18/HSS10/SA2/WASH/NGO/9786,4/11/2019 1:43:38 PM,Overall,5120,8150,6237,7493,27000,7141,8249,9436,9549,34375
19,South Sudan (UNDP),2018,SSD-18/HSS10/SA2/WASH/NGO/9786,4/11/2019 1:43:38 PM,People in Host Communities,1893,3496,2216,2770,10375,4863,5059,5361,5770,21053
19,South Sudan (UNDP),2018,SSD-18/HSS10/SA2/WASH/NGO/9786,4/11/2019 1:43:38 PM,"Trainers, Promoters, Caretakers, committee members, etc.",35,25,100,100,260,31,31,152,160,374
19,South Sudan (UNDP),2018,SSD-18/HSS10/SA2/WASH/NGO/9791,4/10/2019 5:59:20 AM,Internally Displaced People,1303,1751,1519,2146,6719,1500,2133,1866,2885,8384
19,South Sudan (UNDP),2018,SSD-18/HSS10/SA2/WASH/NGO/9791,4/10/2019 5:59:20 AM,Overall,4342,7157,5065,7153,23717,5000,7110,6221,9318,27649
19,South Sudan (UNDP),2018,SSD-18/HSS10/SA2/WASH/NGO/9791,4/10/2019 5:59:20 AM,People in Host Communities,3039,5406,3546,5007,16998,3500,4977,4355,6733,19565
19,South Sudan (UNDP),2018,SSD-18/HSS10/SA2/WASH/NGO/9797,7/5/2019 12:20:05 PM,Internally Displaced People,4886,6388,3382,4134,18790,4825,7278,5468,6814,24385
19,South Sudan (UNDP),2018,SSD-18/HSS10/SA2/WASH/NGO/9797,7/5/2019 12:20:05 PM,Other,980,1285,734,896,3895,1612,2435,1815,2272,8134
19,South Sudan (UNDP),2018,SSD-18/HSS10/SA2/WASH/NGO/9797,7/5/2019 12:20:05 PM,Overall,8144,10648,5638,6890,31320,8961,13412,10005,12485,44863
19,South Sudan (UNDP),2018,SSD-18/HSS10/SA2/WASH/NGO/9797,7/5/2019 12:20:05 PM,People in Host Communities,2198,2875,1522,1860,8455,2478,3645,2722,3400,12245
19,South Sudan (UNDP),2018,SSD-18/HSS10/SA2/WASH/NGO/9797,7/5/2019 12:20:05 PM,"Trainers, Promoters, Caretakers, committee members, etc.",80,100,0,0,180,46,54,0,0,100
19,South Sudan (UNDP),2018,SSD-18/HSS10/SA2/WASH/NGO/9801,4/1/2019 7:01:48 AM,Internally Displaced People,1085,1750,2135,2200,7170,868,1955,1960,2636,7419
19,South Sudan (UNDP),2018,SSD-18/HSS10/SA2/WASH/NGO/9801,4/1/2019 7:01:48 AM,Overall,2250,4150,4350,5250,16000,2049,4864,4315,5976,17204
19,South Sudan (UNDP),2018,SSD-18/HSS10/SA2/WASH/NGO/9801,4/1/2019 7:01:48 AM,People in Host Communities,1165,2400,2215,3050,8830,1181,2909,2355,3340,9785
19,South Sudan (UNDP),2018,SSD-18/HSS10/SA2/WASH/NGO/9845,4/1/2019 7:09:20 AM,Internally Displaced People,2125,4250,5100,5525,17000,1436,4462,7426,7744,21068
19,South Sudan (UNDP),2018,SSD-18/HSS10/SA2/WASH/NGO/9845,4/1/2019 7:09:20 AM,Overall,3163,5876,6779,7682,23500,5295,8276,11324,10951,35846
19,South Sudan (UNDP),2018,SSD-18/HSS10/SA2/WASH/NGO/9845,4/1/2019 7:09:20 AM,People in Host Communities,1038,1626,1679,2157,6500,1323,3264,4526,5665,14778
19,South Sudan (UNDP),2018,SSD-18/HSS10/SA2/WASH/NGO/9885,4/10/2019 6:03:03 AM,Children under 5,0,0,870,1000,1870,0,0,3108,3573,6681
19,South Sudan (UNDP),2018,SSD-18/HSS10/SA2/WASH/NGO/9885,4/10/2019 6:03:03 AM,Internally Displaced People,3241,3584,2909,3266,13000,11580,12805,10394,11669,46448
19,South Sudan (UNDP),2018,SSD-18/HSS10/SA2/WASH/NGO/9885,4/10/2019 6:03:03 AM,Overall,4630,5120,4870,5380,20000,11434,17150,19149,23725,71458
19,South Sudan (UNDP),2018,SSD-18/HSS10/SA2/WASH/NGO/9885,4/10/2019 6:03:03 AM,People in Host Communities,1389,1536,1091,1114,5130,4963,5488,3898,3980,18329
19,South Sudan (UNDP),2018,SSD-18/HSS10/SA2/WASH/NGO/9907,3/28/2019 6:11:52 AM,Internally Displaced People,594,887,2297,2357,6135,572,901,2195,2215,5883
19,South Sudan (UNDP),2018,SSD-18/HSS10/SA2/WASH/NGO/9907,3/28/2019 6:11:52 AM,Overall,1740,2610,6438,6612,17400,1676,2619,6415,6690,17400
19,South Sudan (UNDP),2018,SSD-18/HSS10/SA2/WASH/NGO/9907,3/28/2019 6:11:52 AM,People in Host Communities,1008,1513,3826,3927,10274,970,1505,3903,4148,10526
19,South Sudan (UNDP),2018,SSD-18/HSS10/SA2/WASH/NGO/9907,3/28/2019 6:11:52 AM,Refugee Returnees,65,99,255,262,681,65,98,257,261,681
19,South Sudan (UNDP),2018,SSD-18/HSS10/SA2/WASH/NGO/9907,3/28/2019 6:11:52 AM,"Trainers, Promoters, Caretakers, committee members, etc.",73,111,60,66,310,69,115,60,66,310
19,South Sudan (UNDP),2018,SSD-18/HSS10/SA2/WASH/NGO/9945,5/15/2019 6:24:53 AM,Internally Displaced People,700,4000,1800,1600,8100,1418,2726,939,1513,6596
19,South Sudan (UNDP),2018,SSD-18/HSS10/SA2/WASH/NGO/9945,5/15/2019 6:24:53 AM,Other,300,1000,200,400,1900,0,0,0,0,0
19,South Sudan (UNDP),2018,SSD-18/HSS10/SA2/WASH/NGO/9945,5/15/2019 6:24:53 AM,Overall,1500,7000,3000,3500,15000,3544,6816,2347,3781,16488
19,South Sudan (UNDP),2018,SSD-18/HSS10/SA2/WASH/NGO/9945,5/15/2019 6:24:53 AM,People in Host Communities,500,2000,1000,1500,5000,2126,4090,1408,2270,9894
19,South Sudan (UNDP),2019,SSD-19/HSS10/RA1/WASH/NGO/12596,11/18/2019 1:52:56 PM,Internally Displaced People,434,749,1600,2217,5000,434,749,1600,2217,5000
19,South Sudan (UNDP),2019,SSD-19/HSS10/RA1/WASH/NGO/12596,11/18/2019 1:52:56 PM,Overall,434,749,1600,2217,5000,434,749,1600,2217,5000
19,South Sudan (UNDP),2019,SSD-19/HSS10/RA2/E/INGO/14817,11/16/2020 7:30:14 AM,Other,0,0,1680,1120,2800,0,0,1627,970,2597
19,South Sudan (UNDP),2019,SSD-19/HSS10/RA2/E/INGO/14817,11/16/2020 7:30:14 AM,Overall,0,0,1680,1120,2800,0,0,1627,970,2597
19,South Sudan (UNDP),2019,SSD-19/HSS10/RA2/E-H-N-P/UN/14733,11/20/2020 12:44:35 PM,Host Communities,12713,24757,81215,44190,162875,7473,24941,85205,47408,165027
19,South Sudan (UNDP),2019,SSD-19/HSS10/RA2/E-H-N-P/UN/14733,11/20/2020 12:44:35 PM,Internally Displaced People,3825,5415,5033,5453,19726,797,2455,2608,2995,8855
19,South Sudan (UNDP),2019,SSD-19/HSS10/RA2/E-H-N-P/UN/14733,11/20/2020 12:44:35 PM,Overall,16538,30172,86248,49643,182601,8270,27396,87813,50403,173882
19,South Sudan (UNDP),2019,SSD-19/HSS10/RA2/FSL/UN/14820,11/13/2020 2:55:05 PM,Host Communities,32002,53339,10664,10669,106674,32002,53339,10664,10669,106674
19,South Sudan (UNDP),2019,SSD-19/HSS10/RA2/FSL/UN/14820,11/13/2020 2:55:05 PM,Internally Displaced People,41486,69143,13828,13830,138287,41486,69143,13828,13830,138287
19,South Sudan (UNDP),2019,SSD-19/HSS10/RA2/FSL/UN/14820,11/13/2020 2:55:05 PM,Overall,118529,197552,39505,39514,395100,118529,197552,39505,39514,395100
19,South Sudan (UNDP),2019,SSD-19/HSS10/RA2/FSL/UN/14820,11/13/2020 2:55:05 PM,Refugees,45041,75070,15013,15015,150139,45041,75070,15013,15015,150139
19,South Sudan (UNDP),2019,SSD-19/HSS10/RA2/H/INGO/14800,10/12/2020 11:38:31 AM,Host Communities,4930,5340,6670,8960,25900,8349,9044,2890,3130,23413
19,South Sudan (UNDP),2019,SSD-19/HSS10/RA2/H/INGO/14800,10/12/2020 11:38:31 AM,Other,740,801,1001,1344,3886,39,37,7,8,91
19,South Sudan (UNDP),2019,SSD-19/HSS10/RA2/H/INGO/14800,10/12/2020 11:38:31 AM,Overall,5670,6141,7671,10304,29786,8388,9081,2897,3138,23504
19,South Sudan (UNDP),2019,SSD-19/HSS10/RA2/H/NGO/14684,8/11/2020 8:12:38 AM,Internally Displaced People,5200,6355,9657,11803,33015,5975,7732,11868,15320,40895
19,South Sudan (UNDP),2019,SSD-19/HSS10/RA2/H/NGO/14684,8/11/2020 8:12:38 AM,Overall,5200,6355,9657,11803,33015,5975,7732,11868,15320,40895
19,South Sudan (UNDP),2019,SSD-19/HSS10/RA2/H/NGO/14688,8/13/2020 7:46:15 AM,Host Communities,3410,3520,1980,2090,11000,3571,5680,3386,4912,17549
19,South Sudan (UNDP),2019,SSD-19/HSS10/RA2/H/NGO/14688,8/13/2020 7:46:15 AM,Internally Displaced People,3410,3520,1980,2090,11000,3041,5049,3189,4794,16073
19,South Sudan (UNDP),2019,SSD-19/HSS10/RA2/H/NGO/14688,8/13/2020 7:46:15 AM,Overall,6820,7040,3960,4180,22000,6612,10729,6575,9706,33622
19,South Sudan (UNDP),2019,SSD-19/HSS10/RA2/H/NGO/14690,8/18/2020 11:27:32 AM,Host Communities,10095,10143,8511,8903,37652,5408,7320,1745,1931,16404
19,South Sudan (UNDP),2019,SSD-19/HSS10/RA2/H/NGO/14690,8/18/2020 11:27:32 AM,Internally Displaced People,1043,1500,560,584,3687,833,1415,546,586,3380
19,South Sudan (UNDP),2019,SSD-19/HSS10/RA2/H/NGO/14690,8/18/2020 11:27:32 AM,Overall,11138,11643,9071,9487,41339,6241,8735,2291,2517,19784
19,South Sudan (UNDP),2019,SSD-19/HSS10/RA2/H/UN/14675,8/11/2020 7:47:38 AM,Host Communities,18183,18440,13684,13941,64248,43282,40437,12273,10855,106847
19,South Sudan (UNDP),2019,SSD-19/HSS10/RA2/H/UN/14675,8/11/2020 7:47:38 AM,Internally Displaced People,22395,22577,16856,17172,79000,5862,5458,1688,1474,14482
19,South Sudan (UNDP),2019,SSD-19/HSS10/RA2/H/UN/14675,8/11/2020 7:47:38 AM,Overall,40578,41017,30540,31113,143248,49144,45895,13961,12329,121329
19,South Sudan (UNDP),2019,SSD-19/HSS10/RA2/H-NFI/NGO/14692,10/15/2020 6:55:55 PM,Host Communities,11023,14175,7106,8296,40600,11796,20651,7284,9448,49179
19,South Sudan (UNDP),2019,SSD-19/HSS10/RA2/H-NFI/NGO/14692,10/15/2020 6:55:55 PM,Internally Displaced People,15747,20247,10153,11853,58000,11950,19700,5995,8105,45750
19,South Sudan (UNDP),2019,SSD-19/HSS10/RA2/H-NFI/NGO/14692,10/15/2020 6:55:55 PM,Overall,31487,40499,20317,23697,116000,28632,48863,16248,21416,115159
19,South Sudan (UNDP),2019,SSD-19/HSS10/RA2/H-NFI/NGO/14692,10/15/2020 6:55:55 PM,Returnees,4717,6077,3058,3548,17400,4886,8512,2969,3863,20230
19,South Sudan (UNDP),2019,SSD-19/HSS10/RA2/N/INGO/14716,9/9/2020 7:25:41 AM,Host Communities,500,1658,353,377,2888,782,8220,797,859,10658
19,South Sudan (UNDP),2019,SSD-19/HSS10/RA2/N/INGO/14716,9/9/2020 7:25:41 AM,Internally Displaced People,0,292,74,66,432,0,93,81,90,264
19,South Sudan (UNDP),2019,SSD-19/HSS10/RA2/N/INGO/14716,9/9/2020 7:25:41 AM,Overall,500,1950,427,443,3320,782,8313,878,949,10922
19,South Sudan (UNDP),2019,SSD-19/HSS10/RA2/N/INGO/14723,9/9/2020 8:18:56 AM,Host Communities,0,240,592,592,1424,0,1463,679,711,2853
19,South Sudan (UNDP),2019,SSD-19/HSS10/RA2/N/INGO/14723,9/9/2020 8:18:56 AM,Overall,0,240,592,592,1424,0,1463,679,711,2853
19,South Sudan (UNDP),2019,SSD-19/HSS10/RA2/N/INGO/14755,9/14/2020 7:12:05 AM,Internally Displaced People,0,13750,1647,1520,16917,0,3748,357,379,4484
19,South Sudan (UNDP),2019,SSD-19/HSS10/RA2/N/INGO/14755,9/14/2020 7:12:05 AM,Overall,0,13750,1647,1520,16917,0,3748,357,379,4484
19,South Sudan (UNDP),2019,SSD-19/HSS10/RA2/N/INGO/14819,9/7/2020 7:52:12 AM,Host Communities,615,2458,290,290,3653,6744,23950,7998,7098,45790
19,South Sudan (UNDP),2019,SSD-19/HSS10/RA2/N/INGO/14819,9/7/2020 7:52:12 AM,Internally Displaced People,409,1638,193,193,2433,461,3157,2921,3101,9640
19,South Sudan (UNDP),2019,SSD-19/HSS10/RA2/N/INGO/14819,9/7/2020 7:52:12 AM,Overall,1024,4096,483,483,6086,7205,27107,10919,10199,55430
19,South Sudan (UNDP),2019,SSD-19/HSS10/RA2/N/NGO/14725,9/8/2020 8:25:41 AM,Host Communities,0,3136,45,49,3230,50,5985,350,423,6808
19,South Sudan (UNDP),2019,SSD-19/HSS10/RA2/N/NGO/14725,9/8/2020 8:25:41 AM,Internally Displaced People,0,2811,95,102,3008,45,5309,781,941,7076
19,South Sudan (UNDP),2019,SSD-19/HSS10/RA2/N/NGO/14725,9/8/2020 8:25:41 AM,Overall,0,5947,140,151,6238,95,11294,1131,1364,13884
19,South Sudan (UNDP),2019,SSD-19/HSS10/RA2/NFI/INGO/14802,11/30/2020 5:50:36 AM,Internally Displaced People,21200,19400,21850,21550,84000,10493,12579,15847,17884,56803
19,South Sudan (UNDP),2019,SSD-19/HSS10/RA2/NFI/INGO/14802,11/30/2020 5:50:36 AM,Overall,21200,19400,21850,21550,84000,10493,12579,15847,17884,56803
19,South Sudan (UNDP),2019,SSD-19/HSS10/RA2/NFI/NGO/14717,8/6/2020 5:34:08 AM,Host Communities,11200,28000,7840,8960,56000,11321,28304,7925,9056,56606
19,South Sudan (UNDP),2019,SSD-19/HSS10/RA2/NFI/NGO/14717,8/6/2020 5:34:08 AM,Overall,11200,28000,7840,8960,56000,11321,28304,7925,9056,56606
19,South Sudan (UNDP),2019,SSD-19/HSS10/RA2/NFI/NGO/14750,8/3/2020 7:14:53 AM,Host Communities,10000,10000,700,700,21400,10000,10000,700,700,21400
19,South Sudan (UNDP),2019,SSD-19/HSS10/RA2/NFI/NGO/14750,8/3/2020 7:14:53 AM,Internally Displaced People,10000,23000,800,800,34600,12670,23000,1800,1800,39270
19,South Sudan (UNDP),2019,SSD-19/HSS10/RA2/NFI/NGO/14750,8/3/2020 7:14:53 AM,Overall,20000,33000,1500,1500,56000,22670,33000,2500,2500,60670
19,South Sudan (UNDP),2019,SSD-19/HSS10/RA2/NFI/NGO/14791,8/11/2020 8:33:52 AM,Host Communities,3031,9094,9093,9093,30311,2386,7157,7156,7156,23855
19,South Sudan (UNDP),2019,SSD-19/HSS10/RA2/NFI/NGO/14791,8/11/2020 8:33:52 AM,Internally Displaced People,3057,9172,9171,9171,30571,3908,11722,11713,11719,39062
19,South Sudan (UNDP),2019,SSD-19/HSS10/RA2/NFI/NGO/14791,8/11/2020 8:33:52 AM,Overall,6521,19565,19563,19563,65212,6636,19902,19891,19897,66326
19,South Sudan (UNDP),2019,SSD-19/HSS10/RA2/NFI/NGO/14791,8/11/2020 8:33:52 AM,Returnees,433,1299,1299,1299,4330,342,1023,1022,1022,3409
19,South Sudan (UNDP),2019,SSD-19/HSS10/RA2/P/INGO/14710,7/3/2020 3:23:50 PM,Host Communities,254,467,152,155,1028,105,163,36,64,368
19,South Sudan (UNDP),2019,SSD-19/HSS10/RA2/P/INGO/14710,7/3/2020 3:23:50 PM,Internally Displaced People,592,1076,355,336,2359,245,379,83,150,857
19,South Sudan (UNDP),2019,SSD-19/HSS10/RA2/P/INGO/14710,7/3/2020 3:23:50 PM,Overall,846,1543,507,491,3387,350,542,119,214,1225
19,South Sudan (UNDP),2019,SSD-19/HSS10/RA2/P/INGO/14793,10/15/2020 6:11:03 PM,Host Communities,1476,1159,1536,1206,5377,1234,1610,2967,2710,8521
19,South Sudan (UNDP),2019,SSD-19/HSS10/RA2/P/INGO/14793,10/15/2020 6:11:03 PM,Internally Displaced People,356,280,371,291,1298,245,531,1332,1084,3192
19,South Sudan (UNDP),2019,SSD-19/HSS10/RA2/P/INGO/14793,10/15/2020 6:11:03 PM,Other,25,20,26,21,92,7,5,17,15,44
19,South Sudan (UNDP),2019,SSD-19/HSS10/RA2/P/INGO/14793,10/15/2020 6:11:03 PM,Overall,2544,1998,2648,2080,9270,1521,2188,4360,3861,11930
19,South Sudan (UNDP),2019,SSD-19/HSS10/RA2/P/INGO/14793,10/15/2020 6:11:03 PM,Returnees,687,539,715,562,2503,35,42,44,52,173
19,South Sudan (UNDP),2019,SSD-19/HSS10/RA2/P/INGO/14796,10/15/2020 5:29:36 PM,Host Communities,1565,2817,939,939,6260,280,514,0,0,794
19,South Sudan (UNDP),2019,SSD-19/HSS10/RA2/P/INGO/14796,10/15/2020 5:29:36 PM,Internally Displaced People,1807,3254,1084,1085,7230,290,475,0,0,765
19,South Sudan (UNDP),2019,SSD-19/HSS10/RA2/P/INGO/14796,10/15/2020 5:29:36 PM,Overall,3824,6886,2294,2296,15300,848,1452,0,0,2300
19,South Sudan (UNDP),2019,SSD-19/HSS10/RA2/P/INGO/14796,10/15/2020 5:29:36 PM,Returnees,452,815,271,272,1810,278,463,0,0,741
19,South Sudan (UNDP),2019,SSD-19/HSS10/RA2/P/NGO/14718,10/15/2020 7:05:27 PM,Host Communities,100,1050,275,600,2025,139,1576,386,359,2460
19,South Sudan (UNDP),2019,SSD-19/HSS10/RA2/P/NGO/14718,10/15/2020 7:05:27 PM,Internally Displaced People,100,600,250,400,1350,188,1741,318,561,2808
19,South Sudan (UNDP),2019,SSD-19/HSS10/RA2/P/NGO/14718,10/15/2020 7:05:27 PM,Overall,300,2150,700,1350,4500,448,3929,965,1317,6659
19,South Sudan (UNDP),2019,SSD-19/HSS10/RA2/P/NGO/14718,10/15/2020 7:05:27 PM,Returnees,100,500,175,350,1125,121,612,261,397,1391
19,South Sudan (UNDP),2019,SSD-19/HSS10/RA2/P/NGO/14732,10/15/2020 6:30:37 PM,Host Communities,1700,2100,1200,1600,6600,1651,2417,1638,1363,7069
19,South Sudan (UNDP),2019,SSD-19/HSS10/RA2/P/NGO/14732,10/15/2020 6:30:37 PM,Internally Displaced People,1700,2100,1200,1600,6600,1651,2418,1639,1363,7071
19,South Sudan (UNDP),2019,SSD-19/HSS10/RA2/P/NGO/14732,10/15/2020 6:30:37 PM,Overall,4250,5250,3000,4000,16500,4128,6044,4096,3408,17676
19,South Sudan (UNDP),2019,SSD-19/HSS10/RA2/P/NGO/14732,10/15/2020 6:30:37 PM,Returnees,850,1050,600,800,3300,826,1209,819,682,3536
19,South Sudan (UNDP),2019,SSD-19/HSS10/RA2/P/UN/14756,11/5/2021 10:15:41 AM,Internally Displaced People,3049,5697,2011,4243,15000,8170,15241,5311,11998,40720
19,South Sudan (UNDP),2019,SSD-19/HSS10/RA2/P/UN/14756,11/5/2021 10:15:41 AM,Overall,3049,5697,2011,4243,15000,8170,15241,5311,11998,40720
19,South Sudan (UNDP),2019,SSD-19/HSS10/RA2/P/UN/14770,10/14/2020 7:29:07 PM,Host Communities,0,1000,0,500,1500,0,1227,0,769,1996
19,South Sudan (UNDP),2019,SSD-19/HSS10/RA2/P/UN/14770,10/14/2020 7:29:07 PM,Internally Displaced People,0,3000,0,2000,5000,0,3559,0,1635,5194
19,South Sudan (UNDP),2019,SSD-19/HSS10/RA2/P/UN/14770,10/14/2020 7:29:07 PM,Overall,0,4000,0,2500,6500,0,4786,0,2404,7190
19,South Sudan (UNDP),2019,SSD-19/HSS10/RA2/P-E/INGO/14714,6/30/2020 6:44:04 PM,Host Communities,80,171,1726,1665,3642,63,203,4837,5920,11023
19,South Sudan (UNDP),2019,SSD-19/HSS10/RA2/P-E/INGO/14714,6/30/2020 6:44:04 PM,Internally Displaced People,489,3678,1111,1478,6756,304,3834,2281,3182,9601
19,South Sudan (UNDP),2019,SSD-19/HSS10/RA2/P-E/INGO/14714,6/30/2020 6:44:04 PM,Overall,588,3913,2850,3175,10526,376,4160,7133,9133,20802
19,South Sudan (UNDP),2019,SSD-19/HSS10/RA2/P-E/INGO/14714,6/30/2020 6:44:04 PM,Returnees,19,64,13,32,128,9,123,15,31,178
19,South Sudan (UNDP),2019,SSD-19/HSS10/RA2/WASH/INGO/14744,11/7/2020 6:19:11 AM,Host Communities,1245,2655,1440,2160,7500,1245,2655,2050,2300,8250
19,South Sudan (UNDP),2019,SSD-19/HSS10/RA2/WASH/INGO/14744,11/7/2020 6:19:11 AM,Internally Displaced People,871,1859,1008,1512,5250,871,1859,1401,1570,5701
19,South Sudan (UNDP),2019,SSD-19/HSS10/RA2/WASH/INGO/14744,11/7/2020 6:19:11 AM,Overall,2490,5310,2880,4320,15000,2490,5310,4116,4612,16528
19,South Sudan (UNDP),2019,SSD-19/HSS10/RA2/WASH/INGO/14744,11/7/2020 6:19:11 AM,Returnees,374,796,432,648,2250,374,796,665,742,2577
19,South Sudan (UNDP),2019,SSD-19/HSS10/RA2/WASH/INGO/14811,9/9/2020 4:40:49 AM,Host Communities,2539,2807,668,668,6682,5169,5498,6086,5780,22533
19,South Sudan (UNDP),2019,SSD-19/HSS10/RA2/WASH/INGO/14811,9/9/2020 4:40:49 AM,Internally Displaced People,2539,2807,668,668,6682,646,687,761,723,2817
19,South Sudan (UNDP),2019,SSD-19/HSS10/RA2/WASH/INGO/14811,9/9/2020 4:40:49 AM,Overall,8464,9356,2227,2228,22275,6461,6872,7608,7226,28167
19,South Sudan (UNDP),2019,SSD-19/HSS10/RA2/WASH/INGO/14811,9/9/2020 4:40:49 AM,Returnees,3386,3742,891,892,8911,646,687,761,723,2817
19,South Sudan (UNDP),2019,SSD-19/HSS10/RA2/WASH/NGO/14697,9/21/2020 7:42:57 AM,Host Communities,1139,1436,1040,1337,4952,1122,1415,1025,1317,4879
19,South Sudan (UNDP),2019,SSD-19/HSS10/RA2/WASH/NGO/14697,9/21/2020 7:42:57 AM,Internally Displaced People,2000,2523,1827,2350,8700,1972,2487,1801,2315,8575
19,South Sudan (UNDP),2019,SSD-19/HSS10/RA2/WASH/NGO/14697,9/21/2020 7:42:57 AM,Overall,3450,4350,3150,4050,15000,3400,4288,3105,3991,14784
19,South Sudan (UNDP),2019,SSD-19/HSS10/RA2/WASH/NGO/14697,9/21/2020 7:42:57 AM,Returnees,311,391,283,363,1348,306,386,279,359,1330
19,South Sudan (UNDP),2019,SSD-19/HSS10/RA2/WASH-NFI/INGO/14763,10/14/2020 6:47:57 PM,Host Communities,4476,6396,10246,10882,32000,4851,5522,7088,7549,25010
19,South Sudan (UNDP),2019,SSD-19/HSS10/RA2/WASH-NFI/INGO/14763,10/14/2020 6:47:57 PM,Internally Displaced People,8113,11593,18571,19725,58002,5390,6183,8187,9956,29716
19,South Sudan (UNDP),2019,SSD-19/HSS10/RA2/WASH-NFI/INGO/14763,10/14/2020 6:47:57 PM,Overall,13988,19988,32017,34007,100000,10912,12541,16196,18577,58226
19,South Sudan (UNDP),2019,SSD-19/HSS10/RA2/WASH-NFI/INGO/14763,10/14/2020 6:47:57 PM,Returnees,1399,1999,3200,3400,9998,671,836,921,1072,3500
19,South Sudan (UNDP),2019,SSD-19/HSS10/SA1/CCCM/INGO/11706,11/14/2019 6:00:48 AM,Host Communities,0,0,0,0,0,3380,3841,4149,3994,15364
19,South Sudan (UNDP),2019,SSD-19/HSS10/SA1/CCCM/INGO/11706,11/14/2019 6:00:48 AM,Internally Displaced People,9000,11650,4675,4675,30000,0,0,0,0,0
19,South Sudan (UNDP),2019,SSD-19/HSS10/SA1/CCCM/INGO/11706,11/14/2019 6:00:48 AM,Overall,9000,11650,4675,4675,30000,3380,3841,4149,3994,15364
19,South Sudan (UNDP),2019,SSD-19/HSS10/SA1/CCCM/INGO/11778,11/14/2019 11:00:17 AM,Internally Displaced People,6900,8300,3400,3400,22000,14222,18968,7111,7111,47412
19,South Sudan (UNDP),2019,SSD-19/HSS10/SA1/CCCM/INGO/11778,11/14/2019 11:00:17 AM,Overall,6900,8300,3400,3400,22000,14222,18968,7111,7111,47412
19,South Sudan (UNDP),2019,SSD-19/HSS10/SA1/CCCM/NGO/11512,12/19/2019 12:59:29 PM,Internally Displaced People,3395,9496,9480,8855,31226,7606,8421,9677,9557,35261
19,South Sudan (UNDP),2019,SSD-19/HSS10/SA1/CCCM/NGO/11512,12/19/2019 12:59:29 PM,Overall,3395,9496,9480,8855,31226,7606,8421,9677,9557,35261
19,South Sudan (UNDP),2019,SSD-19/HSS10/SA1/CCCM/UN/11492,6/8/2020 7:40:59 AM,Internally Displaced People,9675,11350,9943,11032,42000,11147,13080,11457,12711,48395
19,South Sudan (UNDP),2019,SSD-19/HSS10/SA1/CCCM/UN/11492,6/8/2020 7:40:59 AM,Overall,9675,11350,9943,11032,42000,11147,13080,11457,12711,48395
19,South Sudan (UNDP),2019,SSD-19/HSS10/SA1/CCS/INGO/11741,2/6/2020 12:59:18 PM,Other,60,60,0,0,120,143,37,0,0,180
19,South Sudan (UNDP),2019,SSD-19/HSS10/SA1/CCS/INGO/11741,2/6/2020 12:59:18 PM,Overall,60,60,0,0,120,143,37,0,0,180
19,South Sudan (UNDP),2019,SSD-19/HSS10/SA1/CCS/INGO/11792,8/3/2020 6:13:24 PM,Other,0,330,0,0,330,0,300,0,0,300
19,South Sudan (UNDP),2019,SSD-19/HSS10/SA1/CCS/INGO/11792,8/3/2020 6:13:24 PM,Overall,0,330,0,0,330,0,300,0,0,300
19,South Sudan (UNDP),2019,SSD-19/HSS10/SA1/CCS/NGO/11541,4/27/2020 8:13:52 AM,Aid Agencies,120,35,0,0,155,76,35,0,0,111
19,South Sudan (UNDP),2019,SSD-19/HSS10/SA1/CCS/NGO/11541,4/27/2020 8:13:52 AM,Host Communities,5502,5915,0,0,11417,7116,6984,6,14,14120
19,South Sudan (UNDP),2019,SSD-19/HSS10/SA1/CCS/NGO/11541,4/27/2020 8:13:52 AM,Internally Displaced People,3500,3900,0,0,7400,3638,3319,12,15,6984
19,South Sudan (UNDP),2019,SSD-19/HSS10/SA1/CCS/NGO/11541,4/27/2020 8:13:52 AM,Overall,14700,15300,0,0,30000,13536,12900,21,37,26494
19,South Sudan (UNDP),2019,SSD-19/HSS10/SA1/CCS/NGO/11541,4/27/2020 8:13:52 AM,Returnees,5578,5450,0,0,11028,2706,2562,3,8,5279
19,South Sudan (UNDP),2019,SSD-19/HSS10/SA1/E/INGO/11589,12/9/2019 1:57:01 PM,Host Communities,202,200,957,526,1885,234,279,2988,1497,4998
19,South Sudan (UNDP),2019,SSD-19/HSS10/SA1/E/INGO/11589,12/9/2019 1:57:01 PM,Internally Displaced People,160,125,715,239,1239,159,135,741,595,1630
19,South Sudan (UNDP),2019,SSD-19/HSS10/SA1/E/INGO/11589,12/9/2019 1:57:01 PM,Other,60,80,0,0,140,38,28,0,0,66
19,South Sudan (UNDP),2019,SSD-19/HSS10/SA1/E/INGO/11589,12/9/2019 1:57:01 PM,Overall,422,405,1672,765,3264,431,442,3729,2092,6694
19,South Sudan (UNDP),2019,SSD-19/HSS10/SA1/E/INGO/11593,2/8/2020 1:08:31 PM,Host Communities,48,28,793,427,1296,276,214,9319,6679,16488
19,South Sudan (UNDP),2019,SSD-19/HSS10/SA1/E/INGO/11593,2/8/2020 1:08:31 PM,Internally Displaced People,207,111,3172,1708,5198,610,214,2818,1742,5384
19,South Sudan (UNDP),2019,SSD-19/HSS10/SA1/E/INGO/11593,2/8/2020 1:08:31 PM,Overall,255,139,3965,2135,6494,886,428,12137,8421,21872
19,South Sudan (UNDP),2019,SSD-19/HSS10/SA1/E/INGO/11598,2/5/2020 10:44:30 AM,Host Communities,77,32,836,656,1601,134,189,4936,2914,8173
19,South Sudan (UNDP),2019,SSD-19/HSS10/SA1/E/INGO/11598,2/5/2020 10:44:30 AM,Internally Displaced People,193,113,1579,1460,3345,49,18,73,136,276
19,South Sudan (UNDP),2019,SSD-19/HSS10/SA1/E/INGO/11598,2/5/2020 10:44:30 AM,Overall,337,224,2635,2316,5512,298,281,5124,3143,8846
19,South Sudan (UNDP),2019,SSD-19/HSS10/SA1/E/INGO/11598,2/5/2020 10:44:30 AM,Returnees,10,10,220,200,440,45,19,115,93,272
19,South Sudan (UNDP),2019,SSD-19/HSS10/SA1/E/INGO/11598,2/5/2020 10:44:30 AM,"Trainers, Promoters, Caretakers, committee members, etc.",57,69,0,0,126,70,55,0,0,125
19,South Sudan (UNDP),2019,SSD-19/HSS10/SA1/E/INGO/11685,2/5/2020 10:48:40 AM,Host Communities,51,20,1852,1748,3671,55,40,2303,1998,4396
19,South Sudan (UNDP),2019,SSD-19/HSS10/SA1/E/INGO/11685,2/5/2020 10:48:40 AM,Internally Displaced People,17,12,728,672,1429,52,19,1802,1631,3504
19,South Sudan (UNDP),2019,SSD-19/HSS10/SA1/E/INGO/11685,2/5/2020 10:48:40 AM,Overall,68,32,2580,2420,5100,107,59,4105,3629,7900
19,South Sudan (UNDP),2019,SSD-19/HSS10/SA1/E/NGO/11457,2/6/2020 9:59:24 AM,Host Communities,0,0,2171,1276,3447,118,142,3439,1373,5072
19,South Sudan (UNDP),2019,SSD-19/HSS10/SA1/E/NGO/11457,2/6/2020 9:59:24 AM,Internally Displaced People,0,0,1448,850,2298,49,48,2921,1732,4750
19,South Sudan (UNDP),2019,SSD-19/HSS10/SA1/E/NGO/11457,2/6/2020 9:59:24 AM,Other,167,190,0,0,357,0,0,0,0,0
19,South Sudan (UNDP),2019,SSD-19/HSS10/SA1/E/NGO/11457,2/6/2020 9:59:24 AM,Overall,167,190,3619,2126,6102,167,190,6360,3105,9822
19,South Sudan (UNDP),2019,SSD-19/HSS10/SA1/E/NGO/11592,2/6/2020 11:53:18 AM,Host Communities,136,64,2160,1280,3640,136,64,3107,1939,5246
19,South Sudan (UNDP),2019,SSD-19/HSS10/SA1/E/NGO/11592,2/6/2020 11:53:18 AM,Internally Displaced People,111,52,1727,1022,2912,108,52,3871,2416,6447
19,South Sudan (UNDP),2019,SSD-19/HSS10/SA1/E/NGO/11592,2/6/2020 11:53:18 AM,Overall,272,128,4320,2560,7280,272,128,7761,4846,13007
19,South Sudan (UNDP),2019,SSD-19/HSS10/SA1/E/NGO/11592,2/6/2020 11:53:18 AM,Returnees,25,12,433,258,728,28,12,783,491,1314
19,South Sudan (UNDP),2019,SSD-19/HSS10/SA1/FSL/INGO/11497,10/18/2019 11:57:20 AM,Host Communities,6430,6965,7250,7855,28500,7460,7755,10231,10055,35501
19,South Sudan (UNDP),2019,SSD-19/HSS10/SA1/FSL/INGO/11497,10/18/2019 11:57:20 AM,Internally Displaced People,1629,1766,1838,1991,7224,1316,1369,1805,1774,6264
19,South Sudan (UNDP),2019,SSD-19/HSS10/SA1/FSL/INGO/11497,10/18/2019 11:57:20 AM,Overall,8059,8731,9088,9846,35724,8776,9124,12036,11829,41765
19,South Sudan (UNDP),2019,SSD-19/HSS10/SA1/FSL/INGO/11566,12/11/2019 8:40:31 AM,Host Communities,21144,20808,0,0,41952,14527,14783,9166,10996,49472
19,South Sudan (UNDP),2019,SSD-19/HSS10/SA1/FSL/INGO/11566,12/11/2019 8:40:31 AM,Internally Displaced People,1113,1095,0,0,2208,927,943,585,702,3157
19,South Sudan (UNDP),2019,SSD-19/HSS10/SA1/FSL/INGO/11566,12/11/2019 8:40:31 AM,Overall,22257,21903,0,0,44160,15454,15726,9751,11698,52629
19,South Sudan (UNDP),2019,SSD-19/HSS10/SA1/FSL/INGO/11635,10/18/2019 12:14:40 PM,Host Communities,6774,10158,354,534,17820,6742,10875,578,855,19050
19,South Sudan (UNDP),2019,SSD-19/HSS10/SA1/FSL/INGO/11635,10/18/2019 12:14:40 PM,Internally Displaced People,3384,5082,180,264,8910,3758,6063,322,477,10620
19,South Sudan (UNDP),2019,SSD-19/HSS10/SA1/FSL/INGO/11635,10/18/2019 12:14:40 PM,Overall,11286,16932,594,888,29700,10500,16938,900,1332,29670
19,South Sudan (UNDP),2019,SSD-19/HSS10/SA1/FSL/INGO/11635,10/18/2019 12:14:40 PM,Returnees,1128,1692,60,90,2970,0,0,0,0,0
19,South Sudan (UNDP),2019,SSD-19/HSS10/SA1/FSL/INGO/11637,11/6/2019 1:00:17 PM,Host Communities,12201,13756,5229,5896,37082,10469,11341,10469,11341,43620
19,South Sudan (UNDP),2019,SSD-19/HSS10/SA1/FSL/INGO/11637,11/6/2019 1:00:17 PM,Overall,14354,16184,6152,6936,43626,10469,11341,10469,11341,43620
19,South Sudan (UNDP),2019,SSD-19/HSS10/SA1/FSL/INGO/11637,11/6/2019 1:00:17 PM,Returnees,2153,2428,923,1040,6544,0,0,0,0,0
19,South Sudan (UNDP),2019,SSD-19/HSS10/SA1/FSL/INGO/11716,10/21/2019 11:49:45 AM,Host Communities,2574,3144,0,0,5718,1143,1430,1429,1716,5718
19,South Sudan (UNDP),2019,SSD-19/HSS10/SA1/FSL/INGO/11716,10/21/2019 11:49:45 AM,Internally Displaced People,8568,10482,0,0,19050,3810,4765,4760,5715,19050
19,South Sudan (UNDP),2019,SSD-19/HSS10/SA1/FSL/INGO/11716,10/21/2019 11:49:45 AM,Overall,17142,20958,0,0,38100,7619,9528,9522,11431,38100
19,South Sudan (UNDP),2019,SSD-19/HSS10/SA1/FSL/INGO/11716,10/21/2019 11:49:45 AM,Returnees,6000,7332,0,0,13332,2666,3333,3333,4000,13332
19,South Sudan (UNDP),2019,SSD-19/HSS10/SA1/FSL/INGO/11737,10/21/2019 11:48:27 AM,Host Communities,1680,1840,2160,2320,8000,1012,1148,4244,4631,11035
19,South Sudan (UNDP),2019,SSD-19/HSS10/SA1/FSL/INGO/11737,10/21/2019 11:48:27 AM,Internally Displaced People,1680,1840,2160,2320,8000,815,917,2216,1987,5935
19,South Sudan (UNDP),2019,SSD-19/HSS10/SA1/FSL/INGO/11737,10/21/2019 11:48:27 AM,Overall,5040,5520,6480,6960,24000,2625,2937,9490,8948,24000
19,South Sudan (UNDP),2019,SSD-19/HSS10/SA1/FSL/INGO/11737,10/21/2019 11:48:27 AM,Returnees,1680,1840,2160,2320,8000,798,872,3030,2330,7030
19,South Sudan (UNDP),2019,SSD-19/HSS10/SA1/FSL/INGO/11744,10/21/2019 11:38:09 AM,Host Communities,1500,1500,3000,3000,9000,4027,22383,1290,1125,28825
19,South Sudan (UNDP),2019,SSD-19/HSS10/SA1/FSL/INGO/11744,10/21/2019 11:38:09 AM,Internally Displaced People,3000,3000,6000,6000,18000,1225,5440,102,111,6878
19,South Sudan (UNDP),2019,SSD-19/HSS10/SA1/FSL/INGO/11744,10/21/2019 11:38:09 AM,Other,500,500,3868,3868,8736,22,11,0,0,33
19,South Sudan (UNDP),2019,SSD-19/HSS10/SA1/FSL/INGO/11744,10/21/2019 11:38:09 AM,Overall,5000,5000,12868,12868,35736,5274,27834,1392,1236,35736
19,South Sudan (UNDP),2019,SSD-19/HSS10/SA1/FSL/INGO/11751,10/21/2019 6:54:12 AM,Host Communities,7202,17195,2470,5869,32736,5879,21246,933,7073,35131
19,South Sudan (UNDP),2019,SSD-19/HSS10/SA1/FSL/INGO/11751,10/21/2019 6:54:12 AM,Internally Displaced People,839,1566,210,385,3000,121,264,123,97,605
19,South Sudan (UNDP),2019,SSD-19/HSS10/SA1/FSL/INGO/11751,10/21/2019 6:54:12 AM,Overall,8041,18761,2680,6254,35736,6000,21510,1056,7170,35736
19,South Sudan (UNDP),2019,SSD-19/HSS10/SA1/FSL/NGO/11440,11/18/2019 6:50:59 AM,Host Communities,2680,8935,2680,3574,17869,9325,10739,10082,13442,43588
19,South Sudan (UNDP),2019,SSD-19/HSS10/SA1/FSL/NGO/11440,11/18/2019 6:50:59 AM,Internally Displaced People,804,5360,804,2144,9112,102,118,111,148,479
19,South Sudan (UNDP),2019,SSD-19/HSS10/SA1/FSL/NGO/11440,11/18/2019 6:50:59 AM,Other,1876,3574,1876,1429,8755,820,944,886,1182,3832
19,South Sudan (UNDP),2019,SSD-19/HSS10/SA1/FSL/NGO/11440,11/18/2019 6:50:59 AM,Overall,5360,17869,5360,7147,35736,10247,11801,11079,14772,47899
19,South Sudan (UNDP),2019,SSD-19/HSS10/SA1/FSL/NGO/11538,11/19/2019 6:57:04 AM,Host Communities,4000,5000,3000,3000,15000,2440,9284,1038,4034,16796
19,South Sudan (UNDP),2019,SSD-19/HSS10/SA1/FSL/NGO/11538,11/19/2019 6:57:04 AM,Internally Displaced People,1000,1500,500,500,3500,560,732,212,183,1687
19,South Sudan (UNDP),2019,SSD-19/HSS10/SA1/FSL/NGO/11538,11/19/2019 6:57:04 AM,Overall,6000,7000,3748,4000,20748,3810,11004,1566,4356,20736
19,South Sudan (UNDP),2019,SSD-19/HSS10/SA1/FSL/NGO/11538,11/19/2019 6:57:04 AM,Returnees,1000,500,248,500,2248,810,988,316,139,2253
19,South Sudan (UNDP),2019,SSD-19/HSS10/SA1/FSL/NGO/11562,11/4/2019 9:30:44 AM,Host Communities,1620,4356,504,720,7200,3156,4488,54,48,7746
19,South Sudan (UNDP),2019,SSD-19/HSS10/SA1/FSL/NGO/11562,11/4/2019 9:30:44 AM,Internally Displaced People,2700,7260,840,1200,12000,5256,7920,126,36,13338
19,South Sudan (UNDP),2019,SSD-19/HSS10/SA1/FSL/NGO/11562,11/4/2019 9:30:44 AM,Overall,5400,14520,1680,2400,24000,9798,13902,216,84,24000
19,South Sudan (UNDP),2019,SSD-19/HSS10/SA1/FSL/NGO/11562,11/4/2019 9:30:44 AM,Returnees,1080,2904,336,480,4800,1386,1494,36,0,2916
19,South Sudan (UNDP),2019,SSD-19/HSS10/SA1/FSL/NGO/11597,11/18/2019 1:45:24 PM,Host Communities,3888,1848,308,120,6164,3888,1850,308,125,6171
19,South Sudan (UNDP),2019,SSD-19/HSS10/SA1/FSL/NGO/11597,11/18/2019 1:45:24 PM,Internally Displaced People,9720,4626,768,312,15426,9720,4626,771,312,15429
19,South Sudan (UNDP),2019,SSD-19/HSS10/SA1/FSL/NGO/11597,11/18/2019 1:45:24 PM,Overall,19440,9252,1542,624,30858,19440,9252,1542,624,30858
19,South Sudan (UNDP),2019,SSD-19/HSS10/SA1/FSL/NGO/11597,11/18/2019 1:45:24 PM,Returnees,5832,2778,466,192,9268,5832,2776,463,187,9258
19,South Sudan (UNDP),2019,SSD-19/HSS10/SA1/FSL/NGO/11633,12/13/2019 8:38:35 AM,Host Communities,2162,2292,978,524,5956,2162,2292,978,524,5956
19,South Sudan (UNDP),2019,SSD-19/HSS10/SA1/FSL/NGO/11633,12/13/2019 8:38:35 AM,Internally Displaced People,3451,3767,1557,923,9698,3451,3767,1557,923,9698
19,South Sudan (UNDP),2019,SSD-19/HSS10/SA1/FSL/NGO/11633,12/13/2019 8:38:35 AM,Overall,10800,12342,4626,3090,30858,10800,12342,4626,3090,30858
19,South Sudan (UNDP),2019,SSD-19/HSS10/SA1/FSL/NGO/11633,12/13/2019 8:38:35 AM,Returnees,5187,6283,2091,1643,15204,5187,6283,2091,1643,15204
19,South Sudan (UNDP),2019,SSD-19/HSS10/SA1/FSL/NGO/11669,11/19/2019 11:14:29 AM,Host Communities,9657,7243,4829,2414,24143,9657,7243,4829,2414,24143
19,South Sudan (UNDP),2019,SSD-19/HSS10/SA1/FSL/NGO/11669,11/19/2019 11:14:29 AM,Internally Displaced People,4138,3103,2069,1035,10345,4138,3103,2069,1035,10345
19,South Sudan (UNDP),2019,SSD-19/HSS10/SA1/FSL/NGO/11669,11/19/2019 11:14:29 AM,Overall,13795,10346,6898,3449,34488,13795,10346,6898,3449,34488
19,South Sudan (UNDP),2019,SSD-19/HSS10/SA1/FSL/NGO/11670,2/6/2020 1:08:15 PM,Host Communities,3334,4443,4074,6664,18515,3100,4634,4180,6667,18581
19,South Sudan (UNDP),2019,SSD-19/HSS10/SA1/FSL/NGO/11670,2/6/2020 1:08:15 PM,Internally Displaced People,2223,2961,2717,4442,12343,2100,3100,2623,4443,12266
19,South Sudan (UNDP),2019,SSD-19/HSS10/SA1/FSL/NGO/11670,2/6/2020 1:08:15 PM,Overall,5557,7404,6791,11106,30858,5200,7734,6803,11110,30847
19,South Sudan (UNDP),2019,SSD-19/HSS10/SA1/FSL/NGO/11733,11/28/2019 7:14:32 AM,Host Communities,10000,7000,4000,7000,28000,8000,8000,6500,5000,27500
19,South Sudan (UNDP),2019,SSD-19/HSS10/SA1/FSL/NGO/11733,11/28/2019 7:14:32 AM,Internally Displaced People,1382,2000,2000,2000,7382,2975,2132,1495,1195,7797
19,South Sudan (UNDP),2019,SSD-19/HSS10/SA1/FSL/NGO/11733,11/28/2019 7:14:32 AM,Other,0,0,0,0,0,25,50,5,5,85
19,South Sudan (UNDP),2019,SSD-19/HSS10/SA1/FSL/NGO/11733,11/28/2019 7:14:32 AM,Overall,11382,9000,6000,9000,35382,11000,10182,8000,6200,35382
19,South Sudan (UNDP),2019,SSD-19/HSS10/SA1/FSL/NGO/11742,11/18/2019 9:14:43 AM,Host Communities,1390,4600,1000,3600,10590,3876,3793,3117,3006,13792
19,South Sudan (UNDP),2019,SSD-19/HSS10/SA1/FSL/NGO/11742,11/18/2019 9:14:43 AM,Internally Displaced People,1000,1900,1000,1100,5000,2159,2113,1737,1668,7677
19,South Sudan (UNDP),2019,SSD-19/HSS10/SA1/FSL/NGO/11742,11/18/2019 9:14:43 AM,Overall,5090,10500,4000,6000,25590,8407,8227,6762,6508,29904
19,South Sudan (UNDP),2019,SSD-19/HSS10/SA1/FSL/NGO/11742,11/18/2019 9:14:43 AM,Returnees,2700,4000,2000,1300,10000,2372,2321,1908,1834,8435
19,South Sudan (UNDP),2019,SSD-19/HSS10/SA1/FSL/NGO/11761,12/3/2019 8:23:30 AM,Host Communities,1000,1730,1000,1000,4730,2500,2730,1000,1500,7730
19,South Sudan (UNDP),2019,SSD-19/HSS10/SA1/FSL/NGO/11761,12/3/2019 8:23:30 AM,Internally Displaced People,4000,4000,4000,4000,16000,3000,4000,3000,3000,13000
19,South Sudan (UNDP),2019,SSD-19/HSS10/SA1/FSL/NGO/11761,12/3/2019 8:23:30 AM,Overall,5000,5730,5000,5000,20730,5500,6730,4000,4500,20730
19,South Sudan (UNDP),2019,SSD-19/HSS10/SA1/FSL/NGO/11787,1/27/2020 2:49:13 PM,Host Communities,2000,2500,2500,1000,8000,2000,6000,1000,860,9860
19,South Sudan (UNDP),2019,SSD-19/HSS10/SA1/FSL/NGO/11787,1/27/2020 2:49:13 PM,Internally Displaced People,4000,1500,3500,5000,14000,4144,7140,1856,1000,14140
19,South Sudan (UNDP),2019,SSD-19/HSS10/SA1/FSL/NGO/11787,1/27/2020 2:49:13 PM,Overall,6000,6000,6000,6000,24000,6144,13140,2856,1860,24000
19,South Sudan (UNDP),2019,SSD-19/HSS10/SA1/H/INGO/11471,12/6/2019 11:54:42 AM,Host Communities,5149,5067,5917,5822,21955,3833,3771,4403,4334,16341
19,South Sudan (UNDP),2019,SSD-19/HSS10/SA1/H/INGO/11471,12/6/2019 11:54:42 AM,Internally Displaced People,3432,3378,3944,3882,14636,2556,2514,2936,2889,10895
19,South Sudan (UNDP),2019,SSD-19/HSS10/SA1/H/INGO/11471,12/6/2019 11:54:42 AM,Overall,8581,8445,9861,9704,36591,6389,6285,7339,7223,27236
19,South Sudan (UNDP),2019,SSD-19/HSS10/SA1/H/INGO/11485,1/6/2020 8:15:27 AM,Overall,9956,9190,2647,2443,24236,4335,9462,919,1039,15755
19,South Sudan (UNDP),2019,SSD-19/HSS10/SA1/H/INGO/11559,10/30/2019 12:57:41 PM,Overall,59,4528,2522,2522,9631,180,6252,2545,2280,11257
19,South Sudan (UNDP),2019,SSD-19/HSS10/SA1/H/INGO/11584,11/14/2019 11:07:42 AM,Host Communities,636,894,969,1017,3516,7690,6454,7666,6100,27910
19,South Sudan (UNDP),2019,SSD-19/HSS10/SA1/H/INGO/11584,11/14/2019 11:07:42 AM,Internally Displaced People,1484,2084,2260,2372,8200,1693,2928,1717,3282,9620
19,South Sudan (UNDP),2019,SSD-19/HSS10/SA1/H/INGO/11584,11/14/2019 11:07:42 AM,Overall,2120,2978,3229,3389,11716,9383,9382,9383,9382,37530
19,South Sudan (UNDP),2019,SSD-19/HSS10/SA1/H/INGO/11585,11/28/2019 11:55:02 AM,Overall,3094,3220,5218,5431,16963,4732,6943,4036,4421,20132
19,South Sudan (UNDP),2019,SSD-19/HSS10/SA1/H/INGO/11629,11/7/2019 8:14:25 AM,Other,0,0,0,0,0,2609,7155,4091,4100,17955
19,South Sudan (UNDP),2019,SSD-19/HSS10/SA1/H/INGO/11629,11/7/2019 8:14:25 AM,Overall,2096,4636,2985,2985,12702,2609,7155,4091,4100,17955
19,South Sudan (UNDP),2019,SSD-19/HSS10/SA1/H/INGO/11643,11/7/2019 6:27:18 AM,Host Communities,4233,4104,2096,2066,12499,3200,3900,2037,2180,11317
19,South Sudan (UNDP),2019,SSD-19/HSS10/SA1/H/INGO/11643,11/7/2019 6:27:18 AM,Internally Displaced People,296,652,127,125,1200,151,154,50,49,404
19,South Sudan (UNDP),2019,SSD-19/HSS10/SA1/H/INGO/11643,11/7/2019 6:27:18 AM,Overall,4529,4756,2223,2191,13699,3351,4054,2087,2229,11721
19,South Sudan (UNDP),2019,SSD-19/HSS10/SA1/H/INGO/11674,2/5/2020 9:40:30 AM,Host Communities,2712,2938,2219,2404,10273,4234,4587,3464,3753,16038
19,South Sudan (UNDP),2019,SSD-19/HSS10/SA1/H/INGO/11674,2/5/2020 9:40:30 AM,Internally Displaced People,1233,1336,1009,1092,4670,398,432,326,353,1509
19,South Sudan (UNDP),2019,SSD-19/HSS10/SA1/H/INGO/11674,2/5/2020 9:40:30 AM,Other,247,267,202,219,935,100,108,81,88,377
19,South Sudan (UNDP),2019,SSD-19/HSS10/SA1/H/INGO/11674,2/5/2020 9:40:30 AM,Overall,4932,5342,4035,4371,18680,4981,5396,4075,4415,18867
19,South Sudan (UNDP),2019,SSD-19/HSS10/SA1/H/INGO/11674,2/5/2020 9:40:30 AM,Returnees,740,801,605,656,2802,249,269,204,221,943
19,South Sudan (UNDP),2019,SSD-19/HSS10/SA1/H/INGO/11703,1/21/2020 8:17:29 AM,Host Communities,762,744,1142,1115,3763,585,889,960,1083,3517
19,South Sudan (UNDP),2019,SSD-19/HSS10/SA1/H/INGO/11703,1/21/2020 8:17:29 AM,Internally Displaced People,3046,2974,4461,4569,15050,2377,3594,3862,4359,14192
19,South Sudan (UNDP),2019,SSD-19/HSS10/SA1/H/INGO/11703,1/21/2020 8:17:29 AM,Overall,3808,3718,5603,5684,18813,2962,4483,4822,5442,17709
19,South Sudan (UNDP),2019,SSD-19/HSS10/SA1/H/INGO/11732,11/15/2019 1:45:53 PM,Overall,37094,35976,20989,20410,114469,30823,32081,18768,18769,100441
19,South Sudan (UNDP),2019,SSD-19/HSS10/SA1/H/INGO/11777,12/16/2019 5:56:11 AM,Overall,3817,3971,3667,3817,15272,3763,4110,4853,4709,17435
19,South Sudan (UNDP),2019,SSD-19/HSS10/SA1/H/NGO/11442,11/5/2019 8:23:43 AM,Children under 5,0,0,500,400,900,0,0,1500,1456,2956
19,South Sudan (UNDP),2019,SSD-19/HSS10/SA1/H/NGO/11442,11/5/2019 8:23:43 AM,Internally Displaced People,1200,1300,100,100,2700,630,591,320,485,2026
19,South Sudan (UNDP),2019,SSD-19/HSS10/SA1/H/NGO/11442,11/5/2019 8:23:43 AM,Overall,5035,4780,1032,1050,11897,4122,5179,3088,3444,15833
19,South Sudan (UNDP),2019,SSD-19/HSS10/SA1/H/NGO/11442,11/5/2019 8:23:43 AM,Pastoralists,700,600,232,250,1782,3492,4588,1268,1503,10851
19,South Sudan (UNDP),2019,SSD-19/HSS10/SA1/H/NGO/11445,12/16/2019 11:50:56 AM,Host Communities,0,467,2772,2224,5463,0,0,0,0,0
19,South Sudan (UNDP),2019,SSD-19/HSS10/SA1/H/NGO/11445,12/16/2019 11:50:56 AM,Internally Displaced People,7303,7082,2403,3181,19969,5831,11923,3529,4687,25970
19,South Sudan (UNDP),2019,SSD-19/HSS10/SA1/H/NGO/11445,12/16/2019 11:50:56 AM,Overall,7320,7549,5175,5405,25449,5831,11923,3529,4687,25970
19,South Sudan (UNDP),2019,SSD-19/HSS10/SA1/H/NGO/11451,11/6/2019 1:13:10 PM,Children under 5,0,0,579,570,1149,0,0,560,554,1114
19,South Sudan (UNDP),2019,SSD-19/HSS10/SA1/H/NGO/11451,11/6/2019 1:13:10 PM,Host Communities,3109,2922,2178,2143,10352,2742,2571,2107,2083,9503
19,South Sudan (UNDP),2019,SSD-19/HSS10/SA1/H/NGO/11451,11/6/2019 1:13:10 PM,Overall,3109,3060,2757,2713,11639,2742,2746,2667,2637,10792
19,South Sudan (UNDP),2019,SSD-19/HSS10/SA1/H/NGO/11451,11/6/2019 1:13:10 PM,Pregnant and Lactating Women,0,138,0,0,138,0,175,0,0,175
19,South Sudan (UNDP),2019,SSD-19/HSS10/SA1/H/NGO/11452,11/4/2019 8:20:49 AM,Host Communities,616,1027,1109,1356,4108,535,892,964,1178,3569
19,South Sudan (UNDP),2019,SSD-19/HSS10/SA1/H/NGO/11452,11/4/2019 8:20:49 AM,Internally Displaced People,841,1401,1513,1849,5604,714,1190,1284,1570,4758
19,South Sudan (UNDP),2019,SSD-19/HSS10/SA1/H/NGO/11452,11/4/2019 8:20:49 AM,Other,131,218,235,289,873,178,297,322,393,1190
19,South Sudan (UNDP),2019,SSD-19/HSS10/SA1/H/NGO/11452,11/4/2019 8:20:49 AM,Overall,1868,3113,3362,4110,12453,1784,2974,3212,3926,11896
19,South Sudan (UNDP),2019,SSD-19/HSS10/SA1/H/NGO/11452,11/4/2019 8:20:49 AM,Returnees,280,467,505,616,1868,357,595,642,785,2379
19,South Sudan (UNDP),2019,SSD-19/HSS10/SA1/H/NGO/11454,12/3/2019 8:38:10 AM,Host Communities,2168,2932,3570,4080,12750,3600,3743,2757,3393,13493
19,South Sudan (UNDP),2019,SSD-19/HSS10/SA1/H/NGO/11454,12/3/2019 8:38:10 AM,Internally Displaced People,1020,1380,1680,1920,6000,1618,1761,1297,1596,6272
19,South Sudan (UNDP),2019,SSD-19/HSS10/SA1/H/NGO/11454,12/3/2019 8:38:10 AM,Overall,3188,4312,5250,6000,18750,5218,5504,4054,4989,19765
19,South Sudan (UNDP),2019,SSD-19/HSS10/SA1/H/NGO/11466,11/18/2019 6:25:16 AM,Host Communities,1576,1667,926,937,5106,2023,4339,2023,1159,9544
19,South Sudan (UNDP),2019,SSD-19/HSS10/SA1/H/NGO/11466,11/18/2019 6:25:16 AM,Internally Displaced People,2268,2398,1332,1349,7347,2130,3402,2440,3471,11443
19,South Sudan (UNDP),2019,SSD-19/HSS10/SA1/H/NGO/11466,11/18/2019 6:25:16 AM,Overall,3844,4065,2258,2286,12453,4153,7741,4463,4630,20987
19,South Sudan (UNDP),2019,SSD-19/HSS10/SA1/H/NGO/11472,11/4/2019 8:44:30 AM,Host Communities,421,1356,870,940,3587,2995,4247,981,1143,9366
19,South Sudan (UNDP),2019,SSD-19/HSS10/SA1/H/NGO/11472,11/4/2019 8:44:30 AM,Internally Displaced People,675,1970,1193,1424,5262,294,369,381,413,1457
19,South Sudan (UNDP),2019,SSD-19/HSS10/SA1/H/NGO/11472,11/4/2019 8:44:30 AM,Overall,1096,3326,2063,2364,8849,3289,4616,1362,1556,10823
19,South Sudan (UNDP),2019,SSD-19/HSS10/SA1/H/NGO/11476,11/21/2019 5:31:41 AM,Children under 5,0,0,5248,5462,10710,0,0,6007,8030,14037
19,South Sudan (UNDP),2019,SSD-19/HSS10/SA1/H/NGO/11476,11/21/2019 5:31:41 AM,Host Communities,18892,19663,0,0,38555,11896,15931,0,0,27827
19,South Sudan (UNDP),2019,SSD-19/HSS10/SA1/H/NGO/11476,11/21/2019 5:31:41 AM,Internally Displaced People,2099,2185,0,0,4284,1321,1770,0,0,3091
19,South Sudan (UNDP),2019,SSD-19/HSS10/SA1/H/NGO/11476,11/21/2019 5:31:41 AM,Overall,20991,21848,5248,5462,53549,13217,17701,6007,8030,44955
19,South Sudan (UNDP),2019,SSD-19/HSS10/SA1/H/NGO/11495,11/18/2019 6:38:56 AM,Host Communities,1595,1743,1567,1633,6538,2388,2763,2408,2733,10292
19,South Sudan (UNDP),2019,SSD-19/HSS10/SA1/H/NGO/11495,11/18/2019 6:38:56 AM,Internally Displaced People,3722,4067,3657,3810,15256,3298,3815,3325,3773,14211
19,South Sudan (UNDP),2019,SSD-19/HSS10/SA1/H/NGO/11495,11/18/2019 6:38:56 AM,Overall,5317,5810,5224,5443,21794,5686,6578,5733,6506,24503
19,South Sudan (UNDP),2019,SSD-19/HSS10/SA1/H/NGO/11498,11/18/2019 12:36:33 PM,Children under 5,0,0,1060,1115,2175,0,0,2241,3540,5781
19,South Sudan (UNDP),2019,SSD-19/HSS10/SA1/H/NGO/11498,11/18/2019 12:36:33 PM,Internally Displaced People,4504,5095,0,0,9599,2653,4445,0,0,7098
19,South Sudan (UNDP),2019,SSD-19/HSS10/SA1/H/NGO/11498,11/18/2019 12:36:33 PM,Overall,4504,5095,1060,1115,11774,2653,4445,2241,3540,12879
19,South Sudan (UNDP),2019,SSD-19/HSS10/SA1/H/NGO/11505,12/13/2019 8:30:05 AM,Host Communities,2062,4094,4774,4549,15479,1917,2873,1133,1647,7570
19,South Sudan (UNDP),2019,SSD-19/HSS10/SA1/H/NGO/11505,12/13/2019 8:30:05 AM,Internally Displaced People,2398,3589,3609,5872,15468,288,431,170,247,1136
19,South Sudan (UNDP),2019,SSD-19/HSS10/SA1/H/NGO/11505,12/13/2019 8:30:05 AM,Other,592,688,768,781,2829,0,0,0,0,0
19,South Sudan (UNDP),2019,SSD-19/HSS10/SA1/H/NGO/11505,12/13/2019 8:30:05 AM,Overall,5921,9869,10658,13026,39474,2396,3591,1416,2059,9462
19,South Sudan (UNDP),2019,SSD-19/HSS10/SA1/H/NGO/11505,12/13/2019 8:30:05 AM,Returnees,869,1498,1507,1824,5698,191,287,113,165,756
19,South Sudan (UNDP),2019,SSD-19/HSS10/SA1/H/NGO/11508,11/18/2019 10:11:55 AM,Children under 5,0,0,3200,3000,6200,0,0,2630,2510,5140
19,South Sudan (UNDP),2019,SSD-19/HSS10/SA1/H/NGO/11508,11/18/2019 10:11:55 AM,Host Communities,10000,10028,0,0,20028,8363,9810,0,0,18173
19,South Sudan (UNDP),2019,SSD-19/HSS10/SA1/H/NGO/11508,11/18/2019 10:11:55 AM,Internally Displaced People,4521,3000,430,988,8939,3800,2800,303,634,7537
19,South Sudan (UNDP),2019,SSD-19/HSS10/SA1/H/NGO/11508,11/18/2019 10:11:55 AM,Overall,14521,14452,3630,3988,36591,12163,14010,2933,3144,32250
19,South Sudan (UNDP),2019,SSD-19/HSS10/SA1/H/NGO/11508,11/18/2019 10:11:55 AM,Pregnant and Lactating Women,0,1424,0,0,1424,0,1400,0,0,1400
19,South Sudan (UNDP),2019,SSD-19/HSS10/SA1/H/NGO/11520,11/18/2019 9:05:51 AM,Host Communities,857,844,4477,4406,10584,1698,2159,7634,7151,18642
19,South Sudan (UNDP),2019,SSD-19/HSS10/SA1/H/NGO/11520,11/18/2019 9:05:51 AM,Internally Displaced People,152,149,791,779,1871,541,557,1271,1178,3547
19,South Sudan (UNDP),2019,SSD-19/HSS10/SA1/H/NGO/11520,11/18/2019 9:05:51 AM,Overall,1009,993,5268,5185,12455,2239,2716,8905,8329,22189
19,South Sudan (UNDP),2019,SSD-19/HSS10/SA1/H/NGO/11521,11/18/2019 1:03:03 PM,Host Communities,3265,3213,868,854,8200,3351,3605,855,916,8727
19,South Sudan (UNDP),2019,SSD-19/HSS10/SA1/H/NGO/11521,11/18/2019 1:03:03 PM,Internally Displaced People,876,862,233,229,2200,2701,3931,1827,1581,10040
19,South Sudan (UNDP),2019,SSD-19/HSS10/SA1/H/NGO/11521,11/18/2019 1:03:03 PM,Overall,4958,4880,1318,1297,12453,6052,7536,2682,2497,18767
19,South Sudan (UNDP),2019,SSD-19/HSS10/SA1/H/NGO/11521,11/18/2019 1:03:03 PM,Returnees,817,804,217,204,2042,0,0,0,0,0
19,South Sudan (UNDP),2019,SSD-19/HSS10/SA1/H/NGO/11542,11/28/2019 11:28:13 AM,Host Communities,17819,16063,4737,4447,43066,4872,6252,4655,4356,20135
19,South Sudan (UNDP),2019,SSD-19/HSS10/SA1/H/NGO/11542,11/28/2019 11:28:13 AM,Internally Displaced People,5939,6434,1579,1710,15662,1392,1786,1330,1245,5753
19,South Sudan (UNDP),2019,SSD-19/HSS10/SA1/H/NGO/11542,11/28/2019 11:28:13 AM,Overall,29698,32171,7895,8552,78316,6960,8931,6650,6223,28764
19,South Sudan (UNDP),2019,SSD-19/HSS10/SA1/H/NGO/11542,11/28/2019 11:28:13 AM,Returnees,5940,6434,1579,1710,15663,696,893,665,622,2876
19,South Sudan (UNDP),2019,SSD-19/HSS10/SA1/H/NGO/11616,11/29/2019 7:13:21 AM,Host Communities,500,700,300,300,1800,1215,2340,790,854,5199
19,South Sudan (UNDP),2019,SSD-19/HSS10/SA1/H/NGO/11616,11/29/2019 7:13:21 AM,Internally Displaced People,1000,1200,300,400,2900,314,528,90,101,1033
19,South Sudan (UNDP),2019,SSD-19/HSS10/SA1/H/NGO/11616,11/29/2019 7:13:21 AM,Overall,3800,4600,1500,2100,12000,4679,8448,2140,2265,17532
19,South Sudan (UNDP),2019,SSD-19/HSS10/SA1/H/NGO/11616,11/29/2019 7:13:21 AM,Returnees,2300,2700,900,1400,7300,3150,5580,1260,1310,11300
19,South Sudan (UNDP),2019,SSD-19/HSS10/SA1/H/NGO/11696,2/6/2020 1:07:42 PM,Host Communities,140,179,112,129,560,120,150,130,160,560
19,South Sudan (UNDP),2019,SSD-19/HSS10/SA1/H/NGO/11696,2/6/2020 1:07:42 PM,Internally Displaced People,4530,5798,3624,4168,18120,4550,5827,3606,4137,18120
19,South Sudan (UNDP),2019,SSD-19/HSS10/SA1/H/NGO/11696,2/6/2020 1:07:42 PM,Overall,4670,5977,3736,4297,18680,4670,5977,3736,4297,18680
19,South Sudan (UNDP),2019,SSD-19/HSS10/SA1/H/NGO/11702,11/22/2019 6:20:14 AM,Host Communities,1671,2042,694,843,5250,1391,1964,1079,853,5287
19,South Sudan (UNDP),2019,SSD-19/HSS10/SA1/H/NGO/11702,11/22/2019 6:20:14 AM,Internally Displaced People,2307,2819,959,1165,7250,1451,2702,1289,1853,7295
19,South Sudan (UNDP),2019,SSD-19/HSS10/SA1/H/NGO/11702,11/22/2019 6:20:14 AM,Overall,3978,4861,1653,2008,12500,2842,4666,2368,2706,12582
19,South Sudan (UNDP),2019,SSD-19/HSS10/SA1/H/NGO/11735,11/18/2019 1:34:25 PM,Host Communities,1402,1757,1269,1250,5678,1985,2746,2136,2143,9010
19,South Sudan (UNDP),2019,SSD-19/HSS10/SA1/H/NGO/11735,11/18/2019 1:34:25 PM,Internally Displaced People,1752,2197,1587,1562,7098,2482,3443,2671,2679,11275
19,South Sudan (UNDP),2019,SSD-19/HSS10/SA1/H/NGO/11735,11/18/2019 1:34:25 PM,Overall,3504,4394,3174,3125,14197,4963,6866,5341,5357,22527
19,South Sudan (UNDP),2019,SSD-19/HSS10/SA1/H/NGO/11735,11/18/2019 1:34:25 PM,Returnees,350,440,318,313,1421,496,677,534,535,2242
19,South Sudan (UNDP),2019,SSD-19/HSS10/SA1/H/NGO/11753,11/18/2019 12:16:42 PM,Host Communities,430,2020,1970,2000,6420,664,2018,1868,1601,6151
19,South Sudan (UNDP),2019,SSD-19/HSS10/SA1/H/NGO/11753,11/18/2019 12:16:42 PM,Internally Displaced People,90,220,430,450,1190,0,0,0,0,0
19,South Sudan (UNDP),2019,SSD-19/HSS10/SA1/H/NGO/11753,11/18/2019 12:16:42 PM,Overall,520,2240,2400,2450,7610,664,2018,1868,1601,6151
19,South Sudan (UNDP),2019,SSD-19/HSS10/SA1/H/UN/11448,12/5/2019 10:55:41 AM,Children under 5,0,0,1973,1958,3931,0,0,43977,45305,89282
19,South Sudan (UNDP),2019,SSD-19/HSS10/SA1/H/UN/11448,12/5/2019 10:55:41 AM,Internally Displaced People,5879,5823,18645,19979,50326,8009,8276,491,509,17285
19,South Sudan (UNDP),2019,SSD-19/HSS10/SA1/H/UN/11448,12/5/2019 10:55:41 AM,Overall,6061,10503,21133,22462,60159,8009,40515,44468,45814,138806
19,South Sudan (UNDP),2019,SSD-19/HSS10/SA1/H/UN/11448,12/5/2019 10:55:41 AM,Pregnant and Lactating Women,0,4500,0,0,4500,0,32239,0,0,32239
19,South Sudan (UNDP),2019,SSD-19/HSS10/SA1/H/UN/11503,2/17/2020 6:50:34 AM,Host Communities,951,966,717,729,3363,10776,11162,8083,8468,38489
19,South Sudan (UNDP),2019,SSD-19/HSS10/SA1/H/UN/11503,2/17/2020 6:50:34 AM,Internally Displaced People,30736,31232,23187,23561,108716,17963,18603,13471,14113,64150
19,South Sudan (UNDP),2019,SSD-19/HSS10/SA1/H/UN/11503,2/17/2020 6:50:34 AM,Overall,31687,32198,23904,24291,112080,28739,29765,21554,22581,102639
19,South Sudan (UNDP),2019,SSD-19/HSS10/SA1/H/UN/11700,11/22/2019 12:28:21 PM,Internally Displaced People,5718,6736,10143,11157,33754,12186,18664,7789,8129,46768
19,South Sudan (UNDP),2019,SSD-19/HSS10/SA1/H/UN/11700,11/22/2019 12:28:21 PM,Other,30,25,0,0,55,15,15,0,0,30
19,South Sudan (UNDP),2019,SSD-19/HSS10/SA1/H/UN/11700,11/22/2019 12:28:21 PM,Overall,5748,6761,10143,11157,33809,12201,18679,7789,8129,46798
19,South Sudan (UNDP),2019,SSD-19/HSS10/SA1/H/UN/11745,2/26/2020 1:57:06 PM,Host Communities,0,4100,0,280,4380,0,2309,0,404,2713
19,South Sudan (UNDP),2019,SSD-19/HSS10/SA1/H/UN/11745,2/26/2020 1:57:06 PM,Internally Displaced People,0,23900,0,4000,27900,0,26144,0,3543,29687
19,South Sudan (UNDP),2019,SSD-19/HSS10/SA1/H/UN/11745,2/26/2020 1:57:06 PM,Overall,0,28000,0,4280,32280,0,28453,0,3947,32400
19,South Sudan (UNDP),2019,SSD-19/HSS10/SA1/L/UN/11625,7/23/2019 6:32:15 AM,Overall,60,0,0,0,60,103,0,0,0,103
19,South Sudan (UNDP),2019,SSD-19/HSS10/SA1/L/UN/11678,12/2/2019 12:26:15 PM,Overall,0,0,0,297,297,300,90,7,19,416
19,South Sudan (UNDP),2019,SSD-19/HSS10/SA1/L/UN/11701,11/20/2019 6:03:01 AM,Overall,20,20,20,20,80,20,20,20,20,80
19,South Sudan (UNDP),2019,SSD-19/HSS10/SA1/N/INGO/11450,11/15/2019 5:51:33 AM,Overall,0,2500,1020,1088,4608,0,0,935,961,1896
19,South Sudan (UNDP),2019,SSD-19/HSS10/SA1/N/INGO/11478,8/12/2020 8:16:15 AM,Children under 5,0,0,4686,4878,9564,0,0,16420,18429,34849
19,South Sudan (UNDP),2019,SSD-19/HSS10/SA1/N/INGO/11478,8/12/2020 8:16:15 AM,Other,389,0,0,0,389,1211,0,0,0,1211
19,South Sudan (UNDP),2019,SSD-19/HSS10/SA1/N/INGO/11478,8/12/2020 8:16:15 AM,Overall,425,5937,4686,4878,15926,1266,44783,16420,18429,80898
19,South Sudan (UNDP),2019,SSD-19/HSS10/SA1/N/INGO/11478,8/12/2020 8:16:15 AM,Pregnant and Lactating Women,0,5889,0,0,5889,0,44783,0,0,44783
19,South Sudan (UNDP),2019,SSD-19/HSS10/SA1/N/INGO/11478,8/12/2020 8:16:15 AM,"Trainers, Promoters, Caretakers, committee members, etc.",36,48,0,0,84,55,0,0,0,55
19,South Sudan (UNDP),2019,SSD-19/HSS10/SA1/N/INGO/11483,12/6/2019 11:50:36 AM,Host Communities,0,0,5110,5029,10139,0,0,3883,3822,7705
19,South Sudan (UNDP),2019,SSD-19/HSS10/SA1/N/INGO/11483,12/6/2019 11:50:36 AM,Internally Displaced People,0,0,3406,3353,6759,0,0,2589,2548,5137
19,South Sudan (UNDP),2019,SSD-19/HSS10/SA1/N/INGO/11483,12/6/2019 11:50:36 AM,Overall,0,0,8516,8382,16898,0,0,6472,6370,12842
19,South Sudan (UNDP),2019,SSD-19/HSS10/SA1/N/INGO/11486,1/6/2020 8:11:58 AM,Host Communities,0,9830,6386,6918,23134,1029,10313,9717,9786,30845
19,South Sudan (UNDP),2019,SSD-19/HSS10/SA1/N/INGO/11486,1/6/2020 8:11:58 AM,Internally Displaced People,0,1368,889,963,3220,464,3115,1251,1338,6168
19,South Sudan (UNDP),2019,SSD-19/HSS10/SA1/N/INGO/11486,1/6/2020 8:11:58 AM,Overall,0,12442,8083,8756,29281,1657,14642,12248,12479,41026
19,South Sudan (UNDP),2019,SSD-19/HSS10/SA1/N/INGO/11486,1/6/2020 8:11:58 AM,Returnees,0,1244,808,875,2927,164,1214,1280,1355,4013
19,South Sudan (UNDP),2019,SSD-19/HSS10/SA1/N/INGO/11509,11/18/2019 9:13:48 AM,Children under 5,0,0,26944,28043,54987,0,0,31180,31788,62968
19,South Sudan (UNDP),2019,SSD-19/HSS10/SA1/N/INGO/11509,11/18/2019 9:13:48 AM,Internally Displaced People,0,0,1014,1056,2070,0,0,0,0,0
19,South Sudan (UNDP),2019,SSD-19/HSS10/SA1/N/INGO/11509,11/18/2019 9:13:48 AM,Overall,0,0,27958,29099,57057,0,0,31180,31788,62968
19,South Sudan (UNDP),2019,SSD-19/HSS10/SA1/N/INGO/11516,10/30/2019 1:37:14 PM,Host Communities,0,0,0,0,0,29,9732,4049,4700,18510
19,South Sudan (UNDP),2019,SSD-19/HSS10/SA1/N/INGO/11516,10/30/2019 1:37:14 PM,Other,0,7648,6103,6613,20364,0,0,0,0,0
19,South Sudan (UNDP),2019,SSD-19/HSS10/SA1/N/INGO/11516,10/30/2019 1:37:14 PM,Overall,0,7648,6103,6613,20364,29,9732,4049,4700,18510
19,South Sudan (UNDP),2019,SSD-19/HSS10/SA1/N/INGO/11519,11/16/2019 6:03:20 PM,Children under 5,0,0,850,860,1710,0,0,1010,1148,2158
19,South Sudan (UNDP),2019,SSD-19/HSS10/SA1/N/INGO/11519,11/16/2019 6:03:20 PM,Host Communities,0,3130,0,0,3130,0,4804,0,0,4804
19,South Sudan (UNDP),2019,SSD-19/HSS10/SA1/N/INGO/11519,11/16/2019 6:03:20 PM,Internally Displaced People,0,0,0,0,0,0,76,0,0,76
19,South Sudan (UNDP),2019,SSD-19/HSS10/SA1/N/INGO/11519,11/16/2019 6:03:20 PM,Overall,0,4230,850,860,5940,0,6321,1010,1148,8479
19,South Sudan (UNDP),2019,SSD-19/HSS10/SA1/N/INGO/11519,11/16/2019 6:03:20 PM,Pregnant and Lactating Women,0,1100,0,0,1100,0,1441,0,0,1441
19,South Sudan (UNDP),2019,SSD-19/HSS10/SA1/N/INGO/11529,12/6/2019 8:00:59 AM,Host Communities,0,0,6720,7280,14000,0,0,3794,6574,10368
19,South Sudan (UNDP),2019,SSD-19/HSS10/SA1/N/INGO/11529,12/6/2019 8:00:59 AM,Internally Displaced People,0,0,0,0,0,0,0,200,346,546
19,South Sudan (UNDP),2019,SSD-19/HSS10/SA1/N/INGO/11529,12/6/2019 8:00:59 AM,Overall,0,0,6720,7280,14000,0,0,3994,6920,10914
19,South Sudan (UNDP),2019,SSD-19/HSS10/SA1/N/INGO/11583,10/31/2019 9:34:00 AM,Host Communities,6,501,1368,1607,3482,15,1700,1181,1313,4209
19,South Sudan (UNDP),2019,SSD-19/HSS10/SA1/N/INGO/11583,10/31/2019 9:34:00 AM,Overall,6,501,1368,1607,3482,15,1700,1181,1313,4209
19,South Sudan (UNDP),2019,SSD-19/HSS10/SA1/N/INGO/11596,11/19/2019 1:37:36 PM,Host Communities,0,0,3935,4101,8036,0,0,2772,3213,5985
19,South Sudan (UNDP),2019,SSD-19/HSS10/SA1/N/INGO/11596,11/19/2019 1:37:36 PM,Internally Displaced People,0,0,168,174,342,0,0,115,134,249
19,South Sudan (UNDP),2019,SSD-19/HSS10/SA1/N/INGO/11596,11/19/2019 1:37:36 PM,Overall,0,0,4103,4275,8378,0,0,2887,3347,6234
19,South Sudan (UNDP),2019,SSD-19/HSS10/SA1/N/INGO/11599,11/11/2019 12:48:29 PM,Host Communities,0,1465,777,842,3084,0,1270,1135,1255,3660
19,South Sudan (UNDP),2019,SSD-19/HSS10/SA1/N/INGO/11599,11/11/2019 12:48:29 PM,Internally Displaced People,0,86,46,50,182,0,149,134,148,431
19,South Sudan (UNDP),2019,SSD-19/HSS10/SA1/N/INGO/11599,11/11/2019 12:48:29 PM,Overall,0,1723,914,991,3628,0,1494,1336,1477,4307
19,South Sudan (UNDP),2019,SSD-19/HSS10/SA1/N/INGO/11599,11/11/2019 12:48:29 PM,Returnees,0,172,91,99,362,0,75,67,74,216
19,South Sudan (UNDP),2019,SSD-19/HSS10/SA1/N/INGO/11620,12/16/2019 5:53:24 AM,Host Communities,0,0,562,578,1140,0,0,2003,2310,4313
19,South Sudan (UNDP),2019,SSD-19/HSS10/SA1/N/INGO/11620,12/16/2019 5:53:24 AM,Internally Displaced People,0,0,1685,1736,3421,0,0,0,0,0
19,South Sudan (UNDP),2019,SSD-19/HSS10/SA1/N/INGO/11620,12/16/2019 5:53:24 AM,Other,0,0,540,586,1126,0,0,0,0,0
19,South Sudan (UNDP),2019,SSD-19/HSS10/SA1/N/INGO/11620,12/16/2019 5:53:24 AM,Overall,0,0,2787,2900,5687,0,0,2003,2310,4313
19,South Sudan (UNDP),2019,SSD-19/HSS10/SA1/N/INGO/11642,11/7/2019 6:07:16 AM,Host Communities,0,1188,687,667,2542,0,412,467,503,1382
19,South Sudan (UNDP),2019,SSD-19/HSS10/SA1/N/INGO/11642,11/7/2019 6:07:16 AM,Internally Displaced People,0,297,171,166,634,0,128,67,79,274
19,South Sudan (UNDP),2019,SSD-19/HSS10/SA1/N/INGO/11642,11/7/2019 6:07:16 AM,Overall,0,1485,858,833,3176,0,540,534,582,1656
19,South Sudan (UNDP),2019,SSD-19/HSS10/SA1/N/INGO/11688,11/7/2019 8:37:17 AM,Overall,0,7346,6200,6453,19999,0,6316,4830,7192,18338
19,South Sudan (UNDP),2019,SSD-19/HSS10/SA1/N/INGO/11768,12/6/2019 7:29:18 AM,Host Communities,0,1456,1024,0,2480,0,5201,1940,2248,9389
19,South Sudan (UNDP),2019,SSD-19/HSS10/SA1/N/INGO/11768,12/6/2019 7:29:18 AM,Internally Displaced People,0,10000,2000,3000,15000,0,0,0,0,0
19,South Sudan (UNDP),2019,SSD-19/HSS10/SA1/N/INGO/11768,12/6/2019 7:29:18 AM,Overall,0,11456,3024,3276,17756,0,5201,1940,2248,9389
19,South Sudan (UNDP),2019,SSD-19/HSS10/SA1/N/NGO/11444,12/16/2019 10:28:33 AM,Children under 5,0,0,564,612,1176,0,0,3601,3566,7167
19,South Sudan (UNDP),2019,SSD-19/HSS10/SA1/N/NGO/11444,12/16/2019 10:28:33 AM,Overall,0,0,564,612,1176,0,1871,3601,3566,9038
19,South Sudan (UNDP),2019,SSD-19/HSS10/SA1/N/NGO/11444,12/16/2019 10:28:33 AM,Pregnant and Lactating Women,0,0,0,0,0,0,1871,0,0,1871
19,South Sudan (UNDP),2019,SSD-19/HSS10/SA1/N/NGO/11570,11/22/2019 5:59:25 AM,Host Communities,0,1525,2156,2964,6645,1053,5481,4760,6377,17671
19,South Sudan (UNDP),2019,SSD-19/HSS10/SA1/N/NGO/11570,11/22/2019 5:59:25 AM,Internally Displaced People,0,1525,2687,2640,6852,190,988,857,1147,3182
19,South Sudan (UNDP),2019,SSD-19/HSS10/SA1/N/NGO/11570,11/22/2019 5:59:25 AM,Overall,0,3600,5846,6746,16192,1329,6917,6007,8047,22300
19,South Sudan (UNDP),2019,SSD-19/HSS10/SA1/N/NGO/11570,11/22/2019 5:59:25 AM,Returnees,0,550,1003,1140,2693,86,448,390,523,1447
19,South Sudan (UNDP),2019,SSD-19/HSS10/SA1/N/NGO/11575,2/6/2020 10:51:16 AM,Host Communities,0,0,1854,1854,3708,174,6045,1681,1835,9735
19,South Sudan (UNDP),2019,SSD-19/HSS10/SA1/N/NGO/11575,2/6/2020 10:51:16 AM,Internally Displaced People,0,0,151,151,302,13,72,54,54,193
19,South Sudan (UNDP),2019,SSD-19/HSS10/SA1/N/NGO/11575,2/6/2020 10:51:16 AM,Overall,0,0,2054,2055,4109,210,6211,1828,1967,10216
19,South Sudan (UNDP),2019,SSD-19/HSS10/SA1/N/NGO/11575,2/6/2020 10:51:16 AM,Returnees,0,0,49,49,98,23,94,93,78,288
19,South Sudan (UNDP),2019,SSD-19/HSS10/SA1/N/NGO/11581,11/22/2019 6:34:51 AM,Host Communities,0,2924,6015,6568,15507,0,10636,471,482,11589
19,South Sudan (UNDP),2019,SSD-19/HSS10/SA1/N/NGO/11581,11/22/2019 6:34:51 AM,Internally Displaced People,0,2194,4512,4926,11632,0,7977,352,362,8691
19,South Sudan (UNDP),2019,SSD-19/HSS10/SA1/N/NGO/11581,11/22/2019 6:34:51 AM,Overall,0,7312,15039,16420,38771,0,26590,1177,1206,28973
19,South Sudan (UNDP),2019,SSD-19/HSS10/SA1/N/NGO/11581,11/22/2019 6:34:51 AM,Returnees,0,2194,4512,4926,11632,0,7977,354,362,8693
19,South Sudan (UNDP),2019,SSD-19/HSS10/SA1/N/NGO/11619,11/28/2019 7:30:08 AM,Host Communities,0,0,484,503,987,0,0,451,460,911
19,South Sudan (UNDP),2019,SSD-19/HSS10/SA1/N/NGO/11619,11/28/2019 7:30:08 AM,Overall,0,0,484,503,987,0,0,451,460,911
19,South Sudan (UNDP),2019,SSD-19/HSS10/SA1/N/NGO/11640,12/3/2019 8:32:23 AM,Host Communities,0,750,750,1800,3300,0,470,675,950,2095
19,South Sudan (UNDP),2019,SSD-19/HSS10/SA1/N/NGO/11640,12/3/2019 8:32:23 AM,Internally Displaced People,0,750,750,1700,3200,0,470,675,950,2095
19,South Sudan (UNDP),2019,SSD-19/HSS10/SA1/N/NGO/11640,12/3/2019 8:32:23 AM,Overall,0,1500,1500,3500,6500,0,1410,1350,1900,4660
19,South Sudan (UNDP),2019,SSD-19/HSS10/SA1/N/NGO/11640,12/3/2019 8:32:23 AM,Returnees,0,0,0,0,0,0,470,0,0,470
19,South Sudan (UNDP),2019,SSD-19/HSS10/SA1/N/NGO/11680,11/18/2019 1:14:11 PM,Host Communities,0,0,1000,1200,2200,6000,8120,5800,6800,26720
19,South Sudan (UNDP),2019,SSD-19/HSS10/SA1/N/NGO/11680,11/18/2019 1:14:11 PM,Internally Displaced People,0,0,200,200,400,1080,2000,1000,1100,5180
19,South Sudan (UNDP),2019,SSD-19/HSS10/SA1/N/NGO/11680,11/18/2019 1:14:11 PM,Other,0,0,111,400,511,0,0,0,0,0
19,South Sudan (UNDP),2019,SSD-19/HSS10/SA1/N/NGO/11680,11/18/2019 1:14:11 PM,Overall,0,0,1811,2200,4011,10080,13120,8124,9377,40701
19,South Sudan (UNDP),2019,SSD-19/HSS10/SA1/N/NGO/11680,11/18/2019 1:14:11 PM,Returnees,0,0,500,400,900,3000,3000,1324,1477,8801
19,South Sudan (UNDP),2019,SSD-19/HSS10/SA1/N/NGO/11749,11/20/2019 1:00:05 PM,Host Communities,0,0,956,930,1886,0,0,0,0,0
19,South Sudan (UNDP),2019,SSD-19/HSS10/SA1/N/NGO/11749,11/20/2019 1:00:05 PM,Internally Displaced People,0,0,24,28,52,0,0,898,908,1806
19,South Sudan (UNDP),2019,SSD-19/HSS10/SA1/N/NGO/11749,11/20/2019 1:00:05 PM,Overall,0,0,980,958,1938,0,0,898,908,1806
19,South Sudan (UNDP),2019,SSD-19/HSS10/SA1/N/UN/11611,2/8/2020 1:03:38 PM,Host Communities,0,0,1135,1229,2364,0,0,949,1025,1974
19,South Sudan (UNDP),2019,SSD-19/HSS10/SA1/N/UN/11611,2/8/2020 1:03:38 PM,Internally Displaced People,0,0,324,351,675,0,0,315,343,658
19,South Sudan (UNDP),2019,SSD-19/HSS10/SA1/N/UN/11611,2/8/2020 1:03:38 PM,Overall,0,0,1621,1756,3377,0,0,1515,1641,3156
19,South Sudan (UNDP),2019,SSD-19/HSS10/SA1/N/UN/11611,2/8/2020 1:03:38 PM,Returnees,0,0,162,176,338,0,0,251,273,524
19,South Sudan (UNDP),2019,SSD-19/HSS10/SA1/N/UN/11730,2/26/2020 1:56:13 PM,Host Communities,1500,7000,309,321,9130,1820,10100,256,262,12438
19,South Sudan (UNDP),2019,SSD-19/HSS10/SA1/N/UN/11730,2/26/2020 1:56:13 PM,Overall,1500,7000,309,321,9130,1820,10100,256,262,12438
19,South Sudan (UNDP),2019,SSD-19/HSS10/SA1/N/UN/11755,11/25/2021 12:21:43 PM,Overall,0,1401,2461,2666,6528,8476,31550,519,536,41081
19,South Sudan (UNDP),2019,SSD-19/HSS10/SA1/NFI/INGO/11555,11/14/2019 6:04:15 AM,Internally Displaced People,945,1350,2160,2295,6750,2110,2715,1783,2476,9084
19,South Sudan (UNDP),2019,SSD-19/HSS10/SA1/NFI/INGO/11555,11/14/2019 6:04:15 AM,Overall,2100,3000,4800,5100,15000,3851,4854,3663,4759,17127
19,South Sudan (UNDP),2019,SSD-19/HSS10/SA1/NFI/INGO/11555,11/14/2019 6:04:15 AM,Returnees,1155,1650,2640,2805,8250,1741,2139,1880,2283,8043
19,South Sudan (UNDP),2019,SSD-19/HSS10/SA1/NFI/INGO/11660,2/18/2020 6:35:01 AM,Host Communities,178,185,268,279,910,93,82,132,126,433
19,South Sudan (UNDP),2019,SSD-19/HSS10/SA1/NFI/INGO/11660,2/18/2020 6:35:01 AM,Internally Displaced People,1427,1485,2140,2228,7280,4755,7699,4588,5408,22450
19,South Sudan (UNDP),2019,SSD-19/HSS10/SA1/NFI/INGO/11660,2/18/2020 6:35:01 AM,Overall,1784,1856,2675,2785,9100,4848,7781,4720,5534,22883
19,South Sudan (UNDP),2019,SSD-19/HSS10/SA1/NFI/INGO/11660,2/18/2020 6:35:01 AM,Returnees,179,186,267,278,910,0,0,0,0,0
19,South Sudan (UNDP),2019,SSD-19/HSS10/SA1/NFI/INGO/11675,11/11/2019 11:59:29 AM,Internally Displaced People,2525,2438,1916,1829,8708,3672,3063,3463,3166,13364
19,South Sudan (UNDP),2019,SSD-19/HSS10/SA1/NFI/INGO/11675,11/11/2019 11:59:29 AM,Overall,4208,4063,3193,3048,14512,6832,6819,5909,6154,25714
19,South Sudan (UNDP),2019,SSD-19/HSS10/SA1/NFI/INGO/11675,11/11/2019 11:59:29 AM,Returnees,1683,1625,1277,1219,5804,3160,3756,2446,2988,12350
19,South Sudan (UNDP),2019,SSD-19/HSS10/SA1/NFI/INGO/11683,12/30/2019 12:20:17 PM,Host Communities,197,214,197,213,821,405,422,395,424,1646
19,South Sudan (UNDP),2019,SSD-19/HSS10/SA1/NFI/INGO/11683,12/30/2019 12:20:17 PM,Internally Displaced People,2145,2324,2145,2324,8938,1946,1823,1627,1730,7126
19,South Sudan (UNDP),2019,SSD-19/HSS10/SA1/NFI/INGO/11683,12/30/2019 12:20:17 PM,Overall,2581,2797,2581,2796,10755,3534,3537,3056,3220,13347
19,South Sudan (UNDP),2019,SSD-19/HSS10/SA1/NFI/INGO/11683,12/30/2019 12:20:17 PM,Returnees,239,259,239,259,996,1183,1292,1034,1066,4575
19,South Sudan (UNDP),2019,SSD-19/HSS10/SA1/NFI/INGO/11691,12/6/2019 7:32:07 AM,Internally Displaced People,1725,2010,2160,2285,8180,2608,2875,3318,3895,12696
19,South Sudan (UNDP),2019,SSD-19/HSS10/SA1/NFI/INGO/11691,12/6/2019 7:32:07 AM,Overall,2180,2540,2740,2890,10350,4706,5442,4939,5464,20551
19,South Sudan (UNDP),2019,SSD-19/HSS10/SA1/NFI/INGO/11691,12/6/2019 7:32:07 AM,Returnees,455,530,580,605,2170,2098,2567,1621,1569,7855
19,South Sudan (UNDP),2019,SSD-19/HSS10/SA1/NFI/INGO/11784,10/29/2019 6:27:29 AM,Host Communities,507,1014,507,507,2535,1936,1988,2866,2918,9708
19,South Sudan (UNDP),2019,SSD-19/HSS10/SA1/NFI/INGO/11784,10/29/2019 6:27:29 AM,Internally Displaced People,2366,4732,2366,2366,11830,4309,4620,2745,3431,15105
19,South Sudan (UNDP),2019,SSD-19/HSS10/SA1/NFI/INGO/11784,10/29/2019 6:27:29 AM,Overall,3380,6760,3380,3380,16900,10442,10796,13223,13333,47794
19,South Sudan (UNDP),2019,SSD-19/HSS10/SA1/NFI/INGO/11784,10/29/2019 6:27:29 AM,Returnees,507,1014,507,507,2535,4197,4188,7612,6984,22981
19,South Sudan (UNDP),2019,SSD-19/HSS10/SA1/NFI/NGO/11467,11/21/2019 11:31:56 AM,Host Communities,639,500,35,48,1222,300,377,190,177,1044
19,South Sudan (UNDP),2019,SSD-19/HSS10/SA1/NFI/NGO/11467,11/21/2019 11:31:56 AM,Internally Displaced People,1299,2569,58,99,4025,1382,1725,1180,1458,5745
19,South Sudan (UNDP),2019,SSD-19/HSS10/SA1/NFI/NGO/11467,11/21/2019 11:31:56 AM,Overall,2538,3769,129,231,6667,1966,2423,1558,1836,7783
19,South Sudan (UNDP),2019,SSD-19/HSS10/SA1/NFI/NGO/11467,11/21/2019 11:31:56 AM,Returnees,600,700,36,84,1420,284,321,188,201,994
19,South Sudan (UNDP),2019,SSD-19/HSS10/SA1/NFI/NGO/11493,11/19/2019 1:07:24 PM,Internally Displaced People,936,1248,1144,1872,5200,1896,1955,1592,1878,7321
19,South Sudan (UNDP),2019,SSD-19/HSS10/SA1/NFI/NGO/11493,11/19/2019 1:07:24 PM,Overall,936,1248,1144,1872,5200,1896,1955,1592,1878,7321
19,South Sudan (UNDP),2019,SSD-19/HSS10/SA1/NFI/NGO/11530,11/28/2019 7:21:09 AM,Host Communities,50,300,50,50,450,512,789,226,321,1848
19,South Sudan (UNDP),2019,SSD-19/HSS10/SA1/NFI/NGO/11530,11/28/2019 7:21:09 AM,Internally Displaced People,100,200,100,150,550,802,1233,348,491,2874
19,South Sudan (UNDP),2019,SSD-19/HSS10/SA1/NFI/NGO/11530,11/28/2019 7:21:09 AM,Overall,1800,2750,900,1200,6650,2161,3324,939,1328,7752
19,South Sudan (UNDP),2019,SSD-19/HSS10/SA1/NFI/NGO/11530,11/28/2019 7:21:09 AM,Returnees,1650,2250,750,1000,5650,847,1302,365,516,3030
19,South Sudan (UNDP),2019,SSD-19/HSS10/SA1/NFI/NGO/11573,12/20/2019 11:27:56 AM,Internally Displaced People,1385,2880,1815,1920,8000,2409,2050,1558,1038,7055
19,South Sudan (UNDP),2019,SSD-19/HSS10/SA1/NFI/NGO/11573,12/20/2019 11:27:56 AM,Overall,1385,2880,1815,1920,8000,2409,2925,1872,1118,8324
19,South Sudan (UNDP),2019,SSD-19/HSS10/SA1/NFI/NGO/11573,12/20/2019 11:27:56 AM,Pregnant and Lactating Women,0,0,0,0,0,0,875,314,80,1269
19,South Sudan (UNDP),2019,SSD-19/HSS10/SA1/NFI/NGO/11601,11/21/2019 10:56:52 AM,Host Communities,150,225,101,149,625,180,205,148,132,665
19,South Sudan (UNDP),2019,SSD-19/HSS10/SA1/NFI/NGO/11601,11/21/2019 10:56:52 AM,Internally Displaced People,1050,1575,707,1043,4375,1264,1434,1036,921,4655
19,South Sudan (UNDP),2019,SSD-19/HSS10/SA1/NFI/NGO/11601,11/21/2019 10:56:52 AM,Overall,1500,2250,1010,1490,6250,1805,2049,1480,1316,6650
19,South Sudan (UNDP),2019,SSD-19/HSS10/SA1/NFI/NGO/11601,11/21/2019 10:56:52 AM,Returnees,300,450,202,298,1250,361,410,296,263,1330
19,South Sudan (UNDP),2019,SSD-19/HSS10/SA1/NFI/NGO/11613,12/23/2019 5:44:17 AM,Host Communities,51,154,153,154,512,88,267,266,266,887
19,South Sudan (UNDP),2019,SSD-19/HSS10/SA1/NFI/NGO/11613,12/23/2019 5:44:17 AM,Internally Displaced People,461,1382,1382,1381,4606,799,2394,2395,2395,7983
19,South Sudan (UNDP),2019,SSD-19/HSS10/SA1/NFI/NGO/11613,12/23/2019 5:44:17 AM,Overall,618,1856,1855,1855,6184,1079,3239,3238,3238,10794
19,South Sudan (UNDP),2019,SSD-19/HSS10/SA1/NFI/NGO/11613,12/23/2019 5:44:17 AM,Returnees,106,320,320,320,1066,192,578,577,577,1924
19,South Sudan (UNDP),2019,SSD-19/HSS10/SA1/NFI/NGO/11628,11/19/2019 7:07:48 AM,Host Communities,142,358,340,269,1109,254,502,298,516,1570
19,South Sudan (UNDP),2019,SSD-19/HSS10/SA1/NFI/NGO/11628,11/19/2019 7:07:48 AM,Internally Displaced People,1082,950,580,820,3432,436,737,446,691,2310
19,South Sudan (UNDP),2019,SSD-19/HSS10/SA1/NFI/NGO/11628,11/19/2019 7:07:48 AM,Overall,1694,3351,1785,2770,9600,1694,3351,1785,2770,9600
19,South Sudan (UNDP),2019,SSD-19/HSS10/SA1/NFI/NGO/11628,11/19/2019 7:07:48 AM,Returnees,470,2043,865,1681,5059,1004,2112,1041,1563,5720
19,South Sudan (UNDP),2019,SSD-19/HSS10/SA1/NFI/UN/11724,2/8/2020 1:04:38 PM,Internally Displaced People,1498,1756,1539,1707,6500,1930,3135,3656,3645,12366
19,South Sudan (UNDP),2019,SSD-19/HSS10/SA1/NFI/UN/11724,2/8/2020 1:04:38 PM,Overall,1498,1756,1539,1707,6500,1930,3135,3656,3645,12366
19,South Sudan (UNDP),2019,SSD-19/HSS10/SA1/P/INGO/11477,11/14/2019 6:03:32 AM,Host Communities,200,300,850,850,2200,233,95,1183,1618,3129
19,South Sudan (UNDP),2019,SSD-19/HSS10/SA1/P/INGO/11477,11/14/2019 6:03:32 AM,Internally Displaced People,300,500,1800,1900,4500,325,610,2200,2400,5535
19,South Sudan (UNDP),2019,SSD-19/HSS10/SA1/P/INGO/11477,11/14/2019 6:03:32 AM,Overall,600,800,3000,3000,7400,558,705,3383,4018,8664
19,South Sudan (UNDP),2019,SSD-19/HSS10/SA1/P/INGO/11496,11/11/2019 12:16:30 PM,Host Communities,300,1152,295,653,2400,1045,2756,869,1540,6210
19,South Sudan (UNDP),2019,SSD-19/HSS10/SA1/P/INGO/11496,11/11/2019 12:16:30 PM,Internally Displaced People,800,2000,300,1000,4100,804,2306,729,1235,5074
19,South Sudan (UNDP),2019,SSD-19/HSS10/SA1/P/INGO/11496,11/11/2019 12:16:30 PM,Overall,1100,3152,595,1653,6500,1849,5062,1598,2775,11284
19,South Sudan (UNDP),2019,SSD-19/HSS10/SA1/P/INGO/11501,1/21/2020 8:12:54 AM,Host Communities,781,737,1431,1388,4337,2654,2442,9913,7352,22361
19,South Sudan (UNDP),2019,SSD-19/HSS10/SA1/P/INGO/11501,1/21/2020 8:12:54 AM,Internally Displaced People,92,92,184,173,541,518,57,342,428,1345
19,South Sudan (UNDP),2019,SSD-19/HSS10/SA1/P/INGO/11501,1/21/2020 8:12:54 AM,Overall,965,921,1799,1734,5419,3236,2873,11394,8549,26052
19,South Sudan (UNDP),2019,SSD-19/HSS10/SA1/P/INGO/11501,1/21/2020 8:12:54 AM,Returnees,92,92,184,173,541,64,374,1139,769,2346
19,South Sudan (UNDP),2019,SSD-19/HSS10/SA1/P/INGO/11524,10/30/2019 8:16:08 AM,Host Communities,0,0,33,27,60,64,115,45,50,274
19,South Sudan (UNDP),2019,SSD-19/HSS10/SA1/P/INGO/11524,10/30/2019 8:16:08 AM,Internally Displaced People,353,447,297,243,1340,579,1040,406,453,2478
19,South Sudan (UNDP),2019,SSD-19/HSS10/SA1/P/INGO/11524,10/30/2019 8:16:08 AM,Overall,353,447,330,270,1400,643,1155,451,503,2752
19,South Sudan (UNDP),2019,SSD-19/HSS10/SA1/P/INGO/11558,10/30/2019 11:25:36 AM,Host Communities,0,0,0,0,0,3114,2935,3596,3047,12692
19,South Sudan (UNDP),2019,SSD-19/HSS10/SA1/P/INGO/11558,10/30/2019 11:25:36 AM,Internally Displaced People,0,0,0,0,0,584,550,674,571,2379
19,South Sudan (UNDP),2019,SSD-19/HSS10/SA1/P/INGO/11558,10/30/2019 11:25:36 AM,Overall,2200,2157,2445,2217,9019,3893,3668,4495,3808,15864
19,South Sudan (UNDP),2019,SSD-19/HSS10/SA1/P/INGO/11558,10/30/2019 11:25:36 AM,Returnees,0,0,0,0,0,195,183,225,190,793
19,South Sudan (UNDP),2019,SSD-19/HSS10/SA1/P/INGO/11571,11/5/2019 10:49:02 AM,Host Communities,2275,2465,605,655,6000,3507,4790,1336,2476,12109
19,South Sudan (UNDP),2019,SSD-19/HSS10/SA1/P/INGO/11571,11/5/2019 10:49:02 AM,Internally Displaced People,1517,1643,403,437,4000,1170,1597,444,825,4036
19,South Sudan (UNDP),2019,SSD-19/HSS10/SA1/P/INGO/11571,11/5/2019 10:49:02 AM,Overall,3792,4108,1008,1092,10000,4677,6387,1780,3301,16145
19,South Sudan (UNDP),2019,SSD-19/HSS10/SA1/P/INGO/11572,11/6/2019 12:51:17 PM,Host Communities,902,859,956,853,3570,1064,889,1243,952,4148
19,South Sudan (UNDP),2019,SSD-19/HSS10/SA1/P/INGO/11572,11/6/2019 12:51:17 PM,Internally Displaced People,120,160,150,150,580,87,134,125,104,450
19,South Sudan (UNDP),2019,SSD-19/HSS10/SA1/P/INGO/11572,11/6/2019 12:51:17 PM,Overall,1022,1019,1106,1003,4150,1151,1023,1368,1056,4598
19,South Sudan (UNDP),2019,SSD-19/HSS10/SA1/P/INGO/11595,11/18/2019 9:06:17 AM,Host Communities,150,300,150,107,707,230,1909,136,583,2858
19,South Sudan (UNDP),2019,SSD-19/HSS10/SA1/P/INGO/11595,11/18/2019 9:06:17 AM,Internally Displaced People,312,2564,312,1783,4971,334,3120,206,2143,5803
19,South Sudan (UNDP),2019,SSD-19/HSS10/SA1/P/INGO/11595,11/18/2019 9:06:17 AM,Overall,462,2864,462,1890,5678,564,5029,342,2726,8661
19,South Sudan (UNDP),2019,SSD-19/HSS10/SA1/P/INGO/11604,11/15/2019 2:31:33 PM,Host Communities,700,592,117,118,1527,343,320,65,72,800
19,South Sudan (UNDP),2019,SSD-19/HSS10/SA1/P/INGO/11604,11/15/2019 2:31:33 PM,Internally Displaced People,1250,2228,800,800,5078,611,1235,443,418,2707
19,South Sudan (UNDP),2019,SSD-19/HSS10/SA1/P/INGO/11604,11/15/2019 2:31:33 PM,Overall,1950,2820,917,918,6605,954,1555,508,490,3507
19,South Sudan (UNDP),2019,SSD-19/HSS10/SA1/P/INGO/11627,11/18/2019 10:23:50 AM,Host Communities,1600,3360,800,2240,8000,734,3434,962,1837,6967
19,South Sudan (UNDP),2019,SSD-19/HSS10/SA1/P/INGO/11627,11/18/2019 10:23:50 AM,Internally Displaced People,400,840,200,560,2000,314,1472,412,787,2985
19,South Sudan (UNDP),2019,SSD-19/HSS10/SA1/P/INGO/11627,11/18/2019 10:23:50 AM,Overall,2000,4200,1000,2800,10000,1048,4906,1374,2624,9952
19,South Sudan (UNDP),2019,SSD-19/HSS10/SA1/P/INGO/11658,11/6/2019 12:07:24 PM,Internally Displaced People,330,810,330,330,1800,653,690,89,68,1500
19,South Sudan (UNDP),2019,SSD-19/HSS10/SA1/P/INGO/11658,11/6/2019 12:07:24 PM,Overall,330,810,330,330,1800,653,690,89,68,1500
19,South Sudan (UNDP),2019,SSD-19/HSS10/SA1/P/INGO/11686,2/11/2020 7:55:51 AM,Host Communities,126,213,65,54,458,256,229,3,8,496
19,South Sudan (UNDP),2019,SSD-19/HSS10/SA1/P/INGO/11686,2/11/2020 7:55:51 AM,Internally Displaced People,375,649,198,168,1390,225,469,14,13,721
19,South Sudan (UNDP),2019,SSD-19/HSS10/SA1/P/INGO/11686,2/11/2020 7:55:51 AM,Overall,627,1075,328,276,2306,918,1062,24,33,2037
19,South Sudan (UNDP),2019,SSD-19/HSS10/SA1/P/INGO/11686,2/11/2020 7:55:51 AM,Returnees,126,213,65,54,458,437,364,7,12,820
19,South Sudan (UNDP),2019,SSD-19/HSS10/SA1/P/INGO/11721,3/13/2020 6:36:24 PM,Overall,2000,2500,3000,3000,10500,1200,1590,1715,2300,6805
19,South Sudan (UNDP),2019,SSD-19/HSS10/SA1/P/INGO/11723,11/6/2019 10:51:02 AM,Host Communities,600,1500,600,1200,3900,1280,4749,371,800,7200
19,South Sudan (UNDP),2019,SSD-19/HSS10/SA1/P/INGO/11723,11/6/2019 10:51:02 AM,Internally Displaced People,300,750,300,600,1950,260,600,80,400,1340
19,South Sudan (UNDP),2019,SSD-19/HSS10/SA1/P/INGO/11723,11/6/2019 10:51:02 AM,Overall,1000,2500,1000,2000,6500,1632,5549,531,1376,9088
19,South Sudan (UNDP),2019,SSD-19/HSS10/SA1/P/INGO/11723,11/6/2019 10:51:02 AM,Returnees,100,250,100,200,650,92,200,80,176,548
19,South Sudan (UNDP),2019,SSD-19/HSS10/SA1/P/INGO/11725,11/15/2019 2:44:51 PM,Host Communities,586,886,200,200,1872,2020,2843,701,758,6322
19,South Sudan (UNDP),2019,SSD-19/HSS10/SA1/P/INGO/11725,11/15/2019 2:44:51 PM,Internally Displaced People,3000,4000,1000,1000,9000,2023,2843,689,758,6313
19,South Sudan (UNDP),2019,SSD-19/HSS10/SA1/P/INGO/11725,11/15/2019 2:44:51 PM,Overall,3586,4886,1200,1200,10872,4043,5686,1390,1516,12635
19,South Sudan (UNDP),2019,SSD-19/HSS10/SA1/P/INGO/11734,6/30/2020 8:00:18 PM,Host Communities,441,1101,338,1000,2880,1797,8919,2574,7322,20612
19,South Sudan (UNDP),2019,SSD-19/HSS10/SA1/P/INGO/11734,6/30/2020 8:00:18 PM,Internally Displaced People,600,2838,1200,2000,6638,0,0,0,0,0
19,South Sudan (UNDP),2019,SSD-19/HSS10/SA1/P/INGO/11734,6/30/2020 8:00:18 PM,Overall,1141,4139,1599,3103,9982,1797,8919,2574,7322,20612
19,South Sudan (UNDP),2019,SSD-19/HSS10/SA1/P/INGO/11734,6/30/2020 8:00:18 PM,Returnees,100,200,61,103,464,0,0,0,0,0
19,South Sudan (UNDP),2019,SSD-19/HSS10/SA1/P/INGO/11767,11/14/2019 11:01:25 AM,Host Communities,364,729,364,364,1821,692,2382,920,938,4932
19,South Sudan (UNDP),2019,SSD-19/HSS10/SA1/P/INGO/11767,11/14/2019 11:01:25 AM,Internally Displaced People,1093,2185,1093,1093,5464,692,2382,919,920,4913
19,South Sudan (UNDP),2019,SSD-19/HSS10/SA1/P/INGO/11767,11/14/2019 11:01:25 AM,Overall,1457,2914,1457,1457,7285,1384,4764,1839,1858,9845
19,South Sudan (UNDP),2019,SSD-19/HSS10/SA1/P/NGO/11437,11/22/2019 11:46:57 AM,Internally Displaced People,1300,3000,900,2000,7200,3000,3800,1800,3400,12000
19,South Sudan (UNDP),2019,SSD-19/HSS10/SA1/P/NGO/11437,11/22/2019 11:46:57 AM,Overall,3000,3800,1800,3400,12000,3000,3800,1800,3400,12000
19,South Sudan (UNDP),2019,SSD-19/HSS10/SA1/P/NGO/11460,11/20/2019 8:22:22 AM,Host Communities,650,1000,1700,1600,4950,873,1273,1771,1848,5765
19,South Sudan (UNDP),2019,SSD-19/HSS10/SA1/P/NGO/11460,11/20/2019 8:22:22 AM,Internally Displaced People,500,800,1500,1600,4400,690,1007,1400,1461,4558
19,South Sudan (UNDP),2019,SSD-19/HSS10/SA1/P/NGO/11460,11/20/2019 8:22:22 AM,Other,200,200,150,150,700,264,385,535,568,1752
19,South Sudan (UNDP),2019,SSD-19/HSS10/SA1/P/NGO/11460,11/20/2019 8:22:22 AM,Overall,1500,2200,3400,3500,10600,2030,2961,4118,4296,13405
19,South Sudan (UNDP),2019,SSD-19/HSS10/SA1/P/NGO/11460,11/20/2019 8:22:22 AM,"Trainers, Promoters, Caretakers, committee members, etc.",150,200,50,50,450,203,296,412,419,1330
19,South Sudan (UNDP),2019,SSD-19/HSS10/SA1/P/NGO/11463,2/11/2020 8:00:56 AM,Aid Agencies,50,50,0,0,100,0,0,0,0,0
19,South Sudan (UNDP),2019,SSD-19/HSS10/SA1/P/NGO/11463,2/11/2020 8:00:56 AM,Host Communities,3200,3100,3500,3500,13300,7904,12095,10845,9969,40813
19,South Sudan (UNDP),2019,SSD-19/HSS10/SA1/P/NGO/11463,2/11/2020 8:00:56 AM,Internally Displaced People,1500,1700,1800,2000,7000,746,694,616,828,2884
19,South Sudan (UNDP),2019,SSD-19/HSS10/SA1/P/NGO/11463,2/11/2020 8:00:56 AM,Overall,6800,7000,7300,7500,28600,9180,13587,12396,11941,47104
19,South Sudan (UNDP),2019,SSD-19/HSS10/SA1/P/NGO/11463,2/11/2020 8:00:56 AM,Returnees,2050,2150,2000,2000,8200,530,798,935,1144,3407
19,South Sudan (UNDP),2019,SSD-19/HSS10/SA1/P/NGO/11500,11/22/2019 6:44:11 AM,Host Communities,155,926,155,308,1544,155,926,155,308,1544
19,South Sudan (UNDP),2019,SSD-19/HSS10/SA1/P/NGO/11500,11/22/2019 6:44:11 AM,Internally Displaced People,360,2162,360,721,3603,360,2162,360,721,3603
19,South Sudan (UNDP),2019,SSD-19/HSS10/SA1/P/NGO/11500,11/22/2019 6:44:11 AM,Overall,515,3088,515,1029,5147,515,3088,515,1029,5147
19,South Sudan (UNDP),2019,SSD-19/HSS10/SA1/P/NGO/11523,11/22/2019 9:21:01 AM,Host Communities,800,1100,800,1000,3700,633,902,243,882,2660
19,South Sudan (UNDP),2019,SSD-19/HSS10/SA1/P/NGO/11523,11/22/2019 9:21:01 AM,Internally Displaced People,300,800,200,600,1900,141,724,181,422,1468
19,South Sudan (UNDP),2019,SSD-19/HSS10/SA1/P/NGO/11523,11/22/2019 9:21:01 AM,Overall,1400,2600,1200,2300,7500,1055,2432,643,1944,6074
19,South Sudan (UNDP),2019,SSD-19/HSS10/SA1/P/NGO/11523,11/22/2019 9:21:01 AM,Returnees,300,700,200,700,1900,281,806,219,640,1946
19,South Sudan (UNDP),2019,SSD-19/HSS10/SA1/P/NGO/11550,2/6/2020 1:06:24 PM,Host Communities,220,850,350,490,1910,678,936,695,856,3165
19,South Sudan (UNDP),2019,SSD-19/HSS10/SA1/P/NGO/11550,2/6/2020 1:06:24 PM,Internally Displaced People,450,1600,550,700,3300,786,1783,635,900,4104
19,South Sudan (UNDP),2019,SSD-19/HSS10/SA1/P/NGO/11550,2/6/2020 1:06:24 PM,Overall,820,2700,1080,1400,6000,1741,3037,1509,2014,8301
19,South Sudan (UNDP),2019,SSD-19/HSS10/SA1/P/NGO/11550,2/6/2020 1:06:24 PM,Returnees,150,250,180,210,790,277,318,179,258,1032
19,South Sudan (UNDP),2019,SSD-19/HSS10/SA1/P/NGO/11553,11/20/2019 5:58:40 AM,Host Communities,489,411,552,648,2100,657,673,925,784,3039
19,South Sudan (UNDP),2019,SSD-19/HSS10/SA1/P/NGO/11553,11/20/2019 5:58:40 AM,Internally Displaced People,1141,959,1288,1512,4900,985,1009,1387,1176,4557
19,South Sudan (UNDP),2019,SSD-19/HSS10/SA1/P/NGO/11553,11/20/2019 5:58:40 AM,Overall,1630,1370,1840,2160,7000,1642,1682,2312,1960,7596
19,South Sudan (UNDP),2019,SSD-19/HSS10/SA1/P/NGO/11557,12/3/2019 11:10:56 AM,Host Communities,600,600,1200,1200,3600,453,430,1066,1056,3005
19,South Sudan (UNDP),2019,SSD-19/HSS10/SA1/P/NGO/11557,12/3/2019 11:10:56 AM,Internally Displaced People,500,500,950,950,2900,430,439,1071,1016,2956
19,South Sudan (UNDP),2019,SSD-19/HSS10/SA1/P/NGO/11557,12/3/2019 11:10:56 AM,Overall,1500,1500,3000,3000,9000,1848,1756,3268,3136,10008
19,South Sudan (UNDP),2019,SSD-19/HSS10/SA1/P/NGO/11557,12/3/2019 11:10:56 AM,Returnees,300,300,800,800,2200,489,455,1131,1064,3139
19,South Sudan (UNDP),2019,SSD-19/HSS10/SA1/P/NGO/11557,12/3/2019 11:10:56 AM,"Trainers, Promoters, Caretakers, committee members, etc.",100,100,50,50,300,476,432,0,0,908
19,South Sudan (UNDP),2019,SSD-19/HSS10/SA1/P/NGO/11623,6/1/2020 5:02:29 PM,Host Communities,815,965,443,499,2722,407,830,265,312,1814
19,South Sudan (UNDP),2019,SSD-19/HSS10/SA1/P/NGO/11623,6/1/2020 5:02:29 PM,Internally Displaced People,850,978,500,500,2828,420,603,202,205,1430
19,South Sudan (UNDP),2019,SSD-19/HSS10/SA1/P/NGO/11623,6/1/2020 5:02:29 PM,Overall,1665,1943,943,999,5550,827,1433,467,517,3244
19,South Sudan (UNDP),2019,SSD-19/HSS10/SA1/P/NGO/11631,11/19/2019 10:47:05 AM,Host Communities,130,270,690,690,1780,248,504,644,654,2050
19,South Sudan (UNDP),2019,SSD-19/HSS10/SA1/P/NGO/11631,11/19/2019 10:47:05 AM,Internally Displaced People,300,530,1400,1400,3630,371,759,967,982,3079
19,South Sudan (UNDP),2019,SSD-19/HSS10/SA1/P/NGO/11631,11/19/2019 10:47:05 AM,Overall,430,800,2090,2090,5410,619,1263,1611,1636,5129
19,South Sudan (UNDP),2019,SSD-19/HSS10/SA1/P/NGO/11634,1/3/2020 11:32:58 AM,Host Communities,1600,2700,4300,4200,12800,1223,1951,2649,2664,8487
19,South Sudan (UNDP),2019,SSD-19/HSS10/SA1/P/NGO/11634,1/3/2020 11:32:58 AM,Internally Displaced People,570,1930,2580,2660,7740,1088,1779,2433,2470,7770
19,South Sudan (UNDP),2019,SSD-19/HSS10/SA1/P/NGO/11634,1/3/2020 11:32:58 AM,Other,80,80,0,0,160,816,1461,1772,1880,5929
19,South Sudan (UNDP),2019,SSD-19/HSS10/SA1/P/NGO/11634,1/3/2020 11:32:58 AM,Overall,2250,4710,6880,6860,20700,3127,5191,6854,7014,22186
19,South Sudan (UNDP),2019,SSD-19/HSS10/SA1/P/NGO/11682,11/19/2019 11:34:51 AM,Host Communities,54,1670,43,991,2758,358,1470,205,983,3016
19,South Sudan (UNDP),2019,SSD-19/HSS10/SA1/P/NGO/11682,11/19/2019 11:34:51 AM,Internally Displaced People,49,719,26,354,1148,225,851,184,522,1782
19,South Sudan (UNDP),2019,SSD-19/HSS10/SA1/P/NGO/11682,11/19/2019 11:34:51 AM,Other,15,39,10,20,84,0,0,0,0,0
19,South Sudan (UNDP),2019,SSD-19/HSS10/SA1/P/NGO/11682,11/19/2019 11:34:51 AM,Overall,156,2524,104,1416,4200,787,2896,541,1973,6197
19,South Sudan (UNDP),2019,SSD-19/HSS10/SA1/P/NGO/11682,11/19/2019 11:34:51 AM,Returnees,38,96,25,51,210,204,575,152,468,1399
19,South Sudan (UNDP),2019,SSD-19/HSS10/SA1/P/NGO/11699,11/22/2019 6:53:27 AM,Host Communities,227,1540,100,500,2367,190,1504,190,800,2684
19,South Sudan (UNDP),2019,SSD-19/HSS10/SA1/P/NGO/11699,11/22/2019 6:53:27 AM,Internally Displaced People,400,2350,350,725,3825,443,2220,250,1000,3913
19,South Sudan (UNDP),2019,SSD-19/HSS10/SA1/P/NGO/11699,11/22/2019 6:53:27 AM,Other,148,400,50,300,898,130,643,130,164,1067
19,South Sudan (UNDP),2019,SSD-19/HSS10/SA1/P/NGO/11699,11/22/2019 6:53:27 AM,Overall,775,4290,500,1525,7090,763,4367,570,1964,7664
19,South Sudan (UNDP),2019,SSD-19/HSS10/SA1/P/NGO/11746,11/18/2019 12:24:33 PM,Host Communities,50,500,0,100,650,50,550,0,100,700
19,South Sudan (UNDP),2019,SSD-19/HSS10/SA1/P/NGO/11746,11/18/2019 12:24:33 PM,Internally Displaced People,100,650,150,400,1300,100,700,98,432,1330
19,South Sudan (UNDP),2019,SSD-19/HSS10/SA1/P/NGO/11746,11/18/2019 12:24:33 PM,Other,50,50,0,0,100,50,50,0,0,100
19,South Sudan (UNDP),2019,SSD-19/HSS10/SA1/P/NGO/11746,11/18/2019 12:24:33 PM,Overall,300,1800,300,1000,3400,250,1700,198,852,3000
19,South Sudan (UNDP),2019,SSD-19/HSS10/SA1/P/NGO/11746,11/18/2019 12:24:33 PM,Returnees,100,600,150,500,1350,50,400,100,320,870
19,South Sudan (UNDP),2019,SSD-19/HSS10/SA1/P/UN/11563,10/14/2020 6:35:29 PM,Host Communities,1058,1193,2115,2385,6751,3427,7856,3983,2573,17839
19,South Sudan (UNDP),2019,SSD-19/HSS10/SA1/P/UN/11563,10/14/2020 6:35:29 PM,Internally Displaced People,2467,2782,4935,5565,15749,7997,18328,9319,6029,41673
19,South Sudan (UNDP),2019,SSD-19/HSS10/SA1/P/UN/11563,10/14/2020 6:35:29 PM,Overall,3525,3975,7050,7950,22500,11424,26184,13302,8602,59512
19,South Sudan (UNDP),2019,SSD-19/HSS10/SA1/WASH/INGO/11560,11/7/2019 5:34:33 AM,Host Communities,94,632,164,206,1096,0,0,0,0,0
19,South Sudan (UNDP),2019,SSD-19/HSS10/SA1/WASH/INGO/11560,11/7/2019 5:34:33 AM,Internally Displaced People,846,5688,1476,1854,9864,1768,5674,2472,2446,12360
19,South Sudan (UNDP),2019,SSD-19/HSS10/SA1/WASH/INGO/11560,11/7/2019 5:34:33 AM,Overall,940,6320,1640,2060,10960,1768,5674,2472,2446,12360
19,South Sudan (UNDP),2019,SSD-19/HSS10/SA1/WASH/INGO/11600,11/6/2019 7:07:27 AM,Host Communities,5076,5500,5500,5956,22032,2747,19130,3699,4342,29918
19,South Sudan (UNDP),2019,SSD-19/HSS10/SA1/WASH/INGO/11600,11/6/2019 7:07:27 AM,Internally Displaced People,299,323,323,351,1296,0,0,0,0,0
19,South Sudan (UNDP),2019,SSD-19/HSS10/SA1/WASH/INGO/11600,11/6/2019 7:07:27 AM,Overall,5972,6470,6470,7008,25920,2747,19130,3699,4342,29918
19,South Sudan (UNDP),2019,SSD-19/HSS10/SA1/WASH/INGO/11600,11/6/2019 7:07:27 AM,Returnees,597,647,647,701,2592,0,0,0,0,0
19,South Sudan (UNDP),2019,SSD-19/HSS10/SA1/WASH/INGO/11617,1/21/2020 7:30:13 AM,Host Communities,2234,2979,2554,2873,10640,2234,2979,2554,2873,10640
19,South Sudan (UNDP),2019,SSD-19/HSS10/SA1/WASH/INGO/11617,1/21/2020 7:30:13 AM,Internally Displaced People,559,745,638,718,2660,559,745,638,718,2660
19,South Sudan (UNDP),2019,SSD-19/HSS10/SA1/WASH/INGO/11617,1/21/2020 7:30:13 AM,Overall,2793,3724,3192,3591,13300,2793,3724,3192,3591,13300
19,South Sudan (UNDP),2019,SSD-19/HSS10/SA1/WASH/INGO/11630,2/5/2020 11:31:29 AM,Host Communities,1000,1250,1000,1250,4500,175,365,438,482,1460
19,South Sudan (UNDP),2019,SSD-19/HSS10/SA1/WASH/INGO/11630,2/5/2020 11:31:29 AM,Internally Displaced People,1000,1250,1000,1250,4500,917,1910,2292,2521,7640
19,South Sudan (UNDP),2019,SSD-19/HSS10/SA1/WASH/INGO/11630,2/5/2020 11:31:29 AM,Overall,2000,2500,2000,2500,9000,1092,2275,2730,3003,9100
19,South Sudan (UNDP),2019,SSD-19/HSS10/SA1/WASH/INGO/11639,11/1/2019 6:22:09 AM,Host Communities,278,348,366,508,1500,278,512,516,488,1794
19,South Sudan (UNDP),2019,SSD-19/HSS10/SA1/WASH/INGO/11639,11/1/2019 6:22:09 AM,Internally Displaced People,1004,1392,1516,2088,6000,926,1200,1666,1988,5780
19,South Sudan (UNDP),2019,SSD-19/HSS10/SA1/WASH/INGO/11639,11/1/2019 6:22:09 AM,Overall,1778,2436,2646,3640,10500,1700,2514,2966,3320,10500
19,South Sudan (UNDP),2019,SSD-19/HSS10/SA1/WASH/INGO/11639,11/1/2019 6:22:09 AM,Returnees,496,696,764,1044,3000,496,802,784,844,2926
19,South Sudan (UNDP),2019,SSD-19/HSS10/SA1/WASH/INGO/11748,10/22/2019 9:21:58 AM,Host Communities,238,266,448,448,1400,1122,1254,2112,2112,6600
19,South Sudan (UNDP),2019,SSD-19/HSS10/SA1/WASH/INGO/11748,10/22/2019 9:21:58 AM,Internally Displaced People,816,912,1536,1536,4800,918,1026,1728,1728,5400
19,South Sudan (UNDP),2019,SSD-19/HSS10/SA1/WASH/INGO/11748,10/22/2019 9:21:58 AM,Overall,1700,1900,3200,3200,10000,2615,2923,4924,4924,15386
19,South Sudan (UNDP),2019,SSD-19/HSS10/SA1/WASH/INGO/11748,10/22/2019 9:21:58 AM,Returnees,646,722,1216,1216,3800,575,643,1084,1084,3386
19,South Sudan (UNDP),2019,SSD-19/HSS10/SA1/WASH/INGO/11763,11/16/2019 5:49:04 PM,Host Communities,3542,3837,8264,8952,24595,3803,4201,6614,6259,20877
19,South Sudan (UNDP),2019,SSD-19/HSS10/SA1/WASH/INGO/11763,11/16/2019 5:49:04 PM,Internally Displaced People,417,451,972,1053,2893,1630,1801,2835,2683,8949
19,South Sudan (UNDP),2019,SSD-19/HSS10/SA1/WASH/INGO/11763,11/16/2019 5:49:04 PM,Overall,4167,4514,9722,10532,28935,5433,6002,9449,8942,29826
19,South Sudan (UNDP),2019,SSD-19/HSS10/SA1/WASH/INGO/11763,11/16/2019 5:49:04 PM,Returnees,208,226,486,527,1447,0,0,0,0,0
19,South Sudan (UNDP),2019,SSD-19/HSS10/SA1/WASH/NGO/11443,2/6/2020 1:08:48 PM,Host Communities,2040,3480,2760,4539,12819,2245,3474,4130,5150,14999
19,South Sudan (UNDP),2019,SSD-19/HSS10/SA1/WASH/NGO/11443,2/6/2020 1:08:48 PM,Internally Displaced People,680,1160,920,1513,4273,1330,2262,2385,2238,8215
19,South Sudan (UNDP),2019,SSD-19/HSS10/SA1/WASH/NGO/11443,2/6/2020 1:08:48 PM,Overall,3400,5800,4600,7565,21365,4156,7315,8286,8607,28364
19,South Sudan (UNDP),2019,SSD-19/HSS10/SA1/WASH/NGO/11443,2/6/2020 1:08:48 PM,Returnees,680,1160,920,1513,4273,581,1579,1771,1219,5150
19,South Sudan (UNDP),2019,SSD-19/HSS10/SA1/WASH/NGO/11453,11/25/2019 7:16:21 AM,Host Communities,1645,2056,1891,2632,8224,4071,5174,4286,4905,18436
19,South Sudan (UNDP),2019,SSD-19/HSS10/SA1/WASH/NGO/11453,11/25/2019 7:16:21 AM,Internally Displaced People,1855,2319,2134,2968,9276,4775,6070,5029,5756,21630
19,South Sudan (UNDP),2019,SSD-19/HSS10/SA1/WASH/NGO/11453,11/25/2019 7:16:21 AM,Overall,3500,4375,4025,5600,17500,8846,11244,9315,10661,40066
19,South Sudan (UNDP),2019,SSD-19/HSS10/SA1/WASH/NGO/11489,11/4/2019 8:52:42 AM,Host Communities,1000,3000,1000,3700,8700,2272,1983,2428,2498,9181
19,South Sudan (UNDP),2019,SSD-19/HSS10/SA1/WASH/NGO/11489,11/4/2019 8:52:42 AM,Internally Displaced People,1500,5000,1800,4000,12300,3409,2975,3266,3282,12932
19,South Sudan (UNDP),2019,SSD-19/HSS10/SA1/WASH/NGO/11489,11/4/2019 8:52:42 AM,Overall,2500,8000,2800,7700,21000,5681,4958,5694,5780,22113
19,South Sudan (UNDP),2019,SSD-19/HSS10/SA1/WASH/NGO/11490,9/17/2019 1:57:56 PM,Children under 5,0,0,100,150,250,0,0,100,150,250
19,South Sudan (UNDP),2019,SSD-19/HSS10/SA1/WASH/NGO/11490,9/17/2019 1:57:56 PM,Host Communities,1697,1698,1339,1697,6431,800,1600,1120,1456,4976
19,South Sudan (UNDP),2019,SSD-19/HSS10/SA1/WASH/NGO/11490,9/17/2019 1:57:56 PM,Internally Displaced People,800,1000,500,700,3000,1400,2800,1960,2550,8710
19,South Sudan (UNDP),2019,SSD-19/HSS10/SA1/WASH/NGO/11490,9/17/2019 1:57:56 PM,Overall,2909,4363,1939,2909,12120,2500,5000,3600,4702,15802
19,South Sudan (UNDP),2019,SSD-19/HSS10/SA1/WASH/NGO/11490,9/17/2019 1:57:56 PM,Returnees,412,1665,0,362,2439,300,600,420,546,1866
19,South Sudan (UNDP),2019,SSD-19/HSS10/SA1/WASH/NGO/11502,2/7/2020 12:37:00 PM,Host Communities,350,1700,1000,1800,4850,350,1700,1000,1800,4850
19,South Sudan (UNDP),2019,SSD-19/HSS10/SA1/WASH/NGO/11502,2/7/2020 12:37:00 PM,Internally Displaced People,650,1800,2000,2700,7150,1273,4386,7115,2663,15437
19,South Sudan (UNDP),2019,SSD-19/HSS10/SA1/WASH/NGO/11502,2/7/2020 12:37:00 PM,Overall,1000,3500,3000,4500,12000,1623,6086,8115,4463,20287
19,South Sudan (UNDP),2019,SSD-19/HSS10/SA1/WASH/NGO/11507,11/4/2019 8:57:55 AM,Host Communities,340,400,600,660,2000,482,573,688,692,2435
19,South Sudan (UNDP),2019,SSD-19/HSS10/SA1/WASH/NGO/11507,11/4/2019 8:57:55 AM,Internally Displaced People,1190,1400,2100,2310,7000,1340,2241,2216,2185,7982
19,South Sudan (UNDP),2019,SSD-19/HSS10/SA1/WASH/NGO/11507,11/4/2019 8:57:55 AM,Other,0,0,0,0,0,309,323,31,49,712
19,South Sudan (UNDP),2019,SSD-19/HSS10/SA1/WASH/NGO/11507,11/4/2019 8:57:55 AM,Overall,1700,2000,3000,3300,10000,2643,3810,3536,3550,13539
19,South Sudan (UNDP),2019,SSD-19/HSS10/SA1/WASH/NGO/11507,11/4/2019 8:57:55 AM,Returnees,170,200,300,330,1000,512,673,601,624,2410
19,South Sudan (UNDP),2019,SSD-19/HSS10/SA1/WASH/NGO/11510,11/4/2019 1:56:07 PM,Host Communities,686,768,1292,1292,4038,7095,4888,3712,2901,18596
19,South Sudan (UNDP),2019,SSD-19/HSS10/SA1/WASH/NGO/11510,11/4/2019 1:56:07 PM,Internally Displaced People,506,565,952,952,2975,0,0,0,0,0
19,South Sudan (UNDP),2019,SSD-19/HSS10/SA1/WASH/NGO/11510,11/4/2019 1:56:07 PM,Overall,1445,1615,2720,2720,8500,7095,4888,3712,2901,18596
19,South Sudan (UNDP),2019,SSD-19/HSS10/SA1/WASH/NGO/11510,11/4/2019 1:56:07 PM,Returnees,253,282,476,476,1487,0,0,0,0,0
19,South Sudan (UNDP),2019,SSD-19/HSS10/SA1/WASH/NGO/11552,11/4/2019 9:22:59 AM,Children under 5,0,0,1730,3670,5400,0,0,510,682,1192
19,South Sudan (UNDP),2019,SSD-19/HSS10/SA1/WASH/NGO/11552,11/4/2019 9:22:59 AM,Host Communities,2550,6160,0,0,8710,3843,9434,1622,3388,18287
19,South Sudan (UNDP),2019,SSD-19/HSS10/SA1/WASH/NGO/11552,11/4/2019 9:22:59 AM,Overall,2700,7850,1730,3670,15950,3945,10986,2132,4070,21133
19,South Sudan (UNDP),2019,SSD-19/HSS10/SA1/WASH/NGO/11552,11/4/2019 9:22:59 AM,Pregnant and Lactating Women,0,1540,0,0,1540,0,491,0,0,491
19,South Sudan (UNDP),2019,SSD-19/HSS10/SA1/WASH/NGO/11552,11/4/2019 9:22:59 AM,"Trainers, Promoters, Caretakers, committee members, etc.",150,150,0,0,300,102,1061,0,0,1163
19,South Sudan (UNDP),2019,SSD-19/HSS10/SA1/WASH/NGO/11569,11/19/2019 7:00:32 AM,Host Communities,1350,2050,1750,1550,6700,2558,3362,2840,3081,11841
19,South Sudan (UNDP),2019,SSD-19/HSS10/SA1/WASH/NGO/11569,11/19/2019 7:00:32 AM,Internally Displaced People,1250,1650,1650,1950,6500,450,1451,1110,2076,5087
19,South Sudan (UNDP),2019,SSD-19/HSS10/SA1/WASH/NGO/11569,11/19/2019 7:00:32 AM,Overall,2950,4750,3950,4850,16500,3077,4890,3995,5224,17186
19,South Sudan (UNDP),2019,SSD-19/HSS10/SA1/WASH/NGO/11569,11/19/2019 7:00:32 AM,Returnees,350,1050,550,1350,3300,69,77,45,67,258
19,South Sudan (UNDP),2019,SSD-19/HSS10/SA1/WASH/NGO/11580,11/19/2019 1:50:11 PM,Host Communities,900,900,1050,1137,3987,156,156,176,196,684
19,South Sudan (UNDP),2019,SSD-19/HSS10/SA1/WASH/NGO/11580,11/19/2019 1:50:11 PM,Internally Displaced People,1800,1800,2100,2274,7974,934,934,1056,1178,4102
19,South Sudan (UNDP),2019,SSD-19/HSS10/SA1/WASH/NGO/11580,11/19/2019 1:50:11 PM,Overall,3000,3000,3500,3790,13290,1557,1557,1760,1963,6837
19,South Sudan (UNDP),2019,SSD-19/HSS10/SA1/WASH/NGO/11580,11/19/2019 1:50:11 PM,Returnees,300,300,350,379,1329,467,467,528,589,2051
19,South Sudan (UNDP),2019,SSD-19/HSS10/SA1/WASH/NGO/11594,1/24/2020 11:46:08 AM,Host Communities,800,2000,900,2008,5708,540,870,624,952,2986
19,South Sudan (UNDP),2019,SSD-19/HSS10/SA1/WASH/NGO/11594,1/24/2020 11:46:08 AM,Internally Displaced People,320,412,340,422,1494,405,652,468,714,2239
19,South Sudan (UNDP),2019,SSD-19/HSS10/SA1/WASH/NGO/11594,1/24/2020 11:46:08 AM,Overall,1688,3112,2000,3200,10000,1350,2175,1560,2380,7465
19,South Sudan (UNDP),2019,SSD-19/HSS10/SA1/WASH/NGO/11594,1/24/2020 11:46:08 AM,Returnees,568,700,760,770,2798,405,653,468,714,2240
19,South Sudan (UNDP),2019,SSD-19/HSS10/SA1/WASH/NGO/11614,11/4/2019 9:43:21 AM,Host Communities,629,731,861,872,3093,2191,2253,2639,2718,9801
19,South Sudan (UNDP),2019,SSD-19/HSS10/SA1/WASH/NGO/11614,11/4/2019 9:43:21 AM,Internally Displaced People,1024,1472,1512,1616,5624,799,859,1025,1351,4034
19,South Sudan (UNDP),2019,SSD-19/HSS10/SA1/WASH/NGO/11614,11/4/2019 9:43:21 AM,Overall,2439,3048,3292,3416,12195,3700,4002,4633,5189,17524
19,South Sudan (UNDP),2019,SSD-19/HSS10/SA1/WASH/NGO/11614,11/4/2019 9:43:21 AM,Returnees,786,845,919,928,3478,710,890,969,1120,3689
19,South Sudan (UNDP),2019,SSD-19/HSS10/SA1/WASH/NGO/11665,12/13/2019 8:57:11 AM,Host Communities,144,216,100,140,600,142,204,110,167,623
19,South Sudan (UNDP),2019,SSD-19/HSS10/SA1/WASH/NGO/11665,12/13/2019 8:57:11 AM,Internally Displaced People,1068,1512,700,980,4260,283,405,219,336,1243
19,South Sudan (UNDP),2019,SSD-19/HSS10/SA1/WASH/NGO/11665,12/13/2019 8:57:11 AM,Overall,1440,2160,1000,1400,6000,1417,2018,1097,1679,6211
19,South Sudan (UNDP),2019,SSD-19/HSS10/SA1/WASH/NGO/11665,12/13/2019 8:57:11 AM,Returnees,228,432,200,280,1140,992,1409,768,1176,4345
19,South Sudan (UNDP),2019,SSD-19/HSS10/SA1/WASH/NGO/11709,11/4/2019 10:51:01 AM,Host Communities,772,1434,1843,2256,6305,775,671,1085,1119,3650
19,South Sudan (UNDP),2019,SSD-19/HSS10/SA1/WASH/NGO/11709,11/4/2019 10:51:01 AM,Internally Displaced People,398,741,952,1164,3255,193,166,276,82,717
19,South Sudan (UNDP),2019,SSD-19/HSS10/SA1/WASH/NGO/11709,11/4/2019 10:51:01 AM,Other,25,49,63,73,210,50,41,69,75,235
19,South Sudan (UNDP),2019,SSD-19/HSS10/SA1/WASH/NGO/11709,11/4/2019 10:51:01 AM,Overall,1287,2391,3073,3755,10506,2414,2070,3450,3564,11498
19,South Sudan (UNDP),2019,SSD-19/HSS10/SA1/WASH/NGO/11709,11/4/2019 10:51:01 AM,Returnees,92,167,215,262,736,1396,1192,2020,2288,6896
19,South Sudan (UNDP),2019,SSD-19/HSS10/SA1/WASH/NGO/11714,11/6/2019 9:30:36 AM,Host Communities,1560,1300,1690,1950,6500,1413,1308,1755,1945,6421
19,South Sudan (UNDP),2019,SSD-19/HSS10/SA1/WASH/NGO/11714,11/6/2019 9:30:36 AM,Internally Displaced People,1440,1200,1560,1800,6000,1401,1166,1583,1765,5915
19,South Sudan (UNDP),2019,SSD-19/HSS10/SA1/WASH/NGO/11714,11/6/2019 9:30:36 AM,Overall,3000,2500,3250,3750,12500,2814,2474,3338,3710,12336
19,South Sudan (UNDP),2019,SSD-19/HSS10/SA1/WASH/NGO/11747,11/4/2019 10:35:19 AM,Host Communities,700,1700,2000,2000,6400,1350,1250,1950,2020,6570
19,South Sudan (UNDP),2019,SSD-19/HSS10/SA1/WASH/NGO/11747,11/4/2019 10:35:19 AM,Internally Displaced People,1000,2000,3500,3500,10000,1140,1450,2500,2650,7740
19,South Sudan (UNDP),2019,SSD-19/HSS10/SA1/WASH/NGO/11747,11/4/2019 10:35:19 AM,Overall,2000,4000,6000,6000,18000,3027,3360,6393,6396,19176
19,South Sudan (UNDP),2019,SSD-19/HSS10/SA1/WASH/NGO/11747,11/4/2019 10:35:19 AM,Returnees,300,300,500,500,1600,537,660,1943,1726,4866
19,South Sudan (UNDP),2019,SSD-19/HSS10/SA1/WASH/NGO/11760,11/4/2019 10:32:21 AM,Host Communities,1000,1000,2000,2000,6000,1123,1780,4500,5660,13063
19,South Sudan (UNDP),2019,SSD-19/HSS10/SA1/WASH/NGO/11760,11/4/2019 10:32:21 AM,Internally Displaced People,3000,3000,6000,6000,18000,3371,2839,4656,4089,14955
19,South Sudan (UNDP),2019,SSD-19/HSS10/SA1/WASH/NGO/11760,11/4/2019 10:32:21 AM,Other,500,500,1000,1000,3000,26,11,4,1,42
19,South Sudan (UNDP),2019,SSD-19/HSS10/SA1/WASH/NGO/11760,11/4/2019 10:32:21 AM,Overall,5000,5000,10000,10000,30000,4860,5130,10500,11400,31890
19,South Sudan (UNDP),2019,SSD-19/HSS10/SA1/WASH/NGO/11760,11/4/2019 10:32:21 AM,Returnees,500,500,1000,1000,3000,340,500,1340,1650,3830
19,South Sudan (UNDP),2019,SSD-19/HSS10/SA2/CCCM/INGO/13512,6/8/2020 7:53:53 AM,Internally Displaced People,11075,15942,10831,10831,48679,28917,38553,14458,14458,96386
19,South Sudan (UNDP),2019,SSD-19/HSS10/SA2/CCCM/INGO/13512,6/8/2020 7:53:53 AM,Overall,13790,20097,14601,14601,63089,32118,42820,16058,16058,107054
19,South Sudan (UNDP),2019,SSD-19/HSS10/SA2/CCCM/INGO/13512,6/8/2020 7:53:53 AM,Returnees,2715,4155,3770,3770,14410,3201,4267,1600,1600,10668
19,South Sudan (UNDP),2019,SSD-19/HSS10/SA2/CCCM/NGO/13426,6/12/2020 6:38:56 AM,Host Communities,300,1500,300,900,3000,300,1500,300,900,3000
19,South Sudan (UNDP),2019,SSD-19/HSS10/SA2/CCCM/NGO/13426,6/12/2020 6:38:56 AM,Internally Displaced People,700,3500,700,2100,7000,700,3500,700,21000,25900
19,South Sudan (UNDP),2019,SSD-19/HSS10/SA2/CCCM/NGO/13426,6/12/2020 6:38:56 AM,Overall,1000,5000,1000,3000,10000,1000,5000,1000,21900,28900
19,South Sudan (UNDP),2019,SSD-19/HSS10/SA2/CCCM-FSL-NFI/INGO/13596,7/28/2020 7:34:06 PM,Host Communities,6108,8610,4240,4684,23642,4767,5852,3708,4196,18523
19,South Sudan (UNDP),2019,SSD-19/HSS10/SA2/CCCM-FSL-NFI/INGO/13596,7/28/2020 7:34:06 PM,Internally Displaced People,8399,11293,6018,6295,32005,7345,9543,5959,6785,29632
19,South Sudan (UNDP),2019,SSD-19/HSS10/SA2/CCCM-FSL-NFI/INGO/13596,7/28/2020 7:34:06 PM,Overall,18990,26227,12885,14008,72110,15693,19556,11819,13533,60601
19,South Sudan (UNDP),2019,SSD-19/HSS10/SA2/CCCM-FSL-NFI/INGO/13596,7/28/2020 7:34:06 PM,Returnees,4483,6324,2627,3029,16463,3581,4161,2152,2552,12446
19,South Sudan (UNDP),2019,SSD-19/HSS10/SA2/E/INGO/13358,8/10/2020 8:49:42 PM,Host Communities,400,200,6232,2371,9203,96,76,6128,3450,9750
19,South Sudan (UNDP),2019,SSD-19/HSS10/SA2/E/INGO/13358,8/10/2020 8:49:42 PM,Overall,400,200,6232,2371,9203,96,76,6128,3450,9750
19,South Sudan (UNDP),2019,SSD-19/HSS10/SA2/E/INGO/13446,6/15/2020 1:31:40 AM,Host Communities,242,61,1411,1356,3070,65,43,1150,866,2124
19,South Sudan (UNDP),2019,SSD-19/HSS10/SA2/E/INGO/13446,6/15/2020 1:31:40 AM,Internally Displaced People,364,91,2115,2032,4602,97,65,1723,1299,3184
19,South Sudan (UNDP),2019,SSD-19/HSS10/SA2/E/INGO/13446,6/15/2020 1:31:40 AM,Overall,970,243,5641,5420,12274,259,173,4596,3464,8492
19,South Sudan (UNDP),2019,SSD-19/HSS10/SA2/E/INGO/13446,6/15/2020 1:31:40 AM,Returnees,364,91,2115,2032,4602,97,65,1723,1299,3184
19,South Sudan (UNDP),2019,SSD-19/HSS10/SA2/E/INGO/13516,10/14/2020 6:00:29 PM,Host Communities,321,132,1773,1502,3728,341,132,1812,1582,3867
19,South Sudan (UNDP),2019,SSD-19/HSS10/SA2/E/INGO/13516,10/14/2020 6:00:29 PM,Internally Displaced People,85,51,667,581,1384,52,51,411,354,868
19,South Sudan (UNDP),2019,SSD-19/HSS10/SA2/E/INGO/13516,10/14/2020 6:00:29 PM,Overall,406,183,2440,2083,5112,393,183,2223,1936,4735
19,South Sudan (UNDP),2019,SSD-19/HSS10/SA2/E-FSL/NGO/13419,8/13/2020 6:36:43 AM,Host Communities,2522,3288,4170,5660,15640,2525,3290,4317,5872,16004
19,South Sudan (UNDP),2019,SSD-19/HSS10/SA2/E-FSL/NGO/13419,8/13/2020 6:36:43 AM,Internally Displaced People,1532,1982,2742,3556,9812,1510,1988,2840,3706,10044
19,South Sudan (UNDP),2019,SSD-19/HSS10/SA2/E-FSL/NGO/13419,8/13/2020 6:36:43 AM,Overall,5044,6576,8340,11320,31280,5033,6589,8621,11723,31966
19,South Sudan (UNDP),2019,SSD-19/HSS10/SA2/E-FSL/NGO/13419,8/13/2020 6:36:43 AM,Returnees,990,1306,1428,2104,5828,998,1311,1464,2145,5918
19,South Sudan (UNDP),2019,SSD-19/HSS10/SA2/E-FSL-WASH-NFI/NGO/13440,6/22/2020 7:18:50 AM,Host Communities,4952,5847,4534,4591,19924,5761,5364,8280,8539,27944
19,South Sudan (UNDP),2019,SSD-19/HSS10/SA2/E-FSL-WASH-NFI/NGO/13440,6/22/2020 7:18:50 AM,Internally Displaced People,3011,3566,2645,2694,11916,4969,4982,7275,7158,24384
19,South Sudan (UNDP),2019,SSD-19/HSS10/SA2/E-FSL-WASH-NFI/NGO/13440,6/22/2020 7:18:50 AM,Overall,15180,18254,10141,10273,53848,17171,17358,23236,22991,80756
19,South Sudan (UNDP),2019,SSD-19/HSS10/SA2/E-FSL-WASH-NFI/NGO/13440,6/22/2020 7:18:50 AM,Returnees,7217,8841,2962,2988,22008,6441,7012,7681,7294,28428
19,South Sudan (UNDP),2019,SSD-19/HSS10/SA2/E-WASH/NGO/13545,8/3/2020 9:55:17 AM,Host Communities,2114,2081,6036,6489,16720,2100,2581,6336,7089,18106
19,South Sudan (UNDP),2019,SSD-19/HSS10/SA2/E-WASH/NGO/13545,8/3/2020 9:55:17 AM,Internally Displaced People,4028,4020,7509,7621,23178,4000,4420,7709,8221,24350
19,South Sudan (UNDP),2019,SSD-19/HSS10/SA2/E-WASH/NGO/13545,8/3/2020 9:55:17 AM,Overall,6642,6601,14045,14610,41898,6595,7581,14595,15865,44636
19,South Sudan (UNDP),2019,SSD-19/HSS10/SA2/E-WASH/NGO/13545,8/3/2020 9:55:17 AM,Returnees,500,500,500,500,2000,495,580,550,555,2180
19,South Sudan (UNDP),2019,SSD-19/HSS10/SA2/FSL/INGO/13361,6/25/2020 9:55:39 PM,Host Communities,7705,8347,8688,9412,34152,7238,8479,8722,9814,34253
19,South Sudan (UNDP),2019,SSD-19/HSS10/SA2/FSL/INGO/13361,6/25/2020 9:55:39 PM,Internally Displaced People,907,982,1023,1108,4020,868,1072,1078,1154,4172
19,South Sudan (UNDP),2019,SSD-19/HSS10/SA2/FSL/INGO/13361,6/25/2020 9:55:39 PM,Overall,9065,9820,10222,11075,40182,8554,10028,10342,11506,40430
19,South Sudan (UNDP),2019,SSD-19/HSS10/SA2/FSL/INGO/13361,6/25/2020 9:55:39 PM,Returnees,453,491,511,555,2010,448,477,542,538,2005
19,South Sudan (UNDP),2019,SSD-19/HSS10/SA2/FSL/INGO/13412,7/6/2020 7:30:32 AM,Host Communities,7963,8627,2117,2293,21000,4845,9331,7120,10386,31682
19,South Sudan (UNDP),2019,SSD-19/HSS10/SA2/FSL/INGO/13412,7/6/2020 7:30:32 AM,Internally Displaced People,3072,3327,816,885,8100,241,366,281,358,1246
19,South Sudan (UNDP),2019,SSD-19/HSS10/SA2/FSL/INGO/13412,7/6/2020 7:30:32 AM,Overall,11376,12324,3024,3276,30000,5349,10052,7678,11148,34227
19,South Sudan (UNDP),2019,SSD-19/HSS10/SA2/FSL/INGO/13412,7/6/2020 7:30:32 AM,Returnees,341,370,91,98,900,263,355,277,404,1299
19,South Sudan (UNDP),2019,SSD-19/HSS10/SA2/FSL/INGO/13449,5/14/2020 12:11:17 PM,Host Communities,1841,2017,2368,2542,8768,1841,2017,2368,2542,8768
19,South Sudan (UNDP),2019,SSD-19/HSS10/SA2/FSL/INGO/13449,5/14/2020 12:11:17 PM,Internally Displaced People,2578,2823,3314,3559,12274,2578,2823,3314,3559,12274
19,South Sudan (UNDP),2019,SSD-19/HSS10/SA2/FSL/INGO/13449,5/14/2020 12:11:17 PM,Overall,7366,8066,9469,10169,35070,7366,8066,9469,10169,35070
19,South Sudan (UNDP),2019,SSD-19/HSS10/SA2/FSL/INGO/13449,5/14/2020 12:11:17 PM,Returnees,2947,3226,3787,4068,14028,2947,3226,3787,4068,14028
19,South Sudan (UNDP),2019,SSD-19/HSS10/SA2/FSL/INGO/13541,6/1/2020 7:14:52 AM,Host Communities,5500,5500,9000,9000,29000,9750,9860,5540,5420,30570
19,South Sudan (UNDP),2019,SSD-19/HSS10/SA2/FSL/INGO/13541,6/1/2020 7:14:52 AM,Internally Displaced People,1500,1500,2498,2498,7996,2410,2650,1206,1140,7406
19,South Sudan (UNDP),2019,SSD-19/HSS10/SA2/FSL/INGO/13541,6/1/2020 7:14:52 AM,Other,500,500,1000,1000,3000,854,504,238,424,2020
19,South Sudan (UNDP),2019,SSD-19/HSS10/SA2/FSL/INGO/13541,6/1/2020 7:14:52 AM,Overall,7500,7500,12498,12498,39996,13014,13014,6984,6984,39996
19,South Sudan (UNDP),2019,SSD-19/HSS10/SA2/FSL/INGO/13626,6/11/2020 6:18:21 AM,Host Communities,4120,5034,6636,7094,22884,1417,1689,7299,9747,20152
19,South Sudan (UNDP),2019,SSD-19/HSS10/SA2/FSL/INGO/13626,6/11/2020 6:18:21 AM,Internally Displaced People,1280,1566,2064,2206,7116,811,1083,4414,1186,7494
19,South Sudan (UNDP),2019,SSD-19/HSS10/SA2/FSL/INGO/13626,6/11/2020 6:18:21 AM,Overall,5400,6600,8700,9300,30000,2228,2772,11713,10933,27646
19,South Sudan (UNDP),2019,SSD-19/HSS10/SA2/FSL/INGO/13665,7/28/2020 5:41:22 PM,Host Communities,3060,5100,1020,1020,10200,3534,5712,852,972,11070
19,South Sudan (UNDP),2019,SSD-19/HSS10/SA2/FSL/INGO/13665,7/28/2020 5:41:22 PM,Internally Displaced People,5940,9900,1980,1980,19800,5844,9588,1872,1626,18930
19,South Sudan (UNDP),2019,SSD-19/HSS10/SA2/FSL/INGO/13665,7/28/2020 5:41:22 PM,Overall,9000,15000,3000,3000,30000,9378,15300,2724,2598,30000
19,South Sudan (UNDP),2019,SSD-19/HSS10/SA2/FSL/NGO/13354,7/28/2020 3:34:44 PM,Host Communities,2890,3040,2148,2760,10838,4734,3288,102,72,8196
19,South Sudan (UNDP),2019,SSD-19/HSS10/SA2/FSL/NGO/13354,7/28/2020 3:34:44 PM,Internally Displaced People,2545,3280,2505,2170,10500,4770,3312,102,72,8256
19,South Sudan (UNDP),2019,SSD-19/HSS10/SA2/FSL/NGO/13354,7/28/2020 3:34:44 PM,Other,45,60,25,32,162,40,53,20,25,138
19,South Sudan (UNDP),2019,SSD-19/HSS10/SA2/FSL/NGO/13354,7/28/2020 3:34:44 PM,Overall,8725,10760,6983,7732,34200,19774,13763,440,325,34302
19,South Sudan (UNDP),2019,SSD-19/HSS10/SA2/FSL/NGO/13354,7/28/2020 3:34:44 PM,Returnees,3245,4380,2305,2770,12700,10230,7110,216,156,17712
19,South Sudan (UNDP),2019,SSD-19/HSS10/SA2/FSL/NGO/13356,10/14/2020 6:23:28 PM,Host Communities,2400,3300,1250,1215,8165,2400,3300,1250,1215,8165
19,South Sudan (UNDP),2019,SSD-19/HSS10/SA2/FSL/NGO/13356,10/14/2020 6:23:28 PM,Internally Displaced People,1800,3150,2135,2412,9497,1800,3150,2135,2412,9497
19,South Sudan (UNDP),2019,SSD-19/HSS10/SA2/FSL/NGO/13356,10/14/2020 6:23:28 PM,Other,50,62,33,25,170,50,62,33,25,170
19,South Sudan (UNDP),2019,SSD-19/HSS10/SA2/FSL/NGO/13356,10/14/2020 6:23:28 PM,Overall,6750,9512,4643,6095,27000,6750,9512,4643,6095,27000
19,South Sudan (UNDP),2019,SSD-19/HSS10/SA2/FSL/NGO/13356,10/14/2020 6:23:28 PM,Returnees,2500,3000,1225,2443,9168,2500,3000,1225,2443,9168
19,South Sudan (UNDP),2019,SSD-19/HSS10/SA2/FSL/NGO/13357,9/25/2020 7:28:27 AM,Host Communities,2800,3095,1800,2076,9771,2800,3095,1800,2076,9771
19,South Sudan (UNDP),2019,SSD-19/HSS10/SA2/FSL/NGO/13357,9/25/2020 7:28:27 AM,Internally Displaced People,2000,2800,2003,2004,8807,2000,2800,2003,2004,8807
19,South Sudan (UNDP),2019,SSD-19/HSS10/SA2/FSL/NGO/13357,9/25/2020 7:28:27 AM,Other,28,35,16,21,100,28,35,16,21,100
19,South Sudan (UNDP),2019,SSD-19/HSS10/SA2/FSL/NGO/13357,9/25/2020 7:28:27 AM,Overall,6832,9506,5535,5325,27198,6832,9506,5535,5325,27198
19,South Sudan (UNDP),2019,SSD-19/HSS10/SA2/FSL/NGO/13357,9/25/2020 7:28:27 AM,Returnees,2004,3576,1716,1224,8520,2004,3576,1716,1224,8520
19,South Sudan (UNDP),2019,SSD-19/HSS10/SA2/FSL/NGO/13403,5/1/2020 8:49:25 AM,Host Communities,4800,5600,4500,4600,19500,4800,5600,4500,4600,19500
19,South Sudan (UNDP),2019,SSD-19/HSS10/SA2/FSL/NGO/13403,5/1/2020 8:49:25 AM,Internally Displaced People,2600,3000,1100,1300,8000,2600,3000,1100,1300,8000
19,South Sudan (UNDP),2019,SSD-19/HSS10/SA2/FSL/NGO/13403,5/1/2020 8:49:25 AM,Other,200,600,204,98,1102,200,600,204,98,1102
19,South Sudan (UNDP),2019,SSD-19/HSS10/SA2/FSL/NGO/13403,5/1/2020 8:49:25 AM,Overall,8300,10500,6502,7500,32802,8300,10500,6502,7500,32802
19,South Sudan (UNDP),2019,SSD-19/HSS10/SA2/FSL/NGO/13403,5/1/2020 8:49:25 AM,Returnees,700,1300,698,1502,4200,700,1300,698,1502,4200
19,South Sudan (UNDP),2019,SSD-19/HSS10/SA2/FSL/NGO/13524,5/27/2020 10:25:04 AM,Host Communities,500,500,2000,2000,5000,690,650,3300,2450,7090
19,South Sudan (UNDP),2019,SSD-19/HSS10/SA2/FSL/NGO/13524,5/27/2020 10:25:04 AM,Internally Displaced People,2500,2500,5000,5000,15000,1540,4200,4100,4320,14160
19,South Sudan (UNDP),2019,SSD-19/HSS10/SA2/FSL/NGO/13524,5/27/2020 10:25:04 AM,Overall,3250,3250,8000,8000,22500,2550,5220,7680,7050,22500
19,South Sudan (UNDP),2019,SSD-19/HSS10/SA2/FSL/NGO/13524,5/27/2020 10:25:04 AM,Returnees,250,250,1000,1000,2500,320,370,280,280,1250
19,South Sudan (UNDP),2019,SSD-19/HSS10/SA2/FSL/NGO/13562,5/9/2020 1:44:17 AM,Host Communities,3306,6684,120,480,10590,3216,4968,840,1122,10146
19,South Sudan (UNDP),2019,SSD-19/HSS10/SA2/FSL/NGO/13562,5/9/2020 1:44:17 AM,Internally Displaced People,5484,11214,1512,654,18864,3906,8430,1008,2616,15960
19,South Sudan (UNDP),2019,SSD-19/HSS10/SA2/FSL/NGO/13562,5/9/2020 1:44:17 AM,Overall,10344,21576,1686,1194,34800,8442,19998,2202,4158,34800
19,South Sudan (UNDP),2019,SSD-19/HSS10/SA2/FSL/NGO/13562,5/9/2020 1:44:17 AM,Returnees,1554,3678,54,60,5346,1320,6600,354,420,8694
19,South Sudan (UNDP),2019,SSD-19/HSS10/SA2/FSL/NGO/13631,5/13/2020 5:59:38 AM,Host Communities,3000,2600,1000,500,7100,3000,2600,1000,500,7100
19,South Sudan (UNDP),2019,SSD-19/HSS10/SA2/FSL/NGO/13631,5/13/2020 5:59:38 AM,Internally Displaced People,2400,3000,1400,1500,8300,2400,3000,1400,1500,8300
19,South Sudan (UNDP),2019,SSD-19/HSS10/SA2/FSL/NGO/13631,5/13/2020 5:59:38 AM,Overall,9000,9600,5400,6000,30000,9000,9600,5400,6000,30000
19,South Sudan (UNDP),2019,SSD-19/HSS10/SA2/FSL/NGO/13631,5/13/2020 5:59:38 AM,Returnees,3600,4000,3000,4000,14600,3600,4000,3000,4000,14600
19,South Sudan (UNDP),2019,SSD-19/HSS10/SA2/FSL/NGO/13660,10/17/2020 12:17:57 PM,Host Communities,4099,6149,2733,4100,17081,1872,4437,2288,5423,14020
19,South Sudan (UNDP),2019,SSD-19/HSS10/SA2/FSL/NGO/13660,10/17/2020 12:17:57 PM,Internally Displaced People,1757,2636,1171,1757,7321,900,1874,1100,2291,6165
19,South Sudan (UNDP),2019,SSD-19/HSS10/SA2/FSL/NGO/13660,10/17/2020 12:17:57 PM,Overall,5856,8785,3904,5857,24402,2772,6311,3388,7714,20185
19,South Sudan (UNDP),2019,SSD-19/HSS10/SA2/FSL/NGO/13661,9/18/2020 7:27:59 AM,Host Communities,3500,4000,2500,2200,12200,8316,4494,3384,3648,19842
19,South Sudan (UNDP),2019,SSD-19/HSS10/SA2/FSL/NGO/13661,9/18/2020 7:27:59 AM,Internally Displaced People,2000,3000,1500,2000,8500,966,642,186,426,2220
19,South Sudan (UNDP),2019,SSD-19/HSS10/SA2/FSL/NGO/13661,9/18/2020 7:27:59 AM,Overall,6000,7200,4200,4800,22200,9330,5154,3576,4140,22200
19,South Sudan (UNDP),2019,SSD-19/HSS10/SA2/FSL/NGO/13661,9/18/2020 7:27:59 AM,Returnees,500,200,200,600,1500,48,18,6,66,138
19,South Sudan (UNDP),2019,SSD-19/HSS10/SA2/FSL-NFI/NGO/13573,5/13/2020 6:59:13 PM,Host Communities,2966,4657,330,344,8297,2866,4655,312,341,8174
19,South Sudan (UNDP),2019,SSD-19/HSS10/SA2/FSL-NFI/NGO/13573,5/13/2020 6:59:13 PM,Internally Displaced People,8244,14202,554,566,23566,8214,14097,551,562,23424
19,South Sudan (UNDP),2019,SSD-19/HSS10/SA2/FSL-NFI/NGO/13573,5/13/2020 6:59:13 PM,Overall,17000,26597,1210,1293,46100,16868,26352,1188,1284,45692
19,South Sudan (UNDP),2019,SSD-19/HSS10/SA2/FSL-NFI/NGO/13573,5/13/2020 6:59:13 PM,Returnees,5790,7738,326,383,14237,5788,7600,325,381,14094
19,South Sudan (UNDP),2019,SSD-19/HSS10/SA2/H/INGO/13376,10/12/2020 11:35:22 AM,Host Communities,1181,1279,1771,1918,6149,1708,1851,961,1041,5561
19,South Sudan (UNDP),2019,SSD-19/HSS10/SA2/H/INGO/13376,10/12/2020 11:35:22 AM,Internally Displaced People,3267,3539,4901,5309,17016,1039,1125,1556,1688,5408
19,South Sudan (UNDP),2019,SSD-19/HSS10/SA2/H/INGO/13376,10/12/2020 11:35:22 AM,Overall,7715,8357,11573,12536,40181,3786,4101,4073,4417,16377
19,South Sudan (UNDP),2019,SSD-19/HSS10/SA2/H/INGO/13376,10/12/2020 11:35:22 AM,Returnees,3267,3539,4901,5309,17016,1039,1125,1556,1688,5408
19,South Sudan (UNDP),2019,SSD-19/HSS10/SA2/H/INGO/13486,6/15/2020 7:23:18 AM,Host Communities,676,964,991,1034,3665,576,894,900,938,3308
19,South Sudan (UNDP),2019,SSD-19/HSS10/SA2/H/INGO/13486,6/15/2020 7:23:18 AM,Internally Displaced People,1584,2284,2460,2492,8820,1500,2200,2360,2392,8452
19,South Sudan (UNDP),2019,SSD-19/HSS10/SA2/H/INGO/13486,6/15/2020 7:23:18 AM,Overall,2260,3248,3451,3526,12485,2076,3094,3260,3330,11760
19,South Sudan (UNDP),2019,SSD-19/HSS10/SA2/H/INGO/13557,6/22/2020 6:45:44 AM,Other,7684,11526,2984,2754,24948,5874,8587,4953,4566,23980
19,South Sudan (UNDP),2019,SSD-19/HSS10/SA2/H/INGO/13557,6/22/2020 6:45:44 AM,Overall,7684,11526,2984,2754,24948,5874,8587,4953,4566,23980
19,South Sudan (UNDP),2019,SSD-19/HSS10/SA2/H/INGO/13587,7/2/2020 6:55:43 AM,Host Communities,12250,12750,7500,7500,40000,12250,12750,10421,9539,44960
19,South Sudan (UNDP),2019,SSD-19/HSS10/SA2/H/INGO/13587,7/2/2020 6:55:43 AM,Internally Displaced People,12250,12750,7500,7500,40000,19605,18728,19627,20426,78386
19,South Sudan (UNDP),2019,SSD-19/HSS10/SA2/H/INGO/13587,7/2/2020 6:55:43 AM,Overall,24500,25500,15000,15000,80000,31855,31478,30048,29965,123346
19,South Sudan (UNDP),2019,SSD-19/HSS10/SA2/H/INGO/13642,7/15/2020 11:13:28 AM,Host Communities,4215,4681,5107,5403,19406,4511,5445,6034,6520,22510
19,South Sudan (UNDP),2019,SSD-19/HSS10/SA2/H/INGO/13642,7/15/2020 11:13:28 AM,Internally Displaced People,1233,1336,1009,1092,4670,1887,2080,1892,2015,7874
19,South Sudan (UNDP),2019,SSD-19/HSS10/SA2/H/INGO/13642,7/15/2020 11:13:28 AM,Other,247,267,202,219,935,301,334,285,302,1222
19,South Sudan (UNDP),2019,SSD-19/HSS10/SA2/H/INGO/13642,7/15/2020 11:13:28 AM,Overall,7255,7781,7539,8064,30639,8526,9670,9773,10593,38562
19,South Sudan (UNDP),2019,SSD-19/HSS10/SA2/H/INGO/13642,7/15/2020 11:13:28 AM,Returnees,1560,1497,1221,1350,5628,1827,1811,1562,1756,6956
19,South Sudan (UNDP),2019,SSD-19/HSS10/SA2/H/INGO/13650,10/5/2020 9:01:50 AM,Host Communities,1175,1200,1300,1350,5025,771,981,669,849,3270
19,South Sudan (UNDP),2019,SSD-19/HSS10/SA2/H/INGO/13650,10/5/2020 9:01:50 AM,Internally Displaced People,3517,4471,5347,5139,18474,2989,4053,4545,4368,15955
19,South Sudan (UNDP),2019,SSD-19/HSS10/SA2/H/INGO/13650,10/5/2020 9:01:50 AM,Overall,4692,5671,6647,6489,23499,3760,5034,5214,5217,19225
19,South Sudan (UNDP),2019,SSD-19/HSS10/SA2/H/INGO/13655,6/30/2020 7:46:34 AM,Host Communities,4152,6636,3287,3361,17436,3349,5581,1488,1612,12030
19,South Sudan (UNDP),2019,SSD-19/HSS10/SA2/H/INGO/13655,6/30/2020 7:46:34 AM,Internally Displaced People,1000,1200,1000,1000,4200,359,481,593,542,1975
19,South Sudan (UNDP),2019,SSD-19/HSS10/SA2/H/INGO/13655,6/30/2020 7:46:34 AM,Overall,5152,7836,4287,4361,21636,3708,6062,2081,2154,14005
19,South Sudan (UNDP),2019,SSD-19/HSS10/SA2/H/NGO/13369,6/29/2020 6:32:58 AM,Host Communities,1756,1835,1950,1850,7391,3429,6857,3086,3771,17143
19,South Sudan (UNDP),2019,SSD-19/HSS10/SA2/H/NGO/13369,6/29/2020 6:32:58 AM,Internally Displaced People,254,550,473,855,2132,2415,4831,2595,2657,12498
19,South Sudan (UNDP),2019,SSD-19/HSS10/SA2/H/NGO/13369,6/29/2020 6:32:58 AM,Overall,3722,3985,4068,4140,15915,7792,15584,7434,8570,39380
19,South Sudan (UNDP),2019,SSD-19/HSS10/SA2/H/NGO/13369,6/29/2020 6:32:58 AM,Returnees,1712,1600,1645,1435,6392,1948,3896,1753,2142,9739
19,South Sudan (UNDP),2019,SSD-19/HSS10/SA2/H/NGO/13372,6/15/2020 6:52:56 AM,Host Communities,1962,2042,593,618,5215,1205,1255,987,1027,4474
19,South Sudan (UNDP),2019,SSD-19/HSS10/SA2/H/NGO/13372,6/15/2020 6:52:56 AM,Internally Displaced People,3954,4115,1228,1277,10574,2255,3136,1973,2180,9544
19,South Sudan (UNDP),2019,SSD-19/HSS10/SA2/H/NGO/13372,6/15/2020 6:52:56 AM,Overall,5916,6157,1821,1895,15789,3460,4391,2960,3207,14018
19,South Sudan (UNDP),2019,SSD-19/HSS10/SA2/H/NGO/13375,6/10/2020 9:31:54 AM,Host Communities,477,794,858,1049,3178,624,855,1038,1245,3762
19,South Sudan (UNDP),2019,SSD-19/HSS10/SA2/H/NGO/13375,6/10/2020 9:31:54 AM,Internally Displaced People,795,1324,1430,1748,5297,727,1141,1309,1435,4612
19,South Sudan (UNDP),2019,SSD-19/HSS10/SA2/H/NGO/13375,6/10/2020 9:31:54 AM,Other,79,133,143,175,530,64,122,297,283,766
19,South Sudan (UNDP),2019,SSD-19/HSS10/SA2/H/NGO/13375,6/10/2020 9:31:54 AM,Overall,1589,2648,2860,3496,10593,1696,2661,3221,3534,11112
19,South Sudan (UNDP),2019,SSD-19/HSS10/SA2/H/NGO/13375,6/10/2020 9:31:54 AM,Returnees,238,397,429,524,1588,281,543,577,571,1972
19,South Sudan (UNDP),2019,SSD-19/HSS10/SA2/H/NGO/13431,6/15/2020 7:01:36 AM,Host Communities,2136,1577,1895,1864,7472,1840,1560,1835,1786,7021
19,South Sudan (UNDP),2019,SSD-19/HSS10/SA2/H/NGO/13431,6/15/2020 7:01:36 AM,Internally Displaced People,748,736,663,653,2800,914,733,645,651,2943
19,South Sudan (UNDP),2019,SSD-19/HSS10/SA2/H/NGO/13431,6/15/2020 7:01:36 AM,Other,0,526,0,0,526,0,418,0,0,418
19,South Sudan (UNDP),2019,SSD-19/HSS10/SA2/H/NGO/13431,6/15/2020 7:01:36 AM,Overall,3561,3505,3158,3108,13332,3321,3359,3065,3026,12771
19,South Sudan (UNDP),2019,SSD-19/HSS10/SA2/H/NGO/13431,6/15/2020 7:01:36 AM,Returnees,677,666,600,591,2534,567,648,585,589,2389
19,South Sudan (UNDP),2019,SSD-19/HSS10/SA2/H/NGO/13441,7/20/2020 9:36:50 AM,Host Communities,3000,5400,5000,6600,20000,3940,6118,2877,4034,16969
19,South Sudan (UNDP),2019,SSD-19/HSS10/SA2/H/NGO/13441,7/20/2020 9:36:50 AM,Internally Displaced People,300,540,500,660,2000,246,382,182,252,1062
19,South Sudan (UNDP),2019,SSD-19/HSS10/SA2/H/NGO/13441,7/20/2020 9:36:50 AM,Overall,3750,6750,6250,8250,25000,4925,7647,3598,5042,21212
19,South Sudan (UNDP),2019,SSD-19/HSS10/SA2/H/NGO/13441,7/20/2020 9:36:50 AM,Returnees,450,810,750,990,3000,739,1147,539,756,3181
19,South Sudan (UNDP),2019,SSD-19/HSS10/SA2/H/NGO/13544,6/15/2020 6:24:23 AM,Host Communities,1077,1060,4306,4237,10680,1673,1595,6435,6519,16222
19,South Sudan (UNDP),2019,SSD-19/HSS10/SA2/H/NGO/13544,6/15/2020 6:24:23 AM,Internally Displaced People,269,265,1077,1059,2670,403,462,1640,1618,4123
19,South Sudan (UNDP),2019,SSD-19/HSS10/SA2/H/NGO/13544,6/15/2020 6:24:23 AM,Overall,1346,1325,5383,5296,13350,2076,2057,8075,8137,20345
19,South Sudan (UNDP),2019,SSD-19/HSS10/SA2/H/NGO/13553,8/10/2020 6:32:10 AM,Host Communities,3051,3778,189,247,7265,2100,2485,524,442,5551
19,South Sudan (UNDP),2019,SSD-19/HSS10/SA2/H/NGO/13553,8/10/2020 6:32:10 AM,Internally Displaced People,509,630,31,41,1211,784,1027,398,395,2604
19,South Sudan (UNDP),2019,SSD-19/HSS10/SA2/H/NGO/13553,8/10/2020 6:32:10 AM,Other,165,199,0,0,364,150,131,0,0,281
19,South Sudan (UNDP),2019,SSD-19/HSS10/SA2/H/NGO/13553,8/10/2020 6:32:10 AM,Overall,5098,6307,305,399,12109,4600,4984,1456,1276,12316
19,South Sudan (UNDP),2019,SSD-19/HSS10/SA2/H/NGO/13553,8/10/2020 6:32:10 AM,Returnees,1373,1700,85,111,3269,1566,1341,534,439,3880
19,South Sudan (UNDP),2019,SSD-19/HSS10/SA2/H/NGO/13555,6/15/2020 6:21:05 AM,Host Communities,751,842,733,936,3262,1130,1250,1047,1198,4625
19,South Sudan (UNDP),2019,SSD-19/HSS10/SA2/H/NGO/13555,6/15/2020 6:21:05 AM,Internally Displaced People,2075,2387,2591,2635,9688,1203,1340,1300,1304,5147
19,South Sudan (UNDP),2019,SSD-19/HSS10/SA2/H/NGO/13555,6/15/2020 6:21:05 AM,Overall,3577,4076,4057,4482,16192,3460,3849,3397,3702,14408
19,South Sudan (UNDP),2019,SSD-19/HSS10/SA2/H/NGO/13555,6/15/2020 6:21:05 AM,Returnees,751,847,733,911,3242,1127,1259,1050,1200,4636
19,South Sudan (UNDP),2019,SSD-19/HSS10/SA2/H/NGO/13610,7/1/2020 6:59:37 AM,Host Communities,2798,3004,1643,1618,9063,3196,4140,3245,3225,13806
19,South Sudan (UNDP),2019,SSD-19/HSS10/SA2/H/NGO/13610,7/1/2020 6:59:37 AM,Internally Displaced People,4026,4324,2365,2328,13043,2509,5848,2748,3103,14208
19,South Sudan (UNDP),2019,SSD-19/HSS10/SA2/H/NGO/13610,7/1/2020 6:59:37 AM,Overall,6824,7328,4008,3946,22106,5705,9988,5993,6328,28014
19,South Sudan (UNDP),2019,SSD-19/HSS10/SA2/H/NGO/13636,7/17/2020 6:39:07 AM,Host Communities,1308,306,157,149,1920,1557,388,690,595,3230
19,South Sudan (UNDP),2019,SSD-19/HSS10/SA2/H/NGO/13636,7/17/2020 6:39:07 AM,Internally Displaced People,1248,1237,434,447,3366,1456,1953,895,974,5278
19,South Sudan (UNDP),2019,SSD-19/HSS10/SA2/H/NGO/13636,7/17/2020 6:39:07 AM,Overall,4283,4274,1070,1069,10696,5021,5497,2631,2582,15731
19,South Sudan (UNDP),2019,SSD-19/HSS10/SA2/H/NGO/13636,7/17/2020 6:39:07 AM,Returnees,1727,2731,479,473,5410,2008,3156,1046,1013,7223
19,South Sudan (UNDP),2019,SSD-19/HSS10/SA2/H/UN/13464,7/6/2020 10:09:19 AM,Host Communities,4585,5141,1668,2501,13895,1304,1605,2908,4212,10029
19,South Sudan (UNDP),2019,SSD-19/HSS10/SA2/H/UN/13464,7/6/2020 10:09:19 AM,Internally Displaced People,1146,1109,1509,1289,5053,2608,3209,5817,8424,20058
19,South Sudan (UNDP),2019,SSD-19/HSS10/SA2/H/UN/13464,7/6/2020 10:09:19 AM,Overall,6363,6945,3534,4211,21053,4347,5349,9694,14040,33430
19,South Sudan (UNDP),2019,SSD-19/HSS10/SA2/H/UN/13464,7/6/2020 10:09:19 AM,Returnees,632,695,357,421,2105,435,535,969,1404,3343
19,South Sudan (UNDP),2019,SSD-19/HSS10/SA2/H-N/NGO/13468,9/8/2020 9:49:19 AM,Host Communities,419,1912,10210,10261,22802,219,234,8230,8447,17130
19,South Sudan (UNDP),2019,SSD-19/HSS10/SA2/H-N/NGO/13468,9/8/2020 9:49:19 AM,Internally Displaced People,2744,3013,3761,4430,13948,589,1023,3500,3472,8584
19,South Sudan (UNDP),2019,SSD-19/HSS10/SA2/H-N/NGO/13468,9/8/2020 9:49:19 AM,Overall,3679,5719,14906,15744,40048,1042,1589,12230,13228,28089
19,South Sudan (UNDP),2019,SSD-19/HSS10/SA2/H-N/NGO/13468,9/8/2020 9:49:19 AM,Returnees,516,794,935,1053,3298,234,332,500,1309,2375
19,South Sudan (UNDP),2019,SSD-19/HSS10/SA2/H-N/NGO/13510,10/6/2020 6:54:56 AM,Host Communities,11400,10980,4000,4310,30690,10950,10800,3800,4120,29670
19,South Sudan (UNDP),2019,SSD-19/HSS10/SA2/H-N/NGO/13510,10/6/2020 6:54:56 AM,Internally Displaced People,300,220,382,299,1201,400,205,320,250,1175
19,South Sudan (UNDP),2019,SSD-19/HSS10/SA2/H-N/NGO/13510,10/6/2020 6:54:56 AM,Overall,18326,18035,6393,6709,49463,17910,17685,6120,6320,48035
19,South Sudan (UNDP),2019,SSD-19/HSS10/SA2/H-N/NGO/13510,10/6/2020 6:54:56 AM,Returnees,6626,6835,2011,2100,17572,6560,6680,2000,1950,17190
19,South Sudan (UNDP),2019,SSD-19/HSS10/SA2/H-N/UN/13644,5/13/2020 2:49:37 PM,Host Communities,15369,15591,11597,11790,54347,60494,58120,16080,15450,150144
19,South Sudan (UNDP),2019,SSD-19/HSS10/SA2/H-N/UN/13644,5/13/2020 2:49:37 PM,Internally Displaced People,45960,46624,34678,35260,162522,19059,18312,5066,4868,47305
19,South Sudan (UNDP),2019,SSD-19/HSS10/SA2/H-N/UN/13644,5/13/2020 2:49:37 PM,Overall,73538,74597,55485,56415,260035,82867,79617,22027,21165,205676
19,South Sudan (UNDP),2019,SSD-19/HSS10/SA2/H-N/UN/13644,5/13/2020 2:49:37 PM,Refugees,12209,12382,9210,9365,43166,3314,3185,881,847,8227
19,South Sudan (UNDP),2019,SSD-19/HSS10/SA2/H-N-P/INGO/13628,8/7/2020 8:01:06 AM,Host Communities,46667,109957,52287,54892,263803,59495,187598,5144,7347,259584
19,South Sudan (UNDP),2019,SSD-19/HSS10/SA2/H-N-P/INGO/13628,8/7/2020 8:01:06 AM,Internally Displaced People,6380,7874,2539,3351,20144,1100,2321,100,109,3630
19,South Sudan (UNDP),2019,SSD-19/HSS10/SA2/H-N-P/INGO/13628,8/7/2020 8:01:06 AM,Overall,53047,117831,54826,58243,283947,60595,189919,5244,7456,263214
19,South Sudan (UNDP),2019,SSD-19/HSS10/SA2/H-N-WASH/NGO/13454,6/29/2020 7:16:30 AM,Host Communities,10076,12577,6007,7200,35860,4413,8748,5391,7091,25643
19,South Sudan (UNDP),2019,SSD-19/HSS10/SA2/H-N-WASH/NGO/13454,6/29/2020 7:16:30 AM,Internally Displaced People,2532,4334,3130,3734,13730,812,3198,2682,3719,10411
19,South Sudan (UNDP),2019,SSD-19/HSS10/SA2/H-N-WASH/NGO/13454,6/29/2020 7:16:30 AM,Overall,12608,16911,9137,10934,49590,5225,11946,8073,10810,36054
19,South Sudan (UNDP),2019,SSD-19/HSS10/SA2/H-P-CCCM/NGO/13459,7/13/2020 9:08:02 AM,Host Communities,3045,5700,1726,4144,14615,3234,6340,1942,4824,16340
19,South Sudan (UNDP),2019,SSD-19/HSS10/SA2/H-P-CCCM/NGO/13459,7/13/2020 9:08:02 AM,Internally Displaced People,4419,6646,4297,5343,20705,5378,7966,4576,5737,23657
19,South Sudan (UNDP),2019,SSD-19/HSS10/SA2/H-P-CCCM/NGO/13459,7/13/2020 9:08:02 AM,Other,25,52,69,105,251,62,83,91,112,348
19,South Sudan (UNDP),2019,SSD-19/HSS10/SA2/H-P-CCCM/NGO/13459,7/13/2020 9:08:02 AM,Overall,7703,13247,6413,10109,37472,8928,15332,6997,11240,42497
19,South Sudan (UNDP),2019,SSD-19/HSS10/SA2/H-P-CCCM/NGO/13459,7/13/2020 9:08:02 AM,Returnees,214,849,321,517,1901,254,943,388,567,2152
19,South Sudan (UNDP),2019,SSD-19/HSS10/SA2/H-WASH/NGO/13460,7/8/2020 7:33:48 AM,Host Communities,429,765,704,1163,3061,934,1277,1312,1754,5277
19,South Sudan (UNDP),2019,SSD-19/HSS10/SA2/H-WASH/NGO/13460,7/8/2020 7:33:48 AM,Internally Displaced People,1071,1914,1760,2908,7653,1334,1654,1118,2118,6224
19,South Sudan (UNDP),2019,SSD-19/HSS10/SA2/H-WASH/NGO/13460,7/8/2020 7:33:48 AM,Overall,2143,3827,3520,5816,15306,2704,3536,3088,4744,14072
19,South Sudan (UNDP),2019,SSD-19/HSS10/SA2/H-WASH/NGO/13460,7/8/2020 7:33:48 AM,Returnees,643,1148,1056,1745,4592,436,605,658,872,2571
19,South Sudan (UNDP),2019,SSD-19/HSS10/SA2/H-WASH/NGO/13614,7/14/2020 6:47:59 AM,Host Communities,2603,3215,1167,1701,8686,3901,8364,3071,7105,22441
19,South Sudan (UNDP),2019,SSD-19/HSS10/SA2/H-WASH/NGO/13614,7/14/2020 6:47:59 AM,Internally Displaced People,5089,6560,2310,3618,17577,2341,5018,1842,4263,13464
19,South Sudan (UNDP),2019,SSD-19/HSS10/SA2/H-WASH/NGO/13614,7/14/2020 6:47:59 AM,Overall,10178,13120,4620,7236,35154,7802,16727,6141,14210,44880
19,South Sudan (UNDP),2019,SSD-19/HSS10/SA2/H-WASH/NGO/13614,7/14/2020 6:47:59 AM,Returnees,2486,3345,1143,1917,8891,1560,3345,1228,2842,8975
19,South Sudan (UNDP),2019,SSD-19/HSS10/SA2/L/UN/13492,5/12/2020 5:07:34 PM,Other,20,20,20,20,80,20,20,20,19,79
19,South Sudan (UNDP),2019,SSD-19/HSS10/SA2/L/UN/13492,5/12/2020 5:07:34 PM,Overall,20,20,20,20,80,20,20,20,19,79
19,South Sudan (UNDP),2019,SSD-19/HSS10/SA2/N/INGO/13450,6/10/2020 9:36:39 AM,Host Communities,30,3497,307,335,4169,28,5487,1111,1215,7841
19,South Sudan (UNDP),2019,SSD-19/HSS10/SA2/N/INGO/13450,6/10/2020 9:36:39 AM,Internally Displaced People,0,201,17,18,236,0,323,66,71,460
19,South Sudan (UNDP),2019,SSD-19/HSS10/SA2/N/INGO/13450,6/10/2020 9:36:39 AM,Overall,30,4106,361,391,4888,28,6456,1308,1429,9221
19,South Sudan (UNDP),2019,SSD-19/HSS10/SA2/N/INGO/13450,6/10/2020 9:36:39 AM,Returnees,0,408,37,38,483,0,646,131,143,920
19,South Sudan (UNDP),2019,SSD-19/HSS10/SA2/N/INGO/13477,7/1/2020 6:34:52 AM,Host Communities,49,2440,1087,1179,4755,46,3829,821,883,5579
19,South Sudan (UNDP),2019,SSD-19/HSS10/SA2/N/INGO/13477,7/1/2020 6:34:52 AM,Internally Displaced People,0,135,60,65,260,2,212,45,49,308
19,South Sudan (UNDP),2019,SSD-19/HSS10/SA2/N/INGO/13477,7/1/2020 6:34:52 AM,Overall,49,2711,1208,1310,5278,51,4254,912,981,6198
19,South Sudan (UNDP),2019,SSD-19/HSS10/SA2/N/INGO/13477,7/1/2020 6:34:52 AM,Returnees,0,136,61,66,263,3,213,46,49,311
19,South Sudan (UNDP),2019,SSD-19/HSS10/SA2/N/INGO/13656,10/28/2020 6:29:56 AM,Host Communities,0,0,374,406,780,0,0,1545,1557,3102
19,South Sudan (UNDP),2019,SSD-19/HSS10/SA2/N/INGO/13656,10/28/2020 6:29:56 AM,Internally Displaced People,0,0,250,270,520,0,505,108,99,712
19,South Sudan (UNDP),2019,SSD-19/HSS10/SA2/N/INGO/13656,10/28/2020 6:29:56 AM,Overall,0,0,624,676,1300,0,505,1653,1656,3814
19,South Sudan (UNDP),2019,SSD-19/HSS10/SA2/N/INGO/13669,6/16/2020 4:09:08 AM,Host Communities,1126,3234,2717,2939,10016,1787,7338,7164,8118,24407
19,South Sudan (UNDP),2019,SSD-19/HSS10/SA2/N/INGO/13669,6/16/2020 4:09:08 AM,Internally Displaced People,698,1741,1463,1589,5491,364,2446,346,360,3516
19,South Sudan (UNDP),2019,SSD-19/HSS10/SA2/N/INGO/13669,6/16/2020 4:09:08 AM,Overall,1824,4975,4180,4528,15507,2151,9784,7510,8478,27923
19,South Sudan (UNDP),2019,SSD-19/HSS10/SA2/N/UN/13668,10/6/2020 7:55:59 AM,Internally Displaced People,7825,7223,1721,1822,18591,5760,17993,1437,1251,26441
19,South Sudan (UNDP),2019,SSD-19/HSS10/SA2/N/UN/13668,10/6/2020 7:55:59 AM,Overall,7825,7223,1721,1822,18591,5760,17993,1437,1251,26441
19,South Sudan (UNDP),2019,SSD-19/HSS10/SA2/NFI/INGO/13452,6/22/2020 6:49:45 AM,Host Communities,158,225,358,382,1123,2720,3082,2621,3077,11500
19,South Sudan (UNDP),2019,SSD-19/HSS10/SA2/NFI/INGO/13452,6/22/2020 6:49:45 AM,Internally Displaced People,912,1303,2085,2215,6515,1516,1728,1546,1719,6509
19,South Sudan (UNDP),2019,SSD-19/HSS10/SA2/NFI/INGO/13452,6/22/2020 6:49:45 AM,Overall,1573,2247,3593,3820,11233,4658,5387,4625,5355,20025
19,South Sudan (UNDP),2019,SSD-19/HSS10/SA2/NFI/INGO/13452,6/22/2020 6:49:45 AM,Returnees,503,719,1150,1223,3595,422,577,458,559,2016
19,South Sudan (UNDP),2019,SSD-19/HSS10/SA2/NFI/INGO/13483,8/4/2020 7:12:01 AM,Internally Displaced People,975,1124,959,961,4019,1979,2004,2018,1905,7906
19,South Sudan (UNDP),2019,SSD-19/HSS10/SA2/NFI/INGO/13483,8/4/2020 7:12:01 AM,Overall,2771,2874,2658,2697,11000,2671,2869,3063,3023,11626
19,South Sudan (UNDP),2019,SSD-19/HSS10/SA2/NFI/INGO/13483,8/4/2020 7:12:01 AM,Returnees,1796,1750,1699,1736,6981,692,865,1045,1118,3720
19,South Sudan (UNDP),2019,SSD-19/HSS10/SA2/NFI/INGO/13551,6/12/2020 6:42:46 AM,Host Communities,213,248,229,256,946,511,557,524,573,2165
19,South Sudan (UNDP),2019,SSD-19/HSS10/SA2/NFI/INGO/13551,6/12/2020 6:42:46 AM,Internally Displaced People,1477,1594,1411,1551,6033,3142,3402,3152,3394,13090
19,South Sudan (UNDP),2019,SSD-19/HSS10/SA2/NFI/INGO/13551,6/12/2020 6:42:46 AM,Overall,2296,2547,2227,2430,9500,4871,5207,4776,5143,19997
19,South Sudan (UNDP),2019,SSD-19/HSS10/SA2/NFI/INGO/13551,6/12/2020 6:42:46 AM,Returnees,606,705,587,623,2521,1218,1248,1100,1176,4742
19,South Sudan (UNDP),2019,SSD-19/HSS10/SA2/NFI/INGO/13554,6/5/2020 6:40:28 AM,Host Communities,392,408,588,612,2000,4313,5088,5708,6139,21248
19,South Sudan (UNDP),2019,SSD-19/HSS10/SA2/NFI/INGO/13554,6/5/2020 6:40:28 AM,Internally Displaced People,784,816,1176,1224,4000,275,325,364,392,1356
19,South Sudan (UNDP),2019,SSD-19/HSS10/SA2/NFI/INGO/13554,6/5/2020 6:40:28 AM,Overall,1960,2040,2940,3060,10000,4588,5413,6072,6531,22604
19,South Sudan (UNDP),2019,SSD-19/HSS10/SA2/NFI/INGO/13554,6/5/2020 6:40:28 AM,Returnees,784,816,1176,1224,4000,0,0,0,0,0
19,South Sudan (UNDP),2019,SSD-19/HSS10/SA2/NFI/INGO/13621,8/4/2020 6:42:29 AM,Internally Displaced People,535,681,867,1067,3150,458,570,704,825,2557
19,South Sudan (UNDP),2019,SSD-19/HSS10/SA2/NFI/INGO/13621,8/4/2020 6:42:29 AM,Overall,764,973,1239,1524,4500,718,1078,1358,1368,4522
19,South Sudan (UNDP),2019,SSD-19/HSS10/SA2/NFI/INGO/13621,8/4/2020 6:42:29 AM,Returnees,229,292,372,457,1350,260,508,654,543,1965
19,South Sudan (UNDP),2019,SSD-19/HSS10/SA2/NFI/INGO/13638,6/8/2020 8:16:12 AM,Host Communities,203,337,405,405,1350,2922,3113,3690,4012,13737
19,South Sudan (UNDP),2019,SSD-19/HSS10/SA2/NFI/INGO/13638,6/8/2020 8:16:12 AM,Internally Displaced People,9514,9980,15979,15346,50819,5731,5633,9360,9248,29972
19,South Sudan (UNDP),2019,SSD-19/HSS10/SA2/NFI/INGO/13638,6/8/2020 8:16:12 AM,Overall,10223,11160,17397,16764,55544,10483,10527,15864,16229,53103
19,South Sudan (UNDP),2019,SSD-19/HSS10/SA2/NFI/INGO/13638,6/8/2020 8:16:12 AM,Returnees,506,843,1013,1013,3375,1830,1781,2814,2969,9394
19,South Sudan (UNDP),2019,SSD-19/HSS10/SA2/NFI/NGO/13427,6/10/2020 5:34:35 AM,Host Communities,145,290,339,436,1210,140,261,369,565,1335
19,South Sudan (UNDP),2019,SSD-19/HSS10/SA2/NFI/NGO/13427,6/10/2020 5:34:35 AM,Internally Displaced People,581,1162,1355,1742,4840,3053,3511,1934,1914,10412
19,South Sudan (UNDP),2019,SSD-19/HSS10/SA2/NFI/NGO/13427,6/10/2020 5:34:35 AM,Overall,726,1452,1694,2178,6050,3193,3772,2303,2479,11747
19,South Sudan (UNDP),2019,SSD-19/HSS10/SA2/NFI/NGO/13467,8/4/2020 7:14:36 AM,Host Communities,172,364,187,250,973,490,332,70,176,1068
19,South Sudan (UNDP),2019,SSD-19/HSS10/SA2/NFI/NGO/13467,8/4/2020 7:14:36 AM,Internally Displaced People,574,1212,624,840,3250,1040,1498,210,320,3068
19,South Sudan (UNDP),2019,SSD-19/HSS10/SA2/NFI/NGO/13467,8/4/2020 7:14:36 AM,Overall,1147,2425,1247,1681,6500,2150,3200,460,690,6500
19,South Sudan (UNDP),2019,SSD-19/HSS10/SA2/NFI/NGO/13467,8/4/2020 7:14:36 AM,Returnees,401,849,436,591,2277,620,1370,180,194,2364
19,South Sudan (UNDP),2019,SSD-19/HSS10/SA2/NFI/NGO/13489,7/23/2020 8:46:55 AM,Host Communities,65,195,195,195,650,60,180,180,180,600
19,South Sudan (UNDP),2019,SSD-19/HSS10/SA2/NFI/NGO/13489,7/23/2020 8:46:55 AM,Internally Displaced People,486,1463,1463,1463,4875,449,1350,1349,1350,4498
19,South Sudan (UNDP),2019,SSD-19/HSS10/SA2/NFI/NGO/13489,7/23/2020 8:46:55 AM,Overall,649,1951,1950,1950,6500,599,1800,1799,1800,5998
19,South Sudan (UNDP),2019,SSD-19/HSS10/SA2/NFI/NGO/13489,7/23/2020 8:46:55 AM,Returnees,98,293,292,292,975,90,270,270,270,900
19,South Sudan (UNDP),2019,SSD-19/HSS10/SA2/NFI/NGO/13622,7/23/2020 8:42:46 AM,Host Communities,93,285,128,133,639,513,720,678,704,2615
19,South Sudan (UNDP),2019,SSD-19/HSS10/SA2/NFI/NGO/13622,7/23/2020 8:42:46 AM,Internally Displaced People,893,2360,663,580,4496,718,873,789,870,3250
19,South Sudan (UNDP),2019,SSD-19/HSS10/SA2/NFI/NGO/13622,7/23/2020 8:42:46 AM,Other,72,141,63,70,346,9,13,26,33,81
19,South Sudan (UNDP),2019,SSD-19/HSS10/SA2/NFI/NGO/13622,7/23/2020 8:42:46 AM,Overall,1486,3781,1150,1083,7500,1450,1718,1608,1724,6500
19,South Sudan (UNDP),2019,SSD-19/HSS10/SA2/NFI/NGO/13622,7/23/2020 8:42:46 AM,Returnees,428,995,296,300,2019,210,112,115,117,554
19,South Sudan (UNDP),2019,SSD-19/HSS10/SA2/NFI/UN/13487,6/10/2020 5:39:35 AM,Internally Displaced People,2764,3243,2841,3152,12000,3211,4381,3532,4080,15204
19,South Sudan (UNDP),2019,SSD-19/HSS10/SA2/NFI/UN/13487,6/10/2020 5:39:35 AM,Overall,3685,4324,3788,4203,16000,3837,5140,4046,4792,17815
19,South Sudan (UNDP),2019,SSD-19/HSS10/SA2/NFI/UN/13487,6/10/2020 5:39:35 AM,Returnees,921,1081,947,1051,4000,626,759,514,712,2611
19,South Sudan (UNDP),2019,SSD-19/HSS10/SA2/NFI-WASH/NGO/13433,10/14/2020 7:20:12 PM,Host Communities,380,668,228,519,1795,258,391,369,512,1530
19,South Sudan (UNDP),2019,SSD-19/HSS10/SA2/NFI-WASH/NGO/13433,10/14/2020 7:20:12 PM,Internally Displaced People,2467,4410,1481,3439,11797,1374,2031,2152,2942,8499
19,South Sudan (UNDP),2019,SSD-19/HSS10/SA2/NFI-WASH/NGO/13433,10/14/2020 7:20:12 PM,Overall,3798,6682,2280,5186,17946,2581,3909,3694,5120,15304
19,South Sudan (UNDP),2019,SSD-19/HSS10/SA2/NFI-WASH/NGO/13433,10/14/2020 7:20:12 PM,Returnees,951,1604,571,1228,4354,949,1487,1173,1666,5275
19,South Sudan (UNDP),2019,SSD-19/HSS10/SA2/N-FSL/NGO/13439,10/14/2020 6:54:40 PM,Host Communities,2700,7317,1969,2192,14178,148,871,98,103,1220
19,South Sudan (UNDP),2019,SSD-19/HSS10/SA2/N-FSL/NGO/13439,10/14/2020 6:54:40 PM,Internally Displaced People,2700,4289,1256,1861,10106,148,871,98,103,1220
19,South Sudan (UNDP),2019,SSD-19/HSS10/SA2/N-FSL/NGO/13439,10/14/2020 6:54:40 PM,Overall,7200,14695,4361,5774,32030,390,2291,257,272,3210
19,South Sudan (UNDP),2019,SSD-19/HSS10/SA2/N-FSL/NGO/13439,10/14/2020 6:54:40 PM,Returnees,1800,3089,1136,1721,7746,94,549,61,66,770
19,South Sudan (UNDP),2019,SSD-19/HSS10/SA2/N-FSL-H-P/INGO/13351,8/12/2020 8:49:31 AM,Host Communities,38160,65648,19048,23377,146233,10112,90126,42502,42612,185352
19,South Sudan (UNDP),2019,SSD-19/HSS10/SA2/N-FSL-H-P/INGO/13351,8/12/2020 8:49:31 AM,Internally Displaced People,1332,4194,1264,2205,8995,857,3581,541,1272,6251
19,South Sudan (UNDP),2019,SSD-19/HSS10/SA2/N-FSL-H-P/INGO/13351,8/12/2020 8:49:31 AM,Overall,39492,69842,20312,25582,155228,10969,93707,43043,43884,191603
19,South Sudan (UNDP),2019,SSD-19/HSS10/SA2/N-H/INGO/13647,6/17/2020 10:05:24 AM,Host Communities,4609,6589,4655,4862,20715,3168,9179,8684,9923,30954
19,South Sudan (UNDP),2019,SSD-19/HSS10/SA2/N-H/INGO/13647,6/17/2020 10:05:24 AM,Internally Displaced People,1895,2821,1850,1962,8528,1357,3935,3722,4254,13268
19,South Sudan (UNDP),2019,SSD-19/HSS10/SA2/N-H/INGO/13647,6/17/2020 10:05:24 AM,Overall,6504,9410,6505,6824,29243,4525,13114,12406,14177,44222
19,South Sudan (UNDP),2019,SSD-19/HSS10/SA2/N-H/NGO/13399,8/3/2020 7:30:38 AM,Internally Displaced People,7225,9378,2536,3688,22827,7536,8478,5620,6349,27983
19,South Sudan (UNDP),2019,SSD-19/HSS10/SA2/N-H/NGO/13399,8/3/2020 7:30:38 AM,Other,0,1813,590,644,3047,0,2128,667,704,3499
19,South Sudan (UNDP),2019,SSD-19/HSS10/SA2/N-H/NGO/13399,8/3/2020 7:30:38 AM,Overall,7225,11191,3126,4332,25874,7536,10606,6287,7053,31482
19,South Sudan (UNDP),2019,SSD-19/HSS10/SA2/N-H-P/UN/13559,7/12/2020 8:18:00 PM,Host Communities,9242,28908,16736,16468,71354,9274,14642,3879,5004,32799
19,South Sudan (UNDP),2019,SSD-19/HSS10/SA2/N-H-P/UN/13559,7/12/2020 8:18:00 PM,Internally Displaced People,2115,2385,4230,4770,13500,5314,3950,2576,2476,14316
19,South Sudan (UNDP),2019,SSD-19/HSS10/SA2/N-H-P/UN/13559,7/12/2020 8:18:00 PM,Overall,12062,32088,22376,22828,89354,14871,18992,7055,7980,48898
19,South Sudan (UNDP),2019,SSD-19/HSS10/SA2/N-H-P/UN/13559,7/12/2020 8:18:00 PM,Returnees,705,795,1410,1590,4500,283,400,600,500,1783
19,South Sudan (UNDP),2019,SSD-19/HSS10/SA2/N-P-NFI/INGO/13392,6/16/2020 4:11:59 AM,Host Communities,1706,7665,9711,10448,29530,2934,8662,5289,5422,22307
19,South Sudan (UNDP),2019,SSD-19/HSS10/SA2/N-P-NFI/INGO/13392,6/16/2020 4:11:59 AM,Internally Displaced People,990,1031,1032,1073,4126,1354,2111,1362,1483,6310
19,South Sudan (UNDP),2019,SSD-19/HSS10/SA2/N-P-NFI/INGO/13392,6/16/2020 4:11:59 AM,Overall,2696,8696,10743,11521,33656,4288,10773,6651,6905,28617
19,South Sudan (UNDP),2019,SSD-19/HSS10/SA2/N-WASH/INGO/13472,7/15/2020 11:16:08 AM,Host Communities,2685,4265,8020,7771,22741,7737,18448,12947,13486,52618
19,South Sudan (UNDP),2019,SSD-19/HSS10/SA2/N-WASH/INGO/13472,7/15/2020 11:16:08 AM,Internally Displaced People,316,980,1317,1506,4119,276,659,462,482,1879
19,South Sudan (UNDP),2019,SSD-19/HSS10/SA2/N-WASH/INGO/13472,7/15/2020 11:16:08 AM,Overall,3159,5416,9705,9676,27956,8127,19378,13599,14167,55271
19,South Sudan (UNDP),2019,SSD-19/HSS10/SA2/N-WASH/INGO/13472,7/15/2020 11:16:08 AM,Returnees,158,171,368,399,1096,114,271,190,199,774
19,South Sudan (UNDP),2019,SSD-19/HSS10/SA2/P/INGO/13408,6/12/2020 10:57:15 PM,Host Communities,98,224,100,186,608,51,550,117,440,1158
19,South Sudan (UNDP),2019,SSD-19/HSS10/SA2/P/INGO/13408,6/12/2020 10:57:15 PM,Internally Displaced People,731,1769,640,1629,4769,349,2369,317,1796,4831
19,South Sudan (UNDP),2019,SSD-19/HSS10/SA2/P/INGO/13408,6/12/2020 10:57:15 PM,Overall,1304,2722,1200,2466,7692,733,4223,696,2716,8368
19,South Sudan (UNDP),2019,SSD-19/HSS10/SA2/P/INGO/13408,6/12/2020 10:57:15 PM,Returnees,475,729,460,651,2315,333,1304,262,480,2379
19,South Sudan (UNDP),2019,SSD-19/HSS10/SA2/P/INGO/13476,10/14/2020 6:25:44 PM,Host Communities,2630,4850,4480,6730,18690,1114,278,56,44,1492
19,South Sudan (UNDP),2019,SSD-19/HSS10/SA2/P/INGO/13476,10/14/2020 6:25:44 PM,Internally Displaced People,1430,2650,2450,3664,10194,0,0,0,0,0
19,South Sudan (UNDP),2019,SSD-19/HSS10/SA2/P/INGO/13476,10/14/2020 6:25:44 PM,Overall,4786,8820,8150,12224,33980,1114,278,56,44,1492
19,South Sudan (UNDP),2019,SSD-19/HSS10/SA2/P/INGO/13476,10/14/2020 6:25:44 PM,Returnees,726,1320,1220,1830,5096,0,0,0,0,0
19,South Sudan (UNDP),2019,SSD-19/HSS10/SA2/P/INGO/13521,7/22/2020 4:30:29 PM,Host Communities,819,2082,669,970,4540,4486,8429,4637,10498,28050
19,South Sudan (UNDP),2019,SSD-19/HSS10/SA2/P/INGO/13521,7/22/2020 4:30:29 PM,Internally Displaced People,3892,7161,3308,3709,18070,2610,4879,3444,4074,15007
19,South Sudan (UNDP),2019,SSD-19/HSS10/SA2/P/INGO/13521,7/22/2020 4:30:29 PM,Overall,5725,10720,5046,5749,27240,8506,16547,10118,17126,52297
19,South Sudan (UNDP),2019,SSD-19/HSS10/SA2/P/INGO/13521,7/22/2020 4:30:29 PM,Returnees,1014,1477,1069,1070,4630,1410,3239,2037,2554,9240
19,South Sudan (UNDP),2019,SSD-19/HSS10/SA2/P/INGO/13547,6/16/2020 10:26:14 PM,Host Communities,169,166,300,240,875,468,642,621,688,2419
19,South Sudan (UNDP),2019,SSD-19/HSS10/SA2/P/INGO/13547,6/16/2020 10:26:14 PM,Internally Displaced People,402,395,720,583,2100,1308,1425,1742,1904,6379
19,South Sudan (UNDP),2019,SSD-19/HSS10/SA2/P/INGO/13547,6/16/2020 10:26:14 PM,Overall,671,659,1200,970,3500,1874,2178,2491,2728,9271
19,South Sudan (UNDP),2019,SSD-19/HSS10/SA2/P/INGO/13547,6/16/2020 10:26:14 PM,Returnees,100,98,180,147,525,98,111,128,136,473
19,South Sudan (UNDP),2019,SSD-19/HSS10/SA2/P/INGO/13561,9/25/2020 9:59:12 AM,Host Communities,62,1182,215,921,2380,70,615,175,525,1385
19,South Sudan (UNDP),2019,SSD-19/HSS10/SA2/P/INGO/13561,9/25/2020 9:59:12 AM,Internally Displaced People,150,1357,232,1006,2745,120,925,125,600,1770
19,South Sudan (UNDP),2019,SSD-19/HSS10/SA2/P/INGO/13561,9/25/2020 9:59:12 AM,Overall,276,2775,532,2295,5878,193,1565,310,1137,3205
19,South Sudan (UNDP),2019,SSD-19/HSS10/SA2/P/INGO/13561,9/25/2020 9:59:12 AM,Returnees,64,236,85,368,753,3,25,10,12,50
19,South Sudan (UNDP),2019,SSD-19/HSS10/SA2/P/INGO/13606,11/5/2020 11:23:06 AM,Host Communities,1110,1230,1470,1590,5400,1577,1818,2008,1991,7394
19,South Sudan (UNDP),2019,SSD-19/HSS10/SA2/P/INGO/13606,11/5/2020 11:23:06 AM,Internally Displaced People,2190,2670,3630,4110,12600,2317,2919,3708,3880,12824
19,South Sudan (UNDP),2019,SSD-19/HSS10/SA2/P/INGO/13606,11/5/2020 11:23:06 AM,Overall,3300,3900,5100,5700,18000,3894,4737,5716,5871,20218
19,South Sudan (UNDP),2019,SSD-19/HSS10/SA2/P/INGO/13645,7/7/2020 10:56:09 PM,Host Communities,508,1196,628,658,2990,832,792,237,175,2036
19,South Sudan (UNDP),2019,SSD-19/HSS10/SA2/P/INGO/13645,7/7/2020 10:56:09 PM,Internally Displaced People,1270,2989,1569,1644,7472,1889,1728,540,374,4531
19,South Sudan (UNDP),2019,SSD-19/HSS10/SA2/P/INGO/13645,7/7/2020 10:56:09 PM,Overall,2540,5978,3138,3288,14944,3992,3692,1133,801,9618
19,South Sudan (UNDP),2019,SSD-19/HSS10/SA2/P/INGO/13645,7/7/2020 10:56:09 PM,Returnees,762,1793,941,986,4482,1271,1172,356,252,3051
19,South Sudan (UNDP),2019,SSD-19/HSS10/SA2/P/NGO/13353,7/13/2020 3:06:25 PM,Host Communities,400,500,256,244,1400,631,718,322,300,1971
19,South Sudan (UNDP),2019,SSD-19/HSS10/SA2/P/NGO/13353,7/13/2020 3:06:25 PM,Internally Displaced People,1700,3300,1700,1576,8276,2000,4300,532,476,7308
19,South Sudan (UNDP),2019,SSD-19/HSS10/SA2/P/NGO/13353,7/13/2020 3:06:25 PM,Overall,2900,4800,2556,2320,12576,3831,6718,1154,1174,12877
19,South Sudan (UNDP),2019,SSD-19/HSS10/SA2/P/NGO/13353,7/13/2020 3:06:25 PM,Returnees,800,1000,600,500,2900,1200,1700,300,398,3598
19,South Sudan (UNDP),2019,SSD-19/HSS10/SA2/P/NGO/13368,7/15/2020 2:41:40 AM,Host Communities,1400,1400,350,350,3500,685,916,402,1377,3380
19,South Sudan (UNDP),2019,SSD-19/HSS10/SA2/P/NGO/13368,7/15/2020 2:41:40 AM,Internally Displaced People,1700,1700,400,400,4200,733,989,674,344,2740
19,South Sudan (UNDP),2019,SSD-19/HSS10/SA2/P/NGO/13368,7/15/2020 2:41:40 AM,Overall,3100,3100,750,750,7700,1418,1905,1076,1721,6120
19,South Sudan (UNDP),2019,SSD-19/HSS10/SA2/P/NGO/13407,7/23/2020 8:15:17 PM,Host Communities,870,1460,2200,2160,6690,962,1330,1240,1430,4962
19,South Sudan (UNDP),2019,SSD-19/HSS10/SA2/P/NGO/13407,7/23/2020 8:15:17 PM,Internally Displaced People,530,1750,2240,2300,6820,976,1338,1246,1421,4981
19,South Sudan (UNDP),2019,SSD-19/HSS10/SA2/P/NGO/13407,7/23/2020 8:15:17 PM,Overall,2020,4180,5900,5900,18000,2913,4008,3740,4290,14951
19,South Sudan (UNDP),2019,SSD-19/HSS10/SA2/P/NGO/13407,7/23/2020 8:15:17 PM,Returnees,620,970,1460,1440,4490,975,1340,1254,1439,5008
19,South Sudan (UNDP),2019,SSD-19/HSS10/SA2/P/NGO/13420,5/12/2020 11:38:48 PM,Host Communities,1350,2250,1440,1560,6600,1560,2409,1696,1410,7075
19,South Sudan (UNDP),2019,SSD-19/HSS10/SA2/P/NGO/13420,5/12/2020 11:38:48 PM,Internally Displaced People,1800,3000,1920,2080,8800,2081,3212,2261,1881,9435
19,South Sudan (UNDP),2019,SSD-19/HSS10/SA2/P/NGO/13420,5/12/2020 11:38:48 PM,Overall,4500,7500,4800,5200,22000,5202,8031,5653,4702,23588
19,South Sudan (UNDP),2019,SSD-19/HSS10/SA2/P/NGO/13420,5/12/2020 11:38:48 PM,Returnees,1350,2250,1440,1560,6600,1561,2410,1696,1411,7078
19,South Sudan (UNDP),2019,SSD-19/HSS10/SA2/P/NGO/13432,5/25/2020 10:32:44 PM,Host Communities,530,450,1700,1867,4547,516,456,1690,1948,4610
19,South Sudan (UNDP),2019,SSD-19/HSS10/SA2/P/NGO/13432,5/25/2020 10:32:44 PM,Internally Displaced People,265,250,1193,1279,2987,313,285,1191,1343,3132
19,South Sudan (UNDP),2019,SSD-19/HSS10/SA2/P/NGO/13432,5/25/2020 10:32:44 PM,Other,392,393,0,0,785,390,398,0,0,788
19,South Sudan (UNDP),2019,SSD-19/HSS10/SA2/P/NGO/13432,5/25/2020 10:32:44 PM,Overall,1317,1178,3443,3683,9621,1361,1271,3434,3981,10047
19,South Sudan (UNDP),2019,SSD-19/HSS10/SA2/P/NGO/13432,5/25/2020 10:32:44 PM,Returnees,130,85,550,537,1302,142,132,553,690,1517
19,South Sudan (UNDP),2019,SSD-19/HSS10/SA2/P/NGO/13445,9/8/2020 10:00:01 AM,Host Communities,3840,2560,5760,3840,16000,3254,2579,4541,3145,13519
19,South Sudan (UNDP),2019,SSD-19/HSS10/SA2/P/NGO/13445,9/8/2020 10:00:01 AM,Internally Displaced People,2880,1920,4320,2880,12000,2441,1934,3405,2359,10139
19,South Sudan (UNDP),2019,SSD-19/HSS10/SA2/P/NGO/13445,9/8/2020 10:00:01 AM,Overall,9600,6400,14400,9600,40000,8316,6448,11352,7862,33978
19,South Sudan (UNDP),2019,SSD-19/HSS10/SA2/P/NGO/13445,9/8/2020 10:00:01 AM,Returnees,2880,1920,4320,2880,12000,2621,1935,3406,2358,10320
19,South Sudan (UNDP),2019,SSD-19/HSS10/SA2/P/NGO/13455,6/29/2020 9:59:52 PM,Host Communities,150,400,150,223,923,93,414,127,231,865
19,South Sudan (UNDP),2019,SSD-19/HSS10/SA2/P/NGO/13455,6/29/2020 9:59:52 PM,Internally Displaced People,200,646,300,700,1846,216,675,302,710,1903
19,South Sudan (UNDP),2019,SSD-19/HSS10/SA2/P/NGO/13455,6/29/2020 9:59:52 PM,Overall,550,1692,750,1623,4615,501,1720,575,1482,4278
19,South Sudan (UNDP),2019,SSD-19/HSS10/SA2/P/NGO/13455,6/29/2020 9:59:52 PM,Returnees,200,646,300,700,1846,192,631,146,541,1510
19,South Sudan (UNDP),2019,SSD-19/HSS10/SA2/P/NGO/13523,6/16/2020 10:16:19 PM,Host Communities,350,900,50,170,1470,120,947,40,448,1555
19,South Sudan (UNDP),2019,SSD-19/HSS10/SA2/P/NGO/13523,6/16/2020 10:16:19 PM,Internally Displaced People,550,1350,150,320,2370,340,1386,110,740,2576
19,South Sudan (UNDP),2019,SSD-19/HSS10/SA2/P/NGO/13523,6/16/2020 10:16:19 PM,Other,140,250,70,140,600,80,210,75,90,455
19,South Sudan (UNDP),2019,SSD-19/HSS10/SA2/P/NGO/13523,6/16/2020 10:16:19 PM,Overall,1328,2972,340,870,5510,631,2893,305,1397,5226
19,South Sudan (UNDP),2019,SSD-19/HSS10/SA2/P/NGO/13523,6/16/2020 10:16:19 PM,Returnees,288,472,70,240,1070,91,350,80,119,640
19,South Sudan (UNDP),2019,SSD-19/HSS10/SA2/P/NGO/13534,11/27/2020 1:00:56 PM,Host Communities,200,300,100,200,800,1101,1666,96,144,3007
19,South Sudan (UNDP),2019,SSD-19/HSS10/SA2/P/NGO/13534,11/27/2020 1:00:56 PM,Internally Displaced People,420,540,208,328,1496,1241,1925,101,209,3476
19,South Sudan (UNDP),2019,SSD-19/HSS10/SA2/P/NGO/13534,11/27/2020 1:00:56 PM,Overall,1620,2240,722,1118,5700,2609,4132,252,446,7439
19,South Sudan (UNDP),2019,SSD-19/HSS10/SA2/P/NGO/13534,11/27/2020 1:00:56 PM,Refugees,100,200,100,100,500,17,81,9,17,124
19,South Sudan (UNDP),2019,SSD-19/HSS10/SA2/P/NGO/13534,11/27/2020 1:00:56 PM,Returnees,900,1200,314,490,2904,250,460,46,76,832
19,South Sudan (UNDP),2019,SSD-19/HSS10/SA2/P/NGO/13550,7/1/2020 7:52:37 PM,Host Communities,667,1135,725,894,3421,779,1412,741,937,3869
19,South Sudan (UNDP),2019,SSD-19/HSS10/SA2/P/NGO/13550,7/1/2020 7:52:37 PM,Internally Displaced People,281,843,255,421,1800,321,892,371,435,2019
19,South Sudan (UNDP),2019,SSD-19/HSS10/SA2/P/NGO/13550,7/1/2020 7:52:37 PM,Overall,1070,2540,1233,1593,6436,1281,2883,1500,1676,7340
19,South Sudan (UNDP),2019,SSD-19/HSS10/SA2/P/NGO/13550,7/1/2020 7:52:37 PM,Returnees,122,562,253,278,1215,181,579,388,304,1452
19,South Sudan (UNDP),2019,SSD-19/HSS10/SA2/P/NGO/13615,6/29/2020 11:00:48 PM,Host Communities,150,1242,250,600,2242,95,1045,263,300,1703
19,South Sudan (UNDP),2019,SSD-19/HSS10/SA2/P/NGO/13615,6/29/2020 11:00:48 PM,Internally Displaced People,400,1000,390,550,2340,238,835,148,297,1518
19,South Sudan (UNDP),2019,SSD-19/HSS10/SA2/P/NGO/13615,6/29/2020 11:00:48 PM,Overall,570,3072,660,1680,5982,391,2380,464,865,4100
19,South Sudan (UNDP),2019,SSD-19/HSS10/SA2/P/NGO/13615,6/29/2020 11:00:48 PM,Returnees,20,830,20,530,1400,58,500,53,268,879
19,South Sudan (UNDP),2019,SSD-19/HSS10/SA2/P-E/INGO/13514,10/14/2020 7:43:38 AM,Host Communities,490,772,1464,976,3702,406,620,2434,1216,4676
19,South Sudan (UNDP),2019,SSD-19/HSS10/SA2/P-E/INGO/13514,10/14/2020 7:43:38 AM,Internally Displaced People,1467,2065,1571,1084,6187,363,1187,1397,494,3441
19,South Sudan (UNDP),2019,SSD-19/HSS10/SA2/P-E/INGO/13514,10/14/2020 7:43:38 AM,Other,40,65,0,0,105,30,30,0,0,60
19,South Sudan (UNDP),2019,SSD-19/HSS10/SA2/P-E/INGO/13514,10/14/2020 7:43:38 AM,Overall,2161,3066,3035,2060,10322,1026,1950,5831,2400,11207
19,South Sudan (UNDP),2019,SSD-19/HSS10/SA2/P-E/INGO/13514,10/14/2020 7:43:38 AM,Returnees,164,164,0,0,328,227,113,2000,690,3030
19,South Sudan (UNDP),2019,SSD-19/HSS10/SA2/P-FSL/NGO/13374,6/15/2020 7:37:08 AM,Host Communities,10393,14595,3649,7852,36489,9300,14430,3600,6800,34130
19,South Sudan (UNDP),2019,SSD-19/HSS10/SA2/P-FSL/NGO/13374,6/15/2020 7:37:08 AM,Internally Displaced People,1155,1622,406,872,4055,950,1600,400,840,3790
19,South Sudan (UNDP),2019,SSD-19/HSS10/SA2/P-FSL/NGO/13374,6/15/2020 7:37:08 AM,Overall,11548,16217,4055,8724,40544,10250,16030,4000,7640,37920
19,South Sudan (UNDP),2019,SSD-19/HSS10/SA2/P-H/INGO/13478,7/7/2020 10:22:11 PM,Host Communities,3250,4144,1460,1566,10420,2620,3995,1480,1982,10077
19,South Sudan (UNDP),2019,SSD-19/HSS10/SA2/P-H/INGO/13478,7/7/2020 10:22:11 PM,Internally Displaced People,4736,6479,1885,1991,15091,2767,4164,1663,3254,11848
19,South Sudan (UNDP),2019,SSD-19/HSS10/SA2/P-H/INGO/13478,7/7/2020 10:22:11 PM,Overall,8844,11674,3811,4023,28352,6098,9075,3616,5684,24473
19,South Sudan (UNDP),2019,SSD-19/HSS10/SA2/P-H/INGO/13478,7/7/2020 10:22:11 PM,Returnees,858,1051,466,466,2841,711,916,473,448,2548
19,South Sudan (UNDP),2019,SSD-19/HSS10/SA2/P-H-NFI/NGO/13560,6/16/2020 11:08:54 AM,Host Communities,3000,3800,640,945,8385,3500,4562,800,1200,10062
19,South Sudan (UNDP),2019,SSD-19/HSS10/SA2/P-H-NFI/NGO/13560,6/16/2020 11:08:54 AM,Internally Displaced People,1370,2860,640,1310,6180,2000,2900,800,1400,7100
19,South Sudan (UNDP),2019,SSD-19/HSS10/SA2/P-H-NFI/NGO/13560,6/16/2020 11:08:54 AM,Other,10,10,0,0,20,10,10,0,0,20
19,South Sudan (UNDP),2019,SSD-19/HSS10/SA2/P-H-NFI/NGO/13560,6/16/2020 11:08:54 AM,Overall,5890,9400,1805,3635,20730,7310,10272,2200,4000,23782
19,South Sudan (UNDP),2019,SSD-19/HSS10/SA2/P-H-NFI/NGO/13560,6/16/2020 11:08:54 AM,Returnees,1510,2730,525,1380,6145,1800,2800,600,1400,6600
19,South Sudan (UNDP),2019,SSD-19/HSS10/SA2/P-H-WASH/NGO/13388,6/16/2020 10:56:41 AM,Host Communities,2000,3100,1900,2950,9950,1750,3000,1850,2950,9550
19,South Sudan (UNDP),2019,SSD-19/HSS10/SA2/P-H-WASH/NGO/13388,6/16/2020 10:56:41 AM,Internally Displaced People,900,1200,550,750,3400,840,1150,520,755,3265
19,South Sudan (UNDP),2019,SSD-19/HSS10/SA2/P-H-WASH/NGO/13388,6/16/2020 10:56:41 AM,Overall,3700,5700,3100,5100,17600,3370,5500,2895,5080,16845
19,South Sudan (UNDP),2019,SSD-19/HSS10/SA2/P-H-WASH/NGO/13388,6/16/2020 10:56:41 AM,Returnees,800,1400,650,1400,4250,780,1350,525,1375,4030
19,South Sudan (UNDP),2019,SSD-19/HSS10/SA2/P-N/INGO/13379,7/7/2020 11:14:18 PM,Host Communities,1918,6221,12736,12926,33801,2122,10785,14691,14101,41699
19,South Sudan (UNDP),2019,SSD-19/HSS10/SA2/P-N/INGO/13379,7/7/2020 11:14:18 PM,Internally Displaced People,505,447,525,466,1943,35,715,768,809,2327
19,South Sudan (UNDP),2019,SSD-19/HSS10/SA2/P-N/INGO/13379,7/7/2020 11:14:18 PM,Other,100,100,60,40,300,0,0,3,3,6
19,South Sudan (UNDP),2019,SSD-19/HSS10/SA2/P-N/INGO/13379,7/7/2020 11:14:18 PM,Overall,3433,7643,14306,14305,39687,2157,11500,15462,14913,44032
19,South Sudan (UNDP),2019,SSD-19/HSS10/SA2/P-N/INGO/13379,7/7/2020 11:14:18 PM,Returnees,910,875,985,873,3643,0,0,0,0,0
19,South Sudan (UNDP),2019,SSD-19/HSS10/SA2/P-N/NGO/13569,7/7/2020 11:42:46 PM,Host Communities,541,1416,2654,2624,7235,701,1029,2215,2182,6127
19,South Sudan (UNDP),2019,SSD-19/HSS10/SA2/P-N/NGO/13569,7/7/2020 11:42:46 PM,Internally Displaced People,773,2023,2905,2905,8606,1231,1847,4435,4019,11532
19,South Sudan (UNDP),2019,SSD-19/HSS10/SA2/P-N/NGO/13569,7/7/2020 11:42:46 PM,Overall,1545,4045,6430,6400,18420,2117,3143,7118,6672,19050
19,South Sudan (UNDP),2019,SSD-19/HSS10/SA2/P-N/NGO/13569,7/7/2020 11:42:46 PM,Returnees,231,606,871,871,2579,185,267,468,471,1391
19,South Sudan (UNDP),2019,SSD-19/HSS10/SA2/WASH/INGO/13418,6/2/2020 11:51:40 AM,Host Communities,357,399,672,672,2100,546,595,1060,1060,3261
19,South Sudan (UNDP),2019,SSD-19/HSS10/SA2/WASH/INGO/13418,6/2/2020 11:51:40 AM,Internally Displaced People,1224,1368,2304,2304,7200,1871,2064,3630,3630,11195
19,South Sudan (UNDP),2019,SSD-19/HSS10/SA2/WASH/INGO/13418,6/2/2020 11:51:40 AM,Overall,2550,2850,4800,4800,15000,3899,4293,7561,7561,23314
19,South Sudan (UNDP),2019,SSD-19/HSS10/SA2/WASH/INGO/13418,6/2/2020 11:51:40 AM,Returnees,969,1083,1824,1824,5700,1482,1634,2871,2871,8858
19,South Sudan (UNDP),2019,SSD-19/HSS10/SA2/WASH/INGO/13470,7/16/2020 12:35:54 PM,Host Communities,4032,4368,1008,1092,10500,6755,8283,5420,5762,26220
19,South Sudan (UNDP),2019,SSD-19/HSS10/SA2/WASH/INGO/13470,7/16/2020 12:35:54 PM,Internally Displaced People,4032,4368,1008,1092,10500,2527,2793,665,665,6650
19,South Sudan (UNDP),2019,SSD-19/HSS10/SA2/WASH/INGO/13470,7/16/2020 12:35:54 PM,Overall,13440,14560,3360,3640,35000,11638,13680,6705,7047,39070
19,South Sudan (UNDP),2019,SSD-19/HSS10/SA2/WASH/INGO/13470,7/16/2020 12:35:54 PM,Returnees,5376,5824,1344,1456,14000,2356,2604,620,620,6200
19,South Sudan (UNDP),2019,SSD-19/HSS10/SA2/WASH/INGO/13501,6/2/2020 11:15:48 AM,Host Communities,3807,4469,3972,4303,16551,5059,4943,3563,4375,17940
19,South Sudan (UNDP),2019,SSD-19/HSS10/SA2/WASH/INGO/13501,6/2/2020 11:15:48 AM,Overall,3952,5266,4044,4738,18000,5307,6724,3719,5329,21079
19,South Sudan (UNDP),2019,SSD-19/HSS10/SA2/WASH/INGO/13501,6/2/2020 11:15:48 AM,Returnees,145,797,72,435,1449,248,1781,156,954,3139
19,South Sudan (UNDP),2019,SSD-19/HSS10/SA2/WASH/INGO/13563,6/2/2020 11:24:11 AM,Host Communities,1020,1380,1740,1860,6000,4714,4937,6759,6990,23400
19,South Sudan (UNDP),2019,SSD-19/HSS10/SA2/WASH/INGO/13563,6/2/2020 11:24:11 AM,Internally Displaced People,2550,3450,4350,4650,15000,2192,2463,3235,3624,11514
19,South Sudan (UNDP),2019,SSD-19/HSS10/SA2/WASH/INGO/13563,6/2/2020 11:24:11 AM,Overall,5100,6900,8700,9300,30000,9261,9798,13553,14152,46764
19,South Sudan (UNDP),2019,SSD-19/HSS10/SA2/WASH/INGO/13563,6/2/2020 11:24:11 AM,Returnees,1530,2070,2610,2790,9000,2355,2398,3559,3538,11850
19,South Sudan (UNDP),2019,SSD-19/HSS10/SA2/WASH/NGO/13371,6/4/2020 11:36:54 AM,Host Communities,444,608,1024,1024,3100,667,842,1112,1235,3856
19,South Sudan (UNDP),2019,SSD-19/HSS10/SA2/WASH/NGO/13371,6/4/2020 11:36:54 AM,Internally Displaced People,1004,1128,3084,3084,8300,1102,1246,3150,3160,8658
19,South Sudan (UNDP),2019,SSD-19/HSS10/SA2/WASH/NGO/13371,6/4/2020 11:36:54 AM,Overall,1720,2040,4620,4620,13000,2121,2567,4929,5073,14690
19,South Sudan (UNDP),2019,SSD-19/HSS10/SA2/WASH/NGO/13371,6/4/2020 11:36:54 AM,Returnees,272,304,512,512,1600,352,479,667,678,2176
19,South Sudan (UNDP),2019,SSD-19/HSS10/SA2/WASH/NGO/13451,7/17/2020 7:20:51 AM,Host Communities,700,690,1220,879,3489,810,788,1715,1300,4613
19,South Sudan (UNDP),2019,SSD-19/HSS10/SA2/WASH/NGO/13451,7/17/2020 7:20:51 AM,Internally Displaced People,1200,1800,1450,1471,5921,1490,1912,1908,2400,7710
19,South Sudan (UNDP),2019,SSD-19/HSS10/SA2/WASH/NGO/13451,7/17/2020 7:20:51 AM,Overall,3500,4500,3600,3700,15300,4150,4950,5020,5400,19520
19,South Sudan (UNDP),2019,SSD-19/HSS10/SA2/WASH/NGO/13451,7/17/2020 7:20:51 AM,Returnees,1600,2010,930,1350,5890,1850,2250,1397,1700,7197
19,South Sudan (UNDP),2019,SSD-19/HSS10/SA2/WASH/NGO/13488,7/17/2020 7:34:58 AM,Host Communities,1750,4375,5250,6125,17500,7822,19291,13338,22180,62631
19,South Sudan (UNDP),2019,SSD-19/HSS10/SA2/WASH/NGO/13488,7/17/2020 7:34:58 AM,Internally Displaced People,750,1875,2250,2625,7500,525,1312,1575,1838,5250
19,South Sudan (UNDP),2019,SSD-19/HSS10/SA2/WASH/NGO/13488,7/17/2020 7:34:58 AM,Overall,2500,6250,7500,8750,25000,8347,20603,14913,24018,67881
19,South Sudan (UNDP),2019,SSD-19/HSS10/SA2/WASH/NGO/13556,7/17/2020 6:53:01 AM,Host Communities,506,843,708,1315,3372,506,843,708,1315,3372
19,South Sudan (UNDP),2019,SSD-19/HSS10/SA2/WASH/NGO/13556,7/17/2020 6:53:01 AM,Internally Displaced People,778,1296,1088,2022,5184,778,1296,1088,2022,5184
19,South Sudan (UNDP),2019,SSD-19/HSS10/SA2/WASH/NGO/13556,7/17/2020 6:53:01 AM,Other,11,18,15,28,72,11,18,15,28,72
19,South Sudan (UNDP),2019,SSD-19/HSS10/SA2/WASH/NGO/13556,7/17/2020 6:53:01 AM,Overall,1801,3000,2519,4680,12000,1801,3000,2519,4680,12000
19,South Sudan (UNDP),2019,SSD-19/HSS10/SA2/WASH/NGO/13556,7/17/2020 6:53:01 AM,Returnees,506,843,708,1315,3372,506,843,708,1315,3372
19,South Sudan (UNDP),2019,SSD-19/HSS10/SA2/WASH/NGO/13570,8/11/2020 8:37:17 AM,Host Communities,363,1088,907,1268,3626,1041,1006,1568,1071,4686
19,South Sudan (UNDP),2019,SSD-19/HSS10/SA2/WASH/NGO/13570,8/11/2020 8:37:17 AM,Internally Displaced People,466,1398,1167,1631,4662,1360,1293,2018,1378,6049
19,South Sudan (UNDP),2019,SSD-19/HSS10/SA2/WASH/NGO/13570,8/11/2020 8:37:17 AM,Overall,1026,3178,2565,3591,10360,2956,2940,4436,3120,13452
19,South Sudan (UNDP),2019,SSD-19/HSS10/SA2/WASH/NGO/13570,8/11/2020 8:37:17 AM,Returnees,197,692,491,692,2072,555,641,850,671,2717
19,South Sudan (UNDP),2019,SSD-19/HSS10/SA2/WASH/NGO/13574,7/13/2020 8:51:23 AM,Host Communities,1141,1628,907,845,4521,1788,1932,2732,2823,9275
19,South Sudan (UNDP),2019,SSD-19/HSS10/SA2/WASH/NGO/13574,7/13/2020 8:51:23 AM,Internally Displaced People,151,211,123,115,600,196,150,219,218,783
19,South Sudan (UNDP),2019,SSD-19/HSS10/SA2/WASH/NGO/13574,7/13/2020 8:51:23 AM,Other,26,28,49,36,139,32,21,18,7,78
19,South Sudan (UNDP),2019,SSD-19/HSS10/SA2/WASH/NGO/13574,7/13/2020 8:51:23 AM,Overall,2522,3700,1980,1798,10000,3247,3005,4242,4355,14849
19,South Sudan (UNDP),2019,SSD-19/HSS10/SA2/WASH/NGO/13574,7/13/2020 8:51:23 AM,Returnees,1204,1833,901,802,4740,1231,902,1273,1307,4713
19,South Sudan (UNDP),2019,SSD-19/HSS10/SA2/WASH/NGO/13662,6/17/2020 5:55:15 PM,Host Communities,362,682,426,660,2130,362,682,426,760,2230
19,South Sudan (UNDP),2019,SSD-19/HSS10/SA2/WASH/NGO/13662,6/17/2020 5:55:15 PM,Internally Displaced People,483,909,568,880,2840,583,1009,668,1080,3340
19,South Sudan (UNDP),2019,SSD-19/HSS10/SA2/WASH/NGO/13662,6/17/2020 5:55:15 PM,Overall,1207,2273,1420,2200,7100,1307,2373,1520,2600,7800
19,South Sudan (UNDP),2019,SSD-19/HSS10/SA2/WASH/NGO/13662,6/17/2020 5:55:15 PM,Returnees,362,682,426,660,2130,362,682,426,760,2230
19,South Sudan (UNDP),2019,SSD-19/HSS10/SA2/WASH/UN/13475,7/16/2020 12:11:23 PM,Host Communities,2649,2679,1918,2904,10150,4259,5261,3892,2905,16317
19,South Sudan (UNDP),2019,SSD-19/HSS10/SA2/WASH/UN/13475,7/16/2020 12:11:23 PM,Internally Displaced People,959,970,695,1050,3674,1321,1633,1207,901,5062
19,South Sudan (UNDP),2019,SSD-19/HSS10/SA2/WASH/UN/13475,7/16/2020 12:11:23 PM,Overall,4567,4619,3309,5005,17500,7342,9071,6709,5008,28130
19,South Sudan (UNDP),2019,SSD-19/HSS10/SA2/WASH/UN/13475,7/16/2020 12:11:23 PM,Returnees,959,970,696,1051,3676,1762,2177,1610,1202,6751
19,South Sudan (UNDP),2019,SSD-19/HSS10/SA2/WASH-FSL/NGO/13350,7/13/2020 3:39:39 PM,Host Communities,3611,6465,5261,5963,21300,3000,2900,870,900,7670
19,South Sudan (UNDP),2019,SSD-19/HSS10/SA2/WASH-FSL/NGO/13350,7/13/2020 3:39:39 PM,Internally Displaced People,2382,3857,2897,3264,12400,0,0,0,0,0
19,South Sudan (UNDP),2019,SSD-19/HSS10/SA2/WASH-FSL/NGO/13350,7/13/2020 3:39:39 PM,Overall,10612,16688,14288,16039,57627,3108,2962,878,944,7892
19,South Sudan (UNDP),2019,SSD-19/HSS10/SA2/WASH-FSL/NGO/13350,7/13/2020 3:39:39 PM,Returnees,4619,6366,6130,6812,23927,108,62,8,44,222
19,South Sudan (UNDP),2019,SSD-19/HSS10/SA2/WASH-H-N/INGO/13657,6/29/2020 6:47:32 AM,Host Communities,3640,8602,5545,6368,24155,5306,5008,3829,3552,17695
19,South Sudan (UNDP),2019,SSD-19/HSS10/SA2/WASH-H-N/INGO/13657,6/29/2020 6:47:32 AM,Internally Displaced People,910,2151,1386,1592,6039,1326,1252,957,887,4422
19,South Sudan (UNDP),2019,SSD-19/HSS10/SA2/WASH-H-N/INGO/13657,6/29/2020 6:47:32 AM,Overall,9100,21506,13862,15921,60389,13264,12520,9572,8878,44234
19,South Sudan (UNDP),2019,SSD-19/HSS10/SA2/WASH-H-N/INGO/13657,6/29/2020 6:47:32 AM,Returnees,4550,10753,6931,7961,30195,6632,6260,4786,4439,22117
19,South Sudan (UNDP),2019,SSD-19/HSS10/SA2/WASH-N-P/NGO/13532,6/12/2020 6:53:59 AM,Host Communities,1724,3236,2436,3334,10730,701,1804,1430,2051,5986
19,South Sudan (UNDP),2019,SSD-19/HSS10/SA2/WASH-N-P/NGO/13532,6/12/2020 6:53:59 AM,Internally Displaced People,2210,3166,3366,4678,13420,2102,2373,3165,3679,11319
19,South Sudan (UNDP),2019,SSD-19/HSS10/SA2/WASH-N-P/NGO/13532,6/12/2020 6:53:59 AM,Overall,4680,7420,7020,9595,28715,3356,4738,5334,6531,19959
19,South Sudan (UNDP),2019,SSD-19/HSS10/SA2/WASH-N-P/NGO/13532,6/12/2020 6:53:59 AM,Returnees,746,1018,1218,1583,4565,553,561,739,801,2654
19,South Sudan (UNDP),2019,SSD-19/HSS10/SA2/WASH-P-NFI/NGO/13387,6/26/2020 7:39:40 AM,Host Communities,1479,4048,2596,5223,13346,1691,5701,2574,6509,16475
19,South Sudan (UNDP),2019,SSD-19/HSS10/SA2/WASH-P-NFI/NGO/13387,6/26/2020 7:39:40 AM,Internally Displaced People,1233,3073,2075,3468,9849,816,2616,2433,3386,9251
19,South Sudan (UNDP),2019,SSD-19/HSS10/SA2/WASH-P-NFI/NGO/13387,6/26/2020 7:39:40 AM,Overall,3525,8998,6286,11039,29848,2784,10101,5826,12072,30783
19,South Sudan (UNDP),2019,SSD-19/HSS10/SA2/WASH-P-NFI/NGO/13387,6/26/2020 7:39:40 AM,Returnees,813,1877,1615,2348,6653,277,1784,819,2177,5057
16,Sudan,2020,SUD-20/HSD20/ RA5/FSL/INGO/17951,11/23/2021 10:12:44 AM,Overall,6000,3000,3000,3000,15000,8166,3743,2042,3062,17013
16,Sudan,2020,SUD-20/HSD20/ RA5/FSL/INGO/17951,11/23/2021 10:12:44 AM,Refugees,6000,3000,3000,3000,15000,8166,3743,2042,3062,17013
16,Sudan,2020,SUD-20/HSD20/ RA5/H-N/INGO/17948,5/29/2022 10:54:15 AM,Host Communities,100,300,200,245,845,1029,3370,2052,2909,9360
16,Sudan,2020,SUD-20/HSD20/ RA5/H-N/INGO/17948,5/29/2022 10:54:15 AM,Overall,1100,3300,2200,2695,9295,16487,11553,5017,6380,39437
16,Sudan,2020,SUD-20/HSD20/ RA5/H-N/INGO/17948,5/29/2022 10:54:15 AM,Refugees,1000,3000,2000,2450,8450,15458,8183,2965,3471,30077
16,Sudan,2020,SUD-20/HSD20/ RA5/H-WASH-P/INGO/17949,3/6/2022 6:56:50 AM,Host Communities,1348,1402,1103,1147,5000,2072,2187,1697,1605,7561
16,Sudan,2020,SUD-20/HSD20/ RA5/H-WASH-P/INGO/17949,3/6/2022 6:56:50 AM,Overall,8085,8415,6615,6885,30000,8289,8749,9240,8294,34572
16,Sudan,2020,SUD-20/HSD20/ RA5/H-WASH-P/INGO/17949,3/6/2022 6:56:50 AM,Refugees,6737,7013,5512,5738,25000,6217,6562,7543,6689,27011
16,Sudan,2020,SUD-20/HSD20/ RA5/WASH/INGO/17950,8/4/2022 6:26:58 AM,Host Communities,1568,1182,1282,968,5000,1241,1317,1349,1308,5215
16,Sudan,2020,SUD-20/HSD20/ RA5/WASH/INGO/17950,8/4/2022 6:26:58 AM,Overall,6270,4730,5130,3870,20000,10249,5446,4352,3935,23982
16,Sudan,2020,SUD-20/HSD20/ RA5/WASH/INGO/17950,8/4/2022 6:26:58 AM,Refugees,4702,3548,3848,2902,15000,9008,4129,3003,2627,18767
16,Sudan,2020,SUD-20/HSD20/ RA5/WASH/INGO/17952,5/18/2022 2:29:31 PM,Host Communities,1620,1680,1320,1380,6000,486,504,396,414,1800
16,Sudan,2020,SUD-20/HSD20/ RA5/WASH/INGO/17952,5/18/2022 2:29:31 PM,Overall,4720,4040,3890,3350,16000,4272,3386,3536,2821,14015
16,Sudan,2020,SUD-20/HSD20/ RA5/WASH/INGO/17952,5/18/2022 2:29:31 PM,Refugees,3100,2360,2570,1970,10000,3786,2882,3140,2407,12215
16,Sudan,2020,SUD-20/HSD20/ RA5/WASH/INGO/17953,8/4/2022 6:33:03 AM,Overall,1442,1088,1180,890,4600,1676,1744,1117,1163,5700
16,Sudan,2020,SUD-20/HSD20/ RA5/WASH/INGO/17953,8/4/2022 6:33:03 AM,Refugees,1442,1088,1180,890,4600,1676,1744,1117,1163,5700
16,Sudan,2020,SUD-20/HSD20/ RA5/WASH-ESNFIs-P/INGO/17955,2/14/2022 10:18:50 AM,Overall,9540,5300,4028,2332,21200,18470,10241,7799,4514,41024
16,Sudan,2020,SUD-20/HSD20/ RA5/WASH-ESNFIs-P/INGO/17955,2/14/2022 10:18:50 AM,Refugees,9540,5300,4028,2332,21200,18470,10241,7799,4514,41024
16,Sudan,2020,SUD-20/HSD20/ RA5/WASH-P/INGO/17954,6/6/2022 4:39:21 PM,Host Communities,0,20,0,0,20,0,0,0,0,0
16,Sudan,2020,SUD-20/HSD20/ RA5/WASH-P/INGO/17954,6/6/2022 4:39:21 PM,Overall,1045,1125,2362,2343,6875,40,40,361,289,730
16,Sudan,2020,SUD-20/HSD20/ RA5/WASH-P/INGO/17954,6/6/2022 4:39:21 PM,Refugees,1045,1105,2362,2343,6855,40,40,361,289,730
16,Sudan,2020,SUD-20/HSD20/ RA6/FSL-E/INGO/17959,7/18/2022 9:11:41 AM,Host Communities,1121,3438,4608,6271,15438,4232,5341,8209,9286,27068
16,Sudan,2020,SUD-20/HSD20/ RA6/FSL-E/INGO/17959,7/18/2022 9:11:41 AM,Internally Displaced People,929,1511,2508,3465,8413,1822,1704,3744,3102,10372
16,Sudan,2020,SUD-20/HSD20/ RA6/FSL-E/INGO/17959,7/18/2022 9:11:41 AM,Overall,2388,5376,7487,10034,25285,6996,8274,13322,13509,42101
16,Sudan,2020,SUD-20/HSD20/ RA6/FSL-E/INGO/17959,7/18/2022 9:11:41 AM,Refugees,338,427,371,298,1434,942,1229,1369,1121,4661
16,Sudan,2020,SUD-20/HSD20/ RA6/FSL-N-H-WASH/INGO/17957,1/11/2022 7:19:16 AM,Overall,5203,5415,6622,6892,24132,4902,5690,6921,8314,25827
16,Sudan,2020,SUD-20/HSD20/ RA6/FSL-N-H-WASH/INGO/17957,1/11/2022 7:19:16 AM,Returnees,5203,5415,6622,6892,24132,4902,5690,6921,8314,25827
16,Sudan,2020,SUD-20/HSD20/ RA6/H-N/INGO/17958,9/17/2023 8:55:34 AM,Host Communities,5760,6240,6000,6000,24000,2279,6274,4570,5044,18167
16,Sudan,2020,SUD-20/HSD20/ RA6/H-N/INGO/17958,9/17/2023 8:55:34 AM,Internally Displaced People,3840,4160,4000,4000,16000,1519,4182,3047,3362,12110
16,Sudan,2020,SUD-20/HSD20/ RA6/H-N/INGO/17958,9/17/2023 8:55:34 AM,Overall,9600,10400,10000,10000,40000,3798,10456,7617,8406,30277
16,Sudan,2020,SUD-20/HSD20/RA 3/CCS/UN/17190,8/10/2022 7:58:12 AM,Host Communities,6410,12389,14398,14638,47835,16836,17976,14014,13354,62180
16,Sudan,2020,SUD-20/HSD20/RA 3/CCS/UN/17190,8/10/2022 7:58:12 AM,Internally Displaced People,1127,2178,2531,2573,8409,1565,1726,1984,2018,7293
16,Sudan,2020,SUD-20/HSD20/RA 3/CCS/UN/17190,8/10/2022 7:58:12 AM,Overall,7537,14567,16929,17211,56244,18401,19702,15998,15372,69473
16,Sudan,2020,SUD-20/HSD20/RA2/E/UN/17604,2/14/2022 10:42:21 AM,Host Communities,350,250,15000,15000,30600,344,296,14021,16626,31287
16,Sudan,2020,SUD-20/HSD20/RA2/E/UN/17604,2/14/2022 10:42:21 AM,Overall,350,250,15000,15000,30600,344,296,14021,16626,31287
16,Sudan,2020,SUD-20/HSD20/RA2/ESNFIs/UN/17603,9/13/2022 6:47:45 AM,Host Communities,5547,7505,8484,11094,32630,945,1260,1190,1605,5000
16,Sudan,2020,SUD-20/HSD20/RA2/ESNFIs/UN/17603,9/13/2022 6:47:45 AM,Overall,10272,13898,15712,20544,60426,10659,14214,13423,18107,56403
16,Sudan,2020,SUD-20/HSD20/RA2/ESNFIs/UN/17603,9/13/2022 6:47:45 AM,Refugees,4725,6393,7228,9450,27796,9714,12954,12233,16502,51403
16,Sudan,2020,SUD-20/HSD20/RA2/FSL/UN/17605,9/13/2022 8:17:10 AM,Host Communities,86524,90056,57683,60037,294300,88916,92534,59277,61698,302425
16,Sudan,2020,SUD-20/HSD20/RA2/FSL/UN/17605,9/13/2022 8:17:10 AM,Internally Displaced People,51914,54034,34610,36022,176580,53322,55404,35629,37100,181455
16,Sudan,2020,SUD-20/HSD20/RA2/FSL/UN/17605,9/13/2022 8:17:10 AM,Overall,173048,180112,115366,120074,588600,177818,184945,118609,123478,604850
16,Sudan,2020,SUD-20/HSD20/RA2/FSL/UN/17605,9/13/2022 8:17:10 AM,Refugees,8653,9005,5768,6004,29430,8899,9244,5923,6177,30243
16,Sudan,2020,SUD-20/HSD20/RA2/FSL/UN/17605,9/13/2022 8:17:10 AM,Returnees,25957,27017,17305,18011,88290,26681,27763,17780,18503,90727
16,Sudan,2020,SUD-20/HSD20/RA2/H/NGO/17081,8/24/2021 8:47:41 AM,Host Communities,1960,2040,490,510,5000,2048,2964,738,846,6596
16,Sudan,2020,SUD-20/HSD20/RA2/H/NGO/17081,8/24/2021 8:47:41 AM,Overall,1960,2040,490,510,5000,2048,2964,738,846,6596
16,Sudan,2020,SUD-20/HSD20/RA2/H-WASH/UN/17240,10/24/2022 7:05:52 AM,Host Communities,122675,101207,46004,36803,306689,122760,101276,46108,36856,307000
16,Sudan,2020,SUD-20/HSD20/RA2/H-WASH/UN/17240,10/24/2022 7:05:52 AM,Overall,122675,101207,46004,36803,306689,122760,101276,46108,36856,307000
16,Sudan,2020,SUD-20/HSD20/RA2/H-WASH/UN/17602,12/14/2022 6:10:58 AM,Host Communities,188702,155828,69964,56610,471104,0,0,0,0,0
16,Sudan,2020,SUD-20/HSD20/RA2/H-WASH/UN/17602,12/14/2022 6:10:58 AM,Internally Displaced People,92200,76065,34575,27660,230500,0,0,0,0,0
16,Sudan,2020,SUD-20/HSD20/RA2/H-WASH/UN/17602,12/14/2022 6:10:58 AM,Overall,320003,264151,119846,96000,800000,0,0,0,0,0
16,Sudan,2020,SUD-20/HSD20/RA2/H-WASH/UN/17602,12/14/2022 6:10:58 AM,Refugees,39101,32258,15307,11730,98396,0,0,0,0,0
16,Sudan,2020,SUD-20/HSD20/RA2/WASH/INGO/17082,1/13/2022 7:50:28 AM,Host Communities,13480,13916,11064,11040,49500,13480,13916,11064,11040,49500
16,Sudan,2020,SUD-20/HSD20/RA2/WASH/INGO/17082,1/13/2022 7:50:28 AM,Overall,13480,13916,11064,11040,49500,13480,13916,11064,11040,49500
16,Sudan,2020,SUD-20/HSD20/RA2/WASH-ESNFIs/INGO/17857,7/14/2022 11:37:25 AM,Host Communities,6400,6600,9600,10000,32600,6340,6599,9510,9898,32347
16,Sudan,2020,SUD-20/HSD20/RA2/WASH-ESNFIs/INGO/17857,7/14/2022 11:37:25 AM,Internally Displaced People,6477,6737,10000,10000,33214,6377,6637,9566,9956,32536
16,Sudan,2020,SUD-20/HSD20/RA2/WASH-ESNFIs/INGO/17857,7/14/2022 11:37:25 AM,Overall,17971,18686,26732,27896,91285,15020,15633,22531,23450,76634
16,Sudan,2020,SUD-20/HSD20/RA2/WASH-ESNFIs/INGO/17857,7/14/2022 11:37:25 AM,Refugees,2304,2419,3226,3571,11520,0,0,0,0,0
16,Sudan,2020,SUD-20/HSD20/RA2/WASH-ESNFIs/INGO/17857,7/14/2022 11:37:25 AM,Returnees,2790,2930,3906,4325,13951,2303,2397,3455,3596,11751
16,Sudan,2020,SUD-20/HSD20/RA4/H/UN/17634,1/13/2022 8:09:49 AM,Host Communities,0,0,211111,219728,430839,0,0,191424,194935,386359
16,Sudan,2020,SUD-20/HSD20/RA4/H/UN/17634,1/13/2022 8:09:49 AM,Internally Displaced People,0,0,49482,51501,100983,0,0,76286,78597,154883
16,Sudan,2020,SUD-20/HSD20/RA4/H/UN/17634,1/13/2022 8:09:49 AM,Other,0,0,115005,119700,234705,0,0,87678,94018,181696
16,Sudan,2020,SUD-20/HSD20/RA4/H/UN/17634,1/13/2022 8:09:49 AM,Overall,0,0,392000,408000,800000,0,0,373112,386404,759516
16,Sudan,2020,SUD-20/HSD20/RA4/H/UN/17634,1/13/2022 8:09:49 AM,Refugees,0,0,16402,17071,33473,0,0,17724,18854,36578
16,Sudan,2020,SUD-20/HSD20/RA4/H/UN/17635,1/17/2022 8:03:19 AM,Host Communities,0,0,211111,219728,430839,0,0,181707,189124,370831
16,Sudan,2020,SUD-20/HSD20/RA4/H/UN/17635,1/17/2022 8:03:19 AM,Internally Displaced People,0,0,49482,51501,100983,0,0,48103,50069,98172
16,Sudan,2020,SUD-20/HSD20/RA4/H/UN/17635,1/17/2022 8:03:19 AM,Other,0,0,115005,119700,234705,0,0,103865,108105,211970
16,Sudan,2020,SUD-20/HSD20/RA4/H/UN/17635,1/17/2022 8:03:19 AM,Overall,0,0,392000,408000,800000,0,0,357447,372043,729490
16,Sudan,2020,SUD-20/HSD20/RA4/H/UN/17635,1/17/2022 8:03:19 AM,Refugees,0,0,16402,17071,33473,0,0,23772,24745,48517
16,Sudan,2020,SUD-20/HSD20/RE/FSL/UN/15049,2/11/2021 11:41:25 AM,Host Communities,2150119,2237880,921480,959090,6268569,2150119,2237880,921480,959090,6268569
16,Sudan,2020,SUD-20/HSD20/RE/FSL/UN/15049,2/11/2021 11:41:25 AM,Overall,2150119,2237880,921480,959090,6268569,2150119,2237880,921480,959090,6268569
16,Sudan,2020,SUD-20/HSD20/RE/FSL/UN/15715,10/6/2021 10:45:42 AM,Host Communities,2632798,2740260,1755200,1826840,8955098,2632799,2740261,1755200,1826840,8955100
16,Sudan,2020,SUD-20/HSD20/RE/FSL/UN/15715,10/6/2021 10:45:42 AM,Overall,2632798,2740260,1755200,1826840,8955098,2632799,2740261,1755200,1826840,8955100
16,Sudan,2020,SUD-20/HSD20/RE/H/INGO/16004,4/1/2021 11:30:52 AM,Host Communities,500,6500,3610,3390,14000,368,8824,4714,4478,18384
16,Sudan,2020,SUD-20/HSD20/RE/H/INGO/16004,4/1/2021 11:30:52 AM,Overall,500,6500,3610,3390,14000,368,8824,4714,4478,18384
16,Sudan,2020,SUD-20/HSD20/RE/H/INGO/16012,4/1/2021 11:25:58 AM,Other,80000,70000,90000,85000,325000,87942,80541,91803,83755,344041
16,Sudan,2020,SUD-20/HSD20/RE/H/INGO/16012,4/1/2021 11:25:58 AM,Overall,80000,70000,90000,85000,325000,87942,80541,91803,83755,344041
16,Sudan,2020,SUD-20/HSD20/RE/H/INGO/16031,1/13/2022 8:05:45 AM,Host Communities,100,200,100,100,500,100,200,100,100,500
16,Sudan,2020,SUD-20/HSD20/RE/H/INGO/16031,1/13/2022 8:05:45 AM,Other,600,800,800,800,3000,600,800,800,800,3000
16,Sudan,2020,SUD-20/HSD20/RE/H/INGO/16031,1/13/2022 8:05:45 AM,Overall,1200,1500,1150,1150,5000,1200,1500,1150,1150,5000
16,Sudan,2020,SUD-20/HSD20/RE/H/INGO/16031,1/13/2022 8:05:45 AM,Refugees,400,300,150,150,1000,400,300,150,150,1000
16,Sudan,2020,SUD-20/HSD20/RE/H/INGO/16031,1/13/2022 8:05:45 AM,Returnees,100,200,100,100,500,100,200,100,100,500
16,Sudan,2020,SUD-20/HSD20/RE/H/NGO/16036,2/8/2021 1:38:12 PM,Host Communities,18200,19800,26300,29700,94000,12740,13860,18410,22500,67510
16,Sudan,2020,SUD-20/HSD20/RE/H/NGO/16036,2/8/2021 1:38:12 PM,Internally Displaced People,6050,5950,7075,7425,26500,3630,3570,4245,4455,15900
16,Sudan,2020,SUD-20/HSD20/RE/H/NGO/16036,2/8/2021 1:38:12 PM,Overall,31840,32360,40260,45540,150000,20165,20735,26097,31162,98159
16,Sudan,2020,SUD-20/HSD20/RE/H/NGO/16036,2/8/2021 1:38:12 PM,Refugees,5700,4300,4050,4950,19000,2850,2150,2025,2475,9500
16,Sudan,2020,SUD-20/HSD20/RE/H/NGO/16036,2/8/2021 1:38:12 PM,Returnees,1890,2310,2835,3465,10500,945,1155,1417,1732,5249
16,Sudan,2020,SUD-20/HSD20/RE/H/NGO/16042,11/22/2021 1:52:08 PM,Host Communities,38551,41780,0,0,80331,53239,58186,0,0,111425
16,Sudan,2020,SUD-20/HSD20/RE/H/NGO/16042,11/22/2021 1:52:08 PM,Other,63,169,0,0,232,104,165,0,0,269
16,Sudan,2020,SUD-20/HSD20/RE/H/NGO/16042,11/22/2021 1:52:08 PM,Overall,48182,52404,0,0,100586,66653,72896,0,0,139549
16,Sudan,2020,SUD-20/HSD20/RE/H/NGO/16042,11/22/2021 1:52:08 PM,Refugees,9568,10455,0,0,20023,13310,14545,0,0,27855
16,Sudan,2020,SUD-20/HSD20/RE/H/UN/15150,3/6/2022 6:59:39 AM,Host Communities,100800,109200,67200,72800,350000,76125,81375,49875,55125,262500
16,Sudan,2020,SUD-20/HSD20/RE/H/UN/15150,3/6/2022 6:59:39 AM,Overall,126720,137280,84480,91520,440000,95700,102300,62700,69300,330000
16,Sudan,2020,SUD-20/HSD20/RE/H/UN/15150,3/6/2022 6:59:39 AM,Refugees,25920,28080,17280,18720,90000,19575,20925,12825,14175,67500
16,Sudan,2020,SUD-20/HSD20/RE/H/UN/16016,2/9/2021 2:19:07 PM,Host Communities,1377,11625,344,3874,17220,1377,11625,2601,5798,21401
16,Sudan,2020,SUD-20/HSD20/RE/H/UN/16016,2/9/2021 2:19:07 PM,Internally Displaced People,90,763,23,254,1130,90,763,23,254,1130
16,Sudan,2020,SUD-20/HSD20/RE/H/UN/16016,2/9/2021 2:19:07 PM,Overall,1599,13502,400,4499,20000,1599,13502,2657,6423,24181
16,Sudan,2020,SUD-20/HSD20/RE/H/UN/16016,2/9/2021 2:19:07 PM,Refugees,132,1114,33,371,1650,132,1114,33,371,1650
16,Sudan,2020,SUD-20/HSD20/RE/H/UN/16025,2/28/2023 11:22:30 AM,Host Communities,149760,162240,99840,108160,520000,134784,146016,89856,97344,468000
16,Sudan,2020,SUD-20/HSD20/RE/H/UN/16025,2/28/2023 11:22:30 AM,Internally Displaced People,17280,18720,11520,12476,59996,13824,14976,9216,9981,47997
16,Sudan,2020,SUD-20/HSD20/RE/H/UN/16025,2/28/2023 11:22:30 AM,Overall,185760,201240,123840,134156,644996,164880,178620,109920,119077,572497
16,Sudan,2020,SUD-20/HSD20/RE/H/UN/16025,2/28/2023 11:22:30 AM,Refugees,12960,14040,8640,9360,45000,11664,12636,7776,8424,40500
16,Sudan,2020,SUD-20/HSD20/RE/H/UN/16025,2/28/2023 11:22:30 AM,Returnees,5760,6240,3840,4160,20000,4608,4992,3072,3328,16000
16,Sudan,2020,SUD-20/HSD20/RE/H/UN/16038,2/14/2022 11:48:53 AM,Overall,14052,12971,0,0,27023,16048,14452,0,0,30500
16,Sudan,2020,SUD-20/HSD20/RE/H/UN/16038,2/14/2022 11:48:53 AM,Refugees,14052,12971,0,0,27023,16048,14452,0,0,30500
16,Sudan,2020,SUD-20/HSD20/RE/H-WASH/INGO/16017,5/25/2021 8:24:36 AM,Host Communities,31623,32914,38651,40228,143416,14771,16958,10895,11203,53827
16,Sudan,2020,SUD-20/HSD20/RE/H-WASH/INGO/16017,5/25/2021 8:24:36 AM,Internally Displaced People,43154,44916,52744,54897,195711,20157,23142,14867,15288,73454
16,Sudan,2020,SUD-20/HSD20/RE/H-WASH/INGO/16017,5/25/2021 8:24:36 AM,Overall,78290,81487,95689,99595,355061,36569,41984,26972,27735,133260
16,Sudan,2020,SUD-20/HSD20/RE/H-WASH/INGO/16017,5/25/2021 8:24:36 AM,Refugees,2459,2560,3006,3129,11154,1149,1319,847,871,4186
16,Sudan,2020,SUD-20/HSD20/RE/H-WASH/INGO/16017,5/25/2021 8:24:36 AM,Returnees,1054,1097,1288,1341,4780,492,565,363,373,1793
16,Sudan,2020,SUD-20/HSD20/RE/H-WASH/INGO/16018,9/16/2021 1:07:40 PM,Host Communities,42321,42321,18138,18138,120918,40312,41450,14670,16248,112680
16,Sudan,2020,SUD-20/HSD20/RE/H-WASH/INGO/16018,9/16/2021 1:07:40 PM,Internally Displaced People,18138,18138,7773,7773,51822,17620,18024,5421,6520,47585
16,Sudan,2020,SUD-20/HSD20/RE/H-WASH/INGO/16018,9/16/2021 1:07:40 PM,Overall,60459,60459,25911,25911,172740,57932,59474,20091,22768,160265
16,Sudan,2020,SUD-20/HSD20/RE/H-WASH/INGO/16022,2/14/2022 11:12:52 AM,Host Communities,64361,66879,42908,44770,218918,67608,64577,43180,44942,220307
16,Sudan,2020,SUD-20/HSD20/RE/H-WASH/INGO/16022,2/14/2022 11:12:52 AM,Internally Displaced People,35447,36896,23632,24597,120572,28975,27675,18505,19261,94416
16,Sudan,2020,SUD-20/HSD20/RE/H-WASH/INGO/16022,2/14/2022 11:12:52 AM,Overall,105639,109844,70427,73413,359323,96583,92252,61685,64203,314723
16,Sudan,2020,SUD-20/HSD20/RE/H-WASH/INGO/16022,2/14/2022 11:12:52 AM,Returnees,5831,6069,3887,4046,19833,0,0,0,0,0
16,Sudan,2020,SUD-20/HSD20/RE/H-WASH/INGO/16023,1/16/2022 10:43:53 AM,Host Communities,280047,291477,356423,370971,1298918,302933,307728,372126,396291,1379078
16,Sudan,2020,SUD-20/HSD20/RE/H-WASH/INGO/16023,1/16/2022 10:43:53 AM,Internally Displaced People,71904,74839,91514,95249,333506,74289,81640,104110,110532,370571
16,Sudan,2020,SUD-20/HSD20/RE/H-WASH/INGO/16023,1/16/2022 10:43:53 AM,Overall,378442,393888,481653,501312,1755295,413953,430095,540611,553862,1938521
16,Sudan,2020,SUD-20/HSD20/RE/H-WASH/INGO/16023,1/16/2022 10:43:53 AM,Returnees,26491,27572,33716,35092,122871,36731,40727,64375,47039,188872
16,Sudan,2020,SUD-20/HSD20/RE/H-WASH/INGO/16024,6/14/2021 7:29:32 AM,Host Communities,124950,130050,120050,124950,500000,3613,3472,3500,2670,13255
16,Sudan,2020,SUD-20/HSD20/RE/H-WASH/INGO/16024,6/14/2021 7:29:32 AM,Overall,124950,130050,120050,124950,500000,3613,3472,3500,2670,13255
16,Sudan,2020,SUD-20/HSD20/RE/H-WASH/INGO/16027,1/25/2021 10:29:31 AM,Host Communities,4355,6865,5766,5999,22985,5245,8268,6943,7225,27681
16,Sudan,2020,SUD-20/HSD20/RE/H-WASH/INGO/16027,1/25/2021 10:29:31 AM,Internally Displaced People,9257,14616,12180,12666,48719,7243,11417,9589,9976,38225
16,Sudan,2020,SUD-20/HSD20/RE/H-WASH/INGO/16027,1/25/2021 10:29:31 AM,Overall,13724,21669,18058,18779,72230,12488,19685,16532,17201,65906
16,Sudan,2020,SUD-20/HSD20/RE/H-WASH/INGO/16027,1/25/2021 10:29:31 AM,Refugees,112,188,112,114,526,0,0,0,0,0
16,Sudan,2020,SUD-20/HSD20/RE/H-WASH/INGO/16032,1/28/2021 2:51:23 PM,Host Communities,5629,5858,5298,5739,22524,9379,9640,6126,5345,30490
16,Sudan,2020,SUD-20/HSD20/RE/H-WASH/INGO/16032,1/28/2021 2:51:23 PM,Overall,5629,5858,5298,5739,22524,9379,9640,6126,5345,30490
16,Sudan,2020,SUD-20/HSD20/RE/H-WASH/INGO/16053,8/24/2021 1:02:19 PM,Host Communities,17005,20784,23483,28702,89974,32536,43886,31682,38602,146706
16,Sudan,2020,SUD-20/HSD20/RE/H-WASH/INGO/16053,8/24/2021 1:02:19 PM,Internally Displaced People,2363,2887,3262,3988,12500,4742,4042,4657,4828,18269
16,Sudan,2020,SUD-20/HSD20/RE/H-WASH/INGO/16053,8/24/2021 1:02:19 PM,Overall,23625,28875,32624,39876,125000,42278,53503,42103,50139,188023
16,Sudan,2020,SUD-20/HSD20/RE/H-WASH/INGO/16053,8/24/2021 1:02:19 PM,Refugees,4257,5204,5879,7186,22526,5000,5575,5764,6709,23048
16,Sudan,2020,SUD-20/HSD20/RE/H-WASH/INGO/16061,5/25/2022 12:03:17 PM,Host Communities,6615,8085,9135,11165,35000,32636,36394,11381,13557,93968
16,Sudan,2020,SUD-20/HSD20/RE/H-WASH/INGO/16061,5/25/2022 12:03:17 PM,Internally Displaced People,11238,13375,15519,18968,59100,3011,3061,2022,2211,10305
16,Sudan,2020,SUD-20/HSD20/RE/H-WASH/INGO/16061,5/25/2022 12:03:17 PM,Overall,27498,33248,37973,46412,145131,44304,49844,24657,28754,147559
16,Sudan,2020,SUD-20/HSD20/RE/H-WASH/INGO/16061,5/25/2022 12:03:17 PM,Refugees,9645,11788,13319,16279,51031,8657,10389,11254,12986,43286
16,Sudan,2020,SUD-20/HSD20/RE/H-WASH/UN/16051,1/25/2021 10:36:19 AM,Host Communities,2450,12550,48675,48825,112500,0,17488,25178,20203,62869
16,Sudan,2020,SUD-20/HSD20/RE/H-WASH/UN/16051,1/25/2021 10:36:19 AM,Internally Displaced People,36750,38250,55125,57375,187500,2897,3019,4346,4528,14790
16,Sudan,2020,SUD-20/HSD20/RE/H-WASH/UN/16051,1/25/2021 10:36:19 AM,Other,1700,2000,0,0,3700,0,1587,0,0,1587
16,Sudan,2020,SUD-20/HSD20/RE/H-WASH/UN/16051,1/25/2021 10:36:19 AM,Overall,40900,52800,103800,106200,303700,2897,22094,29524,24731,79246
16,Sudan,2020,SUD-20/HSD20/SA1/ESNFIs/UN/16115,2/14/2022 12:52:24 PM,Internally Displaced People,6090,8240,9315,12180,35825,0,0,0,0,0
16,Sudan,2020,SUD-20/HSD20/SA1/ESNFIs/UN/16115,2/14/2022 12:52:24 PM,Overall,6090,8240,9315,12180,35825,0,0,0,0,0
16,Sudan,2020,SUD-20/HSD20/SA1/FSL/INGO/16092,2/3/2022 1:58:49 PM,Host Communities,12774,11968,8398,8428,41568,12425,12312,8658,8720,42115
16,Sudan,2020,SUD-20/HSD20/SA1/FSL/INGO/16092,2/3/2022 1:58:49 PM,Overall,12774,11968,8398,8428,41568,12425,12312,8658,8720,42115
16,Sudan,2020,SUD-20/HSD20/SA1/FSL/INGO/16111,1/4/2022 11:58:10 AM,Host Communities,3000,4500,3750,3750,15000,1392,483,1982,1982,5839
16,Sudan,2020,SUD-20/HSD20/SA1/FSL/INGO/16111,1/4/2022 11:58:10 AM,Overall,3000,4500,3750,3750,15000,1392,483,1982,1982,5839
16,Sudan,2020,SUD-20/HSD20/SA1/FSL/INGO/16151,1/4/2022 12:48:24 PM,Host Communities,185,310,123,207,825,190,315,128,212,845
16,Sudan,2020,SUD-20/HSD20/SA1/FSL/INGO/16151,1/4/2022 12:48:24 PM,Internally Displaced People,118,198,78,131,525,118,198,78,131,525
16,Sudan,2020,SUD-20/HSD20/SA1/FSL/INGO/16151,1/4/2022 12:48:24 PM,Overall,337,564,223,376,1500,308,513,206,343,1370
16,Sudan,2020,SUD-20/HSD20/SA1/FSL/INGO/16151,1/4/2022 12:48:24 PM,Returnees,34,56,22,38,150,0,0,0,0,0
16,Sudan,2020,SUD-20/HSD20/SA1/FSL/INGO/16525,5/24/2022 11:44:04 AM,Host Communities,97,166,340,397,1000,500,600,140,165,1405
16,Sudan,2020,SUD-20/HSD20/SA1/FSL/INGO/16525,5/24/2022 11:44:04 AM,Internally Displaced People,194,333,680,793,2000,500,3100,1500,1600,6700
16,Sudan,2020,SUD-20/HSD20/SA1/FSL/INGO/16525,5/24/2022 11:44:04 AM,Overall,726,1249,2550,2975,7500,2000,8020,3840,4165,18025
16,Sudan,2020,SUD-20/HSD20/SA1/FSL/INGO/16525,5/24/2022 11:44:04 AM,Refugees,435,750,1530,1785,4500,1000,4320,2200,2400,9920
16,Sudan,2020,SUD-20/HSD20/SA1/FSL/INGO/16531,1/24/2023 11:12:02 AM,Host Communities,7729,7814,11420,11887,38850,27352,28469,41030,42705,139556
16,Sudan,2020,SUD-20/HSD20/SA1/FSL/INGO/16531,1/24/2023 11:12:02 AM,Internally Displaced People,1077,1121,1566,1632,5396,10010,10419,15015,15628,51072
16,Sudan,2020,SUD-20/HSD20/SA1/FSL/INGO/16531,1/24/2023 11:12:02 AM,Overall,13419,13732,19886,20703,67740,47630,49575,71449,74364,243018
16,Sudan,2020,SUD-20/HSD20/SA1/FSL/INGO/16531,1/24/2023 11:12:02 AM,Refugees,2563,2664,3829,3986,13042,2191,2280,3287,3421,11179
16,Sudan,2020,SUD-20/HSD20/SA1/FSL/INGO/16531,1/24/2023 11:12:02 AM,Returnees,2050,2133,3071,3198,10452,8077,8407,12117,12610,41211
16,Sudan,2020,SUD-20/HSD20/SA1/FSL/NGO/16060,8/2/2022 1:42:40 PM,Host Communities,2241,5976,2684,4039,14940,2241,6276,2384,4150,15051
16,Sudan,2020,SUD-20/HSD20/SA1/FSL/NGO/16060,8/2/2022 1:42:40 PM,Internally Displaced People,12662,21915,6523,7600,48700,12500,24885,6500,8631,52516
16,Sudan,2020,SUD-20/HSD20/SA1/FSL/NGO/16060,8/2/2022 1:42:40 PM,Overall,19383,39839,15173,19115,93510,19221,43581,14844,20557,98203
16,Sudan,2020,SUD-20/HSD20/SA1/FSL/NGO/16060,8/2/2022 1:42:40 PM,Returnees,4480,11948,5966,7476,29870,4480,12420,5960,7776,30636
16,Sudan,2020,SUD-20/HSD20/SA1/FSL/NGO/16543,12/22/2021 12:45:16 PM,Host Communities,760,791,711,740,3002,767,925,822,902,3416
16,Sudan,2020,SUD-20/HSD20/SA1/FSL/NGO/16543,12/22/2021 12:45:16 PM,Internally Displaced People,88,91,82,86,347,22,52,43,67,184
16,Sudan,2020,SUD-20/HSD20/SA1/FSL/NGO/16543,12/22/2021 12:45:16 PM,Overall,1257,1308,1176,1224,4965,1187,1389,1153,1355,5084
16,Sudan,2020,SUD-20/HSD20/SA1/FSL/NGO/16543,12/22/2021 12:45:16 PM,Refugees,409,426,383,398,1616,398,412,288,386,1484
16,Sudan,2020,SUD-20/HSD20/SA1/FSL/UN/16511,8/8/2022 2:22:25 PM,Host Communities,28547,29713,19031,19809,97100,28547,29713,19031,19809,97100
16,Sudan,2020,SUD-20/HSD20/SA1/FSL/UN/16511,8/8/2022 2:22:25 PM,Overall,28547,29713,19031,19809,97100,28547,29713,19031,19809,97100
16,Sudan,2020,SUD-20/HSD20/SA1/FSL-H-N-WASH-P/INGO/16093,9/4/2022 9:38:15 AM,Other,35405,37355,34015,36850,143625,35405,37355,34015,36850,143625
16,Sudan,2020,SUD-20/HSD20/SA1/FSL-H-N-WASH-P/INGO/16093,9/4/2022 9:38:15 AM,Overall,35405,37355,34015,36850,143625,35405,37355,34015,36850,143625
16,Sudan,2020,SUD-20/HSD20/SA1/FSL-N/NGO/16147,5/19/2022 1:17:17 PM,Host Communities,650,8260,8700,10450,28060,1088,8890,7587,7127,24692
16,Sudan,2020,SUD-20/HSD20/SA1/FSL-N/NGO/16147,5/19/2022 1:17:17 PM,Internally Displaced People,970,6900,6700,7500,22070,0,0,0,0,0
16,Sudan,2020,SUD-20/HSD20/SA1/FSL-N/NGO/16147,5/19/2022 1:17:17 PM,Other,910,5509,4570,5600,16589,0,0,0,0,0
16,Sudan,2020,SUD-20/HSD20/SA1/FSL-N/NGO/16147,5/19/2022 1:17:17 PM,Overall,2530,20669,19970,23550,66719,1088,8890,7587,7127,24692
16,Sudan,2020,SUD-20/HSD20/SA1/FSL-N-P/INGO/16145,9/6/2022 1:47:56 PM,Host Communities,7816,7875,4398,4017,24106,7800,8000,5000,5345,26145
16,Sudan,2020,SUD-20/HSD20/SA1/FSL-N-P/INGO/16145,9/6/2022 1:47:56 PM,Internally Displaced People,186,207,143,245,781,250,250,345,450,1295
16,Sudan,2020,SUD-20/HSD20/SA1/FSL-N-P/INGO/16145,9/6/2022 1:47:56 PM,Overall,16518,16422,9858,10840,53638,15850,16025,12675,14095,58645
16,Sudan,2020,SUD-20/HSD20/SA1/FSL-N-P/INGO/16145,9/6/2022 1:47:56 PM,Refugees,5588,5610,3287,3527,18012,4900,4900,4150,4400,18350
16,Sudan,2020,SUD-20/HSD20/SA1/FSL-N-P/INGO/16145,9/6/2022 1:47:56 PM,Returnees,2928,2730,2030,3051,10739,2900,2875,3180,3900,12855
16,Sudan,2020,SUD-20/HSD20/SA1/FSL-N-P/INGO/16146,5/25/2022 2:26:48 PM,Host Communities,5500,5836,4813,4621,20770,5500,5836,4813,4621,20770
16,Sudan,2020,SUD-20/HSD20/SA1/FSL-N-P/INGO/16146,5/25/2022 2:26:48 PM,Overall,5500,5836,4813,4621,20770,5500,5836,4813,4621,20770
16,Sudan,2020,SUD-20/HSD20/SA1/FSL-P/INGO/16112,2/14/2022 10:28:38 AM,Host Communities,11200,13600,6150,8550,39500,8412,15726,9400,10440,43978
16,Sudan,2020,SUD-20/HSD20/SA1/FSL-P/INGO/16112,2/14/2022 10:28:38 AM,Overall,11200,13600,6150,8550,39500,8412,15726,9400,10440,43978
16,Sudan,2020,SUD-20/HSD20/SA1/FSL-P/NGO/16110,1/5/2022 6:49:13 AM,Other,1465,1525,1196,1794,5980,882,918,205,400,2405
16,Sudan,2020,SUD-20/HSD20/SA1/FSL-P/NGO/16110,1/5/2022 6:49:13 AM,Overall,1465,1525,1196,1794,5980,882,918,205,400,2405
16,Sudan,2020,SUD-20/HSD20/SA1/FSL-P/NGO/16226,5/26/2022 12:46:29 PM,Overall,452,433,235,225,1345,411,675,104,197,1387
16,Sudan,2020,SUD-20/HSD20/SA1/FSL-P/NGO/16226,5/26/2022 12:46:29 PM,Refugees,452,433,235,225,1345,411,675,104,197,1387
16,Sudan,2020,SUD-20/HSD20/SA1/FSL-WASH-H/INGO/16117,2/14/2022 10:48:35 AM,Host Communities,7200,6750,4360,4190,22500,10089,11505,7257,6638,35489
16,Sudan,2020,SUD-20/HSD20/SA1/FSL-WASH-H/INGO/16117,2/14/2022 10:48:35 AM,Internally Displaced People,960,900,581,559,3000,855,975,615,563,3008
16,Sudan,2020,SUD-20/HSD20/SA1/FSL-WASH-H/INGO/16117,2/14/2022 10:48:35 AM,Overall,9600,9000,5814,5586,30000,11889,13933,9627,9898,45347
16,Sudan,2020,SUD-20/HSD20/SA1/FSL-WASH-H/INGO/16117,2/14/2022 10:48:35 AM,Refugees,1440,1350,873,837,4500,945,1453,1755,2697,6850
16,Sudan,2020,SUD-20/HSD20/SA1/FSL-WASH-N-H/INGO/16121,7/14/2022 11:44:55 AM,Host Communities,2415,2856,1745,2135,9151,3660,4329,2646,3236,13871
16,Sudan,2020,SUD-20/HSD20/SA1/FSL-WASH-N-H/INGO/16121,7/14/2022 11:44:55 AM,Overall,12472,22184,23576,25998,84230,18894,33624,35735,39405,127658
16,Sudan,2020,SUD-20/HSD20/SA1/FSL-WASH-N-H/INGO/16121,7/14/2022 11:44:55 AM,Refugees,10057,19328,21831,23863,75079,15234,29295,33089,36169,113787
16,Sudan,2020,SUD-20/HSD20/SA1/H/INGO/16054,9/21/2022 12:52:52 PM,Host Communities,13500,50000,10400,10400,84300,45900,100329,26916,26516,199661
16,Sudan,2020,SUD-20/HSD20/SA1/H/INGO/16054,9/21/2022 12:52:52 PM,Internally Displaced People,13500,74000,11600,11600,110700,52811,101287,23471,22417,199986
16,Sudan,2020,SUD-20/HSD20/SA1/H/INGO/16054,9/21/2022 12:52:52 PM,Overall,27000,124000,22000,22000,195000,98711,201616,50387,48933,399647
16,Sudan,2020,SUD-20/HSD20/SA1/H/INGO/16088,11/23/2021 12:49:15 PM,Host Communities,16190,16850,13246,13787,60073,8406,9440,18683,9704,46233
16,Sudan,2020,SUD-20/HSD20/SA1/H/INGO/16088,11/23/2021 12:49:15 PM,Internally Displaced People,10241,10659,8379,8721,38000,5316,5972,11818,6138,29244
16,Sudan,2020,SUD-20/HSD20/SA1/H/INGO/16088,11/23/2021 12:49:15 PM,Overall,26798,27891,21925,22821,99435,13913,15719,30831,16063,76526
16,Sudan,2020,SUD-20/HSD20/SA1/H/INGO/16088,11/23/2021 12:49:15 PM,Refugees,367,382,300,313,1362,191,307,330,221,1049
16,Sudan,2020,SUD-20/HSD20/SA1/H/INGO/16184,5/18/2022 12:06:43 PM,Host Communities,11472,10955,5114,6250,33791,6996,19368,9024,7201,42589
16,Sudan,2020,SUD-20/HSD20/SA1/H/INGO/16184,5/18/2022 12:06:43 PM,Internally Displaced People,208,325,52,65,650,620,2107,1227,1708,5662
16,Sudan,2020,SUD-20/HSD20/SA1/H/INGO/16184,5/18/2022 12:06:43 PM,Overall,11680,11280,5166,6315,34441,7616,21475,10251,8909,48251
16,Sudan,2020,SUD-20/HSD20/SA1/H/INGO/16485,2/14/2022 10:40:55 AM,Host Communities,13635,14772,13101,14192,55700,32539,45917,28267,30277,137000
16,Sudan,2020,SUD-20/HSD20/SA1/H/INGO/16485,2/14/2022 10:40:55 AM,Overall,13635,14772,13101,14192,55700,32539,45917,28267,30277,137000
16,Sudan,2020,SUD-20/HSD20/SA1/H/NGO/16534,5/19/2022 1:41:22 PM,Host Communities,5400,6000,4500,5000,20900,7390,8142,10643,7233,33408
16,Sudan,2020,SUD-20/HSD20/SA1/H/NGO/16534,5/19/2022 1:41:22 PM,Internally Displaced People,1200,1300,751,800,4051,1189,1210,633,701,3733
16,Sudan,2020,SUD-20/HSD20/SA1/H/NGO/16534,5/19/2022 1:41:22 PM,Other,560,551,210,251,1572,532,559,215,266,1572
16,Sudan,2020,SUD-20/HSD20/SA1/H/NGO/16534,5/19/2022 1:41:22 PM,Overall,7160,7851,5461,6051,26523,9111,9911,11491,8200,38713
16,Sudan,2020,SUD-20/HSD20/SA1/H/UN/16124,10/27/2022 9:54:42 AM,Host Communities,180308,148754,67616,54092,450770,193368,149758,67100,55138,465364
16,Sudan,2020,SUD-20/HSD20/SA1/H/UN/16124,10/27/2022 9:54:42 AM,Internally Displaced People,92200,76065,34575,27660,230500,92202,76039,34577,27659,230477
16,Sudan,2020,SUD-20/HSD20/SA1/H/UN/16124,10/27/2022 9:54:42 AM,Overall,320192,264158,120073,96057,800480,334252,261051,117703,95618,808624
16,Sudan,2020,SUD-20/HSD20/SA1/H/UN/16124,10/27/2022 9:54:42 AM,Refugees,47684,39339,17882,14305,119210,48682,35254,16026,12821,112783
16,Sudan,2020,SUD-20/HSD20/SA1/H/UN/16530,1/13/2022 8:08:19 AM,Host Communities,3941,15763,985,3941,24630,4741,18968,1184,4741,29634
16,Sudan,2020,SUD-20/HSD20/SA1/H/UN/16530,1/13/2022 8:08:19 AM,Internally Displaced People,312,1248,78,312,1950,376,1504,94,376,2350
16,Sudan,2020,SUD-20/HSD20/SA1/H/UN/16530,1/13/2022 8:08:19 AM,Overall,4253,17011,1063,4253,26580,5117,20472,1278,5117,31984
16,Sudan,2020,SUD-20/HSD20/SA1/H-N/INGO/16498,6/6/2022 4:35:23 PM,Host Communities,9768,10871,5984,7048,33671,10237,16234,9818,10435,46724
16,Sudan,2020,SUD-20/HSD20/SA1/H-N/INGO/16498,6/6/2022 4:35:23 PM,Overall,11100,12353,6800,8009,38262,11221,17250,10357,11068,49896
16,Sudan,2020,SUD-20/HSD20/SA1/H-N/INGO/16498,6/6/2022 4:35:23 PM,Refugees,1332,1482,816,961,4591,984,1016,539,633,3172
16,Sudan,2020,SUD-20/HSD20/SA1/H-N/UN/16505,7/4/2023 4:34:44 PM,Host Communities,372091,306973,139534,111627,930225,372091,306973,139534,111627,930225
16,Sudan,2020,SUD-20/HSD20/SA1/H-N/UN/16505,7/4/2023 4:34:44 PM,Internally Displaced People,134820,111226,50557,40446,337049,134820,111226,50557,40446,337049
16,Sudan,2020,SUD-20/HSD20/SA1/H-N/UN/16505,7/4/2023 4:34:44 PM,Overall,561749,463440,210655,168524,1404368,561749,463440,210655,168524,1404368
16,Sudan,2020,SUD-20/HSD20/SA1/H-N/UN/16505,7/4/2023 4:34:44 PM,Refugees,54838,45241,20564,16451,137094,54838,45241,20564,16451,137094
16,Sudan,2020,SUD-20/HSD20/SA1/H-N-P/NGO/16106,12/22/2021 12:40:10 PM,Host Communities,748,1492,558,715,3513,639,1447,644,695,3425
16,Sudan,2020,SUD-20/HSD20/SA1/H-N-P/NGO/16106,12/22/2021 12:40:10 PM,Internally Displaced People,1496,2984,1118,1428,7026,1272,2987,1287,1368,6914
16,Sudan,2020,SUD-20/HSD20/SA1/H-N-P/NGO/16106,12/22/2021 12:40:10 PM,Overall,3740,7460,2794,3571,17565,3533,7584,3218,3430,17765
16,Sudan,2020,SUD-20/HSD20/SA1/H-N-P/NGO/16106,12/22/2021 12:40:10 PM,Refugees,1496,2984,1118,1428,7026,1622,3150,1287,1367,7426
16,Sudan,2020,SUD-20/HSD20/SA1/H-N-P-WASH/INGO/16055,9/13/2022 6:51:25 AM,Host Communities,42288,75331,36693,35189,189501,9868,18071,13271,14141,55351
16,Sudan,2020,SUD-20/HSD20/SA1/H-N-P-WASH/INGO/16055,9/13/2022 6:51:25 AM,Internally Displaced People,2260,3974,1843,3162,11239,138,144,206,214,702
16,Sudan,2020,SUD-20/HSD20/SA1/H-N-P-WASH/INGO/16055,9/13/2022 6:51:25 AM,Overall,56588,100389,49438,50142,256557,12769,21919,16823,17762,69273
16,Sudan,2020,SUD-20/HSD20/SA1/H-N-P-WASH/INGO/16055,9/13/2022 6:51:25 AM,Refugees,6777,11398,6666,7554,32395,590,682,759,827,2858
16,Sudan,2020,SUD-20/HSD20/SA1/H-N-P-WASH/INGO/16055,9/13/2022 6:51:25 AM,Returnees,5263,9686,4236,4237,23422,2173,3022,2587,2580,10362
16,Sudan,2020,SUD-20/HSD20/SA1/H-WASH/INGO/16094,2/6/2022 12:37:02 PM,Host Communities,5841,8762,1461,2190,18254,6200,9100,1171,1609,18080
16,Sudan,2020,SUD-20/HSD20/SA1/H-WASH/INGO/16094,2/6/2022 12:37:02 PM,Internally Displaced People,1947,2920,487,730,6084,2669,3882,647,890,8088
16,Sudan,2020,SUD-20/HSD20/SA1/H-WASH/INGO/16094,2/6/2022 12:37:02 PM,Overall,9735,14603,2435,3650,30423,10669,15182,2218,3149,31218
16,Sudan,2020,SUD-20/HSD20/SA1/H-WASH/INGO/16094,2/6/2022 12:37:02 PM,Refugees,1947,2921,487,730,6085,1800,2200,400,650,5050
16,Sudan,2020,SUD-20/HSD20/SA1/H-WASH/INGO/16218,2/6/2022 12:08:59 PM,Host Communities,6933,7511,2808,2809,20061,2090,2182,1600,1600,7472
16,Sudan,2020,SUD-20/HSD20/SA1/H-WASH/INGO/16218,2/6/2022 12:08:59 PM,Internally Displaced People,225,243,91,91,650,35922,45502,17961,20356,119741
16,Sudan,2020,SUD-20/HSD20/SA1/H-WASH/INGO/16218,2/6/2022 12:08:59 PM,Overall,15427,16712,6248,6250,44637,39425,49243,20696,23091,132455
16,Sudan,2020,SUD-20/HSD20/SA1/H-WASH/INGO/16218,2/6/2022 12:08:59 PM,Refugees,5180,5612,2098,2099,14989,663,729,550,550,2492
16,Sudan,2020,SUD-20/HSD20/SA1/H-WASH/INGO/16218,2/6/2022 12:08:59 PM,Returnees,3089,3346,1251,1251,8937,750,830,585,585,2750
16,Sudan,2020,SUD-20/HSD20/SA1/H-WASH-FSL-N-P/INGO/16132,8/30/2022 8:34:12 AM,Host Communities,28082,32515,41384,45816,147797,30158,32515,41384,45816,149873
16,Sudan,2020,SUD-20/HSD20/SA1/H-WASH-FSL-N-P/INGO/16132,8/30/2022 8:34:12 AM,Internally Displaced People,4245,4915,6255,6926,22341,4245,4915,6255,6926,22341
16,Sudan,2020,SUD-20/HSD20/SA1/H-WASH-FSL-N-P/INGO/16132,8/30/2022 8:34:12 AM,Other,0,498,432,450,1380,0,498,593,618,1709
16,Sudan,2020,SUD-20/HSD20/SA1/H-WASH-FSL-N-P/INGO/16132,8/30/2022 8:34:12 AM,Overall,32654,38306,48552,53725,173237,34808,38387,48713,53893,175801
16,Sudan,2020,SUD-20/HSD20/SA1/H-WASH-FSL-N-P/INGO/16132,8/30/2022 8:34:12 AM,Returnees,327,378,481,533,1719,405,459,481,533,1878
16,Sudan,2020,SUD-20/HSD20/SA1/H-WASH-N/INGO/16116,2/14/2022 11:07:16 AM,Host Communities,17076,18498,16406,17773,69753,28609,30255,19239,18937,97040
16,Sudan,2020,SUD-20/HSD20/SA1/H-WASH-N/INGO/16116,2/14/2022 11:07:16 AM,Overall,17076,18498,16406,17773,69753,28609,30255,19239,18937,97040
16,Sudan,2020,SUD-20/HSD20/SA1/N/INGO/16486,2/14/2022 10:43:26 AM,Host Communities,6468,7233,6016,6264,25981,12173,13305,14635,15411,55524
16,Sudan,2020,SUD-20/HSD20/SA1/N/INGO/16486,2/14/2022 10:43:26 AM,Overall,6468,7233,6016,6264,25981,12173,13305,14635,15411,55524
16,Sudan,2020,SUD-20/HSD20/SA1/N/INGO/16563,9/20/2022 12:33:13 PM,Host Communities,0,4000,2000,2000,8000,0,5430,1658,1658,8746
16,Sudan,2020,SUD-20/HSD20/SA1/N/INGO/16563,9/20/2022 12:33:13 PM,Internally Displaced People,0,1000,1000,1000,3000,0,957,995,995,2947
16,Sudan,2020,SUD-20/HSD20/SA1/N/INGO/16563,9/20/2022 12:33:13 PM,Overall,0,6000,3850,3850,13700,0,12000,3251,3251,18502
16,Sudan,2020,SUD-20/HSD20/SA1/N/INGO/16563,9/20/2022 12:33:13 PM,Returnees,0,1000,850,850,2700,0,5613,598,598,6809
16,Sudan,2020,SUD-20/HSD20/SA1/N/INGO/17204,5/26/2022 12:50:01 PM,Other,0,6700,20228,19434,46362,0,1,1,1,3
16,Sudan,2020,SUD-20/HSD20/SA1/N/INGO/17204,5/26/2022 12:50:01 PM,Overall,0,6700,20228,19434,46362,0,1,1,1,3
16,Sudan,2020,SUD-20/HSD20/SA1/N/UN/16509,3/28/2021 6:02:24 AM,Other,0,0,10000,10000,20000,0,0,10000,10000,20000
16,Sudan,2020,SUD-20/HSD20/SA1/N/UN/16509,3/28/2021 6:02:24 AM,Overall,0,0,10000,10000,20000,0,0,10000,10000,20000
16,Sudan,2020,SUD-20/HSD20/SA1/P/NGO/16134,11/25/2021 12:25:58 PM,Host Communities,80,700,75,75,930,80,700,75,75,930
16,Sudan,2020,SUD-20/HSD20/SA1/P/NGO/16134,11/25/2021 12:25:58 PM,Internally Displaced People,1000,2080,1000,2000,6080,1000,2080,1000,2000,6080
16,Sudan,2020,SUD-20/HSD20/SA1/P/NGO/16134,11/25/2021 12:25:58 PM,Overall,1380,3780,1275,2275,8710,1380,3780,1275,2275,8710
16,Sudan,2020,SUD-20/HSD20/SA1/P/NGO/16134,11/25/2021 12:25:58 PM,Returnees,300,1000,200,200,1700,300,1000,200,200,1700
16,Sudan,2020,SUD-20/HSD20/SA1/WASH/INGO/16080,1/4/2022 12:07:13 PM,Host Communities,3000,4500,3750,3750,15000,2100,3150,2625,2625,10500
16,Sudan,2020,SUD-20/HSD20/SA1/WASH/INGO/16080,1/4/2022 12:07:13 PM,Overall,5000,7500,6250,6250,25000,3500,5250,4725,4375,17850
16,Sudan,2020,SUD-20/HSD20/SA1/WASH/INGO/16080,1/4/2022 12:07:13 PM,Refugees,2000,3000,2500,2500,10000,1400,2100,2100,1750,7350
16,Sudan,2020,SUD-20/HSD20/SA1/WASH/INGO/16130,2/20/2022 9:59:57 AM,Host Communities,7871,9112,7275,7120,31378,9911,8313,10524,9920,38668
16,Sudan,2020,SUD-20/HSD20/SA1/WASH/INGO/16130,2/20/2022 9:59:57 AM,Internally Displaced People,115,241,110,129,595,115,177,213,221,726
16,Sudan,2020,SUD-20/HSD20/SA1/WASH/INGO/16130,2/20/2022 9:59:57 AM,Overall,8891,10533,8036,8000,35460,13310,13506,15622,15704,58142
16,Sudan,2020,SUD-20/HSD20/SA1/WASH/INGO/16130,2/20/2022 9:59:57 AM,Refugees,530,590,430,450,2000,2320,3443,3032,3438,12233
16,Sudan,2020,SUD-20/HSD20/SA1/WASH/INGO/16130,2/20/2022 9:59:57 AM,Returnees,375,590,221,301,1487,964,1573,1853,2125,6515
16,Sudan,2020,SUD-20/HSD20/SA1/WASH/INGO/16487,2/14/2022 10:51:15 AM,Host Communities,13635,14772,13101,14192,55700,17378,22288,22322,23193,85181
16,Sudan,2020,SUD-20/HSD20/SA1/WASH/INGO/16487,2/14/2022 10:51:15 AM,Overall,13635,14772,13101,14192,55700,17378,22288,22322,23193,85181
16,Sudan,2020,SUD-20/HSD20/SA1/WASH/NGO/16129,1/19/2022 10:05:31 AM,Host Communities,250,406,434,471,1561,250,406,434,471,1561
16,Sudan,2020,SUD-20/HSD20/SA1/WASH/NGO/16129,1/19/2022 10:05:31 AM,Overall,2496,4056,4337,4711,15600,2496,4056,4337,4711,15600
16,Sudan,2020,SUD-20/HSD20/SA1/WASH/NGO/16129,1/19/2022 10:05:31 AM,Refugees,2246,3650,3903,4240,14039,2246,3650,3903,4240,14039
16,Sudan,2020,SUD-20/HSD20/SA1/WASH/UN/16155,2/9/2021 8:15:08 AM,Host Communities,20384,21216,30576,31824,104000,22187,23092,33280,34639,113198
16,Sudan,2020,SUD-20/HSD20/SA1/WASH/UN/16155,2/9/2021 8:15:08 AM,Internally Displaced People,18816,19584,28224,29376,96000,20480,21316,30720,31974,104490
16,Sudan,2020,SUD-20/HSD20/SA1/WASH/UN/16155,2/9/2021 8:15:08 AM,Overall,39200,40800,58800,61200,200000,42667,44408,64000,66613,217688
16,Sudan,2020,SUD-20/HSD20/SA1/WASH-ESNFIs/INGO/16594,2/23/2022 7:05:42 AM,Host Communities,11000,21000,6300,4500,42800,30570,36796,19511,19233,106110
16,Sudan,2020,SUD-20/HSD20/SA1/WASH-ESNFIs/INGO/16594,2/23/2022 7:05:42 AM,Overall,11000,21000,6300,4500,42800,30570,36796,19511,19233,106110
16,Sudan,2020,SUD-20/HSD20/SA1/WASH-FSL/INGO/16166,5/29/2022 11:27:49 AM,Host Communities,3840,4160,5760,6240,20000,5030,5450,7546,8174,26200
16,Sudan,2020,SUD-20/HSD20/SA1/WASH-FSL/INGO/16166,5/29/2022 11:27:49 AM,Overall,3840,4160,5760,6240,20000,5030,5450,7546,8174,26200
16,Sudan,2020,SUD-20/HSD20/SA1/WASH-N/INGO/16189,8/2/2022 1:45:18 PM,Host Communities,6780,9200,7000,8780,31760,5981,6479,8971,9719,31150
16,Sudan,2020,SUD-20/HSD20/SA1/WASH-N/INGO/16189,8/2/2022 1:45:18 PM,Internally Displaced People,3890,4200,4600,5000,17690,3351,3631,5027,5446,17455
16,Sudan,2020,SUD-20/HSD20/SA1/WASH-N/INGO/16189,8/2/2022 1:45:18 PM,Overall,10911,13678,11901,14056,50546,9514,10306,14270,15460,49550
16,Sudan,2020,SUD-20/HSD20/SA1/WASH-N/INGO/16189,8/2/2022 1:45:18 PM,Refugees,241,278,301,276,1096,182,196,272,295,945
16,Sudan,2020,SUD-20/HSD20/SA1/WASH-P/INGO/16137,7/4/2022 6:50:52 AM,Host Communities,1470,1530,980,1020,5000,3800,3955,2533,2637,12925
16,Sudan,2020,SUD-20/HSD20/SA1/WASH-P/INGO/16137,7/4/2022 6:50:52 AM,Overall,4410,4590,2940,3060,15000,13340,13885,8893,9257,45375
16,Sudan,2020,SUD-20/HSD20/SA1/WASH-P/INGO/16137,7/4/2022 6:50:52 AM,Refugees,2940,3060,1960,2040,10000,9540,9930,6360,6620,32450
16,Sudan,2020,SUD-20/HSD20/SA1/WASH-P/INGO/16507,3/9/2022 12:37:03 PM,Host Communities,16359,16758,3192,3591,39900,18425,18875,3595,4045,44940
16,Sudan,2020,SUD-20/HSD20/SA1/WASH-P/INGO/16507,3/9/2022 12:37:03 PM,Internally Displaced People,3116,3192,608,684,7600,3510,3595,685,770,8560
16,Sudan,2020,SUD-20/HSD20/SA1/WASH-P/INGO/16507,3/9/2022 12:37:03 PM,Overall,19475,19950,3800,4275,47500,21935,22470,4280,4815,53500
16,Sudan,2020,SUD-20/HSD20/SA1/WASH-P/NGO/16126,2/15/2022 6:59:02 AM,Host Communities,475,817,250,180,1722,475,817,250,180,1722
16,Sudan,2020,SUD-20/HSD20/SA1/WASH-P/NGO/16126,2/15/2022 6:59:02 AM,Internally Displaced People,5084,8705,1567,1910,17266,5084,8705,1567,1910,17266
16,Sudan,2020,SUD-20/HSD20/SA1/WASH-P/NGO/16126,2/15/2022 6:59:02 AM,Overall,6841,11530,2199,2642,23212,6841,11530,2199,2642,23212
16,Sudan,2020,SUD-20/HSD20/SA1/WASH-P/NGO/16126,2/15/2022 6:59:02 AM,Refugees,882,1508,272,342,3004,882,1508,272,342,3004
16,Sudan,2020,SUD-20/HSD20/SA1/WASH-P/NGO/16126,2/15/2022 6:59:02 AM,Returnees,400,500,110,210,1220,400,500,110,210,1220
16,Sudan,2020,SUD-20/HSD20/SA1/WASH-P/NGO/16168,12/21/2021 1:49:11 PM,Host Communities,2015,2098,3023,3146,10282,2624,2841,3110,3218,11793
16,Sudan,2020,SUD-20/HSD20/SA1/WASH-P/NGO/16168,12/21/2021 1:49:11 PM,Internally Displaced People,232,242,348,362,1184,210,273,391,367,1241
16,Sudan,2020,SUD-20/HSD20/SA1/WASH-P/NGO/16168,12/21/2021 1:49:11 PM,Overall,3332,3469,4998,5201,17000,3552,4041,4913,5107,17613
16,Sudan,2020,SUD-20/HSD20/SA1/WASH-P/NGO/16168,12/21/2021 1:49:11 PM,Refugees,1085,1129,1627,1693,5534,718,927,1412,1522,4579
16,Sudan,2020,SUD-20/HSD20/SA1/WASH-P/NGO/16533,5/19/2022 1:36:22 PM,Host Communities,5400,6000,4500,5000,20900,7589,9352,5257,5164,27362
16,Sudan,2020,SUD-20/HSD20/SA1/WASH-P/NGO/16533,5/19/2022 1:36:22 PM,Internally Displaced People,1200,1300,750,800,4050,803,720,750,821,3094
16,Sudan,2020,SUD-20/HSD20/SA1/WASH-P/NGO/16533,5/19/2022 1:36:22 PM,Other,560,550,210,250,1570,601,559,311,290,1761
16,Sudan,2020,SUD-20/HSD20/SA1/WASH-P/NGO/16533,5/19/2022 1:36:22 PM,Overall,7160,7850,5460,6050,26520,8993,10631,6318,6275,32217
16,Sudan,2021,SUD-21/HSD20/RA1/FSL/INGO/20217,11/17/2022 7:21:42 AM,Host Communities,4830,5040,5460,5670,21000,4991,5205,5640,5857,21693
16,Sudan,2021,SUD-21/HSD20/RA1/FSL/INGO/20217,11/17/2022 7:21:42 AM,Internally Displaced People,1932,2016,2184,2268,8400,1996,2082,2256,2343,8677
16,Sudan,2021,SUD-21/HSD20/RA1/FSL/INGO/20217,11/17/2022 7:21:42 AM,Overall,9660,10080,10920,11340,42000,9981,10411,11280,11714,43386
16,Sudan,2021,SUD-21/HSD20/RA1/FSL/INGO/20217,11/17/2022 7:21:42 AM,Returnees,2898,3024,3276,3402,12600,2994,3124,3384,3514,13016
16,Sudan,2021,SUD-21/HSD20/RA1/FSL/NGO/20216,7/31/2022 12:14:12 PM,Host Communities,1350,900,0,0,2250,1350,900,0,0,2250
16,Sudan,2021,SUD-21/HSD20/RA1/FSL/NGO/20216,7/31/2022 12:14:12 PM,Internally Displaced People,4050,2700,0,0,6750,4050,2700,0,0,6750
16,Sudan,2021,SUD-21/HSD20/RA1/FSL/NGO/20216,7/31/2022 12:14:12 PM,Overall,5400,3600,0,0,9000,5400,3600,0,0,9000
16,Sudan,2021,SUD-21/HSD20/RA1/H-WASH-N-ESNFIs/INGO/18069,1/4/2022 10:31:50 AM,Internally Displaced People,9209,9584,11720,12198,42711,13506,14119,16628,17586,61839
16,Sudan,2021,SUD-21/HSD20/RA1/H-WASH-N-ESNFIs/INGO/18069,1/4/2022 10:31:50 AM,Overall,9209,9584,11720,12198,42711,13506,14119,16628,17586,61839
16,Sudan,2021,SUD-21/HSD20/RA1/H-WASH-P/INGO/18068,2/6/2022 7:03:29 AM,Internally Displaced People,618,670,2485,2647,6420,6909,7473,6627,7191,28200
16,Sudan,2021,SUD-21/HSD20/RA1/H-WASH-P/INGO/18068,2/6/2022 7:03:29 AM,Overall,618,670,2485,2647,6420,6909,7473,6627,7191,28200
16,Sudan,2021,SUD-21/HSD20/RA10/H/INGO/20977,9/29/2022 5:58:51 AM,Host Communities,295,225,0,0,520,1252,1283,0,0,2535
16,Sudan,2021,SUD-21/HSD20/RA10/H/INGO/20977,9/29/2022 5:58:51 AM,Overall,295,225,0,0,520,1252,1283,0,0,2535
16,Sudan,2021,SUD-21/HSD20/RA11/FSL/NGO/21414,1/17/2023 8:29:35 AM,Host Communities,470,490,706,734,2400,486,506,729,759,2480
16,Sudan,2021,SUD-21/HSD20/RA11/FSL/NGO/21414,1/17/2023 8:29:35 AM,Overall,470,490,706,734,2400,486,506,729,759,2480
16,Sudan,2021,SUD-21/HSD20/RA11/FSL-N-WASH/INGO/20988,2/28/2023 11:29:41 AM,Host Communities,4608,4320,2791,2681,14400,8054,7371,4651,4532,24608
16,Sudan,2021,SUD-21/HSD20/RA11/FSL-N-WASH/INGO/20988,2/28/2023 11:29:41 AM,Internally Displaced People,1152,1080,698,670,3600,1292,1210,712,678,3892
16,Sudan,2021,SUD-21/HSD20/RA11/FSL-N-WASH/INGO/20988,2/28/2023 11:29:41 AM,Overall,5760,5400,3489,3351,18000,9346,8581,5363,5210,28500
16,Sudan,2021,SUD-21/HSD20/RA11/FSL-WASH/INGO/21405,5/26/2023 8:24:42 PM,Host Communities,31341,27859,13929,5224,78353,16000,16539,23964,24707,81210
16,Sudan,2021,SUD-21/HSD20/RA11/FSL-WASH/INGO/21405,5/26/2023 8:24:42 PM,Overall,31341,27859,13929,5224,78353,16000,16539,23964,24707,81210
16,Sudan,2021,SUD-21/HSD20/RA11/FSL-WASH/INGO/21406,3/6/2023 1:25:49 PM,Host Communities,11554,11100,2206,2140,27000,10832,10406,1958,1896,25092
16,Sudan,2021,SUD-21/HSD20/RA11/FSL-WASH/INGO/21406,3/6/2023 1:25:49 PM,Internally Displaced People,3850,3700,736,714,9000,3810,3661,738,818,9027
16,Sudan,2021,SUD-21/HSD20/RA11/FSL-WASH/INGO/21406,3/6/2023 1:25:49 PM,Overall,15404,14800,2942,2854,36000,14642,14067,2696,2714,34119
16,Sudan,2021,SUD-21/HSD20/RA11/WASH/INGO/21415,2/14/2023 10:56:34 AM,Host Communities,91735,81542,81542,84941,339760,91735,81542,81542,84941,339760
16,Sudan,2021,SUD-21/HSD20/RA11/WASH/INGO/21415,2/14/2023 10:56:34 AM,Overall,91735,81542,81542,84941,339760,91735,81542,81542,84941,339760
16,Sudan,2021,SUD-21/HSD20/RA2/FSL/UN/18096,7/20/2022 2:13:32 PM,Host Communities,2940,3060,1960,2040,10000,2940,3060,1960,2040,10000
16,Sudan,2021,SUD-21/HSD20/RA2/FSL/UN/18096,7/20/2022 2:13:32 PM,Overall,2940,3060,1960,2040,10000,2940,3060,1960,2040,10000
16,Sudan,2021,SUD-21/HSD20/RA3/H/INGO/18488,11/29/2021 6:59:51 AM,Host Communities,355,145,0,0,500,118,59,0,0,177
16,Sudan,2021,SUD-21/HSD20/RA3/H/INGO/18488,11/29/2021 6:59:51 AM,Overall,355,145,0,0,500,118,59,0,0,177
16,Sudan,2021,SUD-21/HSD20/RA4/ESNFIs/UN/19399,2/28/2023 11:37:12 AM,Host Communities,2000,3000,2000,3000,10000,1784,2379,2247,3040,9450
16,Sudan,2021,SUD-21/HSD20/RA4/ESNFIs/UN/19399,2/28/2023 11:37:12 AM,Internally Displaced People,9000,13500,9000,13500,45000,11968,15957,15070,20390,63385
16,Sudan,2021,SUD-21/HSD20/RA4/ESNFIs/UN/19399,2/28/2023 11:37:12 AM,Overall,19000,28500,19000,28500,95000,17947,23931,22600,30578,95056
16,Sudan,2021,SUD-21/HSD20/RA4/ESNFIs/UN/19399,2/28/2023 11:37:12 AM,Refugees,7000,10500,7000,10500,35000,3595,4794,4527,6125,19041
16,Sudan,2021,SUD-21/HSD20/RA4/ESNFIs/UN/19399,2/28/2023 11:37:12 AM,Returnees,1000,1500,1000,1500,5000,600,801,756,1023,3180
16,Sudan,2021,SUD-21/HSD20/RA4/H/UN/19201,10/9/2023 9:20:40 AM,Host Communities,17640,18360,26460,27540,90000,17640,18860,26460,27540,90500
16,Sudan,2021,SUD-21/HSD20/RA4/H/UN/19201,10/9/2023 9:20:40 AM,Internally Displaced People,18130,18870,27195,28305,92500,18130,18870,27195,28305,92500
16,Sudan,2021,SUD-21/HSD20/RA4/H/UN/19201,10/9/2023 9:20:40 AM,Overall,35770,37230,53655,55845,182500,35770,37730,53655,55845,183000
16,Sudan,2021,SUD-21/HSD20/RA4/H-P/UN/19241,2/28/2023 11:33:34 AM,Host Communities,6653,34918,2245,12839,56655,99,13584,33,4289,18005
16,Sudan,2021,SUD-21/HSD20/RA4/H-P/UN/19241,2/28/2023 11:33:34 AM,Internally Displaced People,1848,9515,598,4979,16940,219,23714,72,6733,30738
16,Sudan,2021,SUD-21/HSD20/RA4/H-P/UN/19241,2/28/2023 11:33:34 AM,Overall,9178,50304,3066,21252,83800,483,52952,160,15548,69143
16,Sudan,2021,SUD-21/HSD20/RA4/H-P/UN/19241,2/28/2023 11:33:34 AM,Refugees,495,2250,165,751,3661,165,15654,55,4526,20400
16,Sudan,2021,SUD-21/HSD20/RA4/H-P/UN/19241,2/28/2023 11:33:34 AM,Returnees,182,3621,58,2683,6544,0,0,0,0,0
16,Sudan,2021,SUD-21/HSD20/RA5/CCS/INGO/20227,8/10/2022 7:52:07 AM,Host Communities,484811,484811,412987,412987,1795596,484811,484811,412987,412987,1795596
16,Sudan,2021,SUD-21/HSD20/RA5/CCS/INGO/20227,8/10/2022 7:52:07 AM,Internally Displaced People,42570,42570,36263,36263,157666,42570,42570,36263,36263,157666
16,Sudan,2021,SUD-21/HSD20/RA5/CCS/INGO/20227,8/10/2022 7:52:07 AM,Overall,527381,527381,449250,449250,1953262,527381,527381,449250,449250,1953262
16,Sudan,2021,SUD-21/HSD20/RA5/CCS/UN/18738,7/4/2023 1:34:35 PM,Host Communities,125,125,125,125,500,125,125,125,125,500
16,Sudan,2021,SUD-21/HSD20/RA5/CCS/UN/18738,7/4/2023 1:34:35 PM,Internally Displaced People,125,125,125,125,500,125,125,125,125,500
16,Sudan,2021,SUD-21/HSD20/RA5/CCS/UN/18738,7/4/2023 1:34:35 PM,Overall,250,250,250,250,1000,250,250,250,250,1000
16,Sudan,2021,SUD-21/HSD20/RA6/ESNFIs-H-WASH-P/INGO/20146,5/25/2022 2:30:52 PM,Host Communities,24402,33698,19273,26577,103950,32543,40212,17478,28985,119218
16,Sudan,2021,SUD-21/HSD20/RA6/ESNFIs-H-WASH-P/INGO/20146,5/25/2022 2:30:52 PM,Overall,24402,33698,19273,26577,103950,32543,40212,17478,28985,119218
16,Sudan,2021,SUD-21/HSD20/RA6/ESNFIs-WASH/INGO/20149,8/4/2022 8:57:47 AM,Host Communities,1135,1135,0,0,2270,1779,1595,392,413,4179
16,Sudan,2021,SUD-21/HSD20/RA6/ESNFIs-WASH/INGO/20149,8/4/2022 8:57:47 AM,Overall,1135,1135,0,0,2270,1779,1595,392,413,4179
16,Sudan,2021,SUD-21/HSD20/RA6/WASH-ESNFIs/NGO/20174,8/30/2022 6:57:11 AM,Host Communities,7500,6700,2850,2500,19550,7500,6700,2850,2500,19550
16,Sudan,2021,SUD-21/HSD20/RA6/WASH-ESNFIs/NGO/20174,8/30/2022 6:57:11 AM,Overall,11700,11700,4150,4150,31700,11700,11700,4150,4150,31700
16,Sudan,2021,SUD-21/HSD20/RA6/WASH-ESNFIs/NGO/20174,8/30/2022 6:57:11 AM,Refugees,4200,5000,1300,1650,12150,4200,5000,1300,1650,12150
16,Sudan,2021,SUD-21/HSD20/RA6/WASH-ESNFIs-H/INGO/20155,5/25/2022 2:34:24 PM,Host Communities,4205,5807,3305,4563,17880,5690,8880,7793,7583,29946
16,Sudan,2021,SUD-21/HSD20/RA6/WASH-ESNFIs-H/INGO/20155,5/25/2022 2:34:24 PM,Overall,4205,5807,3305,4563,17880,5690,8880,7793,7583,29946
16,Sudan,2021,SUD-21/HSD20/RA6/WASH-H/INGO/20173,7/5/2022 10:35:06 AM,Host Communities,5000,5000,5000,5000,20000,10500,10500,10000,10000,41000
16,Sudan,2021,SUD-21/HSD20/RA6/WASH-H/INGO/20173,7/5/2022 10:35:06 AM,Overall,5000,5000,5000,5000,20000,10500,10500,10000,10000,41000
16,Sudan,2021,SUD-21/HSD20/RA8/ESNFIs/INGO/20904,7/21/2022 6:51:45 AM,Internally Displaced People,1265,1540,2180,2215,7200,1499,2360,1571,2198,7628
16,Sudan,2021,SUD-21/HSD20/RA8/ESNFIs/INGO/20904,7/21/2022 6:51:45 AM,Overall,1265,1540,2180,2215,7200,1499,2360,1571,2198,7628
16,Sudan,2021,SUD-21/HSD20/RA8/FSL-H-N-P-WASH/INGO/20984,11/17/2022 1:51:49 PM,Host Communities,18840,25120,6280,12560,62800,28614,7513,13713,15031,64871
16,Sudan,2021,SUD-21/HSD20/RA8/FSL-H-N-P-WASH/INGO/20984,11/17/2022 1:51:49 PM,Internally Displaced People,28260,37680,9420,18840,94200,11269,42920,20570,22547,97306
16,Sudan,2021,SUD-21/HSD20/RA8/FSL-H-N-P-WASH/INGO/20984,11/17/2022 1:51:49 PM,Overall,47100,62800,15700,31400,157000,39883,50433,34283,37578,162177
16,Sudan,2021,SUD-21/HSD20/RA8/FSL-P/INGO/20906,2/27/2023 12:08:19 PM,Host Communities,1875,2003,2340,2432,8650,1870,2100,2371,2490,8831
16,Sudan,2021,SUD-21/HSD20/RA8/FSL-P/INGO/20906,2/27/2023 12:08:19 PM,Internally Displaced People,1123,1250,1022,1130,4525,1100,1224,993,1140,4457
16,Sudan,2021,SUD-21/HSD20/RA8/FSL-P/INGO/20906,2/27/2023 12:08:19 PM,Other,512,837,557,683,2589,490,830,505,620,2445
16,Sudan,2021,SUD-21/HSD20/RA8/FSL-P/INGO/20906,2/27/2023 12:08:19 PM,Overall,18492,19277,20899,21332,80000,18360,20142,19714,21784,80000
16,Sudan,2021,SUD-21/HSD20/RA8/FSL-P/INGO/20906,2/27/2023 12:08:19 PM,Returnees,14982,15187,16980,17087,64236,14900,15988,15845,17534,64267
16,Sudan,2021,SUD-21/HSD20/RA8/H/INGO/20985,11/17/2022 6:40:39 AM,Host Communities,2500,5000,2000,2000,11500,4000,2811,2147,2004,10962
16,Sudan,2021,SUD-21/HSD20/RA8/H/INGO/20985,11/17/2022 6:40:39 AM,Internally Displaced People,9000,35000,5000,5000,54000,7600,37221,4235,5712,54768
16,Sudan,2021,SUD-21/HSD20/RA8/H/INGO/20985,11/17/2022 6:40:39 AM,Overall,11500,40000,7000,7000,65500,11600,40032,6382,7716,65730
16,Sudan,2021,SUD-21/HSD20/RA8/H/INGO/21458,5/26/2023 8:34:27 PM,Host Communities,13650,18550,9695,9695,51590,6596,8064,7468,8523,30651
16,Sudan,2021,SUD-21/HSD20/RA8/H/INGO/21458,5/26/2023 8:34:27 PM,Internally Displaced People,5850,7950,4155,4155,22110,3385,4590,2975,3373,14323
16,Sudan,2021,SUD-21/HSD20/RA8/H/INGO/21458,5/26/2023 8:34:27 PM,Overall,19500,26500,13850,13850,73700,9981,12654,10443,11896,44974
16,Sudan,2021,SUD-21/HSD20/RA8/H-N/INGO/20907,2/27/2023 10:18:54 AM,Host Communities,4410,4590,2940,3060,15000,3985,4147,2653,2768,13553
16,Sudan,2021,SUD-21/HSD20/RA8/H-N/INGO/20907,2/27/2023 10:18:54 AM,Overall,4410,4590,2940,3060,15000,3985,4147,2653,2768,13553
16,Sudan,2021,SUD-21/HSD20/RA8/H-N-P-WASH/INGO/20983,2/26/2023 1:18:46 PM,Host Communities,18971,19746,28457,29618,96792,11761,18267,18753,23718,72499
16,Sudan,2021,SUD-21/HSD20/RA8/H-N-P-WASH/INGO/20983,2/26/2023 1:18:46 PM,Internally Displaced People,4840,5036,7259,7557,24692,4395,4791,5213,5723,20122
16,Sudan,2021,SUD-21/HSD20/RA8/H-N-P-WASH/INGO/20983,2/26/2023 1:18:46 PM,Overall,24139,25126,36210,37689,123164,16567,23641,24207,29817,94232
16,Sudan,2021,SUD-21/HSD20/RA8/H-N-P-WASH/INGO/20983,2/26/2023 1:18:46 PM,Returnees,328,344,494,514,1680,411,583,241,376,1611
16,Sudan,2021,SUD-21/HSD20/RA8/P/INGO/21393,5/26/2023 8:40:05 PM,Host Communities,4800,9000,600,900,15300,391,1404,399,880,3074
16,Sudan,2021,SUD-21/HSD20/RA8/P/INGO/21393,5/26/2023 8:40:05 PM,Internally Displaced People,135,450,135,300,1020,0,0,0,0,0
16,Sudan,2021,SUD-21/HSD20/RA8/P/INGO/21393,5/26/2023 8:40:05 PM,Other,750,1200,600,600,3150,0,0,0,0,0
16,Sudan,2021,SUD-21/HSD20/RA8/P/INGO/21393,5/26/2023 8:40:05 PM,Overall,7035,12150,1485,2010,22680,391,1404,399,880,3074
16,Sudan,2021,SUD-21/HSD20/RA8/P/INGO/21393,5/26/2023 8:40:05 PM,Returnees,1350,1500,150,210,3210,0,0,0,0,0
16,Sudan,2021,SUD-21/HSD20/RA8/WASH/INGO/20905,2/27/2023 7:59:29 AM,Host Communities,4784,5152,4048,4416,18400,6130,6602,5188,5660,23580
16,Sudan,2021,SUD-21/HSD20/RA8/WASH/INGO/20905,2/27/2023 7:59:29 AM,Internally Displaced People,1300,1400,1100,1200,5000,1670,1798,1412,1540,6420
16,Sudan,2021,SUD-21/HSD20/RA8/WASH/INGO/20905,2/27/2023 7:59:29 AM,Overall,6084,6552,5148,5616,23400,7800,8400,6600,7200,30000
16,Sudan,2021,SUD-21/HSD20/RA8/WASH/INGO/21025,2/26/2023 12:25:30 PM,Host Communities,3000,3500,4500,5000,16000,3179,3309,4769,4964,16221
16,Sudan,2021,SUD-21/HSD20/RA8/WASH/INGO/21025,2/26/2023 12:25:30 PM,Overall,3000,3500,4500,5000,16000,3179,3309,4769,4964,16221
16,Sudan,2021,SUD-21/HSD20/RA8/WASH-E-P/INGO/21391,5/26/2023 8:30:12 PM,Host Communities,4220,4940,6850,7240,23250,6620,8760,10210,11200,36790
16,Sudan,2021,SUD-21/HSD20/RA8/WASH-E-P/INGO/21391,5/26/2023 8:30:12 PM,Overall,4220,4940,6850,7240,23250,6620,8760,10210,11200,36790
16,Sudan,2021,SUD-21/HSD20/RA8/WASH-N-P/INGO/20982,2/27/2023 8:37:07 AM,Host Communities,3000,3000,2000,2000,10000,11950,12946,17926,19419,62241
16,Sudan,2021,SUD-21/HSD20/RA8/WASH-N-P/INGO/20982,2/27/2023 8:37:07 AM,Internally Displaced People,2000,2000,1500,1500,7000,614,666,922,998,3200
16,Sudan,2021,SUD-21/HSD20/RA8/WASH-N-P/INGO/20982,2/27/2023 8:37:07 AM,Overall,5000,5000,3500,3500,17000,12564,13612,18848,20417,65441
16,Sudan,2021,SUD-21/HSD20/RA9/ESNFIs/NGO/20932,8/14/2022 6:34:13 AM,Host Communities,250,270,150,150,820,250,270,150,150,820
16,Sudan,2021,SUD-21/HSD20/RA9/ESNFIs/NGO/20932,8/14/2022 6:34:13 AM,Internally Displaced People,1500,1800,800,850,4950,1500,1800,800,850,4950
16,Sudan,2021,SUD-21/HSD20/RA9/ESNFIs/NGO/20932,8/14/2022 6:34:13 AM,Overall,2650,3270,1280,1400,8600,2650,3270,1280,1400,8600
16,Sudan,2021,SUD-21/HSD20/RA9/ESNFIs/NGO/20932,8/14/2022 6:34:13 AM,Returnees,900,1200,330,400,2830,900,1200,330,400,2830
16,Sudan,2021,SUD-21/HSD20/RA9/ESNFIs/NGO/20941,9/12/2022 11:36:09 AM,Internally Displaced People,1600,2000,500,500,4600,1600,2000,500,500,4600
16,Sudan,2021,SUD-21/HSD20/RA9/ESNFIs/NGO/20941,9/12/2022 11:36:09 AM,Overall,1600,2000,500,500,4600,1600,2000,500,500,4600
16,Sudan,2021,SUD-21/HSD20/RA9/ESNFIs-P-H/INGO/21052,12/4/2022 8:22:00 AM,Host Communities,2140,2940,2175,2811,10066,0,0,74,100,174
16,Sudan,2021,SUD-21/HSD20/RA9/ESNFIs-P-H/INGO/21052,12/4/2022 8:22:00 AM,Internally Displaced People,6906,9512,5731,7761,29910,1109,1533,2405,2372,7419
16,Sudan,2021,SUD-21/HSD20/RA9/ESNFIs-P-H/INGO/21052,12/4/2022 8:22:00 AM,Overall,9046,12452,7906,10572,39976,1109,1533,2479,2472,7593
16,Sudan,2021,SUD-21/HSD20/RA9/H-N/INGO/21035,2/27/2023 12:56:44 PM,Internally Displaced People,7814,8452,7495,8132,31893,632,3367,4006,4894,12899
16,Sudan,2021,SUD-21/HSD20/RA9/H-N/INGO/21035,2/27/2023 12:56:44 PM,Overall,7814,8452,7495,8132,31893,632,3367,4006,4894,12899
16,Sudan,2021,SUD-21/HSD20/RA9/H-N-WASH/INGO/20916,11/17/2022 9:13:08 AM,Host Communities,750,690,780,780,3000,473,435,492,492,1892
16,Sudan,2021,SUD-21/HSD20/RA9/H-N-WASH/INGO/20916,11/17/2022 9:13:08 AM,Internally Displaced People,1500,1380,1560,1560,6000,1890,1739,1966,1966,7561
16,Sudan,2021,SUD-21/HSD20/RA9/H-N-WASH/INGO/20916,11/17/2022 9:13:08 AM,Overall,2250,2070,2340,2340,9000,2363,2174,2458,2458,9453
16,Sudan,2021,SUD-21/HSD20/RA9/H-N-WASH/INGO/21051,12/27/2022 9:00:07 AM,Host Communities,15175,16862,4637,5480,42154,14929,15715,3929,4715,39288
16,Sudan,2021,SUD-21/HSD20/RA9/H-N-WASH/INGO/21051,12/27/2022 9:00:07 AM,Internally Displaced People,22680,25200,6930,8190,63000,22967,25434,6336,8466,63203
16,Sudan,2021,SUD-21/HSD20/RA9/H-N-WASH/INGO/21051,12/27/2022 9:00:07 AM,Overall,45595,50662,13932,16465,126654,45682,50144,13192,16712,125730
16,Sudan,2021,SUD-21/HSD20/RA9/H-N-WASH/INGO/21051,12/27/2022 9:00:07 AM,Refugees,7740,8600,2365,2795,21500,7786,8995,2927,3531,23239
16,Sudan,2021,SUD-21/HSD20/RA9/P/INGO/20934,2/27/2023 6:48:38 AM,Internally Displaced People,0,2500,0,1500,4000,1357,6843,651,10531,19382
16,Sudan,2021,SUD-21/HSD20/RA9/P/INGO/20934,2/27/2023 6:48:38 AM,Overall,0,2500,0,1500,4000,1357,6843,651,10531,19382
16,Sudan,2021,SUD-21/HSD20/RA9/P/INGO/21036,2/27/2023 12:53:46 PM,Internally Displaced People,7814,8452,7495,8132,31893,632,3367,4006,4894,12899
16,Sudan,2021,SUD-21/HSD20/RA9/P/INGO/21036,2/27/2023 12:53:46 PM,Overall,7814,8452,7495,8132,31893,632,3367,4006,4894,12899
16,Sudan,2021,SUD-21/HSD20/RA9/WASH/INGO/20933,9/12/2022 11:51:27 AM,Internally Displaced People,1800,2200,2500,2500,9000,3182,3889,4420,6187,17678
16,Sudan,2021,SUD-21/HSD20/RA9/WASH/INGO/20933,9/12/2022 11:51:27 AM,Overall,1800,2200,2500,2500,9000,3182,3889,4420,6187,17678
16,Sudan,2021,SUD-21/HSD20/RA9/WASH/INGO/20940,9/5/2022 7:13:14 AM,Internally Displaced People,1800,2200,3000,3000,10000,6907,8442,11512,11512,38373
16,Sudan,2021,SUD-21/HSD20/RA9/WASH/INGO/20940,9/5/2022 7:13:14 AM,Overall,1800,2200,3000,3000,10000,6907,8442,11512,11512,38373
16,Sudan,2021,SUD-21/HSD20/RA9/WASH/INGO/21034,2/2/2023 10:33:57 AM,Internally Displaced People,6251,6506,9377,9759,31893,7629,7941,11444,11911,38925
16,Sudan,2021,SUD-21/HSD20/RA9/WASH/INGO/21034,2/2/2023 10:33:57 AM,Overall,6251,6506,9377,9759,31893,7629,7941,11444,11911,38925
16,Sudan,2021,SUD-21/HSD20/SA1/E/NGO/19266,2/27/2023 1:00:22 PM,Other,78,82,0,0,160,78,82,0,0,160
16,Sudan,2021,SUD-21/HSD20/SA1/E/NGO/19266,2/27/2023 1:00:22 PM,Overall,78,82,7856,7768,15784,78,82,8538,8145,16843
16,Sudan,2021,SUD-21/HSD20/SA1/E/NGO/19266,2/27/2023 1:00:22 PM,Refugees,0,0,7856,7768,15624,0,0,8538,8145,16683
16,Sudan,2021,SUD-21/HSD20/SA1/E-H-N-P-WASH-ESNFIs/INGO/19431,7/25/2023 7:16:47 AM,Host Communities,30827,33704,9695,12106,86332,12562,18953,8395,8138,48048
16,Sudan,2021,SUD-21/HSD20/SA1/E-H-N-P-WASH-ESNFIs/INGO/19431,7/25/2023 7:16:47 AM,Internally Displaced People,9345,8550,2746,4402,25043,7814,8452,9240,12576,38082
16,Sudan,2021,SUD-21/HSD20/SA1/E-H-N-P-WASH-ESNFIs/INGO/19431,7/25/2023 7:16:47 AM,Overall,43734,45810,13563,18252,121359,21164,28296,18196,21332,88988
16,Sudan,2021,SUD-21/HSD20/SA1/E-H-N-P-WASH-ESNFIs/INGO/19431,7/25/2023 7:16:47 AM,Refugees,3562,3556,1122,1744,9984,788,891,561,618,2858
16,Sudan,2021,SUD-21/HSD20/SA1/ESNFIs/INGO/18792,2/27/2023 8:40:30 AM,Host Communities,1776,1707,2900,2785,9168,1135,1090,1854,1780,5859
16,Sudan,2021,SUD-21/HSD20/SA1/ESNFIs/INGO/18792,2/27/2023 8:40:30 AM,Internally Displaced People,484,465,789,758,2496,762,733,1244,1196,3935
16,Sudan,2021,SUD-21/HSD20/SA1/ESNFIs/INGO/18792,2/27/2023 8:40:30 AM,Overall,2325,2235,3795,3645,12000,1962,1886,3204,3078,10130
16,Sudan,2021,SUD-21/HSD20/SA1/ESNFIs/INGO/18792,2/27/2023 8:40:30 AM,Returnees,65,63,106,102,336,65,63,106,102,336
16,Sudan,2021,SUD-21/HSD20/SA1/ESNFIs/INGO/19544,2/26/2023 10:50:44 AM,Host Communities,2640,3120,3000,3240,12000,3987,5909,7423,7347,24666
16,Sudan,2021,SUD-21/HSD20/SA1/ESNFIs/INGO/19544,2/26/2023 10:50:44 AM,Overall,2640,3120,3000,3240,12000,3987,5909,7423,7347,24666
16,Sudan,2021,SUD-21/HSD20/SA1/E-WASH-P/INGO/19484,1/24/2023 10:32:09 AM,Host Communities,8028,14198,10699,8559,41484,8097,14303,11177,9550,43127
16,Sudan,2021,SUD-21/HSD20/SA1/E-WASH-P/INGO/19484,1/24/2023 10:32:09 AM,Internally Displaced People,868,1522,1086,869,4345,899,1587,1215,1064,4765
16,Sudan,2021,SUD-21/HSD20/SA1/E-WASH-P/INGO/19484,1/24/2023 10:32:09 AM,Overall,10853,19147,14232,11385,55617,10817,19093,14879,12773,57562
16,Sudan,2021,SUD-21/HSD20/SA1/E-WASH-P/INGO/19484,1/24/2023 10:32:09 AM,Refugees,382,670,479,382,1913,382,665,516,452,2015
16,Sudan,2021,SUD-21/HSD20/SA1/E-WASH-P/INGO/19484,1/24/2023 10:32:09 AM,Returnees,1575,2757,1968,1575,7875,1439,2538,1971,1707,7655
16,Sudan,2021,SUD-21/HSD20/SA1/H-FSL-P-WASH-ESNFIs/INGO/19240,2/27/2023 12:59:11 PM,Host Communities,14538,14789,17482,17356,64165,14819,14786,16151,17494,63250
16,Sudan,2021,SUD-21/HSD20/SA1/H-FSL-P-WASH-ESNFIs/INGO/19240,2/27/2023 12:59:11 PM,Internally Displaced People,21739,22113,26145,25961,95958,21354,22184,26116,25222,94876
16,Sudan,2021,SUD-21/HSD20/SA1/H-FSL-P-WASH-ESNFIs/INGO/19240,2/27/2023 12:59:11 PM,Other,1949,3732,4210,4164,14055,1912,3723,4012,4291,13938
16,Sudan,2021,SUD-21/HSD20/SA1/H-FSL-P-WASH-ESNFIs/INGO/19240,2/27/2023 12:59:11 PM,Overall,38226,40634,47837,47481,174178,38085,40693,46279,47007,172064
16,Sudan,2021,SUD-21/HSD20/SA1/H-N-P/NGO/19023,5/29/2023 10:29:06 AM,Host Communities,455,624,177,254,1510,455,855,374,413,2097
16,Sudan,2021,SUD-21/HSD20/SA1/H-N-P/NGO/19023,5/29/2023 10:29:06 AM,Internally Displaced People,455,624,177,254,1510,455,855,375,411,2096
16,Sudan,2021,SUD-21/HSD20/SA1/H-N-P/NGO/19023,5/29/2023 10:29:06 AM,Other,14,20,0,0,34,14,20,0,0,34
16,Sudan,2021,SUD-21/HSD20/SA1/H-N-P/NGO/19023,5/29/2023 10:29:06 AM,Overall,4565,5759,1770,2539,14633,4565,6221,2165,2855,15806
16,Sudan,2021,SUD-21/HSD20/SA1/H-N-P/NGO/19023,5/29/2023 10:29:06 AM,Refugees,3641,4491,1416,2031,11579,3641,4491,1416,2031,11579
16,Sudan,2021,SUD-21/HSD20/SA1/H-N-WASH-P/INGO/18925,2/26/2023 3:12:28 PM,Other,22900,23600,14781,15141,76422,8366,9400,5913,4485,28164
16,Sudan,2021,SUD-21/HSD20/SA1/H-N-WASH-P/INGO/18925,2/26/2023 3:12:28 PM,Overall,22900,23600,14781,15141,76422,8366,9400,5913,4485,28164
16,Sudan,2021,SUD-21/HSD20/SA1/H-P/NGO/19469,5/26/2023 8:01:54 PM,Host Communities,2389,3088,626,1252,7355,2389,3088,626,1252,7355
16,Sudan,2021,SUD-21/HSD20/SA1/H-P/NGO/19469,5/26/2023 8:01:54 PM,Internally Displaced People,2389,3088,626,1252,7355,2389,3088,626,1252,7355
16,Sudan,2021,SUD-21/HSD20/SA1/H-P/NGO/19469,5/26/2023 8:01:54 PM,Overall,5972,7720,1565,3130,18387,5972,7720,1565,3130,18387
16,Sudan,2021,SUD-21/HSD20/SA1/H-P/NGO/19469,5/26/2023 8:01:54 PM,Refugees,1194,1544,313,626,3677,1194,1544,313,626,3677
16,Sudan,2021,SUD-21/HSD20/SA1/H-WASH/INGO/18787,2/27/2023 12:33:26 PM,Host Communities,26042,25020,42489,40822,134373,20781,45247,19117,20577,105722
16,Sudan,2021,SUD-21/HSD20/SA1/H-WASH/INGO/18787,2/27/2023 12:33:26 PM,Internally Displaced People,19110,18361,31179,29956,98606,17642,32589,28495,27496,106222
16,Sudan,2021,SUD-21/HSD20/SA1/H-WASH/INGO/18787,2/27/2023 12:33:26 PM,Overall,45152,43381,73668,70778,232979,38423,77836,47612,48073,211944
16,Sudan,2021,SUD-21/HSD20/SA1/N-H/INGO/19472,2/26/2023 12:23:04 PM,Host Communities,2072,3332,2644,2923,10971,2160,4024,3505,3672,13361
16,Sudan,2021,SUD-21/HSD20/SA1/N-H/INGO/19472,2/26/2023 12:23:04 PM,Overall,2072,3332,2644,2923,10971,2160,4024,3505,3672,13361
16,Sudan,2021,SUD-21/HSD20/SA1/N-H-WASH/INGO/18899,7/2/2023 6:14:02 PM,Host Communities,18000,37200,12000,52800,120000,39755,82161,26504,116616,265036
16,Sudan,2021,SUD-21/HSD20/SA1/N-H-WASH/INGO/18899,7/2/2023 6:14:02 PM,Internally Displaced People,2250,4650,1500,6600,15000,4969,10270,3313,14577,33129
16,Sudan,2021,SUD-21/HSD20/SA1/N-H-WASH/INGO/18899,7/2/2023 6:14:02 PM,Overall,20250,41850,13500,59400,135000,44724,92431,29817,131193,298165
16,Sudan,2021,SUD-21/HSD20/SA1/N-P/NGO/18739,5/26/2023 7:47:41 PM,Host Communities,49,1489,1302,2048,4888,802,3317,1780,2281,8180
16,Sudan,2021,SUD-21/HSD20/SA1/N-P/NGO/18739,5/26/2023 7:47:41 PM,Internally Displaced People,49,1490,1302,2048,4889,804,3316,1780,2281,8181
16,Sudan,2021,SUD-21/HSD20/SA1/N-P/NGO/18739,5/26/2023 7:47:41 PM,Overall,120,3719,3257,5123,12219,1889,7803,4189,5367,19248
16,Sudan,2021,SUD-21/HSD20/SA1/N-P/NGO/18739,5/26/2023 7:47:41 PM,Refugees,22,740,653,1027,2442,283,1170,629,805,2887
16,Sudan,2021,SUD-21/HSD20/SA1/N-WASH-H/INGO/18779,2/26/2023 12:28:38 PM,Other,9220,9596,8677,9401,36894,6351,8805,7853,8231,31240
16,Sudan,2021,SUD-21/HSD20/SA1/N-WASH-H/INGO/18779,2/26/2023 12:28:38 PM,Overall,9220,9596,8677,9401,36894,6351,8805,7853,8231,31240
16,Sudan,2021,SUD-21/HSD20/SA1/P/INGO/19448,2/27/2023 1:09:11 PM,Host Communities,2872,3175,4384,4687,15118,3081,3406,4703,5028,16218
16,Sudan,2021,SUD-21/HSD20/SA1/P/INGO/19448,2/27/2023 1:09:11 PM,Internally Displaced People,4787,5291,7307,7811,25196,5135,5676,7839,8379,27029
16,Sudan,2021,SUD-21/HSD20/SA1/P/INGO/19448,2/27/2023 1:09:11 PM,Overall,10050,11109,15341,16400,52900,10781,11917,16458,17593,56749
16,Sudan,2021,SUD-21/HSD20/SA1/P/INGO/19448,2/27/2023 1:09:11 PM,Refugees,476,526,727,778,2507,511,564,780,835,2690
16,Sudan,2021,SUD-21/HSD20/SA1/P/INGO/19448,2/27/2023 1:09:11 PM,Returnees,1915,2117,2923,3124,10079,2054,2271,3136,3351,10812
16,Sudan,2021,SUD-21/HSD20/SA1/P/INGO/19545,2/14/2023 12:15:29 PM,Host Communities,2819,3013,1847,2040,9719,2847,3043,1865,2060,9815
16,Sudan,2021,SUD-21/HSD20/SA1/P/INGO/19545,2/14/2023 12:15:29 PM,Overall,9396,10044,6156,6803,32399,9489,10144,6217,6870,32720
16,Sudan,2021,SUD-21/HSD20/SA1/P/INGO/19545,2/14/2023 12:15:29 PM,Refugees,6577,7031,4309,4763,22680,6642,7101,4352,4810,22905
16,Sudan,2021,SUD-21/HSD20/SA1/P/NGO/19445,2/27/2023 1:06:11 PM,Host Communities,189,2147,223,1245,3804,180,2147,200,1217,3744
16,Sudan,2021,SUD-21/HSD20/SA1/P/NGO/19445,2/27/2023 1:06:11 PM,Internally Displaced People,76,859,89,498,1522,200,3385,89,298,3972
16,Sudan,2021,SUD-21/HSD20/SA1/P/NGO/19445,2/27/2023 1:06:11 PM,Overall,379,4294,445,2490,7608,434,6882,429,2289,10034
16,Sudan,2021,SUD-21/HSD20/SA1/P/NGO/19445,2/27/2023 1:06:11 PM,Refugees,38,429,44,249,760,30,450,50,263,793
16,Sudan,2021,SUD-21/HSD20/SA1/P/NGO/19445,2/27/2023 1:06:11 PM,Returnees,76,859,89,498,1522,24,900,90,511,1525
16,Sudan,2021,SUD-21/HSD20/SA1/P-E/INGO/18845,5/26/2023 8:17:33 PM,Other,1135,1747,1929,2016,6827,1135,1747,1929,2016,6827
16,Sudan,2021,SUD-21/HSD20/SA1/P-E/INGO/18845,5/26/2023 8:17:33 PM,Overall,1621,2496,2756,2880,9753,1621,2496,2756,2880,9753
16,Sudan,2021,SUD-21/HSD20/SA1/P-E/INGO/18845,5/26/2023 8:17:33 PM,Refugees,486,749,827,864,2926,486,749,827,864,2926
16,Sudan,2021,SUD-21/HSD20/SA1/P-E/INGO/19134,2/27/2023 1:18:44 PM,Host Communities,216,519,895,1098,2728,216,519,895,1098,2728
16,Sudan,2021,SUD-21/HSD20/SA1/P-E/INGO/19134,2/27/2023 1:18:44 PM,Internally Displaced People,657,1580,2724,3341,8302,657,1580,2724,3341,8302
16,Sudan,2021,SUD-21/HSD20/SA1/P-E/INGO/19134,2/27/2023 1:18:44 PM,Overall,939,2257,3891,4773,11860,939,2257,3891,4773,11860
16,Sudan,2021,SUD-21/HSD20/SA1/P-E/INGO/19134,2/27/2023 1:18:44 PM,Returnees,66,158,272,334,830,66,158,272,334,830
16,Sudan,2021,SUD-21/HSD20/SA1/P-E/INGO/19148,2/26/2023 10:59:01 AM,Host Communities,577,600,866,901,2944,771,1045,860,1416,4092
16,Sudan,2021,SUD-21/HSD20/SA1/P-E/INGO/19148,2/26/2023 10:59:01 AM,Internally Displaced People,893,928,1339,1392,4552,126,230,415,940,1711
16,Sudan,2021,SUD-21/HSD20/SA1/P-E/INGO/19148,2/26/2023 10:59:01 AM,Overall,2255,2345,3382,3518,11500,1681,2144,2297,3663,9785
16,Sudan,2021,SUD-21/HSD20/SA1/P-E/INGO/19148,2/26/2023 10:59:01 AM,Refugees,365,380,547,570,1862,204,323,295,425,1247
16,Sudan,2021,SUD-21/HSD20/SA1/P-E/INGO/19148,2/26/2023 10:59:01 AM,Returnees,420,437,630,655,2142,580,546,727,882,2735
16,Sudan,2021,SUD-21/HSD20/SA1/P-E/NGO/19036,2/28/2023 11:34:05 AM,Host Communities,2800,3500,920,1500,8720,349,1557,1773,1985,5664
16,Sudan,2021,SUD-21/HSD20/SA1/P-E/NGO/19036,2/28/2023 11:34:05 AM,Overall,2800,3500,920,1500,8720,349,1557,1773,1985,5664
16,Sudan,2021,SUD-21/HSD20/SA1/P-E/NGO/19092,1/24/2023 9:53:08 AM,Host Communities,8450,7900,950,1200,18500,8450,7900,950,1200,18500
16,Sudan,2021,SUD-21/HSD20/SA1/P-E/NGO/19092,1/24/2023 9:53:08 AM,Internally Displaced People,900,1000,600,500,3000,900,1000,600,500,3000
16,Sudan,2021,SUD-21/HSD20/SA1/P-E/NGO/19092,1/24/2023 9:53:08 AM,Overall,11500,10900,1900,2300,26600,11500,10900,1900,2300,26600
16,Sudan,2021,SUD-21/HSD20/SA1/P-E/NGO/19092,1/24/2023 9:53:08 AM,Refugees,1550,1300,150,200,3200,1550,1300,150,200,3200
16,Sudan,2021,SUD-21/HSD20/SA1/P-E/NGO/19092,1/24/2023 9:53:08 AM,Returnees,600,700,200,400,1900,600,700,200,400,1900
16,Sudan,2021,SUD-21/HSD20/SA1/P-E/NGO/19473,11/16/2022 7:35:22 AM,Host Communities,1945,2024,2918,3037,9924,2030,2181,4022,4564,12797
16,Sudan,2021,SUD-21/HSD20/SA1/P-E/NGO/19473,11/16/2022 7:35:22 AM,Internally Displaced People,486,507,729,759,2481,1198,2510,2200,2740,8648
16,Sudan,2021,SUD-21/HSD20/SA1/P-E/NGO/19473,11/16/2022 7:35:22 AM,Overall,3241,3375,4863,5061,16540,3638,5209,7045,8192,24084
16,Sudan,2021,SUD-21/HSD20/SA1/P-E/NGO/19473,11/16/2022 7:35:22 AM,Refugees,810,844,1216,1265,4135,410,518,823,888,2639
16,Sudan,2021,SUD-21/HSD20/SA1/P-ESNFIs/NGO/18800,5/26/2023 8:06:25 PM,Host Communities,1160,1240,760,840,4000,1324,1335,1434,1445,5538
16,Sudan,2021,SUD-21/HSD20/SA1/P-ESNFIs/NGO/18800,5/26/2023 8:06:25 PM,Internally Displaced People,1450,1550,950,1050,5000,2124,2160,2321,2339,8944
16,Sudan,2021,SUD-21/HSD20/SA1/P-ESNFIs/NGO/18800,5/26/2023 8:06:25 PM,Overall,2900,3100,1900,2100,10000,3510,3568,3804,3834,14716
16,Sudan,2021,SUD-21/HSD20/SA1/P-ESNFIs/NGO/18800,5/26/2023 8:06:25 PM,Refugees,290,310,190,210,1000,62,73,49,50,234
16,Sudan,2021,SUD-21/HSD20/SA1/P-H/NGO/18998,4/10/2023 7:51:45 AM,Host Communities,2174,20917,3002,2940,29033,2174,20917,3002,2940,29033
16,Sudan,2021,SUD-21/HSD20/SA1/P-H/NGO/18998,4/10/2023 7:51:45 AM,Internally Displaced People,163,173,405,439,1180,163,173,405,439,1180
16,Sudan,2021,SUD-21/HSD20/SA1/P-H/NGO/18998,4/10/2023 7:51:45 AM,Other,769,1208,613,825,3415,769,1208,613,825,3415
16,Sudan,2021,SUD-21/HSD20/SA1/P-H/NGO/18998,4/10/2023 7:51:45 AM,Overall,3300,22429,4148,4278,34155,3300,22429,4148,4278,34155
16,Sudan,2021,SUD-21/HSD20/SA1/P-H/NGO/18998,4/10/2023 7:51:45 AM,Refugees,190,123,119,66,498,190,123,119,66,498
16,Sudan,2021,SUD-21/HSD20/SA1/P-H/NGO/18998,4/10/2023 7:51:45 AM,Returnees,4,8,9,8,29,4,8,9,8,29
16,Sudan,2021,SUD-21/HSD20/SA1/P-WASH-H-N/INGO/18846,2/28/2023 6:51:47 AM,Host Communities,17669,20318,15356,15739,69082,17669,20318,15356,15739,69082
16,Sudan,2021,SUD-21/HSD20/SA1/P-WASH-H-N/INGO/18846,2/28/2023 6:51:47 AM,Overall,23249,26734,20205,20709,90897,23249,26734,20205,20709,90897
16,Sudan,2021,SUD-21/HSD20/SA1/P-WASH-H-N/INGO/18846,2/28/2023 6:51:47 AM,Refugees,5580,6416,4849,4970,21815,5580,6416,4849,4970,21815
16,Sudan,2021,SUD-21/HSD20/SA1/WASH/INGO/18744,2/27/2023 8:09:29 AM,Host Communities,3037,3238,3526,3800,13601,1211,1383,1359,1578,5531
16,Sudan,2021,SUD-21/HSD20/SA1/WASH/INGO/18744,2/27/2023 8:09:29 AM,Internally Displaced People,3330,3523,3880,4140,14873,1576,1327,1665,1719,6287
16,Sudan,2021,SUD-21/HSD20/SA1/WASH/INGO/18744,2/27/2023 8:09:29 AM,Overall,16279,18287,20459,22603,77628,4246,4388,5199,5381,19214
16,Sudan,2021,SUD-21/HSD20/SA1/WASH/INGO/18744,2/27/2023 8:09:29 AM,Refugees,2320,2549,2954,3101,10924,120,243,198,267,828
16,Sudan,2021,SUD-21/HSD20/SA1/WASH/INGO/18744,2/27/2023 8:09:29 AM,Returnees,7592,8977,10099,11562,38230,1339,1435,1977,1817,6568
16,Sudan,2021,SUD-21/HSD20/SA1/WASH/INGO/19341,2/14/2023 2:21:54 PM,Host Communities,650,1285,1562,1510,5007,563,1114,1354,1309,4340
16,Sudan,2021,SUD-21/HSD20/SA1/WASH/INGO/19341,2/14/2023 2:21:54 PM,Internally Displaced People,1410,1364,1130,1186,5090,1508,1564,1229,1285,5586
16,Sudan,2021,SUD-21/HSD20/SA1/WASH/INGO/19341,2/14/2023 2:21:54 PM,Other,9086,8761,7139,7463,32449,10940,10549,8596,8986,39071
16,Sudan,2021,SUD-21/HSD20/SA1/WASH/INGO/19341,2/14/2023 2:21:54 PM,Overall,13747,16549,15936,16200,62432,15840,18816,17818,18150,70624
16,Sudan,2021,SUD-21/HSD20/SA1/WASH/INGO/19341,2/14/2023 2:21:54 PM,Refugees,2601,5139,6105,6041,19886,2829,5589,6639,6570,21627
16,Sudan,2021,SUD-21/HSD20/SA1/WASH/INGO/19485,2/26/2023 10:05:09 AM,Host Communities,7531,10109,7839,9411,34890,7485,10048,7792,9354,34679
16,Sudan,2021,SUD-21/HSD20/SA1/WASH/INGO/19485,2/26/2023 10:05:09 AM,Other,1178,1198,1417,1407,5200,1321,1773,1375,1651,6120
16,Sudan,2021,SUD-21/HSD20/SA1/WASH/INGO/19485,2/26/2023 10:05:09 AM,Overall,8709,11307,9256,10818,40090,8806,11821,9167,11005,40799
16,Sudan,2021,SUD-21/HSD20/SA1/WASH-E-P/INGO/18828,5/26/2023 8:14:19 PM,Host Communities,36000,36000,33000,33000,138000,42000,42000,36000,36000,156000
16,Sudan,2021,SUD-21/HSD20/SA1/WASH-E-P/INGO/18828,5/26/2023 8:14:19 PM,Overall,36000,36000,33000,33000,138000,42000,42000,36000,36000,156000
16,Sudan,2021,SUD-21/HSD20/SA1/WASH-ESNFIs/INGO/19446,2/26/2023 11:45:36 AM,Overall,3036,3253,2277,2277,10843,2297,2461,1722,1722,8202
16,Sudan,2021,SUD-21/HSD20/SA1/WASH-ESNFIs/INGO/19446,2/26/2023 11:45:36 AM,Refugees,3036,3253,2277,2277,10843,2297,2461,1722,1722,8202
16,Sudan,2021,SUD-21/HSD20/SA1/WASH-N-P/INGO/18811,2/27/2023 12:51:26 PM,Host Communities,24900,23924,6323,6074,61221,7024,11569,3058,2937,24588
16,Sudan,2021,SUD-21/HSD20/SA1/WASH-N-P/INGO/18811,2/27/2023 12:51:26 PM,Internally Displaced People,8699,8504,3132,3083,23418,8745,8402,2221,2133,21501
16,Sudan,2021,SUD-21/HSD20/SA1/WASH-N-P/INGO/18811,2/27/2023 12:51:26 PM,Overall,46271,44602,12671,12249,115793,28426,32132,8493,8157,77208
16,Sudan,2021,SUD-21/HSD20/SA1/WASH-N-P/INGO/18811,2/27/2023 12:51:26 PM,Refugees,12672,12174,3216,3092,31154,12657,12161,3214,3087,31119
16,Sudan,2022,SUD-22/HSD20/RA1/FSL/INGO/21583,2/26/2023 12:18:39 PM,Host Communities,7750,7500,5000,4750,25000,7493,7620,5080,5207,25400
16,Sudan,2022,SUD-22/HSD20/RA1/FSL/INGO/21583,2/26/2023 12:18:39 PM,Overall,7750,7500,5000,4750,25000,7493,7620,5080,5207,25400
16,Sudan,2022,SUD-22/HSD20/RA1/FSL/INGO/21716,5/26/2023 9:11:49 PM,Host Communities,3631,4539,4902,5084,18156,3633,3791,4441,4791,16656
16,Sudan,2022,SUD-22/HSD20/RA1/FSL/INGO/21716,5/26/2023 9:11:49 PM,Internally Displaced People,3183,3978,4296,4455,15912,3783,3949,4626,4987,17345
16,Sudan,2022,SUD-22/HSD20/RA1/FSL/INGO/21716,5/26/2023 9:11:49 PM,Overall,8160,10200,11016,11424,40800,12414,12956,15177,16363,56910
16,Sudan,2022,SUD-22/HSD20/RA1/FSL/INGO/21716,5/26/2023 9:11:49 PM,Returnees,1346,1683,1818,1885,6732,4998,5216,6110,6585,22909
16,Sudan,2022,SUD-22/HSD20/RA1/FSL-N/INGO/21588,5/26/2023 9:24:13 PM,Host Communities,12811,13133,19098,19814,64856,8502,11012,15321,14393,49228
16,Sudan,2022,SUD-22/HSD20/RA1/FSL-N/INGO/21588,5/26/2023 9:24:13 PM,Internally Displaced People,679,735,1029,1095,3538,0,0,0,0,0
16,Sudan,2022,SUD-22/HSD20/RA1/FSL-N/INGO/21588,5/26/2023 9:24:13 PM,Overall,14384,14809,21466,22326,72985,11879,15312,20937,19641,67769
16,Sudan,2022,SUD-22/HSD20/RA1/FSL-N/INGO/21588,5/26/2023 9:24:13 PM,Refugees,215,206,310,322,1053,0,0,0,0,0
16,Sudan,2022,SUD-22/HSD20/RA1/FSL-N/INGO/21588,5/26/2023 9:24:13 PM,Returnees,679,735,1029,1095,3538,3377,4300,5616,5248,18541
16,Sudan,2022,SUD-22/HSD20/RA1/FSL-N/INGO/21803,12/29/2022 7:01:37 AM,Host Communities,14500,8500,500,500,24000,22900,15100,500,500,39000
16,Sudan,2022,SUD-22/HSD20/RA1/FSL-N/INGO/21803,12/29/2022 7:01:37 AM,Overall,14500,8500,500,500,24000,22900,15100,500,500,39000
16,Sudan,2022,SUD-22/HSD20/RA1/FSL-N/INGO/21804,2/26/2023 8:17:27 AM,Host Communities,6429,7293,9939,11339,35000,2235,5791,47963,52060,108049
16,Sudan,2022,SUD-22/HSD20/RA1/FSL-N/INGO/21804,2/26/2023 8:17:27 AM,Overall,6429,7293,9939,11339,35000,2235,5791,47963,52060,108049
16,Sudan,2022,SUD-22/HSD20/RA1/N/INGO/21584,2/26/2023 12:09:35 PM,Host Communities,30900,32601,8820,9180,81501,13,2549,7060,7350,16972
16,Sudan,2022,SUD-22/HSD20/RA1/N/INGO/21584,2/26/2023 12:09:35 PM,Overall,30900,32601,8820,9180,81501,13,2549,7060,7350,16972
16,Sudan,2022,SUD-22/HSD20/RA1/N-WASH/INGO/21714,6/7/2023 2:11:56 PM,Host Communities,2803,2917,3567,3713,13000,2803,2917,3567,3713,13000
16,Sudan,2022,SUD-22/HSD20/RA1/N-WASH/INGO/21714,6/7/2023 2:11:56 PM,Internally Displaced People,3234,3366,4116,4284,15000,3234,3366,4116,4284,15000
16,Sudan,2022,SUD-22/HSD20/RA1/N-WASH/INGO/21714,6/7/2023 2:11:56 PM,Other,647,673,823,857,3000,647,673,823,857,3000
16,Sudan,2022,SUD-22/HSD20/RA1/N-WASH/INGO/21714,6/7/2023 2:11:56 PM,Overall,13556,14144,15254,16016,58970,11134,11576,12271,12989,47970
16,Sudan,2022,SUD-22/HSD20/RA1/N-WASH/INGO/21714,6/7/2023 2:11:56 PM,Refugees,2372,2468,3018,3142,11000,0,0,0,0,0
16,Sudan,2022,SUD-22/HSD20/RA1/N-WASH/INGO/21714,6/7/2023 2:11:56 PM,Returnees,4500,4720,3730,4020,16970,4450,4620,3765,4135,16970
16,Sudan,2022,SUD-22/HSD20/RA1/WASH/INGO/21585,2/26/2023 11:14:56 AM,Host Communities,6930,9135,6930,8505,31500,9577,12625,9577,11754,43533
16,Sudan,2022,SUD-22/HSD20/RA1/WASH/INGO/21585,2/26/2023 11:14:56 AM,Overall,6930,9135,6930,8505,31500,9577,12625,9577,11754,43533
16,Sudan,2022,SUD-22/HSD20/RA1/WASH/NGO/21587,2/27/2023 11:51:49 AM,Host Communities,13092,20947,8902,9427,52368,13092,20947,8902,9427,52368
16,Sudan,2022,SUD-22/HSD20/RA1/WASH/NGO/21587,2/27/2023 11:51:49 AM,Internally Displaced People,15840,25440,10812,11448,63540,15840,25440,10812,11448,63540
16,Sudan,2022,SUD-22/HSD20/RA1/WASH/NGO/21587,2/27/2023 11:51:49 AM,Overall,39705,63623,27039,28633,159000,39705,63623,27039,28633,159000
16,Sudan,2022,SUD-22/HSD20/RA1/WASH/NGO/21587,2/27/2023 11:51:49 AM,Returnees,10773,17236,7325,7758,43092,10773,17236,7325,7758,43092
16,Sudan,2022,SUD-22/HSD20/RA2/ESNFIs-WASH-P/INGO/21592,7/27/2023 8:59:21 AM,Internally Displaced People,4070,4715,6803,7037,22625,4082,4730,6824,7059,22695
16,Sudan,2022,SUD-22/HSD20/RA2/ESNFIs-WASH-P/INGO/21592,7/27/2023 8:59:21 AM,Other,262,303,288,298,1151,262,303,288,298,1151
16,Sudan,2022,SUD-22/HSD20/RA2/ESNFIs-WASH-P/INGO/21592,7/27/2023 8:59:21 AM,Overall,4332,5018,7091,7335,23776,4344,5033,7112,7357,23846
16,Sudan,2022,SUD-22/HSD20/RA2/FSL-WASH/NGO/21594,2/28/2023 8:17:50 AM,Internally Displaced People,432,720,288,432,1872,30,50,80,90,250
16,Sudan,2022,SUD-22/HSD20/RA2/FSL-WASH/NGO/21594,2/28/2023 8:17:50 AM,Other,1728,2592,1152,1728,7200,2450,2550,1225,1275,7500
16,Sudan,2022,SUD-22/HSD20/RA2/FSL-WASH/NGO/21594,2/28/2023 8:17:50 AM,Overall,2160,3312,1440,2160,9072,2480,2600,1305,1365,7750
16,Sudan,2022,SUD-22/HSD20/RA2/N-H-ESNFIs/INGO/21591,7/27/2023 9:07:02 AM,Host Communities,762,2135,2592,2135,7624,1790,6750,2323,3882,14745
16,Sudan,2022,SUD-22/HSD20/RA2/N-H-ESNFIs/INGO/21591,7/27/2023 9:07:02 AM,Internally Displaced People,1525,4270,5183,4270,15248,1190,7350,3159,3683,15382
16,Sudan,2022,SUD-22/HSD20/RA2/N-H-ESNFIs/INGO/21591,7/27/2023 9:07:02 AM,Other,1525,4270,5183,4270,15248,810,1059,2348,3804,8021
16,Sudan,2022,SUD-22/HSD20/RA2/N-H-ESNFIs/INGO/21591,7/27/2023 9:07:02 AM,Overall,3812,10675,12958,10675,38120,3790,15159,7830,11369,38148
16,Sudan,2022,SUD-22/HSD20/RA2/WASH-FSL-P/INGO/21593,2/27/2023 7:54:15 AM,Host Communities,3698,3973,2876,3151,13698,3200,4000,3221,3650,14071
16,Sudan,2022,SUD-22/HSD20/RA2/WASH-FSL-P/INGO/21593,2/27/2023 7:54:15 AM,Internally Displaced People,11831,12707,9202,10078,43818,13854,12760,11764,12500,50878
16,Sudan,2022,SUD-22/HSD20/RA2/WASH-FSL-P/INGO/21593,2/27/2023 7:54:15 AM,Other,2962,3181,2304,2523,10970,3700,3850,2800,2767,13117
16,Sudan,2022,SUD-22/HSD20/RA2/WASH-FSL-P/INGO/21593,2/27/2023 7:54:15 AM,Overall,18491,19861,14382,15752,68486,20754,20610,17785,18917,78066
16,Sudan,2022,SUD-22/HSD20/RA3/ESNFIs/UN/22373,9/4/2023 9:59:13 AM,Host Communities,2080,2778,2620,3547,11025,3163,4218,3983,5391,16755
16,Sudan,2022,SUD-22/HSD20/RA3/ESNFIs/UN/22373,9/4/2023 9:59:13 AM,Internally Displaced People,5509,7348,6941,9402,29200,5142,6858,6476,8764,27240
16,Sudan,2022,SUD-22/HSD20/RA3/ESNFIs/UN/22373,9/4/2023 9:59:13 AM,Overall,10850,14476,13667,18507,57500,10930,14577,13765,18628,57900
16,Sudan,2022,SUD-22/HSD20/RA3/ESNFIs/UN/22373,9/4/2023 9:59:13 AM,Refugees,2501,3336,3150,4263,13250,2625,3501,3306,4473,13905
16,Sudan,2022,SUD-22/HSD20/RA3/ESNFIs/UN/22373,9/4/2023 9:59:13 AM,Returnees,760,1014,956,1295,4025,0,0,0,0,0
16,Sudan,2022,SUD-22/HSD20/RA4/E/INGO/23397,2/27/2023 12:17:03 PM,Host Communities,0,0,766,641,1407,0,0,711,631,1342
16,Sudan,2022,SUD-22/HSD20/RA4/E/INGO/23397,2/27/2023 12:17:03 PM,Internally Displaced People,0,0,2471,1992,4463,0,0,2033,1972,4005
16,Sudan,2022,SUD-22/HSD20/RA4/E/INGO/23397,2/27/2023 12:17:03 PM,Overall,0,0,3237,2633,5870,0,0,2744,2603,5347
16,Sudan,2022,SUD-22/HSD20/RA4/ESNFIs/NGO/23400,2/28/2023 8:13:52 AM,Host Communities,475,475,100,100,1150,475,475,100,100,1150
16,Sudan,2022,SUD-22/HSD20/RA4/ESNFIs/NGO/23400,2/28/2023 8:13:52 AM,Internally Displaced People,3000,4000,425,425,7850,3000,4000,425,425,7850
16,Sudan,2022,SUD-22/HSD20/RA4/ESNFIs/NGO/23400,2/28/2023 8:13:52 AM,Overall,3950,4950,675,675,10250,3950,4950,675,675,10250
16,Sudan,2022,SUD-22/HSD20/RA4/ESNFIs/NGO/23400,2/28/2023 8:13:52 AM,Returnees,475,475,150,150,1250,475,475,150,150,1250
16,Sudan,2022,SUD-22/HSD20/RA4/WASH/INGO/23415,5/26/2023 8:47:44 PM,Internally Displaced People,25643,33741,32391,43189,134964,25643,33741,32391,43189,134964
16,Sudan,2022,SUD-22/HSD20/RA4/WASH/INGO/23415,5/26/2023 8:47:44 PM,Overall,25643,33741,32391,43189,134964,25643,33741,32391,43189,134964
16,Sudan,2022,SUD-22/HSD20/RA4/WASH-H-P/INGO/23383,7/27/2023 8:56:20 AM,Host Communities,20544,28031,16519,22421,87515,2605,7845,4866,4795,20111
16,Sudan,2022,SUD-22/HSD20/RA4/WASH-H-P/INGO/23383,7/27/2023 8:56:20 AM,Internally Displaced People,11545,15429,10185,12932,50091,8273,20565,12603,11210,52651
16,Sudan,2022,SUD-22/HSD20/RA4/WASH-H-P/INGO/23383,7/27/2023 8:56:20 AM,Overall,32089,43460,26704,35353,137606,10878,28410,17469,16005,72762
16,Sudan,2022,SUD-22/HSD20/RA5/WASH/NGO/23559,7/25/2023 6:32:20 AM,Host Communities,2604,3503,3255,4278,13640,1823,2452,2279,2995,9549
16,Sudan,2022,SUD-22/HSD20/RA5/WASH/NGO/23559,7/25/2023 6:32:20 AM,Internally Displaced People,882,1187,1102,1449,4620,617,831,771,1014,3233
16,Sudan,2022,SUD-22/HSD20/RA5/WASH/NGO/23559,7/25/2023 6:32:20 AM,Overall,4200,5650,5250,6900,22000,2940,3955,3675,4830,15400
16,Sudan,2022,SUD-22/HSD20/RA5/WASH/NGO/23559,7/25/2023 6:32:20 AM,Refugees,336,452,420,552,1760,235,316,294,386,1231
16,Sudan,2022,SUD-22/HSD20/RA5/WASH/NGO/23559,7/25/2023 6:32:20 AM,Returnees,378,508,473,621,1980,265,356,331,435,1387
16,Sudan,2022,SUD-22/HSD20/RA6/E/INGO/24315,9/6/2023 8:09:57 AM,Host Communities,380,569,151,227,1327,0,0,659,702,1361
16,Sudan,2022,SUD-22/HSD20/RA6/E/INGO/24315,9/6/2023 8:09:57 AM,Internally Displaced People,253,380,101,152,886,12,24,31,21,88
16,Sudan,2022,SUD-22/HSD20/RA6/E/INGO/24315,9/6/2023 8:09:57 AM,Overall,633,949,252,379,2213,12,24,690,723,1449
16,Sudan,2022,SUD-22/HSD20/SA1/P/NGO/21799,9/4/2023 9:00:18 AM,Host Communities,1180,1210,2000,3000,7390,1180,1210,2000,3000,7390
16,Sudan,2022,SUD-22/HSD20/SA1/P/NGO/21799,9/4/2023 9:00:18 AM,Internally Displaced People,2900,3100,275,800,7075,2900,3100,275,800,7075
16,Sudan,2022,SUD-22/HSD20/SA1/P/NGO/21799,9/4/2023 9:00:18 AM,Other,450,550,539,660,2199,450,550,539,660,2199
16,Sudan,2022,SUD-22/HSD20/SA1/P/NGO/21799,9/4/2023 9:00:18 AM,Overall,5690,6111,3039,5160,20000,5690,6111,3039,5160,20000
16,Sudan,2022,SUD-22/HSD20/SA1/P/NGO/21799,9/4/2023 9:00:18 AM,Returnees,1160,1251,225,700,3336,1160,1251,225,700,3336
15,Sudan (UNDP),2013,SUD-13/S1/N/NGO/5,5/4/2015 11:02:54 AM,Overall,12500,12500,12500,12500,50000,0,0,0,0,0
15,Sudan (UNDP),2014,SUD-14/HSD20/S1/H/INGO/1337,10/8/2015 11:06:12 AM,Overall,9266,9644,6710,6984,32604,0,0,0,0,0
15,Sudan (UNDP),2014,SUD-14/HSD20/S1/H/INGO/1338,10/8/2015 11:06:16 AM,Overall,112633,117233,23080,24010,276956,0,0,0,0,0
15,Sudan (UNDP),2014,SUD-14/HSD20/S1/N/INGO/1339,12/6/2022 12:02:56 PM,Overall,10242,17564,5718,9156,42680,6157,15832,11995,20615,54599
15,Sudan (UNDP),2014,SUD-14/HSD20/S1/WASH/UN/1340,10/8/2015 11:06:12 AM,Internally Displaced People,35378,46699,29717,29717,141511,35378,46699,29717,29717,141511
15,Sudan (UNDP),2014,SUD-14/HSD20/S1/WASH/UN/1340,10/8/2015 11:06:12 AM,Overall,36128,47689,30347,30347,144511,37140,48150,31500,32300,149090
15,Sudan (UNDP),2014,SUD-14/HSD20/S1/WASH/UN/1340,10/8/2015 11:06:12 AM,People in Host Communities,750,990,630,630,3000,1762,1451,1783,2583,7579
15,Sudan (UNDP),2014,SUD-14/R/CCS/UN/1027,3/30/2016 12:15:16 PM,Overall,15750,19250,6900,8100,50000,49302,60258,21599,25355,156514
15,Sudan (UNDP),2014,SUD-14/R/E/INGO/1030,5/25/2016 12:25:46 PM,Overall,30,30,1500,1500,3060,37,23,1500,1500,3060
15,Sudan (UNDP),2014,SUD-14/R/E/UN/1018,10/8/2015 11:10:20 AM,Overall,50,50,6585,6635,13320,65,15,8462,7723,16265
15,Sudan (UNDP),2014,SUD-14/R/FSL/INGO/1040,10/8/2015 11:10:22 AM,Overall,16000,17000,20000,22000,75000,16000,17000,20000,22000,75000
15,Sudan (UNDP),2014,SUD-14/R/H/UN/1017,3/30/2016 8:09:53 AM,Overall,1500,12816,1000,6500,21816,200,10200,200,6000,16600
15,Sudan (UNDP),2014,SUD-14/R/H/UN/1020,3/30/2016 7:49:43 AM,Overall,17556,28644,9662,10138,66000,18448,30097,10153,10652,69350
15,Sudan (UNDP),2014,SUD-14/R/H/UN/1022,10/8/2015 11:10:20 AM,Overall,48960,53040,33320,34680,170000,47996,52204,32732,34068,167000
15,Sudan (UNDP),2014,SUD-14/R/H/UN/1045,10/3/2016 12:29:44 PM,Overall,26775,25750,8900,8575,70000,26120,24960,8700,8380,68160
15,Sudan (UNDP),2014,SUD-14/R/H/UN/1046,1/8/2017 1:05:42 PM,Children under 5,0,0,4374,4550,8924,0,0,3650,4201,7851
15,Sudan (UNDP),2014,SUD-14/R/H/UN/1046,1/8/2017 1:05:42 PM,Overall,10709,10263,11601,12047,44620,5988,5747,6498,6746,24979
15,Sudan (UNDP),2014,SUD-14/R/H/UN/1046,1/8/2017 1:05:42 PM,"Staff (own or partner staff, authorities)",870,276,0,0,1146,871,266,0,0,1137
15,Sudan (UNDP),2014,SUD-14/R/H/UN/1047,1/8/2017 1:04:36 PM,Overall,1179346,1115028,221778,206381,2722533,1420752,1367663,285549,253281,3327245
15,Sudan (UNDP),2014,SUD-14/R/H/UN/1047,1/8/2017 1:04:36 PM,"Staff (own or partner staff, authorities)",1200,600,0,0,1800,940,712,0,0,1652
15,Sudan (UNDP),2014,SUD-14/R/H/UN/1047,1/8/2017 1:04:36 PM,"Trainers, Promoters, Caretakers, committee members, etc.",7000,4000,0,0,11000,7070,4806,0,0,11876
15,Sudan (UNDP),2014,SUD-14/R/N/INGO/1024,3/17/2016 8:34:15 AM,Overall,0,790,2347,2719,5856,0,0,721,911,1632
15,Sudan (UNDP),2014,SUD-14/R/N/INGO/1044,10/8/2015 11:10:21 AM,Children under 5,0,0,1015,1056,2071,0,0,915,1231,2146
15,Sudan (UNDP),2014,SUD-14/R/N/INGO/1044,10/8/2015 11:10:21 AM,Overall,50,450,1015,1056,2571,602,3655,915,1231,6403
15,Sudan (UNDP),2014,SUD-14/R/N/INGO/1044,10/8/2015 11:10:21 AM,Pregnant and Lactating Women,0,350,0,0,350,0,356,0,0,356
15,Sudan (UNDP),2014,SUD-14/R/N/INGO/1044,10/8/2015 11:10:21 AM,"Trainers, Promoters, Caretakers, committee members, etc.",0,2694,0,0,2694,602,3299,0,0,3901
15,Sudan (UNDP),2014,SUD-14/R/N/UN/1025,3/30/2016 7:49:44 AM,Overall,0,2100,4463,4463,11026,107,4314,7641,7642,19704
15,Sudan (UNDP),2014,SUD-14/R/NFI/INGO/1026,5/8/2016 2:25:18 PM,Overall,3500,4000,1125,1375,10000,17544,20049,6000,6530,50123
15,Sudan (UNDP),2014,SUD-14/R/NFI/INGO/1039,10/8/2015 11:10:21 AM,Internally Displaced People,5463,6683,6488,8368,27002,1251,2041,1515,1778,6585
15,Sudan (UNDP),2014,SUD-14/R/NFI/INGO/1039,10/8/2015 11:10:21 AM,Overall,5463,6683,6488,8368,27002,4438,7240,5371,6305,23354
15,Sudan (UNDP),2014,SUD-14/R/NFI/UN/1038,10/8/2015 11:10:22 AM,Internally Displaced People,2500,2500,2500,2500,10000,2500,2500,2500,2500,10000
15,Sudan (UNDP),2014,SUD-14/R/NFI/UN/1038,10/8/2015 11:10:22 AM,Overall,2500,2500,2500,2500,10000,2500,2500,2500,2500,10000
15,Sudan (UNDP),2014,SUD-14/R/NFI/UN/1087,5/3/2016 8:09:08 AM,Overall,6000,6000,6000,6000,24000,6000,6000,6000,6000,24000
15,Sudan (UNDP),2014,SUD-14/R/P/UN/1019,7/5/2016 7:31:14 AM,Overall,18118,21918,13080,15180,68296,25160,20585,12499,14709,72953
15,Sudan (UNDP),2014,SUD-14/R/RMS/UN/1088,5/4/2016 9:32:44 AM,Children under 18,3402,3540,1488,1488,9918,0,0,8458,8804,17262
15,Sudan (UNDP),2014,SUD-14/R/RMS/UN/1088,5/4/2016 9:32:44 AM,Other,5557,5783,2430,2430,16200,2961,3081,1269,1320,8631
15,Sudan (UNDP),2014,SUD-14/R/RMS/UN/1088,5/4/2016 9:32:44 AM,Overall,7564,17087,4523,12151,41325,14406,24286,6174,12674,57540
15,Sudan (UNDP),2014,SUD-14/R/RMS/UN/1088,5/4/2016 9:32:44 AM,People in Host Communities,2835,2950,1240,1240,8265,4935,5135,2115,2200,14385
15,Sudan (UNDP),2014,SUD-14/R/RMS/UN/1088,5/4/2016 9:32:44 AM,Women of Child-Bearing Age,0,6942,0,0,6942,0,17262,0,0,17262
15,Sudan (UNDP),2014,SUD-14/R/WASH/INGO/1035,3/31/2016 9:15:34 AM,Overall,6457,8905,6314,7475,29151,3244,3396,2622,2688,11950
15,Sudan (UNDP),2014,SUD-14/R/WASH/INGO/1041,5/2/2016 7:21:00 AM,Overall,7650,9350,0,0,17000,5998,6886,0,0,12884
15,Sudan (UNDP),2014,SUD-14/R/WASH/UN/1032,10/8/2015 11:10:20 AM,Overall,33975,78975,18525,18525,150000,57967,62797,31106,31106,182976
15,Sudan (UNDP),2014,SUD-14/R/WASH/UN/1043,4/24/2016 2:55:17 PM,Children under 18,0,0,4250,5100,9350,2000,4500,2500,3000,12000
15,Sudan (UNDP),2014,SUD-14/R/WASH/UN/1043,4/24/2016 2:55:17 PM,Internally Displaced People,2550,5100,4250,5100,17000,0,4500,0,0,4500
15,Sudan (UNDP),2014,SUD-14/R/WASH/UN/1043,4/24/2016 2:55:17 PM,Overall,2550,5100,4250,5100,17000,2000,4500,2500,3000,12000
15,Sudan (UNDP),2014,SUD-14/R/WASH/UN/1043,4/24/2016 2:55:17 PM,Women of Child-Bearing Age,0,5100,0,0,5100,0,4500,0,0,4500
15,Sudan (UNDP),2014,SUD-14/S1/CCS/UN/725,10/8/2015 11:06:13 AM,Internally Displaced People,77000,63000,27600,32400,200000,262474,214752,94082,110444,681752
15,Sudan (UNDP),2014,SUD-14/S1/CCS/UN/725,10/8/2015 11:06:13 AM,Overall,77000,63000,27600,32400,200000,262474,214752,94082,110444,681752
15,Sudan (UNDP),2014,SUD-14/S1/CCS/UN/725,10/8/2015 11:06:13 AM,"Staff (own or partner staff, authorities)",80,70,0,0,150,650,250,0,0,900
15,Sudan (UNDP),2014,SUD-14/S1/E/NGO/384,10/8/2015 11:06:15 AM,Children under 18,0,0,5250,5250,10500,0,0,5988,6163,12151
15,Sudan (UNDP),2014,SUD-14/S1/E/NGO/384,10/8/2015 11:06:15 AM,Children under 5,0,0,250,250,500,0,0,260,281,541
15,Sudan (UNDP),2014,SUD-14/S1/E/NGO/384,10/8/2015 11:06:15 AM,Other,300,185,0,0,485,160,315,0,0,475
15,Sudan (UNDP),2014,SUD-14/S1/E/NGO/384,10/8/2015 11:06:15 AM,Overall,300,185,5500,5500,11485,160,315,6248,6444,13167
15,Sudan (UNDP),2014,SUD-14/S1/E/NGO/461,4/17/2016 8:05:42 AM,Children under 18,0,0,4061,4261,8322,0,0,4650,4515,9165
15,Sudan (UNDP),2014,SUD-14/S1/E/NGO/461,4/17/2016 8:05:42 AM,Committees,100,100,0,0,200,100,100,0,0,200
15,Sudan (UNDP),2014,SUD-14/S1/E/NGO/461,4/17/2016 8:05:42 AM,Internally Displaced People,190,190,4061,4261,8702,172,239,4650,4515,9576
15,Sudan (UNDP),2014,SUD-14/S1/E/NGO/461,4/17/2016 8:05:42 AM,Other,90,90,0,0,180,72,139,0,0,211
15,Sudan (UNDP),2014,SUD-14/S1/E/NGO/461,4/17/2016 8:05:42 AM,Overall,190,190,4061,4261,8702,172,239,4650,4515,9576
15,Sudan (UNDP),2014,SUD-14/S1/E/NGO/477,10/8/2015 11:06:17 AM,Children under 18,0,0,4425,5249,9674,0,0,5219,4782,10001
15,Sudan (UNDP),2014,SUD-14/S1/E/NGO/477,10/8/2015 11:06:17 AM,Internally Displaced People,132,159,0,0,291,168,117,0,0,285
15,Sudan (UNDP),2014,SUD-14/S1/E/NGO/477,10/8/2015 11:06:17 AM,Overall,132,159,4425,5249,9965,168,117,5219,4782,10286
15,Sudan (UNDP),2014,SUD-14/S1/E/NGO/635,10/8/2015 11:06:12 AM,Children under 18,0,0,981,939,1920,0,0,911,647,1558
15,Sudan (UNDP),2014,SUD-14/S1/E/NGO/635,10/8/2015 11:06:12 AM,Internally Displaced People,100,200,0,0,300,221,243,0,0,464
15,Sudan (UNDP),2014,SUD-14/S1/E/NGO/635,10/8/2015 11:06:12 AM,Overall,100,200,981,939,2220,221,243,911,647,2022
15,Sudan (UNDP),2014,SUD-14/S1/E/NGO/870,10/8/2015 11:06:12 AM,Children under 18,0,0,650,750,1400,0,0,1318,1239,2557
15,Sudan (UNDP),2014,SUD-14/S1/E/NGO/870,10/8/2015 11:06:12 AM,Children under 5,0,0,200,350,550,0,0,236,283,519
15,Sudan (UNDP),2014,SUD-14/S1/E/NGO/870,10/8/2015 11:06:12 AM,Committees,60,60,0,0,120,100,80,0,0,180
15,Sudan (UNDP),2014,SUD-14/S1/E/NGO/870,10/8/2015 11:06:12 AM,Other,360,260,0,0,620,420,350,0,0,770
15,Sudan (UNDP),2014,SUD-14/S1/E/NGO/870,10/8/2015 11:06:12 AM,Overall,420,350,850,1100,2720,520,430,1554,1522,4026
15,Sudan (UNDP),2014,SUD-14/S1/E/UN/698,10/8/2015 11:06:12 AM,Children under 18,0,0,10000,10000,20000,0,0,9753,10998,20751
15,Sudan (UNDP),2014,SUD-14/S1/E/UN/698,10/8/2015 11:06:12 AM,Committees,75,75,0,0,150,61,13,0,0,74
15,Sudan (UNDP),2014,SUD-14/S1/E/UN/698,10/8/2015 11:06:12 AM,Other,180,220,0,0,400,22,15,0,0,37
15,Sudan (UNDP),2014,SUD-14/S1/E/UN/698,10/8/2015 11:06:12 AM,Overall,255,295,10000,10000,20550,83,28,9753,10998,20862
15,Sudan (UNDP),2014,SUD-14/S1/FSL/NGO/566,10/8/2015 11:06:12 AM,Internally Displaced People,1596,3192,3990,3990,12768,1596,3192,3990,3990,12768
15,Sudan (UNDP),2014,SUD-14/S1/FSL/NGO/566,10/8/2015 11:06:12 AM,Overall,1596,3192,3990,3990,12768,1596,3192,3990,3990,12768
15,Sudan (UNDP),2014,SUD-14/S1/FSL/NGO/607,10/8/2015 11:06:19 AM,Internally Displaced People,2525,3029,5049,6227,16830,2525,3029,5049,6227,16830
15,Sudan (UNDP),2014,SUD-14/S1/FSL/NGO/607,10/8/2015 11:06:19 AM,Other,413,495,826,1018,2752,413,495,826,1018,2752
15,Sudan (UNDP),2014,SUD-14/S1/FSL/NGO/607,10/8/2015 11:06:19 AM,Overall,5025,6030,10050,12395,33500,5025,6030,10050,12395,33500
15,Sudan (UNDP),2014,SUD-14/S1/FSL/NGO/607,10/8/2015 11:06:19 AM,People in Host Communities,786,943,1572,1939,5240,786,943,1572,1939,5240
15,Sudan (UNDP),2014,SUD-14/S1/FSL/NGO/607,10/8/2015 11:06:19 AM,Returnees,1302,1562,2603,3211,8678,1302,1562,2603,3211,8678
15,Sudan (UNDP),2014,SUD-14/S1/FSL/NGO/631,10/8/2015 11:08:22 AM,Agro-Pastoralists,1000,1000,1476,1524,5000,750,750,1446,1554,4500
15,Sudan (UNDP),2014,SUD-14/S1/FSL/NGO/631,10/8/2015 11:08:22 AM,Internally Displaced People,4000,4000,5904,6096,20000,2476,2726,4302,4623,14127
15,Sudan (UNDP),2014,SUD-14/S1/FSL/NGO/631,10/8/2015 11:08:22 AM,Overall,5000,5230,7833,8087,26150,3260,3711,6285,6755,20011
15,Sudan (UNDP),2014,SUD-14/S1/FSL/NGO/631,10/8/2015 11:08:22 AM,"Trainers, Promoters, Caretakers, committee members, etc.",15,15,0,0,30,24,10,0,0,34
15,Sudan (UNDP),2014,SUD-14/S1/FSL/NGO/631,10/8/2015 11:08:22 AM,Women of Child-Bearing Age,0,230,453,467,1150,10,225,537,578,1350
15,Sudan (UNDP),2014,SUD-14/S1/FSL/UN/706,10/8/2015 11:06:13 AM,Internally Displaced People,12169,12670,8281,8281,41401,23524,14855,15683,9904,63966
15,Sudan (UNDP),2014,SUD-14/S1/FSL/UN/706,10/8/2015 11:06:13 AM,Overall,17178,18192,11890,11890,59150,30581,19312,20388,12875,83156
15,Sudan (UNDP),2014,SUD-14/S1/FSL/UN/706,10/8/2015 11:06:13 AM,People in Host Communities,5009,5522,3609,3609,17749,7057,4457,4705,2971,19190
15,Sudan (UNDP),2014,SUD-14/S1/FSL/UN/753,10/8/2015 11:08:22 AM,Internally Displaced People,34986,36414,15300,15300,102000,35266,36705,15422,15422,102815
15,Sudan (UNDP),2014,SUD-14/S1/FSL/UN/753,10/8/2015 11:08:22 AM,Overall,60711,63189,26550,26550,177000,61225,63725,26775,26775,178500
15,Sudan (UNDP),2014,SUD-14/S1/FSL/UN/753,10/8/2015 11:08:22 AM,People in Host Communities,25725,26775,11250,11250,75000,25960,27019,11353,11353,75685
15,Sudan (UNDP),2014,SUD-14/S1/H/NGO/536,10/8/2015 11:06:13 AM,Children under 5,0,0,28188,29340,57528,0,0,27970,28136,56106
15,Sudan (UNDP),2014,SUD-14/S1/H/NGO/536,10/8/2015 11:06:13 AM,Internally Displaced People/Returnees,99490,103552,66327,69034,338403,111525,65619,65815,66200,309159
15,Sudan (UNDP),2014,SUD-14/S1/H/NGO/536,10/8/2015 11:06:13 AM,Overall,99490,103552,66327,69034,338403,111525,65619,65815,66200,309159
15,Sudan (UNDP),2014,SUD-14/S1/H/NGO/536,10/8/2015 11:06:13 AM,Pregnant and Lactating Women,0,16920,0,0,16920,0,10721,0,0,10721
15,Sudan (UNDP),2014,SUD-14/S1/H/NGO/536,10/8/2015 11:06:13 AM,Women of Child-Bearing Age,0,87985,0,0,87985,0,55754,0,0,55754
15,Sudan (UNDP),2014,SUD-14/S1/H/NGO/582,10/8/2015 11:06:13 AM,Children under 5,0,0,2000,2000,4000,0,0,0,0,0
15,Sudan (UNDP),2014,SUD-14/S1/H/NGO/582,10/8/2015 11:06:13 AM,Internally Displaced People/Returnees,5000,1000,2000,2000,10000,0,0,0,0,0
15,Sudan (UNDP),2014,SUD-14/S1/H/NGO/582,10/8/2015 11:06:13 AM,Overall,15400,16000,7000,7000,45400,16320,17589,7741,8012,49662
15,Sudan (UNDP),2014,SUD-14/S1/H/NGO/582,10/8/2015 11:06:13 AM,People in Host Communities,0,10000,3000,3000,16000,0,0,0,0,0
15,Sudan (UNDP),2014,SUD-14/S1/H/NGO/582,10/8/2015 11:06:13 AM,Women of Child-Bearing Age,0,15000,0,0,15000,0,0,0,0,0
15,Sudan (UNDP),2014,SUD-14/S1/H/NGO/661,10/8/2015 11:06:19 AM,Children under 5,0,0,4357,4535,8892,0,0,19305,20804,40109
15,Sudan (UNDP),2014,SUD-14/S1/H/NGO/661,10/8/2015 11:06:19 AM,Internally Displaced People,25628,26674,0,0,52302,20346,49669,0,0,70015
15,Sudan (UNDP),2014,SUD-14/S1/H/NGO/661,10/8/2015 11:06:19 AM,Overall,25628,28766,4357,4535,63286,20346,66812,19305,20804,127267
15,Sudan (UNDP),2014,SUD-14/S1/H/NGO/661,10/8/2015 11:06:19 AM,Women of Child-Bearing Age,0,2092,0,0,2092,0,17143,0,0,17143
15,Sudan (UNDP),2014,SUD-14/S1/H/NGO/784,10/8/2015 11:06:14 AM,Children under 5,0,0,3720,9780,13500,0,0,4345,7280,11625
15,Sudan (UNDP),2014,SUD-14/S1/H/NGO/784,10/8/2015 11:06:14 AM,Internally Displaced People,32420,107060,15780,17810,173070,45120,85560,7714,10433,148827
15,Sudan (UNDP),2014,SUD-14/S1/H/NGO/784,10/8/2015 11:06:14 AM,Overall,32480,163430,19500,27590,243000,38424,72104,25494,36524,172546
15,Sudan (UNDP),2014,SUD-14/S1/H/NGO/784,10/8/2015 11:06:14 AM,Pregnant and Lactating Women,0,56320,0,0,56320,0,12027,0,0,12027
15,Sudan (UNDP),2014,SUD-14/S1/H/NGO/784,10/8/2015 11:06:14 AM,"Staff (own or partner staff, authorities)",60,50,0,0,110,23,44,0,0,67
15,Sudan (UNDP),2014,SUD-14/S1/H/NGO/950,10/8/2015 11:06:14 AM,Children under 5,0,0,8932,9677,18609,0,0,5844,5613,11457
15,Sudan (UNDP),2014,SUD-14/S1/H/NGO/950,10/8/2015 11:06:14 AM,Internally Displaced People,52542,56920,26271,28460,164193,36800,43650,22495,23413,126358
15,Sudan (UNDP),2014,SUD-14/S1/H/NGO/950,10/8/2015 11:06:14 AM,Overall,52542,56920,26271,28460,164193,36800,43650,22495,23413,126358
15,Sudan (UNDP),2014,SUD-14/S1/H/NGO/950,10/8/2015 11:06:14 AM,People in Host Communities,6240,6760,3120,3380,19500,0,0,0,0,0
15,Sudan (UNDP),2014,SUD-14/S1/H/NGO/950,10/8/2015 11:06:14 AM,Returnees,481,521,246,267,1515,0,0,0,0,0
15,Sudan (UNDP),2014,SUD-14/S1/H/NGO/964,10/8/2015 11:06:14 AM,Children under 5,0,0,16514,17890,34404,0,0,17832,19624,37456
15,Sudan (UNDP),2014,SUD-14/S1/H/NGO/964,10/8/2015 11:06:14 AM,Internally Displaced People,97139,105234,48570,52617,303560,109096,113032,48656,59674,330458
15,Sudan (UNDP),2014,SUD-14/S1/H/NGO/964,10/8/2015 11:06:14 AM,Overall,103200,111800,51600,55900,322500,132374,136438,55634,69362,393808
15,Sudan (UNDP),2014,SUD-14/S1/H/NGO/964,10/8/2015 11:06:14 AM,People in Host Communities,13341,12286,6151,6663,38441,23278,23406,6978,9688,63350
15,Sudan (UNDP),2014,SUD-14/S1/H/NGO/964,10/8/2015 11:06:14 AM,Women of Child-Bearing Age,0,53750,0,0,53750,0,54862,0,0,54862
15,Sudan (UNDP),2014,SUD-14/S1/H/UN/242,10/8/2015 11:06:14 AM,Internally Displaced People/Returnees,133280,138720,33320,34680,340000,153123,159373,38281,39843,390620
15,Sudan (UNDP),2014,SUD-14/S1/H/UN/242,10/8/2015 11:06:14 AM,Overall,183260,190740,45815,47685,467500,181248,188646,45312,47162,462368
15,Sudan (UNDP),2014,SUD-14/S1/H/UN/242,10/8/2015 11:06:14 AM,People in Host Communities,49980,52020,12495,13005,127500,28125,29273,7031,7318,71747
15,Sudan (UNDP),2014,SUD-14/S1/H/UN/242,10/8/2015 11:06:14 AM,Women of Child-Bearing Age,0,116875,0,0,116875,0,115592,0,0,115592
15,Sudan (UNDP),2014,SUD-14/S1/H/UN/603,10/8/2015 11:06:14 AM,Children under 5,0,0,36000,39000,75000,0,0,32634,33966,66600
15,Sudan (UNDP),2014,SUD-14/S1/H/UN/603,10/8/2015 11:06:14 AM,Internally Displaced People,84000,96000,54000,66000,300000,72240,82560,46440,56760,258000
15,Sudan (UNDP),2014,SUD-14/S1/H/UN/603,10/8/2015 11:06:14 AM,Overall,105000,120000,67500,82500,375000,93240,106560,59940,73260,333000
15,Sudan (UNDP),2014,SUD-14/S1/H/UN/603,10/8/2015 11:06:14 AM,People in Host Communities,21000,24000,13500,16500,75000,16044,18336,10314,12606,57300
15,Sudan (UNDP),2014,SUD-14/S1/H/UN/603,10/8/2015 11:06:14 AM,Pregnant and Lactating Women,0,4800,0,0,4800,0,3996,0,0,3996
15,Sudan (UNDP),2014,SUD-14/S1/L/UN/472,10/8/2015 11:06:15 AM,Overall,33000,34000,34000,34000,135000,33000,34000,34000,34000,135000
15,Sudan (UNDP),2014,SUD-14/S1/N/NGO/353,10/8/2015 11:06:15 AM,Children under 5,0,0,10743,11181,21924,0,0,10487,11338,21825
15,Sudan (UNDP),2014,SUD-14/S1/N/NGO/353,10/8/2015 11:06:15 AM,Internally Displaced People,28372,32241,33531,34821,128965,19646,40918,32733,35309,128606
15,Sudan (UNDP),2014,SUD-14/S1/N/NGO/353,10/8/2015 11:06:15 AM,Overall,28372,32241,33531,34821,128965,19646,40918,32733,35309,128606
15,Sudan (UNDP),2014,SUD-14/S1/N/NGO/353,10/8/2015 11:06:15 AM,Pregnant and Lactating Women,0,6448,0,0,6448,0,8183,0,0,8183
15,Sudan (UNDP),2014,SUD-14/S1/N/NGO/397,10/8/2015 11:06:15 AM,Children under 5,0,0,4009,4172,8181,0,0,4237,4409,8646
15,Sudan (UNDP),2014,SUD-14/S1/N/NGO/397,10/8/2015 11:06:15 AM,Internally Displaced People,10834,11286,12720,13289,48129,12331,14890,11718,11923,50862
15,Sudan (UNDP),2014,SUD-14/S1/N/NGO/397,10/8/2015 11:06:15 AM,Overall,10834,11286,12720,13289,48129,12331,14890,11718,11923,50862
15,Sudan (UNDP),2014,SUD-14/S1/N/NGO/397,10/8/2015 11:06:15 AM,Pregnant and Lactating Women,0,2406,0,0,2406,0,2543,0,0,2543
15,Sudan (UNDP),2014,SUD-14/S1/N/NGO/519,10/8/2015 11:06:15 AM,Children under 5,0,0,6146,8032,14178,0,0,16924,29043,45967
15,Sudan (UNDP),2014,SUD-14/S1/N/NGO/519,10/8/2015 11:06:15 AM,Internally Displaced People,7079,7500,6146,8032,28757,5264,11376,10154,16435,43229
15,Sudan (UNDP),2014,SUD-14/S1/N/NGO/519,10/8/2015 11:06:15 AM,Overall,7079,11250,10204,12092,40625,8638,21610,16924,29043,76215
15,Sudan (UNDP),2014,SUD-14/S1/N/NGO/519,10/8/2015 11:06:15 AM,Pregnant and Lactating Women,0,3750,0,0,3750,0,21610,0,0,21610
15,Sudan (UNDP),2014,SUD-14/S1/N/NGO/524,10/8/2015 11:06:15 AM,Children under 5,0,0,1960,2040,4000,0,0,1929,2407,4336
15,Sudan (UNDP),2014,SUD-14/S1/N/NGO/524,10/8/2015 11:06:15 AM,Internally Displaced People,4508,4692,5292,5508,20000,5718,6140,3248,4872,19978
15,Sudan (UNDP),2014,SUD-14/S1/N/NGO/524,10/8/2015 11:06:15 AM,Overall,4508,4692,5292,5508,20000,5718,6140,3248,4872,19978
15,Sudan (UNDP),2014,SUD-14/S1/N/NGO/524,10/8/2015 11:06:15 AM,Pregnant and Lactating Women,0,1000,0,0,1000,0,1020,0,0,1020
15,Sudan (UNDP),2014,SUD-14/S1/N/NGO/765,10/8/2015 11:06:20 AM,Internally Displaced People/Returnees,860,860,13455,14005,29180,321,853,8249,8584,18007
15,Sudan (UNDP),2014,SUD-14/S1/N/NGO/765,10/8/2015 11:06:20 AM,Overall,860,860,13455,14005,29180,321,853,8249,8584,18007
15,Sudan (UNDP),2014,SUD-14/S1/N/UN/1034,10/8/2015 11:06:15 AM,Overall,0,0,0,0,0,0,625883,116666,112090,854639
15,Sudan (UNDP),2014,SUD-14/S1/NFI/NGO/327,10/8/2015 11:06:15 AM,Internally Displaced People/Returnees,7510,9689,7159,6847,31205,4872,6348,4653,4502,20375
15,Sudan (UNDP),2014,SUD-14/S1/NFI/NGO/327,10/8/2015 11:06:15 AM,Overall,7510,9689,7159,6847,31205,4872,6348,4653,4502,20375
15,Sudan (UNDP),2014,SUD-14/S1/NFI/NGO/469,10/8/2015 11:06:15 AM,Children under 18,0,0,0,0,0,0,0,619,583,1202
15,Sudan (UNDP),2014,SUD-14/S1/NFI/NGO/469,10/8/2015 11:06:15 AM,Internally Displaced People,302,330,164,152,948,0,0,0,0,0
15,Sudan (UNDP),2014,SUD-14/S1/NFI/NGO/469,10/8/2015 11:06:15 AM,Internally Displaced People/Returnees,591,646,321,294,1852,1165,1275,619,583,3642
15,Sudan (UNDP),2014,SUD-14/S1/NFI/NGO/469,10/8/2015 11:06:15 AM,Overall,893,976,485,446,2800,1165,1275,619,583,3642
15,Sudan (UNDP),2014,SUD-14/S1/NFI/NGO/810,10/8/2015 11:06:15 AM,Children under 18,0,0,15448,35120,50568,0,0,0,0,0
15,Sudan (UNDP),2014,SUD-14/S1/NFI/NGO/810,10/8/2015 11:06:15 AM,Internally Displaced People,21789,47950,13350,7878,90967,0,0,0,0,0
15,Sudan (UNDP),2014,SUD-14/S1/NFI/NGO/810,10/8/2015 11:06:15 AM,Overall,31408,62290,30331,45495,169524,0,0,0,0,0
15,Sudan (UNDP),2014,SUD-14/S1/NFI/NGO/810,10/8/2015 11:06:15 AM,Returnees,9619,14340,1533,2497,27989,0,0,0,0,0
15,Sudan (UNDP),2014,SUD-14/S1/NFI/UN/1029,10/8/2015 11:06:16 AM,Overall,288750,288750,288750,288750,1155000,288750,288750,288750,288750,1155000
15,Sudan (UNDP),2014,SUD-14/S1/P/NGO/405,10/8/2015 11:06:16 AM,Children under 18,0,0,5000,5000,10000,4282,5626,0,0,9908
15,Sudan (UNDP),2014,SUD-14/S1/P/NGO/405,10/8/2015 11:06:16 AM,Children under 5,0,0,2000,2000,4000,0,0,0,0,0
15,Sudan (UNDP),2014,SUD-14/S1/P/NGO/405,10/8/2015 11:06:16 AM,Internally Displaced People,5000,6000,8000,9000,28000,6726,6964,0,0,13690
15,Sudan (UNDP),2014,SUD-14/S1/P/NGO/405,10/8/2015 11:06:16 AM,Overall,5000,6000,15000,16000,42000,4282,5626,6726,6964,23598
15,Sudan (UNDP),2014,SUD-14/S1/P/NGO/451,10/8/2015 11:06:20 AM,Children under 18,0,0,1000,1000,2000,0,0,3856,3918,7774
15,Sudan (UNDP),2014,SUD-14/S1/P/NGO/451,10/8/2015 11:06:20 AM,Internally Displaced People,4000,4000,1524,1526,11050,4115,4250,2017,2210,12592
15,Sudan (UNDP),2014,SUD-14/S1/P/NGO/451,10/8/2015 11:06:20 AM,Other,120,130,0,0,250,150,180,0,0,330
15,Sudan (UNDP),2014,SUD-14/S1/P/NGO/451,10/8/2015 11:06:20 AM,Overall,4150,4160,3524,3526,15360,4775,5010,3856,3918,17559
15,Sudan (UNDP),2014,SUD-14/S1/P/NGO/451,10/8/2015 11:06:20 AM,"Staff (own or partner staff, authorities)",30,30,0,0,60,60,60,0,0,120
15,Sudan (UNDP),2014,SUD-14/S1/P/NGO/552,10/8/2015 11:06:16 AM,Internally Displaced People/Returnees,7000,8500,5000,5000,25500,7072,8500,5060,5035,25667
15,Sudan (UNDP),2014,SUD-14/S1/P/NGO/552,10/8/2015 11:06:16 AM,Overall,12042,14022,9500,9500,45064,12217,13824,9816,9552,45409
15,Sudan (UNDP),2014,SUD-14/S1/P/NGO/552,10/8/2015 11:06:16 AM,People in Host Communities,4000,5500,5000,5000,19500,4000,5565,5177,5000,19742
15,Sudan (UNDP),2014,SUD-14/S1/P/NGO/552,10/8/2015 11:06:16 AM,"Staff (own or partner staff, authorities)",22,2,0,0,24,22,2,0,0,24
15,Sudan (UNDP),2014,SUD-14/S1/P/NGO/552,10/8/2015 11:06:16 AM,"Trainers, Promoters, Caretakers, committee members, etc.",20,20,0,0,40,20,20,0,0,40
15,Sudan (UNDP),2014,SUD-14/S1/P/NGO/655,10/8/2015 11:06:16 AM,Overall,1441,2839,1890,1890,8060,746,2420,500,400,4066
15,Sudan (UNDP),2014,SUD-14/S1/P/NGO/669,10/8/2015 11:06:16 AM,Children under 18,0,0,4250,3250,7500,0,0,4335,3848,8183
15,Sudan (UNDP),2014,SUD-14/S1/P/NGO/669,10/8/2015 11:06:16 AM,Overall,4256,3256,4250,3250,15012,3744,3866,4335,3848,15793
15,Sudan (UNDP),2014,SUD-14/S1/P/NGO/669,10/8/2015 11:06:16 AM,"Staff (own or partner staff, authorities)",6,6,0,0,12,6,6,0,0,12
15,Sudan (UNDP),2014,SUD-14/S1/P/NGO/849,10/8/2015 11:06:16 AM,Overall,14824,9883,8884,7589,41180,0,0,0,0,0
15,Sudan (UNDP),2014,SUD-14/S1/P/UN/254,10/8/2015 11:06:17 AM,Overall,1584,1296,1716,1404,6000,0,0,0,0,0
15,Sudan (UNDP),2014,SUD-14/S1/P/UN/381,10/8/2015 11:06:17 AM,Internally Displaced People,3000,15000,3500,3700,25200,0,0,0,0,0
15,Sudan (UNDP),2014,SUD-14/S1/P/UN/381,10/8/2015 11:06:17 AM,Other,16,16,0,0,32,16,16,0,0,32
15,Sudan (UNDP),2014,SUD-14/S1/P/UN/381,10/8/2015 11:06:17 AM,Overall,4432,17727,4432,4432,31023,3714,17300,0,0,21014
15,Sudan (UNDP),2014,SUD-14/S1/P/UN/381,10/8/2015 11:06:17 AM,Returnees,1416,2711,932,732,5791,1416,2711,932,732,5791
15,Sudan (UNDP),2014,SUD-14/S1/P/UN/797,10/8/2015 11:06:17 AM,Children under 18,61500,0,0,0,61500,0,0,17916,17916,35832
15,Sudan (UNDP),2014,SUD-14/S1/P/UN/797,10/8/2015 11:06:17 AM,Other,6250,0,0,0,6250,0,0,2280,1822,4102
15,Sudan (UNDP),2014,SUD-14/S1/P/UN/797,10/8/2015 11:06:17 AM,Overall,3750,2500,36900,24600,67750,2280,1822,38767,31719,74588
15,Sudan (UNDP),2014,SUD-14/S1/RMS/UN/689,10/8/2015 11:06:18 AM,Overall,9000,4500,1000,500,15000,0,0,0,0,0
15,Sudan (UNDP),2014,SUD-14/S1/RMS/UN/840,10/8/2015 11:06:17 AM,Overall,3780,3780,500,500,8560,3759,3759,769,769,9056
15,Sudan (UNDP),2014,SUD-14/S1/RMS/UN/886,10/8/2015 11:06:17 AM,Overall,1445,1445,2805,2805,8500,1445,1445,2805,2805,8500
15,Sudan (UNDP),2014,SUD-14/S1/RRR/NGO/525,10/8/2015 11:06:18 AM,Children under 18,0,0,5207,7592,12799,0,0,2541,3685,6226
15,Sudan (UNDP),2014,SUD-14/S1/RRR/NGO/525,10/8/2015 11:06:18 AM,Children under 5,0,0,3472,5062,8534,0,0,1982,2058,4040
15,Sudan (UNDP),2014,SUD-14/S1/RRR/NGO/525,10/8/2015 11:06:18 AM,Internally Displaced People/Returnees,14094,18914,0,0,33008,6987,10256,0,0,17243
15,Sudan (UNDP),2014,SUD-14/S1/RRR/NGO/525,10/8/2015 11:06:18 AM,Overall,35234,47285,8679,12654,103852,20100,26300,3562,5682,55644
15,Sudan (UNDP),2014,SUD-14/S1/RRR/NGO/525,10/8/2015 11:06:18 AM,People in Host Communities,21140,28371,0,0,49511,12598,19754,0,0,32352
15,Sudan (UNDP),2014,SUD-14/S1/RRR/NGO/908,10/8/2015 11:06:18 AM,Overall,1937,3875,5344,5344,16500,0,0,0,0,0
15,Sudan (UNDP),2014,SUD-14/S1/RRR/UN/662,10/8/2015 11:06:18 AM,Overall,14175,17325,6210,7290,45000,14175,17325,6210,7290,45000
15,Sudan (UNDP),2014,SUD-14/S1/RRR/UN/662,10/8/2015 11:06:18 AM,Returnees,14175,17325,6210,7290,45000,14175,17325,6210,7290,45000
15,Sudan (UNDP),2014,SUD-14/S1/WASH/NGO/389,2/16/2017 1:59:14 PM,Internally Displaced People,5559,7180,5327,5095,23161,5559,7180,5327,5095,23161
15,Sudan (UNDP),2014,SUD-14/S1/WASH/NGO/389,2/16/2017 1:59:14 PM,Internally Displaced People/Returnees,564,729,540,517,2350,564,729,540,517,2350
15,Sudan (UNDP),2014,SUD-14/S1/WASH/NGO/389,2/16/2017 1:59:14 PM,Overall,6123,7908,5868,5612,25511,6123,7908,5868,5612,25511
15,Sudan (UNDP),2014,SUD-14/S1/WASH/NGO/618,10/8/2015 11:06:18 AM,Internally Displaced People,12690,13208,2880,2998,31776,12690,13208,2880,2998,31776
15,Sudan (UNDP),2014,SUD-14/S1/WASH/NGO/618,10/8/2015 11:06:18 AM,Overall,12690,13208,2880,2998,31776,12690,13208,2880,2998,31776
15,Sudan (UNDP),2014,SUD-14/S1/WASH/NGO/744,10/8/2015 11:06:18 AM,Overall,13640,20461,8139,12888,55128,11200,12740,16900,18150,58990
15,Sudan (UNDP),2014,SUD-14/S1/WASH/UN/803,10/8/2015 11:06:18 AM,Internally Displaced People,12991,19795,11518,17556,61860,6300,11400,6150,6150,30000
15,Sudan (UNDP),2014,SUD-14/S1/WASH/UN/803,10/8/2015 11:06:18 AM,Overall,12991,19795,11518,17556,61860,10349,18726,10102,10102,49279
15,Sudan (UNDP),2014,SUD-14/S2/CCS/UN/1076,5/3/2016 8:07:58 AM,Internally Displaced People,57750,47250,20700,24300,150000,86081,70430,30855,36221,223587
15,Sudan (UNDP),2014,SUD-14/S2/CCS/UN/1076,5/3/2016 8:07:58 AM,Overall,57750,47250,20700,24300,150000,86081,70430,30855,36221,223587
15,Sudan (UNDP),2014,SUD-14/S2/CCS/UN/1076,5/3/2016 8:07:58 AM,"Staff (own or partner staff, authorities)",30,20,0,0,50,750,250,0,0,1000
15,Sudan (UNDP),2014,SUD-14/S2/E/INGO/1060,11/28/2016 6:02:53 AM,Children under 18,0,0,2583,1564,4147,0,0,2583,1564,4147
15,Sudan (UNDP),2014,SUD-14/S2/E/INGO/1060,11/28/2016 6:02:53 AM,Internally Displaced People/Returnees,37,37,2583,1564,4221,37,37,2583,1564,4221
15,Sudan (UNDP),2014,SUD-14/S2/E/INGO/1060,11/28/2016 6:02:53 AM,Overall,75,75,2583,1564,4297,75,75,2583,1564,4297
15,Sudan (UNDP),2014,SUD-14/S2/E/INGO/1062,5/26/2016 12:51:30 PM,Children under 18,0,0,1750,1250,3000,0,0,3238,3299,6537
15,Sudan (UNDP),2014,SUD-14/S2/E/INGO/1062,5/26/2016 12:51:30 PM,Other,65,70,0,0,135,141,137,0,0,278
15,Sudan (UNDP),2014,SUD-14/S2/E/INGO/1062,5/26/2016 12:51:30 PM,Overall,65,70,1750,1250,3135,141,137,3238,3299,6815
15,Sudan (UNDP),2014,SUD-14/S2/E/INGO/1064,7/10/2016 6:59:28 AM,Children under 18,0,0,3856,3617,7473,0,0,4434,4544,8978
15,Sudan (UNDP),2014,SUD-14/S2/E/INGO/1064,7/10/2016 6:59:28 AM,Overall,122,86,3856,3617,7681,209,44,4434,4544,9231
15,Sudan (UNDP),2014,SUD-14/S2/E/INGO/1064,7/10/2016 6:59:28 AM,"Trainers, Promoters, Caretakers, committee members, etc.",122,86,0,0,208,209,44,0,0,253
15,Sudan (UNDP),2014,SUD-14/S2/E/NGO/1057,5/23/2016 10:32:46 AM,Children under 18,0,0,2000,3800,5800,0,0,2200,3600,5800
15,Sudan (UNDP),2014,SUD-14/S2/E/NGO/1057,5/23/2016 10:32:46 AM,Overall,120,80,2000,3800,6000,130,70,2200,3600,6000
15,Sudan (UNDP),2014,SUD-14/S2/E/NGO/1057,5/23/2016 10:32:46 AM,"Staff (own or partner staff, authorities)",120,80,0,0,200,130,70,0,0,200
15,Sudan (UNDP),2014,SUD-14/S2/FSL/UN/1075,3/31/2016 12:54:36 PM,Internally Displaced People,17580,18420,12000,12000,60000,19355,20220,13190,13190,65955
15,Sudan (UNDP),2014,SUD-14/S2/FSL/UN/1075,3/31/2016 12:54:36 PM,Overall,27260,28540,18600,18600,93000,29035,30340,19790,19790,98955
15,Sudan (UNDP),2014,SUD-14/S2/FSL/UN/1075,3/31/2016 12:54:36 PM,Returnees,9680,10120,6600,6600,33000,9680,10120,6600,6600,33000
15,Sudan (UNDP),2014,SUD-14/S2/H/INGO/1048,5/26/2016 12:54:49 PM,Children under 5,0,0,4098,3939,8037,0,0,3973,3955,7928
15,Sudan (UNDP),2014,SUD-14/S2/H/INGO/1048,5/26/2016 12:54:49 PM,Internally Displaced People,14768,22652,0,0,37420,18434,15083,0,0,33517
15,Sudan (UNDP),2014,SUD-14/S2/H/INGO/1048,5/26/2016 12:54:49 PM,Overall,14612,24626,4098,3939,47275,15882,19410,3000,3604,41896
15,Sudan (UNDP),2014,SUD-14/S2/H/INGO/1048,5/26/2016 12:54:49 PM,People in Host Communities,3942,5913,0,0,9855,4609,3771,0,0,8380
15,Sudan (UNDP),2014,SUD-14/S2/H/INGO/1048,5/26/2016 12:54:49 PM,Pregnant and Lactating Women,0,3782,0,0,3782,0,9540,0,0,9540
15,Sudan (UNDP),2014,SUD-14/S2/H/INGO/1055,6/15/2016 11:15:25 AM,Children under 5,0,0,4266,4621,8887,0,0,16046,17366,33412
15,Sudan (UNDP),2014,SUD-14/S2/H/INGO/1055,6/15/2016 11:15:25 AM,Internally Displaced People/Returnees,21355,16741,4810,5211,48117,24246,19286,5537,6061,55130
15,Sudan (UNDP),2014,SUD-14/S2/H/INGO/1055,6/15/2016 11:15:25 AM,Overall,35592,57728,9076,9832,112228,45369,76681,21583,23427,167060
15,Sudan (UNDP),2014,SUD-14/S2/H/INGO/1055,6/15/2016 11:15:25 AM,People in Host Communities,14237,11546,0,0,25783,21123,17301,0,0,38424
15,Sudan (UNDP),2014,SUD-14/S2/H/INGO/1055,6/15/2016 11:15:25 AM,Women of Child-Bearing Age,0,29441,0,0,29441,0,40094,0,0,40094
15,Sudan (UNDP),2014,SUD-14/S2/H/UN/1054,5/26/2016 1:03:14 PM,Overall,44688,46512,33712,35088,160000,44306,46113,33423,34788,158630
15,Sudan (UNDP),2014,SUD-14/S2/H/UN/1056,6/2/2016 10:39:17 AM,Children under 5,0,0,46413,44591,91004,0,0,14620,14046,28666
15,Sudan (UNDP),2014,SUD-14/S2/H/UN/1056,6/2/2016 10:39:17 AM,Internally Displaced People,0,13297,10521,10108,33926,0,3917,3314,3189,10420
15,Sudan (UNDP),2014,SUD-14/S2/H/UN/1056,6/2/2016 10:39:17 AM,Other,0,876,399,383,1658,0,0,0,0,0
15,Sudan (UNDP),2014,SUD-14/S2/H/UN/1056,6/2/2016 10:39:17 AM,Overall,0,92153,46413,44591,183157,0,27145,14620,14046,55811
15,Sudan (UNDP),2014,SUD-14/S2/H/UN/1059,5/26/2016 12:53:32 PM,Children under 18,0,0,835,1542,2377,0,0,300,1400,1700
15,Sudan (UNDP),2014,SUD-14/S2/H/UN/1059,5/26/2016 12:53:32 PM,Overall,500,18987,200,240,19927,350,16798,100,240,17488
15,Sudan (UNDP),2014,SUD-14/S2/H/UN/1059,5/26/2016 12:53:32 PM,Pregnant and Lactating Women,0,4747,0,0,4747,0,4747,0,0,4747
15,Sudan (UNDP),2014,SUD-14/S2/H/UN/1059,5/26/2016 12:53:32 PM,"Trainers, Promoters, Caretakers, committee members, etc.",45,65,0,0,110,45,65,0,0,110
15,Sudan (UNDP),2014,SUD-14/S2/N/INGO/1066,6/6/2016 3:09:15 PM,Children under 5,0,0,5645,6365,12010,0,0,7763,8080,15843
15,Sudan (UNDP),2014,SUD-14/S2/N/INGO/1066,6/6/2016 3:09:15 PM,Internally Displaced People,8402,13602,0,0,22004,4144,26697,0,0,30841
15,Sudan (UNDP),2014,SUD-14/S2/N/INGO/1066,6/6/2016 3:09:15 PM,Overall,8402,14376,5645,6365,34788,4144,27373,7763,8080,47360
15,Sudan (UNDP),2014,SUD-14/S2/N/INGO/1066,6/6/2016 3:09:15 PM,Pregnant and Lactating Women,0,774,0,0,774,0,676,0,0,676
15,Sudan (UNDP),2014,SUD-14/S2/N/INGO/1068,6/12/2016 7:53:47 AM,Children under 5,0,0,6017,6689,12706,0,0,2047,2649,4696
15,Sudan (UNDP),2014,SUD-14/S2/N/INGO/1068,6/12/2016 7:53:47 AM,Internally Displaced People/Returnees,4400,8723,3309,3679,20111,15681,20903,1296,2241,40121
15,Sudan (UNDP),2014,SUD-14/S2/N/INGO/1068,6/12/2016 7:53:47 AM,Overall,8000,15860,6017,6689,36566,0,704,2047,2649,5400
15,Sudan (UNDP),2014,SUD-14/S2/N/INGO/1068,6/12/2016 7:53:47 AM,Pregnant and Lactating Women,0,3850,0,0,3850,0,704,0,0,704
15,Sudan (UNDP),2014,SUD-14/S2/N/INGO/1070,3/22/2016 10:28:01 AM,Overall,0,22559,0,0,22559,0,10962,4223,5885,21070
15,Sudan (UNDP),2014,SUD-14/S2/N/INGO/1071,3/31/2016 12:45:20 PM,Agro-Pastoralists,4753,5248,505,762,11268,1421,3512,259,510,5702
15,Sudan (UNDP),2014,SUD-14/S2/N/INGO/1071,3/31/2016 12:45:20 PM,Internally Displaced People,19008,20992,2017,3046,45063,5684,14046,3198,3335,26263
15,Sudan (UNDP),2014,SUD-14/S2/N/INGO/1071,3/31/2016 12:45:20 PM,Overall,23761,26240,2522,3808,56331,7105,17558,3457,3845,31965
15,Sudan (UNDP),2014,SUD-14/S2/NFI/INGO/1061,5/15/2016 11:10:46 AM,Internally Displaced People,4320,6560,2400,2720,16000,4207,6812,2309,2617,15945
15,Sudan (UNDP),2014,SUD-14/S2/NFI/INGO/1061,5/15/2016 11:10:46 AM,Overall,4320,6560,2400,2720,16000,4207,6812,2309,2617,15945
15,Sudan (UNDP),2014,SUD-14/S2/NFI/INGO/1072,5/8/2016 2:45:35 PM,Overall,9000,13500,11250,11250,45000,4570,6856,5712,5712,22850
15,Sudan (UNDP),2014,SUD-14/S2/NFI/INGO/1073,5/8/2016 2:45:45 PM,Internally Displaced People/Returnees,3705,4781,3536,3383,15405,3422,4432,3213,3148,14215
15,Sudan (UNDP),2014,SUD-14/S2/NFI/INGO/1073,5/8/2016 2:45:45 PM,Overall,3705,4781,3536,3383,15405,3422,4432,3213,3148,14215
15,Sudan (UNDP),2014,SUD-14/S2/NFI/NGO/1067,6/27/2016 10:17:03 AM,Overall,43749,61248,31499,38499,174995,43749,61248,31499,38499,174995
15,Sudan (UNDP),2014,SUD-14/S2/NFI/NGO/1069,5/8/2016 2:47:02 PM,Internally Displaced People/Returnees,2150,2350,2000,2150,8650,2150,2350,2000,2150,8650
15,Sudan (UNDP),2014,SUD-14/S2/NFI/NGO/1069,5/8/2016 2:47:02 PM,Overall,2150,2350,2000,2150,8650,2150,2350,2000,2150,8650
15,Sudan (UNDP),2014,SUD-14/S2/NFI/NGO/1074,5/8/2016 2:45:14 PM,Internally Displaced People,3885,4830,635,1150,10500,2550,5000,3500,3500,14550
15,Sudan (UNDP),2014,SUD-14/S2/NFI/NGO/1074,5/8/2016 2:45:14 PM,Internally Displaced People/Returnees,3465,4308,557,1035,9365,0,0,0,0,0
15,Sudan (UNDP),2014,SUD-14/S2/NFI/NGO/1074,5/8/2016 2:45:14 PM,Overall,7350,9138,1182,2195,19865,2550,5000,3500,3500,14550
15,Sudan (UNDP),2014,SUD-14/S2/NFI/UN/1065,5/3/2016 8:06:58 AM,Overall,9250,9250,9250,9250,37000,9250,9250,9250,9250,37000
15,Sudan (UNDP),2014,SUD-14/S2/P/NGO/1077,6/20/2016 11:30:41 AM,Internally Displaced People,250,2400,200,700,3550,250,2400,200,700,3550
15,Sudan (UNDP),2014,SUD-14/S2/P/NGO/1077,6/20/2016 11:30:41 AM,Overall,400,4700,350,1050,6500,400,4700,350,1050,6500
15,Sudan (UNDP),2014,SUD-14/S2/P/NGO/1077,6/20/2016 11:30:41 AM,People in Host Communities,150,2300,150,350,2950,150,2300,150,350,2950
15,Sudan (UNDP),2014,SUD-14/S2/P/NGO/1080,6/16/2016 9:23:15 AM,Children under 18,0,0,1800,2000,3800,0,0,1800,2000,3800
15,Sudan (UNDP),2014,SUD-14/S2/P/NGO/1080,6/16/2016 9:23:15 AM,Internally Displaced People/Returnees,1900,2830,0,0,4730,1900,2830,0,0,4730
15,Sudan (UNDP),2014,SUD-14/S2/P/NGO/1080,6/16/2016 9:23:15 AM,Overall,1900,2830,1800,2000,8530,1900,2820,1800,2000,8520
15,Sudan (UNDP),2014,SUD-14/S2/P/NGO/1082,6/16/2016 12:52:21 PM,Internally Displaced People,4100,6200,950,1250,12500,3331,4095,1023,2990,11439
15,Sudan (UNDP),2014,SUD-14/S2/P/NGO/1082,6/16/2016 12:52:21 PM,Overall,2450,4850,750,950,9000,1600,1920,726,968,5214
15,Sudan (UNDP),2014,SUD-14/S2/P/NGO/1082,6/16/2016 12:52:21 PM,Pastoralists,880,1480,420,720,3500,654,376,178,217,1425
15,Sudan (UNDP),2014,SUD-14/S2/P/NGO/1082,6/16/2016 12:52:21 PM,People in Host Communities,1850,3400,500,750,6500,953,2871,478,780,5082
15,Sudan (UNDP),2014,SUD-14/S2/P/NGO/1084,6/16/2016 9:21:47 AM,Internally Displaced People,55,85,1740,2300,4180,150,227,1819,2500,4696
15,Sudan (UNDP),2014,SUD-14/S2/P/NGO/1084,6/16/2016 9:21:47 AM,Overall,105,155,3040,4000,7300,710,660,3211,5106,9687
15,Sudan (UNDP),2014,SUD-14/S2/P/NGO/1084,6/16/2016 9:21:47 AM,People in Host Communities,50,70,1300,1700,3120,510,483,1392,2606,4991
15,Sudan (UNDP),2014,SUD-14/S2/P/UN/1078,6/21/2016 8:08:17 AM,Internally Displaced People,600,4500,400,500,6000,600,4735,400,1500,7235
15,Sudan (UNDP),2014,SUD-14/S2/P/UN/1078,6/21/2016 8:08:17 AM,Overall,600,4500,400,500,6000,600,4735,400,1500,7235
15,Sudan (UNDP),2014,SUD-14/S2/P/UN/1079,6/16/2016 12:51:52 PM,Internally Displaced People,3000,13000,3500,3500,23000,0,0,0,0,0
15,Sudan (UNDP),2014,SUD-14/S2/P/UN/1079,6/16/2016 12:51:52 PM,Overall,4500,3000,6500,5400,19400,4500,3000,6500,5400,19400
15,Sudan (UNDP),2014,SUD-14/S2/P/UN/1079,6/16/2016 12:51:52 PM,Returnees,1000,1000,932,5000,7932,1000,1000,932,5000,7932
15,Sudan (UNDP),2014,SUD-14/S2/P/UN/1081,6/16/2016 9:22:48 AM,Children under 18,0,0,17916,17916,35832,0,0,0,0,0
15,Sudan (UNDP),2014,SUD-14/S2/P/UN/1081,6/16/2016 9:22:48 AM,Other,0,0,15000,15000,30000,0,0,0,0,0
15,Sudan (UNDP),2014,SUD-14/S2/P/UN/1081,6/16/2016 9:22:48 AM,Overall,15000,15000,17916,17916,65832,2280,1882,38767,31719,74648
15,Sudan (UNDP),2014,SUD-14/S2/RMS/UN/1086,3/31/2016 11:41:34 AM,Overall,1140,1200,1860,1800,6000,1226,1103,1962,1839,6130
15,Sudan (UNDP),2014,SUD-14/S2/WASH/INGO/1049,5/2/2016 7:35:13 AM,Internally Displaced People,12355,15725,11960,11960,52000,12355,15725,11960,11960,52000
15,Sudan (UNDP),2014,SUD-14/S2/WASH/INGO/1049,5/2/2016 7:35:13 AM,Overall,12355,15725,11960,11960,52000,12355,15725,11960,11960,52000
15,Sudan (UNDP),2014,SUD-14/S2/WASH/INGO/1051,5/2/2016 7:33:45 AM,Internally Displaced People/Returnees,3423,3998,1672,2897,11990,3757,4388,1835,3180,13160
15,Sudan (UNDP),2014,SUD-14/S2/WASH/INGO/1051,5/2/2016 7:33:45 AM,Overall,4890,5711,2389,4138,17128,5300,6200,2900,4400,18800
15,Sudan (UNDP),2014,SUD-14/S2/WASH/INGO/1051,5/2/2016 7:33:45 AM,People in Host Communities,1467,1713,717,1241,5138,1610,1881,786,1363,5640
15,Sudan (UNDP),2014,SUD-14/S2/WASH/NGO/1053,6/6/2016 3:13:03 PM,Children under 5,0,0,524,786,1310,0,0,524,786,1310
15,Sudan (UNDP),2014,SUD-14/S2/WASH/NGO/1053,6/6/2016 3:13:03 PM,Overall,14994,22491,1666,2499,41650,14994,22491,1666,2499,41650
15,Sudan (UNDP),2014,SUD-14/S2/WASH/NGO/1053,6/6/2016 3:13:03 PM,People in Host Communities,18221,26173,1432,2365,48191,18221,26173,1432,2365,48191
15,Sudan (UNDP),2014,SUD-14/S2/WASH/NGO/1053,6/6/2016 3:13:03 PM,Women of Child-Bearing Age,0,2469,0,0,2469,0,2469,0,0,2469
15,Sudan (UNDP),2014,SUD-14/S2/WASH/UN/1050,4/24/2016 2:57:38 PM,Children under 18,0,0,7434,7737,15171,0,0,8752,10527,19279
15,Sudan (UNDP),2014,SUD-14/S2/WASH/UN/1050,4/24/2016 2:57:38 PM,Children under 5,0,0,1385,1443,2828,0,0,2113,2632,4745
15,Sudan (UNDP),2014,SUD-14/S2/WASH/UN/1050,4/24/2016 2:57:38 PM,Internally Displaced People,5880,6120,9000,9000,30000,14056,16952,10856,13159,55023
15,Sudan (UNDP),2014,SUD-14/S2/WASH/UN/1050,4/24/2016 2:57:38 PM,Overall,5880,6120,9000,9000,30000,14056,16952,10865,13159,55032
15,Sudan (UNDP),2014,SUD-14/SSp/FSL/UN/1013,10/8/2015 11:06:18 AM,Internally Displaced People,34812,36232,23681,23681,118406,0,0,0,0,0
15,Sudan (UNDP),2014,SUD-14/SSp/FSL/UN/1013,10/8/2015 11:06:18 AM,Overall,87500,91072,59524,59524,297620,0,0,0,0,0
15,Sudan (UNDP),2014,SUD-14/SSp/FSL/UN/1013,10/8/2015 11:06:18 AM,People in Host Communities,52688,54840,35843,35843,179214,0,0,0,0,0
15,Sudan (UNDP),2014,SUD-14/SSp/FSL/UN/1014,10/8/2015 11:06:18 AM,Internally Displaced People,61400,58992,25799,25799,171990,35266,36705,15422,15422,102815
15,Sudan (UNDP),2014,SUD-14/SSp/FSL/UN/1014,10/8/2015 11:06:18 AM,Overall,102333,98321,42998,42998,286650,61225,63725,26775,26775,178500
15,Sudan (UNDP),2014,SUD-14/SSp/FSL/UN/1014,10/8/2015 11:06:18 AM,People in Host Communities,40934,39328,17199,17199,114660,25960,27019,11353,11353,75685
15,Sudan (UNDP),2014,SUD-14/SSp/H/UN/999,10/8/2015 11:06:18 AM,Children under 5,0,0,107432,87898,195330,0,0,106480,86349,192829
15,Sudan (UNDP),2014,SUD-14/SSp/H/UN/999,10/8/2015 11:06:18 AM,Internally Displaced People/Returnees,422530,342707,147876,120990,1034103,421800,341920,146600,120980,1031300
15,Sudan (UNDP),2014,SUD-14/SSp/H/UN/999,10/8/2015 11:06:18 AM,Overall,461326,377450,170627,139604,1149007,455200,375540,170700,136560,1138000
15,Sudan (UNDP),2014,SUD-14/SSp/H/UN/999,10/8/2015 11:06:18 AM,Women of Child-Bearing Age,0,94362,0,0,94362,0,93684,0,0,93684
15,Sudan (UNDP),2014,SUD-14/SSp/L/UN/1010,10/8/2015 11:06:19 AM,Overall,21600,21600,0,0,43200,0,0,0,0,0
15,Sudan (UNDP),2014,SUD-14/SSp/N/UN/1000,10/8/2015 11:06:18 AM,Children under 5,0,0,7650,7350,15000,0,0,7885,7907,15792
15,Sudan (UNDP),2014,SUD-14/SSp/N/UN/1000,10/8/2015 11:06:18 AM,Overall,0,0,7650,7350,15000,0,0,7885,7907,15792
15,Sudan (UNDP),2014,SUD-14/SSp/NFI/UN/1004,10/8/2015 11:06:18 AM,Overall,37500,37500,37500,37500,150000,37500,37500,37500,37500,150000
15,Sudan (UNDP),2014,SUD-14/SSp/WASH/UN/1012,10/8/2015 11:06:19 AM,Children under 18,0,0,40720,42280,83000,0,0,40720,4280,45000
15,Sudan (UNDP),2014,SUD-14/SSp/WASH/UN/1012,10/8/2015 11:06:19 AM,Children under 5,0,0,22000,23000,45000,0,0,22000,23000,45000
15,Sudan (UNDP),2014,SUD-14/SSp/WASH/UN/1012,10/8/2015 11:06:19 AM,Internally Displaced People,35280,36720,0,0,72000,35280,36720,0,0,72000
15,Sudan (UNDP),2014,SUD-14/SSp/WASH/UN/1012,10/8/2015 11:06:19 AM,Overall,35280,36720,62720,65280,200000,35280,36720,62720,65280,200000
15,Sudan (UNDP),2015,SUD-15/HSD20/R/E/UN/1326,3/22/2016 10:33:56 AM,Internally Displaced People,0,0,1750,1750,3500,0,0,2787,2547,5334
15,Sudan (UNDP),2015,SUD-15/HSD20/R/E/UN/1326,3/22/2016 10:33:56 AM,Overall,0,0,1750,1750,3500,0,0,2787,2547,5334
15,Sudan (UNDP),2015,SUD-15/HSD20/R/H/INGO/1515,10/3/2016 12:56:36 PM,Internally Displaced People,396,413,325,338,1472,714,699,146,143,1702
15,Sudan (UNDP),2015,SUD-15/HSD20/R/H/INGO/1515,10/3/2016 12:56:36 PM,Overall,528,550,433,450,1961,490,655,410,448,2003
15,Sudan (UNDP),2015,SUD-15/HSD20/R/H/UN/1517,10/3/2016 12:47:01 PM,Overall,134035,151145,201053,226719,712952,315046,341301,230040,249209,1135596
15,Sudan (UNDP),2015,SUD-15/HSD20/R/H/UN/1517,10/3/2016 12:47:01 PM,"Staff (own or partner staff, authorities)",120,80,0,0,200,127,73,0,0,200
15,Sudan (UNDP),2015,SUD-15/HSD20/R/H/UN/1517,10/3/2016 12:47:01 PM,"Trainers, Promoters, Caretakers, committee members, etc.",300,394,0,0,694,412,280,0,0,692
15,Sudan (UNDP),2015,SUD-15/HSD20/R/H-WASH/UN/1516,4/10/2017 6:05:37 AM,Children under 5,0,0,43924,45716,89640,0,0,41478,45412,86890
15,Sudan (UNDP),2015,SUD-15/HSD20/R/H-WASH/UN/1516,4/10/2017 6:05:37 AM,Internally Displaced People,43499,45274,47124,49048,184945,96883,100837,37677,39213,274610
15,Sudan (UNDP),2015,SUD-15/HSD20/R/H-WASH/UN/1516,4/10/2017 6:05:37 AM,Overall,117130,121910,126890,132070,498000,116663,119097,122717,122523,481000
15,Sudan (UNDP),2015,SUD-15/HSD20/R/H-WASH/UN/1516,4/10/2017 6:05:37 AM,Women of Child-Bearing Age,0,124500,0,0,124500,0,119500,0,0,119500
15,Sudan (UNDP),2015,SUD-15/HSD20/R/N/UN/1327,6/6/2016 3:03:23 PM,Internally Displaced People,0,575,5462,5463,11500,0,558,5610,5390,11558
15,Sudan (UNDP),2015,SUD-15/HSD20/R/N/UN/1327,6/6/2016 3:03:23 PM,Overall,0,575,5462,5463,11500,0,558,5610,5390,11558
15,Sudan (UNDP),2015,SUD-15/HSD20/R/N/UN/1374,3/22/2016 10:34:21 AM,Children under 5,0,0,796,764,1560,0,0,802,758,1560
15,Sudan (UNDP),2015,SUD-15/HSD20/R/N/UN/1374,3/22/2016 10:34:21 AM,Overall,0,6000,796,764,7560,0,7104,802,758,8664
15,Sudan (UNDP),2015,SUD-15/HSD20/R/N/UN/1374,3/22/2016 10:34:21 AM,Women of Child-Bearing Age,0,6000,0,0,6000,0,7104,0,0,7104
15,Sudan (UNDP),2015,SUD-15/HSD20/R/P/UN/1119,6/16/2016 9:22:15 AM,Children under 18,0,0,4280,4526,8806,0,0,8319,10189,18508
15,Sudan (UNDP),2015,SUD-15/HSD20/R/P/UN/1119,6/16/2016 9:22:15 AM,Committees,0,0,120,120,240,994,662,0,0,1656
15,Sudan (UNDP),2015,SUD-15/HSD20/R/P/UN/1119,6/16/2016 9:22:15 AM,Internally Displaced People,5000,5000,0,0,10000,7662,8994,8319,10189,35164
15,Sudan (UNDP),2015,SUD-15/HSD20/R/P/UN/1119,6/16/2016 9:22:15 AM,Overall,5120,5120,4280,4526,19046,7662,8994,8319,10189,35164
15,Sudan (UNDP),2015,SUD-15/HSD20/R/P/UN/1384,6/19/2016 11:45:08 AM,Overall,1500,1500,3500,3500,10000,2195,3990,2652,2420,11257
15,Sudan (UNDP),2015,SUD-15/HSD20/R/RMS/NGO/1377,3/22/2016 10:29:59 AM,Overall,800,2050,950,1200,5000,1417,3277,1665,2499,8858
15,Sudan (UNDP),2015,SUD-15/HSD20/R/RMS/NGO/1377,3/22/2016 10:29:59 AM,People in Host Communities,685,1127,489,699,3000,685,1127,489,699,3000
15,Sudan (UNDP),2015,SUD-15/HSD20/R/RMS/UN/1375,5/9/2016 8:06:16 AM,Overall,100,790,2055,2055,5000,303,342,2093,1621,4359
15,Sudan (UNDP),2015,SUD-15/HSD20/R/RMS/UN/1375,5/9/2016 8:06:16 AM,People in Host Communities,1500,1500,0,0,3000,1500,1500,0,0,3000
15,Sudan (UNDP),2015,SUD-15/HSD20/R/RMS/UN/1380,5/19/2016 8:24:50 AM,Children under 5,0,0,727,889,1616,0,0,749,950,1699
15,Sudan (UNDP),2015,SUD-15/HSD20/R/RMS/UN/1380,5/19/2016 8:24:50 AM,Overall,1536,2343,2020,2181,8080,1614,2463,2123,2294,8494
15,Sudan (UNDP),2015,SUD-15/HSD20/R/RMS/UN/1380,5/19/2016 8:24:50 AM,Women of Child-Bearing Age,0,2320,0,0,2320,0,2450,0,0,2450
15,Sudan (UNDP),2015,SUD-15/HSD20/R/RMS/UN/1383,5/9/2016 8:05:42 AM,Children under 5,0,0,794,794,1588,0,0,504,484,988
15,Sudan (UNDP),2015,SUD-15/HSD20/R/RMS/UN/1383,5/9/2016 8:05:42 AM,Overall,0,150,794,794,1738,0,255,504,484,1243
15,Sudan (UNDP),2015,SUD-15/HSD20/R/RMS/UN/1383,5/9/2016 8:05:42 AM,Pregnant and Lactating Women,0,150,0,0,150,0,255,0,0,255
15,Sudan (UNDP),2015,SUD-15/HSD20/R/WASH/INGO/1373,5/12/2016 6:17:30 AM,Overall,12495,12495,4998,5712,35700,7359,7894,8995,8553,32801
15,Sudan (UNDP),2015,SUD-15/HSD20/S1/CCS/UN/1282,2/13/2017 2:14:37 PM,Internally Displaced People,154000,126000,64800,55200,400000,53060,82482,99077,106713,341332
15,Sudan (UNDP),2015,SUD-15/HSD20/S1/CCS/UN/1282,2/13/2017 2:14:37 PM,Overall,154000,126000,64800,55200,400000,93269,146040,173529,187910,600748
15,Sudan (UNDP),2015,SUD-15/HSD20/S1/E/INGO/1158,4/24/2017 6:00:55 AM,Children under 18,0,0,3734,3121,6855,0,0,4805,3930,8735
15,Sudan (UNDP),2015,SUD-15/HSD20/S1/E/INGO/1158,4/24/2017 6:00:55 AM,Overall,124,100,3734,3121,7079,192,32,4805,3930,8959
15,Sudan (UNDP),2015,SUD-15/HSD20/S1/E/INGO/1158,4/24/2017 6:00:55 AM,"Trainers, Promoters, Caretakers, committee members, etc.",124,100,0,0,224,192,32,0,0,224
15,Sudan (UNDP),2015,SUD-15/HSD20/S1/E/INGO/1165,11/14/2016 7:11:28 AM,Internally Displaced People,23,19,762,612,1416,24,43,762,612,1441
15,Sudan (UNDP),2015,SUD-15/HSD20/S1/E/INGO/1165,11/14/2016 7:11:28 AM,Overall,59,34,1348,1168,2609,62,82,1348,1168,2660
15,Sudan (UNDP),2015,SUD-15/HSD20/S1/E/INGO/1165,11/14/2016 7:11:28 AM,People in Host Communities,36,15,586,556,1193,38,39,586,556,1219
15,Sudan (UNDP),2015,SUD-15/HSD20/S1/E/INGO/1231,4/24/2017 5:58:52 AM,Children under 18,0,0,3000,3000,6000,0,0,2562,3438,6000
15,Sudan (UNDP),2015,SUD-15/HSD20/S1/E/INGO/1231,4/24/2017 5:58:52 AM,Internally Displaced People,86,100,0,0,186,99,72,0,0,171
15,Sudan (UNDP),2015,SUD-15/HSD20/S1/E/INGO/1231,4/24/2017 5:58:52 AM,Overall,96,122,3000,3000,6218,122,89,2558,3432,6201
15,Sudan (UNDP),2015,SUD-15/HSD20/S1/E/INGO/1231,4/24/2017 5:58:52 AM,People in Host Communities,10,22,0,0,32,12,18,0,0,30
15,Sudan (UNDP),2015,SUD-15/HSD20/S1/E/INGO/1239,3/12/2017 1:27:42 PM,Children under 18,0,0,2873,3570,6443,0,0,0,0,0
15,Sudan (UNDP),2015,SUD-15/HSD20/S1/E/INGO/1239,3/12/2017 1:27:42 PM,Internally Displaced People,140,140,2873,3570,6723,228,208,4397,2704,7537
15,Sudan (UNDP),2015,SUD-15/HSD20/S1/E/INGO/1239,3/12/2017 1:27:42 PM,Overall,280,280,2873,3570,7003,368,348,4397,2704,7817
15,Sudan (UNDP),2015,SUD-15/HSD20/S1/E/INGO/1239,3/12/2017 1:27:42 PM,"Staff (own or partner staff, authorities)",140,140,0,0,280,140,140,0,0,280
15,Sudan (UNDP),2015,SUD-15/HSD20/S1/E/NGO/1134,5/19/2016 8:21:30 AM,Children under 18,0,0,1350,1650,3000,0,0,1400,1600,3000
15,Sudan (UNDP),2015,SUD-15/HSD20/S1/E/NGO/1134,5/19/2016 8:21:30 AM,Internally Displaced People,150,100,0,0,250,149,101,0,0,250
15,Sudan (UNDP),2015,SUD-15/HSD20/S1/E/NGO/1134,5/19/2016 8:21:30 AM,Overall,150,100,1350,1650,3250,149,101,1400,1600,3250
15,Sudan (UNDP),2015,SUD-15/HSD20/S1/E/NGO/1263,11/14/2016 7:11:00 AM,Children under 18,0,0,930,1830,2760,0,0,1605,2130,3735
15,Sudan (UNDP),2015,SUD-15/HSD20/S1/E/NGO/1263,11/14/2016 7:11:00 AM,Children under 5,0,0,134,134,268,0,0,134,134,268
15,Sudan (UNDP),2015,SUD-15/HSD20/S1/E/NGO/1263,11/14/2016 7:11:00 AM,Internally Displaced People/Returnees,500,1500,0,0,2000,700,1800,0,0,2500
15,Sudan (UNDP),2015,SUD-15/HSD20/S1/E/NGO/1263,11/14/2016 7:11:00 AM,Overall,537,1537,1064,1964,5102,80,63,2580,3848,6571
15,Sudan (UNDP),2015,SUD-15/HSD20/S1/E/NGO/1263,11/14/2016 7:11:00 AM,People in Host Communities,37,37,0,0,74,38,30,0,0,68
15,Sudan (UNDP),2015,SUD-15/HSD20/S1/ESNFIs/INGO/1120,5/11/2016 6:11:18 AM,Internally Displaced People,10118,15176,12647,12647,50588,10014,15022,12517,12517,50070
15,Sudan (UNDP),2015,SUD-15/HSD20/S1/ESNFIs/INGO/1120,5/11/2016 6:11:18 AM,Overall,10118,15176,12647,12647,50588,10014,15022,12517,12517,50070
15,Sudan (UNDP),2015,SUD-15/HSD20/S1/ESNFIs/INGO/1142,5/11/2016 6:10:24 AM,Children under 18,0,0,3000,3500,6500,0,0,857,1018,1875
15,Sudan (UNDP),2015,SUD-15/HSD20/S1/ESNFIs/INGO/1142,5/11/2016 6:10:24 AM,Committees,200,200,0,0,400,16,17,0,0,33
15,Sudan (UNDP),2015,SUD-15/HSD20/S1/ESNFIs/INGO/1142,5/11/2016 6:10:24 AM,Internally Displaced People/Returnees,10691,13674,0,0,24365,3138,3982,0,0,7120
15,Sudan (UNDP),2015,SUD-15/HSD20/S1/ESNFIs/INGO/1142,5/11/2016 6:10:24 AM,Overall,10891,13874,3000,3500,31265,3138,3982,857,1018,8995
15,Sudan (UNDP),2015,SUD-15/HSD20/S1/ESNFIs/INGO/1153,5/3/2016 8:13:55 AM,Internally Displaced People,7465,9636,7129,6820,31050,6089,7926,5687,5574,25276
15,Sudan (UNDP),2015,SUD-15/HSD20/S1/ESNFIs/INGO/1153,5/3/2016 8:13:55 AM,Overall,7477,9649,7129,6820,31075,6094,7926,5687,5574,25281
15,Sudan (UNDP),2015,SUD-15/HSD20/S1/ESNFIs/INGO/1153,5/3/2016 8:13:55 AM,"Staff (own or partner staff, authorities)",12,13,0,0,25,5,0,0,0,5
15,Sudan (UNDP),2015,SUD-15/HSD20/S1/ESNFIs/INGO/1241,5/8/2016 2:52:28 PM,Aid Agencies,20,20,0,0,40,37,26,0,0,63
15,Sudan (UNDP),2015,SUD-15/HSD20/S1/ESNFIs/INGO/1241,5/8/2016 2:52:28 PM,Children under 18,0,0,0,0,0,0,0,3410,3410,6820
15,Sudan (UNDP),2015,SUD-15/HSD20/S1/ESNFIs/INGO/1241,5/8/2016 2:52:28 PM,Internally Displaced People,2025,3038,3093,3094,11250,1843,2764,2813,2815,10235
15,Sudan (UNDP),2015,SUD-15/HSD20/S1/ESNFIs/INGO/1241,5/8/2016 2:52:28 PM,Overall,2221,3321,3361,3362,12265,2270,3374,3410,3410,12464
15,Sudan (UNDP),2015,SUD-15/HSD20/S1/ESNFIs/INGO/1241,5/8/2016 2:52:28 PM,Returnees,176,263,268,268,975,390,585,595,595,2165
15,Sudan (UNDP),2015,SUD-15/HSD20/S1/ESNFIs/INGO/1280,5/8/2016 2:53:02 PM,Internally Displaced People/Returnees,14237,14816,2913,3034,35000,11414,12472,2836,2995,29717
15,Sudan (UNDP),2015,SUD-15/HSD20/S1/ESNFIs/INGO/1280,5/8/2016 2:53:02 PM,Overall,14237,14816,2913,3034,35000,11414,12472,2836,2995,29717
15,Sudan (UNDP),2015,SUD-15/HSD20/S1/ESNFIs/NGO/1132,10/5/2016 10:36:53 AM,Internally Displaced People,3000,4000,900,900,8800,1000,1500,800,900,4200
15,Sudan (UNDP),2015,SUD-15/HSD20/S1/ESNFIs/NGO/1132,10/5/2016 10:36:53 AM,Internally Displaced People/Returnees,800,700,200,250,1950,200,250,100,120,670
15,Sudan (UNDP),2015,SUD-15/HSD20/S1/ESNFIs/NGO/1132,10/5/2016 10:36:53 AM,Overall,3800,4700,1100,1150,10750,1720,2400,1300,1400,6820
15,Sudan (UNDP),2015,SUD-15/HSD20/S1/ESNFIs/NGO/1181,5/3/2016 8:13:00 AM,Internally Displaced People,2000,3800,1500,2000,9300,2000,3800,1500,2000,9300
15,Sudan (UNDP),2015,SUD-15/HSD20/S1/ESNFIs/NGO/1181,5/3/2016 8:13:00 AM,Overall,2225,4200,1575,2500,10500,2225,4200,1575,2500,10500
15,Sudan (UNDP),2015,SUD-15/HSD20/S1/ESNFIs/NGO/1181,5/3/2016 8:13:00 AM,Returnees,225,400,75,500,1200,225,400,75,500,1200
15,Sudan (UNDP),2015,SUD-15/HSD20/S1/ESNFIs/NGO/1223,6/27/2016 10:13:40 AM,Children under 5,0,0,295,344,639,0,0,290,350,640
15,Sudan (UNDP),2015,SUD-15/HSD20/S1/ESNFIs/NGO/1223,6/27/2016 10:13:40 AM,Internally Displaced People,700,2500,970,1300,5470,700,2360,970,1260,5290
15,Sudan (UNDP),2015,SUD-15/HSD20/S1/ESNFIs/NGO/1223,6/27/2016 10:13:40 AM,Internally Displaced People/Returnees,104,1100,370,446,2020,104,1100,370,450,2024
15,Sudan (UNDP),2015,SUD-15/HSD20/S1/ESNFIs/NGO/1223,6/27/2016 10:13:40 AM,Overall,804,3600,2000,2400,8804,770,3200,2000,2150,8120
15,Sudan (UNDP),2015,SUD-15/HSD20/S1/ESNFIs/NGO/1223,6/27/2016 10:13:40 AM,Pregnant and Lactating Women,0,0,365,310,675,0,0,370,296,666
15,Sudan (UNDP),2015,SUD-15/HSD20/S1/ESNFIs/NGO/1268,6/27/2016 10:20:05 AM,Children under 5,0,0,415,891,1306,0,0,15000,24000,39000
15,Sudan (UNDP),2015,SUD-15/HSD20/S1/ESNFIs/NGO/1268,6/27/2016 10:20:05 AM,Other,173,755,0,0,928,500,1500,0,0,2000
15,Sudan (UNDP),2015,SUD-15/HSD20/S1/ESNFIs/NGO/1268,6/27/2016 10:20:05 AM,Overall,2158,3022,1382,2071,8633,22000,35000,25000,54132,136132
15,Sudan (UNDP),2015,SUD-15/HSD20/S1/ESNFIs/NGO/1268,6/27/2016 10:20:05 AM,Pregnant and Lactating Women,0,907,0,0,907,0,5000,0,0,5000
15,Sudan (UNDP),2015,SUD-15/HSD20/S1/ESNFIs/UN/1234,6/2/2016 2:12:36 PM,Internally Displaced People,492,2400,1008,1100,5000,4179,10459,2358,4794,21790
15,Sudan (UNDP),2015,SUD-15/HSD20/S1/ESNFIs/UN/1234,6/2/2016 2:12:36 PM,Overall,164,1840,480,516,3000,5996,10244,3249,5496,24985
15,Sudan (UNDP),2015,SUD-15/HSD20/S1/FSL/INGO/1312,5/4/2016 9:17:13 AM,Internally Displaced People,7488,6392,2541,2587,19008,7495,8120,3212,3480,22307
15,Sudan (UNDP),2015,SUD-15/HSD20/S1/FSL/INGO/1312,5/4/2016 9:17:13 AM,Overall,9057,7662,3049,3092,22860,9999,10833,4285,4643,29760
15,Sudan (UNDP),2015,SUD-15/HSD20/S1/FSL/INGO/1319,6/15/2016 11:11:56 AM,Committees,100,100,0,0,200,50,50,0,0,100
15,Sudan (UNDP),2015,SUD-15/HSD20/S1/FSL/INGO/1319,6/15/2016 11:11:56 AM,Internally Displaced People,13103,15242,4106,4794,37245,9865,10253,2100,2100,24318
15,Sudan (UNDP),2015,SUD-15/HSD20/S1/FSL/INGO/1319,6/15/2016 11:11:56 AM,Overall,15318,17982,5106,5994,44400,10435,11270,925,1010,23640
15,Sudan (UNDP),2015,SUD-15/HSD20/S1/FSL/INGO/1319,6/15/2016 11:11:56 AM,People in Host Communities,2115,2640,1000,1200,6955,1652,1891,600,800,4943
15,Sudan (UNDP),2015,SUD-15/HSD20/S1/FSL/INGO/1322,7/17/2016 6:12:44 AM,Internally Displaced People,2044,4362,6495,6022,18923,2044,4362,6495,6022,18923
15,Sudan (UNDP),2015,SUD-15/HSD20/S1/FSL/INGO/1322,7/17/2016 6:12:44 AM,Overall,2982,6080,8522,9151,26735,2982,6080,8522,9151,26735
15,Sudan (UNDP),2015,SUD-15/HSD20/S1/FSL/INGO/1322,7/17/2016 6:12:44 AM,People in Host Communities,938,1718,2500,2656,7812,938,1718,2500,2656,7812
15,Sudan (UNDP),2015,SUD-15/HSD20/S1/FSL/INGO/1325,5/4/2016 9:14:29 AM,Internally Displaced People,7840,9380,4480,4491,26191,6368,5568,2459,5827,20222
15,Sudan (UNDP),2015,SUD-15/HSD20/S1/FSL/INGO/1325,5/4/2016 9:14:29 AM,Overall,11200,13400,6400,6416,37416,14152,13920,5464,10594,44130
15,Sudan (UNDP),2015,SUD-15/HSD20/S1/FSL/INGO/1325,5/4/2016 9:14:29 AM,People in Host Communities,3360,4020,1920,1925,11225,7784,8352,3005,4767,23908
15,Sudan (UNDP),2015,SUD-15/HSD20/S1/FSL/INGO/1330,6/23/2016 11:13:14 AM,Internally Displaced People,9933,11919,13409,14404,49665,9933,11919,13409,14404,49665
15,Sudan (UNDP),2015,SUD-15/HSD20/S1/FSL/INGO/1330,6/23/2016 11:13:14 AM,Overall,14190,17028,19157,20575,70950,14190,17028,19157,20575,70950
15,Sudan (UNDP),2015,SUD-15/HSD20/S1/FSL/INGO/1330,6/23/2016 11:13:14 AM,People in Host Communities,4257,5108,5747,6173,21285,4257,5108,5747,6173,21285
15,Sudan (UNDP),2015,SUD-15/HSD20/S1/FSL/INGO/1331,5/4/2016 9:15:34 AM,Children under 18,0,0,8398,8653,17051,0,0,8398,8653,17051
15,Sudan (UNDP),2015,SUD-15/HSD20/S1/FSL/INGO/1331,5/4/2016 9:15:34 AM,Internally Displaced People,2673,3207,0,0,5880,2673,3207,0,0,5880
15,Sudan (UNDP),2015,SUD-15/HSD20/S1/FSL/INGO/1331,5/4/2016 9:15:34 AM,Overall,3818,4581,8398,8653,25450,3818,4581,8398,8653,25450
15,Sudan (UNDP),2015,SUD-15/HSD20/S1/FSL/INGO/1331,5/4/2016 9:15:34 AM,People in Host Communities,1145,1374,0,0,2519,1145,1374,0,0,2519
15,Sudan (UNDP),2015,SUD-15/HSD20/S1/FSL/NGO/1302,5/4/2016 9:12:21 AM,Internally Displaced People,6774,7339,4516,4893,23522,8205,8418,5413,5803,27839
15,Sudan (UNDP),2015,SUD-15/HSD20/S1/FSL/NGO/1302,5/4/2016 9:12:21 AM,Overall,8640,9360,5760,6240,30000,11151,11501,7342,7893,37887
15,Sudan (UNDP),2015,SUD-15/HSD20/S1/FSL/NGO/1304,5/4/2016 9:12:53 AM,Internally Displaced People,13215,19822,5506,5507,44050,12928,19561,5158,5200,42847
15,Sudan (UNDP),2015,SUD-15/HSD20/S1/FSL/NGO/1304,5/4/2016 9:12:53 AM,Overall,13215,19822,5506,5507,44050,12928,19561,5158,5200,42847
15,Sudan (UNDP),2015,SUD-15/HSD20/S1/FSL/NGO/1310,5/4/2016 9:13:27 AM,Internally Displaced People,6484,11712,5784,11178,35158,6484,11712,5784,11178,35158
15,Sudan (UNDP),2015,SUD-15/HSD20/S1/FSL/NGO/1310,5/4/2016 9:13:27 AM,Overall,9034,15492,6816,13738,45080,9034,15492,6816,13738,45080
15,Sudan (UNDP),2015,SUD-15/HSD20/S1/FSL/NGO/1310,5/4/2016 9:13:27 AM,People in Host Communities,2550,3780,1032,2560,9922,2550,3780,1032,2560,9922
15,Sudan (UNDP),2015,SUD-15/HSD20/S1/FSL/NGO/1336,6/15/2016 11:14:07 AM,Internally Displaced People,1415,1473,605,632,4125,1386,1379,567,622,3954
15,Sudan (UNDP),2015,SUD-15/HSD20/S1/FSL/NGO/1336,6/15/2016 11:14:07 AM,Overall,2573,2677,1100,1150,7500,1080,1110,620,840,3650
15,Sudan (UNDP),2015,SUD-15/HSD20/S1/FSL/NGO/1336,6/15/2016 11:14:07 AM,People in Host Communities,1158,1204,495,518,3375,1000,1100,400,500,3000
15,Sudan (UNDP),2015,SUD-15/HSD20/S1/H/INGO/1135,6/2/2016 10:37:24 AM,Children under 5,0,0,7764,9299,17063,0,0,7764,9299,17063
15,Sudan (UNDP),2015,SUD-15/HSD20/S1/H/INGO/1135,6/2/2016 10:37:24 AM,Internally Displaced People,23282,28456,4782,5845,62365,23282,24031,0,0,47313
15,Sudan (UNDP),2015,SUD-15/HSD20/S1/H/INGO/1135,6/2/2016 10:37:24 AM,Overall,34250,41861,8158,9971,94240,23282,23031,7764,9299,63376
15,Sudan (UNDP),2015,SUD-15/HSD20/S1/H/INGO/1135,6/2/2016 10:37:24 AM,Pregnant and Lactating Women,0,3770,0,0,3770,0,0,0,0,0
15,Sudan (UNDP),2015,SUD-15/HSD20/S1/H/INGO/1135,6/2/2016 10:37:24 AM,Women of Child-Bearing Age,0,24031,0,0,24031,0,24031,0,0,24031
15,Sudan (UNDP),2015,SUD-15/HSD20/S1/H/INGO/1136,7/17/2016 6:11:03 AM,Internally Displaced People,90253,93365,62243,65366,311227,55186,69693,142381,148473,415733
15,Sudan (UNDP),2015,SUD-15/HSD20/S1/H/INGO/1136,7/17/2016 6:11:03 AM,Overall,143236,148175,98783,103722,493916,79979,98159,192406,203388,573932
15,Sudan (UNDP),2015,SUD-15/HSD20/S1/H/INGO/1136,7/17/2016 6:11:03 AM,Returnees,3481,3601,2400,2521,12003,0,0,0,0,0
15,Sudan (UNDP),2015,SUD-15/HSD20/S1/H/INGO/1156,5/19/2016 8:22:35 AM,Children under 5,0,0,3400,2754,6154,0,0,6230,6244,12474
15,Sudan (UNDP),2015,SUD-15/HSD20/S1/H/INGO/1156,5/19/2016 8:22:35 AM,Internally Displaced People,17476,19416,15693,15757,68342,50828,41588,9400,9529,111345
15,Sudan (UNDP),2015,SUD-15/HSD20/S1/H/INGO/1156,5/19/2016 8:22:35 AM,Overall,26586,27672,22971,22070,99299,52613,64305,10980,11284,139182
15,Sudan (UNDP),2015,SUD-15/HSD20/S1/H/INGO/1156,5/19/2016 8:22:35 AM,Women of Child-Bearing Age,0,3202,0,0,3202,0,12413,0,0,12413
15,Sudan (UNDP),2015,SUD-15/HSD20/S1/H/INGO/1178,5/19/2016 8:23:00 AM,Children under 5,0,0,7264,7586,14850,0,0,33207,37411,70618
15,Sudan (UNDP),2015,SUD-15/HSD20/S1/H/INGO/1178,5/19/2016 8:23:00 AM,Internally Displaced People,75865,100831,15404,16033,208133,25476,17889,12724,13919,70008
15,Sudan (UNDP),2015,SUD-15/HSD20/S1/H/INGO/1178,5/19/2016 8:23:00 AM,Overall,127074,202826,33022,34485,397407,63547,75674,63535,69697,272453
15,Sudan (UNDP),2015,SUD-15/HSD20/S1/H/INGO/1178,5/19/2016 8:23:00 AM,People in Host Communities,51209,81728,10354,10866,154157,38071,29324,17604,18367,103366
15,Sudan (UNDP),2015,SUD-15/HSD20/S1/H/INGO/1178,5/19/2016 8:23:00 AM,Pregnant and Lactating Women,0,20267,0,0,20267,0,28461,0,0,28461
15,Sudan (UNDP),2015,SUD-15/HSD20/S1/H/INGO/1204,5/16/2016 12:31:04 PM,Internally Displaced People,35859,37323,7345,7644,88171,21450,22327,4393,4573,52743
15,Sudan (UNDP),2015,SUD-15/HSD20/S1/H/INGO/1204,5/16/2016 12:31:04 PM,Internally Displaced People/Returnees,1889,1966,387,402,4644,1906,2777,1450,1419,7552
15,Sudan (UNDP),2015,SUD-15/HSD20/S1/H/INGO/1204,5/16/2016 12:31:04 PM,Overall,37748,39288,7732,8047,92815,38124,55537,29006,28379,151046
15,Sudan (UNDP),2015,SUD-15/HSD20/S1/H/INGO/1211,5/17/2016 6:08:28 AM,Internally Displaced People,12185,18277,3295,3166,36923,10827,10162,10548,14770,46307
15,Sudan (UNDP),2015,SUD-15/HSD20/S1/H/INGO/1211,5/17/2016 6:08:28 AM,Overall,34863,52328,9415,9046,105652,30934,29033,30138,42200,132305
15,Sudan (UNDP),2015,SUD-15/HSD20/S1/H/INGO/1211,5/17/2016 6:08:28 AM,Pastoralists,3482,5223,942,904,10551,3094,2903,3014,4220,13231
15,Sudan (UNDP),2015,SUD-15/HSD20/S1/H/INGO/1211,5/17/2016 6:08:28 AM,People in Host Communities,15666,23500,4237,4071,47474,13920,13065,13562,18990,59537
15,Sudan (UNDP),2015,SUD-15/HSD20/S1/H/INGO/1211,5/17/2016 6:08:28 AM,Returnees,3482,5221,941,905,10549,3093,2903,3014,4220,13230
15,Sudan (UNDP),2015,SUD-15/HSD20/S1/H/INGO/1261,5/17/2016 6:07:50 AM,Children under 5,0,0,22977,22591,45568,0,0,13422,13302,26724
15,Sudan (UNDP),2015,SUD-15/HSD20/S1/H/INGO/1261,5/17/2016 6:07:50 AM,Overall,10999,18557,13920,13686,57162,10579,18373,13422,13302,55676
15,Sudan (UNDP),2015,SUD-15/HSD20/S1/H/INGO/1261,5/17/2016 6:07:50 AM,"Staff (own or partner staff, authorities)",12,8,0,0,20,8,12,0,0,20
15,Sudan (UNDP),2015,SUD-15/HSD20/S1/H/INGO/1261,5/17/2016 6:07:50 AM,"Trainers, Promoters, Caretakers, committee members, etc.",50,50,0,0,100,56,44,0,0,100
15,Sudan (UNDP),2015,SUD-15/HSD20/S1/H/INGO/1261,5/17/2016 6:07:50 AM,Women of Child-Bearing Age,0,13024,0,0,13024,0,12806,0,0,12806
15,Sudan (UNDP),2015,SUD-15/HSD20/S1/H/NGO/1172,5/16/2016 12:31:50 PM,Children under 5,0,0,11890,12881,24771,0,0,7624,7935,15559
15,Sudan (UNDP),2015,SUD-15/HSD20/S1/H/NGO/1172,5/16/2016 12:31:50 PM,Internally Displaced People,35697,37152,34986,37882,145717,30827,35973,15559,16434,98793
15,Sudan (UNDP),2015,SUD-15/HSD20/S1/H/NGO/1172,5/16/2016 12:31:50 PM,Overall,35697,37152,34986,37882,145717,30827,35973,15559,16434,98793
15,Sudan (UNDP),2015,SUD-15/HSD20/S1/H/NGO/1172,5/16/2016 12:31:50 PM,Pregnant and Lactating Women,0,5829,0,0,5829,0,4211,0,0,4211
15,Sudan (UNDP),2015,SUD-15/HSD20/S1/H/NGO/1172,5/16/2016 12:31:50 PM,Women of Child-Bearing Age,0,36429,0,0,36429,0,22448,0,0,22448
15,Sudan (UNDP),2015,SUD-15/HSD20/S1/H/NGO/1176,5/16/2016 12:32:20 PM,Children under 5,0,0,1150,1750,2900,0,0,9985,7647,17632
15,Sudan (UNDP),2015,SUD-15/HSD20/S1/H/NGO/1176,5/16/2016 12:32:20 PM,Internally Displaced People/Returnees,3300,3030,2500,2850,11680,0,0,0,0,0
15,Sudan (UNDP),2015,SUD-15/HSD20/S1/H/NGO/1176,5/16/2016 12:32:20 PM,Overall,3300,6950,3650,4600,18500,14018,16842,9985,7647,48492
15,Sudan (UNDP),2015,SUD-15/HSD20/S1/H/NGO/1176,5/16/2016 12:32:20 PM,Pregnant and Lactating Women,0,2250,0,0,2250,0,1347,0,0,1347
15,Sudan (UNDP),2015,SUD-15/HSD20/S1/H/NGO/1176,5/16/2016 12:32:20 PM,Women of Child-Bearing Age,0,1670,0,0,1670,0,881,0,0,881
15,Sudan (UNDP),2015,SUD-15/HSD20/S1/H/NGO/1194,10/9/2016 12:44:15 PM,Children under 5,0,0,17974,18708,36682,0,0,12188,26576,38764
15,Sudan (UNDP),2015,SUD-15/HSD20/S1/H/NGO/1194,10/9/2016 12:44:15 PM,Internally Displaced People,54000,71672,2938,8880,137490,34824,81153,4969,10834,131780
15,Sudan (UNDP),2015,SUD-15/HSD20/S1/H/NGO/1194,10/9/2016 12:44:15 PM,Overall,55122,81900,18800,27590,183412,34852,94661,17157,37410,184080
15,Sudan (UNDP),2015,SUD-15/HSD20/S1/H/NGO/1194,10/9/2016 12:44:15 PM,Pregnant and Lactating Women,0,9170,0,0,9170,0,13444,0,0,13444
15,Sudan (UNDP),2015,SUD-15/HSD20/S1/H/NGO/1194,10/9/2016 12:44:15 PM,"Staff (own or partner staff, authorities)",40,30,0,0,70,28,46,0,0,74
15,Sudan (UNDP),2015,SUD-15/HSD20/S1/H/NGO/1197,5/17/2016 6:09:51 AM,Children under 5,0,0,18996,19929,38925,0,0,14761,15992,30753
15,Sudan (UNDP),2015,SUD-15/HSD20/S1/H/NGO/1197,5/17/2016 6:09:51 AM,Internally Displaced People,72917,78993,36458,39497,227865,86837,94073,43418,47037,271365
15,Sudan (UNDP),2015,SUD-15/HSD20/S1/H/NGO/1197,5/17/2016 6:09:51 AM,Overall,72917,78993,36458,39497,227865,86837,94073,43418,47037,271365
15,Sudan (UNDP),2015,SUD-15/HSD20/S1/H/NGO/1197,5/17/2016 6:09:51 AM,Pregnant and Lactating Women,0,6076,0,0,6076,0,7236,0,0,7236
15,Sudan (UNDP),2015,SUD-15/HSD20/S1/H/NGO/1197,5/17/2016 6:09:51 AM,Women of Child-Bearing Age,0,57078,0,0,57078,0,67841,0,0,67841
15,Sudan (UNDP),2015,SUD-15/HSD20/S1/H/NGO/1221,5/17/2016 6:09:05 AM,Overall,57503,59850,11778,12258,141389,31851,43958,18318,20221,114348
15,Sudan (UNDP),2015,SUD-15/HSD20/S1/H/NGO/1221,5/17/2016 6:09:05 AM,Pregnant and Lactating Women,0,2602,0,0,2602,0,10576,0,0,10576
15,Sudan (UNDP),2015,SUD-15/HSD20/S1/H/NGO/1221,5/17/2016 6:09:05 AM,Returnees,7457,7762,1527,1590,18336,3378,3382,5140,5720,17620
15,Sudan (UNDP),2015,SUD-15/HSD20/S1/H/NGO/1221,5/17/2016 6:09:05 AM,"Staff (own or partner staff, authorities)",75,30,0,0,105,0,0,0,0,0
15,Sudan (UNDP),2015,SUD-15/HSD20/S1/H/NGO/1221,5/17/2016 6:09:05 AM,Women of Child-Bearing Age,0,32519,0,0,32519,0,0,0,0,0
15,Sudan (UNDP),2015,SUD-15/HSD20/S1/H/UN/1245,6/2/2016 10:36:25 AM,Children under 5,0,0,35280,36720,72000,0,0,34860,36240,71100
15,Sudan (UNDP),2015,SUD-15/HSD20/S1/H/UN/1245,6/2/2016 10:36:25 AM,Internally Displaced People/Returnees,34560,51840,45864,47736,180000,34206,51310,45395,47248,178159
15,Sudan (UNDP),2015,SUD-15/HSD20/S1/H/UN/1245,6/2/2016 10:36:25 AM,Overall,34560,51840,45864,47736,180000,34206,51310,45395,47248,178159
15,Sudan (UNDP),2015,SUD-15/HSD20/S1/H/UN/1245,6/2/2016 10:36:25 AM,Women of Child-Bearing Age,0,45800,0,0,45800,0,44540,0,0,44540
15,Sudan (UNDP),2015,SUD-15/HSD20/S1/N/INGO/1127,12/1/2016 8:49:05 AM,Children under 5,0,0,4539,5546,10085,0,0,3943,4151,8094
15,Sudan (UNDP),2015,SUD-15/HSD20/S1/N/INGO/1127,12/1/2016 8:49:05 AM,Internally Displaced People,0,797,2723,3328,6848,0,0,2878,3320,6198
15,Sudan (UNDP),2015,SUD-15/HSD20/S1/N/INGO/1127,12/1/2016 8:49:05 AM,Overall,0,1227,4539,5546,11312,0,369,3943,4151,8463
15,Sudan (UNDP),2015,SUD-15/HSD20/S1/N/INGO/1127,12/1/2016 8:49:05 AM,People in Host Communities,0,430,1816,2218,4464,0,0,1065,831,1896
15,Sudan (UNDP),2015,SUD-15/HSD20/S1/N/INGO/1127,12/1/2016 8:49:05 AM,Pregnant and Lactating Women,0,1227,0,0,1227,0,369,0,0,369
15,Sudan (UNDP),2015,SUD-15/HSD20/S1/N/INGO/1139,6/6/2016 3:16:36 PM,Children under 5,0,0,1200,1800,3000,0,0,811,873,1684
15,Sudan (UNDP),2015,SUD-15/HSD20/S1/N/INGO/1139,6/6/2016 3:16:36 PM,Committees,30,30,0,0,60,20,20,0,0,40
15,Sudan (UNDP),2015,SUD-15/HSD20/S1/N/INGO/1139,6/6/2016 3:16:36 PM,Internally Displaced People,2770,3970,0,0,6740,2081,3989,0,0,6070
15,Sudan (UNDP),2015,SUD-15/HSD20/S1/N/INGO/1139,6/6/2016 3:16:36 PM,Overall,2800,4600,1200,1800,10400,2481,3889,800,641,7811
15,Sudan (UNDP),2015,SUD-15/HSD20/S1/N/INGO/1139,6/6/2016 3:16:36 PM,Pregnant and Lactating Women,0,600,0,0,600,0,93,0,0,93
15,Sudan (UNDP),2015,SUD-15/HSD20/S1/N/INGO/1157,6/6/2016 3:06:41 PM,Internally Displaced People,0,4248,9311,13966,27525,0,7251,8234,15485,30970
15,Sudan (UNDP),2015,SUD-15/HSD20/S1/N/INGO/1157,6/6/2016 3:06:41 PM,Overall,0,5310,11639,17458,34407,0,5986,11954,13862,31802
15,Sudan (UNDP),2015,SUD-15/HSD20/S1/N/INGO/1157,6/6/2016 3:06:41 PM,People in Host Communities,0,1062,2328,3492,6882,0,2233,2614,4847,9694
15,Sudan (UNDP),2015,SUD-15/HSD20/S1/N/INGO/1183,12/11/2017 1:02:13 PM,Children under 5,0,0,4475,5470,9945,0,0,3956,5500,9456
15,Sudan (UNDP),2015,SUD-15/HSD20/S1/N/INGO/1183,12/11/2017 1:02:13 PM,Other,7500,7500,0,0,15000,0,0,0,0,0
15,Sudan (UNDP),2015,SUD-15/HSD20/S1/N/INGO/1183,12/11/2017 1:02:13 PM,Overall,8023,8412,4475,5470,26380,7892,8462,3956,5500,25810
15,Sudan (UNDP),2015,SUD-15/HSD20/S1/N/INGO/1183,12/11/2017 1:02:13 PM,"Trainers, Promoters, Caretakers, committee members, etc.",523,912,0,0,1435,450,880,0,0,1330
15,Sudan (UNDP),2015,SUD-15/HSD20/S1/N/INGO/1199,7/19/2016 1:51:17 PM,Children under 5,0,0,9178,9178,18356,0,0,11784,11707,23491
15,Sudan (UNDP),2015,SUD-15/HSD20/S1/N/INGO/1199,7/19/2016 1:51:17 PM,Overall,569,25467,9178,9178,44392,1607,14929,11784,11707,40027
15,Sudan (UNDP),2015,SUD-15/HSD20/S1/N/INGO/1199,7/19/2016 1:51:17 PM,Pregnant and Lactating Women,0,5211,0,0,5211,0,746,0,0,746
15,Sudan (UNDP),2015,SUD-15/HSD20/S1/N/INGO/1199,7/19/2016 1:51:17 PM,"Staff (own or partner staff, authorities)",19,15,0,0,34,23,11,0,0,34
15,Sudan (UNDP),2015,SUD-15/HSD20/S1/N/INGO/1199,7/19/2016 1:51:17 PM,"Trainers, Promoters, Caretakers, committee members, etc.",50,50,0,0,100,50,50,0,0,100
15,Sudan (UNDP),2015,SUD-15/HSD20/S1/N/INGO/1205,6/6/2016 3:05:25 PM,Children under 5,0,0,1666,1734,3400,0,0,739,979,1718
15,Sudan (UNDP),2015,SUD-15/HSD20/S1/N/INGO/1205,6/6/2016 3:05:25 PM,Internally Displaced People,2551,2551,1666,1734,8502,256,1064,421,643,2384
15,Sudan (UNDP),2015,SUD-15/HSD20/S1/N/INGO/1205,6/6/2016 3:05:25 PM,Overall,2551,2551,1666,1734,8502,472,831,739,979,3021
15,Sudan (UNDP),2015,SUD-15/HSD20/S1/N/INGO/1205,6/6/2016 3:05:25 PM,Pregnant and Lactating Women,0,2551,0,0,2551,0,294,0,0,294
15,Sudan (UNDP),2015,SUD-15/HSD20/S1/N/INGO/1224,6/6/2016 3:06:05 PM,Children under 5,0,0,27122,28230,55352,0,0,35208,38970,74178
15,Sudan (UNDP),2015,SUD-15/HSD20/S1/N/INGO/1224,6/6/2016 3:06:05 PM,Internally Displaced People,58223,59380,20515,21351,159469,40613,76932,24331,26682,168558
15,Sudan (UNDP),2015,SUD-15/HSD20/S1/N/INGO/1224,6/6/2016 3:06:05 PM,Overall,87749,91330,71794,74725,325598,51934,122940,75439,82056,332369
15,Sudan (UNDP),2015,SUD-15/HSD20/S1/N/INGO/1224,6/6/2016 3:06:05 PM,Pregnant and Lactating Women,0,31950,0,0,31950,0,9514,0,0,9514
15,Sudan (UNDP),2015,SUD-15/HSD20/S1/N/INGO/1255,6/6/2016 3:04:59 PM,Children under 5,0,0,4663,4854,9517,0,0,1182,1428,2610
15,Sudan (UNDP),2015,SUD-15/HSD20/S1/N/INGO/1255,6/6/2016 3:04:59 PM,Internally Displaced People/Returnees,12725,13244,2072,2156,30197,28640,35184,552,699,65075
15,Sudan (UNDP),2015,SUD-15/HSD20/S1/N/INGO/1255,6/6/2016 3:04:59 PM,Overall,25776,26826,1693,1691,55986,58450,70369,1128,1428,131375
15,Sudan (UNDP),2015,SUD-15/HSD20/S1/N/INGO/1255,6/6/2016 3:04:59 PM,People in Host Communities,13051,13582,3207,3338,33178,29810,35185,576,729,66300
15,Sudan (UNDP),2015,SUD-15/HSD20/S1/N/INGO/1255,6/6/2016 3:04:59 PM,Pregnant and Lactating Women,0,2799,0,0,2799,0,3252,0,0,3252
15,Sudan (UNDP),2015,SUD-15/HSD20/S1/N/INGO/1257,7/19/2016 1:52:34 PM,Children under 5,0,0,6767,7743,14510,0,0,8795,10087,18882
15,Sudan (UNDP),2015,SUD-15/HSD20/S1/N/INGO/1257,7/19/2016 1:52:34 PM,Overall,0,2810,9473,10793,23076,0,2147,10664,12855,25666
15,Sudan (UNDP),2015,SUD-15/HSD20/S1/N/INGO/1257,7/19/2016 1:52:34 PM,People in Host Communities,0,702,2706,3050,6458,0,582,1869,2768,5219
15,Sudan (UNDP),2015,SUD-15/HSD20/S1/N/INGO/1257,7/19/2016 1:52:34 PM,Pregnant and Lactating Women,0,2108,0,0,2108,0,2147,0,0,2147
15,Sudan (UNDP),2015,SUD-15/HSD20/S1/N/INGO/1278,6/6/2016 3:07:25 PM,Children under 5,0,0,1320,1266,2586,0,0,1300,1358,2658
15,Sudan (UNDP),2015,SUD-15/HSD20/S1/N/INGO/1278,6/6/2016 3:07:25 PM,Internally Displaced People,0,1410,3078,2960,7448,0,1187,3034,3170,7391
15,Sudan (UNDP),2015,SUD-15/HSD20/S1/N/INGO/1278,6/6/2016 3:07:25 PM,Overall,0,2014,4398,4226,10638,0,1696,4334,4528,10558
15,Sudan (UNDP),2015,SUD-15/HSD20/S1/N/INGO/1278,6/6/2016 3:07:25 PM,Pregnant and Lactating Women,0,604,0,0,604,0,509,0,0,509
15,Sudan (UNDP),2015,SUD-15/HSD20/S1/N/INGO/1296,6/12/2016 9:34:38 AM,Children under 5,0,0,3128,3823,6951,0,0,3128,3823,6951
15,Sudan (UNDP),2015,SUD-15/HSD20/S1/N/INGO/1296,6/12/2016 9:34:38 AM,Internally Displaced People,1017,1243,339,414,3013,1017,1243,339,414,3013
15,Sudan (UNDP),2015,SUD-15/HSD20/S1/N/INGO/1296,6/12/2016 9:34:38 AM,Overall,12041,14717,3597,4396,34751,1886,5286,4096,5005,16273
15,Sudan (UNDP),2015,SUD-15/HSD20/S1/N/INGO/1296,6/12/2016 9:34:38 AM,Pregnant and Lactating Women,0,1738,0,0,1738,0,1738,0,0,1738
15,Sudan (UNDP),2015,SUD-15/HSD20/S1/N/INGO/1296,6/12/2016 9:34:38 AM,Returnees,1886,2305,629,768,5588,1886,2305,629,768,5588
15,Sudan (UNDP),2015,SUD-15/HSD20/S1/N/NGO/1193,7/19/2016 1:52:01 PM,Children under 5,0,0,2705,2708,5413,0,0,2507,3009,5516
15,Sudan (UNDP),2015,SUD-15/HSD20/S1/N/NGO/1193,7/19/2016 1:52:01 PM,Other,1689,2083,0,0,3772,2340,4824,0,0,7164
15,Sudan (UNDP),2015,SUD-15/HSD20/S1/N/NGO/1193,7/19/2016 1:52:01 PM,Overall,1715,2151,2705,2708,9279,2366,4892,2505,3009,12772
15,Sudan (UNDP),2015,SUD-15/HSD20/S1/N/NGO/1193,7/19/2016 1:52:01 PM,"Staff (own or partner staff, authorities)",6,28,0,0,34,6,28,0,0,34
15,Sudan (UNDP),2015,SUD-15/HSD20/S1/N/NGO/1193,7/19/2016 1:52:01 PM,"Trainers, Promoters, Caretakers, committee members, etc.",20,40,0,0,60,20,40,0,0,60
15,Sudan (UNDP),2015,SUD-15/HSD20/S1/N/NGO/1230,7/19/2016 1:53:02 PM,Children under 5,0,0,7000,7000,14000,0,0,4142,4073,8215
15,Sudan (UNDP),2015,SUD-15/HSD20/S1/N/NGO/1230,7/19/2016 1:53:02 PM,Overall,650,8410,7210,7210,23480,0,0,0,0,0
15,Sudan (UNDP),2015,SUD-15/HSD20/S1/N/NGO/1230,7/19/2016 1:53:02 PM,Pastoralists,650,210,210,210,1280,710,210,210,210,1340
15,Sudan (UNDP),2015,SUD-15/HSD20/S1/N/NGO/1230,7/19/2016 1:53:02 PM,Pregnant and Lactating Women,0,8200,0,0,8200,0,5304,0,0,5304
15,Sudan (UNDP),2015,SUD-15/HSD20/S1/N/NGO/1230,7/19/2016 1:53:02 PM,"Trainers, Promoters, Caretakers, committee members, etc.",0,0,0,0,0,4,2,0,0,6
15,Sudan (UNDP),2015,SUD-15/HSD20/S1/P/INGO/1162,6/15/2016 11:22:03 AM,Aid Agencies,50,50,0,0,100,30,20,0,0,50
15,Sudan (UNDP),2015,SUD-15/HSD20/S1/P/INGO/1162,6/15/2016 11:22:03 AM,Internally Displaced People/Returnees,4114,7046,1070,1070,13300,3564,6093,920,920,11497
15,Sudan (UNDP),2015,SUD-15/HSD20/S1/P/INGO/1162,6/15/2016 11:22:03 AM,Overall,4179,7126,1070,1070,13445,3960,6770,1022,1022,12774
15,Sudan (UNDP),2015,SUD-15/HSD20/S1/P/INGO/1162,6/15/2016 11:22:03 AM,People in Host Communities,432,723,112,112,1379,396,677,102,102,1277
15,Sudan (UNDP),2015,SUD-15/HSD20/S1/P/INGO/1162,6/15/2016 11:22:03 AM,"Trainers, Promoters, Caretakers, committee members, etc.",15,30,0,0,45,71,51,0,0,122
15,Sudan (UNDP),2015,SUD-15/HSD20/S1/P/INGO/1164,6/20/2016 11:32:04 AM,Host Communities,720,1440,720,720,3600,1244,3819,980,863,6906
15,Sudan (UNDP),2015,SUD-15/HSD20/S1/P/INGO/1164,6/20/2016 11:32:04 AM,Overall,720,1440,720,720,3600,1244,3819,980,863,6906
15,Sudan (UNDP),2015,SUD-15/HSD20/S1/P/INGO/1164,6/20/2016 11:32:04 AM,"Staff (own or partner staff, authorities)",0,0,0,0,0,20,27,0,0,47
15,Sudan (UNDP),2015,SUD-15/HSD20/S1/P/INGO/1164,6/20/2016 11:32:04 AM,"Trainers, Promoters, Caretakers, committee members, etc.",0,0,0,0,0,0,31,0,0,31
15,Sudan (UNDP),2015,SUD-15/HSD20/S1/P/INGO/1295,6/15/2016 12:25:57 PM,Children under 18,0,0,3400,4100,7500,0,0,2050,1700,3750
15,Sudan (UNDP),2015,SUD-15/HSD20/S1/P/INGO/1295,6/15/2016 12:25:57 PM,Committees,120,120,0,0,240,120,120,0,0,240
15,Sudan (UNDP),2015,SUD-15/HSD20/S1/P/INGO/1295,6/15/2016 12:25:57 PM,Internally Displaced People,6400,9420,0,0,15820,6400,9420,0,0,15820
15,Sudan (UNDP),2015,SUD-15/HSD20/S1/P/INGO/1295,6/15/2016 12:25:57 PM,Overall,6520,9540,3400,4100,23560,0,0,0,0,0
15,Sudan (UNDP),2015,SUD-15/HSD20/S1/P/NGO/1152,7/4/2016 1:03:08 PM,Internally Displaced People,15450,10150,0,0,25600,10488,15688,0,0,26176
15,Sudan (UNDP),2015,SUD-15/HSD20/S1/P/NGO/1152,7/4/2016 1:03:08 PM,Overall,15590,10290,0,0,25880,10722,15805,0,0,26527
15,Sudan (UNDP),2015,SUD-15/HSD20/S1/P/NGO/1152,7/4/2016 1:03:08 PM,"Staff (own or partner staff, authorities)",140,140,0,0,280,234,117,0,0,351
15,Sudan (UNDP),2015,SUD-15/HSD20/S1/P/NGO/1173,6/16/2016 9:20:44 AM,Internally Displaced People,510,690,4800,4930,10930,606,993,4356,4801,10756
15,Sudan (UNDP),2015,SUD-15/HSD20/S1/P/NGO/1173,6/16/2016 9:20:44 AM,Internally Displaced People/Returnees,350,390,1350,1450,3540,533,547,1376,2219,4675
15,Sudan (UNDP),2015,SUD-15/HSD20/S1/P/NGO/1173,6/16/2016 9:20:44 AM,Overall,940,1210,6830,7810,16790,814,1088,5065,6009,12976
15,Sudan (UNDP),2015,SUD-15/HSD20/S1/P/NGO/1173,6/16/2016 9:20:44 AM,Pastoralists,80,130,550,810,1570,48,130,353,491,1022
15,Sudan (UNDP),2015,SUD-15/HSD20/S1/P/NGO/1173,6/16/2016 9:20:44 AM,Women of Child-Bearing Age,0,0,0,750,750,0,0,812,0,812
15,Sudan (UNDP),2015,SUD-15/HSD20/S1/P/NGO/1174,6/20/2016 11:29:27 AM,Host Communities,440,1560,0,0,2000,440,1560,420,520,2940
15,Sudan (UNDP),2015,SUD-15/HSD20/S1/P/NGO/1174,6/20/2016 11:29:27 AM,Internally Displaced People,3900,5400,400,400,10100,3900,5400,580,600,10480
15,Sudan (UNDP),2015,SUD-15/HSD20/S1/P/NGO/1174,6/20/2016 11:29:27 AM,Overall,5950,7800,650,710,15110,5950,7800,650,710,15110
15,Sudan (UNDP),2015,SUD-15/HSD20/S1/P/NGO/1174,6/20/2016 11:29:27 AM,Returnees,350,650,250,310,1560,350,650,250,440,1690
15,Sudan (UNDP),2015,SUD-15/HSD20/S1/P/NGO/1182,6/26/2016 10:25:56 AM,Internally Displaced People/Returnees,10424,10275,11197,10757,42653,8451,8330,9078,8721,34580
15,Sudan (UNDP),2015,SUD-15/HSD20/S1/P/NGO/1182,6/26/2016 10:25:56 AM,Other,150,50,0,0,200,170,50,0,0,220
15,Sudan (UNDP),2015,SUD-15/HSD20/S1/P/NGO/1182,6/26/2016 10:25:56 AM,Overall,12351,12230,13215,12857,50653,10489,10383,11199,10929,43000
15,Sudan (UNDP),2015,SUD-15/HSD20/S1/P/NGO/1182,6/26/2016 10:25:56 AM,People in Host Communities,1777,1905,2018,2100,7800,1868,2003,2121,2208,8200
15,Sudan (UNDP),2015,SUD-15/HSD20/S1/P/NGO/1187,6/15/2016 12:26:38 PM,Internally Displaced People,1375,1905,480,730,4490,1375,1905,480,730,4490
15,Sudan (UNDP),2015,SUD-15/HSD20/S1/P/NGO/1187,6/15/2016 12:26:38 PM,Overall,1375,1905,480,730,4490,1375,1905,480,730,4490
15,Sudan (UNDP),2015,SUD-15/HSD20/S1/P/NGO/1202,6/16/2016 9:21:17 AM,Children under 18,0,0,0,0,0,0,0,3659,3365,7024
15,Sudan (UNDP),2015,SUD-15/HSD20/S1/P/NGO/1202,6/16/2016 9:21:17 AM,Internally Displaced People,1300,1300,3800,3800,10200,813,814,2927,2693,7247
15,Sudan (UNDP),2015,SUD-15/HSD20/S1/P/NGO/1202,6/16/2016 9:21:17 AM,Overall,1300,1300,3800,3800,10200,1016,1018,3659,3365,9058
15,Sudan (UNDP),2015,SUD-15/HSD20/S1/P/NGO/1212,6/19/2016 6:08:11 AM,Internally Displaced People/Returnees,9900,11907,16726,16710,55243,9920,11917,16720,16715,55272
15,Sudan (UNDP),2015,SUD-15/HSD20/S1/P/NGO/1212,6/19/2016 6:08:11 AM,Overall,9900,11907,16726,16710,55243,9920,11917,16720,16715,55272
15,Sudan (UNDP),2015,SUD-15/HSD20/S1/P/NGO/1213,6/19/2016 6:07:42 AM,Internally Displaced People/Returnees,15340,10227,11505,26847,63919,7998,15636,23994,32352,79980
15,Sudan (UNDP),2015,SUD-15/HSD20/S1/P/NGO/1213,6/19/2016 6:07:42 AM,Overall,15340,10227,11505,26847,63919,7998,15636,23994,32352,79980
15,Sudan (UNDP),2015,SUD-15/HSD20/S1/P/NGO/1242,6/16/2016 9:20:10 AM,Committees,30,30,0,0,60,27,27,3,3,60
15,Sudan (UNDP),2015,SUD-15/HSD20/S1/P/NGO/1242,6/16/2016 9:20:10 AM,Internally Displaced People,1110,1566,876,948,4500,1110,1566,876,948,4500
15,Sudan (UNDP),2015,SUD-15/HSD20/S1/P/NGO/1242,6/16/2016 9:20:10 AM,Overall,1140,1596,876,948,4560,1325,2004,626,921,4876
15,Sudan (UNDP),2015,SUD-15/HSD20/S1/P/NGO/1247,10/5/2016 9:58:10 AM,Children under 18,0,0,3085,4715,7800,0,0,3628,4098,7726
15,Sudan (UNDP),2015,SUD-15/HSD20/S1/P/NGO/1247,10/5/2016 9:58:10 AM,Internally Displaced People,1800,2897,0,0,4697,2200,3009,2500,3200,10909
15,Sudan (UNDP),2015,SUD-15/HSD20/S1/P/NGO/1247,10/5/2016 9:58:10 AM,Overall,2317,3607,3085,4715,13724,3513,4131,3628,4098,15370
15,Sudan (UNDP),2015,SUD-15/HSD20/S1/P/NGO/1262,2/19/2017 11:17:43 AM,Internally Displaced People,225,5000,150,200,5575,425,5325,155,200,6105
15,Sudan (UNDP),2015,SUD-15/HSD20/S1/P/NGO/1262,2/19/2017 11:17:43 AM,Internally Displaced People/Returnees,200,1000,130,150,1480,200,1000,200,200,1600
15,Sudan (UNDP),2015,SUD-15/HSD20/S1/P/NGO/1262,2/19/2017 11:17:43 AM,Overall,525,6325,300,400,7550,600,7000,350,450,8400
15,Sudan (UNDP),2015,SUD-15/HSD20/S1/P/NGO/1262,2/19/2017 11:17:43 AM,People in Host Communities,100,325,20,50,495,175,400,20,100,695
15,Sudan (UNDP),2015,SUD-15/HSD20/S1/RMS/INGO/1123,5/26/2016 12:59:48 PM,Other,2900,6600,3200,3400,16100,2900,6600,3200,3400,16100
15,Sudan (UNDP),2015,SUD-15/HSD20/S1/RMS/INGO/1123,5/26/2016 12:59:48 PM,Overall,5000,8950,5760,6000,25710,5000,8950,5760,6000,25710
15,Sudan (UNDP),2015,SUD-15/HSD20/S1/RMS/INGO/1123,5/26/2016 12:59:48 PM,People in Host Communities,2100,2350,2560,2600,9610,2100,2350,2560,2600,9610
15,Sudan (UNDP),2015,SUD-15/HSD20/S1/RMS/INGO/1146,1/8/2017 8:35:11 AM,Children under 18,0,0,507,510,1017,0,0,461,486,947
15,Sudan (UNDP),2015,SUD-15/HSD20/S1/RMS/INGO/1146,1/8/2017 8:35:11 AM,Children under 5,0,0,241,294,535,0,0,248,421,669
15,Sudan (UNDP),2015,SUD-15/HSD20/S1/RMS/INGO/1146,1/8/2017 8:35:11 AM,Overall,438,545,748,804,2535,310,743,615,775,2443
15,Sudan (UNDP),2015,SUD-15/HSD20/S1/RMS/INGO/1146,1/8/2017 8:35:11 AM,"Trainers, Promoters, Caretakers, committee members, etc.",438,545,0,0,983,340,603,0,0,943
15,Sudan (UNDP),2015,SUD-15/HSD20/S1/RMS/INGO/1229,6/16/2016 11:20:05 AM,Children under 18,0,0,2096,2175,4271,0,0,600,600,1200
15,Sudan (UNDP),2015,SUD-15/HSD20/S1/RMS/INGO/1229,6/16/2016 11:20:05 AM,Committees,90,80,0,0,170,60,40,0,0,100
15,Sudan (UNDP),2015,SUD-15/HSD20/S1/RMS/INGO/1229,6/16/2016 11:20:05 AM,Other,1032,1963,0,0,2995,770,936,570,574,2850
15,Sudan (UNDP),2015,SUD-15/HSD20/S1/RMS/INGO/1229,6/16/2016 11:20:05 AM,Overall,1032,1963,2096,2175,7266,830,976,1170,1174,4150
15,Sudan (UNDP),2015,SUD-15/HSD20/S1/RMS/INGO/1229,6/16/2016 11:20:05 AM,Pastoralists,300,500,900,900,2600,0,0,0,0,0
15,Sudan (UNDP),2015,SUD-15/HSD20/S1/RMS/INGO/1232,6/16/2016 11:20:25 AM,Children under 18,0,0,2267,2834,5101,0,0,4628,4846,9474
15,Sudan (UNDP),2015,SUD-15/HSD20/S1/RMS/INGO/1232,6/16/2016 11:20:25 AM,Children under 5,0,0,1600,1318,2918,0,0,1290,1342,2632
15,Sudan (UNDP),2015,SUD-15/HSD20/S1/RMS/INGO/1232,6/16/2016 11:20:25 AM,Overall,5502,5669,2667,2834,16672,3741,5391,4628,4846,18606
15,Sudan (UNDP),2015,SUD-15/HSD20/S1/RMS/INGO/1232,6/16/2016 11:20:25 AM,Pregnant and Lactating Women,0,491,0,0,491,0,491,0,0,491
15,Sudan (UNDP),2015,SUD-15/HSD20/S1/RMS/NGO/1130,8/30/2016 5:54:59 AM,Other,700,900,600,900,3100,700,900,600,900,3100
15,Sudan (UNDP),2015,SUD-15/HSD20/S1/RMS/NGO/1130,8/30/2016 5:54:59 AM,Overall,1000,1500,800,1200,4500,900,1600,800,1200,4500
15,Sudan (UNDP),2015,SUD-15/HSD20/S1/RMS/NGO/1130,8/30/2016 5:54:59 AM,People in Host Communities,300,600,200,300,1400,280,620,200,300,1400
15,Sudan (UNDP),2015,SUD-15/HSD20/S1/RMS/NGO/1184,5/19/2016 8:23:28 AM,Other,7420,8556,5304,5202,26482,5311,7039,6332,7124,25806
15,Sudan (UNDP),2015,SUD-15/HSD20/S1/RMS/NGO/1184,5/19/2016 8:23:28 AM,Overall,8676,11156,6044,7827,33703,7348,14724,5871,8396,36339
15,Sudan (UNDP),2015,SUD-15/HSD20/S1/RMS/NGO/1184,5/19/2016 8:23:28 AM,People in Host Communities,1256,2600,740,2625,7221,2301,3782,1287,3567,10937
15,Sudan (UNDP),2015,SUD-15/HSD20/S1/RMS/NGO/1267,8/28/2016 2:43:49 PM,Children under 5,0,0,1200,1200,2400,0,0,4356,4010,8366
15,Sudan (UNDP),2015,SUD-15/HSD20/S1/RMS/NGO/1267,8/28/2016 2:43:49 PM,Other,1470,2650,0,0,4120,1545,4595,0,0,6140
15,Sudan (UNDP),2015,SUD-15/HSD20/S1/RMS/NGO/1267,8/28/2016 2:43:49 PM,Overall,1470,2686,1200,1200,6556,1547,4629,4356,4010,14542
15,Sudan (UNDP),2015,SUD-15/HSD20/S1/RMS/NGO/1267,8/28/2016 2:43:49 PM,"Staff (own or partner staff, authorities)",0,36,0,0,36,2,34,0,0,36
15,Sudan (UNDP),2015,SUD-15/HSD20/S1/RMS/UN/1281,5/16/2016 12:33:36 PM,Overall,1070,1910,1025,1025,5030,2397,4338,2293,2387,11415
15,Sudan (UNDP),2015,SUD-15/HSD20/S1/RMS/UN/1281,5/16/2016 12:33:36 PM,People in Host Communities,760,420,410,410,2000,882,1596,844,878,4200
15,Sudan (UNDP),2015,SUD-15/HSD20/S1/WASH/INGO/1128,6/27/2016 6:50:40 AM,Internally Displaced People,11812,13388,13650,13650,52500,11576,13120,13152,13152,51000
15,Sudan (UNDP),2015,SUD-15/HSD20/S1/WASH/INGO/1128,6/27/2016 6:50:40 AM,Internally Displaced People/Returnees,3375,3825,3900,3900,15000,2812,3187,3250,3251,12500
15,Sudan (UNDP),2015,SUD-15/HSD20/S1/WASH/INGO/1128,6/27/2016 6:50:40 AM,Overall,16775,18625,19800,19800,75000,15399,17098,18176,18177,68850
15,Sudan (UNDP),2015,SUD-15/HSD20/S1/WASH/INGO/1128,6/27/2016 6:50:40 AM,People in Host Communities,1688,1912,1950,1950,7500,1204,1364,1391,1391,5350
15,Sudan (UNDP),2015,SUD-15/HSD20/S1/WASH/INGO/1141,6/6/2016 3:16:48 PM,Children under 18,0,0,1500,2400,3900,0,0,150,150,300
15,Sudan (UNDP),2015,SUD-15/HSD20/S1/WASH/INGO/1141,6/6/2016 3:16:48 PM,Committees,60,60,0,0,120,60,60,0,0,120
15,Sudan (UNDP),2015,SUD-15/HSD20/S1/WASH/INGO/1141,6/6/2016 3:16:48 PM,Internally Displaced People,7610,8670,0,0,16280,3800,5400,0,0,9200
15,Sudan (UNDP),2015,SUD-15/HSD20/S1/WASH/INGO/1141,6/6/2016 3:16:48 PM,Overall,8670,10930,2300,3600,25500,4236,5900,400,600,11136
15,Sudan (UNDP),2015,SUD-15/HSD20/S1/WASH/INGO/1141,6/6/2016 3:16:48 PM,People in Host Communities,1000,2200,800,1200,5200,436,500,400,600,1936
15,Sudan (UNDP),2015,SUD-15/HSD20/S1/WASH/INGO/1155,10/4/2016 1:55:28 PM,Internally Displaced People,7140,7854,9639,11067,35700,7650,8415,10327,11858,38250
15,Sudan (UNDP),2015,SUD-15/HSD20/S1/WASH/INGO/1155,10/4/2016 1:55:28 PM,Overall,8400,9240,11340,13020,42000,8920,9812,12042,13826,44600
15,Sudan (UNDP),2015,SUD-15/HSD20/S1/WASH/INGO/1155,10/4/2016 1:55:28 PM,People in Host Communities,1260,1386,1701,1953,6300,1270,1397,1715,1968,6350
15,Sudan (UNDP),2015,SUD-15/HSD20/S1/WASH/INGO/1166,2/12/2017 11:27:58 AM,Internally Displaced People,7752,9985,14886,14896,47519,12248,14921,22706,22691,72566
15,Sudan (UNDP),2015,SUD-15/HSD20/S1/WASH/INGO/1166,2/12/2017 11:27:58 AM,Other,103,107,175,190,575,0,0,0,0,0
15,Sudan (UNDP),2015,SUD-15/HSD20/S1/WASH/INGO/1166,2/12/2017 11:27:58 AM,Overall,8501,10763,16117,16158,51539,15870,18676,28840,28766,92152
15,Sudan (UNDP),2015,SUD-15/HSD20/S1/WASH/INGO/1166,2/12/2017 11:27:58 AM,People in Host Communities,647,670,1056,1072,3445,3244,3424,5767,5587,18022
15,Sudan (UNDP),2015,SUD-15/HSD20/S1/WASH/INGO/1166,2/12/2017 11:27:58 AM,Returnees,0,0,0,0,0,184,185,318,284,971
15,Sudan (UNDP),2015,SUD-15/HSD20/S1/WASH/INGO/1180,10/5/2016 9:23:19 AM,Other,918,1375,1273,2165,5731,1361,3602,1282,1004,7249
15,Sudan (UNDP),2015,SUD-15/HSD20/S1/WASH/INGO/1180,10/5/2016 9:23:19 AM,Overall,23895,33175,23002,34565,114637,24268,34401,22485,34533,115687
15,Sudan (UNDP),2015,SUD-15/HSD20/S1/WASH/INGO/1185,7/10/2016 9:23:28 AM,Committees,90,90,0,0,180,90,90,0,0,180
15,Sudan (UNDP),2015,SUD-15/HSD20/S1/WASH/INGO/1185,7/10/2016 9:23:28 AM,Internally Displaced People,8845,9200,13260,13805,45110,8845,9200,13260,13805,45110
15,Sudan (UNDP),2015,SUD-15/HSD20/S1/WASH/INGO/1185,7/10/2016 9:23:28 AM,Overall,8845,9200,13260,13805,45110,8845,9200,13260,13805,45110
15,Sudan (UNDP),2015,SUD-15/HSD20/S1/WASH/INGO/1228,7/11/2016 6:40:41 AM,Internally Displaced People/Returnees,3268,3548,1214,1307,9337,3268,3548,1214,1307,9337
15,Sudan (UNDP),2015,SUD-15/HSD20/S1/WASH/INGO/1228,7/11/2016 6:40:41 AM,Overall,3268,3548,1214,1307,9337,3268,3548,1214,1307,9337
15,Sudan (UNDP),2015,SUD-15/HSD20/S1/WASH/INGO/1279,5/9/2016 8:24:06 AM,Internally Displaced People,106590,110940,71050,73950,362530,106590,110940,71050,73950,362530
15,Sudan (UNDP),2015,SUD-15/HSD20/S1/WASH/INGO/1279,5/9/2016 8:24:06 AM,Overall,28883,30061,5916,6157,71017,23106,24048,4732,4925,56811
15,Sudan (UNDP),2015,SUD-15/HSD20/S1/WASH/NGO/1145,5/16/2016 12:32:46 PM,Overall,6106,7211,3632,3229,20178,6106,7211,3632,3229,20178
15,Sudan (UNDP),2015,SUD-15/HSD20/S1/WASH/NGO/1145,5/16/2016 12:32:46 PM,People in Host Communities,6106,7211,3632,3229,20178,6106,7211,3632,3229,20178
15,Sudan (UNDP),2015,SUD-15/HSD20/S1/WASH/NGO/1256,2/12/2017 11:42:10 AM,Internally Displaced People,15101,10125,4012,2644,31882,15101,10125,4012,2644,31882
15,Sudan (UNDP),2015,SUD-15/HSD20/S1/WASH/NGO/1256,2/12/2017 11:42:10 AM,Overall,15101,10125,4012,2644,31882,15101,10125,4012,2644,31882
15,Sudan (UNDP),2015,SUD-15/HSD20/S1/WASH/UN/1195,6/6/2016 3:06:20 PM,Children under 18,0,0,188206,248687,436893,0,0,68360,106744,175104
15,Sudan (UNDP),2015,SUD-15/HSD20/S1/WASH/UN/1195,6/6/2016 3:06:20 PM,Children under 5,0,0,197569,251511,449080,0,0,36786,59187,95973
15,Sudan (UNDP),2015,SUD-15/HSD20/S1/WASH/UN/1195,6/6/2016 3:06:20 PM,Internally Displaced People,467446,615766,181885,239206,1504303,159345,239198,61157,89765,549465
15,Sudan (UNDP),2015,SUD-15/HSD20/S1/WASH/UN/1195,6/6/2016 3:06:20 PM,Overall,173442,260158,67443,101171,602214,174800,253930,68360,106744,603834
15,Sudan (UNDP),2015,SUD-15/HSD20/S1/WASH/UN/1195,6/6/2016 3:06:20 PM,Women of Child-Bearing Age,0,58941,0,0,58941,0,43765,0,0,43765
15,Sudan (UNDP),2015,SUD-15/HSD20/S2/CCS/UN/1414,2/13/2017 2:14:56 PM,Overall,15150,18131,20851,20868,75000,42093,50375,57933,57980,208381
15,Sudan (UNDP),2015,SUD-15/HSD20/S2/E/INGO/1512,4/24/2017 5:58:17 AM,Children under 18,0,0,4000,4000,8000,0,0,9675,8312,17987
15,Sudan (UNDP),2015,SUD-15/HSD20/S2/E/INGO/1512,4/24/2017 5:58:17 AM,Internally Displaced People,450,450,0,0,900,1243,3507,0,0,4750
15,Sudan (UNDP),2015,SUD-15/HSD20/S2/E/INGO/1512,4/24/2017 5:58:17 AM,Overall,450,450,4000,4000,8900,543,601,9675,8312,19131
15,Sudan (UNDP),2015,SUD-15/HSD20/S2/E/NGO/1418,4/24/2017 6:00:17 AM,Children under 18,0,0,1475,1403,2878,0,0,1662,1725,3387
15,Sudan (UNDP),2015,SUD-15/HSD20/S2/E/NGO/1418,4/24/2017 6:00:17 AM,Internally Displaced People,256,275,1475,1403,3409,22,28,0,0,50
15,Sudan (UNDP),2015,SUD-15/HSD20/S2/E/NGO/1418,4/24/2017 6:00:17 AM,Overall,256,275,1475,1403,3409,22,28,1662,1725,3437
15,Sudan (UNDP),2015,SUD-15/HSD20/S2/E/NGO/1494,10/18/2017 8:48:09 AM,Children under 18,0,0,1300,1400,2700,0,0,1360,1340,2700
15,Sudan (UNDP),2015,SUD-15/HSD20/S2/E/NGO/1494,10/18/2017 8:48:09 AM,Internally Displaced People,90,60,0,0,150,90,62,0,0,152
15,Sudan (UNDP),2015,SUD-15/HSD20/S2/E/NGO/1494,10/18/2017 8:48:09 AM,Overall,90,60,1400,1600,3150,92,60,1350,1650,3152
15,Sudan (UNDP),2015,SUD-15/HSD20/S2/E-P/NGO/1466,4/24/2017 5:59:29 AM,Children under 18,0,0,2620,2770,5390,0,0,1311,2230,3541
15,Sudan (UNDP),2015,SUD-15/HSD20/S2/E-P/NGO/1466,4/24/2017 5:59:29 AM,Internally Displaced People,85,65,2620,2770,5540,85,65,1311,2230,3691
15,Sudan (UNDP),2015,SUD-15/HSD20/S2/E-P/NGO/1466,4/24/2017 5:59:29 AM,Overall,85,65,2620,2770,5540,85,65,1311,2230,3691
15,Sudan (UNDP),2015,SUD-15/HSD20/S2/ESNFIs/INGO/1433,6/6/2017 8:39:33 AM,Internally Displaced People,335,404,634,627,2000,451,543,853,843,2690
15,Sudan (UNDP),2015,SUD-15/HSD20/S2/ESNFIs/INGO/1433,6/6/2017 8:39:33 AM,Overall,1176,1905,2681,2813,8575,1467,1905,2903,2915,9190
15,Sudan (UNDP),2015,SUD-15/HSD20/S2/ESNFIs/INGO/1433,6/6/2017 8:39:33 AM,Returnees,841,1501,2047,2186,6575,831,1484,2024,2161,6500
15,Sudan (UNDP),2015,SUD-15/HSD20/S2/ESNFIs/INGO/1458,2/5/2017 1:59:35 PM,Internally Displaced People,10000,15000,12500,12500,50000,10066,15100,12583,12583,50332
15,Sudan (UNDP),2015,SUD-15/HSD20/S2/ESNFIs/INGO/1458,2/5/2017 1:59:35 PM,Overall,1000,15000,12500,12500,41000,10066,15100,12583,12582,50331
15,Sudan (UNDP),2015,SUD-15/HSD20/S2/ESNFIs/INGO/1474,2/16/2017 10:25:02 AM,Internally Displaced People,143,214,387,394,1138,144,213,386,395,1138
15,Sudan (UNDP),2015,SUD-15/HSD20/S2/ESNFIs/INGO/1474,2/16/2017 10:25:02 AM,Internally Displaced People/Returnees,84,86,70,77,317,83,87,68,79,317
15,Sudan (UNDP),2015,SUD-15/HSD20/S2/ESNFIs/INGO/1474,2/16/2017 10:25:02 AM,Overall,377,495,624,624,2120,376,495,623,626,2120
15,Sudan (UNDP),2015,SUD-15/HSD20/S2/ESNFIs/INGO/1474,2/16/2017 10:25:02 AM,People in Host Communities,125,170,167,153,615,123,172,168,152,615
15,Sudan (UNDP),2015,SUD-15/HSD20/S2/ESNFIs/INGO/1474,2/16/2017 10:25:02 AM,"Staff (own or partner staff, authorities)",25,25,0,0,50,25,26,0,0,51
15,Sudan (UNDP),2015,SUD-15/HSD20/S2/ESNFIs/NGO/1403,2/19/2017 10:54:36 AM,Children under 18,0,0,2475,3300,5775,0,0,2003,2671,4674
15,Sudan (UNDP),2015,SUD-15/HSD20/S2/ESNFIs/NGO/1403,2/19/2017 10:54:36 AM,Internally Displaced People,3300,7425,0,0,10725,2671,6010,0,0,8681
15,Sudan (UNDP),2015,SUD-15/HSD20/S2/ESNFIs/NGO/1403,2/19/2017 10:54:36 AM,Overall,3300,7425,2475,3300,16500,2671,6010,2003,2671,13355
15,Sudan (UNDP),2015,SUD-15/HSD20/S2/ESNFIs/NGO/1410,2/13/2017 11:01:41 AM,Internally Displaced People,731,5579,1190,1785,9285,378,3658,565,959,5560
15,Sudan (UNDP),2015,SUD-15/HSD20/S2/ESNFIs/NGO/1410,2/13/2017 11:01:41 AM,Internally Displaced People/Returnees,208,1594,340,510,2652,208,739,195,439,1581
15,Sudan (UNDP),2015,SUD-15/HSD20/S2/ESNFIs/NGO/1410,2/13/2017 11:01:41 AM,Overall,1063,7970,1701,2550,13284,658,4812,850,1530,7850
15,Sudan (UNDP),2015,SUD-15/HSD20/S2/ESNFIs/NGO/1410,2/13/2017 11:01:41 AM,People in Host Communities,104,767,171,255,1297,104,385,90,132,711
15,Sudan (UNDP),2015,SUD-15/HSD20/S2/ESNFIs/NGO/1410,2/13/2017 11:01:41 AM,"Staff (own or partner staff, authorities)",20,30,0,0,50,20,30,0,0,50
15,Sudan (UNDP),2015,SUD-15/HSD20/S2/ESNFIs/NGO/1432,2/5/2017 2:00:47 PM,Internally Displaced People/Returnees,2380,3350,2000,2700,10430,2380,3350,2000,2700,10430
15,Sudan (UNDP),2015,SUD-15/HSD20/S2/ESNFIs/NGO/1432,2/5/2017 2:00:47 PM,Overall,2380,3350,2000,2700,10430,2380,3350,2000,2700,10430
15,Sudan (UNDP),2015,SUD-15/HSD20/S2/ESNFIs/NGO/1471,2/5/2017 1:54:22 PM,Internally Displaced People/Returnees,3672,7584,4420,5184,20860,4251,5462,6542,4532,20787
15,Sudan (UNDP),2015,SUD-15/HSD20/S2/ESNFIs/NGO/1471,2/5/2017 1:54:22 PM,Overall,3672,7584,4420,5184,20860,4251,5462,6542,4532,20787
15,Sudan (UNDP),2015,SUD-15/HSD20/S2/FSL/UN/1462,2/7/2017 7:01:44 AM,Internally Displaced People,14138,14716,6183,6183,41220,14250,15990,6480,6480,43200
15,Sudan (UNDP),2015,SUD-15/HSD20/S2/FSL/UN/1462,2/7/2017 7:01:44 AM,Overall,41777,43483,18270,18270,121800,44600,49630,20680,20270,135180
15,Sudan (UNDP),2015,SUD-15/HSD20/S2/FSL/UN/1462,2/7/2017 7:01:44 AM,People in Host Communities,27639,28767,12087,12087,80580,30350,33640,14200,13790,91980
15,Sudan (UNDP),2015,SUD-15/HSD20/S2/H/INGO/1416,2/16/2017 7:02:16 AM,Children under 18,0,0,9820,7857,17677,0,0,11376,10011,21387
15,Sudan (UNDP),2015,SUD-15/HSD20/S2/H/INGO/1416,2/16/2017 7:02:16 AM,Internally Displaced People,6285,3830,0,0,10115,8217,6432,0,0,14649
15,Sudan (UNDP),2015,SUD-15/HSD20/S2/H/INGO/1416,2/16/2017 7:02:16 AM,Overall,6285,15320,9820,7857,39282,8217,23305,11376,10011,52909
15,Sudan (UNDP),2015,SUD-15/HSD20/S2/H/INGO/1416,2/16/2017 7:02:16 AM,Women of Child-Bearing Age,0,11490,0,0,11490,0,16873,0,0,16873
15,Sudan (UNDP),2015,SUD-15/HSD20/S2/H/INGO/1455,1/22/2018 7:37:14 AM,Internally Displaced People/Returnees,4578,4888,3284,4927,17677,2750,3630,2800,3020,12200
15,Sudan (UNDP),2015,SUD-15/HSD20/S2/H/INGO/1455,1/22/2018 7:37:14 AM,Overall,8698,11481,5845,8768,34792,6550,7830,6206,7520,28106
15,Sudan (UNDP),2015,SUD-15/HSD20/S2/H/INGO/1455,1/22/2018 7:37:14 AM,Pastoralists,2010,4216,1351,2026,9603,1900,2100,1506,2200,7706
15,Sudan (UNDP),2015,SUD-15/HSD20/S2/H/INGO/1455,1/22/2018 7:37:14 AM,People in Host Communities,2101,2377,1210,1815,7503,1900,2100,1900,2300,8200
15,Sudan (UNDP),2015,SUD-15/HSD20/S2/H/NGO/1460,10/22/2017 11:49:49 AM,Children under 5,0,0,7290,7898,15188,0,0,7319,8011,15330
15,Sudan (UNDP),2015,SUD-15/HSD20/S2/H/NGO/1460,10/22/2017 11:49:49 AM,Internally Displaced People,461,540,499,500,2000,8412,9712,6345,5766,30235
15,Sudan (UNDP),2015,SUD-15/HSD20/S2/H/NGO/1460,10/22/2017 11:49:49 AM,Overall,21015,24161,21872,22302,89350,14378,19194,17844,17312,68728
15,Sudan (UNDP),2015,SUD-15/HSD20/S2/H/UN/1401,7/17/2016 6:10:18 AM,Internally Displaced People,0,0,123454,128493,251947,0,0,123704,128753,252457
15,Sudan (UNDP),2015,SUD-15/HSD20/S2/H/UN/1401,7/17/2016 6:10:18 AM,Overall,0,0,2374681,2471606,4846287,0,0,2378922,2476021,4854943
15,Sudan (UNDP),2015,SUD-15/HSD20/S2/H/UN/1401,7/17/2016 6:10:18 AM,Pastoralists,0,0,166228,173012,339240,0,0,166525,173321,339846
15,Sudan (UNDP),2015,SUD-15/HSD20/S2/H/UN/1437,10/3/2016 12:26:16 PM,Agro-Pastoralists,0,0,149959,156079,306038,0,0,149525,157213,306738
15,Sudan (UNDP),2015,SUD-15/HSD20/S2/H/UN/1437,10/3/2016 12:26:16 PM,Internally Displaced People,0,0,123454,128493,251947,0,0,124318,128967,253285
15,Sudan (UNDP),2015,SUD-15/HSD20/S2/H/UN/1437,10/3/2016 12:26:16 PM,Overall,0,0,2374681,2471606,4846287,0,0,2378922,2476021,4854943
15,Sudan (UNDP),2015,SUD-15/HSD20/S2/H/UN/1443,5/2/2017 7:39:31 AM,Children under 5,0,0,11129,10693,21822,0,0,11465,10478,21943
15,Sudan (UNDP),2015,SUD-15/HSD20/S2/H/UN/1443,5/2/2017 7:39:31 AM,Internally Displaced People/Returnees,29096,33946,30309,27884,121235,18467,11567,25769,13313,69116
15,Sudan (UNDP),2015,SUD-15/HSD20/S2/H/UN/1443,5/2/2017 7:39:31 AM,Overall,29096,33946,30309,27884,121235,29125,33896,30267,27749,121037
15,Sudan (UNDP),2015,SUD-15/HSD20/S2/H/UN/1443,5/2/2017 7:39:31 AM,Women of Child-Bearing Age,0,30308,0,0,30308,0,29978,0,0,29978
15,Sudan (UNDP),2015,SUD-15/HSD20/S2/H/UN/1461,2/19/2017 10:32:04 AM,Internally Displaced People,14000,23753,5569,5782,49104,13900,23600,5650,5750,48900
15,Sudan (UNDP),2015,SUD-15/HSD20/S2/H/UN/1461,2/19/2017 10:32:04 AM,Overall,14000,23753,5569,5782,49104,15430,24005,9270,9508,58213
15,Sudan (UNDP),2015,SUD-15/HSD20/S2/H/UN/1461,2/19/2017 10:32:04 AM,People in Host Communities,37500,37500,37500,37500,150000,50000,55400,22000,22600,150000
15,Sudan (UNDP),2015,SUD-15/HSD20/S2/H/UN/1461,2/19/2017 10:32:04 AM,"Trainers, Promoters, Caretakers, committee members, etc.",40,40,0,0,80,45,45,0,0,90
15,Sudan (UNDP),2015,SUD-15/HSD20/S2/H-P/UN/1412,4/5/2017 8:41:57 AM,Children under 18,0,0,2160,2879,5039,0,0,1260,5050,6310
15,Sudan (UNDP),2015,SUD-15/HSD20/S2/H-P/UN/1412,4/5/2017 8:41:57 AM,Overall,820,11631,2160,2879,17490,700,19970,1260,5050,26980
15,Sudan (UNDP),2015,SUD-15/HSD20/S2/H-P/UN/1412,4/5/2017 8:41:57 AM,"Trainers, Promoters, Caretakers, committee members, etc.",125,220,0,0,345,175,200,0,0,375
15,Sudan (UNDP),2015,SUD-15/HSD20/S2/L/UN/1388,6/26/2016 10:26:13 AM,Overall,840,840,0,0,1680,981,981,0,0,1962
15,Sudan (UNDP),2015,SUD-15/HSD20/S2/N/INGO/1405,2/11/2018 10:04:11 AM,Internally Displaced People,443,2256,2020,3018,7737,440,2550,2024,3023,8037
15,Sudan (UNDP),2015,SUD-15/HSD20/S2/N/INGO/1405,2/11/2018 10:04:11 AM,Overall,1161,4386,4288,5353,15188,1558,4653,4293,5084,15588
15,Sudan (UNDP),2015,SUD-15/HSD20/S2/N/INGO/1405,2/11/2018 10:04:11 AM,"Trainers, Promoters, Caretakers, committee members, etc.",6,14,0,0,20,6,14,0,0,20
15,Sudan (UNDP),2015,SUD-15/HSD20/S2/N/INGO/1423,2/1/2017 5:38:05 PM,Children under 5,0,0,1668,2033,3701,0,0,1568,1738,3306
15,Sudan (UNDP),2015,SUD-15/HSD20/S2/N/INGO/1423,2/1/2017 5:38:05 PM,Overall,0,0,1668,2033,3701,0,0,1568,1738,3306
15,Sudan (UNDP),2015,SUD-15/HSD20/S2/N/INGO/1453,2/16/2017 5:53:41 AM,Internally Displaced People,0,10316,3842,3998,18156,0,10618,13430,11330,35378
15,Sudan (UNDP),2015,SUD-15/HSD20/S2/N/INGO/1453,2/16/2017 5:53:41 AM,Other,0,27246,0,0,27246,0,9207,0,0,9207
15,Sudan (UNDP),2015,SUD-15/HSD20/S2/N/INGO/1453,2/16/2017 5:53:41 AM,Overall,0,41186,5192,5403,51781,4674,21356,19187,16258,61475
15,Sudan (UNDP),2015,SUD-15/HSD20/S2/N/INGO/1453,2/16/2017 5:53:41 AM,People in Host Communities,0,3624,1350,1405,6379,0,6205,5757,4928,16890
15,Sudan (UNDP),2015,SUD-15/HSD20/S2/N/NGO/1481,3/9/2017 6:12:41 AM,Children under 5,0,0,2230,1795,4025,0,0,2138,1402,3540
15,Sudan (UNDP),2015,SUD-15/HSD20/S2/N/NGO/1481,3/9/2017 6:12:41 AM,Other,500,0,0,0,500,906,389,0,0,1295
15,Sudan (UNDP),2015,SUD-15/HSD20/S2/N/NGO/1481,3/9/2017 6:12:41 AM,Overall,950,1780,2230,1795,6755,914,1405,2138,1402,5859
15,Sudan (UNDP),2015,SUD-15/HSD20/S2/N/NGO/1481,3/9/2017 6:12:41 AM,Pregnant and Lactating Women,0,1780,0,0,1780,0,1002,0,0,1002
15,Sudan (UNDP),2015,SUD-15/HSD20/S2/N/NGO/1481,3/9/2017 6:12:41 AM,"Staff (own or partner staff, authorities)",0,0,0,0,0,8,14,0,0,22
15,Sudan (UNDP),2015,SUD-15/HSD20/S2/N/UN/1501,1/8/2017 10:05:07 AM,Children under 5,0,0,2300,2300,4600,0,0,2300,2300,4600
15,Sudan (UNDP),2015,SUD-15/HSD20/S2/N/UN/1501,1/8/2017 10:05:07 AM,Internally Displaced People,104300,104500,26000,26200,261000,0,0,59448,59447,118895
15,Sudan (UNDP),2015,SUD-15/HSD20/S2/N/UN/1501,1/8/2017 10:05:07 AM,Overall,0,0,2300,2300,4600,0,0,2300,2300,4600
15,Sudan (UNDP),2015,SUD-15/HSD20/S2/P/INGO/1502,3/24/2022 9:27:28 AM,Internally Displaced People,4634,7832,1053,1053,14572,0,0,0,0,0
15,Sudan (UNDP),2015,SUD-15/HSD20/S2/P/INGO/1502,3/24/2022 9:27:28 AM,Overall,5184,8746,1170,1170,16270,0,0,0,0,0
15,Sudan (UNDP),2015,SUD-15/HSD20/S2/P/INGO/1502,3/24/2022 9:27:28 AM,"Staff (own or partner staff, authorities)",10,10,0,0,20,0,0,0,0,0
15,Sudan (UNDP),2015,SUD-15/HSD20/S2/P/INGO/1502,3/24/2022 9:27:28 AM,"Trainers, Promoters, Caretakers, committee members, etc.",20,30,0,0,50,0,0,0,0,0
15,Sudan (UNDP),2015,SUD-15/HSD20/S2/P/NGO/1454,2/19/2017 11:19:47 AM,Internally Displaced People,296,681,346,519,1842,362,733,350,436,1881
15,Sudan (UNDP),2015,SUD-15/HSD20/S2/P/NGO/1454,2/19/2017 11:19:47 AM,Overall,328,756,384,576,2044,402,813,311,574,2100
15,Sudan (UNDP),2015,SUD-15/HSD20/S2/P/NGO/1454,2/19/2017 11:19:47 AM,People in Host Communities,32,75,38,57,202,40,80,41,58,219
15,Sudan (UNDP),2015,SUD-15/HSD20/S2/P/UN/1456,11/1/2017 1:51:19 PM,Children under 18,0,0,3400,4100,7500,0,0,5574,4225,9799
15,Sudan (UNDP),2015,SUD-15/HSD20/S2/P/UN/1456,11/1/2017 1:51:19 PM,Committees,120,120,0,0,240,206,108,0,0,314
15,Sudan (UNDP),2015,SUD-15/HSD20/S2/P/UN/1456,11/1/2017 1:51:19 PM,Internally Displaced People,6520,9540,3400,4100,23560,7168,6929,5574,4225,23896
15,Sudan (UNDP),2015,SUD-15/HSD20/S2/P/UN/1456,11/1/2017 1:51:19 PM,Overall,6720,9740,3700,4400,24560,7168,6929,5574,4225,23896
15,Sudan (UNDP),2015,SUD-15/HSD20/S2/P/UN/1456,11/1/2017 1:51:19 PM,People in Host Communities,200,200,300,300,1000,0,0,0,0,0
15,Sudan (UNDP),2015,SUD-15/HSD20/S2/RMS/INGO/1419,5/28/2017 8:47:46 AM,Overall,80,96,137,140,453,100,230,708,614,1652
15,Sudan (UNDP),2015,SUD-15/HSD20/S2/RMS/INGO/1435,3/7/2017 8:58:37 AM,Children under 18,0,0,1000,950,1950,0,0,1054,905,1959
15,Sudan (UNDP),2015,SUD-15/HSD20/S2/RMS/INGO/1435,3/7/2017 8:58:37 AM,Other,30,15,0,0,45,20,25,0,0,45
15,Sudan (UNDP),2015,SUD-15/HSD20/S2/RMS/INGO/1435,3/7/2017 8:58:37 AM,Overall,30,15,1000,950,1995,20,25,1100,905,2050
15,Sudan (UNDP),2015,SUD-15/HSD20/S2/RMS/NGO/1394,2/16/2017 7:03:23 AM,Other,600,800,400,400,2200,610,790,379,421,2200
15,Sudan (UNDP),2015,SUD-15/HSD20/S2/RMS/NGO/1394,2/16/2017 7:03:23 AM,Overall,1000,1200,600,600,3400,750,1450,620,580,3400
15,Sudan (UNDP),2015,SUD-15/HSD20/S2/RMS/NGO/1394,2/16/2017 7:03:23 AM,People in Host Communities,400,400,200,200,1200,360,440,215,185,1200
15,Sudan (UNDP),2015,SUD-15/HSD20/S2/RMS/NGO/1449,2/13/2017 8:50:46 AM,Children under 18,0,0,1836,2754,4590,0,0,5164,5070,10234
15,Sudan (UNDP),2015,SUD-15/HSD20/S2/RMS/NGO/1449,2/13/2017 8:50:46 AM,Internally Displaced People/Returnees,1900,2046,0,0,3946,555,640,0,0,1195
15,Sudan (UNDP),2015,SUD-15/HSD20/S2/RMS/NGO/1449,2/13/2017 8:50:46 AM,Overall,1900,2046,2749,2520,9215,555,640,5164,5070,11429
15,Sudan (UNDP),2015,SUD-15/HSD20/S2/RMS/UN/1413,2/13/2017 8:51:51 AM,Children under 18,0,0,1000,6000,7000,0,0,33,4600,4633
15,Sudan (UNDP),2015,SUD-15/HSD20/S2/RMS/UN/1413,2/13/2017 8:51:51 AM,Other,2000,0,0,0,2000,0,0,0,0,0
15,Sudan (UNDP),2015,SUD-15/HSD20/S2/RMS/UN/1413,2/13/2017 8:51:51 AM,Overall,2000,17100,1000,6000,26100,205,12784,33,4600,17622
15,Sudan (UNDP),2015,SUD-15/HSD20/S2/RMS/UN/1413,2/13/2017 8:51:51 AM,Pregnant and Lactating Women,0,1100,0,0,1100,0,2300,0,0,2300
15,Sudan (UNDP),2015,SUD-15/HSD20/S2/RMS/UN/1413,2/13/2017 8:51:51 AM,Women of Child-Bearing Age,0,16000,0,0,16000,0,12784,0,4600,17384
15,Sudan (UNDP),2015,SUD-15/HSD20/S2/RMS/UN/1420,2/12/2017 1:36:04 PM,Internally Displaced People,400,900,600,600,2500,0,0,0,0,0
15,Sudan (UNDP),2015,SUD-15/HSD20/S2/RMS/UN/1420,2/12/2017 1:36:04 PM,Other,1389,1792,3198,3407,9786,1389,1792,3198,3407,9786
15,Sudan (UNDP),2015,SUD-15/HSD20/S2/RMS/UN/1420,2/12/2017 1:36:04 PM,Overall,1789,2692,3798,4007,12286,1389,1792,3198,3407,9786
15,Sudan (UNDP),2015,SUD-15/HSD20/S2/RMS/UN/1421,1/31/2017 9:20:13 AM,Other,19200,30400,51200,59200,160000,18073,35252,54219,55863,163407
15,Sudan (UNDP),2015,SUD-15/HSD20/S2/RMS/UN/1421,1/31/2017 9:20:13 AM,Overall,19200,30400,51200,59200,160000,18073,35252,54219,55863,163407
15,Sudan (UNDP),2015,SUD-15/HSD20/S2/RMS/UN/1422,10/17/2017 12:45:15 PM,Children under 18,4411,1226,1826,2243,9706,4460,4287,1837,1911,12495
15,Sudan (UNDP),2015,SUD-15/HSD20/S2/RMS/UN/1422,10/17/2017 12:45:15 PM,Other,134,292,124,165,715,358,372,153,159,1042
15,Sudan (UNDP),2015,SUD-15/HSD20/S2/RMS/UN/1422,10/17/2017 12:45:15 PM,Overall,5145,6143,2205,2632,16125,7100,7477,3043,3205,20825
15,Sudan (UNDP),2015,SUD-15/HSD20/S2/RMS/UN/1422,10/17/2017 12:45:15 PM,People in Host Communities,600,625,255,224,1704,786,817,337,350,2290
15,Sudan (UNDP),2015,SUD-15/HSD20/S2/RMS/UN/1422,10/17/2017 12:45:15 PM,Women of Child-Bearing Age,0,4000,0,0,4000,0,4998,0,0,4998
15,Sudan (UNDP),2015,SUD-15/HSD20/S2/RMS/UN/1477,2/16/2017 6:14:42 AM,Children under 18,0,0,27456,29744,57200,0,0,26222,31315,57537
15,Sudan (UNDP),2015,SUD-15/HSD20/S2/RMS/UN/1477,2/16/2017 6:14:42 AM,Children under 5,0,0,11232,12168,23400,0,0,11380,12578,23958
15,Sudan (UNDP),2015,SUD-15/HSD20/S2/RMS/UN/1477,2/16/2017 6:14:42 AM,Overall,26000,37700,32800,33800,130300,31426,34968,31653,33554,131601
15,Sudan (UNDP),2015,SUD-15/HSD20/S2/RMS/UN/1477,2/16/2017 6:14:42 AM,Women of Child-Bearing Age,0,32500,0,0,32500,0,31650,0,0,31650
15,Sudan (UNDP),2015,SUD-15/HSD20/S2/RRR/INGO/1436,11/28/2016 6:41:10 AM,Internally Displaced People,262,284,112,122,780,262,284,112,122,780
15,Sudan (UNDP),2015,SUD-15/HSD20/S2/RRR/INGO/1436,11/28/2016 6:41:10 AM,Internally Displaced People/Returnees,927,1005,397,431,2760,927,1005,397,431,2760
15,Sudan (UNDP),2015,SUD-15/HSD20/S2/RRR/INGO/1436,11/28/2016 6:41:10 AM,Overall,1422,1631,509,553,4115,1422,1631,509,553,4115
15,Sudan (UNDP),2015,SUD-15/HSD20/S2/RRR/INGO/1436,11/28/2016 6:41:10 AM,"Staff (own or partner staff, authorities)",6,19,0,0,25,15,10,0,0,25
15,Sudan (UNDP),2015,SUD-15/HSD20/S2/RRR/INGO/1436,11/28/2016 6:41:10 AM,"Trainers, Promoters, Caretakers, committee members, etc.",227,323,0,0,550,227,323,0,0,550
15,Sudan (UNDP),2015,SUD-15/HSD20/S2/RRR/NGO/1457,10/18/2017 1:04:42 PM,Internally Displaced People,6214,7300,2700,3800,20014,6200,7300,2700,3800,20000
15,Sudan (UNDP),2015,SUD-15/HSD20/S2/RRR/NGO/1457,10/18/2017 1:04:42 PM,Overall,6214,10000,4500,5500,26214,6214,10000,3100,3400,22714
15,Sudan (UNDP),2015,SUD-15/HSD20/S2/RRR/NGO/1457,10/18/2017 1:04:42 PM,Returnees,0,995,182,250,1427,787,995,182,250,2214
15,Sudan (UNDP),2015,SUD-15/HSD20/S2/RRR/NGO/1510,2/15/2017 8:05:51 AM,Internally Displaced People,1000,1200,600,400,3200,950,1400,500,600,3450
15,Sudan (UNDP),2015,SUD-15/HSD20/S2/RRR/NGO/1510,2/15/2017 8:05:51 AM,Internally Displaced People/Returnees,1000,1300,1100,900,4300,1200,1450,1050,950,4650
15,Sudan (UNDP),2015,SUD-15/HSD20/S2/RRR/NGO/1510,2/15/2017 8:05:51 AM,Overall,2000,2500,1700,1300,7500,2600,2500,1580,1420,8100
15,Sudan (UNDP),2015,SUD-15/HSD20/S2/WASH/INGO/1440,10/9/2017 8:41:16 AM,Internally Displaced People,8577,9392,11027,11841,40837,9962,10911,12809,13757,47439
15,Sudan (UNDP),2015,SUD-15/HSD20/S2/WASH/INGO/1440,10/9/2017 8:41:16 AM,Overall,11436,12523,14703,15788,54450,12821,14042,16484,17705,61052
15,Sudan (UNDP),2015,SUD-15/HSD20/S2/WASH/INGO/1440,10/9/2017 8:41:16 AM,People in Host Communities,2859,3131,3676,3947,13613,2859,3131,3676,3947,13613
15,Sudan (UNDP),2015,SUD-15/HSD20/S2/WASH/INGO/1475,7/10/2016 10:20:35 AM,Internally Displaced People,8174,8871,12773,13202,43020,8174,8871,12773,13202,43020
15,Sudan (UNDP),2015,SUD-15/HSD20/S2/WASH/INGO/1475,7/10/2016 10:20:35 AM,Overall,8550,9279,13361,13810,45000,8550,9279,13361,13810,45000
15,Sudan (UNDP),2015,SUD-15/HSD20/S2/WASH/INGO/1475,7/10/2016 10:20:35 AM,People in Host Communities,376,408,588,608,1980,376,408,588,608,1980
15,Sudan (UNDP),2015,SUD-15/HSD20/S2/WASH/INGO/1525,12/21/2017 11:47:58 AM,Children under 18,0,0,1500,2400,3900,0,0,5000,5290,10290
15,Sudan (UNDP),2015,SUD-15/HSD20/S2/WASH/INGO/1525,12/21/2017 11:47:58 AM,Committees,60,60,0,0,120,60,60,0,0,120
15,Sudan (UNDP),2015,SUD-15/HSD20/S2/WASH/INGO/1525,12/21/2017 11:47:58 AM,Internally Displaced People,7610,8670,0,0,16280,7610,8670,0,0,16280
15,Sudan (UNDP),2015,SUD-15/HSD20/S2/WASH/INGO/1525,12/21/2017 11:47:58 AM,Overall,8670,10930,2300,3600,25500,6125,8085,5000,5290,24500
15,Sudan (UNDP),2015,SUD-15/HSD20/S2/WASH/INGO/1525,12/21/2017 11:47:58 AM,People in Host Communities,1000,2200,800,1200,5200,1050,1386,764,1000,4200
15,Sudan (UNDP),2015,SUD-15/HSD20/S2/WASH/NGO/1404,2/16/2017 10:57:43 AM,Internally Displaced People,801,1854,942,1413,5010,1657,1251,1078,1677,5663
15,Sudan (UNDP),2015,SUD-15/HSD20/S2/WASH/NGO/1404,2/16/2017 10:57:43 AM,Internally Displaced People/Returnees,534,1236,628,942,3340,1089,1356,894,1189,4528
15,Sudan (UNDP),2015,SUD-15/HSD20/S2/WASH/NGO/1404,2/16/2017 10:57:43 AM,Overall,2672,6179,3140,4709,16700,2874,7269,3463,4959,18565
15,Sudan (UNDP),2015,SUD-15/HSD20/S2/WASH/NGO/1404,2/16/2017 10:57:43 AM,People in Host Communities,1336,3090,1570,2354,8350,1280,3178,2303,1613,8374
15,Sudan (UNDP),2015,SUD-15/HSD20/S2/WASH/UN/1406,2/12/2017 11:31:17 AM,Internally Displaced People,101667,152683,83264,124871,462485,101467,152483,83064,124671,461685
15,Sudan (UNDP),2015,SUD-15/HSD20/S2/WASH/UN/1406,2/12/2017 11:31:17 AM,Overall,101667,152683,83264,124871,462485,101467,152483,83064,124671,461685
15,Sudan (UNDP),2015,SUD-15/HSD20/S2/WASH/UN/1427,3/15/2017 6:06:27 AM,Internally Displaced People,19001,34383,18178,18920,90482,19428,35023,18320,19133,91904
15,Sudan (UNDP),2015,SUD-15/HSD20/S2/WASH/UN/1427,3/15/2017 6:06:27 AM,Overall,19001,34383,18178,18920,90482,19428,35023,18320,19133,91904
15,Sudan (UNDP),2015,SUD-15/HSD20/SSp/E/UN/1093,5/25/2016 12:24:17 PM,Children under 18,0,0,27000,27000,54000,0,0,26378,28576,54954
15,Sudan (UNDP),2015,SUD-15/HSD20/SSp/E/UN/1093,5/25/2016 12:24:17 PM,Internally Displaced People,0,0,13500,13500,27000,0,0,14818,15415,30233
15,Sudan (UNDP),2015,SUD-15/HSD20/SSp/E/UN/1093,5/25/2016 12:24:17 PM,Overall,0,0,27000,27000,54000,466,324,26378,28576,55744
15,Sudan (UNDP),2015,SUD-15/HSD20/SSp/ESNFIs/UN/1102,5/8/2016 2:49:15 PM,Overall,250000,250000,250000,250000,1000000,154597,154597,154597,154598,618389
15,Sudan (UNDP),2015,SUD-15/HSD20/SSp/ESNFIs/UN/1118,5/8/2016 2:49:17 PM,Internally Displaced People/Returnees,57000,58000,57000,58000,230000,0,0,0,0,0
15,Sudan (UNDP),2015,SUD-15/HSD20/SSp/ESNFIs/UN/1118,5/8/2016 2:49:17 PM,Overall,27000,28000,27000,28000,110000,27000,28000,27000,28000,110000
15,Sudan (UNDP),2015,SUD-15/HSD20/SSp/FSL/UN/1095,5/4/2016 9:16:25 AM,Internally Displaced People,61740,64260,27000,27000,180000,0,0,0,0,0
15,Sudan (UNDP),2015,SUD-15/HSD20/SSp/FSL/UN/1095,5/4/2016 9:16:25 AM,Overall,113190,117810,49500,49500,330000,0,0,0,0,0
15,Sudan (UNDP),2015,SUD-15/HSD20/SSp/FSL/UN/1095,5/4/2016 9:16:25 AM,People in Host Communities,51450,53550,22500,22500,150000,0,0,0,0,0
15,Sudan (UNDP),2015,SUD-15/HSD20/SSp/H/UN/1096,5/16/2016 12:26:32 PM,Children under 5,0,0,43904,45696,89600,0,0,0,0,0
15,Sudan (UNDP),2015,SUD-15/HSD20/SSp/H/UN/1096,5/16/2016 12:26:32 PM,Internally Displaced People,78848,118272,122931,127949,448000,77284,114366,118890,122650,433190
15,Sudan (UNDP),2015,SUD-15/HSD20/SSp/H/UN/1096,5/16/2016 12:26:32 PM,Overall,78848,118272,122931,127949,448000,77284,114366,118890,122650,433190
15,Sudan (UNDP),2015,SUD-15/HSD20/SSp/H/UN/1096,5/16/2016 12:26:32 PM,Women of Child-Bearing Age,0,120000,0,0,120000,0,0,0,0,0
15,Sudan (UNDP),2015,SUD-15/HSD20/SSp/H/UN/1110,6/15/2016 11:14:44 AM,Children under 5,0,0,334000,408500,742500,0,0,334000,408500,742500
15,Sudan (UNDP),2015,SUD-15/HSD20/SSp/H/UN/1110,6/15/2016 11:14:44 AM,Internally Displaced People,1296000,1404000,0,0,2700000,1296000,1404000,0,0,2700000
15,Sudan (UNDP),2015,SUD-15/HSD20/SSp/H/UN/1110,6/15/2016 11:14:44 AM,Overall,1793683,1868684,402774,434859,4500000,1793683,1868684,402774,434859,4500000
15,Sudan (UNDP),2015,SUD-15/HSD20/SSp/H/UN/1115,5/16/2016 12:29:34 PM,Overall,37566,39100,56350,58560,191576,21570,22451,32355,33624,110000
15,Sudan (UNDP),2015,SUD-15/HSD20/SSp/H/UN/1116,5/23/2016 10:31:59 AM,Children under 18,0,0,10,68,78,0,0,50,853,903
15,Sudan (UNDP),2015,SUD-15/HSD20/SSp/H/UN/1116,5/23/2016 10:31:59 AM,Other,1875,0,0,0,1875,1875,0,0,0,1875
15,Sudan (UNDP),2015,SUD-15/HSD20/SSp/H/UN/1116,5/23/2016 10:31:59 AM,Overall,1875,13984,10,68,15937,1875,25000,50,853,27778
15,Sudan (UNDP),2015,SUD-15/HSD20/SSp/H/UN/1116,5/23/2016 10:31:59 AM,Pregnant and Lactating Women,0,13984,0,0,13984,0,25000,0,0,25000
15,Sudan (UNDP),2015,SUD-15/HSD20/SSp/L/UN/1101,6/26/2016 10:26:30 AM,Overall,21000,21000,0,0,42000,20279,20279,0,0,40558
15,Sudan (UNDP),2015,SUD-15/HSD20/SSp/N/UN/1097,6/12/2016 9:34:58 AM,Overall,0,12280,6140,6140,24560,0,0,7967,7967,15934
15,Sudan (UNDP),2015,SUD-15/HSD20/SSp/P/UN/1106,5/2/2016 7:07:29 AM,Internally Displaced People,18552,624358,802288,895165,2340363,0,0,0,0,0
15,Sudan (UNDP),2015,SUD-15/HSD20/SSp/P/UN/1106,5/2/2016 7:07:29 AM,Other,29525,99349,127677,142440,398991,0,0,0,0,0
15,Sudan (UNDP),2015,SUD-15/HSD20/SSp/P/UN/1106,5/2/2016 7:07:29 AM,Overall,226205,751161,978187,1091290,3046843,0,0,0,0,0
15,Sudan (UNDP),2015,SUD-15/HSD20/SSp/P/UN/1106,5/2/2016 7:07:29 AM,Returnees,11127,37444,48120,53684,150375,0,0,0,0,0
15,Sudan (UNDP),2015,SUD-15/HSD20/SSp/P/UN/1114,6/21/2016 8:08:03 AM,Children under 18,0,0,0,0,0,0,0,0,4880,4880
15,Sudan (UNDP),2015,SUD-15/HSD20/SSp/P/UN/1114,6/21/2016 8:08:03 AM,Internally Displaced People,0,0,0,0,0,0,19520,0,4880,24400
15,Sudan (UNDP),2015,SUD-15/HSD20/SSp/P/UN/1114,6/21/2016 8:08:03 AM,Overall,0,19520,0,4880,24400,0,19520,0,4880,24400
15,Sudan (UNDP),2015,SUD-15/HSD20/SSp/RMS/UN/1099,5/16/2016 12:28:48 PM,Overall,2250,2250,2250,2250,9000,2250,2250,2250,2250,9000
15,Sudan (UNDP),2015,SUD-15/HSD20/SSp/RMS/UN/1109,8/28/2016 8:03:23 AM,Overall,178897,178897,178897,178897,715588,178897,178897,178897,178897,715588
15,Sudan (UNDP),2015,SUD-15/HSD20/SSp/RMS/UN/1117,5/16/2016 12:30:05 PM,Children under 18,0,0,0,0,0,0,0,0,3700,3700
15,Sudan (UNDP),2015,SUD-15/HSD20/SSp/RMS/UN/1117,5/16/2016 12:30:05 PM,Overall,0,14800,0,3700,18500,0,14700,0,3800,18500
15,Sudan (UNDP),2015,SUD-15/HSD20/SSp/RMS/UN/1117,5/16/2016 12:30:05 PM,Women of Child-Bearing Age,0,0,0,0,0,0,14800,0,0,14800
15,Sudan (UNDP),2015,SUD-15/HSD20/SSp/WASH/UN/1100,6/23/2016 12:01:49 PM,Children under 18,0,0,37674,39211,76885,0,0,68030,70801,138831
15,Sudan (UNDP),2015,SUD-15/HSD20/SSp/WASH/UN/1100,6/23/2016 12:01:49 PM,Children under 5,0,0,16926,17617,34543,0,0,30564,31811,62375
15,Sudan (UNDP),2015,SUD-15/HSD20/SSp/WASH/UN/1100,6/23/2016 12:01:49 PM,Internally Displaced People,36404,37882,0,0,74286,62208,64703,93312,97101,317324
15,Sudan (UNDP),2015,SUD-15/HSD20/SSp/WASH/UN/1100,6/23/2016 12:01:49 PM,Overall,36404,37882,54605,56823,185714,69655,72479,104483,108723,355340
15,Sudan (UNDP),2015,SUD-15/HSD20/SSp/WASH/UN/1112,5/2/2016 3:05:08 PM,Internally Displaced People,610050,634950,614950,640050,2500000,238088,247806,240000,249797,975691
15,Sudan (UNDP),2015,SUD-15/HSD20/SSp/WASH/UN/1112,5/2/2016 3:05:08 PM,Internally Displaced People/Returnees,122010,126990,122990,128010,500000,47617,49561,48000,49960,195138
15,Sudan (UNDP),2015,SUD-15/HSD20/SSp/WASH/UN/1112,5/2/2016 3:05:08 PM,Overall,878472,914328,885528,921672,3600000,342848,356841,345601,359708,1404998
15,Sudan (UNDP),2016,SUD-16/HSD20/R/CCS/UN/1576,11/8/2018 11:25:48 AM,Overall,2500,1600,0,0,4100,2000,1200,0,0,3200
15,Sudan (UNDP),2016,SUD-16/HSD20/R/CCS/UN/1705,12/10/2017 10:26:43 AM,Internally Displaced People/Returnees,70700,84611,97305,97384,350000,75624,90503,104081,104166,374374
15,Sudan (UNDP),2016,SUD-16/HSD20/R/CCS/UN/1705,12/10/2017 10:26:43 AM,Overall,70700,84611,97305,97384,350000,75624,90503,104081,104166,374374
15,Sudan (UNDP),2016,SUD-16/HSD20/R/CCS/UN/1713,1/8/2018 1:59:25 PM,Overall,140000,120000,15000,25000,300000,120000,80000,13000,18000,231000
15,Sudan (UNDP),2016,SUD-16/HSD20/R/E/UN/1524,6/14/2017 9:32:06 AM,Overall,0,0,27000,27000,54000,0,1,0,0,1
15,Sudan (UNDP),2016,SUD-16/HSD20/R/ESNFIs/UN/1520,10/19/2017 8:59:27 AM,Overall,189000,231000,126000,154000,700000,95000,115000,63000,77000,350000
15,Sudan (UNDP),2016,SUD-16/HSD20/R/H/UN/1528,10/19/2017 8:52:24 AM,Children under 5,0,0,33550,31230,64780,0,0,220000,20000,240000
15,Sudan (UNDP),2016,SUD-16/HSD20/R/H/UN/1528,10/19/2017 8:52:24 AM,Internally Displaced People/Returnees,341978,506660,594660,571340,2014638,300000,290000,320000,310000,1220000
15,Sudan (UNDP),2016,SUD-16/HSD20/R/H/UN/1528,10/19/2017 8:52:24 AM,Overall,928320,891917,1005778,1046830,3872845,309000,698000,353000,340500,1700500
15,Sudan (UNDP),2016,SUD-16/HSD20/R/H/UN/1528,10/19/2017 8:52:24 AM,Returnees,20024,24186,28386,27273,99869,9000,8000,11000,10500,38500
15,Sudan (UNDP),2016,SUD-16/HSD20/R/H/UN/1528,10/19/2017 8:52:24 AM,Women of Child-Bearing Age,566318,0,0,0,566318,400000,0,0,0,400000
15,Sudan (UNDP),2016,SUD-16/HSD20/R/N/UN/1522,10/19/2017 8:57:50 AM,Overall,0,12280,6140,6140,24560,0,12280,6140,6140,24560
15,Sudan (UNDP),2016,SUD-16/HSD20/R/WASH/UN/1521,10/19/2017 8:54:56 AM,Overall,306298,306297,386400,386400,1385395,0,0,0,0,0
15,Sudan (UNDP),2016,SUD-16/HSD20/RE/ESNFIs/INGO/4121,12/10/2017 10:36:27 AM,Children under 18,0,0,1986,2978,4964,0,0,1986,2978,4964
15,Sudan (UNDP),2016,SUD-16/HSD20/RE/ESNFIs/INGO/4121,12/10/2017 10:36:27 AM,Overall,1489,3475,1986,2978,9928,1489,3475,1986,2978,9928
15,Sudan (UNDP),2016,SUD-16/HSD20/RE/ESNFIs/INGO/4121,12/10/2017 10:36:27 AM,Pregnant and Lactating Women,0,1390,0,0,1390,0,1390,0,0,1390
15,Sudan (UNDP),2016,SUD-16/HSD20/RE/ESNFIs/INGO/4121,12/10/2017 10:36:27 AM,Women of Child-Bearing Age,0,1564,0,0,1564,0,1564,0,0,1564
15,Sudan (UNDP),2016,SUD-16/HSD20/RE/H/UN/4150,12/4/2017 1:37:14 PM,Children under 5,0,0,816,784,1600,0,0,869,795,1664
15,Sudan (UNDP),2016,SUD-16/HSD20/RE/H/UN/4150,12/4/2017 1:37:14 PM,Overall,1882,1958,2122,2038,8000,1800,2040,2140,2120,8100
15,Sudan (UNDP),2016,SUD-16/HSD20/RE/H/UN/4150,12/4/2017 1:37:14 PM,Pregnant and Lactating Women,0,400,0,0,400,0,407,0,0,407
15,Sudan (UNDP),2016,SUD-16/HSD20/RE/H/UN/4150,12/4/2017 1:37:14 PM,Women of Child-Bearing Age,0,1380,0,0,1380,0,1459,0,0,1459
15,Sudan (UNDP),2016,SUD-16/HSD20/RE/H/UN/4299,7/19/2017 7:19:07 AM,Children under 5,0,0,772310,870902,1643212,0,0,924744,882080,1806824
15,Sudan (UNDP),2016,SUD-16/HSD20/RE/H/UN/4299,7/19/2017 7:19:07 AM,Overall,1971854,2061484,2599262,2330373,8962973,2255790,2455600,2774322,2646245,10131957
15,Sudan (UNDP),2016,SUD-16/HSD20/RE/H/UN/4299,7/19/2017 7:19:07 AM,"Staff (own or partner staff, authorities)",225,150,0,0,375,156,168,0,0,324
15,Sudan (UNDP),2016,SUD-16/HSD20/RE/H/UN/4299,7/19/2017 7:19:07 AM,"Trainers, Promoters, Caretakers, committee members, etc.",675,550,0,0,1225,609,863,0,0,1472
15,Sudan (UNDP),2016,SUD-16/HSD20/RE/H/UN/4314,10/12/2017 8:50:58 AM,Children under 5,0,0,204,196,400,0,0,198,198,396
15,Sudan (UNDP),2016,SUD-16/HSD20/RE/H/UN/4314,10/12/2017 8:50:58 AM,Overall,490,470,530,510,2000,498,468,576,518,2060
15,Sudan (UNDP),2016,SUD-16/HSD20/RE/H/UN/4314,10/12/2017 8:50:58 AM,Pregnant and Lactating Women,0,160,0,0,160,0,166,0,0,166
15,Sudan (UNDP),2016,SUD-16/HSD20/RE/N/UN/1754,12/19/2016 9:23:45 AM,Internally Displaced People/Returnees,0,0,750,750,1500,0,0,794,906,1700
15,Sudan (UNDP),2016,SUD-16/HSD20/RE/N/UN/1754,12/19/2016 9:23:45 AM,Overall,0,0,750,750,1500,0,0,794,906,1700
15,Sudan (UNDP),2016,SUD-16/HSD20/RE/N/UN/4237,6/7/2017 7:49:44 AM,Overall,0,0,2500,2500,5000,0,0,2922,3041,5963
15,Sudan (UNDP),2016,SUD-16/HSD20/RE/P/NGO/3670,12/11/2017 1:06:36 PM,Internally Displaced People,1142,2456,845,1267,5710,2019,5167,618,814,8618
15,Sudan (UNDP),2016,SUD-16/HSD20/RE/P/NGO/3670,12/11/2017 1:06:36 PM,Overall,1142,2456,845,1267,5710,2019,5167,618,814,8618
15,Sudan (UNDP),2016,SUD-16/HSD20/RE/P/UN/3432,11/15/2017 1:38:14 PM,Children under 18,0,0,3787,5681,9468,0,0,5390,3680,9070
15,Sudan (UNDP),2016,SUD-16/HSD20/RE/P/UN/3432,11/15/2017 1:38:14 PM,Overall,0,0,3787,5681,9468,0,0,5390,3680,9070
15,Sudan (UNDP),2016,SUD-16/HSD20/RE/RMS/INGO/1782,1/8/2017 8:43:08 AM,Overall,2142,6854,2856,2428,14280,1520,4867,2028,1724,10139
15,Sudan (UNDP),2016,SUD-16/HSD20/RE/RMS/INGO/1783,3/7/2017 9:02:21 AM,Overall,3742,11973,4989,4240,24944,21200,29227,0,0,50427
15,Sudan (UNDP),2016,SUD-16/HSD20/RE/RMS/INGO/3191,10/12/2017 11:35:02 AM,Other,726,1089,1088,1635,4538,1271,1819,597,1398,5085
15,Sudan (UNDP),2016,SUD-16/HSD20/RE/RMS/INGO/3191,10/12/2017 11:35:02 AM,Overall,872,1306,1307,1961,5446,1524,2134,792,1648,6098
15,Sudan (UNDP),2016,SUD-16/HSD20/RE/RMS/INGO/3191,10/12/2017 11:35:02 AM,People in Host Communities,146,217,219,326,908,242,362,131,278,1013
15,Sudan (UNDP),2016,SUD-16/HSD20/RE/RMS/INGO/3193,6/5/2017 10:30:28 AM,Other,1510,1562,600,641,4313,450,1007,1265,1245,3967
15,Sudan (UNDP),2016,SUD-16/HSD20/RE/RMS/INGO/3193,6/5/2017 10:30:28 AM,Overall,4397,5893,1329,1381,13000,1736,5843,2552,2568,12699
15,Sudan (UNDP),2016,SUD-16/HSD20/RE/RMS/INGO/3193,6/5/2017 10:30:28 AM,People in Host Communities,2887,4331,729,740,8687,1286,4841,1287,1323,8737
15,Sudan (UNDP),2016,SUD-16/HSD20/RE/RMS/INGO/3204,11/26/2017 6:51:10 AM,Internally Displaced People/Returnees,1132,1698,290,290,3410,2802,1868,1868,1245,7783
15,Sudan (UNDP),2016,SUD-16/HSD20/RE/RMS/INGO/3204,11/26/2017 6:51:10 AM,Overall,3259,4889,668,1001,9817,3114,4670,1364,2046,11194
15,Sudan (UNDP),2016,SUD-16/HSD20/RE/RMS/INGO/3204,11/26/2017 6:51:10 AM,People in HE and/or AFLC,2127,3191,378,711,6407,1556,1038,778,513,3885
15,Sudan (UNDP),2016,SUD-16/HSD20/RE/RMS/INGO/4147,10/15/2017 12:33:45 PM,Overall,1780,5299,2920,5501,15500,772,1874,937,1930,5513
15,Sudan (UNDP),2016,SUD-16/HSD20/RE/RMS/INGO/4147,10/15/2017 12:33:45 PM,People in Host Communities,500,2040,1000,1960,5500,45,1818,783,2116,4762
15,Sudan (UNDP),2016,SUD-16/HSD20/RE/RMS/INGO/4151,2/11/2018 10:28:07 AM,Children under 5,2650,1750,2448,2352,9200,0,0,4096,3991,8087
15,Sudan (UNDP),2016,SUD-16/HSD20/RE/RMS/INGO/4151,2/11/2018 10:28:07 AM,Overall,2650,2550,2448,2352,10000,4578,7421,7470,7973,27442
15,Sudan (UNDP),2016,SUD-16/HSD20/RE/RMS/INGO/4151,2/11/2018 10:28:07 AM,Pregnant and Lactating Women,0,800,0,0,800,0,1825,0,0,1825
15,Sudan (UNDP),2016,SUD-16/HSD20/RE/RMS/NGO/3195,5/28/2017 12:23:01 PM,Internally Displaced People,57,265,28,29,379,57,265,28,29,379
15,Sudan (UNDP),2016,SUD-16/HSD20/RE/RMS/NGO/3195,5/28/2017 12:23:01 PM,Other,455,2125,210,247,3037,455,2125,210,247,3037
15,Sudan (UNDP),2016,SUD-16/HSD20/RE/RMS/NGO/3195,5/28/2017 12:23:01 PM,Overall,569,2655,266,305,3795,569,2655,266,305,3795
15,Sudan (UNDP),2016,SUD-16/HSD20/RE/RMS/NGO/3195,5/28/2017 12:23:01 PM,People in Host Communities,57,265,28,29,379,57,265,28,29,379
15,Sudan (UNDP),2016,SUD-16/HSD20/RE/RMS/NGO/3202,10/17/2017 6:33:22 AM,Committees,0,0,0,0,0,20,25,0,0,45
15,Sudan (UNDP),2016,SUD-16/HSD20/RE/RMS/NGO/3202,10/17/2017 6:33:22 AM,Internally Displaced People,93,139,216,323,771,150,150,215,330,845
15,Sudan (UNDP),2016,SUD-16/HSD20/RE/RMS/NGO/3202,10/17/2017 6:33:22 AM,Other,927,1390,2162,3244,7723,880,1385,2165,3345,7775
15,Sudan (UNDP),2016,SUD-16/HSD20/RE/RMS/NGO/3202,10/17/2017 6:33:22 AM,Overall,1113,1668,2594,3890,9265,1150,1700,2600,3900,9350
15,Sudan (UNDP),2016,SUD-16/HSD20/RE/RMS/NGO/3202,10/17/2017 6:33:22 AM,People in Host Communities,93,139,216,323,771,100,140,220,225,685
15,Sudan (UNDP),2016,SUD-16/HSD20/RE/RMS/NGO/4143,10/12/2017 6:35:28 AM,Children under 18,0,0,3400,3400,6800,0,0,3600,3500,7100
15,Sudan (UNDP),2016,SUD-16/HSD20/RE/RMS/NGO/4143,10/12/2017 6:35:28 AM,Other,1280,1920,0,0,3200,1350,2200,0,0,3550
15,Sudan (UNDP),2016,SUD-16/HSD20/RE/RMS/NGO/4143,10/12/2017 6:35:28 AM,Overall,1440,2160,3700,3700,11000,1500,2500,3800,3750,11550
15,Sudan (UNDP),2016,SUD-16/HSD20/RE/RMS/NGO/4143,10/12/2017 6:35:28 AM,People in Host Communities,160,240,300,300,1000,150,300,200,250,900
15,Sudan (UNDP),2016,SUD-16/HSD20/RE/RMS/UN/1781,2/12/2017 12:37:32 PM,Overall,12472,12472,0,0,24944,12472,12472,0,0,24944
15,Sudan (UNDP),2016,SUD-16/HSD20/RE/RMS/UN/1786,2/12/2017 12:39:50 PM,Children under 18,0,0,9049,11062,20111,0,0,4989,4240,9229
15,Sudan (UNDP),2016,SUD-16/HSD20/RE/RMS/UN/1786,2/12/2017 12:39:50 PM,Overall,2223,2610,9049,11062,24944,3742,11973,4989,4240,24944
15,Sudan (UNDP),2016,SUD-16/HSD20/RE/RMS/UN/3213,11/26/2017 11:23:20 AM,Overall,3861,3862,0,0,7723,5000,5112,0,0,10112
15,Sudan (UNDP),2016,SUD-16/HSD20/RE/RMS/UN/4103,11/23/2017 6:41:09 AM,Overall,2000,8000,0,0,10000,2372,9486,0,0,11858
15,Sudan (UNDP),2016,SUD-16/HSD20/RE/RMS/UN/4152,10/12/2017 9:07:46 AM,Children under 18,0,0,30,0,30,0,0,0,39,39
15,Sudan (UNDP),2016,SUD-16/HSD20/RE/RMS/UN/4152,10/12/2017 9:07:46 AM,Overall,80,2720,30,1230,4060,0,2716,0,1139,3855
15,Sudan (UNDP),2016,SUD-16/HSD20/RE/RMS/UN/4152,10/12/2017 9:07:46 AM,Pregnant and Lactating Women,0,520,0,100,620,0,516,0,0,516
15,Sudan (UNDP),2016,SUD-16/HSD20/RE/RMS/UN/4152,10/12/2017 9:07:46 AM,Women of Child-Bearing Age,0,2200,0,1130,3330,0,2200,0,1100,3300
15,Sudan (UNDP),2016,SUD-16/HSD20/RE/RMS/UN/4154,10/12/2017 7:55:25 AM,Overall,7500,7500,0,0,15000,7809,8461,0,0,16270
15,Sudan (UNDP),2016,SUD-16/HSD20/RE/WASH/INGO/1787,2/12/2017 12:24:43 PM,Overall,4291,13725,5719,4860,28595,4291,13725,5719,4860,28595
15,Sudan (UNDP),2016,SUD-16/HSD20/RE/WASH/UN/1780,3/13/2017 6:37:50 AM,Internally Displaced People,17000,18800,7200,8000,51000,16800,18500,6900,7300,49500
15,Sudan (UNDP),2016,SUD-16/HSD20/RE/WASH/UN/1780,3/13/2017 6:37:50 AM,Overall,27032,29278,10892,8742,75944,26980,29150,11010,8615,75755
15,Sudan (UNDP),2016,SUD-16/HSD20/RE/WASH/UN/3189,5/25/2017 7:34:44 AM,Internally Displaced People,1515,1779,6167,7539,17000,1337,1570,5441,6652,15000
15,Sudan (UNDP),2016,SUD-16/HSD20/RE/WASH/UN/3189,5/25/2017 7:34:44 AM,Overall,1515,1779,6167,7539,17000,1337,1570,5441,6652,15000
15,Sudan (UNDP),2016,SUD-16/HSD20/RE/WASH/UN/4330,12/4/2017 1:41:46 PM,Overall,5311,7009,4460,4460,21240,6622,8742,5563,5563,26490
15,Sudan (UNDP),2016,SUD-16/HSD20/RE/WASH/UN/4330,12/4/2017 1:41:46 PM,People in Host Communities,5311,7009,4460,4460,21240,6622,8742,5563,5563,26490
15,Sudan (UNDP),2016,SUD-16/HSD20/RE/WASH/UN/4332,7/19/2017 7:01:27 AM,Overall,208206,200040,216703,208207,833156,206318,198416,205938,207245,817917
15,Sudan (UNDP),2016,SUD-16/HSD20/RE/WASH/UN/4333,7/19/2017 6:54:55 AM,Overall,145901,151815,218851,227738,744305,291602,279834,173945,189291,934672
15,Sudan (UNDP),2016,SUD-16/HSD20/RE/WASH/UN/4333,7/19/2017 6:54:55 AM,People in Host Communities,145901,151815,218851,227738,744305,291602,279834,173945,189291,934672
15,Sudan (UNDP),2016,SUD-16/HSD20/S1/E/INGO/1552,11/14/2017 7:55:14 AM,Children under 18,0,0,2317,2589,4906,0,0,4302,5520,9822
15,Sudan (UNDP),2016,SUD-16/HSD20/S1/E/INGO/1552,11/14/2017 7:55:14 AM,Committees,0,0,0,0,0,787,1049,0,0,1836
15,Sudan (UNDP),2016,SUD-16/HSD20/S1/E/INGO/1552,11/14/2017 7:55:14 AM,Internally Displaced People,189,266,0,0,455,355,587,2469,3346,6757
15,Sudan (UNDP),2016,SUD-16/HSD20/S1/E/INGO/1552,11/14/2017 7:55:14 AM,Overall,270,380,2317,2589,5556,787,1049,4302,5520,11658
15,Sudan (UNDP),2016,SUD-16/HSD20/S1/E/INGO/1592,11/1/2017 7:59:51 AM,Children under 18,0,0,1881,2299,4180,0,0,3621,4057,7678
15,Sudan (UNDP),2016,SUD-16/HSD20/S1/E/INGO/1592,11/1/2017 7:59:51 AM,Internally Displaced People,140,160,0,0,300,160,143,0,0,303
15,Sudan (UNDP),2016,SUD-16/HSD20/S1/E/INGO/1592,11/1/2017 7:59:51 AM,Overall,140,160,1881,2299,4480,160,143,3621,4057,7981
15,Sudan (UNDP),2016,SUD-16/HSD20/S1/E/INGO/1679,12/26/2017 7:42:13 AM,Internally Displaced People,51,76,2950,2950,6027,60,74,4304,3508,7946
15,Sudan (UNDP),2016,SUD-16/HSD20/S1/E/INGO/1679,12/26/2017 7:42:13 AM,Overall,64,96,3081,3081,6322,87,107,6149,5012,11355
15,Sudan (UNDP),2016,SUD-16/HSD20/S1/E/INGO/1679,12/26/2017 7:42:13 AM,People in Host Communities,13,20,131,131,295,27,33,1748,1424,3232
15,Sudan (UNDP),2016,SUD-16/HSD20/S1/E/NGO/1645,12/7/2017 7:12:55 AM,Internally Displaced People,71,113,850,1080,2114,63,120,930,1061,2174
15,Sudan (UNDP),2016,SUD-16/HSD20/S1/E/NGO/1645,12/7/2017 7:12:55 AM,Overall,171,313,2300,2760,5544,202,172,2640,2622,5636
15,Sudan (UNDP),2016,SUD-16/HSD20/S1/E/NGO/1645,12/7/2017 7:12:55 AM,People in Host Communities,50,100,950,850,1950,50,90,900,920,1960
15,Sudan (UNDP),2016,SUD-16/HSD20/S1/E/NGO/1645,12/7/2017 7:12:55 AM,Returnees,50,100,500,830,1480,30,85,537,850,1502
15,Sudan (UNDP),2016,SUD-16/HSD20/S1/E/UN/1748,11/9/2017 8:14:09 AM,Children under 18,0,0,27000,27000,54000,0,0,30720,30720,61440
15,Sudan (UNDP),2016,SUD-16/HSD20/S1/E/UN/1748,11/9/2017 8:14:09 AM,Overall,0,0,27000,27000,54000,0,0,30720,30720,61440
15,Sudan (UNDP),2016,SUD-16/HSD20/S1/ESNFIs/INGO/1618,12/7/2017 7:56:57 AM,Internally Displaced People,10000,15000,12500,12500,50000,8418,12629,10524,10524,42095
15,Sudan (UNDP),2016,SUD-16/HSD20/S1/ESNFIs/INGO/1618,12/7/2017 7:56:57 AM,Overall,10000,15000,12500,12500,50000,8418,12629,10524,10524,42095
15,Sudan (UNDP),2016,SUD-16/HSD20/S1/ESNFIs/NGO/1566,1/28/2018 7:31:36 AM,Internally Displaced People,2500,3000,2000,1500,9000,2500,3040,1916,1600,9056
15,Sudan (UNDP),2016,SUD-16/HSD20/S1/ESNFIs/NGO/1566,1/28/2018 7:31:36 AM,Internally Displaced People/Returnees,500,1500,500,1000,3500,500,1560,634,1100,3794
15,Sudan (UNDP),2016,SUD-16/HSD20/S1/ESNFIs/NGO/1566,1/28/2018 7:31:36 AM,Overall,3000,4500,2500,2500,12500,3000,4600,2550,2700,12850
15,Sudan (UNDP),2016,SUD-16/HSD20/S1/ESNFIs/NGO/1630,12/4/2017 6:41:06 AM,Overall,2000,2500,2000,2000,8500,2000,2500,2000,2000,8500
15,Sudan (UNDP),2016,SUD-16/HSD20/S1/ESNFIs/NGO/1630,12/4/2017 6:41:06 AM,Returnees,2000,2500,2000,2000,8500,2000,2500,2000,2000,8500
15,Sudan (UNDP),2016,SUD-16/HSD20/S1/ESNFIs/NGO/1660,10/9/2017 11:55:50 AM,Internally Displaced People,4659,7601,5640,6620,24520,4377,7141,5298,6219,23035
15,Sudan (UNDP),2016,SUD-16/HSD20/S1/ESNFIs/NGO/1660,10/9/2017 11:55:50 AM,Other,959,1564,1160,1362,5045,959,1564,1160,1362,5045
15,Sudan (UNDP),2016,SUD-16/HSD20/S1/ESNFIs/NGO/1660,10/9/2017 11:55:50 AM,Overall,5631,9187,6816,8002,29636,5382,8728,6458,7582,28150
15,Sudan (UNDP),2016,SUD-16/HSD20/S1/ESNFIs/NGO/1660,10/9/2017 11:55:50 AM,"Trainers, Promoters, Caretakers, committee members, etc.",0,0,0,0,0,35,35,0,0,70
15,Sudan (UNDP),2016,SUD-16/HSD20/S1/ESNFIs/NGO/1776,12/11/2017 1:30:16 PM,Internally Displaced People,5945,17865,2983,2983,29776,2087,6233,1044,1044,10408
15,Sudan (UNDP),2016,SUD-16/HSD20/S1/ESNFIs/NGO/1776,12/11/2017 1:30:16 PM,Overall,5965,17895,2983,2983,29826,2087,6263,1044,1044,10438
15,Sudan (UNDP),2016,SUD-16/HSD20/S1/ESNFIs/NGO/1776,12/11/2017 1:30:16 PM,"Staff (own or partner staff, authorities)",20,30,0,0,50,20,30,0,0,50
15,Sudan (UNDP),2016,SUD-16/HSD20/S1/ESNFIs/UN/1636,2/19/2018 10:49:04 AM,Overall,16000,19500,22250,26750,84500,16000,19500,22250,26750,84500
15,Sudan (UNDP),2016,SUD-16/HSD20/S1/FSL/INGO/1718,1/7/2018 10:21:16 AM,Internally Displaced People,40019,52598,34603,35057,162277,37767,45129,20848,22216,125960
15,Sudan (UNDP),2016,SUD-16/HSD20/S1/FSL/INGO/1718,1/7/2018 10:21:16 AM,Overall,93581,130783,72780,73584,370728,110136,122289,65272,72379,370076
15,Sudan (UNDP),2016,SUD-16/HSD20/S1/FSL/INGO/1718,1/7/2018 10:21:16 AM,People in Host Communities,40469,57158,25965,26573,150165,62561,75532,47521,52262,237876
15,Sudan (UNDP),2016,SUD-16/HSD20/S1/FSL/INGO/1718,1/7/2018 10:21:16 AM,Returnees,13093,21027,12212,11954,58286,998,1498,1498,2246,6240
15,Sudan (UNDP),2016,SUD-16/HSD20/S1/FSL/INGO/1734,11/16/2017 7:44:02 AM,Agro-Pastoralists,3262,3606,6868,6868,20604,3756,10723,4230,5982,24691
15,Sudan (UNDP),2016,SUD-16/HSD20/S1/FSL/INGO/1734,11/16/2017 7:44:02 AM,Internally Displaced People/Returnees,2003,2576,4579,4579,13737,1323,3320,1170,1290,7103
15,Sudan (UNDP),2016,SUD-16/HSD20/S1/FSL/INGO/1734,11/16/2017 7:44:02 AM,Overall,7802,9364,17167,17687,52020,8641,12120,14200,17710,52671
15,Sudan (UNDP),2016,SUD-16/HSD20/S1/FSL/INGO/1734,11/16/2017 7:44:02 AM,Pastoralists,2289,2289,4579,4579,13736,3120,6236,4902,6942,21200
15,Sudan (UNDP),2016,SUD-16/HSD20/S1/FSL/INGO/1734,11/16/2017 7:44:02 AM,People in Host Communities,248,893,1141,1661,3943,65,246,15,54,380
15,Sudan (UNDP),2016,SUD-16/HSD20/S1/FSL/NGO/1595,1/22/2018 9:20:46 AM,Agro-Pastoralists,11000,9401,4324,4643,29368,6629,7937,4608,4838,24012
15,Sudan (UNDP),2016,SUD-16/HSD20/S1/FSL/NGO/1595,1/22/2018 9:20:46 AM,Committees,144,204,84,78,510,142,187,35,46,410
15,Sudan (UNDP),2016,SUD-16/HSD20/S1/FSL/NGO/1595,1/22/2018 9:20:46 AM,Internally Displaced People/Returnees,423,410,208,197,1238,331,409,252,258,1250
15,Sudan (UNDP),2016,SUD-16/HSD20/S1/FSL/NGO/1595,1/22/2018 9:20:46 AM,Overall,13020,12500,5269,5736,36525,8067,10054,5280,5800,29201
15,Sudan (UNDP),2016,SUD-16/HSD20/S1/FSL/NGO/1595,1/22/2018 9:20:46 AM,People in Host Communities,215,306,125,119,765,177,178,89,90,534
15,Sudan (UNDP),2016,SUD-16/HSD20/S1/FSL/UN/1622,1/22/2018 9:33:58 AM,Internally Displaced People,65560,68240,44600,44600,223000,65560,68240,44600,44600,223000
15,Sudan (UNDP),2016,SUD-16/HSD20/S1/FSL/UN/1622,1/22/2018 9:33:58 AM,Overall,118200,123000,80400,80400,402000,118200,123000,80400,80400,402000
15,Sudan (UNDP),2016,SUD-16/HSD20/S1/FSL/UN/1622,1/22/2018 9:33:58 AM,People in Host Communities,44700,46500,30400,30400,152000,44700,46500,30400,30400,152000
15,Sudan (UNDP),2016,SUD-16/HSD20/S1/FSL/UN/1622,1/22/2018 9:33:58 AM,Returnees,7940,8260,5400,5400,27000,7940,8260,5400,5400,27000
15,Sudan (UNDP),2016,SUD-16/HSD20/S1/H/INGO/1580,11/20/2017 7:15:20 AM,Internally Displaced People,5140,6119,6364,6853,24476,3455,4113,4278,4607,16453
15,Sudan (UNDP),2016,SUD-16/HSD20/S1/H/INGO/1580,11/20/2017 7:15:20 AM,Overall,34266,40793,42424,45688,163171,23035,27423,28519,30715,109692
15,Sudan (UNDP),2016,SUD-16/HSD20/S1/H/INGO/1580,11/20/2017 7:15:20 AM,Pastoralists,3769,4487,4667,5026,17949,2534,3017,3137,3378,12066
15,Sudan (UNDP),2016,SUD-16/HSD20/S1/H/INGO/1580,11/20/2017 7:15:20 AM,People in Host Communities,22273,26515,27576,29697,106061,14742,17551,18253,19657,70203
15,Sudan (UNDP),2016,SUD-16/HSD20/S1/H/INGO/1580,11/20/2017 7:15:20 AM,Returnees,3084,3671,3817,4112,14684,2304,2743,2852,3072,10971
15,Sudan (UNDP),2016,SUD-16/HSD20/S1/H/INGO/1590,11/21/2017 12:41:00 PM,Internally Displaced People,37714,36308,29705,28542,132269,32167,33505,22925,24956,113553
15,Sudan (UNDP),2016,SUD-16/HSD20/S1/H/INGO/1590,11/21/2017 12:41:00 PM,Overall,47142,49065,40142,38570,174919,44314,47101,24712,31476,147603
15,Sudan (UNDP),2016,SUD-16/HSD20/S1/H/INGO/1590,11/21/2017 12:41:00 PM,People in Host Communities,9428,12757,10437,10028,42650,7324,9675,7896,9155,34050
15,Sudan (UNDP),2016,SUD-16/HSD20/S1/H/INGO/1728,11/29/2017 1:16:49 PM,Children under 5,0,0,817,1225,2042,0,0,800,1199,1999
15,Sudan (UNDP),2016,SUD-16/HSD20/S1/H/INGO/1728,11/29/2017 1:16:49 PM,Internally Displaced People,4033,4302,2267,3937,14539,3480,6173,1240,3042,13935
15,Sudan (UNDP),2016,SUD-16/HSD20/S1/H/INGO/1728,11/29/2017 1:16:49 PM,Other,1827,2337,1316,649,6129,1500,2200,1220,650,5570
15,Sudan (UNDP),2016,SUD-16/HSD20/S1/H/INGO/1728,11/29/2017 1:16:49 PM,Overall,5860,7377,4400,5811,23448,4980,8123,4240,4891,22234
15,Sudan (UNDP),2016,SUD-16/HSD20/S1/H/INGO/1728,11/29/2017 1:16:49 PM,Women of Child-Bearing Age,0,738,0,0,738,0,730,0,0,730
15,Sudan (UNDP),2016,SUD-16/HSD20/S1/H/NGO/1589,1/3/2018 7:01:15 AM,Internally Displaced People,51131,55392,25266,27696,159485,75285,81558,37642,40779,235264
15,Sudan (UNDP),2016,SUD-16/HSD20/S1/H/NGO/1589,1/3/2018 7:01:15 AM,Overall,51131,55392,25266,27696,159485,75285,81558,37642,40779,235264
15,Sudan (UNDP),2016,SUD-16/HSD20/S1/H/NGO/1589,1/3/2018 7:01:15 AM,Returnees,0,0,0,0,0,14478,15333,10872,13707,54390
15,Sudan (UNDP),2016,SUD-16/HSD20/S1/H/NGO/1589,1/3/2018 7:01:15 AM,Women of Child-Bearing Age,0,0,0,0,0,0,4359,0,0,4359
15,Sudan (UNDP),2016,SUD-16/HSD20/S1/H/NGO/1779,11/20/2017 7:27:59 AM,Children under 5,0,0,4244,3918,8162,0,0,3007,3970,6977
15,Sudan (UNDP),2016,SUD-16/HSD20/S1/H/NGO/1779,11/20/2017 7:27:59 AM,Internally Displaced People,1756,1620,0,0,3376,450,761,0,0,1211
15,Sudan (UNDP),2016,SUD-16/HSD20/S1/H/NGO/1779,11/20/2017 7:27:59 AM,Overall,9128,13923,12005,12963,48019,7845,14762,8868,9971,41446
15,Sudan (UNDP),2016,SUD-16/HSD20/S1/H/NGO/1779,11/20/2017 7:27:59 AM,Pregnant and Lactating Women,0,0,0,0,0,0,828,0,0,828
15,Sudan (UNDP),2016,SUD-16/HSD20/S1/H/NGO/1779,11/20/2017 7:27:59 AM,Women of Child-Bearing Age,0,12244,0,0,12244,0,11740,0,0,11740
15,Sudan (UNDP),2016,SUD-16/HSD20/S1/H/UN/1732,10/22/2017 9:13:45 AM,Internally Displaced People,19831,21483,22363,23790,87467,18350,19250,21400,23500,82500
15,Sudan (UNDP),2016,SUD-16/HSD20/S1/H/UN/1732,10/22/2017 9:13:45 AM,Overall,101263,109701,109702,118842,439508,143000,147000,70000,75000,435000
15,Sudan (UNDP),2016,SUD-16/HSD20/S1/H/UN/1732,10/22/2017 9:13:45 AM,People in Host Communities,81010,87761,85933,95052,349756,124650,127750,45650,54450,352500
15,Sudan (UNDP),2016,SUD-16/HSD20/S1/H/UN/1733,12/10/2017 10:29:16 AM,Internally Displaced People,94990,91265,107117,102916,396288,95200,91750,106900,103090,396940
15,Sudan (UNDP),2016,SUD-16/HSD20/S1/H/UN/1733,12/10/2017 10:29:16 AM,Overall,119680,114986,134958,129666,499290,118950,116540,135781,130510,501781
15,Sudan (UNDP),2016,SUD-16/HSD20/S1/H/UN/1733,12/10/2017 10:29:16 AM,Returnees,24689,23720,27840,26749,102998,25400,22938,27930,26867,103135
15,Sudan (UNDP),2016,SUD-16/HSD20/S1/H-N/INGO/1632,11/29/2017 9:34:19 AM,Children under 5,0,0,53222,65050,118272,73121,88607,58429,68590,288747
15,Sudan (UNDP),2016,SUD-16/HSD20/S1/H-N/INGO/1632,11/29/2017 9:34:19 AM,Internally Displaced People,53722,66124,0,0,119846,0,0,96493,97139,193632
15,Sudan (UNDP),2016,SUD-16/HSD20/S1/H-N/INGO/1632,11/29/2017 9:34:19 AM,Overall,76745,94463,53222,65050,289480,114035,134367,96493,97139,442034
15,Sudan (UNDP),2016,SUD-16/HSD20/S1/H-N-WASH/INGO/1542,11/27/2017 8:12:47 AM,Children under 5,0,0,0,0,0,0,0,88323,88282,176605
15,Sudan (UNDP),2016,SUD-16/HSD20/S1/H-N-WASH/INGO/1542,11/27/2017 8:12:47 AM,Internally Displaced People,179155,175606,36694,35968,427423,76632,118922,52596,54898,303048
15,Sudan (UNDP),2016,SUD-16/HSD20/S1/H-N-WASH/INGO/1542,11/27/2017 8:12:47 AM,Overall,247484,242582,50689,49682,590437,110510,167252,88323,88282,454367
15,Sudan (UNDP),2016,SUD-16/HSD20/S1/H-N-WASH/INGO/1542,11/27/2017 8:12:47 AM,People in Host Communities,68329,0,0,0,68329,33878,48330,35727,33384,151319
15,Sudan (UNDP),2016,SUD-16/HSD20/S1/H-N-WASH/INGO/1542,11/27/2017 8:12:47 AM,Pregnant and Lactating Women,0,47235,0,0,47235,0,32856,0,0,32856
15,Sudan (UNDP),2016,SUD-16/HSD20/S1/H-N-WASH/INGO/1546,10/29/2017 1:07:40 PM,Children under 5,0,0,0,14050,14050,0,0,33016,32545,65561
15,Sudan (UNDP),2016,SUD-16/HSD20/S1/H-N-WASH/INGO/1546,10/29/2017 1:07:40 PM,Internally Displaced People,23424,22505,4798,0,50727,23424,22505,4798,4609,55336
15,Sudan (UNDP),2016,SUD-16/HSD20/S1/H-N-WASH/INGO/1546,10/29/2017 1:07:40 PM,Overall,71398,68599,14624,14050,168671,45725,48020,40297,34629,168671
15,Sudan (UNDP),2016,SUD-16/HSD20/S1/H-N-WASH/INGO/1546,10/29/2017 1:07:40 PM,Women of Child-Bearing Age,0,6747,0,0,6747,0,7196,0,0,7196
15,Sudan (UNDP),2016,SUD-16/HSD20/S1/H-P/UN/1674,2/11/2018 10:07:48 AM,Children under 18,0,0,300,8000,8300,0,0,300,7190,7490
15,Sudan (UNDP),2016,SUD-16/HSD20/S1/H-P/UN/1674,2/11/2018 10:07:48 AM,Other,0,0,0,0,0,500,0,0,0,500
15,Sudan (UNDP),2016,SUD-16/HSD20/S1/H-P/UN/1674,2/11/2018 10:07:48 AM,Overall,1500,21200,300,8000,31000,500,21040,200,7190,28930
15,Sudan (UNDP),2016,SUD-16/HSD20/S1/H-P/UN/1674,2/11/2018 10:07:48 AM,Women of Child-Bearing Age,0,21200,0,0,21200,0,21040,0,0,21040
15,Sudan (UNDP),2016,SUD-16/HSD20/S1/N/INGO/1534,10/26/2017 8:04:34 AM,Children under 5,0,0,5837,6151,11988,0,0,7509,8468,15977
15,Sudan (UNDP),2016,SUD-16/HSD20/S1/N/INGO/1534,10/26/2017 8:04:34 AM,Internally Displaced People,0,0,0,0,0,629,3991,6008,6774,17402
15,Sudan (UNDP),2016,SUD-16/HSD20/S1/N/INGO/1534,10/26/2017 8:04:34 AM,Overall,1578,6807,8197,9781,26363,825,4749,7509,8468,21551
15,Sudan (UNDP),2016,SUD-16/HSD20/S1/N/INGO/1534,10/26/2017 8:04:34 AM,People in Host Communities,1578,3680,2360,3630,11248,196,758,1501,1694,4149
15,Sudan (UNDP),2016,SUD-16/HSD20/S1/N/INGO/1534,10/26/2017 8:04:34 AM,Pregnant and Lactating Women,0,3127,0,0,3127,0,3991,0,0,3991
15,Sudan (UNDP),2016,SUD-16/HSD20/S1/N/INGO/1584,11/27/2017 8:50:44 AM,Children under 5,0,0,6152,6000,12152,0,0,15224,15845,31069
15,Sudan (UNDP),2016,SUD-16/HSD20/S1/N/INGO/1584,11/27/2017 8:50:44 AM,Overall,840,4337,6377,6225,17779,6536,29598,15224,13073,64431
15,Sudan (UNDP),2016,SUD-16/HSD20/S1/N/INGO/1584,11/27/2017 8:50:44 AM,Pastoralists,840,1210,225,225,2500,3536,2721,578,561,7396
15,Sudan (UNDP),2016,SUD-16/HSD20/S1/N/INGO/1584,11/27/2017 8:50:44 AM,Pregnant and Lactating Women,0,3127,0,0,3127,0,25966,0,0,25966
15,Sudan (UNDP),2016,SUD-16/HSD20/S1/N/INGO/1635,11/5/2017 10:11:09 AM,Children under 5,0,0,3644,3644,7288,0,0,771,1085,1856
15,Sudan (UNDP),2016,SUD-16/HSD20/S1/N/INGO/1635,11/5/2017 10:11:09 AM,Internally Displaced People,2141,4578,0,0,6719,1481,7730,0,0,9211
15,Sudan (UNDP),2016,SUD-16/HSD20/S1/N/INGO/1635,11/5/2017 10:11:09 AM,Overall,2141,4578,3644,3644,14007,1481,8725,771,1085,12062
15,Sudan (UNDP),2016,SUD-16/HSD20/S1/N/INGO/1635,11/5/2017 10:11:09 AM,Pregnant and Lactating Women,0,0,0,0,0,0,995,0,0,995
15,Sudan (UNDP),2016,SUD-16/HSD20/S1/N/INGO/1700,1/22/2018 9:01:12 AM,Children under 5,0,0,4463,4462,8925,0,0,20094,20952,41046
15,Sudan (UNDP),2016,SUD-16/HSD20/S1/N/INGO/1700,1/22/2018 9:01:12 AM,Overall,2055,9767,4463,4462,20747,3420,9981,20094,20952,54447
15,Sudan (UNDP),2016,SUD-16/HSD20/S1/N/INGO/1700,1/22/2018 9:01:12 AM,Pregnant and Lactating Women,0,1255,0,0,1255,0,1324,0,0,1324
15,Sudan (UNDP),2016,SUD-16/HSD20/S1/N/INGO/1700,1/22/2018 9:01:12 AM,"Trainers, Promoters, Caretakers, committee members, etc.",30,30,0,0,60,44,94,0,0,138
15,Sudan (UNDP),2016,SUD-16/HSD20/S1/N/NGO/1598,11/21/2017 7:20:38 AM,Children under 5,0,0,637,663,1300,1239,1285,111,142,2777
15,Sudan (UNDP),2016,SUD-16/HSD20/S1/N/NGO/1598,11/21/2017 7:20:38 AM,Other,1000,900,0,0,1900,1239,1285,111,142,2777
15,Sudan (UNDP),2016,SUD-16/HSD20/S1/N/NGO/1598,11/21/2017 7:20:38 AM,Overall,1015,915,637,663,3230,1239,1285,111,142,2777
15,Sudan (UNDP),2016,SUD-16/HSD20/S1/N/NGO/1598,11/21/2017 7:20:38 AM,"Staff (own or partner staff, authorities)",5,5,0,0,10,5,5,0,0,10
15,Sudan (UNDP),2016,SUD-16/HSD20/S1/N/NGO/1598,11/21/2017 7:20:38 AM,"Trainers, Promoters, Caretakers, committee members, etc.",10,10,0,0,20,10,10,0,0,20
15,Sudan (UNDP),2016,SUD-16/HSD20/S1/N/NGO/1663,10/24/2017 8:28:27 AM,Children under 5,0,0,18390,19528,37918,0,0,15913,17149,33062
15,Sudan (UNDP),2016,SUD-16/HSD20/S1/N/NGO/1663,10/24/2017 8:28:27 AM,Overall,174,60093,18390,19528,98185,162,89358,15913,17149,122582
15,Sudan (UNDP),2016,SUD-16/HSD20/S1/N/NGO/1663,10/24/2017 8:28:27 AM,"Trainers, Promoters, Caretakers, committee members, etc.",174,280,0,0,454,162,296,0,0,458
15,Sudan (UNDP),2016,SUD-16/HSD20/S1/N/NGO/1663,10/24/2017 8:28:27 AM,Women of Child-Bearing Age,0,59813,0,0,59813,0,89062,0,0,89062
15,Sudan (UNDP),2016,SUD-16/HSD20/S1/N/NGO/1707,11/22/2017 12:44:43 PM,Children under 5,0,0,1326,1274,2600,0,0,14372,14840,29212
15,Sudan (UNDP),2016,SUD-16/HSD20/S1/N/NGO/1707,11/22/2017 12:44:43 PM,Committees,80,40,0,0,120,136,64,0,0,200
15,Sudan (UNDP),2016,SUD-16/HSD20/S1/N/NGO/1707,11/22/2017 12:44:43 PM,Overall,5331,5122,1326,1274,13053,2888,3884,14372,14840,35984
15,Sudan (UNDP),2016,SUD-16/HSD20/S1/N/NGO/1707,11/22/2017 12:44:43 PM,Pregnant and Lactating Women,0,43,0,0,43,0,46,0,0,46
15,Sudan (UNDP),2016,SUD-16/HSD20/S1/N/NGO/1708,10/24/2017 10:09:42 AM,Children under 5,0,0,7250,7250,14500,0,0,5595,5943,11538
15,Sudan (UNDP),2016,SUD-16/HSD20/S1/N/NGO/1708,10/24/2017 10:09:42 AM,Internally Displaced People,620,300,300,300,1520,900,828,0,0,1728
15,Sudan (UNDP),2016,SUD-16/HSD20/S1/N/NGO/1708,10/24/2017 10:09:42 AM,Overall,1020,5680,7650,7650,22000,1537,9063,5595,5943,22138
15,Sudan (UNDP),2016,SUD-16/HSD20/S1/N/NGO/1708,10/24/2017 10:09:42 AM,People in Host Communities,400,100,100,100,700,637,552,0,0,1189
15,Sudan (UNDP),2016,SUD-16/HSD20/S1/N/NGO/1708,10/24/2017 10:09:42 AM,Pregnant and Lactating Women,0,5280,0,0,5280,0,7683,0,0,7683
15,Sudan (UNDP),2016,SUD-16/HSD20/S1/N/NGO/1744,10/26/2017 12:38:10 PM,Children under 5,0,0,1624,1624,3248,0,0,1125,152,1277
15,Sudan (UNDP),2016,SUD-16/HSD20/S1/N/NGO/1744,10/26/2017 12:38:10 PM,Internally Displaced People,350,500,900,900,2650,80,130,200,290,700
15,Sudan (UNDP),2016,SUD-16/HSD20/S1/N/NGO/1744,10/26/2017 12:38:10 PM,Overall,500,2264,4784,4784,12332,220,430,300,600,1550
15,Sudan (UNDP),2016,SUD-16/HSD20/S1/N/NGO/1744,10/26/2017 12:38:10 PM,Pregnant and Lactating Women,0,1500,0,0,1500,0,1225,0,0,1225
15,Sudan (UNDP),2016,SUD-16/HSD20/S1/N/NGO/1744,10/26/2017 12:38:10 PM,"Trainers, Promoters, Caretakers, committee members, etc.",50,50,0,0,100,0,0,0,0,0
15,Sudan (UNDP),2016,SUD-16/HSD20/S1/N/UN/1544,10/26/2017 9:06:58 AM,Children under 5,0,0,2040,1960,4000,0,0,2049,1956,4005
15,Sudan (UNDP),2016,SUD-16/HSD20/S1/N/UN/1544,10/26/2017 9:06:58 AM,Overall,0,0,2040,1960,4000,0,0,2049,1956,4005
15,Sudan (UNDP),2016,SUD-16/HSD20/S1/N/UN/1666,10/17/2017 8:17:58 AM,Children under 5,0,0,6829,6562,13391,0,0,6829,6562,13391
15,Sudan (UNDP),2016,SUD-16/HSD20/S1/N/UN/1666,10/17/2017 8:17:58 AM,Overall,0,0,6829,6562,13391,0,0,6829,6562,13391
15,Sudan (UNDP),2016,SUD-16/HSD20/S1/N/UN/1729,10/17/2017 9:26:42 AM,Children under 5,0,0,4200,4200,8400,0,0,4116,4284,8400
15,Sudan (UNDP),2016,SUD-16/HSD20/S1/N/UN/1729,10/17/2017 9:26:42 AM,Overall,0,0,4200,4200,8400,0,0,4116,4284,8400
15,Sudan (UNDP),2016,SUD-16/HSD20/S1/N/UN/1737,1/3/2018 6:35:40 AM,Overall,260,520,700,650,2130,679,1512,1604,1736,5531
15,Sudan (UNDP),2016,SUD-16/HSD20/S1/N/UN/1737,1/3/2018 6:35:40 AM,People in Host Communities,201,451,699,649,2000,5000,10000,9227,9603,33830
15,Sudan (UNDP),2016,SUD-16/HSD20/S1/N/UN/1737,1/3/2018 6:35:40 AM,"Trainers, Promoters, Caretakers, committee members, etc.",59,69,0,0,128,60,70,0,0,130
15,Sudan (UNDP),2016,SUD-16/HSD20/S1/N-H-FSL-WASH/NGO/1743,2/6/2018 2:29:49 PM,Children under 5,0,0,8000,9639,17639,0,0,6242,8615,14857
15,Sudan (UNDP),2016,SUD-16/HSD20/S1/N-H-FSL-WASH/NGO/1743,2/6/2018 2:29:49 PM,Other,11150,15744,25400,27600,79894,9812,1271,19558,24012,54653
15,Sudan (UNDP),2016,SUD-16/HSD20/S1/N-H-FSL-WASH/NGO/1743,2/6/2018 2:29:49 PM,Overall,11150,21970,33400,37239,103759,9812,21311,25718,32398,89239
15,Sudan (UNDP),2016,SUD-16/HSD20/S1/N-H-FSL-WASH/NGO/1743,2/6/2018 2:29:49 PM,Pregnant and Lactating Women,0,6226,0,0,6226,0,5728,0,0,5728
15,Sudan (UNDP),2016,SUD-16/HSD20/S1/N-H-WASH-FSL/INGO/1646,1/3/2018 7:17:55 AM,Children under 5,0,0,9924,10329,20253,0,0,8096,7336,15432
15,Sudan (UNDP),2016,SUD-16/HSD20/S1/N-H-WASH-FSL/INGO/1646,1/3/2018 7:17:55 AM,Other,25315,12151,10328,9924,57718,21875,11872,9831,9781,53359
15,Sudan (UNDP),2016,SUD-16/HSD20/S1/N-H-WASH-FSL/INGO/1646,1/3/2018 7:17:55 AM,Overall,25315,35441,20252,20253,101261,22507,32809,18265,17482,91063
15,Sudan (UNDP),2016,SUD-16/HSD20/S1/N-H-WASH-FSL/INGO/1646,1/3/2018 7:17:55 AM,Women of Child-Bearing Age,0,23290,0,0,23290,0,19812,0,0,19812
15,Sudan (UNDP),2016,SUD-16/HSD20/S1/P/INGO/3276,2/6/2018 1:32:57 PM,Overall,30,30,0,0,60,26,30,0,0,56
15,Sudan (UNDP),2016,SUD-16/HSD20/S1/P/INGO/3276,2/6/2018 1:32:57 PM,"Staff (own or partner staff, authorities)",30,30,0,0,60,26,30,0,0,56
15,Sudan (UNDP),2016,SUD-16/HSD20/S1/P/NGO/1558,12/11/2017 1:15:45 PM,Internally Displaced People/Returnees,4001,17963,5253,5930,33147,3449,8422,2210,2323,16404
15,Sudan (UNDP),2016,SUD-16/HSD20/S1/P/NGO/1558,12/11/2017 1:15:45 PM,Overall,6159,27636,8082,9123,51000,6965,29372,8746,9603,54686
15,Sudan (UNDP),2016,SUD-16/HSD20/S1/P/NGO/1558,12/11/2017 1:15:45 PM,People in Host Communities,618,2764,800,913,5095,3004,7005,5646,6210,21865
15,Sudan (UNDP),2016,SUD-16/HSD20/S1/P/NGO/1558,12/11/2017 1:15:45 PM,Returnees,1540,6909,2029,2280,12758,512,2536,920,1070,5038
15,Sudan (UNDP),2016,SUD-16/HSD20/S1/P/NGO/1574,10/9/2017 12:34:44 PM,Internally Displaced People/Returnees,8000,9400,10900,10950,39250,8329,9471,11169,11232,40201
15,Sudan (UNDP),2016,SUD-16/HSD20/S1/P/NGO/1574,10/9/2017 12:34:44 PM,Overall,12500,13000,14500,14500,54500,13159,13141,15038,15064,56402
15,Sudan (UNDP),2016,SUD-16/HSD20/S1/P/NGO/1574,10/9/2017 12:34:44 PM,People in Host Communities,4500,3600,3600,3550,15250,4830,3670,3869,3832,16201
15,Sudan (UNDP),2016,SUD-16/HSD20/S1/P/NGO/1603,11/19/2017 9:46:21 AM,Children under 18,0,0,200,0,200,0,0,250,0,250
15,Sudan (UNDP),2016,SUD-16/HSD20/S1/P/NGO/1603,11/19/2017 9:46:21 AM,Internally Displaced People/Returnees,2440,2410,2625,2525,10000,3600,3386,2292,8700,17978
15,Sudan (UNDP),2016,SUD-16/HSD20/S1/P/NGO/1603,11/19/2017 9:46:21 AM,Overall,3788,3720,4073,3919,15500,4800,4515,3055,11600,23970
15,Sudan (UNDP),2016,SUD-16/HSD20/S1/P/NGO/1711,11/20/2017 7:33:27 AM,Children under 18,0,0,4011,6908,10919,2675,17086,4011,6910,30682
15,Sudan (UNDP),2016,SUD-16/HSD20/S1/P/NGO/1711,11/20/2017 7:33:27 AM,Children under 5,0,0,880,1440,2320,0,0,880,1440,2320
15,Sudan (UNDP),2016,SUD-16/HSD20/S1/P/NGO/1711,11/20/2017 7:33:27 AM,Internally Displaced People,2675,17086,0,0,19761,2690,17102,880,1440,22112
15,Sudan (UNDP),2016,SUD-16/HSD20/S1/P/NGO/1711,11/20/2017 7:33:27 AM,Overall,2715,17126,4891,8348,33080,2730,17142,4891,8350,33113
15,Sudan (UNDP),2016,SUD-16/HSD20/S1/P/NGO/1711,11/20/2017 7:33:27 AM,"Trainers, Promoters, Caretakers, committee members, etc.",40,40,0,0,80,40,40,0,0,80
15,Sudan (UNDP),2016,SUD-16/HSD20/S1/P/NGO/1730,11/19/2017 12:10:20 PM,Internally Displaced People,373,450,965,940,2728,684,541,1265,1170,3660
15,Sudan (UNDP),2016,SUD-16/HSD20/S1/P/NGO/1730,11/19/2017 12:10:20 PM,Overall,523,583,1385,1345,3836,1095,929,1890,987,4901
15,Sudan (UNDP),2016,SUD-16/HSD20/S1/P/NGO/1730,11/19/2017 12:10:20 PM,People in Host Communities,150,133,420,385,1088,260,242,420,385,1307
15,Sudan (UNDP),2016,SUD-16/HSD20/S1/P/UN/1715,1/7/2018 12:18:27 PM,Committees,160,160,0,0,320,250,213,0,0,463
15,Sudan (UNDP),2016,SUD-16/HSD20/S1/P/UN/1715,1/7/2018 12:18:27 PM,Internally Displaced People/Returnees,5200,12000,6300,7600,31100,7487,9152,10732,13227,40598
15,Sudan (UNDP),2016,SUD-16/HSD20/S1/P/UN/1715,1/7/2018 12:18:27 PM,Overall,5768,13768,6600,7950,34086,7960,9707,11056,13537,42260
15,Sudan (UNDP),2016,SUD-16/HSD20/S1/P/UN/1715,1/7/2018 12:18:27 PM,People in Host Communities,400,1500,300,350,2550,253,264,323,311,1151
15,Sudan (UNDP),2016,SUD-16/HSD20/S1/P/UN/1715,1/7/2018 12:18:27 PM,"Trainers, Promoters, Caretakers, committee members, etc.",8,8,0,0,16,22,26,0,0,48
15,Sudan (UNDP),2016,SUD-16/HSD20/S1/P/UN/1741,11/26/2017 6:55:53 AM,Children under 18,0,0,9562,14342,23904,0,0,12673,11590,24263
15,Sudan (UNDP),2016,SUD-16/HSD20/S1/P/UN/1741,11/26/2017 6:55:53 AM,Internally Displaced People,2390,3586,0,0,5976,1105,1236,12673,11590,26604
15,Sudan (UNDP),2016,SUD-16/HSD20/S1/P/UN/1741,11/26/2017 6:55:53 AM,Overall,2390,3586,9562,14342,29880,1114,1296,12673,11590,26673
15,Sudan (UNDP),2016,SUD-16/HSD20/S1/P/UN/1777,11/22/2017 11:34:49 AM,Children under 18,0,0,32500,42500,75000,0,0,32500,42500,75000
15,Sudan (UNDP),2016,SUD-16/HSD20/S1/P/UN/1777,11/22/2017 11:34:49 AM,Internally Displaced People,5630,13120,0,0,18750,5630,13120,0,0,18750
15,Sudan (UNDP),2016,SUD-16/HSD20/S1/P/UN/1777,11/22/2017 11:34:49 AM,Overall,5630,13120,32500,42500,93750,5630,13120,32500,42500,93750
15,Sudan (UNDP),2016,SUD-16/HSD20/S1/P-ESNFIs/NGO/1535,12/11/2017 1:36:53 PM,Children under 18,0,0,2550,3450,6000,0,0,1767,2083,3850
15,Sudan (UNDP),2016,SUD-16/HSD20/S1/P-ESNFIs/NGO/1535,12/11/2017 1:36:53 PM,Committees,104,156,0,0,260,80,80,0,0,160
15,Sudan (UNDP),2016,SUD-16/HSD20/S1/P-ESNFIs/NGO/1535,12/11/2017 1:36:53 PM,Other,2256,4260,4024,4500,15040,2000,5900,3100,4000,15000
15,Sudan (UNDP),2016,SUD-16/HSD20/S1/P-ESNFIs/NGO/1535,12/11/2017 1:36:53 PM,Overall,4588,7648,8260,10094,30590,2080,5980,4867,6083,19010
15,Sudan (UNDP),2016,SUD-16/HSD20/S1/P-ESNFIs/NGO/1536,11/21/2017 1:09:47 PM,Children under 5,0,0,779,1448,2227,0,0,1000,1400,2400
15,Sudan (UNDP),2016,SUD-16/HSD20/S1/P-ESNFIs/NGO/1536,11/21/2017 1:09:47 PM,Committees,78,87,0,0,165,78,87,0,0,165
15,Sudan (UNDP),2016,SUD-16/HSD20/S1/P-ESNFIs/NGO/1536,11/21/2017 1:09:47 PM,Overall,1780,2220,2900,3100,10000,2112,1805,4199,3711,11827
15,Sudan (UNDP),2016,SUD-16/HSD20/S1/P-ESNFIs/NGO/1536,11/21/2017 1:09:47 PM,People in Host Communities,450,350,500,700,2000,450,350,500,700,2000
15,Sudan (UNDP),2016,SUD-16/HSD20/S1/P-ESNFIs/NGO/1536,11/21/2017 1:09:47 PM,Pregnant and Lactating Women,0,850,0,0,850,0,1700,0,0,1700
15,Sudan (UNDP),2016,SUD-16/HSD20/S1/P-N-WASH-E-ESNFIs-H-RMS/NGO/1764,5/7/2018 12:20:38 PM,Children under 5,0,0,5673,6712,12385,0,0,0,0,0
15,Sudan (UNDP),2016,SUD-16/HSD20/S1/P-N-WASH-E-ESNFIs-H-RMS/NGO/1764,5/7/2018 12:20:38 PM,Internally Displaced People,12477,18723,14635,19635,65470,0,0,0,0,0
15,Sudan (UNDP),2016,SUD-16/HSD20/S1/P-N-WASH-E-ESNFIs-H-RMS/NGO/1764,5/7/2018 12:20:38 PM,Overall,12477,23548,20308,27947,84280,13676,27608,24560,31370,97214
15,Sudan (UNDP),2016,SUD-16/HSD20/S1/P-N-WASH-E-ESNFIs-H-RMS/NGO/1764,5/7/2018 12:20:38 PM,Pregnant and Lactating Women,0,4825,0,1229,6054,0,0,0,0,0
15,Sudan (UNDP),2016,SUD-16/HSD20/S1/P-N-WASH-E-ESNFIs-H-RMS/NGO/1764,5/7/2018 12:20:38 PM,Women of Child-Bearing Age,0,0,0,371,371,0,0,0,0,0
15,Sudan (UNDP),2016,SUD-16/HSD20/S1/RMS/INGO/1649,10/17/2017 6:59:13 AM,Children under 18,0,0,0,0,0,0,0,14735,13769,28504
15,Sudan (UNDP),2016,SUD-16/HSD20/S1/RMS/INGO/1649,10/17/2017 6:59:13 AM,Overall,3000,6000,1400,2100,12500,698,1396,14735,13769,30598
15,Sudan (UNDP),2016,SUD-16/HSD20/S1/RMS/INGO/1649,10/17/2017 6:59:13 AM,People in Host Communities,2400,4800,1120,1680,10000,44,51,1000,700,1795
15,Sudan (UNDP),2016,SUD-16/HSD20/S1/RMS/NGO/1559,1/7/2018 12:57:36 PM,Other,41,458,2350,2650,5499,142,630,1696,3360,5828
15,Sudan (UNDP),2016,SUD-16/HSD20/S1/RMS/NGO/1559,1/7/2018 12:57:36 PM,Overall,41,458,2350,2650,5499,142,630,1696,3360,5828
15,Sudan (UNDP),2016,SUD-16/HSD20/S1/RMS/NGO/1631,10/16/2017 9:14:42 AM,Other,7,12,2600,2900,5519,51,9,5587,4448,10095
15,Sudan (UNDP),2016,SUD-16/HSD20/S1/RMS/NGO/1631,10/16/2017 9:14:42 AM,Overall,14,22,3074,3672,6782,60,15,5723,4535,10333
15,Sudan (UNDP),2016,SUD-16/HSD20/S1/RMS/NGO/1631,10/16/2017 9:14:42 AM,People in Host Communities,7,10,474,772,1263,9,6,136,87,238
15,Sudan (UNDP),2016,SUD-16/HSD20/S1/RMS/NGO/1694,10/17/2017 11:30:12 AM,Other,2545,5468,1654,2146,11813,2545,5468,1654,2146,11813
15,Sudan (UNDP),2016,SUD-16/HSD20/S1/RMS/NGO/1694,10/17/2017 11:30:12 AM,Overall,2545,5468,1654,2146,11813,2545,5468,1654,2146,11813
15,Sudan (UNDP),2016,SUD-16/HSD20/S1/RMS/NGO/1721,11/29/2017 7:38:57 AM,Children under 5,0,0,2073,2418,4491,0,0,3098,3308,6406
15,Sudan (UNDP),2016,SUD-16/HSD20/S1/RMS/NGO/1721,11/29/2017 7:38:57 AM,Overall,2075,2768,4274,5020,14137,4095,7089,7470,8539,27193
15,Sudan (UNDP),2016,SUD-16/HSD20/S1/RMS/NGO/1721,11/29/2017 7:38:57 AM,People in Host Communities,549,582,352,465,1948,0,0,0,0,0
15,Sudan (UNDP),2016,SUD-16/HSD20/S1/RMS/NGO/1721,11/29/2017 7:38:57 AM,Pregnant and Lactating Women,0,1999,0,0,1999,0,1628,0,0,1628
15,Sudan (UNDP),2016,SUD-16/HSD20/S1/RMS/UN/1624,12/21/2017 11:41:38 AM,Overall,2035,3682,1938,2035,9690,2035,3682,1938,2035,9690
15,Sudan (UNDP),2016,SUD-16/HSD20/S1/RMS/UN/1624,12/21/2017 11:41:38 AM,People in Host Communities,75,99,63,63,300,75,99,63,63,300
15,Sudan (UNDP),2016,SUD-16/HSD20/S1/RMS/UN/1675,10/15/2017 7:18:36 AM,Overall,355,6719,100,3256,10430,255,6585,65,2000,8905
15,Sudan (UNDP),2016,SUD-16/HSD20/S1/RMS/UN/1687,10/9/2017 10:32:11 AM,Overall,3362,10088,0,0,13450,3662,10088,0,0,13750
15,Sudan (UNDP),2016,SUD-16/HSD20/S1/RMS/UN/1760,10/15/2017 6:50:49 AM,Committees,731,760,1096,1140,3727,731,760,1096,1140,3727
15,Sudan (UNDP),2016,SUD-16/HSD20/S1/RMS/UN/1760,10/15/2017 6:50:49 AM,Other,4204,4375,6306,6562,21447,13874,14837,20854,21208,70773
15,Sudan (UNDP),2016,SUD-16/HSD20/S1/RMS/UN/1760,10/15/2017 6:50:49 AM,Overall,4935,5135,7402,7702,25174,14605,15597,21950,22348,74500
15,Sudan (UNDP),2016,SUD-16/HSD20/S1/WASH/INGO/1550,10/11/2017 11:59:30 AM,Internally Displaced People,17003,21042,20286,20769,79100,17971,21466,18451,18644,76532
15,Sudan (UNDP),2016,SUD-16/HSD20/S1/WASH/INGO/1550,10/11/2017 11:59:30 AM,Overall,17003,21042,20286,20769,79100,17971,21466,18451,18644,76532
15,Sudan (UNDP),2016,SUD-16/HSD20/S1/WASH/INGO/1575,10/9/2017 7:19:46 AM,Internally Displaced People,4157,4595,985,1205,10942,4157,4504,975,1190,10826
15,Sudan (UNDP),2016,SUD-16/HSD20/S1/WASH/INGO/1575,10/9/2017 7:19:46 AM,Overall,13859,15318,3282,4013,36472,13859,15318,3282,4013,36472
15,Sudan (UNDP),2016,SUD-16/HSD20/S1/WASH/INGO/1575,10/9/2017 7:19:46 AM,Pastoralists,3188,3523,755,923,8389,3187,3453,747,913,8300
15,Sudan (UNDP),2016,SUD-16/HSD20/S1/WASH/INGO/1575,10/9/2017 7:19:46 AM,People in Host Communities,4435,4902,1050,1284,11671,4435,4804,1040,1269,11548
15,Sudan (UNDP),2016,SUD-16/HSD20/S1/WASH/INGO/1575,10/9/2017 7:19:46 AM,Returnees,2079,2298,492,601,5470,2080,2252,487,596,5415
15,Sudan (UNDP),2016,SUD-16/HSD20/S1/WASH/INGO/1579,1/7/2018 12:41:39 PM,Overall,3886,3778,3211,2969,13844,932,905,1456,1538,4831
15,Sudan (UNDP),2016,SUD-16/HSD20/S1/WASH/INGO/1579,1/7/2018 12:41:39 PM,People in Host Communities,2085,1871,1590,1515,7061,457,443,713,754,2367
15,Sudan (UNDP),2016,SUD-16/HSD20/S1/WASH/INGO/1579,1/7/2018 12:41:39 PM,Returnees,1801,1907,1621,1454,6783,475,462,743,784,2464
15,Sudan (UNDP),2016,SUD-16/HSD20/S1/WASH/INGO/1582,10/31/2017 12:01:05 PM,Internally Displaced People,3197,5711,7786,13792,30486,1469,2623,3576,3820,11488
15,Sudan (UNDP),2016,SUD-16/HSD20/S1/WASH/INGO/1582,10/31/2017 12:01:05 PM,Overall,11209,20020,27293,29159,87681,10301,18399,25083,26797,80580
15,Sudan (UNDP),2016,SUD-16/HSD20/S1/WASH/INGO/1582,10/31/2017 12:01:05 PM,Returnees,8012,14309,19507,15367,57195,8832,15776,21507,22977,69092
15,Sudan (UNDP),2016,SUD-16/HSD20/S1/WASH/INGO/1712,10/9/2017 7:55:59 AM,Internally Displaced People,53606,51462,60154,49204,214426,54606,52422,61274,50124,218426
15,Sudan (UNDP),2016,SUD-16/HSD20/S1/WASH/INGO/1712,10/9/2017 7:55:59 AM,Overall,57366,55072,64365,52663,229466,58366,56032,65485,53583,233466
15,Sudan (UNDP),2016,SUD-16/HSD20/S1/WASH/INGO/1712,10/9/2017 7:55:59 AM,People in Host Communities,3760,3610,4211,3459,15040,3760,3610,4211,3459,15040
15,Sudan (UNDP),2016,SUD-16/HSD20/S1/WASH/NGO/1626,11/2/2017 7:00:44 AM,Children under 18,0,0,0,0,0,7389,9998,11736,14344,43467
15,Sudan (UNDP),2016,SUD-16/HSD20/S1/WASH/NGO/1626,11/2/2017 7:00:44 AM,Internally Displaced People,7389,9998,11736,14344,43467,7389,9998,11736,14344,43467
15,Sudan (UNDP),2016,SUD-16/HSD20/S1/WASH/NGO/1626,11/2/2017 7:00:44 AM,Overall,7389,9998,11736,14344,43467,7389,9998,11736,14344,43467
15,Sudan (UNDP),2016,SUD-16/HSD20/S1/WASH/NGO/1726,1/7/2018 1:06:36 PM,Internally Displaced People,1020,1080,1620,2280,6000,1020,1080,1620,2280,6000
15,Sudan (UNDP),2016,SUD-16/HSD20/S1/WASH/NGO/1726,1/7/2018 1:06:36 PM,Overall,5538,5864,8796,12379,32577,5538,5864,8796,12379,32577
15,Sudan (UNDP),2016,SUD-16/HSD20/S1/WASH/NGO/1726,1/7/2018 1:06:36 PM,People in Host Communities,4518,4784,7176,10099,26577,4518,4784,7176,10099,26577
15,Sudan (UNDP),2016,SUD-16/HSD20/S1/WASH/UN/1556,2/12/2017 12:21:13 PM,Internally Displaced People,142640,203280,118440,121640,586000,142440,203080,118240,121440,585200
15,Sudan (UNDP),2016,SUD-16/HSD20/S1/WASH/UN/1556,2/12/2017 12:21:13 PM,Internally Displaced People/Returnees,10960,27120,7000,8920,54000,10960,27120,7000,8920,54000
15,Sudan (UNDP),2016,SUD-16/HSD20/S1/WASH/UN/1556,2/12/2017 12:21:13 PM,Overall,153600,230400,125440,130560,640000,153400,230200,125240,130360,639200
15,Sudan (UNDP),2016,SUD-16/HSD20/S1/WASH/UN/1602,2/11/2018 10:36:32 AM,Internally Displaced People,1027,1473,0,0,2500,5951,6710,0,0,12661
15,Sudan (UNDP),2016,SUD-16/HSD20/S1/WASH/UN/1602,2/11/2018 10:36:32 AM,Overall,1027,1473,0,0,2500,6476,7303,0,0,13779
15,Sudan (UNDP),2016,SUD-16/HSD20/S1/WASH/UN/1746,4/5/2017 2:03:48 PM,Children under 18,0,0,29400,30600,60000,0,0,97712,101700,199412
15,Sudan (UNDP),2016,SUD-16/HSD20/S1/WASH/UN/1746,4/5/2017 2:03:48 PM,Children under 5,0,0,14700,15300,30000,0,0,48856,50850,99706
15,Sudan (UNDP),2016,SUD-16/HSD20/S1/WASH/UN/1746,4/5/2017 2:03:48 PM,Internally Displaced People,29403,30597,0,0,60000,31892,33188,0,0,65080
15,Sudan (UNDP),2016,SUD-16/HSD20/S1/WASH/UN/1746,4/5/2017 2:03:48 PM,Overall,29403,30597,44100,45900,150000,97723,101685,146585,152537,498530
15,Sudan (UNDP),2016,SUD-16/HSD20/S1/WASH-N/INGO/1633,10/30/2017 8:00:23 AM,Children under 5,0,0,0,0,0,0,0,4113,3952,8065
15,Sudan (UNDP),2016,SUD-16/HSD20/S1/WASH-N/INGO/1633,10/30/2017 8:00:23 AM,Internally Displaced People,7253,14636,13601,14270,49760,10998,17859,14273,15202,58332
15,Sudan (UNDP),2016,SUD-16/HSD20/S1/WASH-N/INGO/1633,10/30/2017 8:00:23 AM,Overall,7253,20347,15794,16646,60040,9490,18890,18527,20222,67129
15,Sudan (UNDP),2016,SUD-16/HSD20/S1/WASH-N/INGO/1633,10/30/2017 8:00:23 AM,People in Host Communities,0,5711,2193,2376,10280,13,3500,2114,3170,8797
15,Sudan (UNDP),2016,SUD-16/HSD20/S1/WASH-N/INGO/1633,10/30/2017 8:00:23 AM,Pregnant and Lactating Women,0,0,0,0,0,0,3604,0,0,3604
15,Sudan (UNDP),2017,SUD-17/HSD20/R/CCS/UN/4740,12/26/2018 6:15:36 AM,Internally Displaced People/Returnees,40425,50225,78400,75950,245000,24559,28694,31773,32974,118000
15,Sudan (UNDP),2017,SUD-17/HSD20/R/CCS/UN/4740,12/26/2018 6:15:36 AM,Overall,40425,50225,78400,75950,245000,53568,76762,97247,97662,325239
15,Sudan (UNDP),2017,SUD-17/HSD20/R/CCS/UN/4741,5/7/2018 12:10:08 PM,Other,0,1,0,0,1,0,0,0,0,0
15,Sudan (UNDP),2017,SUD-17/HSD20/R/CCS/UN/4741,5/7/2018 12:10:08 PM,Overall,0,1,0,0,1,0,1,0,0,1
15,Sudan (UNDP),2017,SUD-17/HSD20/R/CCS/UN/4742,5/29/2018 9:32:28 AM,Other,0,1,0,0,1,0,0,0,0,0
15,Sudan (UNDP),2017,SUD-17/HSD20/R/CCS/UN/4742,5/29/2018 9:32:28 AM,Overall,0,1,0,0,1,0,1,0,0,1
15,Sudan (UNDP),2017,SUD-17/HSD20/R/CCS/UN/4743,5/7/2018 11:27:51 AM,Overall,256846,267329,56381,58682,639238,256846,267329,56381,58682,639238
15,Sudan (UNDP),2017,SUD-17/HSD20/R/CCS/UN/4744,10/2/2018 10:47:14 AM,Internally Displaced People/Returnees,64879,67527,27805,28940,189151,0,0,0,0,0
15,Sudan (UNDP),2017,SUD-17/HSD20/R/CCS/UN/4744,10/2/2018 10:47:14 AM,Overall,108131,112545,46342,48234,315252,0,0,0,0,0
15,Sudan (UNDP),2017,SUD-17/HSD20/R/CCS/UN/4744,10/2/2018 10:47:14 AM,People from Riverine Communities,43252,45018,18537,19294,126101,0,0,0,0,0
15,Sudan (UNDP),2017,SUD-17/HSD20/R/CCS/UN/4746,4/12/2018 9:04:17 AM,Internally Displaced People,291380,356131,437070,534196,1618777,291380,356131,437070,534196,1618777
15,Sudan (UNDP),2017,SUD-17/HSD20/R/CCS/UN/4746,4/12/2018 9:04:17 AM,Other,110188,134674,165283,202011,612156,110188,134674,165283,202011,612156
15,Sudan (UNDP),2017,SUD-17/HSD20/R/CCS/UN/4746,4/12/2018 9:04:17 AM,Overall,439230,536835,658792,805253,2440110,439230,536835,658792,805253,2440110
15,Sudan (UNDP),2017,SUD-17/HSD20/R/CCS/UN/4746,4/12/2018 9:04:17 AM,Returnees,37662,46030,56439,69046,209177,37662,46030,56439,69046,209177
15,Sudan (UNDP),2017,SUD-17/HSD20/R/FSL/UN/7337,6/16/2019 9:31:21 AM,Overall,3710,4385,4216,4554,16865,2808,3610,3209,3744,13371
15,Sudan (UNDP),2017,SUD-17/HSD20/R/H/INGO/7334,6/16/2019 9:15:12 AM,Overall,1224,1326,1176,1274,5000,1149,1245,1104,1195,4693
15,Sudan (UNDP),2017,SUD-17/HSD20/R/H/NGO/6247,10/24/2018 9:58:56 AM,Children under 5,0,0,3500,4000,7500,0,0,3457,3520,6977
15,Sudan (UNDP),2017,SUD-17/HSD20/R/H/NGO/6247,10/24/2018 9:58:56 AM,Overall,8000,16000,14400,21600,60000,1168,13671,7671,7536,30046
15,Sudan (UNDP),2017,SUD-17/HSD20/R/H/NGO/6247,10/24/2018 9:58:56 AM,Pregnant and Lactating Women,0,1640,0,0,1640,0,61335,0,0,61335
15,Sudan (UNDP),2017,SUD-17/HSD20/R/H/NGO/6247,10/24/2018 9:58:56 AM,Women of Child-Bearing Age,0,4000,0,1200,5200,0,8008,0,0,8008
15,Sudan (UNDP),2017,SUD-17/HSD20/R/H-N-WASH/INGO/6249,7/11/2018 7:35:33 AM,Children under 5,0,0,14050,14624,28674,0,0,11447,13767,25214
15,Sudan (UNDP),2017,SUD-17/HSD20/R/H-N-WASH/INGO/6249,7/11/2018 7:35:33 AM,Internally Displaced People/Returnees,27115,28221,0,0,55336,7411,9675,4709,4901,26696
15,Sudan (UNDP),2017,SUD-17/HSD20/R/H-N-WASH/INGO/6249,7/11/2018 7:35:33 AM,Overall,68599,71398,14050,14624,168671,41174,53751,26164,27232,148321
15,Sudan (UNDP),2017,SUD-17/HSD20/R/H-N-WASH/INGO/6249,7/11/2018 7:35:33 AM,Pregnant and Lactating Women,0,6747,0,0,6747,0,218,0,0,218
15,Sudan (UNDP),2017,SUD-17/HSD20/R/P/NGO/7309,1/28/2019 6:39:56 AM,Children under 18,0,0,2850,2900,5750,0,0,3528,3843,7371
15,Sudan (UNDP),2017,SUD-17/HSD20/R/P/NGO/7309,1/28/2019 6:39:56 AM,Overall,500,1000,3000,3000,7500,613,1350,5968,6642,14573
15,Sudan (UNDP),2017,SUD-17/HSD20/R/P/NGO/7309,1/28/2019 6:39:56 AM,People in Host Communities,100,150,150,100,500,613,1350,0,0,1963
15,Sudan (UNDP),2017,SUD-17/HSD20/R/P/NGO/7309,1/28/2019 6:39:56 AM,Women of Child-Bearing Age,0,850,0,0,850,0,0,2415,2824,5239
15,Sudan (UNDP),2017,SUD-17/HSD20/R/RRR/INGO/6246,6/18/2019 11:23:40 AM,Children under 5,0,0,446,465,911,0,0,331,538,869
15,Sudan (UNDP),2017,SUD-17/HSD20/R/RRR/INGO/6246,6/18/2019 11:23:40 AM,Overall,8842,9214,1942,2022,22020,2878,4145,740,1048,8811
15,Sudan (UNDP),2017,SUD-17/HSD20/R/RRR/INGO/6246,6/18/2019 11:23:40 AM,People in Host Communities,2210,2304,485,505,5504,370,1290,205,473,2338
15,Sudan (UNDP),2017,SUD-17/HSD20/R/RRR/INGO/6246,6/18/2019 11:23:40 AM,Pregnant and Lactating Women,0,614,0,0,614,0,1315,0,0,1315
15,Sudan (UNDP),2017,SUD-17/HSD20/R/RRR/INGO/6246,6/18/2019 11:23:40 AM,Returnees,6632,6296,1011,1052,14991,510,1540,280,450,2780
15,Sudan (UNDP),2017,SUD-17/HSD20/R/WASH/INGO/6296,2/11/2018 11:28:34 AM,Internally Displaced People,4960,5165,6063,6312,22500,4750,4942,5804,6040,21536
15,Sudan (UNDP),2017,SUD-17/HSD20/R/WASH/INGO/6296,2/11/2018 11:28:34 AM,Overall,4960,5165,6063,6312,22500,4750,4942,5804,6040,21536
15,Sudan (UNDP),2017,SUD-17/HSD20/R/WASH-FSL-E/INGO/7336,7/7/2019 7:23:41 AM,Internally Displaced People,4581,4810,6643,6873,22907,4581,4810,6643,6873,22907
15,Sudan (UNDP),2017,SUD-17/HSD20/R/WASH-FSL-E/INGO/7336,7/7/2019 7:23:41 AM,Overall,5581,5860,8093,8373,27907,5581,5860,8093,8373,27907
15,Sudan (UNDP),2017,SUD-17/HSD20/R/WASH-FSL-E/INGO/7336,7/7/2019 7:23:41 AM,People in Host Communities,1000,1050,1450,1500,5000,1000,1050,1450,1500,5000
15,Sudan (UNDP),2017,SUD-17/HSD20/R2/CCS/UN/6972,2/21/2018 7:47:02 AM,Overall,2700,2700,0,0,5400,3323,3323,0,0,6646
15,Sudan (UNDP),2017,SUD-17/HSD20/R2/FSL/INGO/6933,6/18/2019 11:25:11 AM,Internally Displaced People,9751,22550,11580,17065,60946,17735,41013,21060,31036,110844
15,Sudan (UNDP),2017,SUD-17/HSD20/R2/FSL/INGO/6933,6/18/2019 11:25:11 AM,Overall,21199,49022,25173,37098,132492,33717,77971,40039,59005,210732
15,Sudan (UNDP),2017,SUD-17/HSD20/R2/FSL/INGO/6933,6/18/2019 11:25:11 AM,People in Host Communities,4664,10785,5537,8162,29148,5328,12319,6327,9322,33296
15,Sudan (UNDP),2017,SUD-17/HSD20/R2/FSL/INGO/6933,6/18/2019 11:25:11 AM,Returnees,6784,15686,8056,11870,42396,10655,24638,12652,18647,66592
15,Sudan (UNDP),2017,SUD-17/HSD20/R2/FSL/INGO/6955,6/18/2019 11:08:49 AM,Internally Displaced People,16897,17585,24315,25307,84104,9627,32554,25211,28887,96279
15,Sudan (UNDP),2017,SUD-17/HSD20/R2/FSL/INGO/6955,6/18/2019 11:08:49 AM,Internally Displaced People/Returnees,5619,5850,8087,8416,27972,798,3048,2136,2565,8547
15,Sudan (UNDP),2017,SUD-17/HSD20/R2/FSL/INGO/6955,6/18/2019 11:08:49 AM,Other,727,756,1046,1089,3618,226,791,565,677,2259
15,Sudan (UNDP),2017,SUD-17/HSD20/R2/FSL/INGO/6955,6/18/2019 11:08:49 AM,Overall,34806,36224,50085,52128,173243,16069,54681,41457,49066,161273
15,Sudan (UNDP),2017,SUD-17/HSD20/R2/FSL/INGO/6955,6/18/2019 11:08:49 AM,People in Host Communities,11563,12033,16637,17316,57549,5418,18288,13545,16937,54188
15,Sudan (UNDP),2017,SUD-17/HSD20/R2/H/NGO/6913,2/17/2019 1:12:22 PM,Children under 5,0,0,3248,2550,5798,0,0,1865,3208,5073
15,Sudan (UNDP),2017,SUD-17/HSD20/R2/H/NGO/6913,2/17/2019 1:12:22 PM,Internally Displaced People/Returnees,10442,14109,934,2025,27510,7425,10677,3640,5317,27059
15,Sudan (UNDP),2017,SUD-17/HSD20/R2/H/NGO/6913,2/17/2019 1:12:22 PM,Overall,10442,15552,4182,4755,34931,10067,15824,2892,4342,33125
15,Sudan (UNDP),2017,SUD-17/HSD20/R2/H/NGO/6913,2/17/2019 1:12:22 PM,Pregnant and Lactating Women,0,1443,0,0,1443,0,1022,0,0,1022
15,Sudan (UNDP),2017,SUD-17/HSD20/R2/H/NGO/6913,2/17/2019 1:12:22 PM,"Staff (own or partner staff, authorities)",0,0,0,0,0,38,50,0,0,88
15,Sudan (UNDP),2017,SUD-17/HSD20/R2/H/NGO/6921,12/26/2018 6:32:20 AM,Children under 5,0,0,1569,1201,2770,0,0,2996,3039,6035
15,Sudan (UNDP),2017,SUD-17/HSD20/R2/H/NGO/6921,12/26/2018 6:32:20 AM,Internally Displaced People/Returnees,8022,8267,3540,3740,23569,0,0,0,0,0
15,Sudan (UNDP),2017,SUD-17/HSD20/R2/H/NGO/6921,12/26/2018 6:32:20 AM,Overall,19811,19504,10055,10255,59625,11550,21466,8248,9158,50422
15,Sudan (UNDP),2017,SUD-17/HSD20/R2/H/NGO/6921,12/26/2018 6:32:20 AM,People in Host Communities,1311,1425,1657,1589,5982,0,0,0,0,0
15,Sudan (UNDP),2017,SUD-17/HSD20/R2/H/NGO/6921,12/26/2018 6:32:20 AM,Pregnant and Lactating Women,0,2705,0,0,2705,0,178,0,0,178
15,Sudan (UNDP),2017,SUD-17/HSD20/R2/H/NGO/6971,1/30/2020 10:09:19 AM,Children under 5,0,0,9873,11499,21372,0,0,6243,7382,13625
15,Sudan (UNDP),2017,SUD-17/HSD20/R2/H/NGO/6971,1/30/2020 10:09:19 AM,Internally Displaced People/Returnees,14515,18630,3465,5623,42233,15873,16527,15723,16870,64993
15,Sudan (UNDP),2017,SUD-17/HSD20/R2/H/NGO/6971,1/30/2020 10:09:19 AM,Overall,27429,41903,16463,21070,106865,31274,38231,35726,42133,147364
15,Sudan (UNDP),2017,SUD-17/HSD20/R2/H/NGO/6971,1/30/2020 10:09:19 AM,People in Host Communities,12914,17898,3125,3948,37885,15401,15901,13760,17881,62943
15,Sudan (UNDP),2017,SUD-17/HSD20/R2/H/NGO/6971,1/30/2020 10:09:19 AM,Pregnant and Lactating Women,0,5375,0,0,5375,0,5803,0,0,5803
15,Sudan (UNDP),2017,SUD-17/HSD20/R2/P/NGO/6952,5/29/2018 11:56:28 AM,Internally Displaced People/Returnees,3110,4050,2277,2390,11827,6950,10378,2508,4468,24304
15,Sudan (UNDP),2017,SUD-17/HSD20/R2/P/NGO/6952,5/29/2018 11:56:28 AM,Overall,8210,9010,6500,6500,30220,12655,14137,7305,8333,42430
15,Sudan (UNDP),2017,SUD-17/HSD20/R2/P/NGO/6952,5/29/2018 11:56:28 AM,People in Host Communities,5100,4960,4223,4110,18393,18360,17896,12102,12198,60556
15,Sudan (UNDP),2017,SUD-17/HSD20/R2/P/UN/6931,6/26/2019 1:00:22 PM,Internally Displaced People,1561,1941,2362,2224,8088,1509,1906,2303,2225,7943
15,Sudan (UNDP),2017,SUD-17/HSD20/R2/P/UN/6931,6/26/2019 1:00:22 PM,Overall,5524,6870,8359,7872,28625,5536,6994,8449,8162,29141
15,Sudan (UNDP),2017,SUD-17/HSD20/R2/P/UN/6931,6/26/2019 1:00:22 PM,People in Host Communities,2404,2989,3637,3425,12455,2366,2990,3611,3488,12455
15,Sudan (UNDP),2017,SUD-17/HSD20/R2/P/UN/6931,6/26/2019 1:00:22 PM,Returnees,1559,1940,2360,2223,8082,1661,2098,2535,2449,8743
15,Sudan (UNDP),2017,SUD-17/HSD20/R2/WASH/INGO/6887,5/7/2019 8:18:43 AM,Internally Displaced People/Returnees,3204,5607,3604,3605,16020,3000,4750,1150,5000,13900
15,Sudan (UNDP),2017,SUD-17/HSD20/R2/WASH/INGO/6887,5/7/2019 8:18:43 AM,Overall,10680,18690,12015,12015,53400,14112,28545,8443,23019,74119
15,Sudan (UNDP),2017,SUD-17/HSD20/R2/WASH/INGO/6887,5/7/2019 8:18:43 AM,People in Host Communities,7476,13083,8411,8410,37380,11112,23795,7293,18019,60219
15,Sudan (UNDP),2017,SUD-17/HSD20/R2/WASH/INGO/6895,12/9/2018 6:12:11 AM,Internally Displaced People,14441,15028,20779,21628,71876,5069,5322,7350,7603,25344
15,Sudan (UNDP),2017,SUD-17/HSD20/R2/WASH/INGO/6895,12/9/2018 6:12:11 AM,Other,663,690,954,993,3300,282,296,408,422,1408
15,Sudan (UNDP),2017,SUD-17/HSD20/R2/WASH/INGO/6895,12/9/2018 6:12:11 AM,Overall,24345,25335,35029,36460,121169,9377,9865,13611,14080,46933
15,Sudan (UNDP),2017,SUD-17/HSD20/R2/WASH/INGO/6895,12/9/2018 6:12:11 AM,People in Host Communities,9187,9560,13218,13758,45723,3567,3745,5172,5351,17835
15,Sudan (UNDP),2017,SUD-17/HSD20/R2/WASH/INGO/6895,12/9/2018 6:12:11 AM,Returnees,54,57,78,81,270,469,493,680,704,2346
15,Sudan (UNDP),2017,SUD-17/HSD20/R2/WASH/INGO/6978,12/5/2018 6:18:33 AM,Internally Displaced People,3276,4914,1092,1638,10920,0,0,0,0,0
15,Sudan (UNDP),2017,SUD-17/HSD20/R2/WASH/INGO/6978,12/5/2018 6:18:33 AM,Overall,10920,16380,3640,5460,36400,11060,16589,3686,5530,36865
15,Sudan (UNDP),2017,SUD-17/HSD20/R2/WASH/INGO/6978,12/5/2018 6:18:33 AM,People in Host Communities,7644,11466,2548,3822,25480,0,0,0,0,0
15,Sudan (UNDP),2017,SUD-17/HSD20/R2/WASH-FSL-E/INGO/6909,6/26/2019 12:57:51 PM,Internally Displaced People,35351,37472,13160,13650,99633,0,0,0,0,0
15,Sudan (UNDP),2017,SUD-17/HSD20/R2/WASH-FSL-E/INGO/6909,6/26/2019 12:57:51 PM,Other,589,625,219,228,1661,0,0,0,0,0
15,Sudan (UNDP),2017,SUD-17/HSD20/R2/WASH-FSL-E/INGO/6909,6/26/2019 12:57:51 PM,Overall,58918,62454,21933,22751,166056,27378,26547,47806,52381,154112
15,Sudan (UNDP),2017,SUD-17/HSD20/R2/WASH-FSL-E/INGO/6909,6/26/2019 12:57:51 PM,People in Host Communities,20032,21234,7457,7735,56458,0,0,0,0,0
15,Sudan (UNDP),2017,SUD-17/HSD20/R2/WASH-FSL-E/INGO/6909,6/26/2019 12:57:51 PM,Returnees,2946,3123,1097,1138,8304,0,0,0,0,0
15,Sudan (UNDP),2017,SUD-17/HSD20/RE/ESNFIs-P/NGO/6396,5/7/2018 11:35:05 AM,Internally Displaced People,500,2000,1400,2100,6000,1436,2750,1640,2360,8186
15,Sudan (UNDP),2017,SUD-17/HSD20/RE/ESNFIs-P/NGO/6396,5/7/2018 11:35:05 AM,Overall,500,2000,1400,2100,6000,1436,2750,1640,2360,8186
15,Sudan (UNDP),2017,SUD-17/HSD20/RE/ESNFIs-RCF/NGO/6256,1/3/2018 7:09:24 AM,Internally Displaced People,1500,2500,1800,1754,7554,1500,2500,1800,1754,7554
15,Sudan (UNDP),2017,SUD-17/HSD20/RE/ESNFIs-RCF/NGO/6256,1/3/2018 7:09:24 AM,Other,1100,2200,2000,2500,7800,1100,2200,2000,2500,7800
15,Sudan (UNDP),2017,SUD-17/HSD20/RE/ESNFIs-RCF/NGO/6256,1/3/2018 7:09:24 AM,Overall,2600,4700,3800,4254,15354,2600,4700,3800,4254,15354
15,Sudan (UNDP),2017,SUD-17/HSD20/RE/H-N-WASH/INGO/6395,8/30/2018 12:44:23 PM,Children under 5,0,0,1695,1990,3685,0,0,5064,5270,10334
15,Sudan (UNDP),2017,SUD-17/HSD20/RE/H-N-WASH/INGO/6395,8/30/2018 12:44:23 PM,Internally Displaced People,5509,4279,447,459,10694,13127,14590,4013,4741,36471
15,Sudan (UNDP),2017,SUD-17/HSD20/RE/H-N-WASH/INGO/6395,8/30/2018 12:44:23 PM,Overall,8292,9213,2534,2994,23033,25524,6616,8599,20048,60787
15,Sudan (UNDP),2017,SUD-17/HSD20/RE/H-N-WASH/INGO/6395,8/30/2018 12:44:23 PM,People in Host Communities,2782,3091,386,232,6491,8754,9726,2675,3161,24316
15,Sudan (UNDP),2017,SUD-17/HSD20/RE/H-N-WASH/INGO/6395,8/30/2018 12:44:23 PM,Pregnant and Lactating Women,0,1842,0,0,1842,0,4863,0,0,4863
15,Sudan (UNDP),2017,SUD-17/HSD20/RE/H-RCF/INGO/6254,8/13/2018 5:45:55 AM,Internally Displaced People,1490,1549,1747,1819,6605,1255,1351,1187,1239,5032
15,Sudan (UNDP),2017,SUD-17/HSD20/RE/H-RCF/INGO/6254,8/13/2018 5:45:55 AM,Other,1730,1799,2028,2113,7670,1283,1421,1342,1411,5457
15,Sudan (UNDP),2017,SUD-17/HSD20/RE/H-RCF/INGO/6254,8/13/2018 5:45:55 AM,Overall,4034,4194,4729,4927,17884,3086,5299,3342,4262,15989
15,Sudan (UNDP),2017,SUD-17/HSD20/RE/H-RCF/INGO/6254,8/13/2018 5:45:55 AM,People in Host Communities,805,837,944,983,3569,1254,1222,1396,1610,5482
15,Sudan (UNDP),2017,SUD-17/HSD20/RE/H-WASH/UN/6415,2/19/2018 11:37:49 AM,Overall,3920,4079,5881,6120,20000,13300,14000,20300,22400,70000
15,Sudan (UNDP),2017,SUD-17/HSD20/RE/H-WASH/UN/6415,2/19/2018 11:37:49 AM,People from Riverine Communities,3920,4079,5881,6120,20000,13300,14000,20300,22400,70000
15,Sudan (UNDP),2017,SUD-17/HSD20/RE/H-WASH/UN/6416,2/11/2018 11:40:16 AM,Overall,44627,56278,41790,52560,195255,44566,56100,41650,52470,194786
15,Sudan (UNDP),2017,SUD-17/HSD20/RE/P/INGO/6532,12/27/2018 6:41:50 AM,Internally Displaced People,1480,1720,1914,1636,6750,0,0,0,0,0
15,Sudan (UNDP),2017,SUD-17/HSD20/RE/P/INGO/6532,12/27/2018 6:41:50 AM,Overall,1850,2150,2393,2045,8438,320,320,1447,1340,3427
15,Sudan (UNDP),2017,SUD-17/HSD20/RE/P/INGO/6532,12/27/2018 6:41:50 AM,People in Host Communities,370,430,479,409,1688,0,0,0,0,0
15,Sudan (UNDP),2017,SUD-17/HSD20/RE/RCF/UN/7285,10/30/2018 1:30:03 PM,Overall,2100,15400,0,0,17500,8225,9275,0,0,17500
15,Sudan (UNDP),2017,SUD-17/HSD20/RE/WASH/INGO/6245,8/30/2018 12:49:20 PM,Overall,6300,6560,1300,1340,15500,7208,9553,1272,1687,19720
15,Sudan (UNDP),2017,SUD-17/HSD20/RE/WASH/INGO/7622,1/6/2019 7:34:40 AM,Internally Displaced People,4031,4992,1443,1564,12030,6718,7678,2492,2300,19188
15,Sudan (UNDP),2017,SUD-17/HSD20/RE/WASH/INGO/7622,1/6/2019 7:34:40 AM,Overall,14091,15890,4796,5197,39974,16796,19196,6229,5749,47970
15,Sudan (UNDP),2017,SUD-17/HSD20/RE/WASH/INGO/7622,1/6/2019 7:34:40 AM,People in Host Communities,6496,7037,2165,2346,18044,9918,11335,3678,3394,28325
15,Sudan (UNDP),2017,SUD-17/HSD20/RE/WASH/INGO/7622,1/6/2019 7:34:40 AM,Returnees,3564,3861,1188,1287,9900,160,183,59,55,457
15,Sudan (UNDP),2017,SUD-17/HSD20/RE/WASH-RCF/INGO/6255,5/31/2018 10:55:21 AM,Internally Displaced People,884,2057,2161,2248,7350,882,2057,2161,2249,7349
15,Sudan (UNDP),2017,SUD-17/HSD20/RE/WASH-RCF/INGO/6255,5/31/2018 10:55:21 AM,Other,819,1865,1975,2037,6696,1228,2865,3010,3132,10235
15,Sudan (UNDP),2017,SUD-17/HSD20/RE/WASH-RCF/INGO/6255,5/31/2018 10:55:21 AM,Overall,2520,5880,6174,6426,21000,4039,9426,9901,10304,33670
15,Sudan (UNDP),2017,SUD-17/HSD20/RE/WASH-RCF/INGO/6255,5/31/2018 10:55:21 AM,Pastoralists,83,172,164,188,607,0,0,0,0,0
15,Sudan (UNDP),2017,SUD-17/HSD20/RE/WASH-RCF/INGO/6255,5/31/2018 10:55:21 AM,People in Host Communities,734,1786,1874,1952,6346,1930,4503,4730,4923,16086
15,Sudan (UNDP),2017,SUD-17/HSD20/S1/E/NGO/4871,7/4/2018 1:30:52 PM,Children under 18,0,0,1650,1650,3300,0,0,3112,3495,6607
15,Sudan (UNDP),2017,SUD-17/HSD20/S1/E/NGO/4871,7/4/2018 1:30:52 PM,Internally Displaced People,45,45,0,0,90,56,63,0,0,119
15,Sudan (UNDP),2017,SUD-17/HSD20/S1/E/NGO/4871,7/4/2018 1:30:52 PM,Overall,45,45,1650,1650,3390,56,63,3112,3495,6726
15,Sudan (UNDP),2017,SUD-17/HSD20/S1/E-P/INGO/4849,10/24/2018 6:51:45 AM,Children under 18,0,0,6343,6552,12895,0,0,0,0,0
15,Sudan (UNDP),2017,SUD-17/HSD20/S1/E-P/INGO/4849,10/24/2018 6:51:45 AM,Other,132,123,0,0,255,0,0,0,0,0
15,Sudan (UNDP),2017,SUD-17/HSD20/S1/E-P/INGO/4849,10/24/2018 6:51:45 AM,Overall,157,148,6343,6552,13200,253,143,6605,6713,13714
15,Sudan (UNDP),2017,SUD-17/HSD20/S1/E-P/INGO/4849,10/24/2018 6:51:45 AM,"Staff (own or partner staff, authorities)",25,25,0,0,50,0,0,0,0,0
15,Sudan (UNDP),2017,SUD-17/HSD20/S1/E-P/INGO/4930,6/7/2018 8:52:38 AM,Overall,173,133,3612,3228,7146,403,161,3181,3454,7199
15,Sudan (UNDP),2017,SUD-17/HSD20/S1/E-P/UN/4893,1/7/2019 6:36:00 AM,Children under 18,0,0,4023,3618,7641,0,0,0,0,0
15,Sudan (UNDP),2017,SUD-17/HSD20/S1/E-P/UN/4893,1/7/2019 6:36:00 AM,Internally Displaced People,176,199,0,0,375,0,0,4045,3939,7984
15,Sudan (UNDP),2017,SUD-17/HSD20/S1/E-P/UN/4893,1/7/2019 6:36:00 AM,Overall,176,199,5031,4860,10266,176,146,5303,4610,10235
15,Sudan (UNDP),2017,SUD-17/HSD20/S1/E-P/UN/4893,1/7/2019 6:36:00 AM,People in Host Communities,0,0,1008,1242,2250,35,33,0,0,68
15,Sudan (UNDP),2017,SUD-17/HSD20/S1/ESNFIs/INGO/4822,5/10/2018 7:10:15 AM,Internally Displaced People,850,1912,2697,3041,8500,186,417,589,663,1855
15,Sudan (UNDP),2017,SUD-17/HSD20/S1/ESNFIs/INGO/4822,5/10/2018 7:10:15 AM,Overall,850,1912,2697,3041,8500,0,0,0,0,0
15,Sudan (UNDP),2017,SUD-17/HSD20/S1/ESNFIs/INGO/4863,12/6/2018 6:10:54 AM,Internally Displaced People,3790,5686,4737,4737,18950,5371,8056,6714,6714,26855
15,Sudan (UNDP),2017,SUD-17/HSD20/S1/ESNFIs/INGO/4863,12/6/2018 6:10:54 AM,Overall,3790,5686,4737,4737,18950,5371,8056,6714,6714,26855
15,Sudan (UNDP),2017,SUD-17/HSD20/S1/ESNFIs/NGO/4750,5/10/2018 2:28:11 PM,Internally Displaced People,2150,2650,2200,2555,9555,2150,2650,2200,2555,9555
15,Sudan (UNDP),2017,SUD-17/HSD20/S1/ESNFIs/NGO/4750,5/10/2018 2:28:11 PM,Overall,2150,2650,2200,2555,9555,2150,2650,2200,2555,9555
15,Sudan (UNDP),2017,SUD-17/HSD20/S1/ESNFIs/UN/4796,2/19/2018 10:43:21 AM,Internally Displaced People,14000,21000,0,0,35000,8647,17288,0,0,25935
15,Sudan (UNDP),2017,SUD-17/HSD20/S1/ESNFIs/UN/4796,2/19/2018 10:43:21 AM,Overall,14000,21000,0,0,35000,8647,17288,0,0,25935
15,Sudan (UNDP),2017,SUD-17/HSD20/S1/ESNFIs/UN/4858,5/7/2018 11:40:58 AM,Internally Displaced People,2730,4030,3640,2600,13000,3435,3088,3977,5284,15784
15,Sudan (UNDP),2017,SUD-17/HSD20/S1/ESNFIs/UN/4858,5/7/2018 11:40:58 AM,Overall,2730,4030,3640,2600,13000,3435,3088,3977,5284,15784
15,Sudan (UNDP),2017,SUD-17/HSD20/S1/FSL/INGO/4783,9/26/2018 6:22:15 AM,Internally Displaced People,20043,21713,8590,9306,59652,20489,21694,8431,9638,60252
15,Sudan (UNDP),2017,SUD-17/HSD20/S1/FSL/INGO/4783,9/26/2018 6:22:15 AM,Overall,33405,36189,14316,15510,99420,35965,38092,14808,16925,105790
15,Sudan (UNDP),2017,SUD-17/HSD20/S1/FSL/INGO/4783,9/26/2018 6:22:15 AM,People in Host Communities,13362,14476,5726,6204,39768,15486,16298,6377,7287,45448
15,Sudan (UNDP),2017,SUD-17/HSD20/S1/FSL/INGO/4848,12/6/2018 7:24:06 AM,Internally Displaced People,10833,18993,10157,13978,53961,15643,33603,13045,19482,81773
15,Sudan (UNDP),2017,SUD-17/HSD20/S1/FSL/INGO/4848,12/6/2018 7:24:06 AM,Overall,34274,44335,25401,31424,135434,34216,44368,25333,31323,135240
15,Sudan (UNDP),2017,SUD-17/HSD20/S1/FSL/UN/4789,6/19/2018 9:28:09 AM,Internally Displaced People,0,0,0,0,0,11,2,0,0,13
15,Sudan (UNDP),2017,SUD-17/HSD20/S1/FSL/UN/4789,6/19/2018 9:28:09 AM,Other,3,2,3,3,11,0,0,0,0,0
15,Sudan (UNDP),2017,SUD-17/HSD20/S1/FSL/UN/4789,6/19/2018 9:28:09 AM,Overall,3,2,3,3,11,3,2,3,3,11
15,Sudan (UNDP),2017,SUD-17/HSD20/S1/H/INGO/4754,7/11/2018 6:47:21 AM,Internally Displaced People,95167,93283,19493,19105,227048,31836,73307,33686,31429,170258
15,Sudan (UNDP),2017,SUD-17/HSD20/S1/H/INGO/4754,7/11/2018 6:47:21 AM,Overall,120935,118540,24770,24279,288524,40642,81330,52334,46063,220369
15,Sudan (UNDP),2017,SUD-17/HSD20/S1/H/INGO/4754,7/11/2018 6:47:21 AM,People in Host Communities,25768,25257,5277,5174,61476,9946,17137,11855,11173,50111
15,Sudan (UNDP),2017,SUD-17/HSD20/S1/H/INGO/4775,11/1/2018 6:31:41 AM,Internally Displaced People,5275,5665,4212,4384,19536,5361,7184,3508,1879,17932
15,Sudan (UNDP),2017,SUD-17/HSD20/S1/H/INGO/4775,11/1/2018 6:31:41 AM,Overall,30957,33250,24719,25728,114654,37577,50605,25121,12831,126134
15,Sudan (UNDP),2017,SUD-17/HSD20/S1/H/INGO/4775,11/1/2018 6:31:41 AM,Pastoralists,3919,4209,3129,3257,14514,14127,19047,9488,4790,47452
15,Sudan (UNDP),2017,SUD-17/HSD20/S1/H/INGO/4775,11/1/2018 6:31:41 AM,People in Host Communities,11283,12120,9010,9377,41790,11579,15483,7718,3896,38676
15,Sudan (UNDP),2017,SUD-17/HSD20/S1/H/INGO/4775,11/1/2018 6:31:41 AM,Returnees,10480,11256,8368,8710,38814,6510,8891,4407,2266,22074
15,Sudan (UNDP),2017,SUD-17/HSD20/S1/H/INGO/4792,12/9/2018 6:23:50 AM,Internally Displaced People,39882,49425,32878,40177,162362,53469,58194,6516,8135,126314
15,Sudan (UNDP),2017,SUD-17/HSD20/S1/H/INGO/4792,12/9/2018 6:23:50 AM,Overall,56316,68377,55832,64158,244683,50383,55651,26743,34286,167063
15,Sudan (UNDP),2017,SUD-17/HSD20/S1/H/INGO/4792,12/9/2018 6:23:50 AM,People in Host Communities,16434,18952,22954,23981,82321,12856,17613,4520,5760,40749
15,Sudan (UNDP),2017,SUD-17/HSD20/S1/H/INGO/4804,7/25/2018 7:45:44 AM,Children under 18,0,0,15994,16304,32298,0,0,16943,13934,30877
15,Sudan (UNDP),2017,SUD-17/HSD20/S1/H/INGO/4804,7/25/2018 7:45:44 AM,Internally Displaced People,28290,23952,0,0,52242,27789,15077,0,0,42866
15,Sudan (UNDP),2017,SUD-17/HSD20/S1/H/INGO/4804,7/25/2018 7:45:44 AM,Overall,28290,61264,15994,16304,121852,27789,62983,16943,13934,121649
15,Sudan (UNDP),2017,SUD-17/HSD20/S1/H/INGO/4804,7/25/2018 7:45:44 AM,Women of Child-Bearing Age,0,37312,0,0,37312,0,47906,0,0,47906
15,Sudan (UNDP),2017,SUD-17/HSD20/S1/H/NGO/4841,7/11/2018 8:04:41 AM,Children under 5,0,0,2933,3093,6026,0,0,3011,3215,6226
15,Sudan (UNDP),2017,SUD-17/HSD20/S1/H/NGO/4841,7/11/2018 8:04:41 AM,Internally Displaced People/Returnees,4063,6701,4462,4626,19852,0,0,0,0,0
15,Sudan (UNDP),2017,SUD-17/HSD20/S1/H/NGO/4841,7/11/2018 8:04:41 AM,Overall,5066,7601,8031,8524,29222,8463,11321,8078,5401,33263
15,Sudan (UNDP),2017,SUD-17/HSD20/S1/H/NGO/4841,7/11/2018 8:04:41 AM,People in Host Communities,1003,900,636,805,3344,0,0,0,0,0
15,Sudan (UNDP),2017,SUD-17/HSD20/S1/H/UN/4759,12/27/2018 12:05:55 PM,Internally Displaced People,2800,16273,1800,3000,23873,1520,11600,1250,2360,16730
15,Sudan (UNDP),2017,SUD-17/HSD20/S1/H/UN/4759,12/27/2018 12:05:55 PM,Internally Displaced People/Returnees,0,0,0,0,0,400,1300,100,200,2000
15,Sudan (UNDP),2017,SUD-17/HSD20/S1/H/UN/4759,12/27/2018 12:05:55 PM,Overall,3200,19273,2200,4546,29219,2800,19800,2000,4460,29060
15,Sudan (UNDP),2017,SUD-17/HSD20/S1/H/UN/4759,12/27/2018 12:05:55 PM,People in Host Communities,400,3000,400,1546,5346,880,6900,650,1900,10330
15,Sudan (UNDP),2017,SUD-17/HSD20/S1/H/UN/4876,5/10/2018 2:20:13 PM,Children under 5,0,0,12700,17600,30300,8797,9762,754,772,20085
15,Sudan (UNDP),2017,SUD-17/HSD20/S1/H/UN/4876,5/10/2018 2:20:13 PM,Internally Displaced People/Returnees,24500,31200,23455,31400,110555,22046,26029,20073,25608,93756
15,Sudan (UNDP),2017,SUD-17/HSD20/S1/H/UN/4876,5/10/2018 2:20:13 PM,Overall,39752,42973,36431,50844,170000,44423,55221,32632,40824,173100
15,Sudan (UNDP),2017,SUD-17/HSD20/S1/H/UN/4876,5/10/2018 2:20:13 PM,People in Host Communities,0,0,0,0,0,13431,14851,11637,14273,54192
15,Sudan (UNDP),2017,SUD-17/HSD20/S1/H/UN/4876,5/10/2018 2:20:13 PM,Pregnant and Lactating Women,0,6800,0,0,6800,191,4579,168,172,5110
15,Sudan (UNDP),2017,SUD-17/HSD20/S1/H-N/INGO/4788,11/29/2018 6:04:51 AM,Children under 5,0,0,3147,3410,6557,0,0,5839,6779,12618
15,Sudan (UNDP),2017,SUD-17/HSD20/S1/H-N/INGO/4788,11/29/2018 6:04:51 AM,Internally Displaced People/Returnees,2167,2168,0,0,4335,0,0,0,0,0
15,Sudan (UNDP),2017,SUD-17/HSD20/S1/H-N/INGO/4788,11/29/2018 6:04:51 AM,Overall,6398,8793,3147,3410,21748,4111,9289,5839,6779,26018
15,Sudan (UNDP),2017,SUD-17/HSD20/S1/H-N/INGO/4788,11/29/2018 6:04:51 AM,People in Host Communities,4231,4232,0,0,8463,4111,0,0,0,4111
15,Sudan (UNDP),2017,SUD-17/HSD20/S1/H-N/INGO/4788,11/29/2018 6:04:51 AM,Pregnant and Lactating Women,0,2393,0,0,2393,0,10027,0,0,10027
15,Sudan (UNDP),2017,SUD-17/HSD20/S1/N/INGO/4758,6/24/2018 1:21:14 PM,Children under 5,0,0,14653,14704,29357,0,0,20541,22300,42841
15,Sudan (UNDP),2017,SUD-17/HSD20/S1/N/INGO/4758,6/24/2018 1:21:14 PM,Overall,1616,3355,15191,14704,34866,916,1567,24850,26785,54118
15,Sudan (UNDP),2017,SUD-17/HSD20/S1/N/INGO/4758,6/24/2018 1:21:14 PM,Pregnant and Lactating Women,0,1152,0,0,1152,0,901,0,0,901
15,Sudan (UNDP),2017,SUD-17/HSD20/S1/N/INGO/4758,6/24/2018 1:21:14 PM,"Staff (own or partner staff, authorities)",15,19,0,0,34,47,57,0,0,104
15,Sudan (UNDP),2017,SUD-17/HSD20/S1/N/INGO/4758,6/24/2018 1:21:14 PM,"Trainers, Promoters, Caretakers, committee members, etc.",1601,2184,0,0,3785,83,165,0,0,248
15,Sudan (UNDP),2017,SUD-17/HSD20/S1/N/INGO/4765,10/2/2018 10:43:22 AM,Internally Displaced People,0,0,551,647,1198,0,1816,370,404,2590
15,Sudan (UNDP),2017,SUD-17/HSD20/S1/N/INGO/4765,10/2/2018 10:43:22 AM,Overall,0,1009,4713,5533,11255,967,14979,4086,4525,24557
15,Sudan (UNDP),2017,SUD-17/HSD20/S1/N/INGO/4765,10/2/2018 10:43:22 AM,People in Host Communities,0,0,1392,1635,3027,0,2670,387,450,3507
15,Sudan (UNDP),2017,SUD-17/HSD20/S1/N/INGO/4765,10/2/2018 10:43:22 AM,Pregnant and Lactating Women,0,1009,0,0,1009,967,8647,3329,3671,16614
15,Sudan (UNDP),2017,SUD-17/HSD20/S1/N/INGO/4765,10/2/2018 10:43:22 AM,Returnees,0,0,2770,3251,6021,0,1846,0,0,1846
15,Sudan (UNDP),2017,SUD-17/HSD20/S1/N/INGO/4805,9/6/2018 10:53:39 AM,Children under 5,0,0,2879,3336,6215,0,0,1294,1444,2738
15,Sudan (UNDP),2017,SUD-17/HSD20/S1/N/INGO/4805,9/6/2018 10:53:39 AM,Internally Displaced People,2334,1211,0,0,3545,9155,3724,0,0,12879
15,Sudan (UNDP),2017,SUD-17/HSD20/S1/N/INGO/4805,9/6/2018 10:53:39 AM,Overall,2334,9326,2879,3336,17875,9155,26639,1294,1444,38532
15,Sudan (UNDP),2017,SUD-17/HSD20/S1/N/INGO/4805,9/6/2018 10:53:39 AM,Pregnant and Lactating Women,0,8115,0,0,8115,0,24915,0,0,24915
15,Sudan (UNDP),2017,SUD-17/HSD20/S1/N/INGO/4915,8/30/2018 12:33:53 PM,Children under 5,0,0,3330,3466,6796,0,0,3178,3607,6785
15,Sudan (UNDP),2017,SUD-17/HSD20/S1/N/INGO/4915,8/30/2018 12:33:53 PM,Internally Displaced People,415,7689,0,0,8104,420,13901,0,0,14321
15,Sudan (UNDP),2017,SUD-17/HSD20/S1/N/INGO/4915,8/30/2018 12:33:53 PM,Overall,415,8310,3330,3466,15521,420,14155,3178,3607,21360
15,Sudan (UNDP),2017,SUD-17/HSD20/S1/N/INGO/4915,8/30/2018 12:33:53 PM,Pregnant and Lactating Women,0,621,0,0,621,0,254,0,0,254
15,Sudan (UNDP),2017,SUD-17/HSD20/S1/N/NGO/4803,7/9/2018 7:40:37 AM,Children under 5,0,0,1016,1017,2033,0,0,7815,8305,16120
15,Sudan (UNDP),2017,SUD-17/HSD20/S1/N/NGO/4803,7/9/2018 7:40:37 AM,Overall,48,10089,1016,1017,12170,86,13291,1203,1562,16142
15,Sudan (UNDP),2017,SUD-17/HSD20/S1/N/NGO/4803,7/9/2018 7:40:37 AM,Pregnant and Lactating Women,0,1601,0,0,1601,0,1931,0,0,1931
15,Sudan (UNDP),2017,SUD-17/HSD20/S1/N/NGO/4803,7/9/2018 7:40:37 AM,"Trainers, Promoters, Caretakers, committee members, etc.",48,64,0,0,112,48,64,0,0,112
15,Sudan (UNDP),2017,SUD-17/HSD20/S1/N/NGO/4803,7/9/2018 7:40:37 AM,Women of Child-Bearing Age,0,8424,0,0,8424,0,9110,0,0,9110
15,Sudan (UNDP),2017,SUD-17/HSD20/S1/N/NGO/4900,12/31/2018 6:38:56 AM,Children under 5,0,0,2940,3060,6000,0,0,43519,52855,96374
15,Sudan (UNDP),2017,SUD-17/HSD20/S1/N/NGO/4900,12/31/2018 6:38:56 AM,Other,3100,3500,0,0,6600,0,0,0,0,0
15,Sudan (UNDP),2017,SUD-17/HSD20/S1/N/NGO/4900,12/31/2018 6:38:56 AM,Overall,3130,3530,2940,3060,12660,2461,9103,43519,52855,107938
15,Sudan (UNDP),2017,SUD-17/HSD20/S1/N/NGO/4900,12/31/2018 6:38:56 AM,"Staff (own or partner staff, authorities)",10,10,0,0,20,3,17,0,0,20
15,Sudan (UNDP),2017,SUD-17/HSD20/S1/N/NGO/4900,12/31/2018 6:38:56 AM,"Trainers, Promoters, Caretakers, committee members, etc.",20,20,0,0,40,2458,9086,0,0,11544
15,Sudan (UNDP),2017,SUD-17/HSD20/S1/N/UN/4799,7/9/2018 7:53:58 AM,Children under 5,0,0,0,0,0,0,0,1817,1938,3755
15,Sudan (UNDP),2017,SUD-17/HSD20/S1/N/UN/4799,7/9/2018 7:53:58 AM,Overall,85,88,0,0,173,105,330,0,0,435
15,Sudan (UNDP),2017,SUD-17/HSD20/S1/N/UN/4799,7/9/2018 7:53:58 AM,"Staff (own or partner staff, authorities)",85,88,0,0,173,105,330,0,0,435
15,Sudan (UNDP),2017,SUD-17/HSD20/S1/N/UN/4867,6/5/2018 9:19:49 AM,Children under 5,0,0,5706,5483,11189,0,0,5990,5758,11748
15,Sudan (UNDP),2017,SUD-17/HSD20/S1/N/UN/4867,6/5/2018 9:19:49 AM,Overall,0,0,5706,5483,11189,0,0,5706,5483,11189
15,Sudan (UNDP),2017,SUD-17/HSD20/S1/N-E/INGO/4888,10/14/2018 12:20:21 PM,Children under 5,0,6,9775,11947,21728,0,0,0,0,0
15,Sudan (UNDP),2017,SUD-17/HSD20/S1/N-E/INGO/4888,10/14/2018 12:20:21 PM,Internally Displaced People,6708,696,399,487,8290,0,0,0,0,0
15,Sudan (UNDP),2017,SUD-17/HSD20/S1/N-E/INGO/4888,10/14/2018 12:20:21 PM,Other,500,660,378,462,2000,0,0,0,0,0
15,Sudan (UNDP),2017,SUD-17/HSD20/S1/N-E/INGO/4888,10/14/2018 12:20:21 PM,Overall,7208,9515,10552,12896,40171,0,11079,19657,16083,46819
15,Sudan (UNDP),2017,SUD-17/HSD20/S1/N-E/INGO/4888,10/14/2018 12:20:21 PM,Pregnant and Lactating Women,0,8153,0,0,8153,0,0,0,0,0
15,Sudan (UNDP),2017,SUD-17/HSD20/S1/N-WASH/INGO/4760,7/5/2018 6:19:26 AM,Children under 5,0,0,4536,4721,9257,0,0,0,0,0
15,Sudan (UNDP),2017,SUD-17/HSD20/S1/N-WASH/INGO/4760,7/5/2018 6:19:26 AM,Internally Displaced People,9562,10715,6647,7737,34661,6753,9257,6305,7198,29513
15,Sudan (UNDP),2017,SUD-17/HSD20/S1/N-WASH/INGO/4760,7/5/2018 6:19:26 AM,Overall,9597,13045,11183,12458,46283,17484,21756,14291,15474,69005
15,Sudan (UNDP),2017,SUD-17/HSD20/S1/N-WASH/INGO/4760,7/5/2018 6:19:26 AM,Pregnant and Lactating Women,0,2300,0,0,2300,0,0,0,0,0
15,Sudan (UNDP),2017,SUD-17/HSD20/S1/N-WASH/INGO/4760,7/5/2018 6:19:26 AM,"Staff (own or partner staff, authorities)",35,30,0,0,65,0,0,0,0,0
15,Sudan (UNDP),2017,SUD-17/HSD20/S1/N-WASH/INGO/4934,12/20/2018 7:02:13 AM,Children under 5,0,0,8335,7647,15982,0,0,9711,9853,19564
15,Sudan (UNDP),2017,SUD-17/HSD20/S1/N-WASH/INGO/4934,12/20/2018 7:02:13 AM,Overall,1900,3643,8335,7647,21525,2122,13503,12317,12986,40928
15,Sudan (UNDP),2017,SUD-17/HSD20/S1/N-WASH/INGO/4934,12/20/2018 7:02:13 AM,Pregnant and Lactating Women,0,1695,0,0,1695,0,6652,0,0,6652
15,Sudan (UNDP),2017,SUD-17/HSD20/S1/N-WASH/INGO/4934,12/20/2018 7:02:13 AM,"Trainers, Promoters, Caretakers, committee members, etc.",0,50,0,0,50,1061,88,0,0,1149
15,Sudan (UNDP),2017,SUD-17/HSD20/S1/P/NGO/4847,6/18/2019 11:31:49 AM,Internally Displaced People,2500,4000,3810,3200,13510,2855,5834,4559,3710,16958
15,Sudan (UNDP),2017,SUD-17/HSD20/S1/P/NGO/4847,6/18/2019 11:31:49 AM,Overall,10220,11020,10500,10500,42240,14855,8834,11574,12705,47968
15,Sudan (UNDP),2017,SUD-17/HSD20/S1/P/NGO/4847,6/18/2019 11:31:49 AM,People in Host Communities,6000,4200,4800,5000,20000,5400,4890,6709,3450,20449
15,Sudan (UNDP),2017,SUD-17/HSD20/S1/P/NGO/4847,6/18/2019 11:31:49 AM,Returnees,1700,2800,1890,2300,8690,2145,2875,2581,2920,10521
15,Sudan (UNDP),2017,SUD-17/HSD20/S1/P/NGO/4847,6/18/2019 11:31:49 AM,"Trainers, Promoters, Caretakers, committee members, etc.",20,20,0,0,40,20,20,0,0,40
15,Sudan (UNDP),2017,SUD-17/HSD20/S1/P/NGO/4877,7/18/2018 7:43:20 AM,Children under 18,0,0,2400,3330,5730,0,0,900,1100,2000
15,Sudan (UNDP),2017,SUD-17/HSD20/S1/P/NGO/4877,7/18/2018 7:43:20 AM,Children under 5,0,0,120,140,260,0,0,120,140,260
15,Sudan (UNDP),2017,SUD-17/HSD20/S1/P/NGO/4877,7/18/2018 7:43:20 AM,Internally Displaced People,3102,6502,0,0,9604,4094,6528,1280,3100,15002
15,Sudan (UNDP),2017,SUD-17/HSD20/S1/P/NGO/4877,7/18/2018 7:43:20 AM,Overall,3163,6571,2520,4720,16974,4150,6603,2300,4340,17393
15,Sudan (UNDP),2017,SUD-17/HSD20/S1/P/NGO/4877,7/18/2018 7:43:20 AM,"Trainers, Promoters, Caretakers, committee members, etc.",61,69,0,0,130,56,75,0,0,131
15,Sudan (UNDP),2017,SUD-17/HSD20/S1/P/UN/4739,7/25/2018 8:15:45 AM,Internally Displaced People,400,7000,400,750,8550,400,7300,400,950,9050
15,Sudan (UNDP),2017,SUD-17/HSD20/S1/P/UN/4739,7/25/2018 8:15:45 AM,Overall,560,9000,500,1000,11060,560,9300,500,1200,11560
15,Sudan (UNDP),2017,SUD-17/HSD20/S1/P/UN/4739,7/25/2018 8:15:45 AM,People in Host Communities,160,2000,100,250,2510,160,2000,100,250,2510
15,Sudan (UNDP),2017,SUD-17/HSD20/S1/RCF/INGO/4782,9/18/2018 11:04:52 AM,Other,656,984,997,1518,4155,1271,1819,597,1398,5085
15,Sudan (UNDP),2017,SUD-17/HSD20/S1/RCF/INGO/4782,9/18/2018 11:04:52 AM,Overall,820,1230,1246,1898,5194,1524,2134,792,1648,6098
15,Sudan (UNDP),2017,SUD-17/HSD20/S1/RCF/INGO/4782,9/18/2018 11:04:52 AM,People in Host Communities,164,246,249,380,1039,242,362,131,278,1013
15,Sudan (UNDP),2017,SUD-17/HSD20/S1/RCF/INGO/4827,10/28/2018 12:55:11 PM,Other,7700,14000,6300,7000,35000,8553,15551,6998,7775,38877
15,Sudan (UNDP),2017,SUD-17/HSD20/S1/RCF/INGO/4827,10/28/2018 12:55:11 PM,Overall,10010,18200,8190,9100,45500,11108,20196,9088,10098,50490
15,Sudan (UNDP),2017,SUD-17/HSD20/S1/RCF/INGO/4827,10/28/2018 12:55:11 PM,People in Host Communities,2310,4200,1890,2100,10500,2555,4645,2090,2323,11613
15,Sudan (UNDP),2017,SUD-17/HSD20/S1/RCF/INGO/4928,6/5/2018 9:46:01 AM,Overall,3692,3615,752,741,8800,3692,3615,752,741,8800
15,Sudan (UNDP),2017,SUD-17/HSD20/S1/RCF/INGO/4928,6/5/2018 9:46:01 AM,People in Host Communities,335,329,69,67,800,0,0,0,0,0
15,Sudan (UNDP),2017,SUD-17/HSD20/S1/RCF/NGO/4921,9/18/2018 12:18:36 PM,Children under 5,0,0,4562,4748,9310,0,0,12571,15092,27663
15,Sudan (UNDP),2017,SUD-17/HSD20/S1/RCF/NGO/4921,9/18/2018 12:18:36 PM,Other,11725,15227,0,0,26952,20339,23994,0,0,44333
15,Sudan (UNDP),2017,SUD-17/HSD20/S1/RCF/NGO/4921,9/18/2018 12:18:36 PM,Overall,11755,15257,4562,4748,36322,20360,24018,12571,15092,72041
15,Sudan (UNDP),2017,SUD-17/HSD20/S1/RCF/NGO/4921,9/18/2018 12:18:36 PM,"Staff (own or partner staff, authorities)",10,10,0,0,20,9,6,0,0,15
15,Sudan (UNDP),2017,SUD-17/HSD20/S1/RCF/NGO/4921,9/18/2018 12:18:36 PM,"Trainers, Promoters, Caretakers, committee members, etc.",20,20,0,0,40,12,18,0,0,30
15,Sudan (UNDP),2017,SUD-17/HSD20/S1/RCF/UN/4731,7/1/2018 10:18:51 AM,Overall,585,7435,470,2550,11040,314,8343,77,2320,11054
15,Sudan (UNDP),2017,SUD-17/HSD20/S1/RCF/UN/4731,7/1/2018 10:18:51 AM,People in Host Communities,100,590,100,360,1150,0,0,0,0,0
15,Sudan (UNDP),2017,SUD-17/HSD20/S1/RCF/UN/4731,7/1/2018 10:18:51 AM,Pregnant and Lactating Women,0,1500,0,400,1900,0,0,0,0,0
15,Sudan (UNDP),2017,SUD-17/HSD20/S1/RCF/UN/4801,10/30/2018 1:17:03 PM,Overall,1901,5805,1825,1825,11356,2685,3506,4233,4167,14591
15,Sudan (UNDP),2017,SUD-17/HSD20/S1/RRR/INGO/4785,9/23/2018 9:01:03 AM,Overall,2845,4917,2586,2587,12935,5304,9167,4821,4823,24115
15,Sudan (UNDP),2017,SUD-17/HSD20/S1/RRR/INGO/4785,9/23/2018 9:01:03 AM,People in Host Communities,859,1487,780,781,3907,3887,6720,3533,3533,17673
15,Sudan (UNDP),2017,SUD-17/HSD20/S1/RRR/INGO/4785,9/23/2018 9:01:03 AM,Returnees,1986,3430,1806,1806,9028,1417,2447,1228,1228,6320
15,Sudan (UNDP),2017,SUD-17/HSD20/S1/RRR/INGO/4820,9/27/2018 8:23:45 AM,Internally Displaced People/Returnees,1864,1947,2571,2670,9052,667,737,1102,1099,3605
15,Sudan (UNDP),2017,SUD-17/HSD20/S1/RRR/INGO/4820,9/27/2018 8:23:45 AM,Overall,6516,6807,8990,9321,31634,2331,2575,3852,3842,12600
15,Sudan (UNDP),2017,SUD-17/HSD20/S1/RRR/INGO/4820,9/27/2018 8:23:45 AM,People in Host Communities,1057,1104,1458,1512,5131,377,417,624,622,2040
15,Sudan (UNDP),2017,SUD-17/HSD20/S1/RRR/INGO/4820,9/27/2018 8:23:45 AM,Returnees,3595,3756,4961,5139,17451,1287,1421,2126,2121,6955
15,Sudan (UNDP),2017,SUD-17/HSD20/S1/RRR/INGO/4910,11/29/2018 5:55:44 AM,Overall,5938,8907,0,0,14845,5938,8907,0,0,14845
15,Sudan (UNDP),2017,SUD-17/HSD20/S1/RRR/INGO/4910,11/29/2018 5:55:44 AM,People in Host Communities,2760,4140,0,0,6900,3584,4500,0,0,8084
15,Sudan (UNDP),2017,SUD-17/HSD20/S1/RRR/INGO/4910,11/29/2018 5:55:44 AM,Returnees,3178,4767,0,0,7945,2348,4413,0,0,6761
15,Sudan (UNDP),2017,SUD-17/HSD20/S1/RRR/NGO/4751,6/28/2018 7:07:57 AM,Overall,300,450,300,450,1500,300,450,300,450,1500
15,Sudan (UNDP),2017,SUD-17/HSD20/S1/RRR/NGO/4751,6/28/2018 7:07:57 AM,Returnees,300,450,300,450,1500,300,450,300,450,1500
15,Sudan (UNDP),2017,SUD-17/HSD20/S1/RRR/UN/4840,10/10/2018 7:14:39 AM,Internally Displaced People,221,370,395,247,1233,40,9,3,45,97
15,Sudan (UNDP),2017,SUD-17/HSD20/S1/RRR/UN/4840,10/10/2018 7:14:39 AM,Overall,1710,3150,2740,1900,9500,1700,2700,2989,1890,9279
15,Sudan (UNDP),2017,SUD-17/HSD20/S1/RRR/UN/4840,10/10/2018 7:14:39 AM,Pastoralists,35,57,61,38,191,159,35,129,19,342
15,Sudan (UNDP),2017,SUD-17/HSD20/S1/RRR/UN/4840,10/10/2018 7:14:39 AM,People in Host Communities,684,1240,1216,760,3900,600,611,1101,971,3283
15,Sudan (UNDP),2017,SUD-17/HSD20/S1/RRR/UN/4840,10/10/2018 7:14:39 AM,Returnees,770,1483,1068,855,4176,901,2045,1756,855,5557
15,Sudan (UNDP),2017,SUD-17/HSD20/S1/WASH/INGO/4753,9/6/2018 11:32:50 AM,Internally Displaced People,5029,5448,3910,4236,18623,10144,10990,7887,8544,37565
15,Sudan (UNDP),2017,SUD-17/HSD20/S1/WASH/INGO/4753,9/6/2018 11:32:50 AM,Overall,22543,24422,17526,18986,83477,15374,17586,10890,16938,60788
15,Sudan (UNDP),2017,SUD-17/HSD20/S1/WASH/INGO/4753,9/6/2018 11:32:50 AM,People in Host Communities,1114,1207,866,938,4125,0,0,0,0,0
15,Sudan (UNDP),2017,SUD-17/HSD20/S1/WASH/INGO/4753,9/6/2018 11:32:50 AM,Returnees,16400,17767,12750,13812,60729,12399,13432,9639,10442,45912
15,Sudan (UNDP),2017,SUD-17/HSD20/S1/WASH/INGO/4755,7/30/2018 6:29:49 AM,Internally Displaced People,16730,20170,17428,17672,72000,21796,26985,21538,21681,92000
15,Sudan (UNDP),2017,SUD-17/HSD20/S1/WASH/INGO/4755,7/30/2018 6:29:49 AM,Overall,21720,25990,21991,22299,92000,21796,26985,21538,21681,92000
15,Sudan (UNDP),2017,SUD-17/HSD20/S1/WASH/INGO/4755,7/30/2018 6:29:49 AM,People in Host Communities,1240,1460,1146,1154,5000,0,0,0,0,0
15,Sudan (UNDP),2017,SUD-17/HSD20/S1/WASH/INGO/4755,7/30/2018 6:29:49 AM,Returnees,3750,4360,3417,3473,15000,0,0,0,0,0
15,Sudan (UNDP),2017,SUD-17/HSD20/S1/WASH/INGO/4807,6/25/2018 12:54:38 PM,Internally Displaced People,1060,1189,1591,1684,5524,996,1173,1411,1596,5176
15,Sudan (UNDP),2017,SUD-17/HSD20/S1/WASH/INGO/4807,6/25/2018 12:54:38 PM,Overall,6240,6994,9360,9906,32500,6398,7549,9548,11388,34883
15,Sudan (UNDP),2017,SUD-17/HSD20/S1/WASH/INGO/4807,6/25/2018 12:54:38 PM,Pastoralists,1435,1608,2153,2278,7474,2968,3398,4531,5399,16296
15,Sudan (UNDP),2017,SUD-17/HSD20/S1/WASH/INGO/4807,6/25/2018 12:54:38 PM,People in Host Communities,2496,2798,3744,3962,13000,598,744,1142,1191,3675
15,Sudan (UNDP),2017,SUD-17/HSD20/S1/WASH/INGO/4807,6/25/2018 12:54:38 PM,Returnees,1249,1399,1872,1982,6502,1824,2157,2500,3255,9736
15,Sudan (UNDP),2017,SUD-17/HSD20/S1/WASH/INGO/4830,9/27/2018 6:56:43 AM,Internally Displaced People,2025,3510,3780,4185,13500,2390,4142,4460,4966,15958
15,Sudan (UNDP),2017,SUD-17/HSD20/S1/WASH/INGO/4830,9/27/2018 6:56:43 AM,Internally Displaced People/Returnees,675,1170,1260,1395,4500,796,1381,1488,1646,5311
15,Sudan (UNDP),2017,SUD-17/HSD20/S1/WASH/INGO/4830,9/27/2018 6:56:43 AM,Overall,6750,11700,12600,13950,45000,7965,13807,14869,16462,53103
15,Sudan (UNDP),2017,SUD-17/HSD20/S1/WASH/INGO/4830,9/27/2018 6:56:43 AM,People in Host Communities,4050,7020,7560,8370,27000,4752,8284,8921,9877,31834
15,Sudan (UNDP),2017,SUD-17/HSD20/S1/WASH/INGO/4844,9/6/2018 11:51:23 AM,Internally Displaced People,2044,2146,3057,3068,10315,2272,2385,4110,4311,13078
15,Sudan (UNDP),2017,SUD-17/HSD20/S1/WASH/INGO/4844,9/6/2018 11:51:23 AM,Overall,4007,4208,5995,6194,20404,4454,4676,8057,8451,25638
15,Sudan (UNDP),2017,SUD-17/HSD20/S1/WASH/INGO/4844,9/6/2018 11:51:23 AM,Returnees,1963,2062,2938,3126,10089,2182,2291,3947,4140,12560
15,Sudan (UNDP),2017,SUD-17/HSD20/S1/WASH/INGO/4913,7/11/2018 12:51:53 PM,Internally Displaced People,24174,23891,4991,4693,57749,24490,24023,4914,4722,58149
15,Sudan (UNDP),2017,SUD-17/HSD20/S1/WASH/INGO/4913,7/11/2018 12:51:53 PM,Overall,25374,24891,5091,4893,60249,25374,24891,5091,4893,60249
15,Sudan (UNDP),2017,SUD-17/HSD20/S1/WASH/INGO/4913,7/11/2018 12:51:53 PM,People in Host Communities,800,1000,100,200,2100,884,868,177,171,2100
15,Sudan (UNDP),2017,SUD-17/HSD20/S1/WASH/INGO/4923,12/5/2018 6:42:43 AM,Internally Displaced People/Returnees,4929,6506,3726,4554,19715,6639,8763,5577,5577,26556
15,Sudan (UNDP),2017,SUD-17/HSD20/S1/WASH/INGO/4923,12/5/2018 6:42:43 AM,Overall,4929,6506,3726,4554,19715,6639,8763,5577,5577,26556
15,Sudan (UNDP),2017,SUD-17/HSD20/S1/WASH/INGO/4935,2/28/2019 5:25:58 PM,Internally Displaced People/Returnees,3805,3443,5074,5798,18120,3594,3251,4792,5476,17113
15,Sudan (UNDP),2017,SUD-17/HSD20/S1/WASH/INGO/4935,2/28/2019 5:25:58 PM,Overall,10983,9937,14664,16736,52320,9713,8788,12950,14800,46251
15,Sudan (UNDP),2017,SUD-17/HSD20/S1/WASH/INGO/4935,2/28/2019 5:25:58 PM,People in Host Communities,4800,4342,6399,7314,22855,4176,3779,5569,6364,19888
15,Sudan (UNDP),2017,SUD-17/HSD20/S1/WASH/INGO/4935,2/28/2019 5:25:58 PM,Returnees,2378,2152,3171,3624,11325,1943,1758,2590,2960,9251
15,Sudan (UNDP),2018,SUD-18/HSD20/RE/H/UN/11359,9/15/2019 6:32:40 AM,Children under 18,0,0,69000,99500,168500,0,0,139067,160461,299528
15,Sudan (UNDP),2018,SUD-18/HSD20/RE/H/UN/11359,9/15/2019 6:32:40 AM,Overall,165000,184500,69000,99500,518000,166650,186345,69605,100400,523000
15,Sudan (UNDP),2018,SUD-18/HSD20/RE/H/UN/11359,9/15/2019 6:32:40 AM,Women of Child-Bearing Age,0,95300,0,0,95300,0,267436,0,0,267436
15,Sudan (UNDP),2018,SUD-18/HSD20/RE/H/UN/11360,6/27/2019 6:49:47 AM,Children under 18,0,0,129279,134556,263835,0,0,0,0,0
15,Sudan (UNDP),2018,SUD-18/HSD20/RE/H/UN/11360,6/27/2019 6:49:47 AM,Other,119335,124205,0,0,243540,0,0,0,0,0
15,Sudan (UNDP),2018,SUD-18/HSD20/RE/H/UN/11360,6/27/2019 6:49:47 AM,Overall,119335,124205,129279,134556,507375,140075,152256,157423,159268,609022
15,Sudan (UNDP),2018,SUD-18/HSD20/RE/H-N/INGO/10459,12/18/2019 12:29:01 PM,Children under 5,0,0,372,455,827,0,0,1229,1430,2659
15,Sudan (UNDP),2018,SUD-18/HSD20/RE/H-N/INGO/10459,12/18/2019 12:29:01 PM,Internally Displaced People,1423,1106,0,0,2529,4089,3000,1070,281,8440
15,Sudan (UNDP),2018,SUD-18/HSD20/RE/H-N/INGO/10459,12/18/2019 12:29:01 PM,Overall,4732,5784,372,455,11343,11289,13759,3679,3931,32658
15,Sudan (UNDP),2018,SUD-18/HSD20/RE/H-N/INGO/10459,12/18/2019 12:29:01 PM,People in Host Communities,3309,4048,0,0,7357,7200,10759,1380,720,20059
15,Sudan (UNDP),2018,SUD-18/HSD20/RE/H-N/INGO/10459,12/18/2019 12:29:01 PM,Pregnant and Lactating Women,0,630,0,0,630,0,0,0,1500,1500
15,Sudan (UNDP),2018,SUD-18/HSD20/RE/H-N/INGO/9217,6/12/2019 6:21:08 AM,Children under 5,0,0,2276,2226,4502,0,0,0,0,0
15,Sudan (UNDP),2018,SUD-18/HSD20/RE/H-N/INGO/9217,6/12/2019 6:21:08 AM,Internally Displaced People/Returnees,2383,2647,728,860,6618,0,0,0,0,0
15,Sudan (UNDP),2018,SUD-18/HSD20/RE/H-N/INGO/9217,6/12/2019 6:21:08 AM,Overall,8510,10936,4876,5298,29620,11676,12535,6708,6659,37578
15,Sudan (UNDP),2018,SUD-18/HSD20/RE/H-N/INGO/9217,6/12/2019 6:21:08 AM,People in Host Communities,6127,6808,1872,2212,17019,0,0,0,0,0
15,Sudan (UNDP),2018,SUD-18/HSD20/RE/H-N/INGO/9217,6/12/2019 6:21:08 AM,Pregnant and Lactating Women,0,1481,0,0,1481,0,0,0,0,0
15,Sudan (UNDP),2018,SUD-18/HSD20/RE/H-N-WASH-ESNFIs/INGO/9210,9/2/2019 12:29:20 PM,Internally Displaced People/Returnees,1090,1181,726,787,3784,1090,1181,726,787,3784
15,Sudan (UNDP),2018,SUD-18/HSD20/RE/H-N-WASH-ESNFIs/INGO/9210,9/2/2019 12:29:20 PM,Other,483,523,323,349,1678,483,523,323,349,1678
15,Sudan (UNDP),2018,SUD-18/HSD20/RE/H-N-WASH-ESNFIs/INGO/9210,9/2/2019 12:29:20 PM,Overall,2077,2250,1385,1500,7212,2077,2250,1385,1500,7212
15,Sudan (UNDP),2018,SUD-18/HSD20/RE/H-N-WASH-ESNFIs/INGO/9210,9/2/2019 12:29:20 PM,People in Host Communities,504,546,336,364,1750,504,546,336,364,1750
15,Sudan (UNDP),2018,SUD-18/HSD20/RE/L/UN/10939,12/22/2019 12:59:46 PM,Overall,2700,2700,0,0,5400,2818,2818,0,0,5636
15,Sudan (UNDP),2018,SUD-18/HSD20/RE/RCF/INGO/10829,2/11/2020 8:08:55 AM,Overall,5850,5400,7150,6600,25000,10719,11156,4500,4875,31250
15,Sudan (UNDP),2018,SUD-18/HSD20/RE/RCF/INGO/10829,2/11/2020 8:08:55 AM,People in Host Communities,1462,1350,1788,1650,6250,10719,11156,4500,4875,31250
15,Sudan (UNDP),2018,SUD-18/HSD20/RE/RCF/INGO/10830,7/12/2020 12:58:54 PM,Other,5175,5400,6075,5850,22500,5175,5400,6075,5850,22500
15,Sudan (UNDP),2018,SUD-18/HSD20/RE/RCF/INGO/10830,7/12/2020 12:58:54 PM,Overall,5175,5400,6075,5850,22500,5175,5400,6075,5850,22500
15,Sudan (UNDP),2018,SUD-18/HSD20/RE/RCF/NGO/10828,10/13/2019 2:09:47 PM,Children under 5,0,0,0,0,0,0,0,16,15,31
15,Sudan (UNDP),2018,SUD-18/HSD20/RE/RCF/NGO/10828,10/13/2019 2:09:47 PM,Committees,60,75,5,10,150,75,75,0,0,150
15,Sudan (UNDP),2018,SUD-18/HSD20/RE/RCF/NGO/10828,10/13/2019 2:09:47 PM,Other,0,0,0,0,0,8400,12384,13716,14919,49419
15,Sudan (UNDP),2018,SUD-18/HSD20/RE/RCF/NGO/10828,10/13/2019 2:09:47 PM,Overall,8496,10384,13688,14632,47200,8400,12384,13732,14934,49450
15,Sudan (UNDP),2018,SUD-18/HSD20/RE/RCF/NGO/10831,3/3/2020 7:17:05 AM,Children under 5,0,0,2205,2295,4500,0,0,32088,32220,64308
15,Sudan (UNDP),2018,SUD-18/HSD20/RE/RCF/NGO/10831,3/3/2020 7:17:05 AM,Other,8750,9010,0,0,17760,20450,28678,0,0,49128
15,Sudan (UNDP),2018,SUD-18/HSD20/RE/RCF/NGO/10831,3/3/2020 7:17:05 AM,Overall,8795,9055,2205,2295,22350,20471,28741,32088,32220,113520
15,Sudan (UNDP),2018,SUD-18/HSD20/RE/RCF/NGO/10831,3/3/2020 7:17:05 AM,"Trainers, Promoters, Caretakers, committee members, etc.",45,45,0,0,90,21,63,0,0,84
15,Sudan (UNDP),2018,SUD-18/HSD20/RE/WASH/INGO/9226,12/4/2018 11:57:27 AM,Internally Displaced People,5805,6040,4749,4942,21536,5805,6040,4749,4942,21536
15,Sudan (UNDP),2018,SUD-18/HSD20/RE/WASH/INGO/9226,12/4/2018 11:57:27 AM,Overall,7261,7804,5672,5799,26536,7261,7804,5672,5799,26536
15,Sudan (UNDP),2018,SUD-18/HSD20/RE/WASH/INGO/9226,12/4/2018 11:57:27 AM,Pastoralists,1456,1764,923,857,5000,1456,1764,923,857,5000
15,Sudan (UNDP),2018,SUD-18/HSD20/RE/WASH-ESNFIs-P/INGO/10466,12/18/2019 12:31:35 PM,Other,18547,21197,5299,7949,52992,23208,26524,6632,9946,66310
15,Sudan (UNDP),2018,SUD-18/HSD20/RE/WASH-ESNFIs-P/INGO/10466,12/18/2019 12:31:35 PM,Overall,18547,21197,5299,7949,52992,23208,26524,6632,9946,66310
15,Sudan (UNDP),2018,SUD-18/HSD20/RE/WASH-P/INGO/9218,6/16/2019 10:29:31 AM,Internally Displaced People,602,632,873,903,3010,2359,2895,2573,2896,10723
15,Sudan (UNDP),2018,SUD-18/HSD20/RE/WASH-P/INGO/9218,6/16/2019 10:29:31 AM,Overall,2776,2915,4025,4164,13880,8078,8474,5009,8226,29787
15,Sudan (UNDP),2018,SUD-18/HSD20/RE/WASH-P/INGO/9218,6/16/2019 10:29:31 AM,People in Host Communities,890,935,1290,1335,4450,1233,1501,1287,1341,5362
15,Sudan (UNDP),2018,SUD-18/HSD20/RE/WASH-P/INGO/9218,6/16/2019 10:29:31 AM,Returnees,1284,1348,1862,1926,6420,3014,3837,3289,3562,13702
15,Sudan (UNDP),2018,SUD-18/HSD20/SA1/H-WASH/INGO/7734,12/22/2019 10:29:23 AM,Internally Displaced People,5699,8249,1888,2537,18373,1600,1830,4000,4000,11430
15,Sudan (UNDP),2018,SUD-18/HSD20/SA1/H-WASH/INGO/7734,12/22/2019 10:29:23 AM,Other,397,642,330,360,1729,18000,20000,8900,5300,52200
15,Sudan (UNDP),2018,SUD-18/HSD20/SA1/H-WASH/INGO/7734,12/22/2019 10:29:23 AM,Overall,52925,79388,14885,18193,165391,103850,111650,81450,50375,347325
15,Sudan (UNDP),2018,SUD-18/HSD20/SA1/H-WASH/INGO/7734,12/22/2019 10:29:23 AM,People in Host Communities,46829,70497,12667,15296,145289,84250,89820,68550,41075,283695
15,Sudan (UNDP),2018,SUD-18/HSD20/SA1/H-WASH/INGO/8327,12/29/2019 10:24:51 AM,Other,0,0,0,0,0,194956,267772,143808,144478,751014
15,Sudan (UNDP),2018,SUD-18/HSD20/SA1/H-WASH/INGO/8327,12/29/2019 10:24:51 AM,Overall,111163,126247,120325,114890,472625,194963,267771,143807,144479,751020
15,Sudan (UNDP),2018,SUD-18/HSD20/SA1/RCF/INGO/7726,12/22/2019 10:50:44 AM,Children under 5,0,0,0,0,0,3449,5751,6899,6899,22998
15,Sudan (UNDP),2018,SUD-18/HSD20/SA1/RCF/INGO/7726,12/22/2019 10:50:44 AM,Overall,5466,6958,6760,9828,29012,3449,5751,6899,6899,22998
15,Sudan (UNDP),2018,SUD-18/HSD20/SA1/RCF/INGO/7743,12/29/2019 10:41:58 AM,Overall,5385,6855,10880,10880,34000,3896,7643,11559,15375,38473
15,Sudan (UNDP),2018,SUD-18/HSD20/SA1/RCF/NGO/7723,12/22/2019 10:32:05 AM,Other,833,1038,741,1017,3629,1690,2534,14256,8904,27384
15,Sudan (UNDP),2018,SUD-18/HSD20/SA1/RCF/NGO/7723,12/22/2019 10:32:05 AM,Overall,834,1038,741,1017,3630,1690,2534,14256,8904,27384
15,Sudan (UNDP),2018,SUD-18/HSD20/SA1/WASH-H/INGO/7718,5/28/2019 1:19:08 PM,Children under 18,0,0,20765,22496,43261,31665,32932,23865,24888,113350
15,Sudan (UNDP),2018,SUD-18/HSD20/SA1/WASH-H/INGO/7718,5/28/2019 1:19:08 PM,Internally Displaced People,590,639,567,614,2410,22202,24054,21332,23110,90698
15,Sudan (UNDP),2018,SUD-18/HSD20/SA1/WASH-H/INGO/7718,5/28/2019 1:19:08 PM,Other,21613,23414,0,0,45027,0,0,0,0,0
15,Sudan (UNDP),2018,SUD-18/HSD20/SA1/WASH-H/INGO/7718,5/28/2019 1:19:08 PM,Overall,22203,24053,21332,23110,90698,31665,32932,23865,24888,113350
15,Sudan (UNDP),2018,SUD-18/HSD20/SA2/E/INGO/8053,12/22/2019 10:38:13 AM,Children under 18,0,0,1449,1708,3157,0,0,0,0,0
15,Sudan (UNDP),2018,SUD-18/HSD20/SA2/E/INGO/8053,12/22/2019 10:38:13 AM,Internally Displaced People,0,0,0,0,0,90,89,1159,1280,2618
15,Sudan (UNDP),2018,SUD-18/HSD20/SA2/E/INGO/8053,12/22/2019 10:38:13 AM,Other,66,54,0,0,120,0,0,0,0,0
15,Sudan (UNDP),2018,SUD-18/HSD20/SA2/E/INGO/8053,12/22/2019 10:38:13 AM,Overall,66,54,1449,1708,3277,107,104,1649,1908,3768
15,Sudan (UNDP),2018,SUD-18/HSD20/SA2/E/INGO/8053,12/22/2019 10:38:13 AM,People in Host Communities,0,0,0,0,0,17,15,490,628,1150
15,Sudan (UNDP),2018,SUD-18/HSD20/SA2/E/INGO/8219,12/18/2019 12:34:53 PM,Internally Displaced People,110,115,2302,3531,6058,125,115,2310,3610,6160
15,Sudan (UNDP),2018,SUD-18/HSD20/SA2/E/INGO/8219,12/18/2019 12:34:53 PM,Overall,110,115,2302,3531,6058,125,115,2310,3610,6160
15,Sudan (UNDP),2018,SUD-18/HSD20/SA2/E/NGO/7803,9/5/2019 11:33:38 AM,Committees,25,9,0,0,34,0,0,0,0,0
15,Sudan (UNDP),2018,SUD-18/HSD20/SA2/E/NGO/7803,9/5/2019 11:33:38 AM,Internally Displaced People,30,11,689,812,1542,1853,3129,2334,3553,10869
15,Sudan (UNDP),2018,SUD-18/HSD20/SA2/E/NGO/7803,9/5/2019 11:33:38 AM,Internally Displaced People/Returnees,12,10,610,525,1157,0,0,0,0,0
15,Sudan (UNDP),2018,SUD-18/HSD20/SA2/E/NGO/7803,9/5/2019 11:33:38 AM,Overall,72,38,1308,1351,2769,1853,3129,2334,3553,10869
15,Sudan (UNDP),2018,SUD-18/HSD20/SA2/E/NGO/7803,9/5/2019 11:33:38 AM,People in Host Communities,5,8,9,14,36,0,0,0,0,0
15,Sudan (UNDP),2018,SUD-18/HSD20/SA2/E/NGO/8012,12/16/2019 6:43:48 AM,Children under 18,0,0,1132,919,2051,0,0,1204,1163,2367
15,Sudan (UNDP),2018,SUD-18/HSD20/SA2/E/NGO/8012,12/16/2019 6:43:48 AM,Other,55,35,0,0,90,73,25,0,0,98
15,Sudan (UNDP),2018,SUD-18/HSD20/SA2/E/NGO/8012,12/16/2019 6:43:48 AM,Overall,55,35,1132,919,2141,73,25,1204,1163,2465
15,Sudan (UNDP),2018,SUD-18/HSD20/SA2/E-P/INGO/7838,12/29/2019 10:18:50 AM,Internally Displaced People/Returnees,563,540,2034,2198,5335,23564,23483,34050,35603,116700
15,Sudan (UNDP),2018,SUD-18/HSD20/SA2/E-P/INGO/7838,12/29/2019 10:18:50 AM,Overall,704,675,2543,2747,6669,66437,69713,150360,399260,685770
15,Sudan (UNDP),2018,SUD-18/HSD20/SA2/E-P/INGO/7838,12/29/2019 10:18:50 AM,People in Host Communities,141,135,509,549,1334,42873,46230,116310,363657,569070
15,Sudan (UNDP),2018,SUD-18/HSD20/SA2/FSL/INGO/7820,7/22/2019 5:45:53 AM,Agro-Pastoralists,4900,5000,2500,2600,15000,2220,1900,1177,1103,6400
15,Sudan (UNDP),2018,SUD-18/HSD20/SA2/FSL/INGO/7820,7/22/2019 5:45:53 AM,Overall,6400,6000,3922,3678,20000,6550,6100,4002,3748,20400
15,Sudan (UNDP),2018,SUD-18/HSD20/SA2/FSL/INGO/7820,7/22/2019 5:45:53 AM,Pastoralists,1500,1000,1422,1078,5000,4480,4199,2746,2575,14000
15,Sudan (UNDP),2018,SUD-18/HSD20/SA2/FSL/INGO/7830,12/23/2019 6:28:10 AM,Internally Displaced People,596,824,0,0,1420,1226,1694,0,0,2920
15,Sudan (UNDP),2018,SUD-18/HSD20/SA2/FSL/INGO/7830,12/23/2019 6:28:10 AM,Other,836,1154,0,0,1990,284,392,0,0,676
15,Sudan (UNDP),2018,SUD-18/HSD20/SA2/FSL/INGO/7830,12/23/2019 6:28:10 AM,Overall,6539,9031,0,0,15570,11617,16044,0,0,27661
15,Sudan (UNDP),2018,SUD-18/HSD20/SA2/FSL/INGO/7830,12/23/2019 6:28:10 AM,People in Host Communities,5107,7053,0,0,12160,10107,13958,0,0,24065
15,Sudan (UNDP),2018,SUD-18/HSD20/SA2/FSL/INGO/7865,9/5/2019 10:52:51 AM,Internally Displaced People/Returnees,996,1105,1554,1595,5250,1423,1579,2220,2278,7500
15,Sudan (UNDP),2018,SUD-18/HSD20/SA2/FSL/INGO/7865,9/5/2019 10:52:51 AM,Overall,1423,1579,2220,2278,7500,1423,1579,2220,2278,7500
15,Sudan (UNDP),2018,SUD-18/HSD20/SA2/FSL/INGO/7865,9/5/2019 10:52:51 AM,People in Host Communities,427,474,666,683,2250,0,0,0,0,0
15,Sudan (UNDP),2018,SUD-18/HSD20/SA2/FSL/INGO/8037,12/23/2019 6:41:55 AM,Internally Displaced People,9288,9834,3005,5191,27318,0,0,0,0,0
15,Sudan (UNDP),2018,SUD-18/HSD20/SA2/FSL/INGO/8037,12/23/2019 6:41:55 AM,Overall,9777,10352,3163,5464,28756,6752,6951,2384,3773,19860
15,Sudan (UNDP),2018,SUD-18/HSD20/SA2/FSL/INGO/8037,12/23/2019 6:41:55 AM,People in Host Communities,489,518,158,273,1438,6752,6951,2384,3773,19860
15,Sudan (UNDP),2018,SUD-18/HSD20/SA2/FSL/INGO/8803,6/18/2019 11:33:45 AM,Internally Displaced People/Returnees,5095,5303,1044,1087,12529,3111,3238,637,663,7649
15,Sudan (UNDP),2018,SUD-18/HSD20/SA2/FSL/INGO/8803,6/18/2019 11:33:45 AM,Overall,7428,7731,1521,1584,18264,18302,19048,3748,3902,45000
15,Sudan (UNDP),2018,SUD-18/HSD20/SA2/FSL/INGO/8803,6/18/2019 11:33:45 AM,People in Host Communities,2333,2428,477,497,5735,15190,15810,3113,3238,37351
15,Sudan (UNDP),2018,SUD-18/HSD20/SA2/FSL/UN/8022,9/15/2019 6:22:58 AM,Agro-Pastoralists,3087,3347,1323,1377,9134,3156,3284,1352,1408,9200
15,Sudan (UNDP),2018,SUD-18/HSD20/SA2/FSL/UN/8022,9/15/2019 6:22:58 AM,Overall,9261,10039,3969,4131,27400,9261,10039,3969,4131,27400
15,Sudan (UNDP),2018,SUD-18/HSD20/SA2/FSL/UN/8022,9/15/2019 6:22:58 AM,Pastoralists,3087,3346,1323,1377,9133,3156,3284,1352,1408,9200
15,Sudan (UNDP),2018,SUD-18/HSD20/SA2/FSL/UN/8022,9/15/2019 6:22:58 AM,People in Host Communities,3087,3346,1323,1377,9133,3087,3213,1323,1377,9000
15,Sudan (UNDP),2018,SUD-18/HSD20/SA2/FSL-P/INGO/8168,3/3/2020 7:11:01 AM,Internally Displaced People/Returnees,3325,4305,8225,8225,24080,5133,4367,9222,9182,27904
15,Sudan (UNDP),2018,SUD-18/HSD20/SA2/FSL-P/INGO/8168,3/3/2020 7:11:01 AM,Overall,5025,6005,11000,11000,33030,5133,4367,9222,9182,27904
15,Sudan (UNDP),2018,SUD-18/HSD20/SA2/FSL-WASH/INGO/8381,12/28/2020 11:56:50 AM,Agro-Pastoralists,13892,13033,8397,8069,43391,7524,7282,4855,4612,24273
15,Sudan (UNDP),2018,SUD-18/HSD20/SA2/FSL-WASH/INGO/8381,12/28/2020 11:56:50 AM,Overall,18524,17366,11218,10778,57886,14331,13870,9247,8785,46233
15,Sudan (UNDP),2018,SUD-18/HSD20/SA2/FSL-WASH/INGO/8381,12/28/2020 11:56:50 AM,Pastoralists,4632,4333,2821,2709,14495,6807,6588,4392,4173,21960
15,Sudan (UNDP),2018,SUD-18/HSD20/SA2/H/INGO/7785,9/2/2019 12:37:36 PM,Children under 18,0,0,14704,15937,30641,0,0,35952,44422,80374
15,Sudan (UNDP),2018,SUD-18/HSD20/SA2/H/INGO/7785,9/2/2019 12:37:36 PM,Internally Displaced People,24887,20244,0,0,45131,43267,15266,0,0,58533
15,Sudan (UNDP),2018,SUD-18/HSD20/SA2/H/INGO/7785,9/2/2019 12:37:36 PM,Overall,24887,69589,14704,15937,125117,43267,84191,35952,44422,207832
15,Sudan (UNDP),2018,SUD-18/HSD20/SA2/H/INGO/7785,9/2/2019 12:37:36 PM,Women of Child-Bearing Age,0,49345,0,0,49345,0,68925,0,0,68925
15,Sudan (UNDP),2018,SUD-18/HSD20/SA2/H-E/NGO/7846,7/23/2019 7:52:05 AM,Internally Displaced People,4640,7192,5800,5568,23200,0,0,0,0,0
15,Sudan (UNDP),2018,SUD-18/HSD20/SA2/H-E/NGO/7846,7/23/2019 7:52:05 AM,Other,5600,8680,6200,7520,28000,0,30,9,15,54
15,Sudan (UNDP),2018,SUD-18/HSD20/SA2/H-E/NGO/7846,7/23/2019 7:52:05 AM,Overall,16000,24800,19200,20000,80000,12006,17439,8830,10015,48290
15,Sudan (UNDP),2018,SUD-18/HSD20/SA2/H-E/NGO/7846,7/23/2019 7:52:05 AM,Returnees,1600,2480,2000,1920,8000,0,0,0,0,0
15,Sudan (UNDP),2018,SUD-18/HSD20/SA2/H-N/INGO/7798,12/29/2019 7:48:15 AM,Internally Displaced People,9952,10689,7741,8478,36860,7766,8083,9885,10288,36022
15,Sudan (UNDP),2018,SUD-18/HSD20/SA2/H-N/INGO/7798,12/29/2019 7:48:15 AM,Overall,28847,30983,22438,24574,106842,24423,25420,31084,32353,113280
15,Sudan (UNDP),2018,SUD-18/HSD20/SA2/H-N/INGO/7798,12/29/2019 7:48:15 AM,People in Host Communities,12384,13301,9632,10550,45867,5081,5286,6465,6729,23561
15,Sudan (UNDP),2018,SUD-18/HSD20/SA2/H-N/INGO/7798,12/29/2019 7:48:15 AM,Returnees,6511,6993,5065,5546,24115,11577,12050,14733,15335,53695
15,Sudan (UNDP),2018,SUD-18/HSD20/SA2/H-N/INGO/7825,6/16/2019 10:34:12 AM,Children under 5,0,0,7167,7311,14478,0,0,0,0,0
15,Sudan (UNDP),2018,SUD-18/HSD20/SA2/H-N/INGO/7825,6/16/2019 10:34:12 AM,Internally Displaced People,34990,32291,0,0,67281,0,0,0,0,0
15,Sudan (UNDP),2018,SUD-18/HSD20/SA2/H-N/INGO/7825,6/16/2019 10:34:12 AM,Overall,34990,35698,7167,7311,85166,5723,34052,27273,27163,94211
15,Sudan (UNDP),2018,SUD-18/HSD20/SA2/H-N/INGO/7825,6/16/2019 10:34:12 AM,Pregnant and Lactating Women,0,3407,0,0,3407,0,0,0,0,0
15,Sudan (UNDP),2018,SUD-18/HSD20/SA2/H-N/INGO/7834,8/21/2019 6:33:57 AM,Children under 5,0,0,42504,45591,88095,0,0,0,0,0
15,Sudan (UNDP),2018,SUD-18/HSD20/SA2/H-N/INGO/7834,8/21/2019 6:33:57 AM,Internally Displaced People,50657,53955,0,0,104612,0,0,0,0,0
15,Sudan (UNDP),2018,SUD-18/HSD20/SA2/H-N/INGO/7834,8/21/2019 6:33:57 AM,Overall,50657,53955,42504,45591,192707,50030,81432,28439,32166,192067
15,Sudan (UNDP),2018,SUD-18/HSD20/SA2/H-N/INGO/7855,9/5/2019 10:42:33 AM,Internally Displaced People,12210,12708,2501,2603,30022,61580,64093,38560,38920,203153
15,Sudan (UNDP),2018,SUD-18/HSD20/SA2/H-N/INGO/7855,9/5/2019 10:42:33 AM,Overall,73886,76901,15133,15751,181671,61580,64093,38560,38920,203153
15,Sudan (UNDP),2018,SUD-18/HSD20/SA2/H-N/INGO/7855,9/5/2019 10:42:33 AM,Pregnant and Lactating Women,0,7266,0,0,7266,0,0,0,0,0
15,Sudan (UNDP),2018,SUD-18/HSD20/SA2/H-N/INGO/7861,8/21/2019 7:12:47 AM,Children under 18,0,0,31000,30123,61123,0,0,0,0,0
15,Sudan (UNDP),2018,SUD-18/HSD20/SA2/H-N/INGO/7861,8/21/2019 7:12:47 AM,Internally Displaced People,15197,16817,0,0,32014,0,0,0,0,0
15,Sudan (UNDP),2018,SUD-18/HSD20/SA2/H-N/INGO/7861,8/21/2019 7:12:47 AM,Overall,37993,40838,31000,30123,139954,32164,39810,26540,28094,126608
15,Sudan (UNDP),2018,SUD-18/HSD20/SA2/H-N/INGO/7861,8/21/2019 7:12:47 AM,People in Host Communities,22796,24021,0,0,46817,0,0,0,0,0
15,Sudan (UNDP),2018,SUD-18/HSD20/SA2/H-N-WASH/UN/7862,12/18/2019 12:30:31 PM,Children under 5,0,0,0,0,0,0,0,21548,23344,44892
15,Sudan (UNDP),2018,SUD-18/HSD20/SA2/H-N-WASH/UN/7862,12/18/2019 12:30:31 PM,Internally Displaced People/Returnees,73868,76883,18467,19176,188394,105943,57390,13593,13573,190499
15,Sudan (UNDP),2018,SUD-18/HSD20/SA2/H-N-WASH/UN/7862,12/18/2019 12:30:31 PM,Overall,94864,98736,23716,24684,242000,105943,119740,35141,36917,297741
15,Sudan (UNDP),2018,SUD-18/HSD20/SA2/H-N-WASH/UN/7862,12/18/2019 12:30:31 PM,Pregnant and Lactating Women,0,9680,0,0,9680,0,62350,0,0,62350
15,Sudan (UNDP),2018,SUD-18/HSD20/SA2/N/UN/8225,6/18/2019 11:30:09 AM,Overall,0,0,8290,8289,16579,0,0,8124,8455,16579
15,Sudan (UNDP),2018,SUD-18/HSD20/SA2/N-H/INGO/8561,2/12/2021 3:52:48 PM,Children under 5,0,0,2256,2156,4412,0,0,7093,6944,14037
15,Sudan (UNDP),2018,SUD-18/HSD20/SA2/N-H/INGO/8561,2/12/2021 3:52:48 PM,Overall,7181,35913,14365,14365,71824,36863,61297,53276,57692,209128
15,Sudan (UNDP),2018,SUD-18/HSD20/SA2/N-H/INGO/8561,2/12/2021 3:52:48 PM,People in Host Communities,7181,15012,0,0,22193,36863,46142,46183,50748,179936
15,Sudan (UNDP),2018,SUD-18/HSD20/SA2/N-H/INGO/8561,2/12/2021 3:52:48 PM,Pregnant and Lactating Women,0,20901,0,0,20901,0,15155,0,0,15155
15,Sudan (UNDP),2018,SUD-18/HSD20/SA2/N-H/NGO/8055,7/20/2019 6:11:39 AM,Children under 5,0,0,877,1316,2193,0,0,741,931,1672
15,Sudan (UNDP),2018,SUD-18/HSD20/SA2/N-H/NGO/8055,7/20/2019 6:11:39 AM,Overall,42,10408,980,1470,12900,23,9528,741,931,11223
15,Sudan (UNDP),2018,SUD-18/HSD20/SA2/N-H/NGO/8055,7/20/2019 6:11:39 AM,Pregnant and Lactating Women,0,516,0,0,516,0,3529,0,0,3529
15,Sudan (UNDP),2018,SUD-18/HSD20/SA2/N-H/NGO/8055,7/20/2019 6:11:39 AM,"Trainers, Promoters, Caretakers, committee members, etc.",0,82,0,0,82,23,59,0,0,82
15,Sudan (UNDP),2018,SUD-18/HSD20/SA2/N-H/NGO/8055,7/20/2019 6:11:39 AM,Women of Child-Bearing Age,0,516,0,0,516,0,2411,0,0,2411
15,Sudan (UNDP),2018,SUD-18/HSD20/SA2/P/INGO/7907,6/29/2019 7:59:38 AM,Children under 18,0,0,4134,4312,8446,126,144,2332,2605,5207
15,Sudan (UNDP),2018,SUD-18/HSD20/SA2/P/INGO/7907,6/29/2019 7:59:38 AM,Overall,103,107,4134,4312,8656,126,144,2332,2605,5207
15,Sudan (UNDP),2018,SUD-18/HSD20/SA2/P/INGO/7907,6/29/2019 7:59:38 AM,"Trainers, Promoters, Caretakers, committee members, etc.",103,107,0,0,210,126,144,2332,2605,5207
15,Sudan (UNDP),2018,SUD-18/HSD20/SA2/P/NGO/8186,12/18/2019 12:22:51 PM,Internally Displaced People,490,3960,2300,2300,9050,128,153,2985,1997,5263
15,Sudan (UNDP),2018,SUD-18/HSD20/SA2/P/NGO/8186,12/18/2019 12:22:51 PM,Overall,665,4135,2300,2300,9400,275,4979,2985,1997,10236
15,Sudan (UNDP),2018,SUD-18/HSD20/SA2/P/NGO/8186,12/18/2019 12:22:51 PM,"Trainers, Promoters, Caretakers, committee members, etc.",175,175,0,0,350,147,4826,0,0,4973
15,Sudan (UNDP),2018,SUD-18/HSD20/SA2/P/NGO/8884,8/22/2019 7:42:46 AM,Internally Displaced People,1546,3540,350,1050,6486,432,1180,466,863,2941
15,Sudan (UNDP),2018,SUD-18/HSD20/SA2/P/NGO/8884,8/22/2019 7:42:46 AM,Overall,1546,3540,350,1050,6486,976,2204,1092,1627,5899
15,Sudan (UNDP),2018,SUD-18/HSD20/SA2/RCF/INGO/7775,9/2/2019 12:34:01 PM,Other,739,914,1186,1257,4096,0,0,0,0,0
15,Sudan (UNDP),2018,SUD-18/HSD20/SA2/RCF/INGO/7775,9/2/2019 12:34:01 PM,Overall,1027,1283,1498,1566,5374,6249,9108,2012,2165,19534
15,Sudan (UNDP),2018,SUD-18/HSD20/SA2/RCF/INGO/7775,9/2/2019 12:34:01 PM,People in Host Communities,288,39,312,309,948,0,0,0,0,0
15,Sudan (UNDP),2018,SUD-18/HSD20/SA2/RCF/INGO/7791,12/18/2019 6:36:56 AM,Children under 5,0,0,1285,1929,3214,0,0,4600,5500,10100
15,Sudan (UNDP),2018,SUD-18/HSD20/SA2/RCF/INGO/7791,12/18/2019 6:36:56 AM,Other,1555,2333,1715,2572,8175,5200,8260,1900,2560,17920
15,Sudan (UNDP),2018,SUD-18/HSD20/SA2/RCF/INGO/7791,12/18/2019 6:36:56 AM,Overall,4286,6429,4286,6430,21431,11600,17500,12900,13900,55900
15,Sudan (UNDP),2018,SUD-18/HSD20/SA2/RCF/INGO/7791,12/18/2019 6:36:56 AM,People in Host Communities,1953,2929,1286,1929,8097,6400,9240,6400,5840,27880
15,Sudan (UNDP),2018,SUD-18/HSD20/SA2/RCF/INGO/7805,7/1/2019 9:54:37 AM,Overall,7827,7827,6404,9566,31624,7827,7827,7029,10110,32793
15,Sudan (UNDP),2018,SUD-18/HSD20/SA2/RCF/INGO/7823,7/1/2019 8:41:14 AM,Other,5500,5572,1717,1713,14502,15480,18876,8179,9427,51962
15,Sudan (UNDP),2018,SUD-18/HSD20/SA2/RCF/INGO/7823,7/1/2019 8:41:14 AM,Overall,14497,14030,6185,5863,40575,21765,26626,11387,13157,72935
15,Sudan (UNDP),2018,SUD-18/HSD20/SA2/RCF/INGO/8199,12/22/2019 12:56:47 PM,Other,2100,2400,600,900,6000,3416,3915,977,1454,9762
15,Sudan (UNDP),2018,SUD-18/HSD20/SA2/RCF/INGO/8199,12/22/2019 12:56:47 PM,Overall,2100,2400,600,900,6000,3416,3915,977,1454,9762
15,Sudan (UNDP),2018,SUD-18/HSD20/SA2/RCF/NGO/8217,6/16/2019 9:25:51 AM,Other,0,0,533,579,1112,0,0,0,0,0
15,Sudan (UNDP),2018,SUD-18/HSD20/SA2/RCF/NGO/8217,6/16/2019 9:25:51 AM,Overall,129,161,1681,1826,3797,132,138,3406,3546,7222
15,Sudan (UNDP),2018,SUD-18/HSD20/SA2/RCF/NGO/8217,6/16/2019 9:25:51 AM,People in Host Communities,0,0,1148,1247,2395,0,0,0,0,0
15,Sudan (UNDP),2018,SUD-18/HSD20/SA2/RCF/NGO/8217,6/16/2019 9:25:51 AM,"Trainers, Promoters, Caretakers, committee members, etc.",129,161,0,0,290,34,71,0,0,105
15,Sudan (UNDP),2018,SUD-18/HSD20/SA2/RRR/INGO/8368,2/3/2020 10:50:33 AM,Internally Displaced People/Returnees,2853,3153,4355,4656,15017,713,788,1088,1164,3753
15,Sudan (UNDP),2018,SUD-18/HSD20/SA2/RRR/INGO/8368,2/3/2020 10:50:33 AM,Overall,3566,3941,5443,5820,18770,3566,3941,5443,5820,18770
15,Sudan (UNDP),2018,SUD-18/HSD20/SA2/RRR/INGO/8368,2/3/2020 10:50:33 AM,People in Host Communities,713,788,1088,1164,3753,2853,3153,4355,4656,15017
15,Sudan (UNDP),2018,SUD-18/HSD20/SA2/RRR/INGO/8697,3/3/2020 7:07:11 AM,Children under 5,0,0,2597,3020,5617,0,0,116,185,301
15,Sudan (UNDP),2018,SUD-18/HSD20/SA2/RRR/INGO/8697,3/3/2020 7:07:11 AM,Overall,13247,16190,3138,3817,36392,2567,5530,1992,2340,12429
15,Sudan (UNDP),2018,SUD-18/HSD20/SA2/RRR/INGO/8697,3/3/2020 7:07:11 AM,People in Host Communities,7617,6200,0,0,13817,1840,2537,1485,1665,7527
15,Sudan (UNDP),2018,SUD-18/HSD20/SA2/RRR/INGO/8697,3/3/2020 7:07:11 AM,Pregnant and Lactating Women,0,2287,0,0,2287,0,1834,0,0,1834
15,Sudan (UNDP),2018,SUD-18/HSD20/SA2/RRR/INGO/8697,3/3/2020 7:07:11 AM,Returnees,5630,7250,0,0,12880,727,1159,391,490,2767
15,Sudan (UNDP),2018,SUD-18/HSD20/SA2/RRR/NGO/8208,8/20/2019 11:21:51 AM,Overall,700,1080,410,490,2680,700,1080,410,490,2680
15,Sudan (UNDP),2018,SUD-18/HSD20/SA2/RRR/NGO/8208,8/20/2019 11:21:51 AM,Returnees,700,1080,410,490,2680,700,1080,410,490,2680
15,Sudan (UNDP),2018,SUD-18/HSD20/SA2/RRR/UN/8714,12/31/2019 9:39:56 AM,Internally Displaced People/Returnees,221,370,395,247,1233,300,500,1400,1500,3700
15,Sudan (UNDP),2018,SUD-18/HSD20/SA2/RRR/UN/8714,12/31/2019 9:39:56 AM,Overall,1710,3150,2740,1900,9500,3503,4112,5483,5940,19038
15,Sudan (UNDP),2018,SUD-18/HSD20/SA2/RRR/UN/8714,12/31/2019 9:39:56 AM,Pastoralists,35,57,61,38,191,200,300,100,0,600
15,Sudan (UNDP),2018,SUD-18/HSD20/SA2/RRR/UN/8714,12/31/2019 9:39:56 AM,People in Host Communities,684,1240,1216,760,3900,1500,1200,1500,1500,5700
15,Sudan (UNDP),2018,SUD-18/HSD20/SA2/RRR/UN/8714,12/31/2019 9:39:56 AM,Returnees,770,1483,1068,855,4176,1503,2112,2483,2940,9038
15,Sudan (UNDP),2018,SUD-18/HSD20/SA2/WASH/INGO/7796,12/23/2019 6:29:27 AM,Internally Displaced People,922,2151,2228,2382,7683,0,0,0,0,0
15,Sudan (UNDP),2018,SUD-18/HSD20/SA2/WASH/INGO/7796,12/23/2019 6:29:27 AM,Other,1299,3032,3140,3357,10828,1898,4005,4664,4646,15213
15,Sudan (UNDP),2018,SUD-18/HSD20/SA2/WASH/INGO/7796,12/23/2019 6:29:27 AM,Overall,3951,9219,9548,10208,32926,4116,8687,10115,10077,32995
15,Sudan (UNDP),2018,SUD-18/HSD20/SA2/WASH/INGO/7796,12/23/2019 6:29:27 AM,People in Host Communities,1730,4036,4180,4469,14415,2218,4682,5451,5431,17782
15,Sudan (UNDP),2018,SUD-18/HSD20/SA2/WASH/INGO/7807,10/13/2019 2:13:14 PM,Internally Displaced People,3563,3872,3718,4337,15490,3350,3486,4263,4437,15536
15,Sudan (UNDP),2018,SUD-18/HSD20/SA2/WASH/INGO/7807,10/13/2019 2:13:14 PM,Internally Displaced People/Returnees,3295,3581,3438,4011,14325,5680,5913,7230,7525,26348
15,Sudan (UNDP),2018,SUD-18/HSD20/SA2/WASH/INGO/7807,10/13/2019 2:13:14 PM,Overall,9387,10204,9796,11428,40815,9030,9399,11493,11962,41884
15,Sudan (UNDP),2018,SUD-18/HSD20/SA2/WASH/INGO/7807,10/13/2019 2:13:14 PM,Returnees,2529,2751,2640,3080,11000,0,0,0,0,0
15,Sudan (UNDP),2018,SUD-18/HSD20/SA2/WASH/INGO/7822,6/26/2019 12:42:44 PM,Internally Displaced People,24574,23891,4991,4693,58149,24423,23841,5233,4652,58149
15,Sudan (UNDP),2018,SUD-18/HSD20/SA2/WASH/INGO/7822,6/26/2019 12:42:44 PM,Overall,25374,24891,5091,4893,60249,25305,24702,5422,4820,60249
15,Sudan (UNDP),2018,SUD-18/HSD20/SA2/WASH/INGO/7822,6/26/2019 12:42:44 PM,People in Host Communities,800,1000,100,200,2100,882,861,189,168,2100
15,Sudan (UNDP),2018,SUD-18/HSD20/SA2/WASH/INGO/7824,12/23/2019 6:37:06 AM,Internally Displaced People/Returnees,13573,15001,21431,21431,71436,19318,21351,30503,30503,101675
15,Sudan (UNDP),2018,SUD-18/HSD20/SA2/WASH/INGO/7824,12/23/2019 6:37:06 AM,Overall,19318,21351,30503,30503,101675,19318,21351,30503,30503,101675
15,Sudan (UNDP),2018,SUD-18/HSD20/SA2/WASH/INGO/7824,12/23/2019 6:37:06 AM,People in Host Communities,5745,6350,9072,9072,30239,0,0,0,0,0
15,Sudan (UNDP),2018,SUD-18/HSD20/SA2/WASH/INGO/7856,9/5/2019 10:47:10 AM,Children under 5,0,0,3660,3810,7470,0,0,0,0,0
15,Sudan (UNDP),2018,SUD-18/HSD20/SA2/WASH/INGO/7856,9/5/2019 10:47:10 AM,Internally Displaced People,12293,12794,2518,2620,30225,21934,22829,16002,15319,76084
15,Sudan (UNDP),2018,SUD-18/HSD20/SA2/WASH/INGO/7856,9/5/2019 10:47:10 AM,Overall,31394,30163,6178,6430,74165,21934,22829,16002,15319,76084
15,Sudan (UNDP),2018,SUD-18/HSD20/SA2/WASH/INGO/7856,9/5/2019 10:47:10 AM,Pregnant and Lactating Women,0,6747,0,0,6747,0,0,0,0,0
15,Sudan (UNDP),2018,SUD-18/HSD20/SA2/WASH/INGO/7951,6/18/2019 11:17:49 AM,Internally Displaced People,5805,6040,4749,4942,21536,1909,1693,1763,1835,7200
15,Sudan (UNDP),2018,SUD-18/HSD20/SA2/WASH/INGO/7951,6/18/2019 11:17:49 AM,Overall,6328,7172,5383,5653,24536,6328,7172,5383,5653,24536
15,Sudan (UNDP),2018,SUD-18/HSD20/SA2/WASH/INGO/7951,6/18/2019 11:17:49 AM,Pastoralists,523,1132,634,711,3000,0,0,0,0,0
15,Sudan (UNDP),2018,SUD-18/HSD20/SA2/WASH/INGO/8038,12/22/2019 10:46:18 AM,Internally Displaced People,5328,5772,1036,2664,14800,7841,8494,1614,3831,21780
15,Sudan (UNDP),2018,SUD-18/HSD20/SA2/WASH/INGO/8038,12/22/2019 10:46:18 AM,Overall,5609,6076,1091,2804,15580,7841,8494,1614,3831,21780
15,Sudan (UNDP),2018,SUD-18/HSD20/SA2/WASH/INGO/8038,12/22/2019 10:46:18 AM,People in Host Communities,281,304,55,140,780,0,0,0,0,0
15,Sudan (UNDP),2018,SUD-18/HSD20/SA2/WASH-ESNFIs/UN/7858,12/31/2019 7:01:17 AM,Other,1500,1980,1260,1260,6000,0,0,0,0,0
15,Sudan (UNDP),2018,SUD-18/HSD20/SA2/WASH-ESNFIs/UN/7858,12/31/2019 7:01:17 AM,Overall,5000,6600,4200,4200,20000,7300,9636,6132,6132,29200
15,Sudan (UNDP),2018,SUD-18/HSD20/SA2/WASH-ESNFIs/UN/7858,12/31/2019 7:01:17 AM,People in Host Communities,3500,4620,2940,2940,14000,7300,9636,6132,6132,29200
15,Sudan (UNDP),2018,SUD-18/HSD20/SA3/CCS/UN/10873,9/20/2020 3:34:02 PM,Overall,40425,50225,78400,75950,245000,28329,36728,43303,55870,164230
15,Sudan (UNDP),2018,SUD-18/HSD20/SA3/FSL-H-N-WASH/INGO/10888,11/8/2020 6:48:18 AM,Other,869,920,1585,1737,5111,9540,11130,15370,16960,53000
15,Sudan (UNDP),2018,SUD-18/HSD20/SA3/FSL-H-N-WASH/INGO/10888,11/8/2020 6:48:18 AM,Overall,17400,18424,31730,34801,102355,9540,11130,15370,16960,53000
15,Sudan (UNDP),2018,SUD-18/HSD20/SA3/FSL-H-N-WASH/INGO/10933,6/8/2020 5:12:03 PM,Children under 18,0,0,54055,54055,108110,0,0,40293,39468,79761
15,Sudan (UNDP),2018,SUD-18/HSD20/SA3/FSL-H-N-WASH/INGO/10933,6/8/2020 5:12:03 PM,Other,66340,0,0,0,66340,56418,15566,0,0,71984
15,Sudan (UNDP),2018,SUD-18/HSD20/SA3/FSL-H-N-WASH/INGO/10933,6/8/2020 5:12:03 PM,Overall,66340,71254,54055,54055,245704,56418,58365,40293,39468,194544
15,Sudan (UNDP),2018,SUD-18/HSD20/SA3/FSL-H-N-WASH/INGO/10933,6/8/2020 5:12:03 PM,Pregnant and Lactating Women,0,12285,0,0,12285,0,9726,0,0,9726
15,Sudan (UNDP),2018,SUD-18/HSD20/SA3/FSL-H-N-WASH/INGO/10933,6/8/2020 5:12:03 PM,Women of Child-Bearing Age,0,9829,0,0,9829,0,33073,0,0,33073
15,Sudan (UNDP),2018,SUD-18/HSD20/SA3/FSL-WASH-H-N/INGO/10892,7/3/2020 9:49:12 AM,Overall,44656,50357,48378,54553,197944,55287,83029,18063,20588,176967
15,Sudan (UNDP),2018,SUD-18/HSD20/SA3/FSL-WASH-H-N/INGO/10896,12/24/2020 10:42:56 AM,Internally Displaced People,7507,17360,8915,13138,46920,10446,24156,12404,18280,65286
15,Sudan (UNDP),2018,SUD-18/HSD20/SA3/FSL-WASH-H-N/INGO/10896,12/24/2020 10:42:56 AM,Overall,16320,37740,19380,28560,102000,14923,34508,17721,26114,93266
15,Sudan (UNDP),2018,SUD-18/HSD20/SA3/FSL-WASH-H-N/INGO/10896,12/24/2020 10:42:56 AM,Returnees,5222,12077,6202,9139,32640,4477,10352,5317,7834,27980
15,Sudan (UNDP),2018,SUD-18/HSD20/SA3/FSL-WASH-N-H/INGO/10908,6/21/2020 7:42:33 AM,Internally Displaced People,5271,4942,3192,3067,16472,16972,14500,5599,4695,41766
15,Sudan (UNDP),2018,SUD-18/HSD20/SA3/FSL-WASH-N-H/INGO/10908,6/21/2020 7:42:33 AM,Overall,35326,33118,21394,20555,110393,62444,56923,32818,30691,182876
15,Sudan (UNDP),2018,SUD-18/HSD20/SA3/FSL-WASH-N-H/INGO/10908,6/21/2020 7:42:33 AM,Returnees,591,554,358,344,1847,45472,42423,27219,25996,141110
15,Sudan (UNDP),2018,SUD-18/HSD20/SA3/FSL-WASH-N-H/INGO/10938,4/16/2020 7:37:00 AM,Internally Displaced People,8301,7623,5300,6634,27858,21221,22974,13793,15319,73307
15,Sudan (UNDP),2018,SUD-18/HSD20/SA3/FSL-WASH-N-H/INGO/10938,4/16/2020 7:37:00 AM,Overall,21221,22947,13793,15319,73280,21221,22974,13793,15319,73307
15,Sudan (UNDP),2018,SUD-18/HSD20/SA3/FSL-WASH-N-H/INGO/10938,4/16/2020 7:37:00 AM,Returnees,1197,3048,1059,1705,7009,0,0,0,0,0
15,Sudan (UNDP),2019,SUD-19/HSD20/RE/E/UN/14146,12/28/2020 1:09:21 PM,Other,300,300,2000,2000,4600,444,291,1832,2603,5170
15,Sudan (UNDP),2019,SUD-19/HSD20/RE/E/UN/14146,12/28/2020 1:09:21 PM,Overall,300,300,2000,2000,4600,444,291,1832,2603,5170
15,Sudan (UNDP),2019,SUD-19/HSD20/RE/ESNFIs/INGO/13249,1/18/2021 9:25:00 AM,Internally Displaced People,1800,2700,2250,2250,9000,1985,2978,2481,2481,9925
15,Sudan (UNDP),2019,SUD-19/HSD20/RE/ESNFIs/INGO/13249,1/18/2021 9:25:00 AM,Overall,1800,2700,2250,2250,9000,1985,2978,2481,2481,9925
15,Sudan (UNDP),2019,SUD-19/HSD20/RE/ESNFIs/UN/14133,7/20/2023 1:27:05 PM,Internally Displaced People,18490,24510,27735,36765,107500,12052,16306,18432,24105,70895
15,Sudan (UNDP),2019,SUD-19/HSD20/RE/ESNFIs/UN/14133,7/20/2023 1:27:05 PM,Overall,18490,24510,27735,36765,107500,12052,16306,18432,24105,70895
15,Sudan (UNDP),2019,SUD-19/HSD20/RE/FSL/INGO/14060,1/29/2021 2:26:27 PM,Host Communities,568,980,515,515,2578,1378,2156,0,0,3534
15,Sudan (UNDP),2019,SUD-19/HSD20/RE/FSL/INGO/14060,1/29/2021 2:26:27 PM,Overall,568,980,515,515,2578,1378,2156,0,0,3534
15,Sudan (UNDP),2019,SUD-19/HSD20/RE/FSL/UN/14240,12/28/2020 11:47:58 AM,Internally Displaced People,2834,3349,3220,3478,12881,2677,4308,3077,3319,13381
15,Sudan (UNDP),2019,SUD-19/HSD20/RE/FSL/UN/14240,12/28/2020 11:47:58 AM,Overall,2834,3349,3220,3478,12881,2677,4308,3077,3319,13381
15,Sudan (UNDP),2019,SUD-19/HSD20/RE/H/INGO/14233,2/9/2021 12:34:43 PM,Internally Displaced People,2669,2778,2512,2721,10680,2681,2793,2602,2790,10866
15,Sudan (UNDP),2019,SUD-19/HSD20/RE/H/INGO/14233,2/9/2021 12:34:43 PM,Overall,2669,2778,2512,2721,10680,2681,2793,2602,2790,10866
15,Sudan (UNDP),2019,SUD-19/HSD20/RE/H/UN/13111,12/16/2019 6:37:14 AM,Host Communities,0,0,186932,179605,366537,0,0,189658,180891,370549
15,Sudan (UNDP),2019,SUD-19/HSD20/RE/H/UN/13111,12/16/2019 6:37:14 AM,Internally Displaced People,0,0,12137,11661,23798,0,0,12147,11680,23827
15,Sudan (UNDP),2019,SUD-19/HSD20/RE/H/UN/13111,12/16/2019 6:37:14 AM,Overall,0,0,214045,205651,419696,0,0,216856,207028,423884
15,Sudan (UNDP),2019,SUD-19/HSD20/RE/H/UN/13111,12/16/2019 6:37:14 AM,Refugees,0,0,14976,14385,29361,0,0,15051,14457,29508
15,Sudan (UNDP),2019,SUD-19/HSD20/RE/H/UN/13122,12/18/2019 12:26:22 PM,Host Communities,0,0,182789,175621,358410,0,0,231462,222386,453848
15,Sudan (UNDP),2019,SUD-19/HSD20/RE/H/UN/13122,12/18/2019 12:26:22 PM,Internally Displaced People,0,0,13633,13098,26731,0,0,0,0,0
15,Sudan (UNDP),2019,SUD-19/HSD20/RE/H/UN/13122,12/18/2019 12:26:22 PM,Overall,0,0,214045,205651,419696,0,0,231462,222386,453848
15,Sudan (UNDP),2019,SUD-19/HSD20/RE/H/UN/13122,12/18/2019 12:26:22 PM,Refugees,0,0,17623,16932,34555,0,0,0,0,0
15,Sudan (UNDP),2019,SUD-19/HSD20/RE/H/UN/13877,10/30/2022 6:45:54 AM,Host Communities,16410,15765,3480,3345,39000,16400,15775,3480,3340,38995
15,Sudan (UNDP),2019,SUD-19/HSD20/RE/H/UN/13877,10/30/2022 6:45:54 AM,Overall,27350,26275,5800,5575,65000,27350,26275,5799,5576,65000
15,Sudan (UNDP),2019,SUD-19/HSD20/RE/H/UN/13877,10/30/2022 6:45:54 AM,Refugees,10940,10510,2320,2230,26000,10950,10500,2319,2236,26005
15,Sudan (UNDP),2019,SUD-19/HSD20/RE/H/UN/13911,1/29/2021 2:47:58 PM,Host Communities,106,1788,731,963,3588,100,1720,680,959,3459
15,Sudan (UNDP),2019,SUD-19/HSD20/RE/H/UN/13911,1/29/2021 2:47:58 PM,Overall,106,1788,731,963,3588,100,1720,680,959,3459
15,Sudan (UNDP),2019,SUD-19/HSD20/RE/H/UN/14147,9/27/2021 2:16:53 PM,Other,5063,15188,1688,5061,27000,9402,19011,5288,6003,39704
15,Sudan (UNDP),2019,SUD-19/HSD20/RE/H/UN/14147,9/27/2021 2:16:53 PM,Overall,5063,15188,1688,5061,27000,9402,19011,5288,6003,39704
15,Sudan (UNDP),2019,SUD-19/HSD20/RE/H-WASH/UN/14047,10/3/2021 2:33:23 PM,Host Communities,378093,362154,80068,76892,897207,372379,356680,78859,75730,883648
15,Sudan (UNDP),2019,SUD-19/HSD20/RE/H-WASH/UN/14047,10/3/2021 2:33:23 PM,Internally Displaced People,146698,140947,31118,29906,348669,143713,139612,30645,29430,343400
15,Sudan (UNDP),2019,SUD-19/HSD20/RE/H-WASH/UN/14047,10/3/2021 2:33:23 PM,Overall,722742,693286,154767,147137,1717932,712020,683948,150994,145008,1691970
15,Sudan (UNDP),2019,SUD-19/HSD20/RE/H-WASH/UN/14047,10/3/2021 2:33:23 PM,Refugees,197951,190185,43581,40339,472056,195928,187656,41490,39848,464922
15,Sudan (UNDP),2019,SUD-19/HSD20/RE/N/NGO/14293,2/11/2021 7:38:02 AM,Host Communities,1994,2385,1593,1658,7630,26962,45398,11463,11637,95460
15,Sudan (UNDP),2019,SUD-19/HSD20/RE/N/NGO/14293,2/11/2021 7:38:02 AM,Internally Displaced People,1820,1955,551,574,4900,10154,18462,9482,9847,47945
15,Sudan (UNDP),2019,SUD-19/HSD20/RE/N/NGO/14293,2/11/2021 7:38:02 AM,Overall,4825,5426,2450,2550,15251,42827,74245,24651,25290,167013
15,Sudan (UNDP),2019,SUD-19/HSD20/RE/N/NGO/14293,2/11/2021 7:38:02 AM,Refugees,1011,1086,306,318,2721,5711,10385,3706,3806,23608
15,Sudan (UNDP),2019,SUD-19/HSD20/RE/P/INGO/13953,4/19/2020 10:23:11 AM,Host Communities,2499,2499,4998,5000,14996,0,0,0,0,0
15,Sudan (UNDP),2019,SUD-19/HSD20/RE/P/INGO/13953,4/19/2020 10:23:11 AM,Overall,2499,2499,4998,5000,14996,0,0,0,0,0
15,Sudan (UNDP),2019,SUD-19/HSD20/RE/WASH/INGO/14038,1/10/2021 8:34:53 AM,Host Communities,1010,1052,972,1011,4045,1010,1052,972,1011,4045
15,Sudan (UNDP),2019,SUD-19/HSD20/RE/WASH/INGO/14038,1/10/2021 8:34:53 AM,Overall,1010,1052,972,1011,4045,1010,1052,972,1011,4045
15,Sudan (UNDP),2019,SUD-19/HSD20/RE/WASH/INGO/14149,12/28/2020 11:52:05 AM,Host Communities,3924,4676,2160,3160,13920,3924,4676,2160,3160,13920
15,Sudan (UNDP),2019,SUD-19/HSD20/RE/WASH/INGO/14149,12/28/2020 11:52:05 AM,Internally Displaced People,7500,7700,2940,2840,20980,7500,7700,2940,2840,20980
15,Sudan (UNDP),2019,SUD-19/HSD20/RE/WASH/INGO/14149,12/28/2020 11:52:05 AM,Other,17772,20310,5078,7616,50776,17772,20310,5078,7616,50776
15,Sudan (UNDP),2019,SUD-19/HSD20/RE/WASH/INGO/14149,12/28/2020 11:52:05 AM,Overall,29196,32686,10178,13616,85676,29196,32686,10178,13616,85676
15,Sudan (UNDP),2019,SUD-19/HSD20/RE/WASH/INGO/14154,1/28/2021 3:25:01 PM,Host Communities,10346,17880,9403,9407,47036,39697,39701,17010,17010,113418
15,Sudan (UNDP),2019,SUD-19/HSD20/RE/WASH/INGO/14154,1/28/2021 3:25:01 PM,Overall,10346,17880,9403,9407,47036,39697,39701,17010,17010,113418
15,Sudan (UNDP),2019,SUD-19/HSD20/RE/WASH/INGO/14206,1/29/2021 2:32:35 PM,Host Communities,8424,10376,3029,3671,25500,8424,10376,3029,3671,25500
15,Sudan (UNDP),2019,SUD-19/HSD20/RE/WASH/INGO/14206,1/29/2021 2:32:35 PM,Internally Displaced People,2000,2000,1000,1000,6000,2000,2000,1000,1000,6000
15,Sudan (UNDP),2019,SUD-19/HSD20/RE/WASH/INGO/14206,1/29/2021 2:32:35 PM,Other,1056,1144,864,936,4000,1056,1144,864,936,4000
15,Sudan (UNDP),2019,SUD-19/HSD20/RE/WASH/INGO/14206,1/29/2021 2:32:35 PM,Overall,11480,13520,4893,5607,35500,11480,13520,4893,5607,35500
15,Sudan (UNDP),2019,SUD-19/HSD20/RE/WASH/NGO/14143,1/10/2021 8:20:22 AM,Host Communities,2393,2494,3593,3740,12220,2154,2245,3234,3366,10999
15,Sudan (UNDP),2019,SUD-19/HSD20/RE/WASH/NGO/14143,1/10/2021 8:20:22 AM,Overall,2393,2494,3593,3740,12220,2154,2245,3234,3366,10999
15,Sudan (UNDP),2019,SUD-19/HSD20/RE/WASH/NGO/14398,2/3/2021 11:37:18 AM,Host Communities,25480,38220,10920,16380,91000,684,712,1026,1068,3490
15,Sudan (UNDP),2019,SUD-19/HSD20/RE/WASH/NGO/14398,2/3/2021 11:37:18 AM,Overall,25480,38220,10920,16380,91000,684,712,1026,1068,3490
15,Sudan (UNDP),2019,SUD-19/HSD20/RE/WASH/UN/14134,7/3/2023 2:48:31 PM,Other,7500,9900,6300,6300,30000,10249,13531,8610,8610,41000
15,Sudan (UNDP),2019,SUD-19/HSD20/RE/WASH/UN/14134,7/3/2023 2:48:31 PM,Overall,7500,9900,6300,6300,30000,10249,13531,8610,8610,41000
15,Sudan (UNDP),2019,SUD-19/HSD20/RE/WASH-FSL-E/INGO/14397,7/18/2021 11:19:15 AM,Host Communities,1630,1712,2363,2445,8150,2475,2526,2426,3170,10597
15,Sudan (UNDP),2019,SUD-19/HSD20/RE/WASH-FSL-E/INGO/14397,7/18/2021 11:19:15 AM,Internally Displaced People,6520,6846,9454,9780,32600,9900,10109,9702,12678,42389
15,Sudan (UNDP),2019,SUD-19/HSD20/RE/WASH-FSL-E/INGO/14397,7/18/2021 11:19:15 AM,Overall,8150,8558,11817,12225,40750,12375,12635,12128,15848,52986
15,Sudan (UNDP),2019,SUD-19/HSD20/RE/WASH-H/UN/14136,7/30/2020 10:39:33 AM,Host Communities,545011,567259,567259,590411,2269940,545011,567259,567259,590411,2269940
15,Sudan (UNDP),2019,SUD-19/HSD20/RE/WASH-H/UN/14136,7/30/2020 10:39:33 AM,Internally Displaced People,11843,11379,12327,11843,47392,11843,11379,12327,11943,47492
15,Sudan (UNDP),2019,SUD-19/HSD20/RE/WASH-H/UN/14136,7/30/2020 10:39:33 AM,Overall,556854,578638,579586,602254,2317332,556854,578638,579586,602354,2317432
15,Sudan (UNDP),2019,SUD-19/HSD20/SA1/E/INGO/12985,9/13/2020 7:22:52 AM,Host Communities,669,474,0,0,1143,669,474,0,0,1143
15,Sudan (UNDP),2019,SUD-19/HSD20/SA1/E/INGO/12985,9/13/2020 7:22:52 AM,Internally Displaced People,49,200,0,0,249,49,200,0,0,249
15,Sudan (UNDP),2019,SUD-19/HSD20/SA1/E/INGO/12985,9/13/2020 7:22:52 AM,Other,0,0,3218,4111,7329,0,0,3218,4111,7329
15,Sudan (UNDP),2019,SUD-19/HSD20/SA1/E/INGO/12985,9/13/2020 7:22:52 AM,Overall,718,674,3218,4111,8721,718,674,3218,4111,8721
15,Sudan (UNDP),2019,SUD-19/HSD20/SA1/E/NGO/12988,1/28/2021 4:06:53 PM,Internally Displaced People,54,36,1312,1212,2614,102,18,1492,1480,3092
15,Sudan (UNDP),2019,SUD-19/HSD20/SA1/E/NGO/12988,1/28/2021 4:06:53 PM,Overall,54,36,1312,1212,2614,102,18,1492,1480,3092
15,Sudan (UNDP),2019,SUD-19/HSD20/SA1/E-FSL-H-N-P/INGO/12804,2/27/2022 8:53:15 AM,Internally Displaced People,13499,31779,19592,20878,85748,13499,31779,19592,20878,85748
15,Sudan (UNDP),2019,SUD-19/HSD20/SA1/E-FSL-H-N-P/INGO/12804,2/27/2022 8:53:15 AM,Other,4439,10508,6686,7106,28739,4439,10508,6686,7106,28739
15,Sudan (UNDP),2019,SUD-19/HSD20/SA1/E-FSL-H-N-P/INGO/12804,2/27/2022 8:53:15 AM,Overall,17938,42287,26278,27984,114487,17938,42287,26278,27984,114487
15,Sudan (UNDP),2019,SUD-19/HSD20/SA1/E-P/NGO/12817,1/31/2021 4:17:06 PM,Host Communities,227,237,784,816,2064,182,190,627,653,1652
15,Sudan (UNDP),2019,SUD-19/HSD20/SA1/E-P/NGO/12817,1/31/2021 4:17:06 PM,Internally Displaced People,199,207,686,714,1806,159,166,549,571,1445
15,Sudan (UNDP),2019,SUD-19/HSD20/SA1/E-P/NGO/12817,1/31/2021 4:17:06 PM,Other,100,100,0,0,200,100,100,0,0,200
15,Sudan (UNDP),2019,SUD-19/HSD20/SA1/E-P/NGO/12817,1/31/2021 4:17:06 PM,Overall,668,692,1960,2040,5360,555,574,1568,1632,4329
15,Sudan (UNDP),2019,SUD-19/HSD20/SA1/E-P/NGO/12817,1/31/2021 4:17:06 PM,Refugees,142,148,490,510,1290,114,118,392,408,1032
15,Sudan (UNDP),2019,SUD-19/HSD20/SA1/E-P/UN/12906,7/4/2023 12:19:50 PM,Host Communities,50,50,750,750,1600,85,45,135,538,803
15,Sudan (UNDP),2019,SUD-19/HSD20/SA1/E-P/UN/12906,7/4/2023 12:19:50 PM,Internally Displaced People,50,50,750,750,1600,158,148,437,1531,2274
15,Sudan (UNDP),2019,SUD-19/HSD20/SA1/E-P/UN/12906,7/4/2023 12:19:50 PM,Overall,100,100,1500,1500,3200,243,193,572,2069,3077
15,Sudan (UNDP),2019,SUD-19/HSD20/SA1/FSL/INGO/12847,2/9/2021 11:49:28 AM,Host Communities,1368,1653,1425,1254,5700,920,980,1630,1788,5318
15,Sudan (UNDP),2019,SUD-19/HSD20/SA1/FSL/INGO/12847,2/9/2021 11:49:28 AM,Internally Displaced People,875,1050,840,735,3500,466,1046,2330,730,4572
15,Sudan (UNDP),2019,SUD-19/HSD20/SA1/FSL/INGO/12847,2/9/2021 11:49:28 AM,Other,104,336,168,192,800,66,145,180,60,451
15,Sudan (UNDP),2019,SUD-19/HSD20/SA1/FSL/INGO/12847,2/9/2021 11:49:28 AM,Overall,2347,3039,2433,2181,10000,1452,2171,4140,2578,10341
15,Sudan (UNDP),2019,SUD-19/HSD20/SA1/FSL/INGO/12987,1/29/2021 6:24:07 PM,Host Communities,3528,4872,4032,4368,16800,1425,3295,1692,2493,8905
15,Sudan (UNDP),2019,SUD-19/HSD20/SA1/FSL/INGO/12987,1/29/2021 6:24:07 PM,Internally Displaced People,5670,7830,6480,7020,27000,5699,13178,6767,9973,35617
15,Sudan (UNDP),2019,SUD-19/HSD20/SA1/FSL/INGO/12987,1/29/2021 6:24:07 PM,Other,882,1218,1008,1092,4200,7123,16473,8459,12466,44521
15,Sudan (UNDP),2019,SUD-19/HSD20/SA1/FSL/INGO/12987,1/29/2021 6:24:07 PM,Overall,10080,13920,11520,12480,48000,14247,32946,16918,24932,89043
15,Sudan (UNDP),2019,SUD-19/HSD20/SA1/FSL/INGO/13001,12/31/2020 10:51:35 AM,Host Communities,14000,14000,18500,18500,65000,8442,10905,8093,7740,35180
15,Sudan (UNDP),2019,SUD-19/HSD20/SA1/FSL/INGO/13001,12/31/2020 10:51:35 AM,Overall,14000,14000,18500,18500,65000,8442,10905,8093,7740,35180
15,Sudan (UNDP),2019,SUD-19/HSD20/SA1/FSL/NGO/12854,4/19/2020 10:17:16 AM,Host Communities,8752,7056,3740,4799,24347,8752,7056,3740,4799,24347
15,Sudan (UNDP),2019,SUD-19/HSD20/SA1/FSL/NGO/12854,4/19/2020 10:17:16 AM,Overall,8752,7056,3740,4799,24347,8752,7056,3740,4799,24347
15,Sudan (UNDP),2019,SUD-19/HSD20/SA1/FSL/NGO/12858,5/3/2020 12:00:40 PM,Internally Displaced People,320,480,1000,2200,4000,320,480,1000,2000,3800
15,Sudan (UNDP),2019,SUD-19/HSD20/SA1/FSL/NGO/12858,5/3/2020 12:00:40 PM,Overall,320,480,1000,2200,4000,320,480,1000,2000,3800
15,Sudan (UNDP),2019,SUD-19/HSD20/SA1/FSL-WASH/INGO/12939,1/29/2021 6:57:57 PM,Internally Displaced People,501,553,790,790,2634,501,553,790,790,2634
15,Sudan (UNDP),2019,SUD-19/HSD20/SA1/FSL-WASH/INGO/12939,1/29/2021 6:57:57 PM,Other,4338,4795,6848,6848,22829,4338,4795,6848,6848,22829
15,Sudan (UNDP),2019,SUD-19/HSD20/SA1/FSL-WASH/INGO/12939,1/29/2021 6:57:57 PM,Overall,4839,5348,7638,7638,25463,4839,5348,7638,7638,25463
15,Sudan (UNDP),2019,SUD-19/HSD20/SA1/FSL-WASH/INGO/12959,1/29/2021 6:36:48 PM,Host Communities,1644,2466,5283,5283,14676,3472,3142,4630,4630,15874
15,Sudan (UNDP),2019,SUD-19/HSD20/SA1/FSL-WASH/INGO/12959,1/29/2021 6:36:48 PM,Internally Displaced People,1433,3324,5567,5567,15891,1095,405,2200,2200,5900
15,Sudan (UNDP),2019,SUD-19/HSD20/SA1/FSL-WASH/INGO/12959,1/29/2021 6:36:48 PM,Overall,5996,9670,14729,16169,46564,7297,6017,10470,10990,34774
15,Sudan (UNDP),2019,SUD-19/HSD20/SA1/FSL-WASH/INGO/12959,1/29/2021 6:36:48 PM,Refugees,2919,3880,3879,5319,15997,2730,2470,3640,4160,13000
15,Sudan (UNDP),2019,SUD-19/HSD20/SA1/H-FSL-N-WASH/INGO/12688,1/29/2021 5:21:53 PM,Internally Displaced People,13877,14444,17662,18383,64366,14621,19124,20268,21399,75412
15,Sudan (UNDP),2019,SUD-19/HSD20/SA1/H-FSL-N-WASH/INGO/12688,1/29/2021 5:21:53 PM,Other,23074,24016,29367,30566,107023,43863,57373,60805,64197,226238
15,Sudan (UNDP),2019,SUD-19/HSD20/SA1/H-FSL-N-WASH/INGO/12688,1/29/2021 5:21:53 PM,Overall,36951,38460,47029,48949,171389,58484,76497,81073,85596,301650
15,Sudan (UNDP),2019,SUD-19/HSD20/SA1/H-N/INGO/12690,1/13/2021 4:26:29 AM,Internally Displaced People,12904,13431,16423,17094,59852,12904,27607,16423,17094,74028
15,Sudan (UNDP),2019,SUD-19/HSD20/SA1/H-N/INGO/12690,1/13/2021 4:26:29 AM,Other,765,796,973,1013,3547,12172,13431,973,1013,27589
15,Sudan (UNDP),2019,SUD-19/HSD20/SA1/H-N/INGO/12690,1/13/2021 4:26:29 AM,Overall,13669,14227,17396,18107,63399,25076,41038,17396,18107,101617
15,Sudan (UNDP),2019,SUD-19/HSD20/SA1/H-N/UN/13038,10/20/2022 2:14:36 PM,Host Communities,21000,22000,5435,5880,54315,21000,22000,5436,5880,54316
15,Sudan (UNDP),2019,SUD-19/HSD20/SA1/H-N/UN/13038,10/20/2022 2:14:36 PM,Internally Displaced People,73868,76883,18467,18467,187685,73900,76883,18500,18470,187753
15,Sudan (UNDP),2019,SUD-19/HSD20/SA1/H-N/UN/13038,10/20/2022 2:14:36 PM,Overall,94868,98883,23902,24347,242000,94900,98883,23936,24350,242069
15,Sudan (UNDP),2019,SUD-19/HSD20/SA1/H-N-FSL/INGO/12726,1/29/2021 3:24:05 PM,Host Communities,28038,29179,5742,5977,68936,16086,16702,26688,27737,87213
15,Sudan (UNDP),2019,SUD-19/HSD20/SA1/H-N-FSL/INGO/12726,1/29/2021 3:24:05 PM,Internally Displaced People,9524,9911,1950,2030,23415,6275,7976,7738,7788,29777
15,Sudan (UNDP),2019,SUD-19/HSD20/SA1/H-N-FSL/INGO/12726,1/29/2021 3:24:05 PM,Overall,39782,41324,10268,10471,101845,24740,27194,39177,40511,131622
15,Sudan (UNDP),2019,SUD-19/HSD20/SA1/H-N-FSL/INGO/12726,1/29/2021 3:24:05 PM,Refugees,2220,2234,2576,2464,9494,2379,2516,4751,4986,14632
15,Sudan (UNDP),2019,SUD-19/HSD20/SA1/H-N-FSL/INGO/12848,1/11/2021 11:33:23 AM,Host Communities,6216,7460,5222,5964,24862,6417,7956,5389,5903,25665
15,Sudan (UNDP),2019,SUD-19/HSD20/SA1/H-N-FSL/INGO/12848,1/11/2021 11:33:23 AM,Internally Displaced People,414,497,348,397,1656,324,450,370,430,1574
15,Sudan (UNDP),2019,SUD-19/HSD20/SA1/H-N-FSL/INGO/12848,1/11/2021 11:33:23 AM,Other,1344,1613,1129,1290,5376,1200,1400,1240,1320,5160
15,Sudan (UNDP),2019,SUD-19/HSD20/SA1/H-N-FSL/INGO/12848,1/11/2021 11:33:23 AM,Overall,8843,10613,7429,8485,35370,8504,10501,7471,8168,34644
15,Sudan (UNDP),2019,SUD-19/HSD20/SA1/H-N-FSL/INGO/12848,1/11/2021 11:33:23 AM,Refugees,869,1043,730,834,3476,563,695,472,515,2245
15,Sudan (UNDP),2019,SUD-19/HSD20/SA1/H-N-P/UN/13330,9/23/2021 6:55:37 AM,Host Communities,5000,6600,4200,4200,20000,5523,6543,2815,2649,17530
15,Sudan (UNDP),2019,SUD-19/HSD20/SA1/H-N-P/UN/13330,9/23/2021 6:55:37 AM,Internally Displaced People,1650,1250,1050,1050,5000,1842,2181,938,883,5844
15,Sudan (UNDP),2019,SUD-19/HSD20/SA1/H-N-P/UN/13330,9/23/2021 6:55:37 AM,Overall,6650,7850,5250,5250,25000,7365,8724,3753,3532,23374
15,Sudan (UNDP),2019,SUD-19/HSD20/SA1/H-N-WASH-FSL/INGO/12717,1/29/2021 4:20:31 PM,Internally Displaced People,38356,39921,7856,8177,94310,36982,36753,8920,9737,92392
15,Sudan (UNDP),2019,SUD-19/HSD20/SA1/H-N-WASH-FSL/INGO/12717,1/29/2021 4:20:31 PM,Overall,38356,39921,7856,8177,94310,36982,36753,8920,9737,92392
15,Sudan (UNDP),2019,SUD-19/HSD20/SA1/H-N-WASH-FSL/INGO/12862,1/24/2021 8:40:21 AM,Host Communities,61593,64107,12615,13130,151445,63467,91181,43798,45276,243722
15,Sudan (UNDP),2019,SUD-19/HSD20/SA1/H-N-WASH-FSL/INGO/12862,1/24/2021 8:40:21 AM,Internally Displaced People,12293,12794,2518,2621,30226,10789,15501,7446,7697,41433
15,Sudan (UNDP),2019,SUD-19/HSD20/SA1/H-N-WASH-FSL/INGO/12862,1/24/2021 8:40:21 AM,Other,180,70,0,0,250,180,70,0,0,250
15,Sudan (UNDP),2019,SUD-19/HSD20/SA1/H-N-WASH-FSL/INGO/12862,1/24/2021 8:40:21 AM,Overall,74066,76971,15133,15751,181921,74436,106752,51244,52973,285405
15,Sudan (UNDP),2019,SUD-19/HSD20/SA1/L/UN/12724,7/20/2023 5:45:59 PM,Other,12000,12000,0,0,24000,8323,8323,0,0,16646
15,Sudan (UNDP),2019,SUD-19/HSD20/SA1/L/UN/12724,7/20/2023 5:45:59 PM,Overall,12000,12000,0,0,24000,8323,8323,0,0,16646
15,Sudan (UNDP),2019,SUD-19/HSD20/SA1/N-E-FSL-H-P/INGO/12667,1/19/2021 8:31:16 AM,Host Communities,1400,1750,1400,2450,7000,2282,3016,2302,4007,11607
15,Sudan (UNDP),2019,SUD-19/HSD20/SA1/N-E-FSL-H-P/INGO/12667,1/19/2021 8:31:16 AM,Internally Displaced People,4190,5240,4180,7320,20930,6285,7860,6269,10981,31395
15,Sudan (UNDP),2019,SUD-19/HSD20/SA1/N-E-FSL-H-P/INGO/12667,1/19/2021 8:31:16 AM,Other,700,875,700,1225,3500,1042,1325,1044,1900,5311
15,Sudan (UNDP),2019,SUD-19/HSD20/SA1/N-E-FSL-H-P/INGO/12667,1/19/2021 8:31:16 AM,Overall,6990,8740,6980,12220,34930,10731,13524,10680,18759,53694
15,Sudan (UNDP),2019,SUD-19/HSD20/SA1/N-E-FSL-H-P/INGO/12667,1/19/2021 8:31:16 AM,Refugees,700,875,700,1225,3500,1122,1323,1065,1871,5381
15,Sudan (UNDP),2019,SUD-19/HSD20/SA1/N-H-P/INGO/12639,1/29/2021 5:28:50 PM,Other,1616,3356,14653,14704,34329,9483,9652,5920,9813,34868
15,Sudan (UNDP),2019,SUD-19/HSD20/SA1/N-H-P/INGO/12639,1/29/2021 5:28:50 PM,Overall,1616,3356,14653,14704,34329,9483,9652,5920,9813,34868
15,Sudan (UNDP),2019,SUD-19/HSD20/SA1/P/INGO/12636,2/12/2021 3:19:18 PM,Other,1643,1614,2925,3221,9403,1837,3351,4113,4831,14132
15,Sudan (UNDP),2019,SUD-19/HSD20/SA1/P/INGO/12636,2/12/2021 3:19:18 PM,Overall,1643,1614,2925,3221,9403,1837,3351,4113,4831,14132
15,Sudan (UNDP),2019,SUD-19/HSD20/SA1/P/INGO/12971,1/24/2021 8:45:27 AM,Host Communities,2060,4807,3097,4646,14610,2849,5637,3987,3866,16339
15,Sudan (UNDP),2019,SUD-19/HSD20/SA1/P/INGO/12971,1/24/2021 8:45:27 AM,Internally Displaced People,9621,22378,14384,21631,68014,60973,101342,11548,5928,179791
15,Sudan (UNDP),2019,SUD-19/HSD20/SA1/P/INGO/12971,1/24/2021 8:45:27 AM,Other,1031,2406,1550,2326,7313,2453,2839,1156,1389,7837
15,Sudan (UNDP),2019,SUD-19/HSD20/SA1/P/INGO/12971,1/24/2021 8:45:27 AM,Overall,12712,29591,19031,28603,89937,66275,109818,16691,11183,203967
15,Sudan (UNDP),2019,SUD-19/HSD20/SA1/P/INGO/13298,7/3/2020 9:42:08 AM,Host Communities,1624,2436,415,1165,5640,1109,2150,390,972,4621
15,Sudan (UNDP),2019,SUD-19/HSD20/SA1/P/INGO/13298,7/3/2020 9:42:08 AM,Overall,2416,3784,475,1240,7915,1525,2864,433,1039,5861
15,Sudan (UNDP),2019,SUD-19/HSD20/SA1/P/INGO/13298,7/3/2020 9:42:08 AM,Refugees,792,1348,60,75,2275,416,714,43,67,1240
15,Sudan (UNDP),2019,SUD-19/HSD20/SA1/P/NGO/12946,2/9/2021 12:00:15 PM,Host Communities,150,300,250,410,1110,150,300,250,410,1110
15,Sudan (UNDP),2019,SUD-19/HSD20/SA1/P/NGO/12946,2/9/2021 12:00:15 PM,Internally Displaced People,880,1150,950,1260,4240,880,1150,950,1260,4240
15,Sudan (UNDP),2019,SUD-19/HSD20/SA1/P/NGO/12946,2/9/2021 12:00:15 PM,Overall,1030,1450,1200,1670,5350,1030,1450,1200,1670,5350
15,Sudan (UNDP),2019,SUD-19/HSD20/SA1/P/UN/13009,1/24/2021 9:18:47 AM,Host Communities,86,559,43,172,860,75,295,39,130,539
15,Sudan (UNDP),2019,SUD-19/HSD20/SA1/P/UN/13009,1/24/2021 9:18:47 AM,Internally Displaced People,774,5029,387,1547,7737,602,1847,342,1659,4450
15,Sudan (UNDP),2019,SUD-19/HSD20/SA1/P/UN/13009,1/24/2021 9:18:47 AM,Overall,1646,10694,823,3290,16453,934,3462,415,2027,6838
15,Sudan (UNDP),2019,SUD-19/HSD20/SA1/P/UN/13009,1/24/2021 9:18:47 AM,Refugees,786,5106,393,1571,7856,257,1320,34,238,1849
15,Sudan (UNDP),2019,SUD-19/HSD20/SA1/WASH/INGO/12868,2/9/2021 12:17:19 PM,Host Communities,6683,7799,8037,7981,30500,3529,3590,4244,4213,15576
15,Sudan (UNDP),2019,SUD-19/HSD20/SA1/WASH/INGO/12868,2/9/2021 12:17:19 PM,Overall,6683,7799,8037,7981,30500,3529,3590,4244,4213,15576
15,Sudan (UNDP),2019,SUD-19/HSD20/SA1/WASH/INGO/13000,1/28/2021 6:13:17 PM,Host Communities,2375,2727,829,1141,7072,4593,5249,1312,1969,13123
15,Sudan (UNDP),2019,SUD-19/HSD20/SA1/WASH/INGO/13000,1/28/2021 6:13:17 PM,Overall,11876,13634,4146,5704,35360,15310,17497,4375,6563,43745
15,Sudan (UNDP),2019,SUD-19/HSD20/SA1/WASH/INGO/13000,1/28/2021 6:13:17 PM,Refugees,9501,10907,3317,4563,28288,10717,12248,3063,4594,30622
15,Sudan (UNDP),2019,SUD-19/HSD20/SA1/WASH-FSL/INGO/12723,1/29/2021 3:57:43 PM,Host Communities,5105,5581,1045,1143,12874,3239,3165,2568,2506,11478
15,Sudan (UNDP),2019,SUD-19/HSD20/SA1/WASH-FSL/INGO/12723,1/29/2021 3:57:43 PM,Internally Displaced People,5566,5476,1183,1116,13341,2619,2714,1710,1527,8570
15,Sudan (UNDP),2019,SUD-19/HSD20/SA1/WASH-FSL/INGO/12723,1/29/2021 3:57:43 PM,Overall,21627,21550,4443,4423,52043,11556,10211,7991,7549,37307
15,Sudan (UNDP),2019,SUD-19/HSD20/SA1/WASH-FSL/INGO/12723,1/29/2021 3:57:43 PM,Refugees,10956,10493,2215,2164,25828,5698,4332,3713,3516,17259
15,Sudan (UNDP),2019,SUD-19/HSD20/SA1/WASH-FSL-P/INGO/12933,2/11/2021 8:36:01 AM,Host Communities,3920,4080,5880,6120,20000,3788,3943,5681,5913,19325
15,Sudan (UNDP),2019,SUD-19/HSD20/SA1/WASH-FSL-P/INGO/12933,2/11/2021 8:36:01 AM,Internally Displaced People,4704,4916,7056,7344,24020,4546,4751,6819,7097,23213
15,Sudan (UNDP),2019,SUD-19/HSD20/SA1/WASH-FSL-P/INGO/12933,2/11/2021 8:36:01 AM,Other,1577,1514,2186,2230,7507,1525,1463,2112,2155,7255
15,Sudan (UNDP),2019,SUD-19/HSD20/SA1/WASH-FSL-P/INGO/12933,2/11/2021 8:36:01 AM,Overall,10201,10510,15122,15694,51527,9859,10157,14612,15165,49793
15,Sudan (UNDP),2019,SUD-19/HSD20/SA1/WASH-P/INGO/12986,2/9/2021 12:06:09 PM,Host Communities,3978,6858,5800,4640,21276,3580,5712,3162,3867,16321
15,Sudan (UNDP),2019,SUD-19/HSD20/SA1/WASH-P/INGO/12986,2/9/2021 12:06:09 PM,Internally Displaced People,9100,11200,2000,2100,24400,4202,4274,5053,5018,18547
15,Sudan (UNDP),2019,SUD-19/HSD20/SA1/WASH-P/INGO/12986,2/9/2021 12:06:09 PM,Other,970,1180,450,500,3100,506,760,450,510,2226
15,Sudan (UNDP),2019,SUD-19/HSD20/SA1/WASH-P/INGO/12986,2/9/2021 12:06:09 PM,Overall,14048,19238,8250,7240,48776,8288,10746,8665,9395,37094
15,Sudan (UNDP),2019,SUD-19/HSD20/SA2/E/INGO/14139,2/3/2021 7:42:32 AM,Host Communities,4207,4378,4042,4206,16833,4003,3654,2738,3532,13927
15,Sudan (UNDP),2019,SUD-19/HSD20/SA2/E/INGO/14139,2/3/2021 7:42:32 AM,Internally Displaced People,7790,8107,7484,7790,31171,12955,12900,1304,2131,29290
15,Sudan (UNDP),2019,SUD-19/HSD20/SA2/E/INGO/14139,2/3/2021 7:42:32 AM,Overall,18981,19755,18237,18980,75953,23210,22774,6265,7644,59893
15,Sudan (UNDP),2019,SUD-19/HSD20/SA2/E/INGO/14139,2/3/2021 7:42:32 AM,Refugees,6984,7270,6711,6984,27949,6252,6220,2223,1981,16676
15,Sudan (UNDP),2019,SUD-19/HSD20/SA2/E/INGO/14165,1/28/2021 3:44:35 PM,Host Communities,21627,26434,4120,5035,57216,21627,26434,4120,5035,57216
15,Sudan (UNDP),2019,SUD-19/HSD20/SA2/E/INGO/14165,1/28/2021 3:44:35 PM,Internally Displaced People,6179,7552,1177,1439,16347,6179,7552,1177,1439,16347
15,Sudan (UNDP),2019,SUD-19/HSD20/SA2/E/INGO/14165,1/28/2021 3:44:35 PM,Overall,30896,37763,5885,7193,81737,30896,37763,5885,7193,81737
15,Sudan (UNDP),2019,SUD-19/HSD20/SA2/E/INGO/14165,1/28/2021 3:44:35 PM,Refugees,3090,3777,588,719,8174,3090,3777,588,719,8174
15,Sudan (UNDP),2019,SUD-19/HSD20/SA2/E/NGO/14131,2/3/2021 11:41:13 AM,Host Communities,86,90,3498,3641,7315,60,63,2449,2549,5121
15,Sudan (UNDP),2019,SUD-19/HSD20/SA2/E/NGO/14131,2/3/2021 11:41:13 AM,Internally Displaced People,71,73,2862,2979,5985,50,51,2003,2085,4189
15,Sudan (UNDP),2019,SUD-19/HSD20/SA2/E/NGO/14131,2/3/2021 11:41:13 AM,Overall,157,163,6360,6620,13300,110,114,4452,4634,9310
15,Sudan (UNDP),2019,SUD-19/HSD20/SA2/E-P/NGO/14164,2/12/2021 4:00:01 PM,Host Communities,120,230,250,300,900,100,223,250,300,873
15,Sudan (UNDP),2019,SUD-19/HSD20/SA2/E-P/NGO/14164,2/12/2021 4:00:01 PM,Other,118,210,230,240,798,50,110,100,98,358
15,Sudan (UNDP),2019,SUD-19/HSD20/SA2/E-P/NGO/14164,2/12/2021 4:00:01 PM,Overall,638,940,1080,1340,3998,526,873,950,1154,3503
15,Sudan (UNDP),2019,SUD-19/HSD20/SA2/E-P/NGO/14164,2/12/2021 4:00:01 PM,Refugees,400,500,600,800,2300,376,540,600,756,2272
15,Sudan (UNDP),2019,SUD-19/HSD20/SA2/FSL-H-N-WASH/INGO/14152,3/21/2021 7:15:12 AM,Host Communities,20047,29995,24923,26511,101476,14484,25584,25480,26451,91999
15,Sudan (UNDP),2019,SUD-19/HSD20/SA2/FSL-H-N-WASH/INGO/14152,3/21/2021 7:15:12 AM,Internally Displaced People,8025,8973,6775,6269,30042,1519,2941,2770,3228,10458
15,Sudan (UNDP),2019,SUD-19/HSD20/SA2/FSL-H-N-WASH/INGO/14152,3/21/2021 7:15:12 AM,Overall,30512,43173,34165,35284,143134,16239,28639,28324,29753,102955
15,Sudan (UNDP),2019,SUD-19/HSD20/SA2/FSL-H-N-WASH/INGO/14152,3/21/2021 7:15:12 AM,Refugees,2440,4205,2467,2504,11616,236,114,74,74,498
15,Sudan (UNDP),2019,SUD-19/HSD20/SA2/FSL-N-P-WASH/INGO/14126,4/7/2021 8:39:36 AM,Host Communities,4096,4263,5213,5426,18998,4086,4363,5313,5526,19288
15,Sudan (UNDP),2019,SUD-19/HSD20/SA2/FSL-N-P-WASH/INGO/14126,4/7/2021 8:39:36 AM,Internally Displaced People,3069,3194,3906,4065,14234,2120,3322,3300,4420,13162
15,Sudan (UNDP),2019,SUD-19/HSD20/SA2/FSL-N-P-WASH/INGO/14126,4/7/2021 8:39:36 AM,Other,6481,6746,8249,8585,30061,5930,5030,7200,7330,25490
15,Sudan (UNDP),2019,SUD-19/HSD20/SA2/FSL-N-P-WASH/INGO/14126,4/7/2021 8:39:36 AM,Overall,13646,14203,17368,18076,63293,12136,12715,15813,17276,57940
15,Sudan (UNDP),2019,SUD-19/HSD20/SA2/FSL-WASH-H-N-E-P/INGO/14138,10/17/2021 6:19:50 AM,Host Communities,1738,2963,2962,4187,11850,30110,28476,19799,17498,95883
15,Sudan (UNDP),2019,SUD-19/HSD20/SA2/FSL-WASH-H-N-E-P/INGO/14138,10/17/2021 6:19:50 AM,Internally Displaced People,3050,5150,5150,7250,20600,7905,7466,4513,4337,24221
15,Sudan (UNDP),2019,SUD-19/HSD20/SA2/FSL-WASH-H-N-E-P/INGO/14138,10/17/2021 6:19:50 AM,Overall,4951,8451,8449,11949,33800,38015,35942,24312,21835,120104
15,Sudan (UNDP),2019,SUD-19/HSD20/SA2/FSL-WASH-H-N-E-P/INGO/14138,10/17/2021 6:19:50 AM,Refugees,163,338,337,512,1350,0,0,0,0,0
15,Sudan (UNDP),2019,SUD-19/HSD20/SA2/FSL-WASH-H-N-P/INGO/14141,7/6/2021 8:54:50 AM,Host Communities,5983,13839,7103,10472,37397,2607,6028,3096,4562,16293
15,Sudan (UNDP),2019,SUD-19/HSD20/SA2/FSL-WASH-H-N-P/INGO/14141,7/6/2021 8:54:50 AM,Internally Displaced People,21216,49062,25195,37128,132601,9242,21373,10975,16174,57764
15,Sudan (UNDP),2019,SUD-19/HSD20/SA2/FSL-WASH-H-N-P/INGO/14141,7/6/2021 8:54:50 AM,Overall,27199,62901,32298,47600,169998,11849,27401,14071,20736,74057
15,Sudan (UNDP),2019,SUD-19/HSD20/SA2/FSL-WASH-P/INGO/14132,7/18/2021 11:06:50 AM,Host Communities,5194,7791,5194,7791,25970,3851,4493,3691,4012,16047
15,Sudan (UNDP),2019,SUD-19/HSD20/SA2/FSL-WASH-P/INGO/14132,7/18/2021 11:06:50 AM,Internally Displaced People,4098,6145,4098,6145,20486,3169,4030,2953,3384,13536
15,Sudan (UNDP),2019,SUD-19/HSD20/SA2/FSL-WASH-P/INGO/14132,7/18/2021 11:06:50 AM,Overall,10733,16098,10733,16098,53662,8939,10762,8483,9395,37579
15,Sudan (UNDP),2019,SUD-19/HSD20/SA2/FSL-WASH-P/INGO/14132,7/18/2021 11:06:50 AM,Refugees,1441,2162,1441,2162,7206,1919,2239,1839,1999,7996
15,Sudan (UNDP),2019,SUD-19/HSD20/SA2/H-N/INGO/14125,1/29/2021 7:03:21 PM,Host Communities,1450,2500,5100,5950,15000,1938,2670,5300,6450,16358
15,Sudan (UNDP),2019,SUD-19/HSD20/SA2/H-N/INGO/14125,1/29/2021 7:03:21 PM,Internally Displaced People,650,800,1800,1750,5000,940,930,2030,1870,5770
15,Sudan (UNDP),2019,SUD-19/HSD20/SA2/H-N/INGO/14125,1/29/2021 7:03:21 PM,Other,1400,1600,3700,3300,10000,2000,1840,4200,3704,11744
15,Sudan (UNDP),2019,SUD-19/HSD20/SA2/H-N/INGO/14125,1/29/2021 7:03:21 PM,Overall,6700,10200,21900,21200,60000,8678,10870,23630,23064,66242
15,Sudan (UNDP),2019,SUD-19/HSD20/SA2/H-N/INGO/14125,1/29/2021 7:03:21 PM,Refugees,3200,5300,11300,10200,30000,3800,5430,12100,11040,32370
15,Sudan (UNDP),2019,SUD-19/HSD20/SA2/H-N/INGO/14145,1/28/2021 3:39:50 PM,Host Communities,4315,3676,7849,8684,24524,2917,1971,7298,8121,20307
15,Sudan (UNDP),2019,SUD-19/HSD20/SA2/H-N/INGO/14145,1/28/2021 3:39:50 PM,Internally Displaced People,8505,9788,4164,4332,26789,9585,10401,3253,3976,27215
15,Sudan (UNDP),2019,SUD-19/HSD20/SA2/H-N/INGO/14145,1/28/2021 3:39:50 PM,Overall,12820,13464,12013,13016,51313,12502,12372,10551,12097,47522
15,Sudan (UNDP),2019,SUD-19/HSD20/SA2/H-N-FSL-P/INGO/14324,1/24/2021 8:04:03 AM,Host Communities,22888,23822,4688,4879,56277,4810,6025,958,1147,12940
15,Sudan (UNDP),2019,SUD-19/HSD20/SA2/H-N-FSL-P/INGO/14324,1/24/2021 8:04:03 AM,Internally Displaced People,10925,11371,2238,2329,26863,2627,3813,471,563,7474
15,Sudan (UNDP),2019,SUD-19/HSD20/SA2/H-N-FSL-P/INGO/14324,1/24/2021 8:04:03 AM,Overall,37317,38840,7644,7955,91756,8866,11949,1681,2011,24507
15,Sudan (UNDP),2019,SUD-19/HSD20/SA2/H-N-FSL-P/INGO/14324,1/24/2021 8:04:03 AM,Refugees,3504,3647,718,747,8616,1429,2111,252,301,4093
15,Sudan (UNDP),2019,SUD-19/HSD20/SA2/H-N-WASH/INGO/14068,7/19/2021 9:10:17 AM,Host Communities,19495,20289,3993,4155,47932,4027,11782,6597,8169,30575
15,Sudan (UNDP),2019,SUD-19/HSD20/SA2/H-N-WASH/INGO/14068,7/19/2021 9:10:17 AM,Internally Displaced People,38692,40271,7925,8248,95136,8858,25921,14514,17973,67266
15,Sudan (UNDP),2019,SUD-19/HSD20/SA2/H-N-WASH/INGO/14068,7/19/2021 9:10:17 AM,Overall,59447,61700,13598,14323,149068,13422,39274,21991,27231,101918
15,Sudan (UNDP),2019,SUD-19/HSD20/SA2/H-N-WASH/INGO/14068,7/19/2021 9:10:17 AM,Refugees,1260,1140,1680,1920,6000,537,1571,880,1089,4077
15,Sudan (UNDP),2019,SUD-19/HSD20/SA2/H-N-WASH/INGO/14129,2/12/2021 3:25:22 PM,Host Communities,14023,14595,17847,18575,65040,2257,2350,2873,2990,10470
15,Sudan (UNDP),2019,SUD-19/HSD20/SA2/H-N-WASH/INGO/14129,2/12/2021 3:25:22 PM,Internally Displaced People,2805,2919,3569,3715,13008,1451,1470,2575,2598,8094
15,Sudan (UNDP),2019,SUD-19/HSD20/SA2/H-N-WASH/INGO/14129,2/12/2021 3:25:22 PM,Other,11218,11676,14277,14860,52031,1806,1880,2298,2392,8376
15,Sudan (UNDP),2019,SUD-19/HSD20/SA2/H-N-WASH/INGO/14129,2/12/2021 3:25:22 PM,Overall,28046,29190,35693,37150,130079,5514,5700,7746,7980,26940
15,Sudan (UNDP),2019,SUD-19/HSD20/SA2/H-N-WASH/INGO/14157,3/21/2021 7:01:52 AM,Host Communities,20000,20544,10544,25816,76904,37731,39271,24123,25108,126233
15,Sudan (UNDP),2019,SUD-19/HSD20/SA2/H-N-WASH/INGO/14157,3/21/2021 7:01:52 AM,Internally Displaced People,20544,23816,10634,12516,67510,43750,45536,27972,29113,146371
15,Sudan (UNDP),2019,SUD-19/HSD20/SA2/H-N-WASH/INGO/14157,3/21/2021 7:01:52 AM,Overall,40889,44814,21278,38457,145438,81820,85160,52312,54447,273739
15,Sudan (UNDP),2019,SUD-19/HSD20/SA2/H-N-WASH/INGO/14157,3/21/2021 7:01:52 AM,Refugees,345,454,100,125,1024,339,353,217,226,1135
15,Sudan (UNDP),2019,SUD-19/HSD20/SA2/H-P-N/NGO/14159,3/28/2021 1:54:29 PM,Host Communities,4200,4200,6300,6300,21000,6048,7392,4032,4928,22400
15,Sudan (UNDP),2019,SUD-19/HSD20/SA2/H-P-N/NGO/14159,3/28/2021 1:54:29 PM,Overall,6000,6000,9000,9000,30000,8640,10560,5760,7040,32000
15,Sudan (UNDP),2019,SUD-19/HSD20/SA2/H-P-N/NGO/14159,3/28/2021 1:54:29 PM,Refugees,1800,1800,2700,2700,9000,2592,3168,1728,2112,9600
15,Sudan (UNDP),2019,SUD-19/HSD20/SA2/P/INGO/14150,2/3/2021 7:34:57 AM,Host Communities,105,105,3500,3500,7210,193,153,3700,3400,7446
15,Sudan (UNDP),2019,SUD-19/HSD20/SA2/P/INGO/14150,2/3/2021 7:34:57 AM,Overall,105,105,3500,3500,7210,193,153,3700,3400,7446
15,Sudan (UNDP),2019,SUD-19/HSD20/SA2/P/INGO/14151,1/29/2021 2:37:10 PM,Host Communities,412,822,200,600,2034,12,15,0,0,27
15,Sudan (UNDP),2019,SUD-19/HSD20/SA2/P/INGO/14151,1/29/2021 2:37:10 PM,Internally Displaced People,1643,3283,800,2400,8126,32487,38009,0,0,70496
15,Sudan (UNDP),2019,SUD-19/HSD20/SA2/P/INGO/14151,1/29/2021 2:37:10 PM,Overall,2055,4105,1000,3000,10160,32499,38024,0,0,70523
15,Sudan (UNDP),2019,SUD-19/HSD20/SA2/P/NGO/14115,11/23/2020 6:55:06 AM,Host Communities,1160,1240,760,840,4000,1160,1240,760,840,4000
15,Sudan (UNDP),2019,SUD-19/HSD20/SA2/P/NGO/14115,11/23/2020 6:55:06 AM,Internally Displaced People,2900,3100,1900,2100,10000,2900,3100,1900,2100,10000
15,Sudan (UNDP),2019,SUD-19/HSD20/SA2/P/NGO/14115,11/23/2020 6:55:06 AM,Other,1740,1860,1140,1260,6000,1740,1860,1140,1260,6000
15,Sudan (UNDP),2019,SUD-19/HSD20/SA2/P/NGO/14115,11/23/2020 6:55:06 AM,Overall,5800,6200,3800,4200,20000,5800,6200,3800,4200,20000
15,Sudan (UNDP),2019,SUD-19/HSD20/SA2/P/NGO/14156,5/12/2020 8:55:50 AM,Host Communities,190,700,320,375,1585,190,700,218,400,1508
15,Sudan (UNDP),2019,SUD-19/HSD20/SA2/P/NGO/14156,5/12/2020 8:55:50 AM,Overall,1490,5160,2600,4350,13600,1484,6887,2068,3587,14026
15,Sudan (UNDP),2019,SUD-19/HSD20/SA2/P/NGO/14156,5/12/2020 8:55:50 AM,Refugees,1300,4460,2280,3975,12015,1294,6187,1850,3187,12518
15,Sudan (UNDP),2019,SUD-19/HSD20/SA2/WASH-E/INGO/14155,7/26/2021 12:53:05 PM,Host Communities,6935,7926,1981,2972,19814,10578,12089,3022,4535,30224
15,Sudan (UNDP),2019,SUD-19/HSD20/SA2/WASH-E/INGO/14155,7/26/2021 12:53:05 PM,Overall,8849,9687,4365,5189,28090,15111,17272,4317,6477,43177
15,Sudan (UNDP),2019,SUD-19/HSD20/SA2/WASH-E/INGO/14155,7/26/2021 12:53:05 PM,Refugees,1914,1761,2384,2217,8276,4533,5183,1295,1942,12953
15,Sudan (UNDP),2019,SUD-19/HSD20/SA2/WASH-H-N/INGO/14166,2/12/2021 3:09:49 PM,Host Communities,12428,12937,6827,6829,39021,19647,20891,10797,11802,63137
15,Sudan (UNDP),2019,SUD-19/HSD20/SA2/WASH-H-N/INGO/14166,2/12/2021 3:09:49 PM,Internally Displaced People,13120,13656,7206,7208,41190,19613,20415,10772,10776,61576
15,Sudan (UNDP),2019,SUD-19/HSD20/SA2/WASH-H-N/INGO/14166,2/12/2021 3:09:49 PM,Overall,31116,31231,16480,16485,95312,44828,45944,24016,25026,139814
15,Sudan (UNDP),2019,SUD-19/HSD20/SA2/WASH-H-N/INGO/14166,2/12/2021 3:09:49 PM,Refugees,5568,4638,2447,2448,15101,5568,4638,2447,2448,15101
62,Syria,2015,SYR-15/DDA-3477/RA/WASH/UN/2161,8/30/2016 12:45:56 PM,Host Communities,234612,244188,180600,180600,840000,391020,406980,301000,301000,1400000
62,Syria,2015,SYR-15/DDA-3477/RA/WASH/UN/2161,8/30/2016 12:45:56 PM,Internally Displaced People,100548,104652,77400,77400,360000,167580,174420,129000,129000,600000
62,Syria,2015,SYR-15/DDA-3477/RA/WASH/UN/2161,8/30/2016 12:45:56 PM,Overall,335160,348840,258000,258000,1200000,558600,581400,430000,430000,2000000
62,Syria,2015,SYR-15/DDA-3477/WCP/WASH/INGO/2049,1/2/2017 12:09:35 PM,Host Communities,74867,77260,39970,41604,233701,74867,77260,39970,41604,233701
62,Syria,2015,SYR-15/DDA-3477/WCP/WASH/INGO/2049,1/2/2017 12:09:35 PM,Internally Displaced People,25719,27432,14192,14767,82110,25719,27432,14192,14767,82110
62,Syria,2015,SYR-15/DDA-3477/WCP/WASH/INGO/2049,1/2/2017 12:09:35 PM,Overall,100586,104692,54162,56371,315811,100586,104692,54162,56371,315811
62,Syria,2015,SYR-15/DDA-3477/WCP/WASH/INGO/2079,6/8/2016 11:48:01 AM,Host Communities,42965,64447,17542,18260,143214,44040,66060,17970,18720,146790
62,Syria,2015,SYR-15/DDA-3477/WCP/WASH/INGO/2079,6/8/2016 11:48:01 AM,Internally Displaced People,54685,82028,22332,23241,182286,56040,84150,23850,22880,186920
62,Syria,2015,SYR-15/DDA-3477/WCP/WASH/INGO/2079,6/8/2016 11:48:01 AM,Overall,97650,146475,39874,41501,325500,100112,150170,40880,42548,333710
62,Syria,2015,SYR-15/DDA-3477/WCP/WASH/UN/2047,8/30/2016 1:42:57 PM,Host Communities,92610,96390,80500,80500,350000,92610,96390,80500,80500,350000
62,Syria,2015,SYR-15/DDA-3477/WCP/WASH/UN/2047,8/30/2016 1:42:57 PM,Internally Displaced People,92610,96390,80500,80500,350000,92610,96390,80500,80500,350000
62,Syria,2015,SYR-15/DDA-3477/WCP/WASH/UN/2047,8/30/2016 1:42:57 PM,Overall,185220,192780,161000,161000,700000,185220,192780,161000,161000,700000
62,Syria,2015,SYR-15/DDA-3477/WCP/WASH/UN/2048,12/7/2016 10:01:26 AM,Host Communities,5516,5516,4484,4484,20000,5516,5516,4484,4484,20000
62,Syria,2015,SYR-15/DDA-3477/WCP/WASH/UN/2048,12/7/2016 10:01:26 AM,Internally Displaced People,11032,11032,8967,8967,39998,11032,11031,8967,8967,39997
62,Syria,2015,SYR-15/DDA-3477/WCP/WASH/UN/2048,12/7/2016 10:01:26 AM,Overall,11032,11032,8967,8967,39998,11032,11032,8967,8967,39998
62,Syria,2015,SYR-15/DDA-3558/RA/FSA/INGO/2213,11/30/2016 11:16:53 AM,Host Communities,104,127,121,149,501,104,127,121,149,501
62,Syria,2015,SYR-15/DDA-3558/RA/FSA/INGO/2213,11/30/2016 11:16:53 AM,Internally Displaced People,1968,2406,2311,2824,9509,1968,2406,2311,2824,9509
62,Syria,2015,SYR-15/DDA-3558/RA/FSA/INGO/2213,11/30/2016 11:16:53 AM,Overall,2072,2533,2432,2973,10010,2072,2533,2432,2973,10010
62,Syria,2015,SYR-15/DDA-3558/RA/FSA/O/2335,11/21/2016 11:14:05 AM,Host Communities,18900,11229,11229,13786,55144,17900,10229,10229,12786,51144
62,Syria,2015,SYR-15/DDA-3558/RA/FSA/O/2335,11/21/2016 11:14:05 AM,Internally Displaced People,17396,50640,34192,23110,125338,17396,50640,34192,23110,125338
62,Syria,2015,SYR-15/DDA-3558/RA/FSA/O/2335,11/21/2016 11:14:05 AM,Overall,36296,61869,45421,36896,180482,35296,60869,44421,35896,176482
62,Syria,2015,SYR-15/DDA-3558/RA/H/NGO/2331,1/2/2017 9:19:40 AM,Host Communities,1230,970,0,460,2660,6460,6120,2940,2510,18030
62,Syria,2015,SYR-15/DDA-3558/RA/H/NGO/2331,1/2/2017 9:19:40 AM,Internally Displaced People,2420,1880,0,940,5240,2319,1858,549,490,5216
62,Syria,2015,SYR-15/DDA-3558/RA/H/NGO/2331,1/2/2017 9:19:40 AM,Overall,3650,2850,0,1400,7900,8003,7728,3890,3625,23246
62,Syria,2015,SYR-15/DDA-3558/RA/LOG/UN/2333,10/31/2016 9:48:56 AM,Overall,1,1,1,1,4,0,0,0,0,0
62,Syria,2015,SYR-15/DDA-3558/SA/S/NFI/NGO/2314,2/3/2017 8:56:05 PM,Internally Displaced People,540,840,755,756,2891,385,600,540,540,2065
62,Syria,2015,SYR-15/DDA-3558/SA/S/NFI/NGO/2314,2/3/2017 8:56:05 PM,Overall,540,840,755,756,2891,385,600,540,540,2065
62,Syria,2016,SYR-16/DDA-3558/RA/FSA/NGO/3424,12/7/2016 9:53:21 AM,Host Communities,2899,2831,1575,1538,8843,3141,3110,1645,1612,9508
62,Syria,2016,SYR-16/DDA-3558/RA/FSA/NGO/3424,12/7/2016 9:53:21 AM,Internally Displaced People,5800,5662,3151,3076,17689,5709,5675,3176,3080,17640
62,Syria,2016,SYR-16/DDA-3558/RA/FSA/NGO/3424,12/7/2016 9:53:21 AM,Overall,8699,8493,4726,4614,26532,8855,8785,4821,4692,27153
62,Syria,2016,SYR-16/DDA-3558/RA/FSA/O/2936,3/23/2017 11:26:46 AM,Host Communities,2500,5834,4166,4166,16666,2500,5834,4166,4166,16666
62,Syria,2016,SYR-16/DDA-3558/RA/FSA/O/2936,3/23/2017 11:26:46 AM,Internally Displaced People,2834,5745,4043,4044,16666,2834,5745,4043,4044,16666
62,Syria,2016,SYR-16/DDA-3558/RA/FSA/O/2936,3/23/2017 11:26:46 AM,Overall,5334,11579,8209,8210,33332,5334,11579,8209,8210,33332
62,Syria,2016,SYR-16/DDA-3558/RA/FSA/UN/3151,9/18/2018 6:22:07 AM,Host Communities,20880,22320,14400,14400,72000,20793,22227,14340,14340,71700
62,Syria,2016,SYR-16/DDA-3558/RA/FSA/UN/3151,9/18/2018 6:22:07 AM,Overall,20880,22320,14400,14400,72000,20793,22227,14340,14340,71700
62,Syria,2016,SYR-16/DDA-3558/RA/H/NGO/2561,6/2/2017 2:30:52 PM,Host Communities,180,180,85,85,530,220,305,115,81,721
62,Syria,2016,SYR-16/DDA-3558/RA/H/NGO/2561,6/2/2017 2:30:52 PM,Internally Displaced People,210,210,100,100,620,260,365,134,85,844
62,Syria,2016,SYR-16/DDA-3558/RA/H/NGO/2561,6/2/2017 2:30:52 PM,Other,60,60,60,60,240,70,88,80,45,283
62,Syria,2016,SYR-16/DDA-3558/RA/H/NGO/2561,6/2/2017 2:30:52 PM,Overall,450,450,245,245,1390,550,758,329,211,1848
62,Syria,2016,SYR-16/DDA-3558/RA/H/NGO/2562,3/12/2017 1:18:53 PM,Host Communities,217,187,95,75,574,152,210,142,106,610
62,Syria,2016,SYR-16/DDA-3558/RA/H/NGO/2562,3/12/2017 1:18:53 PM,Internally Displaced People,362,312,158,126,958,363,539,326,207,1435
62,Syria,2016,SYR-16/DDA-3558/RA/H/NGO/2562,3/12/2017 1:18:53 PM,Other,145,124,64,50,383,78,104,67,66,315
62,Syria,2016,SYR-16/DDA-3558/RA/H/NGO/2562,3/12/2017 1:18:53 PM,Overall,724,623,317,251,1915,593,853,535,379,2360
62,Syria,2016,SYR-16/DDA-3558/RA/H/NGO/2563,3/15/2017 8:23:30 AM,Host Communities,60,325,40,40,465,79,443,60,76,658
62,Syria,2016,SYR-16/DDA-3558/RA/H/NGO/2563,3/15/2017 8:23:30 AM,Internally Displaced People,175,810,120,120,1225,138,804,106,140,1188
62,Syria,2016,SYR-16/DDA-3558/RA/H/NGO/2563,3/15/2017 8:23:30 AM,Overall,235,1135,160,160,1690,217,1247,166,216,1846
62,Syria,2016,SYR-16/DDA-3558/RA/H/NGO/3137,7/22/2018 11:42:11 AM,Host Communities,113,95,45,45,298,97,56,13,5,171
62,Syria,2016,SYR-16/DDA-3558/RA/H/NGO/3137,7/22/2018 11:42:11 AM,Internally Displaced People,168,141,66,66,441,171,112,53,22,358
62,Syria,2016,SYR-16/DDA-3558/RA/H/NGO/3137,7/22/2018 11:42:11 AM,Other,335,282,132,132,881,483,397,150,64,1094
62,Syria,2016,SYR-16/DDA-3558/RA/H/NGO/3137,7/22/2018 11:42:11 AM,Overall,616,518,243,243,1620,751,565,216,91,1623
62,Syria,2016,SYR-16/DDA-3558/RA/H/NGO/3814,9/16/2018 7:38:17 AM,Host Communities,280,400,360,360,1400,511,1080,267,305,2163
62,Syria,2016,SYR-16/DDA-3558/RA/H/NGO/3814,9/16/2018 7:38:17 AM,Internally Displaced People,320,500,390,390,1600,443,815,309,353,1920
62,Syria,2016,SYR-16/DDA-3558/RA/H/NGO/3814,9/16/2018 7:38:17 AM,Overall,600,900,750,750,3000,954,1895,576,658,4083
62,Syria,2016,SYR-16/DDA-3558/RA/H/UN/2327,10/31/2016 11:56:24 AM,Other,2809,2699,136,130,5774,3162,3038,153,147,6500
62,Syria,2016,SYR-16/DDA-3558/RA/H/UN/2327,10/31/2016 11:56:24 AM,Overall,2809,2699,136,130,5774,3162,3038,153,147,6500
62,Syria,2016,SYR-16/DDA-3558/RA/H/UN/2574,6/1/2017 6:59:05 AM,Overall,123960,123960,82640,82640,413200,124088,134410,73826,78402,410726
62,Syria,2016,SYR-16/DDA-3558/RA/LOG/UN/4361,3/15/2017 8:20:36 AM,Overall,1,0,0,0,1,1,0,0,0,1
62,Syria,2016,SYR-16/DDA-3558/RA/S/NFI/NGO/2343,2/7/2017 10:09:29 AM,Internally Displaced People,2361,2602,1920,2113,8996,2361,2602,1920,2113,8996
62,Syria,2016,SYR-16/DDA-3558/RA/S/NFI/NGO/2343,2/7/2017 10:09:29 AM,Overall,2361,2602,1920,2113,8996,2361,2602,1920,2113,8996
62,Syria,2016,SYR-16/DDA-3558/RA/S/NFI/NGO/2405,10/3/2016 11:45:17 AM,Internally Displaced People,150,250,300,300,1000,150,265,310,325,1050
62,Syria,2016,SYR-16/DDA-3558/RA/S/NFI/NGO/2405,10/3/2016 11:45:17 AM,Overall,150,250,300,300,1000,150,265,310,325,1050
62,Syria,2016,SYR-16/DDA-3558/RA/S/NFI/NGO/2788,7/23/2018 12:19:39 PM,Internally Displaced People,392,589,560,694,2235,217,326,368,449,1360
62,Syria,2016,SYR-16/DDA-3558/RA/S/NFI/NGO/2788,7/23/2018 12:19:39 PM,Overall,392,589,560,694,2235,217,326,368,449,1360
62,Syria,2016,SYR-16/DDA-3558/RA/S/NFI/NGO/3147,9/5/2017 7:21:15 AM,Internally Displaced People,133,156,296,337,922,133,158,299,340,930
62,Syria,2016,SYR-16/DDA-3558/RA/S/NFI/NGO/3147,9/5/2017 7:21:15 AM,Overall,133,156,296,337,922,133,158,299,340,930
62,Syria,2016,SYR-16/DDA-3558/RA/S/NFI/NGO/3804,7/15/2018 7:22:45 AM,Internally Displaced People,300,400,500,550,1750,298,408,507,576,1789
62,Syria,2016,SYR-16/DDA-3558/RA/S/NFI/NGO/3804,7/15/2018 7:22:45 AM,Overall,300,400,500,550,1750,298,408,507,576,1789
62,Syria,2016,SYR-16/DDA-3558/RA/WASH/INGO/2552,4/19/2017 1:05:45 PM,Host Communities,9000,13000,7500,7500,37000,9000,13000,7500,7500,37000
62,Syria,2016,SYR-16/DDA-3558/RA/WASH/INGO/2552,4/19/2017 1:05:45 PM,Internally Displaced People,2000,3000,1500,1500,8000,2000,3000,1500,1500,8000
62,Syria,2016,SYR-16/DDA-3558/RA/WASH/INGO/2552,4/19/2017 1:05:45 PM,Overall,11000,16000,9000,9000,45000,11000,16000,9000,9000,45000
62,Syria,2016,SYR-16/DDA-3558/RA/WASH/INGO/3715,8/13/2017 8:27:04 AM,Internally Displaced People,23750,23750,23750,23750,95000,23750,23750,23750,23750,95000
62,Syria,2016,SYR-16/DDA-3558/RA/WASH/INGO/3715,8/13/2017 8:27:04 AM,Overall,23750,23750,23750,23750,95000,23750,23750,23750,23750,95000
62,Syria,2016,SYR-16/DDA-3558/SA/E/INGO/2457,9/5/2017 7:49:26 AM,Host Communities,150,150,4920,4920,10140,53,176,5381,5692,11302
62,Syria,2016,SYR-16/DDA-3558/SA/E/INGO/2457,9/5/2017 7:49:26 AM,Internally Displaced People,0,0,1230,1230,2460,18,59,1794,1897,3768
62,Syria,2016,SYR-16/DDA-3558/SA/E/INGO/2457,9/5/2017 7:49:26 AM,Overall,150,150,6150,6150,12600,71,235,7175,7589,15070
62,Syria,2016,SYR-16/DDA-3558/SA/E/INGO/4158,11/6/2018 8:08:19 AM,Host Communities,785,1232,9841,9150,21008,973,1326,10316,8891,21506
62,Syria,2016,SYR-16/DDA-3558/SA/E/INGO/4158,11/6/2018 8:08:19 AM,Overall,785,1232,9841,9150,21008,973,1326,10316,8891,21506
62,Syria,2016,SYR-16/DDA-3558/SA/E/INGO/4290,5/23/2018 10:59:42 AM,Host Communities,75,100,4600,4600,9375,50,148,3054,4100,7352
62,Syria,2016,SYR-16/DDA-3558/SA/E/INGO/4290,5/23/2018 10:59:42 AM,Internally Displaced People,25,100,2300,2300,4725,17,100,2500,2457,5074
62,Syria,2016,SYR-16/DDA-3558/SA/E/INGO/4290,5/23/2018 10:59:42 AM,Overall,100,200,6900,6900,14100,67,248,5554,6557,12426
62,Syria,2016,SYR-16/DDA-3558/SA/E/NGO/2449,2/26/2018 9:29:48 AM,Host Communities,0,0,1250,1250,2500,0,0,3715,4480,8195
62,Syria,2016,SYR-16/DDA-3558/SA/E/NGO/2449,2/26/2018 9:29:48 AM,Internally Displaced People,0,0,3000,3000,6000,0,0,9400,9722,19122
62,Syria,2016,SYR-16/DDA-3558/SA/E/NGO/2449,2/26/2018 9:29:48 AM,Overall,0,0,4250,4250,8500,0,0,14545,12772,27317
62,Syria,2016,SYR-16/DDA-3558/SA/E/NGO/4291,10/31/2018 11:05:27 AM,Host Communities,50,500,1000,1000,2550,55,510,995,1048,2608
62,Syria,2016,SYR-16/DDA-3558/SA/E/NGO/4291,10/31/2018 11:05:27 AM,Internally Displaced People,75,900,2700,2700,6375,95,940,2534,2870,6439
62,Syria,2016,SYR-16/DDA-3558/SA/E/NGO/4291,10/31/2018 11:05:27 AM,Overall,125,1400,3700,3700,8925,150,1450,3529,3918,9047
62,Syria,2016,SYR-16/DDA-3558/SA/E-WASH/INGO/4178,2/28/2018 8:25:57 AM,Internally Displaced People,7200,9000,5400,5400,27000,7200,9000,5400,5400,27000
62,Syria,2016,SYR-16/DDA-3558/SA/E-WASH/INGO/4178,2/28/2018 8:25:57 AM,Overall,7200,9000,5400,5400,27000,7200,9000,5400,5400,27000
62,Syria,2016,SYR-16/DDA-3558/SA/FSA/INGO/2512,1/28/2018 9:53:27 AM,Host Communities,9494,15822,18987,18987,63290,2240,2542,1199,1199,7180
62,Syria,2016,SYR-16/DDA-3558/SA/FSA/INGO/2512,1/28/2018 9:53:27 AM,Internally Displaced People,33076,55128,66153,66153,220510,58889,89816,44050,44042,236797
62,Syria,2016,SYR-16/DDA-3558/SA/FSA/INGO/2512,1/28/2018 9:53:27 AM,Overall,42570,70950,85140,85140,283800,61129,92358,45249,45241,243977
62,Syria,2016,SYR-16/DDA-3558/SA/FSA/INGO/4282,7/1/2019 9:21:57 AM,Host Communities,7430,18960,9450,9450,45290,11785,30487,18822,17735,78829
62,Syria,2016,SYR-16/DDA-3558/SA/FSA/INGO/4282,7/1/2019 9:21:57 AM,Internally Displaced People,8076,21167,16202,16192,61637,5901,13741,8092,7966,35700
62,Syria,2016,SYR-16/DDA-3558/SA/FSA/INGO/4282,7/1/2019 9:21:57 AM,Overall,15506,40127,25652,25642,106927,17686,44228,26914,25701,114529
62,Syria,2016,SYR-16/DDA-3558/SA/FSA/NGO/2476,6/21/2017 9:39:30 AM,Internally Displaced People,9200,24750,13550,30500,78000,6500,12400,8150,16100,43150
62,Syria,2016,SYR-16/DDA-3558/SA/FSA/NGO/2476,6/21/2017 9:39:30 AM,Overall,9200,24750,13550,30500,78000,6500,12400,8150,16100,43150
62,Syria,2016,SYR-16/DDA-3558/SA/FSA/NGO/2501,12/1/2016 12:14:13 PM,Host Communities,250,350,520,650,1770,264,374,856,695,2189
62,Syria,2016,SYR-16/DDA-3558/SA/FSA/NGO/2501,12/1/2016 12:14:13 PM,Internally Displaced People,250,300,450,500,1500,260,329,483,536,1608
62,Syria,2016,SYR-16/DDA-3558/SA/FSA/NGO/2501,12/1/2016 12:14:13 PM,Overall,700,950,1420,1550,4620,763,1059,1518,1612,4952
62,Syria,2016,SYR-16/DDA-3558/SA/FSA/NGO/2501,12/1/2016 12:14:13 PM,Refugees,200,300,450,400,1350,217,325,481,432,1455
62,Syria,2016,SYR-16/DDA-3558/SA/FSA/NGO/4196,6/19/2018 11:38:02 AM,Host Communities,128,325,301,350,1104,598,838,611,614,2661
62,Syria,2016,SYR-16/DDA-3558/SA/FSA/NGO/4196,6/19/2018 11:38:02 AM,Internally Displaced People,125,165,195,198,683,92,94,104,84,374
62,Syria,2016,SYR-16/DDA-3558/SA/FSA/NGO/4196,6/19/2018 11:38:02 AM,Overall,330,677,646,681,2334,690,932,715,698,3035
62,Syria,2016,SYR-16/DDA-3558/SA/FSA/NGO/4196,6/19/2018 11:38:02 AM,Refugees,77,187,150,133,547,0,0,0,0,0
62,Syria,2016,SYR-16/DDA-3558/SA/FSA/NGO/4279,7/15/2018 7:15:41 AM,Host Communities,350,850,1150,1500,3850,2000,3000,4000,5000,14000
62,Syria,2016,SYR-16/DDA-3558/SA/FSA/NGO/4279,7/15/2018 7:15:41 AM,Internally Displaced People,500,500,1500,2000,4500,828,629,846,660,2963
62,Syria,2016,SYR-16/DDA-3558/SA/FSA/NGO/4279,7/15/2018 7:15:41 AM,Other,2150,2500,2500,2500,9650,0,0,0,0,0
62,Syria,2016,SYR-16/DDA-3558/SA/FSA/NGO/4279,7/15/2018 7:15:41 AM,Overall,3000,3850,5150,6000,18000,2828,3629,4854,5655,16966
62,Syria,2016,SYR-16/DDA-3558/SA/FSA/UN/2464,2/7/2017 11:16:00 AM,Host Communities,56305,59194,71663,75338,262500,109726,115353,139651,146813,511543
62,Syria,2016,SYR-16/DDA-3558/SA/FSA/UN/2464,2/7/2017 11:16:00 AM,Internally Displaced People,18769,19731,23887,25113,87500,36575,38451,46550,48938,170514
62,Syria,2016,SYR-16/DDA-3558/SA/FSA/UN/2464,2/7/2017 11:16:00 AM,Overall,75075,78925,95550,100450,350000,146301,153804,186201,195750,682056
62,Syria,2016,SYR-16/DDA-3558/SA/FSA/UN/2525,3/13/2018 8:07:40 AM,Host Communities,4895,5230,3375,3375,16875,5070,5421,3497,3497,17485
62,Syria,2016,SYR-16/DDA-3558/SA/FSA/UN/2525,3/13/2018 8:07:40 AM,Internally Displaced People,1630,1745,1125,1125,5625,1690,1807,1167,1167,5831
62,Syria,2016,SYR-16/DDA-3558/SA/FSA/UN/2525,3/13/2018 8:07:40 AM,Overall,6525,6975,4500,4500,22500,6762,7228,4663,4663,23316
62,Syria,2016,SYR-16/DDA-3558/SA/FSA-P/INGO/4287,2/4/2018 9:21:31 AM,Host Communities,57,54,72,84,267,57,54,72,84,267
62,Syria,2016,SYR-16/DDA-3558/SA/FSA-P/INGO/4287,2/4/2018 9:21:31 AM,Internally Displaced People,579,652,727,854,2812,579,652,727,854,2812
62,Syria,2016,SYR-16/DDA-3558/SA/FSA-P/INGO/4287,2/4/2018 9:21:31 AM,Overall,815,918,1024,1203,3960,815,918,1024,1203,3960
62,Syria,2016,SYR-16/DDA-3558/SA/FSA-P/INGO/4287,2/4/2018 9:21:31 AM,Refugees,179,202,225,265,871,179,202,225,265,871
62,Syria,2016,SYR-16/DDA-3558/SA/FSA-S/NFI/UN/2355,7/3/2017 6:06:58 AM,Overall,8668,10040,5345,5152,29205,7515,8934,4520,4368,25337
62,Syria,2016,SYR-16/DDA-3558/SA/FSA-S/NFI/UN/2355,7/3/2017 6:06:58 AM,Refugees,8668,10040,5345,5152,29205,7515,8934,4520,4368,25337
62,Syria,2016,SYR-16/DDA-3558/SA/FSA-S/NFI/UN/4281,3/25/2018 12:21:40 PM,Internally Displaced People,616,772,584,558,2530,567,723,534,515,2339
62,Syria,2016,SYR-16/DDA-3558/SA/FSA-S/NFI/UN/4281,3/25/2018 12:21:40 PM,Overall,616,772,584,558,2530,567,723,534,515,2339
62,Syria,2016,SYR-16/DDA-3558/SA/FSA-WASH-S/NFI/INGO/4301,7/4/2018 11:21:03 AM,Host Communities,61740,64260,41160,42840,210000,70063,72926,46707,48618,238314
62,Syria,2016,SYR-16/DDA-3558/SA/FSA-WASH-S/NFI/INGO/4301,7/4/2018 11:21:03 AM,Internally Displaced People,41160,42840,27440,28560,140000,40873,42545,29036,30819,143273
62,Syria,2016,SYR-16/DDA-3558/SA/FSA-WASH-S/NFI/INGO/4301,7/4/2018 11:21:03 AM,Overall,102900,107100,68600,71400,350000,110936,115471,75738,79437,381582
62,Syria,2016,SYR-16/DDA-3558/SA/H/NGO/2447,5/21/2017 1:19:02 PM,Host Communities,72,89,0,0,161,83,64,0,0,147
62,Syria,2016,SYR-16/DDA-3558/SA/H/NGO/2447,5/21/2017 1:19:02 PM,Internally Displaced People,120,148,0,0,268,179,116,2,1,298
62,Syria,2016,SYR-16/DDA-3558/SA/H/NGO/2447,5/21/2017 1:19:02 PM,Other,48,59,0,0,107,47,47,0,0,94
62,Syria,2016,SYR-16/DDA-3558/SA/H/NGO/2447,5/21/2017 1:19:02 PM,Overall,240,296,0,0,536,309,227,2,1,539
62,Syria,2016,SYR-16/DDA-3558/SA/H/NGO/2499,11/28/2017 9:46:07 AM,Host Communities,1770,1770,1230,1230,6000,2802,3266,2006,1922,9996
62,Syria,2016,SYR-16/DDA-3558/SA/H/NGO/2499,11/28/2017 9:46:07 AM,Internally Displaced People,4130,4130,2870,2870,14000,5452,8572,2890,3005,19919
62,Syria,2016,SYR-16/DDA-3558/SA/H/NGO/2499,11/28/2017 9:46:07 AM,Overall,5900,5900,4100,4100,20000,8254,11838,4896,4927,29915
62,Syria,2016,SYR-16/DDA-3558/SA/H/NGO/2516,10/29/2017 1:54:54 PM,Overall,321,284,0,0,605,338,259,8,8,613
62,Syria,2016,SYR-16/DDA-3558/SA/H/NGO/4187,9/13/2018 8:54:42 AM,Host Communities,28634,30153,8303,8275,75365,28634,30153,8303,8276,75366
62,Syria,2016,SYR-16/DDA-3558/SA/H/NGO/4187,9/13/2018 8:54:42 AM,Internally Displaced People,53179,55999,15420,15370,139968,53179,55999,15420,15370,139968
62,Syria,2016,SYR-16/DDA-3558/SA/H/NGO/4187,9/13/2018 8:54:42 AM,Overall,81813,86152,23724,23645,215334,81813,86152,23724,23645,215334
62,Syria,2016,SYR-16/DDA-3558/SA/H/NGO/4202,2/8/2018 11:05:35 AM,Host Communities,900,900,275,275,2350,360,412,134,121,1027
62,Syria,2016,SYR-16/DDA-3558/SA/H/NGO/4202,2/8/2018 11:05:35 AM,Overall,1200,1200,435,435,3270,485,635,180,164,1464
62,Syria,2016,SYR-16/DDA-3558/SA/H/NGO/4216,6/14/2018 7:18:22 AM,Host Communities,70,44,2,0,116,132,64,0,9,205
62,Syria,2016,SYR-16/DDA-3558/SA/H/NGO/4216,6/14/2018 7:18:22 AM,Internally Displaced People,160,100,0,1,261,186,92,1,4,283
62,Syria,2016,SYR-16/DDA-3558/SA/H/NGO/4216,6/14/2018 7:18:22 AM,Other,40,42,0,0,82,12,9,2,0,23
62,Syria,2016,SYR-16/DDA-3558/SA/H/NGO/4216,6/14/2018 7:18:22 AM,Overall,270,186,2,1,459,330,165,3,13,511
62,Syria,2016,SYR-16/DDA-3558/SA/H/NGO/4228,5/14/2018 11:29:01 AM,Host Communities,111,238,111,190,650,178,323,166,132,799
62,Syria,2016,SYR-16/DDA-3558/SA/H/NGO/4228,5/14/2018 11:29:01 AM,Internally Displaced People,111,170,111,172,564,179,175,169,90,613
62,Syria,2016,SYR-16/DDA-3558/SA/H/NGO/4228,5/14/2018 11:29:01 AM,Other,0,60,0,70,130,0,70,0,40,110
62,Syria,2016,SYR-16/DDA-3558/SA/H/NGO/4228,5/14/2018 11:29:01 AM,Overall,222,468,222,432,1344,357,568,335,262,1522
62,Syria,2016,SYR-16/DDA-3558/SA/H/NGO/4295,10/1/2018 8:31:51 AM,Internally Displaced People,249,217,0,0,466,288,259,0,0,547
62,Syria,2016,SYR-16/DDA-3558/SA/H/NGO/4295,10/1/2018 8:31:51 AM,Overall,249,217,0,0,466,288,259,0,0,547
62,Syria,2016,SYR-16/DDA-3558/SA/H/NGO/4298,6/3/2018 9:50:32 AM,Host Communities,0,0,0,0,0,201,890,159,231,1481
62,Syria,2016,SYR-16/DDA-3558/SA/H/NGO/4298,6/3/2018 9:50:32 AM,Internally Displaced People,0,0,0,0,0,60,172,33,46,311
62,Syria,2016,SYR-16/DDA-3558/SA/H/NGO/4298,6/3/2018 9:50:32 AM,Overall,300,1200,240,300,2040,261,1062,192,277,1792
62,Syria,2016,SYR-16/DDA-3558/SA/H/UN/2521,5/22/2017 12:18:06 PM,Host Communities,6750,15750,6750,6750,36000,20948,29513,4686,4704,59851
62,Syria,2016,SYR-16/DDA-3558/SA/H/UN/2521,5/22/2017 12:18:06 PM,Internally Displaced People,8250,19250,8250,8250,44000,32767,46163,7331,7359,93620
62,Syria,2016,SYR-16/DDA-3558/SA/H/UN/2521,5/22/2017 12:18:06 PM,Overall,15000,35000,15000,15000,80000,53715,75676,12017,12063,153471
62,Syria,2016,SYR-16/DDA-3558/SA/H/UN/4180,2/7/2019 7:12:09 AM,Host Communities,6911,6912,2962,2962,19747,2918,6451,5207,5391,19967
62,Syria,2016,SYR-16/DDA-3558/SA/H/UN/4180,2/7/2019 7:12:09 AM,Internally Displaced People,6911,6912,2962,2962,19747,2045,4085,3140,3245,12515
62,Syria,2016,SYR-16/DDA-3558/SA/H/UN/4180,2/7/2019 7:12:09 AM,Other,6911,6911,2962,2962,19746,1026,2477,2075,2152,7730
62,Syria,2016,SYR-16/DDA-3558/SA/H/UN/4180,2/7/2019 7:12:09 AM,Overall,20733,20735,8886,8886,59240,20892,20893,8954,8954,59693
62,Syria,2016,SYR-16/DDA-3558/SA/N/UN/2515,6/21/2017 8:36:16 AM,Host Communities,0,6580,25668,24662,56910,0,20814,42615,42615,106044
62,Syria,2016,SYR-16/DDA-3558/SA/N/UN/2515,6/21/2017 8:36:16 AM,Internally Displaced People,0,2820,11001,10569,24390,0,5926,16515,16515,38956
62,Syria,2016,SYR-16/DDA-3558/SA/N/UN/2515,6/21/2017 8:36:16 AM,Overall,0,9400,35950,35950,81300,0,26740,59130,59130,145000
62,Syria,2016,SYR-16/DDA-3558/SA/N/UN/4210,6/29/2017 1:08:36 PM,Internally Displaced People,0,0,24610,25870,50480,0,0,24610,25870,50480
62,Syria,2016,SYR-16/DDA-3558/SA/N/UN/4210,6/29/2017 1:08:36 PM,Overall,0,0,24610,25870,50480,0,0,24610,25870,50480
62,Syria,2016,SYR-16/DDA-3558/SA/N/UN/4215,9/5/2017 7:55:52 AM,Host Communities,0,0,100000,100000,200000,0,0,115500,115500,231000
62,Syria,2016,SYR-16/DDA-3558/SA/N/UN/4215,9/5/2017 7:55:52 AM,Internally Displaced People,0,0,45000,45000,90000,0,0,50000,50000,100000
62,Syria,2016,SYR-16/DDA-3558/SA/N/UN/4215,9/5/2017 7:55:52 AM,Overall,0,0,145000,145000,290000,0,0,165500,165500,331000
62,Syria,2016,SYR-16/DDA-3558/SA/P/INGO/4294,12/4/2018 8:43:29 AM,Host Communities,3010,3010,1200,1200,8420,5725,5508,4887,3323,19443
62,Syria,2016,SYR-16/DDA-3558/SA/P/INGO/4294,12/4/2018 8:43:29 AM,Internally Displaced People,5000,6000,2100,2550,15650,4685,4506,3997,2719,15907
62,Syria,2016,SYR-16/DDA-3558/SA/P/INGO/4294,12/4/2018 8:43:29 AM,Overall,8010,9010,3300,3750,24070,10410,10014,8884,6042,35350
62,Syria,2016,SYR-16/DDA-3558/SA/P/INGO/4311,6/12/2018 12:25:18 PM,Host Communities,49,49,204,260,562,104,117,626,960,1807
62,Syria,2016,SYR-16/DDA-3558/SA/P/INGO/4311,6/12/2018 12:25:18 PM,Internally Displaced People,197,198,814,758,1967,136,190,850,1100,2276
62,Syria,2016,SYR-16/DDA-3558/SA/P/INGO/4311,6/12/2018 12:25:18 PM,Overall,246,247,1018,1018,2529,240,307,1476,2060,4083
62,Syria,2016,SYR-16/DDA-3558/SA/P-H-WASH/UN/4307,5/3/2018 8:47:49 PM,Host Communities,49,58559,69,11493,70170,185,60379,665,9418,70647
62,Syria,2016,SYR-16/DDA-3558/SA/P-H-WASH/UN/4307,5/3/2018 8:47:49 PM,Internally Displaced People,91,117120,141,22988,140340,231,99625,1487,20400,121743
62,Syria,2016,SYR-16/DDA-3558/SA/P-H-WASH/UN/4307,5/3/2018 8:47:49 PM,Overall,140,175679,210,34481,210510,416,157722,2152,29818,190108
62,Syria,2016,SYR-16/DDA-3558/SA/S/NFI/NGO/4224,2/14/2018 8:36:01 AM,Host Communities,0,0,726,826,1552,0,0,650,590,1240
62,Syria,2016,SYR-16/DDA-3558/SA/S/NFI/NGO/4224,2/14/2018 8:36:01 AM,Internally Displaced People,0,0,1900,2170,4070,0,0,2648,2752,5400
62,Syria,2016,SYR-16/DDA-3558/SA/S/NFI/NGO/4224,2/14/2018 8:36:01 AM,Overall,0,0,2626,2996,5622,0,0,3298,3342,6640
62,Syria,2016,SYR-16/DDA-3558/SA/S/NFI/NGO/4288,4/30/2018 11:42:36 AM,Host Communities,0,0,800,800,1600,0,0,700,700,1400
62,Syria,2016,SYR-16/DDA-3558/SA/S/NFI/NGO/4288,4/30/2018 11:42:36 AM,Internally Displaced People,0,0,925,925,1850,0,0,1525,1525,3050
62,Syria,2016,SYR-16/DDA-3558/SA/S/NFI/NGO/4288,4/30/2018 11:42:36 AM,Other,0,0,1875,1875,3750,0,0,1375,1375,2750
62,Syria,2016,SYR-16/DDA-3558/SA/S/NFI/NGO/4288,4/30/2018 11:42:36 AM,Overall,0,0,3600,3600,7200,0,0,3600,3600,7200
62,Syria,2016,SYR-16/DDA-3558/SA/S/NFI/NGO/4306,10/1/2018 7:14:00 AM,Host Communities,152,174,99,120,545,152,174,99,120,545
62,Syria,2016,SYR-16/DDA-3558/SA/S/NFI/NGO/4306,10/1/2018 7:14:00 AM,Internally Displaced People,200,200,368,488,1256,200,200,368,488,1256
62,Syria,2016,SYR-16/DDA-3558/SA/S/NFI/NGO/4306,10/1/2018 7:14:00 AM,Overall,352,374,467,608,1801,352,374,467,608,1801
62,Syria,2016,SYR-16/DDA-3558/SA/S/NFI/UN/4262,9/5/2017 7:57:57 AM,Host Communities,0,0,1530,1530,3060,0,0,1530,1530,3060
62,Syria,2016,SYR-16/DDA-3558/SA/S/NFI/UN/4262,9/5/2017 7:57:57 AM,Internally Displaced People,0,0,6121,6121,12242,0,0,6121,6121,12242
62,Syria,2016,SYR-16/DDA-3558/SA/S/NFI/UN/4262,9/5/2017 7:57:57 AM,Overall,0,0,7651,7651,15302,0,0,7651,7651,15302
62,Syria,2016,SYR-16/DDA-3558/SA/S/NFI-FSA/NGO/2406,11/10/2016 1:58:07 PM,Host Communities,8728,11586,12124,43741,76179,28653,28123,61157,73178,191111
62,Syria,2016,SYR-16/DDA-3558/SA/S/NFI-FSA/NGO/2406,11/10/2016 1:58:07 PM,Internally Displaced People,13597,14268,26166,12384,66415,2579,2579,7928,7973,21059
62,Syria,2016,SYR-16/DDA-3558/SA/S/NFI-FSA/NGO/2406,11/10/2016 1:58:07 PM,Overall,22458,26127,38290,56125,143000,31232,30702,69085,81151,212170
62,Syria,2016,SYR-16/DDA-3558/SA/S/NFI-P/INGO/4304,11/6/2018 1:14:41 PM,Internally Displaced People,196,179,315,360,1050,392,358,630,720,2100
62,Syria,2016,SYR-16/DDA-3558/SA/S/NFI-P/INGO/4304,11/6/2018 1:14:41 PM,Overall,196,179,315,360,1050,196,179,315,360,1050
62,Syria,2016,SYR-16/DDA-3558/SA/S/NFI-WASH/INGO/4164,5/14/2018 11:42:49 AM,Host Communities,3805,4288,2235,2522,12850,3755,4432,2205,2518,12910
62,Syria,2016,SYR-16/DDA-3558/SA/S/NFI-WASH/INGO/4164,5/14/2018 11:42:49 AM,Internally Displaced People,4486,5058,2634,2972,15150,5415,6114,3114,3531,18174
62,Syria,2016,SYR-16/DDA-3558/SA/S/NFI-WASH/INGO/4164,5/14/2018 11:42:49 AM,Overall,8291,9346,4869,5494,28000,9170,10546,5319,6049,31084
62,Syria,2016,SYR-16/DDA-3558/SA/S/NFI-WASH-P/INGO/4293,5/5/2019 8:49:51 AM,Host Communities,0,0,0,0,0,845,1100,250,112,2307
62,Syria,2016,SYR-16/DDA-3558/SA/S/NFI-WASH-P/INGO/4293,5/5/2019 8:49:51 AM,Other,530,560,190,178,1458,4420,5400,980,463,11263
62,Syria,2016,SYR-16/DDA-3558/SA/S/NFI-WASH-P/INGO/4293,5/5/2019 8:49:51 AM,Overall,530,560,190,178,1458,338,392,194,183,1107
62,Syria,2016,SYR-16/DDA-3558/SA/WASH/INGO/2403,12/5/2017 1:15:07 PM,Overall,49017,73526,19607,21241,163391,105309,157963,42123,45634,351029
62,Syria,2016,SYR-16/DDA-3558/SA/WASH/INGO/2506,6/12/2017 1:02:55 PM,Host Communities,26250,25900,17640,17710,87500,101628,105776,62222,76048,345674
62,Syria,2016,SYR-16/DDA-3558/SA/WASH/INGO/2506,6/12/2017 1:02:55 PM,Internally Displaced People,11250,11100,7560,7590,37500,33355,34717,20423,24960,113455
62,Syria,2016,SYR-16/DDA-3558/SA/WASH/INGO/2506,6/12/2017 1:02:55 PM,Overall,37500,37000,25200,25300,125000,134983,140493,82645,101008,459129
62,Syria,2016,SYR-16/DDA-3558/SA/WASH/INGO/4161,6/20/2018 8:07:38 AM,Host Communities,0,0,0,0,0,75876,113814,30351,32880,252921
62,Syria,2016,SYR-16/DDA-3558/SA/WASH/INGO/4161,6/20/2018 8:07:38 AM,Internally Displaced People,0,0,0,0,0,33723,92737,20234,21920,168614
62,Syria,2016,SYR-16/DDA-3558/SA/WASH/INGO/4161,6/20/2018 8:07:38 AM,Overall,88968,139039,42258,45779,316044,123579,186469,53646,57841,421535
62,Syria,2016,SYR-16/DDA-3558/SA/WASH/INGO/4206,2/4/2018 12:35:01 PM,Host Communities,36000,44000,0,0,80000,21500,30100,17200,17200,86000
62,Syria,2016,SYR-16/DDA-3558/SA/WASH/INGO/4206,2/4/2018 12:35:01 PM,Internally Displaced People,15750,19250,0,0,35000,12168,16868,10004,10004,49044
62,Syria,2016,SYR-16/DDA-3558/SA/WASH/INGO/4206,2/4/2018 12:35:01 PM,Overall,51750,63250,0,0,115000,33668,46968,27204,27204,135044
62,Syria,2016,SYR-16/DDA-3558/SA/WASH/INGO/4305,4/19/2018 7:12:23 AM,Host Communities,44100,45900,20400,30600,141000,46234,49422,30291,33480,159427
62,Syria,2016,SYR-16/DDA-3558/SA/WASH/INGO/4305,4/19/2018 7:12:23 AM,Internally Displaced People,29400,30600,19600,29400,109000,37828,40436,24784,27392,130440
62,Syria,2016,SYR-16/DDA-3558/SA/WASH/INGO/4305,4/19/2018 7:12:23 AM,Overall,73500,76500,40000,60000,250000,84061,89859,55075,60872,289867
62,Syria,2016,SYR-16/DDA-3558/SA/WASH/NGO/4292,9/24/2018 9:15:57 AM,Internally Displaced People,300,500,1030,1250,3080,290,477,1004,1225,2996
62,Syria,2016,SYR-16/DDA-3558/SA/WASH/NGO/4292,9/24/2018 9:15:57 AM,Overall,300,500,1030,1250,3080,290,477,1004,1225,2996
62,Syria,2017,SYR-17/DDA-3558/Aleppo SA 2017/E/INGO/4551,3/31/2018 7:29:35 PM,Other,0,0,0,0,0,64,181,7444,1222,8911
62,Syria,2017,SYR-17/DDA-3558/Aleppo SA 2017/E/INGO/4551,3/31/2018 7:29:35 PM,Overall,65,181,7444,1221,8911,65,181,7444,1222,8912
62,Syria,2017,SYR-17/DDA-3558/Aleppo SA 2017/E/INGO/4585,10/14/2018 7:56:53 AM,Overall,200,400,2662,2650,5912,102,687,5002,7841,13632
62,Syria,2017,SYR-17/DDA-3558/Aleppo SA 2017/E-P/INGO/4634,7/16/2018 7:17:33 AM,Other,148,346,1559,1901,3954,123,328,1855,2510,4816
62,Syria,2017,SYR-17/DDA-3558/Aleppo SA 2017/E-P/INGO/4634,7/16/2018 7:17:33 AM,Overall,148,346,1559,1901,3954,123,328,1855,2510,4816
62,Syria,2017,SYR-17/DDA-3558/Aleppo SA 2017/E-P/INGO/4647,8/5/2018 8:54:34 AM,Overall,0,0,930,3425,4355,28,559,1815,2634,5036
62,Syria,2017,SYR-17/DDA-3558/Aleppo SA 2017/ERL/NGO/4657,9/22/2019 8:42:35 AM,Host Communities,200,200,297,303,1000,200,200,239,361,1000
62,Syria,2017,SYR-17/DDA-3558/Aleppo SA 2017/ERL/NGO/4657,9/22/2019 8:42:35 AM,Overall,200,200,297,303,1000,200,200,239,361,1000
62,Syria,2017,SYR-17/DDA-3558/Aleppo SA 2017/ERL/UN/4648,10/7/2018 9:45:16 AM,Host Communities,1169,1602,1127,1127,5025,1171,1607,1133,1133,5044
62,Syria,2017,SYR-17/DDA-3558/Aleppo SA 2017/ERL/UN/4648,10/7/2018 9:45:16 AM,Internally Displaced People,388,535,378,377,1678,390,538,375,376,1679
62,Syria,2017,SYR-17/DDA-3558/Aleppo SA 2017/ERL/UN/4648,10/7/2018 9:45:16 AM,Other,388,535,376,376,1675,390,536,376,378,1680
62,Syria,2017,SYR-17/DDA-3558/Aleppo SA 2017/ERL/UN/4648,10/7/2018 9:45:16 AM,Overall,1945,2672,1881,1880,8378,1951,2681,1886,1885,8403
62,Syria,2017,SYR-17/DDA-3558/Aleppo SA 2017/ERL/UN/6447,1/12/2020 1:26:01 PM,Host Communities,277,189,75,63,604,277,189,75,63,604
62,Syria,2017,SYR-17/DDA-3558/Aleppo SA 2017/ERL/UN/6447,1/12/2020 1:26:01 PM,Internally Displaced People,253,182,61,82,578,253,182,61,82,578
62,Syria,2017,SYR-17/DDA-3558/Aleppo SA 2017/ERL/UN/6447,1/12/2020 1:26:01 PM,Overall,530,371,136,145,1182,530,371,136,145,1182
62,Syria,2017,SYR-17/DDA-3558/Aleppo SA 2017/FSA/NGO/4519,6/29/2017 1:34:23 PM,Host Communities,2780,3075,2198,2301,10354,2780,3075,2198,2301,10354
62,Syria,2017,SYR-17/DDA-3558/Aleppo SA 2017/FSA/NGO/4519,6/29/2017 1:34:23 PM,Overall,2780,3075,2198,2301,10354,2780,3075,2198,2301,10354
62,Syria,2017,SYR-17/DDA-3558/Aleppo SA 2017/FSA/UN/4661,9/23/2019 6:20:33 AM,Host Communities,473,1786,1256,1256,4771,5102,8161,6118,6119,25500
62,Syria,2017,SYR-17/DDA-3558/Aleppo SA 2017/FSA/UN/4661,9/23/2019 6:20:33 AM,Internally Displaced People,598,1126,778,778,3280,0,0,0,0,0
62,Syria,2017,SYR-17/DDA-3558/Aleppo SA 2017/FSA/UN/4661,9/23/2019 6:20:33 AM,Other,3111,5554,4092,4092,16849,0,0,0,0,0
62,Syria,2017,SYR-17/DDA-3558/Aleppo SA 2017/FSA/UN/4661,9/23/2019 6:20:33 AM,Overall,4182,8466,6126,6126,24900,5108,8160,6116,6116,25500
62,Syria,2017,SYR-17/DDA-3558/Aleppo SA 2017/H/NGO/4730,6/30/2019 10:32:54 AM,Host Communities,50,25,10,10,95,810,420,65,31,1326
62,Syria,2017,SYR-17/DDA-3558/Aleppo SA 2017/H/NGO/4730,6/30/2019 10:32:54 AM,Internally Displaced People,30,13,5,5,53,30,23,5,3,61
62,Syria,2017,SYR-17/DDA-3558/Aleppo SA 2017/H/NGO/4730,6/30/2019 10:32:54 AM,Other,734,400,115,115,1364,50,28,4,2,84
62,Syria,2017,SYR-17/DDA-3558/Aleppo SA 2017/H/NGO/4730,6/30/2019 10:32:54 AM,Overall,844,450,135,135,1564,950,506,80,40,1576
62,Syria,2017,SYR-17/DDA-3558/Aleppo SA 2017/H/NGO/4730,6/30/2019 10:32:54 AM,Returnees,30,12,5,5,52,60,35,6,4,105
62,Syria,2017,SYR-17/DDA-3558/Aleppo SA 2017/H/UN/4650,3/15/2018 2:04:56 PM,Host Communities,4676,9475,3160,3790,21101,5724,11705,4234,4234,25897
62,Syria,2017,SYR-17/DDA-3558/Aleppo SA 2017/H/UN/4650,3/15/2018 2:04:56 PM,Internally Displaced People,7733,15893,5300,6358,35284,12746,21539,6856,6945,48086
62,Syria,2017,SYR-17/DDA-3558/Aleppo SA 2017/H/UN/4650,3/15/2018 2:04:56 PM,Overall,12409,25368,8460,10148,56385,18470,33244,11090,11179,73983
62,Syria,2017,SYR-17/DDA-3558/Aleppo SA 2017/H/UN/4735,9/6/2020 12:08:20 PM,Overall,4600,10350,4140,3910,23000,10076,22672,9068,8565,50381
62,Syria,2017,SYR-17/DDA-3558/Aleppo SA 2017/H-N/INGO/4614,12/16/2018 11:25:51 AM,Host Communities,2142,2229,1488,1549,7408,390,1096,920,924,3330
62,Syria,2017,SYR-17/DDA-3558/Aleppo SA 2017/H-N/INGO/4614,12/16/2018 11:25:51 AM,Internally Displaced People,962,1002,669,696,3329,161,467,413,415,1456
62,Syria,2017,SYR-17/DDA-3558/Aleppo SA 2017/H-N/INGO/4614,12/16/2018 11:25:51 AM,Overall,3104,3231,2157,2245,10737,551,1563,1333,1339,4786
62,Syria,2017,SYR-17/DDA-3558/Aleppo SA 2017/H-WASH/INGO/4658,5/14/2018 11:34:11 AM,Other,36,45,0,0,81,36,45,0,0,81
62,Syria,2017,SYR-17/DDA-3558/Aleppo SA 2017/H-WASH/INGO/4658,5/14/2018 11:34:11 AM,Overall,2646,2867,3970,4302,13785,2952,3072,3803,3958,13785
62,Syria,2017,SYR-17/DDA-3558/Aleppo SA 2017/H-WASH-P/UN/4643,7/2/2018 6:59:28 AM,Host Communities,8000,42000,15000,10000,75000,0,0,0,0,0
62,Syria,2017,SYR-17/DDA-3558/Aleppo SA 2017/H-WASH-P/UN/4643,7/2/2018 6:59:28 AM,Internally Displaced People,4000,50000,2000,7100,63100,0,0,0,0,0
62,Syria,2017,SYR-17/DDA-3558/Aleppo SA 2017/H-WASH-P/UN/4643,7/2/2018 6:59:28 AM,Other,0,27000,0,13400,40400,10727,174989,7800,27700,221216
62,Syria,2017,SYR-17/DDA-3558/Aleppo SA 2017/H-WASH-P/UN/4643,7/2/2018 6:59:28 AM,Overall,12000,119000,17000,30500,178500,10727,174989,7800,27700,221216
62,Syria,2017,SYR-17/DDA-3558/Aleppo SA 2017/N/UN/4737,3/15/2018 2:08:18 PM,Internally Displaced People,0,13500,59916,59917,133333,0,13500,59916,59917,133333
62,Syria,2017,SYR-17/DDA-3558/Aleppo SA 2017/N/UN/4737,3/15/2018 2:08:18 PM,Overall,0,13500,59916,59917,133333,0,13500,59916,59917,133333
62,Syria,2017,SYR-17/DDA-3558/Aleppo SA 2017/S/NFI/INGO/4623,1/29/2020 1:51:41 PM,Internally Displaced People,0,0,0,0,0,169,196,96,25,486
62,Syria,2017,SYR-17/DDA-3558/Aleppo SA 2017/S/NFI/INGO/4623,1/29/2020 1:51:41 PM,Other,380,860,300,380,1920,507,586,302,537,1932
62,Syria,2017,SYR-17/DDA-3558/Aleppo SA 2017/S/NFI/INGO/4623,1/29/2020 1:51:41 PM,Overall,380,860,300,380,1920,676,782,398,562,2418
62,Syria,2017,SYR-17/DDA-3558/Aleppo SA 2017/S/NFI/NGO/4531,10/3/2017 7:00:57 AM,Host Communities,500,1000,1000,1500,4000,16,17,19,34,86
62,Syria,2017,SYR-17/DDA-3558/Aleppo SA 2017/S/NFI/NGO/4531,10/3/2017 7:00:57 AM,Internally Displaced People,1000,2000,1500,2000,6500,942,5924,5774,8308,20948
62,Syria,2017,SYR-17/DDA-3558/Aleppo SA 2017/S/NFI/NGO/4531,10/3/2017 7:00:57 AM,Other,3500,6000,9500,12620,31620,5774,7364,11469,11636,36243
62,Syria,2017,SYR-17/DDA-3558/Aleppo SA 2017/S/NFI/NGO/4531,10/3/2017 7:00:57 AM,Overall,5000,9000,12000,16120,42120,6732,13305,17262,19978,57277
62,Syria,2017,SYR-17/DDA-3558/Aleppo SA 2017/S/NFI/NGO/4532,8/12/2018 7:51:26 AM,Internally Displaced People,200,200,300,300,1000,343,345,141,125,954
62,Syria,2017,SYR-17/DDA-3558/Aleppo SA 2017/S/NFI/NGO/4532,8/12/2018 7:51:26 AM,Overall,200,200,300,300,1000,343,345,141,125,954
62,Syria,2017,SYR-17/DDA-3558/Aleppo SA 2017/S/NFI/NGO/4649,6/11/2019 8:33:17 AM,Host Communities,22,106,167,250,545,0,0,0,0,0
62,Syria,2017,SYR-17/DDA-3558/Aleppo SA 2017/S/NFI/NGO/4649,6/11/2019 8:33:17 AM,Internally Displaced People,5,30,40,60,135,0,0,0,0,0
62,Syria,2017,SYR-17/DDA-3558/Aleppo SA 2017/S/NFI/NGO/4649,6/11/2019 8:33:17 AM,Other,0,0,0,0,0,171,249,185,183,788
62,Syria,2017,SYR-17/DDA-3558/Aleppo SA 2017/S/NFI/NGO/4649,6/11/2019 8:33:17 AM,Overall,27,136,207,310,680,171,249,185,183,788
62,Syria,2017,SYR-17/DDA-3558/Aleppo SA 2017/S/NFI/NGO/4660,9/8/2019 8:33:52 AM,Host Communities,144,249,465,487,1345,283,372,364,504,1523
62,Syria,2017,SYR-17/DDA-3558/Aleppo SA 2017/S/NFI/NGO/4660,9/8/2019 8:33:52 AM,Overall,144,249,465,487,1345,283,372,364,504,1523
62,Syria,2017,SYR-17/DDA-3558/Aleppo SA 2017/S/NFI/UN/4726,10/16/2018 7:10:36 AM,Internally Displaced People,750,1200,510,540,3000,1376,2800,936,990,6102
62,Syria,2017,SYR-17/DDA-3558/Aleppo SA 2017/S/NFI/UN/4726,10/16/2018 7:10:36 AM,Overall,750,1200,510,540,3000,688,1100,468,495,2751
62,Syria,2017,SYR-17/DDA-3558/Aleppo SA 2017/WASH/INGO/4595,10/15/2018 8:51:03 AM,Host Communities,31950,42176,23005,30672,127803,32710,43177,23551,31401,130839
62,Syria,2017,SYR-17/DDA-3558/Aleppo SA 2017/WASH/INGO/4595,10/15/2018 8:51:03 AM,Internally Displaced People,125,165,90,120,500,125,165,90,120,500
62,Syria,2017,SYR-17/DDA-3558/Aleppo SA 2017/WASH/INGO/4595,10/15/2018 8:51:03 AM,Overall,32075,42341,23095,30792,128303,32835,43342,23641,31522,131340
62,Syria,2017,SYR-17/DDA-3558/Aleppo SA 2017/WASH/INGO/4596,9/25/2018 7:04:11 AM,Other,26550,27900,19170,16380,90000,23359,24164,15304,17720,80547
62,Syria,2017,SYR-17/DDA-3558/Aleppo SA 2017/WASH/INGO/4596,9/25/2018 7:04:11 AM,Overall,26550,27900,19170,16380,90000,23359,24164,15304,17720,80547
62,Syria,2017,SYR-17/DDA-3558/Aleppo SA 2017/WASH-S/NFI/INGO/4566,9/8/2019 8:29:28 AM,Host Communities,10650,15975,4260,4615,35500,2608,4028,6031,6005,18672
62,Syria,2017,SYR-17/DDA-3558/Aleppo SA 2017/WASH-S/NFI/INGO/4566,9/8/2019 8:29:28 AM,Internally Displaced People,7050,10575,2820,3055,23500,5216,8057,9678,9745,32696
62,Syria,2017,SYR-17/DDA-3558/Aleppo SA 2017/WASH-S/NFI/INGO/4566,9/8/2019 8:29:28 AM,Other,8400,12600,3360,3640,28000,5537,8539,11911,12180,38167
62,Syria,2017,SYR-17/DDA-3558/Aleppo SA 2017/WASH-S/NFI/INGO/4566,9/8/2019 8:29:28 AM,Overall,26100,39150,10440,11310,87000,13361,20624,27620,27930,89535
62,Syria,2017,SYR-17/DDA-3558/Aleppo SA 2017/WASH-S/NFI/UN/4654,12/11/2019 2:22:05 PM,Internally Displaced People,540,660,420,380,2000,972,1254,756,646,3628
62,Syria,2017,SYR-17/DDA-3558/Aleppo SA 2017/WASH-S/NFI/UN/4654,12/11/2019 2:22:05 PM,Other,4860,5940,3780,3420,18000,4428,5346,3444,3154,16372
62,Syria,2017,SYR-17/DDA-3558/Aleppo SA 2017/WASH-S/NFI/UN/4654,12/11/2019 2:22:05 PM,Overall,5400,6600,4200,3800,20000,5400,6600,4200,3800,20000
62,Syria,2017,SYR-17/DDA-3558/NE Standard Allocation/FSA/NGO/7499,8/28/2018 11:07:16 AM,Host Communities,1650,1650,3475,3475,10250,3195,3316,5870,5734,18115
62,Syria,2017,SYR-17/DDA-3558/NE Standard Allocation/FSA/NGO/7499,8/28/2018 11:07:16 AM,Internally Displaced People,9000,9000,12500,12500,43000,12778,13266,23477,22933,72454
62,Syria,2017,SYR-17/DDA-3558/NE Standard Allocation/FSA/NGO/7499,8/28/2018 11:07:16 AM,Overall,10650,10650,15975,15975,53250,15973,16582,29347,28667,90569
62,Syria,2017,SYR-17/DDA-3558/NE Standard Allocation/H/INGO/7574,12/15/2019 10:28:36 AM,Host Communities,13519,21059,10666,12588,57832,28062,35183,21342,23697,108284
62,Syria,2017,SYR-17/DDA-3558/NE Standard Allocation/H/INGO/7574,12/15/2019 10:28:36 AM,Internally Displaced People,8284,12270,6432,8210,35196,0,0,0,0,0
62,Syria,2017,SYR-17/DDA-3558/NE Standard Allocation/H/INGO/7574,12/15/2019 10:28:36 AM,Overall,21803,33329,17098,20798,93028,28062,35183,21342,23697,108284
62,Syria,2017,SYR-17/DDA-3558/NE Standard Allocation/H/UN/7577,3/12/2019 8:50:29 AM,Host Communities,800,8000,2100,4000,14900,109,5124,281,1040,6554
62,Syria,2017,SYR-17/DDA-3558/NE Standard Allocation/H/UN/7577,3/12/2019 8:50:29 AM,Internally Displaced People,700,7875,3838,4437,16850,712,23309,957,7495,32473
62,Syria,2017,SYR-17/DDA-3558/NE Standard Allocation/H/UN/7577,3/12/2019 8:50:29 AM,Overall,1500,15875,5938,8437,31750,821,28433,1238,8535,39027
62,Syria,2017,SYR-17/DDA-3558/NE Standard Allocation/N/UN/7561,1/16/2019 8:37:47 AM,Internally Displaced People,0,31511,27526,27526,86563,0,25286,32409,33732,91427
62,Syria,2017,SYR-17/DDA-3558/NE Standard Allocation/N/UN/7561,1/16/2019 8:37:47 AM,Overall,0,31511,27526,27526,86563,0,25286,32409,33732,91427
62,Syria,2017,SYR-17/DDA-3558/NE Standard Allocation/P/UN/7578,5/9/2019 10:14:38 AM,Internally Displaced People,0,13759,0,4241,18000,0,17239,0,4695,21934
62,Syria,2017,SYR-17/DDA-3558/NE Standard Allocation/P/UN/7578,5/9/2019 10:14:38 AM,Overall,0,13759,0,4241,18000,0,17239,0,4695,21934
62,Syria,2017,SYR-17/DDA-3558/NE Standard Allocation/S/NFI/NGO/7398,10/24/2018 9:19:52 AM,Host Communities,3000,4500,1500,3000,12000,3360,5924,8719,8720,26723
62,Syria,2017,SYR-17/DDA-3558/NE Standard Allocation/S/NFI/NGO/7398,10/24/2018 9:19:52 AM,Internally Displaced People,12000,18000,17250,23250,70500,13442,23695,34882,34886,106905
62,Syria,2017,SYR-17/DDA-3558/NE Standard Allocation/S/NFI/NGO/7398,10/24/2018 9:19:52 AM,Overall,15000,22500,18750,26250,82500,16802,29619,43601,43606,133628
62,Syria,2017,SYR-17/DDA-3558/NE Standard Allocation/S/NFI/UN/7503,7/29/2019 6:59:08 AM,Internally Displaced People,374,742,1492,1492,4100,0,0,0,0,0
62,Syria,2017,SYR-17/DDA-3558/NE Standard Allocation/S/NFI/UN/7503,7/29/2019 6:59:08 AM,Other,136,272,546,546,1500,1123,1496,2143,2595,7357
62,Syria,2017,SYR-17/DDA-3558/NE Standard Allocation/S/NFI/UN/7503,7/29/2019 6:59:08 AM,Overall,510,1014,2038,2038,5600,1123,1499,2143,2595,7360
62,Syria,2017,SYR-17/DDA-3558/NE Standard Allocation/S/NFI/UN/7521,7/31/2018 6:32:50 AM,Internally Displaced People,0,0,17887,17888,35775,0,0,17886,17886,35772
62,Syria,2017,SYR-17/DDA-3558/NE Standard Allocation/S/NFI/UN/7521,7/31/2018 6:32:50 AM,Overall,0,0,17887,17888,35775,0,0,17886,17886,35772
62,Syria,2017,SYR-17/DDA-3558/NE Standard Allocation/S/NFI/UN/7562,4/30/2019 8:47:57 AM,Internally Displaced People,7350,8400,9800,9450,35000,7350,8400,9800,9450,35000
62,Syria,2017,SYR-17/DDA-3558/NE Standard Allocation/S/NFI/UN/7562,4/30/2019 8:47:57 AM,Overall,7350,8400,9800,9450,35000,7350,8400,9800,9450,35000
62,Syria,2017,SYR-17/DDA-3558/NE Standard Allocation/WASH/INGO/7365,4/4/2019 7:47:01 AM,Host Communities,3557,3802,2331,2576,12266,14840,15861,9209,11256,51166
62,Syria,2017,SYR-17/DDA-3558/NE Standard Allocation/WASH/INGO/7365,4/4/2019 7:47:01 AM,Internally Displaced People,27688,29597,18140,20062,95487,5755,6153,3572,4366,19846
62,Syria,2017,SYR-17/DDA-3558/NE Standard Allocation/WASH/INGO/7365,4/4/2019 7:47:01 AM,Other,8306,8879,5424,6030,28639,22651,24212,14059,17184,78106
62,Syria,2017,SYR-17/DDA-3558/NE Standard Allocation/WASH/INGO/7365,4/4/2019 7:47:01 AM,Overall,39551,42278,25895,28668,136392,43246,46226,26840,32806,149118
62,Syria,2017,SYR-17/DDA-3558/NE Standard Allocation/WASH/INGO/7532,6/25/2019 11:23:54 AM,Host Communities,1075,1230,1224,1345,4874,5756,6265,5330,4762,22113
62,Syria,2017,SYR-17/DDA-3558/NE Standard Allocation/WASH/INGO/7532,6/25/2019 11:23:54 AM,Internally Displaced People,13823,15824,15741,17299,62687,11728,14138,12714,12974,51554
62,Syria,2017,SYR-17/DDA-3558/NE Standard Allocation/WASH/INGO/7532,6/25/2019 11:23:54 AM,Other,82,71,374,382,909,1729,2637,1095,1357,6818
62,Syria,2017,SYR-17/DDA-3558/NE Standard Allocation/WASH/INGO/7532,6/25/2019 11:23:54 AM,Overall,15359,17583,17491,19222,69655,19213,23040,19139,19093,80485
62,Syria,2017,SYR-17/DDA-3558/RA/CCS/UN/4968,7/17/2019 6:42:13 AM,Overall,1,0,0,0,1,1,0,0,0,1
62,Syria,2017,SYR-17/DDA-3558/RA/H/NGO/5170,10/3/2018 6:24:51 AM,Host Communities,1600,1724,2,4,3330,2664,2623,2,0,5289
62,Syria,2017,SYR-17/DDA-3558/RA/H/NGO/5170,10/3/2018 6:24:51 AM,Internally Displaced People,5500,3900,6,8,9414,5243,4159,1,1,9404
62,Syria,2017,SYR-17/DDA-3558/RA/H/NGO/5170,10/3/2018 6:24:51 AM,Overall,7100,5624,8,12,12744,7907,6782,3,1,14693
62,Syria,2017,SYR-17/DDA-3558/RA/H/UN/7327,11/29/2018 7:43:35 AM,Other,650,600,0,0,1250,800,725,0,0,1525
62,Syria,2017,SYR-17/DDA-3558/RA/H/UN/7327,11/29/2018 7:43:35 AM,Overall,650,600,0,0,1250,800,725,0,0,1525
62,Syria,2017,SYR-17/DDA-3558/RA/LOG/UN/5291,12/26/2017 10:16:08 AM,Overall,1,0,0,0,1,1,0,0,0,1
62,Syria,2017,SYR-17/DDA-3558/RA/LOG/UN/5324,3/15/2018 1:51:24 PM,Overall,1,0,0,0,1,1,0,0,0,1
62,Syria,2017,SYR-17/DDA-3558/RA/LOG/UN/6295,10/3/2019 1:29:16 PM,Overall,1,0,0,0,1,1,0,0,0,1
62,Syria,2017,SYR-17/DDA-3558/RA/S/NFI/UN/6646,5/14/2018 8:50:37 AM,Other,1,0,0,0,1,0,0,0,0,0
62,Syria,2017,SYR-17/DDA-3558/RA/S/NFI/UN/6646,5/14/2018 8:50:37 AM,Overall,1,0,0,0,1,1,0,0,0,1
62,Syria,2018,SYR-18/DDA-3558/AR/FSA/O/8818,9/26/2018 7:15:21 AM,Internally Displaced People,8140,18993,8141,18994,54268,0,0,0,0,0
62,Syria,2018,SYR-18/DDA-3558/AR/FSA/O/8818,9/26/2018 7:15:21 AM,Overall,8140,18993,8141,18994,54268,0,0,0,0,0
62,Syria,2018,SYR-18/DDA-3558/AR/FSA/UN/10953,1/15/2020 8:55:38 AM,Host Communities,9352,10849,9352,7855,37408,12180,13990,11703,9993,47866
62,Syria,2018,SYR-18/DDA-3558/AR/FSA/UN/10953,1/15/2020 8:55:38 AM,Internally Displaced People,2741,3180,2741,2303,10965,0,0,0,0,0
62,Syria,2018,SYR-18/DDA-3558/AR/FSA/UN/10953,1/15/2020 8:55:38 AM,Other,4031,4676,4031,3387,16125,4154,4817,4154,3509,16634
62,Syria,2018,SYR-18/DDA-3558/AR/FSA/UN/10953,1/15/2020 8:55:38 AM,Overall,16125,18705,16125,13545,64500,16334,18807,15857,13502,64500
62,Syria,2018,SYR-18/DDA-3558/AR/S/NFI/UN/9223,7/1/2019 9:50:36 AM,Host Communities,95,108,126,122,451,0,0,0,0,0
62,Syria,2018,SYR-18/DDA-3558/AR/S/NFI/UN/9223,7/1/2019 9:50:36 AM,Internally Displaced People,955,1092,1274,1228,4549,3074,3514,5982,5836,18406
62,Syria,2018,SYR-18/DDA-3558/AR/S/NFI/UN/9223,7/1/2019 9:50:36 AM,Other,1260,1440,1680,1620,6000,0,0,0,0,0
62,Syria,2018,SYR-18/DDA-3558/AR/S/NFI/UN/9223,7/1/2019 9:50:36 AM,Overall,2310,2640,3080,2970,11000,3865,4418,5154,4969,18406
62,Syria,2018,SYR-18/DDA-3558/AR/S/NFI-FSA-H-WASH/UN/9265,10/29/2019 9:03:21 AM,Overall,3332,2952,1618,1618,9520,2872,2544,1395,1395,8206
62,Syria,2018,SYR-18/DDA-3558/AR/S/NFI-FSA-H-WASH/UN/9265,10/29/2019 9:03:21 AM,Refugees,3332,2952,1618,1618,9520,2872,2544,1395,1395,8206
62,Syria,2018,SYR-18/DDA-3558/AR/WASH/INGO/10958,7/4/2019 8:15:58 AM,Host Communities,10973,15154,12541,13586,52254,29963,41375,34240,37096,142674
62,Syria,2018,SYR-18/DDA-3558/AR/WASH/INGO/10958,7/4/2019 8:15:58 AM,Internally Displaced People,2195,3031,2508,2717,10451,4992,6895,5705,6183,23775
62,Syria,2018,SYR-18/DDA-3558/AR/WASH/INGO/10958,7/4/2019 8:15:58 AM,Other,5121,7071,5853,6340,24385,14981,20686,17119,18549,71335
62,Syria,2018,SYR-18/DDA-3558/AR/WASH/INGO/10958,7/4/2019 8:15:58 AM,Overall,18289,25256,20902,22644,87091,22804,31491,26062,28233,108590
62,Syria,2018,SYR-18/DDA-3558/RA1/FSA/INGO/8846,1/31/2019 8:19:40 AM,Host Communities,1000,3000,2000,2000,8000,1261,2258,2480,2161,8160
62,Syria,2018,SYR-18/DDA-3558/RA1/FSA/INGO/8846,1/31/2019 8:19:40 AM,Overall,1000,3000,2000,2000,8000,1261,2258,2480,2161,8160
62,Syria,2018,SYR-18/DDA-3558/RA1/H/UN/8813,1/8/2019 9:49:09 AM,Internally Displaced People,3115,7276,5194,5195,20780,3371,7412,6236,6971,23990
62,Syria,2018,SYR-18/DDA-3558/RA1/H/UN/8813,1/8/2019 9:49:09 AM,Overall,3115,7276,5194,5195,20780,3371,7412,6236,6971,23990
62,Syria,2018,SYR-18/DDA-3558/RA1/H/UN/8814,12/16/2018 12:31:14 PM,Internally Displaced People,16000,22400,3900,6352,48652,16128,25124,5306,7311,53869
62,Syria,2018,SYR-18/DDA-3558/RA1/H/UN/8814,12/16/2018 12:31:14 PM,Overall,16000,22400,3900,6352,48652,16128,25124,5306,7311,53869
62,Syria,2018,SYR-18/DDA-3558/RA1/H/UN/8849,11/5/2018 7:55:50 AM,Host Communities,400,2000,250,1250,3900,0,0,0,0,0
62,Syria,2018,SYR-18/DDA-3558/RA1/H/UN/8849,11/5/2018 7:55:50 AM,Internally Displaced People,600,18000,500,9000,28100,8820,30028,2787,9248,50883
62,Syria,2018,SYR-18/DDA-3558/RA1/H/UN/8849,11/5/2018 7:55:50 AM,Overall,1000,20000,750,10250,32000,8820,30028,2787,9248,50883
62,Syria,2018,SYR-18/DDA-3558/RA1/H/UN/8877,1/21/2019 8:42:42 AM,Internally Displaced People,10000,40000,46500,46500,143000,9546,48870,53079,57200,168695
62,Syria,2018,SYR-18/DDA-3558/RA1/H/UN/8877,1/21/2019 8:42:42 AM,Overall,10000,40000,46500,46500,143000,9546,48870,53079,57200,168695
62,Syria,2018,SYR-18/DDA-3558/RA1/H-P-WASH/INGO/8869,1/8/2019 8:12:08 AM,Internally Displaced People,9811,14717,6273,9409,40210,13634,18966,8582,13424,54606
62,Syria,2018,SYR-18/DDA-3558/RA1/H-P-WASH/INGO/8869,1/8/2019 8:12:08 AM,Overall,9811,14717,6273,9409,40210,13634,18966,8582,13424,54606
62,Syria,2018,SYR-18/DDA-3558/RA1/N/UN/8838,9/23/2018 12:48:25 PM,Internally Displaced People,0,25000,21000,21000,67000,0,22072,22525,22551,67148
62,Syria,2018,SYR-18/DDA-3558/RA1/N/UN/8838,9/23/2018 12:48:25 PM,Overall,0,25000,21000,21000,67000,0,22072,22536,22540,67148
62,Syria,2018,SYR-18/DDA-3558/RA1/P/UN/8848,2/10/2019 8:43:20 AM,Host Communities,800,1000,800,1000,3600,883,14595,2383,5416,23277
62,Syria,2018,SYR-18/DDA-3558/RA1/P/UN/8848,2/10/2019 8:43:20 AM,Internally Displaced People,3028,32506,6046,17083,58663,1118,18243,2944,6768,29073
62,Syria,2018,SYR-18/DDA-3558/RA1/P/UN/8848,2/10/2019 8:43:20 AM,Overall,3828,33506,6846,18083,62263,2001,32838,5327,12184,52350
62,Syria,2018,SYR-18/DDA-3558/RA1/P/UN/8854,5/6/2019 8:27:31 AM,Internally Displaced People,4500,4500,15000,15000,39000,687,803,20780,20760,43030
62,Syria,2018,SYR-18/DDA-3558/RA1/P/UN/8854,5/6/2019 8:27:31 AM,Overall,4500,4500,15000,15000,39000,687,803,20780,20760,43030
62,Syria,2018,SYR-18/DDA-3558/RA1/S/NFI/INGO/8842,10/16/2018 12:50:02 PM,Internally Displaced People,2700,3450,2775,2775,11700,2700,3450,2775,2775,11700
62,Syria,2018,SYR-18/DDA-3558/RA1/S/NFI/INGO/8842,10/16/2018 12:50:02 PM,Overall,2700,3450,2775,2775,11700,2700,3450,2775,2775,11700
62,Syria,2018,SYR-18/DDA-3558/RA1/S/NFI/INGO/8867,1/31/2019 3:27:16 PM,Internally Displaced People,1069,1603,3028,3206,8906,1014,1520,2872,3040,8446
62,Syria,2018,SYR-18/DDA-3558/RA1/S/NFI/INGO/8867,1/31/2019 3:27:16 PM,Overall,1069,1603,3028,3206,8906,1014,1520,2872,3040,8446
62,Syria,2018,SYR-18/DDA-3558/RA1/S/NFI/NGO/8823,9/19/2018 12:19:20 PM,Internally Displaced People,6000,6000,13000,13000,38000,7935,9360,13692,13137,44124
62,Syria,2018,SYR-18/DDA-3558/RA1/S/NFI/NGO/8823,9/19/2018 12:19:20 PM,Overall,6000,6000,13000,13000,38000,7935,9360,13692,13137,44124
62,Syria,2018,SYR-18/DDA-3558/RA1/S/NFI/UN/8845,9/19/2018 8:31:11 AM,Internally Displaced People,0,0,15067,15067,30134,0,0,15111,15111,30222
62,Syria,2018,SYR-18/DDA-3558/RA1/S/NFI/UN/8845,9/19/2018 8:31:11 AM,Overall,0,0,15067,15067,30134,0,0,15111,15111,30222
62,Syria,2018,SYR-18/DDA-3558/RA1/S/NFI/UN/8852,9/19/2018 10:38:02 AM,Internally Displaced People,0,0,42182,42181,84363,0,0,42182,42181,84363
62,Syria,2018,SYR-18/DDA-3558/RA1/S/NFI/UN/8852,9/19/2018 10:38:02 AM,Overall,0,0,42182,42181,84363,0,0,42182,42181,84363
62,Syria,2018,SYR-18/DDA-3558/RA1/S/NFI-P/UN/8850,12/24/2019 11:07:52 AM,Internally Displaced People,10670,11959,14159,13229,50017,10046,11481,13394,12916,47837
62,Syria,2018,SYR-18/DDA-3558/RA1/S/NFI-P/UN/8850,12/24/2019 11:07:52 AM,Overall,10670,11959,14159,13229,50017,10046,11481,13394,12916,47837
62,Syria,2018,SYR-18/DDA-3558/RA1/S/NFI-WASH/INGO/8820,12/10/2018 10:33:57 AM,Internally Displaced People,13408,15922,5447,7123,41900,14108,16755,5732,7495,44090
62,Syria,2018,SYR-18/DDA-3558/RA1/S/NFI-WASH/INGO/8820,12/10/2018 10:33:57 AM,Overall,13408,15922,5447,7123,41900,14108,16755,5732,7495,44090
62,Syria,2018,SYR-18/DDA-3558/RA1/S/NFI-WASH-P/INGO/8826,4/4/2019 7:51:58 AM,Internally Displaced People,6713,6713,5275,5274,23975,7310,7323,7214,7180,29027
62,Syria,2018,SYR-18/DDA-3558/RA1/S/NFI-WASH-P/INGO/8826,4/4/2019 7:51:58 AM,Overall,6713,6713,5275,5274,23975,7080,7090,7422,7435,29027
62,Syria,2018,SYR-18/DDA-3558/RA1/WASH/INGO/8868,1/31/2019 3:26:13 PM,Internally Displaced People,1580,2580,9120,10480,23760,600,900,5225,5325,12050
62,Syria,2018,SYR-18/DDA-3558/RA1/WASH/INGO/8868,1/31/2019 3:26:13 PM,Overall,1580,2580,9120,10480,23760,600,900,5225,5325,12050
62,Syria,2018,SYR-18/DDA-3558/RA1/WASH/UN/8840,1/16/2019 8:48:59 AM,Internally Displaced People,25000,35000,20000,20000,100000,46500,52500,35000,36000,170000
62,Syria,2018,SYR-18/DDA-3558/RA1/WASH/UN/8840,1/16/2019 8:48:59 AM,Overall,42500,57500,35000,35000,170000,42500,57500,35000,35000,170000
62,Syria,2018,SYR-18/DDA-3558/RA1/WASH-H/O/8866,12/1/2019 8:49:00 AM,Internally Displaced People,29035,35487,21903,25771,112196,21977,32784,29929,26415,111105
62,Syria,2018,SYR-18/DDA-3558/RA1/WASH-H/O/8866,12/1/2019 8:49:00 AM,Overall,29035,35487,21903,25771,112196,21977,32784,29929,26415,111105
62,Syria,2018,SYR-18/DDA-3558/RA1/WASH-S/NFI/INGO/8812,12/17/2019 12:36:18 PM,Internally Displaced People,87647,129471,43134,46076,306328,82846,146310,54473,56952,340581
62,Syria,2018,SYR-18/DDA-3558/RA1/WASH-S/NFI/INGO/8812,12/17/2019 12:36:18 PM,Overall,87647,129471,43134,46076,306328,82846,146310,54473,56952,340581
62,Syria,2018,SYR-18/DDA-3558/SA/E/INGO/10509,5/5/2020 9:38:40 AM,Host Communities,30,45,1936,1936,3947,16,44,1411,2112,3583
62,Syria,2018,SYR-18/DDA-3558/SA/E/INGO/10509,5/5/2020 9:38:40 AM,Internally Displaced People,0,0,530,531,1061,5,10,27,43,85
62,Syria,2018,SYR-18/DDA-3558/SA/E/INGO/10509,5/5/2020 9:38:40 AM,Overall,30,45,2466,2467,5008,21,54,1438,2155,3668
62,Syria,2018,SYR-18/DDA-3558/SA/E/INGO/10543,3/3/2020 7:53:29 AM,Host Communities,146,407,2883,2883,6319,145,532,3872,3958,8507
62,Syria,2018,SYR-18/DDA-3558/SA/E/INGO/10543,3/3/2020 7:53:29 AM,Internally Displaced People,25,69,480,480,1054,39,107,787,792,1725
62,Syria,2018,SYR-18/DDA-3558/SA/E/INGO/10543,3/3/2020 7:53:29 AM,Other,75,203,1442,1442,3162,5,17,272,285,579
62,Syria,2018,SYR-18/DDA-3558/SA/E/INGO/10543,3/3/2020 7:53:29 AM,Overall,246,679,4805,4805,10535,189,656,4931,5035,10811
62,Syria,2018,SYR-18/DDA-3558/SA/E/INGO/10550,7/1/2019 11:34:25 AM,Other,0,0,1280,1280,2560,0,0,1280,1280,2560
62,Syria,2018,SYR-18/DDA-3558/SA/E/INGO/10550,7/1/2019 11:34:25 AM,Overall,0,0,1280,1280,2560,0,0,1280,1280,2560
62,Syria,2018,SYR-18/DDA-3558/SA/E/INGO/10682,1/7/2020 10:46:15 AM,Host Communities,147,153,5909,6151,12360,90,448,3093,6016,9647
62,Syria,2018,SYR-18/DDA-3558/SA/E/INGO/10682,1/7/2020 10:46:15 AM,Overall,147,153,5909,6151,12360,90,448,3093,6016,9647
62,Syria,2018,SYR-18/DDA-3558/SA/H/INGO/10638,3/15/2020 7:59:40 AM,Host Communities,8449,19186,11700,14750,54085,10928,17329,13471,15709,57437
62,Syria,2018,SYR-18/DDA-3558/SA/H/INGO/10638,3/15/2020 7:59:40 AM,Internally Displaced People,500,1000,700,600,2800,0,0,0,0,0
62,Syria,2018,SYR-18/DDA-3558/SA/H/INGO/10638,3/15/2020 7:59:40 AM,Overall,8949,20186,12400,15350,56885,10928,17329,13471,15709,57437
62,Syria,2018,SYR-18/DDA-3558/SA/H/NGO/10620,11/11/2019 3:04:32 PM,Host Communities,7208,8010,4420,4766,24404,0,0,0,0,0
62,Syria,2018,SYR-18/DDA-3558/SA/H/NGO/10620,11/11/2019 3:04:32 PM,Internally Displaced People,20464,22021,10905,11023,64413,28023,30141,15637,15929,89730
62,Syria,2018,SYR-18/DDA-3558/SA/H/NGO/10620,11/11/2019 3:04:32 PM,Overall,27673,30031,15326,15789,88819,28023,30141,15637,15929,89730
62,Syria,2018,SYR-18/DDA-3558/SA/H/UN/10544,5/4/2020 2:20:42 PM,Other,2000,28000,1500,11000,42500,1670,32460,2988,9360,46478
62,Syria,2018,SYR-18/DDA-3558/SA/H/UN/10544,5/4/2020 2:20:42 PM,Overall,2000,28000,1500,11000,42500,1670,32460,2988,9360,46478
62,Syria,2018,SYR-18/DDA-3558/SA/H/UN/10635,1/15/2020 12:50:23 PM,Overall,13652,16074,9781,9494,49001,13629,16050,9757,9472,48908
62,Syria,2018,SYR-18/DDA-3558/SA/H/UN/10635,1/15/2020 12:50:23 PM,Refugees,13652,16074,9781,9494,49001,13629,16050,9757,9472,48908
62,Syria,2018,SYR-18/DDA-3558/SA/H/UN/10656,12/24/2019 10:05:17 AM,Host Communities,0,9000,10000,10000,29000,0,19292,21098,21551,61941
62,Syria,2018,SYR-18/DDA-3558/SA/H/UN/10656,12/24/2019 10:05:17 AM,Internally Displaced People,0,10000,10000,10000,30000,0,0,0,0,0
62,Syria,2018,SYR-18/DDA-3558/SA/H/UN/10656,12/24/2019 10:05:17 AM,Overall,0,19000,20000,20000,59000,0,19292,21098,21551,61941
62,Syria,2018,SYR-18/DDA-3558/SA/H/UN/10672,12/13/2020 8:05:07 AM,Internally Displaced People,57536,86304,46872,57288,248000,58944,89088,48375,58821,255228
62,Syria,2018,SYR-18/DDA-3558/SA/H/UN/10672,12/13/2020 8:05:07 AM,Overall,57536,86304,46872,57288,248000,58944,89088,48375,58821,255228
62,Syria,2018,SYR-18/DDA-3558/SA/H/UN/10683,3/16/2020 2:42:52 PM,Host Communities,10410,30465,13439,16661,70975,23648,65758,18866,20146,128418
62,Syria,2018,SYR-18/DDA-3558/SA/H/UN/10683,3/16/2020 2:42:52 PM,Internally Displaced People,5204,15232,6719,8330,35485,3183,7004,2669,2323,15179
62,Syria,2018,SYR-18/DDA-3558/SA/H/UN/10683,3/16/2020 2:42:52 PM,Overall,15614,45697,20158,24991,106460,26831,72762,21535,22469,143597
62,Syria,2018,SYR-18/DDA-3558/SA/P/INGO/10636,1/13/2020 10:33:36 AM,Host Communities,310,310,400,400,1420,498,561,688,630,2377
62,Syria,2018,SYR-18/DDA-3558/SA/P/INGO/10636,1/13/2020 10:33:36 AM,Internally Displaced People,310,310,400,400,1420,142,125,299,231,797
62,Syria,2018,SYR-18/DDA-3558/SA/P/INGO/10636,1/13/2020 10:33:36 AM,Overall,620,620,800,800,2840,640,686,987,861,3174
62,Syria,2018,SYR-18/DDA-3558/SA/P/NGO/10504,12/29/2020 9:38:37 AM,Host Communities,0,75,75,150,300,0,195,269,339,803
62,Syria,2018,SYR-18/DDA-3558/SA/P/NGO/10504,12/29/2020 9:38:37 AM,Internally Displaced People,0,75,75,150,300,0,30,100,111,241
62,Syria,2018,SYR-18/DDA-3558/SA/P/NGO/10504,12/29/2020 9:38:37 AM,Other,0,75,75,150,300,0,0,0,0,0
62,Syria,2018,SYR-18/DDA-3558/SA/P/NGO/10504,12/29/2020 9:38:37 AM,Overall,0,225,250,450,925,0,225,369,450,1044
62,Syria,2018,SYR-18/DDA-3558/SA/P/UN/10618,5/4/2020 1:19:40 PM,Overall,1424,12500,2596,7080,23600,139,20856,110,3614,24719
62,Syria,2018,SYR-18/DDA-3558/SA/S/NFI/INGO/10519,9/7/2020 8:20:08 AM,Other,262,262,228,218,970,255,270,220,225,970
62,Syria,2018,SYR-18/DDA-3558/SA/S/NFI/INGO/10519,9/7/2020 8:20:08 AM,Overall,262,262,228,218,970,255,270,220,225,970
62,Syria,2018,SYR-18/DDA-3558/SA/S/NFI/INGO/10625,1/23/2020 3:10:03 PM,Overall,345,360,307,318,1330,424,518,416,495,1853
62,Syria,2018,SYR-18/DDA-3558/SA/S/NFI/INGO/10681,7/1/2019 9:36:51 AM,Host Communities,570,719,545,645,2479,283,247,398,372,1300
62,Syria,2018,SYR-18/DDA-3558/SA/S/NFI/INGO/10681,7/1/2019 9:36:51 AM,Internally Displaced People,570,719,545,645,2479,2908,2634,3926,3708,13176
62,Syria,2018,SYR-18/DDA-3558/SA/S/NFI/INGO/10681,7/1/2019 9:36:51 AM,Overall,11402,14377,10906,12890,49575,21390,19206,29280,27261,97137
62,Syria,2018,SYR-18/DDA-3558/SA/S/NFI/INGO/10681,7/1/2019 9:36:51 AM,Returnees,10262,12939,9816,11600,44617,18199,16325,24956,23181,82661
62,Syria,2018,SYR-18/DDA-3558/SA/S/NFI/NGO/10530,6/12/2019 7:30:51 AM,Host Communities,700,700,1050,1050,3500,925,925,1388,1388,4626
62,Syria,2018,SYR-18/DDA-3558/SA/S/NFI/NGO/10530,6/12/2019 7:30:51 AM,Internally Displaced People,3000,3000,4500,4500,15000,2775,2775,4162,4162,13874
62,Syria,2018,SYR-18/DDA-3558/SA/S/NFI/NGO/10530,6/12/2019 7:30:51 AM,Overall,3700,3700,5550,5550,18500,3700,3700,5550,5550,18500
62,Syria,2018,SYR-18/DDA-3558/SA/S/NFI/NGO/10542,6/2/2021 12:59:11 PM,Host Communities,729,795,136,127,1787,9521,9412,4088,4226,27247
62,Syria,2018,SYR-18/DDA-3558/SA/S/NFI/NGO/10542,6/2/2021 12:59:11 PM,Other,16457,17352,7799,7661,49269,0,0,0,0,0
62,Syria,2018,SYR-18/DDA-3558/SA/S/NFI/NGO/10542,6/2/2021 12:59:11 PM,Overall,17186,18147,7935,7788,51056,9521,9412,4088,4226,27247
62,Syria,2018,SYR-18/DDA-3558/SA/S/NFI/UN/10511,3/9/2021 8:04:51 AM,Other,2900,3400,2000,1700,10000,2900,3400,2000,1700,10000
62,Syria,2018,SYR-18/DDA-3558/SA/S/NFI/UN/10511,3/9/2021 8:04:51 AM,Overall,2900,3400,2000,1700,10000,2900,3400,2000,1700,10000
62,Syria,2018,SYR-18/DDA-3558/SA/S/NFI/UN/10517,12/19/2019 1:39:35 PM,Overall,13652,16074,9781,9494,49001,13629,16050,9757,9472,48908
62,Syria,2018,SYR-18/DDA-3558/SA/S/NFI/UN/10517,12/19/2019 1:39:35 PM,Refugees,13652,16074,9781,9494,49001,13629,16050,9757,9472,48908
62,Syria,2018,SYR-18/DDA-3558/SA/WASH/INGO/10501,12/31/2019 5:24:51 PM,Host Communities,1388,1918,1587,1719,6612,1502,2075,1716,1860,7153
62,Syria,2018,SYR-18/DDA-3558/SA/WASH/INGO/10501,12/31/2019 5:24:51 PM,Internally Displaced People,530,732,606,656,2524,592,816,676,732,2816
62,Syria,2018,SYR-18/DDA-3558/SA/WASH/INGO/10501,12/31/2019 5:24:51 PM,Other,1809,2498,2067,2240,8614,1942,2683,2221,2405,9251
62,Syria,2018,SYR-18/DDA-3558/SA/WASH/INGO/10501,12/31/2019 5:24:51 PM,Overall,3727,5148,4260,4615,17750,4036,5574,4613,4997,19220
62,Syria,2018,SYR-18/DDA-3558/SA/WASH/INGO/10513,4/29/2020 10:12:29 AM,Host Communities,22652,22652,17798,17798,80900,33488,33488,26312,26312,119600
62,Syria,2018,SYR-18/DDA-3558/SA/WASH/INGO/10513,4/29/2020 10:12:29 AM,Internally Displaced People,9492,9492,7458,7458,33900,168,168,132,132,600
62,Syria,2018,SYR-18/DDA-3558/SA/WASH/INGO/10513,4/29/2020 10:12:29 AM,Overall,32144,32144,25256,25256,114800,33656,33656,26444,26444,120200
62,Syria,2018,SYR-18/DDA-3558/SA/WASH/INGO/10514,9/2/2019 8:01:07 AM,Other,12600,14150,12875,12875,52500,12600,14150,12875,12875,52500
62,Syria,2018,SYR-18/DDA-3558/SA/WASH/INGO/10514,9/2/2019 8:01:07 AM,Overall,12600,14150,12875,12875,52500,12600,14150,12875,12875,52500
62,Syria,2018,SYR-18/DDA-3558/SA/WASH/INGO/10621,3/3/2020 7:54:47 AM,Host Communities,5064,7729,6396,6396,25585,6310,9464,7887,7887,31548
62,Syria,2018,SYR-18/DDA-3558/SA/WASH/INGO/10621,3/3/2020 7:54:47 AM,Other,21094,31981,26533,26533,106141,23940,26288,29239,26490,105957
62,Syria,2018,SYR-18/DDA-3558/SA/WASH/INGO/10621,3/3/2020 7:54:47 AM,Overall,26158,39710,32929,32929,131726,30250,35752,37126,34377,137505
62,Syria,2018,SYR-18/DDA-3558/SA/WASH/INGO/10642,12/31/2019 1:17:28 PM,Host Communities,18123,20712,12298,13592,64725,23038,26343,15644,17274,82299
62,Syria,2018,SYR-18/DDA-3558/SA/WASH/INGO/10642,12/31/2019 1:17:28 PM,Internally Displaced People,2814,3009,1844,2038,9705,3005,3211,1864,2279,10359
62,Syria,2018,SYR-18/DDA-3558/SA/WASH/INGO/10642,12/31/2019 1:17:28 PM,Overall,20937,23721,14142,15630,74430,26043,29554,17508,19553,92658
62,Syria,2018,SYR-18/DDA-3558/SA/WASH/INGO/10654,5/3/2020 1:42:38 PM,Host Communities,1960,2940,2940,4410,12250,14505,12404,9275,8734,44918
62,Syria,2018,SYR-18/DDA-3558/SA/WASH/INGO/10654,5/3/2020 1:42:38 PM,Internally Displaced People,5488,8232,8232,12348,34300,5991,7267,6665,7409,27332
62,Syria,2018,SYR-18/DDA-3558/SA/WASH/INGO/10654,5/3/2020 1:42:38 PM,Other,392,588,588,258,1826,5856,5010,3747,3529,18142
62,Syria,2018,SYR-18/DDA-3558/SA/WASH/INGO/10654,5/3/2020 1:42:38 PM,Overall,7840,11760,11760,17640,49000,26352,24681,19687,19672,90392
62,Syria,2018,SYR-18/DDA-3558/SA/WASH/UN/10637,7/17/2019 8:23:42 AM,Host Communities,3375,4125,3750,3750,15000,7425,9075,8250,8250,33000
62,Syria,2018,SYR-18/DDA-3558/SA/WASH/UN/10637,7/17/2019 8:23:42 AM,Internally Displaced People,5850,7150,6500,6500,26000,1800,2200,2000,2000,8000
62,Syria,2018,SYR-18/DDA-3558/SA/WASH/UN/10637,7/17/2019 8:23:42 AM,Overall,9225,11275,10250,10250,41000,9225,11275,10250,10250,41000
62,Syria,2019,SYR-19/DDA-3558/2017 SA2/FSA/NGO/13234,12/2/2020 9:16:48 AM,Internally Displaced People,5500,6800,4800,5427,22527,5500,6800,4800,5427,22527
62,Syria,2019,SYR-19/DDA-3558/2017 SA2/FSA/NGO/13234,12/2/2020 9:16:48 AM,Overall,5500,6800,4800,5427,22527,5500,6800,4800,5427,22527
62,Syria,2019,SYR-19/DDA-3558/2017 SA2/FSA/NGO/13235,12/21/2020 8:48:14 AM,Internally Displaced People,6200,9000,5000,7800,28000,4785,6960,3915,6090,21750
62,Syria,2019,SYR-19/DDA-3558/2017 SA2/FSA/NGO/13235,12/21/2020 8:48:14 AM,Overall,6200,9000,5000,7800,28000,4785,6960,3915,6090,21750
62,Syria,2019,SYR-19/DDA-3558/2018 SA1/E/NGO/13246,7/16/2020 8:31:35 AM,Host Communities,0,0,735,765,1500,0,0,735,765,1500
62,Syria,2019,SYR-19/DDA-3558/2018 SA1/E/NGO/13246,7/16/2020 8:31:35 AM,Internally Displaced People,0,0,1715,1785,3500,0,0,1715,1785,3500
62,Syria,2019,SYR-19/DDA-3558/2018 SA1/E/NGO/13246,7/16/2020 8:31:35 AM,Overall,0,0,2450,2550,5000,0,0,2450,2550,5000
62,Syria,2019,SYR-19/DDA-3558/2018 SA1/E/NGO/13248,2/3/2021 12:25:49 PM,Host Communities,23,60,1352,1648,3083,35,60,1648,1570,3313
62,Syria,2019,SYR-19/DDA-3558/2018 SA1/E/NGO/13248,2/3/2021 12:25:49 PM,Internally Displaced People,0,0,240,290,530,0,0,0,290,290
62,Syria,2019,SYR-19/DDA-3558/2018 SA1/E/NGO/13248,2/3/2021 12:25:49 PM,Overall,23,60,1592,1938,3613,35,60,1648,1860,3603
62,Syria,2019,SYR-19/DDA-3558/2018 SA1/E/NGO/13286,11/9/2020 3:29:41 PM,Overall,0,0,300,350,650,0,0,243,407,650
62,Syria,2019,SYR-19/DDA-3558/2018 SA1/E/NGO/13286,11/9/2020 3:29:41 PM,Returnees,0,0,300,350,650,0,0,243,407,650
62,Syria,2019,SYR-19/DDA-3558/2018 SA1/H/NGO/13250,7/13/2020 7:05:05 AM,Overall,2654,6920,3078,3348,16000,1795,7606,3411,3910,16722
62,Syria,2019,SYR-19/DDA-3558/2018 SA1/H/NGO/13250,7/13/2020 7:05:05 AM,Returnees,2654,6920,3078,3348,16000,1795,7606,3411,3910,16722
62,Syria,2019,SYR-19/DDA-3558/2018 SA1/H/NGO/13297,5/5/2020 10:17:04 AM,Host Communities,55,107,75,75,312,115,208,59,31,413
62,Syria,2019,SYR-19/DDA-3558/2018 SA1/H/NGO/13297,5/5/2020 10:17:04 AM,Internally Displaced People,55,107,75,75,312,0,0,0,0,0
62,Syria,2019,SYR-19/DDA-3558/2018 SA1/H/NGO/13297,5/5/2020 10:17:04 AM,Overall,183,357,250,250,1040,303,539,154,89,1085
62,Syria,2019,SYR-19/DDA-3558/2018 SA1/H/NGO/13297,5/5/2020 10:17:04 AM,Returnees,73,143,100,100,416,188,331,95,58,672
62,Syria,2019,SYR-19/DDA-3558/2018 SA1/H/NGO/13335,10/25/2020 10:46:45 AM,Host Communities,3188,6130,1471,1471,12260,3338,8072,1538,1395,14343
62,Syria,2019,SYR-19/DDA-3558/2018 SA1/H/NGO/13335,10/25/2020 10:46:45 AM,Internally Displaced People,796,1533,368,368,3065,1315,2827,1465,1261,6868
62,Syria,2019,SYR-19/DDA-3558/2018 SA1/H/NGO/13335,10/25/2020 10:46:45 AM,Overall,3984,7663,1839,1839,15325,4653,10899,3003,2656,21211
62,Syria,2019,SYR-19/DDA-3558/2018 SA1/S/NFI/NGO/13237,1/14/2020 11:56:11 AM,Host Communities,0,0,2190,2731,4921,0,0,2190,2731,4921
62,Syria,2019,SYR-19/DDA-3558/2018 SA1/S/NFI/NGO/13237,1/14/2020 11:56:11 AM,Internally Displaced People,0,0,942,1169,2111,0,0,942,1169,2111
62,Syria,2019,SYR-19/DDA-3558/2018 SA1/S/NFI/NGO/13237,1/14/2020 11:56:11 AM,Overall,0,0,3132,3900,7032,0,0,3132,3900,7032
62,Syria,2019,SYR-19/DDA-3558/2018 SA1/WASH/NGO/13243,3/29/2020 3:06:57 PM,Host Communities,9850,14320,10046,10780,44996,12202,17830,12550,13240,55822
62,Syria,2019,SYR-19/DDA-3558/2018 SA1/WASH/NGO/13243,3/29/2020 3:06:57 PM,Internally Displaced People,2100,3060,2040,2120,9320,2502,3705,2550,2450,11207
62,Syria,2019,SYR-19/DDA-3558/2018 SA1/WASH/NGO/13243,3/29/2020 3:06:57 PM,Overall,11950,17380,12086,12900,54316,14704,21535,15100,15690,67029
62,Syria,2019,SYR-19/DDA-3558/RA/H/UN/14169,10/20/2020 7:33:51 AM,Other,774,1200,710,714,3398,628,2001,411,429,3469
62,Syria,2019,SYR-19/DDA-3558/RA/H/UN/14169,10/20/2020 7:33:51 AM,Overall,774,1200,710,714,3398,628,2001,411,429,3469
62,Syria,2019,SYR-19/DDA-3558/RA/WASH/UN/13134,1/29/2020 2:32:00 PM,Host Communities,127943,148326,109178,103158,488605,127943,148326,109178,103158,488605
62,Syria,2019,SYR-19/DDA-3558/RA/WASH/UN/13134,1/29/2020 2:32:00 PM,Internally Displaced People,56406,66779,43850,40158,207193,56406,66779,43850,40158,207193
62,Syria,2019,SYR-19/DDA-3558/RA/WASH/UN/13134,1/29/2020 2:32:00 PM,Overall,187021,217904,154870,145340,705135,187021,217904,154870,145340,705135
62,Syria,2019,SYR-19/DDA-3558/RA/WASH/UN/13134,1/29/2020 2:32:00 PM,Returnees,2672,2799,1842,2024,9337,2672,2799,1842,2024,9337
62,Syria,2019,SYR-19/DDA-3558/RA1/H/UN/11971,1/15/2020 2:38:55 PM,Internally Displaced People,7391,12619,14483,14784,49277,5658,23060,9160,10533,48411
62,Syria,2019,SYR-19/DDA-3558/RA1/H/UN/11971,1/15/2020 2:38:55 PM,Overall,7391,12619,14483,14784,49277,5658,23060,9160,10533,48411
62,Syria,2019,SYR-19/DDA-3558/RA1/N-H/UN/12032,12/18/2019 10:59:57 AM,Internally Displaced People,0,15000,17500,17500,50000,0,12594,14586,14912,42092
62,Syria,2019,SYR-19/DDA-3558/RA1/N-H/UN/12032,12/18/2019 10:59:57 AM,Overall,0,15000,17500,17500,50000,0,12594,14586,14912,42092
62,Syria,2019,SYR-19/DDA-3558/RA1/P/UN/12039,1/12/2020 6:44:22 AM,Internally Displaced People,600,8000,250,1400,10250,5,10354,1174,3923,15456
62,Syria,2019,SYR-19/DDA-3558/RA1/P/UN/12039,1/12/2020 6:44:22 AM,Other,100,500,50,100,750,0,779,88,295,1162
62,Syria,2019,SYR-19/DDA-3558/RA1/P/UN/12039,1/12/2020 6:44:22 AM,Overall,700,8500,300,1500,11000,5,11133,1262,4218,16618
62,Syria,2019,SYR-19/DDA-3558/RA1/P-WASH/NGO/12216,10/14/2019 1:35:35 PM,Internally Displaced People,1550,12900,5250,8434,28134,1550,12900,5250,8434,28134
62,Syria,2019,SYR-19/DDA-3558/RA1/P-WASH/NGO/12216,10/14/2019 1:35:35 PM,Overall,1550,12900,5250,8434,28134,1550,12900,5250,8434,28134
62,Syria,2019,SYR-19/DDA-3558/RA1/S/NFI/INGO/12205,7/1/2019 1:11:24 PM,Internally Displaced People,1610,1965,1460,1465,6500,0,0,0,0,0
62,Syria,2019,SYR-19/DDA-3558/RA1/S/NFI/INGO/12205,7/1/2019 1:11:24 PM,Overall,2535,2965,2250,2250,10000,0,0,0,0,0
62,Syria,2019,SYR-19/DDA-3558/RA1/S/NFI/INGO/12205,7/1/2019 1:11:24 PM,Refugees,925,1000,790,785,3500,0,0,0,0,0
62,Syria,2019,SYR-19/DDA-3558/RA1/S/NFI/UN/12040,12/31/2019 12:02:54 PM,Internally Displaced People,2775,3210,4210,3725,13920,2063,2370,3126,2655,10214
62,Syria,2019,SYR-19/DDA-3558/RA1/S/NFI/UN/12040,12/31/2019 12:02:54 PM,Overall,2775,3210,4210,3725,13920,2063,2370,3126,2655,10214
62,Syria,2019,SYR-19/DDA-3558/RA1/WASH/INGO/12204,7/22/2020 7:31:13 AM,Internally Displaced People,8800,13200,13200,19800,55000,1671,9619,13403,13307,38000
62,Syria,2019,SYR-19/DDA-3558/RA1/WASH/INGO/12204,7/22/2020 7:31:13 AM,Overall,8800,13200,13200,19800,55000,1671,9619,13403,13307,38000
62,Syria,2019,SYR-19/DDA-3558/RA2/E/NGO/12591,2/28/2021 6:50:07 AM,Host Communities,0,0,1350,1350,2700,0,0,1260,1260,2520
62,Syria,2019,SYR-19/DDA-3558/RA2/E/NGO/12591,2/28/2021 6:50:07 AM,Overall,0,0,2250,2250,4500,0,0,1800,1800,3600
62,Syria,2019,SYR-19/DDA-3558/RA2/E/NGO/12591,2/28/2021 6:50:07 AM,Returnees,0,0,900,900,1800,0,0,540,540,1080
62,Syria,2019,SYR-19/DDA-3558/RA2/H/NGO/12602,3/4/2020 7:46:44 AM,Host Communities,796,1479,2324,1901,6500,1454,3708,1429,1187,7778
62,Syria,2019,SYR-19/DDA-3558/RA2/H/NGO/12602,3/4/2020 7:46:44 AM,Internally Displaced People,429,796,1251,1024,3500,519,1106,355,345,2325
62,Syria,2019,SYR-19/DDA-3558/RA2/H/NGO/12602,3/4/2020 7:46:44 AM,Overall,1225,2275,3575,2925,10000,1973,4814,1784,1532,10103
62,Syria,2019,SYR-19/DDA-3558/RA2/H/UN/12585,7/15/2020 6:57:46 AM,Internally Displaced People,10888,18149,21777,21776,72590,10888,18149,21777,21776,72590
62,Syria,2019,SYR-19/DDA-3558/RA2/H/UN/12585,7/15/2020 6:57:46 AM,Overall,10888,18149,21777,21776,72590,10888,18149,21777,21776,72590
62,Syria,2019,SYR-19/DDA-3558/RA2/H/UN/12595,12/24/2019 12:01:33 PM,Internally Displaced People,350,9000,300,1500,11150,1337,12010,367,2205,15919
62,Syria,2019,SYR-19/DDA-3558/RA2/H/UN/12595,12/24/2019 12:01:33 PM,Other,50,1600,100,400,2150,650,2200,195,840,3885
62,Syria,2019,SYR-19/DDA-3558/RA2/H/UN/12595,12/24/2019 12:01:33 PM,Overall,400,10600,400,1900,13300,1987,14210,562,3045,19804
62,Syria,2019,SYR-19/DDA-3558/RA2/P/INGO/12594,2/15/2021 5:33:08 PM,Host Communities,2717,6084,3463,4140,16404,6377,7709,2690,3594,20370
62,Syria,2019,SYR-19/DDA-3558/RA2/P/INGO/12594,2/15/2021 5:33:08 PM,Internally Displaced People,1357,3041,1730,2068,8196,3576,4640,1580,2168,11964
62,Syria,2019,SYR-19/DDA-3558/RA2/P/INGO/12594,2/15/2021 5:33:08 PM,Overall,4074,9125,5193,6208,24600,9953,12349,4270,5762,32334
62,Syria,2019,SYR-19/DDA-3558/RA2/P/UN/12593,10/25/2020 10:56:53 AM,Host Communities,200,500,1000,1000,2700,1010,3204,9849,6973,21036
62,Syria,2019,SYR-19/DDA-3558/RA2/P/UN/12593,10/25/2020 10:56:53 AM,Internally Displaced People,1000,2000,7000,7000,17000,2019,6408,19700,13946,42073
62,Syria,2019,SYR-19/DDA-3558/RA2/P/UN/12593,10/25/2020 10:56:53 AM,Overall,1400,3000,8500,8500,21400,3366,10680,32832,23243,70121
62,Syria,2019,SYR-19/DDA-3558/RA2/P/UN/12593,10/25/2020 10:56:53 AM,Refugees,200,500,500,500,1700,337,1068,3283,2324,7012
62,Syria,2019,SYR-19/DDA-3558/RA2/P/UN/12598,1/11/2021 8:04:32 AM,Internally Displaced People,702,13615,1855,6328,22500,704,13713,1802,6650,22869
62,Syria,2019,SYR-19/DDA-3558/RA2/P/UN/12598,1/11/2021 8:04:32 AM,Overall,702,13615,1855,6328,22500,704,13713,1802,6650,22869
62,Syria,2019,SYR-19/DDA-3558/RA2/WASH/INGO/12597,1/23/2020 12:12:13 PM,Host Communities,540,720,564,576,2400,540,720,564,576,2400
62,Syria,2019,SYR-19/DDA-3558/RA2/WASH/INGO/12597,1/23/2020 12:12:13 PM,Overall,5400,7200,5640,5760,24000,5400,7200,5640,5760,24000
62,Syria,2019,SYR-19/DDA-3558/RA2/WASH/INGO/12597,1/23/2020 12:12:13 PM,Returnees,4860,6480,5076,5184,21600,4860,6480,5076,5184,21600
62,Syria,2019,SYR-19/DDA-3558/RA2/WASH/INGO/12603,12/26/2019 9:24:08 AM,Host Communities,44790,47880,29345,32435,154450,44790,47880,29345,32435,154450
62,Syria,2019,SYR-19/DDA-3558/RA2/WASH/INGO/12603,12/26/2019 9:24:08 AM,Internally Displaced People,819,1170,1930,1930,5849,752,1507,2924,3457,8640
62,Syria,2019,SYR-19/DDA-3558/RA2/WASH/INGO/12603,12/26/2019 9:24:08 AM,Overall,45609,49050,31275,34365,160299,45542,49387,32269,35892,163090
62,Syria,2019,SYR-19/DDA-3558/RA2/WASH/NGO/12587,3/23/2020 6:34:19 PM,Host Communities,6200,29400,8600,8600,52800,7840,31040,10240,10240,59360
62,Syria,2019,SYR-19/DDA-3558/RA2/WASH/NGO/12587,3/23/2020 6:34:19 PM,Overall,7750,36750,10750,10750,66000,9800,38800,12800,12800,74200
62,Syria,2019,SYR-19/DDA-3558/RA2/WASH/NGO/12587,3/23/2020 6:34:19 PM,Returnees,1550,7350,2150,2150,13200,1960,7760,2560,2560,14840
62,Syria,2019,SYR-19/DDA-3558/RA2/WASH/UN/12600,2/26/2020 1:30:45 PM,Internally Displaced People,3179,10970,10367,14799,39315,3179,10970,10367,14799,39315
62,Syria,2019,SYR-19/DDA-3558/RA2/WASH/UN/12600,2/26/2020 1:30:45 PM,Overall,6785,22480,21179,31054,81498,6785,22480,21179,31054,81498
62,Syria,2019,SYR-19/DDA-3558/RA2/WASH/UN/12600,2/26/2020 1:30:45 PM,Refugees,3606,11510,10812,16255,42183,3606,11510,10812,16255,42183
62,Syria,2019,SYR-19/DDA-3558/RA3/FSA/UN/14556,4/15/2021 6:51:35 AM,Host Communities,22807,24379,15728,15728,78642,22807,24379,15728,15728,78642
62,Syria,2019,SYR-19/DDA-3558/RA3/FSA/UN/14556,4/15/2021 6:51:35 AM,Overall,22807,24379,15728,15728,78642,22807,24379,15728,15728,78642
62,Syria,2019,SYR-19/DDA-3558/RA3/H/UN/14659,3/4/2021 7:22:24 AM,Other,600,2000,500,1000,4100,0,9967,197,317,10481
62,Syria,2019,SYR-19/DDA-3558/RA3/H/UN/14659,3/4/2021 7:22:24 AM,Overall,600,2000,500,1000,4100,0,9967,197,317,10481
62,Syria,2019,SYR-19/DDA-3558/RA3/H-WASH/UN/14799,4/11/2021 1:01:57 PM,Host Communities,15000,20000,76000,76000,187000,3369,10224,108079,108080,229752
62,Syria,2019,SYR-19/DDA-3558/RA3/H-WASH/UN/14799,4/11/2021 1:01:57 PM,Internally Displaced People,20000,28000,30000,30000,108000,4490,15105,24555,24554,68704
62,Syria,2019,SYR-19/DDA-3558/RA3/H-WASH/UN/14799,4/11/2021 1:01:57 PM,Overall,35000,48000,106000,106000,295000,7859,25329,132634,132634,298456
62,Syria,2019,SYR-19/DDA-3558/RA3/N/INGO/14703,3/15/2021 3:15:21 PM,Host Communities,7305,7603,6709,8199,29816,1060,9434,3003,3620,17117
62,Syria,2019,SYR-19/DDA-3558/RA3/N/INGO/14703,3/15/2021 3:15:21 PM,Internally Displaced People,9884,10287,9077,11094,40342,3179,28300,4590,4746,40815
62,Syria,2019,SYR-19/DDA-3558/RA3/N/INGO/14703,3/15/2021 3:15:21 PM,Overall,17189,17890,15786,19293,70158,4239,37734,7593,8366,57932
62,Syria,2019,SYR-19/DDA-3558/RA3/N/UN/14709,1/12/2021 3:57:52 PM,Internally Displaced People,0,13750,20375,20375,54500,0,13751,20033,20884,54668
62,Syria,2019,SYR-19/DDA-3558/RA3/N/UN/14709,1/12/2021 3:57:52 PM,Overall,0,13750,20375,20375,54500,0,13751,20033,20884,54668
62,Syria,2019,SYR-19/DDA-3558/RA3/P/INGO/14704,12/29/2020 2:23:29 PM,Host Communities,300,496,598,628,2022,878,1107,972,1202,4159
62,Syria,2019,SYR-19/DDA-3558/RA3/P/INGO/14704,12/29/2020 2:23:29 PM,Internally Displaced People,900,1488,1793,1884,6065,755,837,2773,2780,7145
62,Syria,2019,SYR-19/DDA-3558/RA3/P/INGO/14704,12/29/2020 2:23:29 PM,Overall,1200,1984,2391,2512,8087,1633,1944,3745,3982,11304
62,Syria,2019,SYR-19/DDA-3558/RA3/P/UN/14625,3/28/2021 2:20:45 PM,Host Communities,419,662,122,284,1487,585,940,101,249,1875
62,Syria,2019,SYR-19/DDA-3558/RA3/P/UN/14625,3/28/2021 2:20:45 PM,Internally Displaced People,418,661,121,283,1483,272,683,99,190,1244
62,Syria,2019,SYR-19/DDA-3558/RA3/P/UN/14625,3/28/2021 2:20:45 PM,Overall,837,1323,243,567,2970,857,1623,200,439,3119
62,Syria,2019,SYR-19/DDA-3558/RA3/P/UN/14682,12/19/2022 7:22:55 AM,Host Communities,12,0,0,0,12,1,0,0,0,1
62,Syria,2019,SYR-19/DDA-3558/RA3/P/UN/14682,12/19/2022 7:22:55 AM,Overall,12,0,0,0,12,1,0,0,0,1
62,Syria,2019,SYR-19/DDA-3558/RA3/S/NFI/INGO/14641,3/3/2021 2:20:24 PM,Host Communities,443,547,924,1056,2970,792,1188,317,343,2640
62,Syria,2019,SYR-19/DDA-3558/RA3/S/NFI/INGO/14641,3/3/2021 2:20:24 PM,Internally Displaced People,443,547,924,1056,2970,791,1187,317,343,2638
62,Syria,2019,SYR-19/DDA-3558/RA3/S/NFI/INGO/14641,3/3/2021 2:20:24 PM,Overall,6199,8177,12474,14510,41360,7336,9749,9859,9644,36588
62,Syria,2019,SYR-19/DDA-3558/RA3/S/NFI/INGO/14641,3/3/2021 2:20:24 PM,Returnees,5313,7083,10626,12398,35420,5753,7374,9225,8958,31310
62,Syria,2019,SYR-19/DDA-3558/RA3/S/NFI/NGO/14567,3/9/2021 2:37:12 PM,Internally Displaced People,8000,8000,12000,12000,40000,8822,8822,13233,13233,44110
62,Syria,2019,SYR-19/DDA-3558/RA3/S/NFI/NGO/14567,3/9/2021 2:37:12 PM,Overall,8000,8000,12000,12000,40000,8822,8822,13233,13233,44110
62,Syria,2019,SYR-19/DDA-3558/RA3/S/NFI/NGO/14629,9/3/2020 10:00:39 AM,Internally Displaced People,2350,5630,4520,2500,15000,6494,7166,5803,5389,24852
62,Syria,2019,SYR-19/DDA-3558/RA3/S/NFI/NGO/14629,9/3/2020 10:00:39 AM,Overall,2350,5630,4520,2500,15000,6494,7166,5803,5389,24852
62,Syria,2019,SYR-19/DDA-3558/RA3/S/NFI/NGO/14652,10/20/2020 7:45:27 AM,Internally Displaced People,1500,1800,4860,7290,15450,1500,1800,4860,7290,15450
62,Syria,2019,SYR-19/DDA-3558/RA3/S/NFI/NGO/14652,10/20/2020 7:45:27 AM,Overall,1500,1800,4860,7290,15450,1500,1800,4860,7290,15450
62,Syria,2019,SYR-19/DDA-3558/RA3/WASH/INGO/14561,2/16/2021 12:20:56 PM,Internally Displaced People,5789,8608,10211,12478,37086,2822,3556,2006,2095,10479
62,Syria,2019,SYR-19/DDA-3558/RA3/WASH/INGO/14561,2/16/2021 12:20:56 PM,Overall,5789,8608,10211,12478,37086,2822,3556,2006,2095,10479
62,Syria,2019,SYR-19/DDA-3558/RA3/WASH/INGO/14590,1/7/2021 1:00:24 PM,Host Communities,9000,11000,2000,3000,25000,9000,11000,2000,3000,25000
62,Syria,2019,SYR-19/DDA-3558/RA3/WASH/INGO/14590,1/7/2021 1:00:24 PM,Internally Displaced People,9000,11000,2000,3000,25000,9000,11000,2000,3000,25000
62,Syria,2019,SYR-19/DDA-3558/RA3/WASH/INGO/14590,1/7/2021 1:00:24 PM,Overall,18000,22000,4000,6000,50000,18000,22000,4000,6000,50000
62,Syria,2019,SYR-19/DDA-3558/RA3/WASH/INGO/14644,11/29/2020 9:30:43 PM,Host Communities,32234,34457,21119,23341,111151,53171,62303,44737,43082,203293
62,Syria,2019,SYR-19/DDA-3558/RA3/WASH/INGO/14644,11/29/2020 9:30:43 PM,Internally Displaced People,4213,4503,2760,3050,14526,26689,32451,22980,19147,101267
62,Syria,2019,SYR-19/DDA-3558/RA3/WASH/INGO/14644,11/29/2020 9:30:43 PM,Overall,36447,38960,23879,26391,125677,79860,94754,67717,62229,304560
62,Syria,2019,SYR-19/DDA-3558/RA3/WASH/NGO/14594,4/6/2021 11:35:06 AM,Internally Displaced People,5000,7500,6250,6250,25000,5000,7500,12509,13881,38890
62,Syria,2019,SYR-19/DDA-3558/RA3/WASH/NGO/14594,4/6/2021 11:35:06 AM,Overall,5000,7500,6250,6250,25000,5000,7500,12509,13881,38890
62,Syria,2019,SYR-19/DDA-3558/RA3/WASH/UN/14557,2/8/2021 11:10:27 AM,Host Communities,18898,21709,36935,30198,107740,18898,21709,36935,30198,107740
62,Syria,2019,SYR-19/DDA-3558/RA3/WASH/UN/14557,2/8/2021 11:10:27 AM,Internally Displaced People,22489,25017,44255,32604,124365,22489,25017,44255,32604,124365
62,Syria,2019,SYR-19/DDA-3558/RA3/WASH/UN/14557,2/8/2021 11:10:27 AM,Overall,41387,46726,81190,62802,232105,41387,46726,81190,62802,232105
62,Syria,2019,SYR-19/DDA-3558/RA3/WASH/UN/14683,4/25/2021 5:09:03 PM,Host Communities,92845,94141,128649,102540,418175,92845,94141,128649,102540,418175
62,Syria,2019,SYR-19/DDA-3558/RA3/WASH/UN/14683,4/25/2021 5:09:03 PM,Internally Displaced People,35180,36237,53771,41587,166775,35180,36237,53771,41587,166775
62,Syria,2019,SYR-19/DDA-3558/RA3/WASH/UN/14683,4/25/2021 5:09:03 PM,Overall,128025,130378,182420,144127,584950,128025,130378,182420,144127,584950
62,Syria,2019,SYR-19/DDA-3558/SA1/E/INGO/13924,8/16/2021 10:10:12 AM,Internally Displaced People,0,0,28,18,46,0,0,28,18,46
62,Syria,2019,SYR-19/DDA-3558/SA1/E/INGO/13924,8/16/2021 10:10:12 AM,Other,6,49,0,0,55,6,49,0,0,55
62,Syria,2019,SYR-19/DDA-3558/SA1/E/INGO/13924,8/16/2021 10:10:12 AM,Overall,62,116,480,472,1130,66,124,480,472,1142
62,Syria,2019,SYR-19/DDA-3558/SA1/E/INGO/13924,8/16/2021 10:10:12 AM,Returnees,56,67,452,454,1029,60,75,452,454,1041
62,Syria,2019,SYR-19/DDA-3558/SA1/E/INGO/13935,1/10/2022 8:26:19 AM,Host Communities,15,57,937,1397,2406,0,0,0,0,0
62,Syria,2019,SYR-19/DDA-3558/SA1/E/INGO/13935,1/10/2022 8:26:19 AM,Internally Displaced People,2,10,127,191,330,0,0,0,0,0
62,Syria,2019,SYR-19/DDA-3558/SA1/E/INGO/13935,1/10/2022 8:26:19 AM,Overall,20,80,1172,1748,3020,0,0,0,0,0
62,Syria,2019,SYR-19/DDA-3558/SA1/E/INGO/13935,1/10/2022 8:26:19 AM,Returnees,3,13,108,160,284,0,0,0,0,0
62,Syria,2019,SYR-19/DDA-3558/SA1/E/INGO/13941,3/9/2021 11:44:01 AM,Host Communities,5,21,572,599,1197,3,11,479,497,990
62,Syria,2019,SYR-19/DDA-3558/SA1/E/INGO/13941,3/9/2021 11:44:01 AM,Internally Displaced People,1,2,34,37,74,0,0,11,10,21
62,Syria,2019,SYR-19/DDA-3558/SA1/E/INGO/13941,3/9/2021 11:44:01 AM,Overall,15,65,1716,1800,3596,23,67,1040,1128,2258
62,Syria,2019,SYR-19/DDA-3558/SA1/E/INGO/13941,3/9/2021 11:44:01 AM,Returnees,9,42,1110,1164,2325,20,56,550,621,1247
62,Syria,2019,SYR-19/DDA-3558/SA1/E/INGO/13946,3/15/2021 1:13:27 PM,Host Communities,29,35,560,580,1204,10,28,492,490,1020
62,Syria,2019,SYR-19/DDA-3558/SA1/E/INGO/13946,3/15/2021 1:13:27 PM,Overall,29,35,670,690,1424,20,53,855,851,1779
62,Syria,2019,SYR-19/DDA-3558/SA1/E/INGO/13946,3/15/2021 1:13:27 PM,Returnees,0,0,110,110,220,10,25,363,361,759
62,Syria,2019,SYR-19/DDA-3558/SA1/E/INGO/14018,3/11/2021 7:58:25 AM,Host Communities,49,49,528,551,1177,8,37,983,869,1897
62,Syria,2019,SYR-19/DDA-3558/SA1/E/INGO/14018,3/11/2021 7:58:25 AM,Internally Displaced People,3,3,528,551,1085,12,54,174,88,328
62,Syria,2019,SYR-19/DDA-3558/SA1/E/INGO/14018,3/11/2021 7:58:25 AM,Overall,131,128,2637,2754,5650,39,208,2229,2181,4657
62,Syria,2019,SYR-19/DDA-3558/SA1/E/INGO/14018,3/11/2021 7:58:25 AM,Returnees,79,76,1581,1652,3388,19,117,1072,1224,2432
62,Syria,2019,SYR-19/DDA-3558/SA1/E/NGO/13917,6/3/2021 6:48:35 AM,Host Communities,0,0,360,360,720,0,0,360,360,720
62,Syria,2019,SYR-19/DDA-3558/SA1/E/NGO/13917,6/3/2021 6:48:35 AM,Overall,0,0,1200,1200,2400,0,0,1200,1200,2400
62,Syria,2019,SYR-19/DDA-3558/SA1/E/NGO/13917,6/3/2021 6:48:35 AM,Returnees,0,0,840,840,1680,0,0,840,840,1680
62,Syria,2019,SYR-19/DDA-3558/SA1/E/NGO/14079,8/4/2021 7:42:36 AM,Host Communities,445,435,385,385,1650,316,855,288,444,1903
62,Syria,2019,SYR-19/DDA-3558/SA1/E/NGO/14079,8/4/2021 7:42:36 AM,Other,127,208,277,268,880,116,367,130,125,738
62,Syria,2019,SYR-19/DDA-3558/SA1/E/NGO/14079,8/4/2021 7:42:36 AM,Overall,1032,1098,1157,1138,4425,516,1641,1116,1719,4992
62,Syria,2019,SYR-19/DDA-3558/SA1/E/NGO/14079,8/4/2021 7:42:36 AM,Returnees,460,455,495,485,1895,84,419,698,1150,2351
62,Syria,2019,SYR-19/DDA-3558/SA1/E/NGO/14090,4/12/2021 12:57:00 PM,Host Communities,7,8,1125,1200,2340,7,8,1215,1266,2496
62,Syria,2019,SYR-19/DDA-3558/SA1/E/NGO/14090,4/12/2021 12:57:00 PM,Internally Displaced People,4,5,500,625,1134,4,5,594,723,1326
62,Syria,2019,SYR-19/DDA-3558/SA1/E/NGO/14090,4/12/2021 12:57:00 PM,Overall,30,50,4750,5050,9880,30,50,5037,5286,10403
62,Syria,2019,SYR-19/DDA-3558/SA1/E/NGO/14090,4/12/2021 12:57:00 PM,Returnees,19,37,3125,3225,6406,19,37,3228,3297,6581
62,Syria,2019,SYR-19/DDA-3558/SA1/E/UN/14044,6/20/2021 7:01:47 AM,Host Communities,422,438,14000,16000,30860,422,438,480052,460813,941725
62,Syria,2019,SYR-19/DDA-3558/SA1/E/UN/14044,6/20/2021 7:01:47 AM,Internally Displaced People,0,0,10420,10640,21060,0,0,0,0,0
62,Syria,2019,SYR-19/DDA-3558/SA1/E/UN/14044,6/20/2021 7:01:47 AM,Overall,422,438,24420,26640,51920,422,438,480052,460813,941725
62,Syria,2019,SYR-19/DDA-3558/SA1/FSA/INGO/13957,4/27/2021 8:38:23 AM,Host Communities,1694,2430,377,508,5009,18,20,17,22,77
62,Syria,2019,SYR-19/DDA-3558/SA1/FSA/INGO/13957,4/27/2021 8:38:23 AM,Overall,3151,5500,1075,1700,11426,2769,3054,2624,2736,11183
62,Syria,2019,SYR-19/DDA-3558/SA1/FSA/INGO/13957,4/27/2021 8:38:23 AM,Returnees,1457,3070,698,1192,6417,2751,3034,2607,2714,11106
62,Syria,2019,SYR-19/DDA-3558/SA1/FSA/INGO/14116,9/21/2021 9:09:54 AM,Host Communities,1363,1658,104,104,3229,1505,1655,205,205,3570
62,Syria,2019,SYR-19/DDA-3558/SA1/FSA/INGO/14116,9/21/2021 9:09:54 AM,Internally Displaced People,98,474,15,15,602,165,280,60,65,570
62,Syria,2019,SYR-19/DDA-3558/SA1/FSA/INGO/14116,9/21/2021 9:09:54 AM,Overall,2017,2882,188,188,5275,2410,2690,385,390,5875
62,Syria,2019,SYR-19/DDA-3558/SA1/FSA/INGO/14116,9/21/2021 9:09:54 AM,Returnees,556,750,69,69,1444,740,755,120,120,1735
62,Syria,2019,SYR-19/DDA-3558/SA1/FSA/UN/13933,6/3/2021 6:29:06 AM,Host Communities,37375,39959,25776,25776,128886,37375,39959,25776,25776,128886
62,Syria,2019,SYR-19/DDA-3558/SA1/FSA/UN/13933,6/3/2021 6:29:06 AM,Internally Displaced People,18688,19976,12885,12885,64434,18688,19976,12885,12885,64434
62,Syria,2019,SYR-19/DDA-3558/SA1/FSA/UN/13933,6/3/2021 6:29:06 AM,Overall,93438,99888,64437,64437,322200,93438,99888,64437,64437,322200
62,Syria,2019,SYR-19/DDA-3558/SA1/FSA/UN/13933,6/3/2021 6:29:06 AM,Returnees,37375,39953,25776,25776,128880,37375,39953,25776,25776,128880
62,Syria,2019,SYR-19/DDA-3558/SA1/H/INGO/14001,7/26/2021 9:25:23 AM,Host Communities,19000,41000,19000,21000,100000,19000,41000,19000,21000,100000
62,Syria,2019,SYR-19/DDA-3558/SA1/H/INGO/14001,7/26/2021 9:25:23 AM,Internally Displaced People,3800,8200,3800,4200,20000,3800,8200,3800,4200,20000
62,Syria,2019,SYR-19/DDA-3558/SA1/H/INGO/14001,7/26/2021 9:25:23 AM,Overall,38000,82000,38000,42000,200000,38000,82000,38000,42000,200000
62,Syria,2019,SYR-19/DDA-3558/SA1/H/INGO/14001,7/26/2021 9:25:23 AM,Returnees,15200,32800,15200,16800,80000,15200,32800,15200,16800,80000
62,Syria,2019,SYR-19/DDA-3558/SA1/H/NGO/13910,5/3/2021 7:15:17 AM,Host Communities,1234,4298,1614,1989,9135,1313,4400,1763,2070,9546
62,Syria,2019,SYR-19/DDA-3558/SA1/H/NGO/13910,5/3/2021 7:15:17 AM,Internally Displaced People,642,2824,798,1172,5436,765,2974,871,1238,5848
62,Syria,2019,SYR-19/DDA-3558/SA1/H/NGO/13910,5/3/2021 7:15:17 AM,Overall,3008,13486,4437,6085,27016,3284,13919,4715,6189,28107
62,Syria,2019,SYR-19/DDA-3558/SA1/H/NGO/13910,5/3/2021 7:15:17 AM,Returnees,1132,6364,2025,2924,12445,1206,6545,2081,2881,12713
62,Syria,2019,SYR-19/DDA-3558/SA1/H/NGO/13954,1/12/2021 7:06:37 AM,Host Communities,1064,1617,2540,2050,7271,2117,3783,1256,1302,8458
62,Syria,2019,SYR-19/DDA-3558/SA1/H/NGO/13954,1/12/2021 7:06:37 AM,Internally Displaced People,511,808,1310,1100,3729,873,1527,432,458,3290
62,Syria,2019,SYR-19/DDA-3558/SA1/H/NGO/13954,1/12/2021 7:06:37 AM,Overall,1575,2425,3850,3150,11000,2990,5310,1688,1760,11748
62,Syria,2019,SYR-19/DDA-3558/SA1/H/NGO/13977,3/23/2021 9:53:44 AM,Host Communities,424,567,190,205,1386,990,743,100,51,1884
62,Syria,2019,SYR-19/DDA-3558/SA1/H/NGO/13977,3/23/2021 9:53:44 AM,Internally Displaced People,50,100,30,40,220,485,1079,122,72,1758
62,Syria,2019,SYR-19/DDA-3558/SA1/H/NGO/13977,3/23/2021 9:53:44 AM,Overall,819,1007,405,400,2631,1561,1938,262,148,3909
62,Syria,2019,SYR-19/DDA-3558/SA1/H/NGO/13977,3/23/2021 9:53:44 AM,Returnees,345,340,185,155,1025,86,116,40,25,267
62,Syria,2019,SYR-19/DDA-3558/SA1/H/UN/13987,7/29/2021 6:43:46 AM,Other,1000,180000,3000,20000,204000,544,54625,204,1661,57034
62,Syria,2019,SYR-19/DDA-3558/SA1/H/UN/13987,7/29/2021 6:43:46 AM,Overall,1000,180000,3000,20000,204000,544,54625,204,1661,57034
62,Syria,2019,SYR-19/DDA-3558/SA1/H/UN/14081,3/9/2021 12:03:14 PM,Host Communities,21199,22655,7132,7228,58214,13527,21225,9054,9604,53410
62,Syria,2019,SYR-19/DDA-3558/SA1/H/UN/14081,3/9/2021 12:03:14 PM,Internally Displaced People,3540,3650,1205,1191,9586,4313,9042,4056,4664,22075
62,Syria,2019,SYR-19/DDA-3558/SA1/H/UN/14081,3/9/2021 12:03:14 PM,Overall,25156,26735,8479,8559,68929,20629,37063,15832,17757,91281
62,Syria,2019,SYR-19/DDA-3558/SA1/H/UN/14081,3/9/2021 12:03:14 PM,Returnees,417,430,142,140,1129,2789,6796,2722,3489,15796
62,Syria,2019,SYR-19/DDA-3558/SA1/H/UN/14086,8/19/2021 8:10:21 AM,Host Communities,103,9,7,0,119,98,12,6,0,116
62,Syria,2019,SYR-19/DDA-3558/SA1/H/UN/14086,8/19/2021 8:10:21 AM,Internally Displaced People,0,2,0,0,2,3,1,1,0,5
62,Syria,2019,SYR-19/DDA-3558/SA1/H/UN/14086,8/19/2021 8:10:21 AM,Overall,103,11,7,0,121,101,13,7,0,121
62,Syria,2019,SYR-19/DDA-3558/SA1/P/INGO/14024,3/2/2021 11:01:08 AM,Host Communities,32,261,159,161,613,0,0,0,0,0
62,Syria,2019,SYR-19/DDA-3558/SA1/P/INGO/14024,3/2/2021 11:01:08 AM,Internally Displaced People,33,261,161,163,618,0,0,0,0,0
62,Syria,2019,SYR-19/DDA-3558/SA1/P/INGO/14024,3/2/2021 11:01:08 AM,Overall,322,2612,1610,1629,6173,97,306,556,959,1918
62,Syria,2019,SYR-19/DDA-3558/SA1/P/INGO/14024,3/2/2021 11:01:08 AM,Returnees,257,2090,1290,1305,4942,97,306,556,959,1918
62,Syria,2019,SYR-19/DDA-3558/SA1/P/NGO/13945,5/9/2021 9:46:19 AM,Host Communities,75,300,100,300,775,144,1863,336,549,2892
62,Syria,2019,SYR-19/DDA-3558/SA1/P/NGO/13945,5/9/2021 9:46:19 AM,Internally Displaced People,150,700,175,500,1525,90,1164,210,342,1806
62,Syria,2019,SYR-19/DDA-3558/SA1/P/NGO/13945,5/9/2021 9:46:19 AM,Overall,425,1800,525,1300,4050,360,4656,839,1371,7226
62,Syria,2019,SYR-19/DDA-3558/SA1/P/NGO/13945,5/9/2021 9:46:19 AM,Returnees,200,800,250,500,1750,126,1629,293,480,2528
62,Syria,2019,SYR-19/DDA-3558/SA1/P/NGO/14107,4/1/2021 6:54:49 AM,Overall,4085,5695,5850,5850,21480,5813,7992,6678,6906,27389
62,Syria,2019,SYR-19/DDA-3558/SA1/P/NGO/14107,4/1/2021 6:54:49 AM,Returnees,4085,5695,5850,5850,21480,5813,7992,6678,6906,27389
62,Syria,2019,SYR-19/DDA-3558/SA1/P/UN/14005,4/26/2021 8:41:45 AM,Host Communities,2806,3028,3801,4100,13735,2634,2873,3271,3505,12283
62,Syria,2019,SYR-19/DDA-3558/SA1/P/UN/14005,4/26/2021 8:41:45 AM,Internally Displaced People,1275,1377,1729,1864,6245,1229,1338,1506,1610,5683
62,Syria,2019,SYR-19/DDA-3558/SA1/P/UN/14005,4/26/2021 8:41:45 AM,Overall,5101,5507,6912,7454,24974,6734,7413,7237,7612,28996
62,Syria,2019,SYR-19/DDA-3558/SA1/P/UN/14005,4/26/2021 8:41:45 AM,Returnees,1020,1102,1382,1490,4994,2871,3202,2460,2497,11030
62,Syria,2019,SYR-19/DDA-3558/SA1/P/UN/14083,9/8/2021 9:18:25 AM,Host Communities,136,10780,386,1424,12726,41,15438,471,915,16865
62,Syria,2019,SYR-19/DDA-3558/SA1/P/UN/14083,9/8/2021 9:18:25 AM,Internally Displaced People,410,22288,1156,4288,28142,25,9310,283,550,10168
62,Syria,2019,SYR-19/DDA-3558/SA1/P/UN/14083,9/8/2021 9:18:25 AM,Overall,663,46238,1821,6783,55505,82,30954,944,1832,33812
62,Syria,2019,SYR-19/DDA-3558/SA1/P/UN/14083,9/8/2021 9:18:25 AM,Returnees,117,13170,279,1071,14637,16,6206,190,367,6779
62,Syria,2019,SYR-19/DDA-3558/SA1/S/NFI/INGO/14105,9/8/2020 10:28:44 AM,Host Communities,2844,3721,3057,3650,13272,4342,5713,4760,5564,20379
62,Syria,2019,SYR-19/DDA-3558/SA1/S/NFI/INGO/14105,9/8/2020 10:28:44 AM,Internally Displaced People,1891,2505,2056,2418,8870,2902,3818,3182,3718,13620
62,Syria,2019,SYR-19/DDA-3558/SA1/S/NFI/INGO/14105,9/8/2020 10:28:44 AM,Overall,5114,6728,5606,6552,24000,7852,10331,8608,10061,36852
62,Syria,2019,SYR-19/DDA-3558/SA1/S/NFI/INGO/14105,9/8/2020 10:28:44 AM,Returnees,379,502,493,484,1858,608,800,666,779,2853
62,Syria,2019,SYR-19/DDA-3558/SA1/S/NFI/NGO/13909,9/28/2020 9:45:25 AM,Internally Displaced People,645,645,2580,2580,6450,645,645,2580,2580,6450
62,Syria,2019,SYR-19/DDA-3558/SA1/S/NFI/NGO/13909,9/28/2020 9:45:25 AM,Overall,2150,2150,8600,8600,21500,2150,2150,8600,8600,21500
62,Syria,2019,SYR-19/DDA-3558/SA1/S/NFI/NGO/13909,9/28/2020 9:45:25 AM,Returnees,1505,1505,6020,6020,15050,1505,1505,6020,6020,15050
62,Syria,2019,SYR-19/DDA-3558/SA1/S/NFI/UN/13978,2/21/2021 10:03:52 AM,Overall,10312,11902,6708,6578,35500,8883,10203,5492,5366,29944
62,Syria,2019,SYR-19/DDA-3558/SA1/S/NFI/UN/13978,2/21/2021 10:03:52 AM,Refugees,10312,11902,6708,6578,35500,8883,10203,5492,5366,29944
62,Syria,2019,SYR-19/DDA-3558/SA1/S/NFI/UN/14003,5/4/2020 12:35:52 PM,Host Communities,0,0,5760,5760,11520,0,0,9500,9248,18748
62,Syria,2019,SYR-19/DDA-3558/SA1/S/NFI/UN/14003,5/4/2020 12:35:52 PM,Internally Displaced People,0,0,4290,4290,8580,0,0,0,0,0
62,Syria,2019,SYR-19/DDA-3558/SA1/S/NFI/UN/14003,5/4/2020 12:35:52 PM,Overall,0,0,12255,12255,24510,0,0,12500,12010,24510
62,Syria,2019,SYR-19/DDA-3558/SA1/S/NFI/UN/14003,5/4/2020 12:35:52 PM,Returnees,0,0,2205,2205,4410,0,0,3000,2762,5762
62,Syria,2019,SYR-19/DDA-3558/SA1/S/NFI/UN/14004,2/16/2021 8:22:13 AM,Host Communities,1364,1705,2473,2981,8523,2636,3250,1200,1640,8726
62,Syria,2019,SYR-19/DDA-3558/SA1/S/NFI/UN/14004,2/16/2021 8:22:13 AM,Internally Displaced People,620,775,1124,1357,3876,640,1500,669,837,3646
62,Syria,2019,SYR-19/DDA-3558/SA1/S/NFI/UN/14004,2/16/2021 8:22:13 AM,Overall,2480,3100,4496,5423,15499,3826,6102,2269,3177,15374
62,Syria,2019,SYR-19/DDA-3558/SA1/S/NFI/UN/14004,2/16/2021 8:22:13 AM,Returnees,496,620,899,1085,3100,550,1352,400,700,3002
62,Syria,2019,SYR-19/DDA-3558/SA1/WASH/INGO/13884,4/19/2021 8:04:11 AM,Host Communities,10666,16091,11285,11814,49856,10593,15795,7992,8453,42833
62,Syria,2019,SYR-19/DDA-3558/SA1/WASH/INGO/13884,4/19/2021 8:04:11 AM,Internally Displaced People,4379,6868,2887,3049,17183,4387,6582,2555,2516,16040
62,Syria,2019,SYR-19/DDA-3558/SA1/WASH/INGO/13884,4/19/2021 8:04:11 AM,Overall,23321,35244,23457,24455,106477,22949,34102,19935,20780,97766
62,Syria,2019,SYR-19/DDA-3558/SA1/WASH/INGO/13884,4/19/2021 8:04:11 AM,Returnees,8276,12285,9285,9592,39438,7969,11725,9388,9811,38893
62,Syria,2019,SYR-19/DDA-3558/SA1/WASH/INGO/13905,1/7/2021 9:38:15 AM,Host Communities,10339,11052,6774,7487,35652,9747,10299,8868,7739,36653
62,Syria,2019,SYR-19/DDA-3558/SA1/WASH/INGO/13905,1/7/2021 9:38:15 AM,Internally Displaced People,2067,2210,1354,1497,7128,1949,2059,1773,1547,7328
62,Syria,2019,SYR-19/DDA-3558/SA1/WASH/INGO/13905,1/7/2021 9:38:15 AM,Overall,20677,22103,13547,14973,71300,19493,20596,17735,15477,73301
62,Syria,2019,SYR-19/DDA-3558/SA1/WASH/INGO/13905,1/7/2021 9:38:15 AM,Returnees,8271,8841,5419,5989,28520,7797,8238,7094,6191,29320
62,Syria,2019,SYR-19/DDA-3558/SA1/WASH/INGO/13940,3/9/2021 11:02:25 AM,Host Communities,26864,37096,30700,33250,127910,32483,44857,37123,40217,154680
62,Syria,2019,SYR-19/DDA-3558/SA1/WASH/INGO/13940,3/9/2021 11:02:25 AM,Internally Displaced People,1641,2253,1862,2013,7769,1969,2719,2250,2437,9375
62,Syria,2019,SYR-19/DDA-3558/SA1/WASH/INGO/13940,3/9/2021 11:02:25 AM,Overall,81228,112116,92802,100538,386684,98433,135931,112494,121869,468727
62,Syria,2019,SYR-19/DDA-3558/SA1/WASH/INGO/13940,3/9/2021 11:02:25 AM,Returnees,52723,72767,60240,65275,251005,63981,88355,73121,79215,304672
62,Syria,2019,SYR-19/DDA-3558/SA1/WASH/INGO/14007,1/11/2022 10:41:05 AM,Host Communities,34857,34860,27386,27390,124493,0,0,0,0,0
62,Syria,2019,SYR-19/DDA-3558/SA1/WASH/INGO/14007,1/11/2022 10:41:05 AM,Internally Displaced People,4960,4961,3897,3900,17718,0,0,0,0,0
62,Syria,2019,SYR-19/DDA-3558/SA1/WASH/INGO/14007,1/11/2022 10:41:05 AM,Overall,41696,41702,32760,32767,148925,0,0,0,0,0
62,Syria,2019,SYR-19/DDA-3558/SA1/WASH/INGO/14007,1/11/2022 10:41:05 AM,Returnees,1879,1881,1477,1477,6714,0,0,0,0,0
62,Syria,2019,SYR-19/DDA-3558/SA1/WASH/UN/14023,2/16/2021 8:14:23 AM,Host Communities,4291,4777,6558,7044,22670,3422,3798,5227,5603,18050
62,Syria,2019,SYR-19/DDA-3558/SA1/WASH/UN/14023,2/16/2021 8:14:23 AM,Internally Displaced People,1444,1608,2207,2371,7630,1147,1273,1752,1878,6050
62,Syria,2019,SYR-19/DDA-3558/SA1/WASH/UN/14023,2/16/2021 8:14:23 AM,Overall,14197,15803,21697,23303,75000,11376,12625,17376,18623,60000
62,Syria,2019,SYR-19/DDA-3558/SA1/WASH/UN/14023,2/16/2021 8:14:23 AM,Returnees,8462,9418,12932,13888,44700,6807,7554,10397,11142,35900
62,Syria,2019,SYR-19/DDA-3558/SA1/WASH/UN/14045,2/1/2021 8:18:20 AM,Host Communities,54792,57358,82382,66003,260535,54792,57358,82382,66003,260535
62,Syria,2019,SYR-19/DDA-3558/SA1/WASH/UN/14045,2/1/2021 8:18:20 AM,Internally Displaced People,7905,8548,12550,4941,33944,7905,8548,12550,4941,33944
62,Syria,2019,SYR-19/DDA-3558/SA1/WASH/UN/14045,2/1/2021 8:18:20 AM,Overall,65145,68564,98980,74206,306895,65145,68564,98980,74206,306895
62,Syria,2019,SYR-19/DDA-3558/SA1/WASH/UN/14045,2/1/2021 8:18:20 AM,Returnees,2448,2658,4048,3262,12416,2448,2658,4048,3262,12416
62,Syria,2020,SYR-20/DDA-3558/2019 NNGO project 2020/H/NGO/16047,8/16/2021 10:24:59 AM,Host Communities,4350,8700,4350,4350,21750,7078,15197,2310,1802,26387
62,Syria,2020,SYR-20/DDA-3558/2019 NNGO project 2020/H/NGO/16047,8/16/2021 10:24:59 AM,Internally Displaced People,1864,3728,1864,1864,9320,2624,4674,980,787,9065
62,Syria,2020,SYR-20/DDA-3558/2019 NNGO project 2020/H/NGO/16047,8/16/2021 10:24:59 AM,Overall,6214,12428,6214,6214,31070,9702,19871,3290,2589,35452
62,Syria,2020,SYR-20/DDA-3558/2019 NNGO project 2020/H/NGO/16049,3/22/2021 8:52:37 AM,Host Communities,2450,3300,3400,3400,12550,2175,4708,2028,1919,10830
62,Syria,2020,SYR-20/DDA-3558/2019 NNGO project 2020/H/NGO/16049,3/22/2021 8:52:37 AM,Internally Displaced People,4100,4550,3300,3500,15450,4289,7475,3710,3540,19014
62,Syria,2020,SYR-20/DDA-3558/2019 NNGO project 2020/H/NGO/16049,3/22/2021 8:52:37 AM,Overall,6550,7850,6700,6900,28000,6464,12183,5738,5459,29844
62,Syria,2020,SYR-20/DDA-3558/2019 NNGO project 2020/P/NGO/16046,2/14/2021 8:20:43 AM,Host Communities,600,600,2500,2000,5700,600,600,2500,2000,5700
62,Syria,2020,SYR-20/DDA-3558/2019 NNGO project 2020/P/NGO/16046,2/14/2021 8:20:43 AM,Internally Displaced People,900,1000,5500,5000,12400,900,1000,5500,5000,12400
62,Syria,2020,SYR-20/DDA-3558/2019 NNGO project 2020/P/NGO/16046,2/14/2021 8:20:43 AM,Overall,2000,2000,8900,7800,20700,2010,2000,8915,7815,20740
62,Syria,2020,SYR-20/DDA-3558/2019 NNGO project 2020/P/NGO/16046,2/14/2021 8:20:43 AM,Returnees,500,400,900,800,2600,510,400,915,815,2640
62,Syria,2020,SYR-20/DDA-3558/2019 NNGO project 2020/WASH/NGO/16048,11/14/2021 7:31:19 AM,Internally Displaced People,1750,2625,2100,2275,8750,1750,2625,2100,2275,8750
62,Syria,2020,SYR-20/DDA-3558/2019 NNGO project 2020/WASH/NGO/16048,11/14/2021 7:31:19 AM,Overall,1750,2625,2100,2275,8750,1750,2625,2100,2275,8750
62,Syria,2020,SYR-20/DDA-3558/COVID 19 Adhoc/COVID-19/UN/16328,6/13/2022 9:05:29 PM,Other,8700,9000,5500,5800,29000,7102,7187,3678,3561,21528
62,Syria,2020,SYR-20/DDA-3558/COVID 19 Adhoc/COVID-19/UN/16328,6/13/2022 9:05:29 PM,Overall,8700,9000,5500,5800,29000,7102,7187,3678,3561,21528
62,Syria,2020,SYR-20/DDA-3558/COVID 19 RA/COVID-19/INGO/15787,8/26/2021 7:42:01 AM,Host Communities,6337,7041,5398,4694,23470,40516,31663,4381,4448,81008
62,Syria,2020,SYR-20/DDA-3558/COVID 19 RA/COVID-19/INGO/15787,8/26/2021 7:42:01 AM,Internally Displaced People,3884,4316,3309,2877,14386,23730,19944,3167,3216,50057
62,Syria,2020,SYR-20/DDA-3558/COVID 19 RA/COVID-19/INGO/15787,8/26/2021 7:42:01 AM,Overall,10252,11392,8734,7594,37972,64298,51656,7557,7672,131183
62,Syria,2020,SYR-20/DDA-3558/COVID 19 RA/COVID-19/INGO/15787,8/26/2021 7:42:01 AM,Returnees,31,35,27,23,116,52,49,9,8,118
62,Syria,2020,SYR-20/DDA-3558/COVID 19 RA/COVID-19/INGO/15788,5/6/2021 7:26:38 AM,Host Communities,2000,4300,1300,3500,11100,1438,8174,1430,1564,12606
62,Syria,2020,SYR-20/DDA-3558/COVID 19 RA/COVID-19/INGO/15788,5/6/2021 7:26:38 AM,Internally Displaced People,2100,4743,3000,4000,13843,901,6248,1075,1590,9814
62,Syria,2020,SYR-20/DDA-3558/COVID 19 RA/COVID-19/INGO/15788,5/6/2021 7:26:38 AM,Overall,4700,10743,5100,8700,29243,3600,20303,3640,4530,32073
62,Syria,2020,SYR-20/DDA-3558/COVID 19 RA/COVID-19/INGO/15788,5/6/2021 7:26:38 AM,Refugees,300,700,400,500,1900,0,0,0,0,0
62,Syria,2020,SYR-20/DDA-3558/COVID 19 RA/COVID-19/INGO/15788,5/6/2021 7:26:38 AM,Returnees,300,1000,400,700,2400,1261,5881,1135,1376,9653
62,Syria,2020,SYR-20/DDA-3558/COVID 19 RA/COVID-19/INGO/15789,5/5/2021 9:19:25 AM,Host Communities,35555,49098,40632,44017,169302,26634,36780,40821,44221,148456
62,Syria,2020,SYR-20/DDA-3558/COVID 19 RA/COVID-19/INGO/15789,5/5/2021 9:19:25 AM,Internally Displaced People,2156,2977,2461,2669,10263,1614,2228,2475,2680,8997
62,Syria,2020,SYR-20/DDA-3558/COVID 19 RA/COVID-19/INGO/15789,5/5/2021 9:19:25 AM,Overall,107742,148782,123125,133390,513039,80708,111453,123702,134004,449867
62,Syria,2020,SYR-20/DDA-3558/COVID 19 RA/COVID-19/INGO/15789,5/5/2021 9:19:25 AM,Returnees,70031,96707,80032,86704,333474,52460,72445,80406,87103,292414
62,Syria,2020,SYR-20/DDA-3558/COVID 19 RA/COVID-19/INGO/15795,5/6/2021 7:10:18 AM,Host Communities,33843,50724,30973,26389,141929,78684,118026,72127,59013,327850
62,Syria,2020,SYR-20/DDA-3558/COVID 19 RA/COVID-19/INGO/15795,5/6/2021 7:10:18 AM,Internally Displaced People,1145,1739,1035,878,4797,3026,4539,2774,2269,12608
62,Syria,2020,SYR-20/DDA-3558/COVID 19 RA/COVID-19/INGO/15795,5/6/2021 7:10:18 AM,Overall,44717,67296,41013,29137,182163,100876,151314,92470,75656,420316
62,Syria,2020,SYR-20/DDA-3558/COVID 19 RA/COVID-19/INGO/15795,5/6/2021 7:10:18 AM,Returnees,9729,14833,9005,1870,35437,19166,28749,17569,14374,79858
62,Syria,2020,SYR-20/DDA-3558/COVID 19 RA/COVID-19/INGO/15796,3/6/2021 2:37:54 PM,Host Communities,675,1097,1577,1650,4999,675,1097,1577,1650,4999
62,Syria,2020,SYR-20/DDA-3558/COVID 19 RA/COVID-19/INGO/15796,3/6/2021 2:37:54 PM,Internally Displaced People,37,62,89,93,281,58,77,96,99,330
62,Syria,2020,SYR-20/DDA-3558/COVID 19 RA/COVID-19/INGO/15796,3/6/2021 2:37:54 PM,Overall,1484,2417,3469,3630,11000,2424,3092,3995,4588,14099
62,Syria,2020,SYR-20/DDA-3558/COVID 19 RA/COVID-19/INGO/15796,3/6/2021 2:37:54 PM,Returnees,772,1258,1803,1887,5720,1691,1918,2322,2839,8770
62,Syria,2020,SYR-20/DDA-3558/COVID 19 RA/COVID-19/INGO/15808,5/8/2021 1:49:58 PM,Host Communities,541,362,12,13,928,223,490,18,11,742
62,Syria,2020,SYR-20/DDA-3558/COVID 19 RA/COVID-19/INGO/15808,5/8/2021 1:49:58 PM,Internally Displaced People,120,159,14,9,302,207,221,31,29,488
62,Syria,2020,SYR-20/DDA-3558/COVID 19 RA/COVID-19/INGO/15808,5/8/2021 1:49:58 PM,Overall,661,808,26,22,1517,430,998,49,40,1517
62,Syria,2020,SYR-20/DDA-3558/COVID 19 RA/COVID-19/INGO/15808,5/8/2021 1:49:58 PM,Returnees,0,287,0,0,287,0,287,0,0,287
62,Syria,2020,SYR-20/DDA-3558/COVID 19 RA/COVID-19/INGO/15823,8/29/2021 7:54:32 AM,Host Communities,22118,22118,17379,17379,78994,17233,23434,17479,14433,72579
62,Syria,2020,SYR-20/DDA-3558/COVID 19 RA/COVID-19/INGO/15823,8/29/2021 7:54:32 AM,Internally Displaced People,2534,2534,1991,1991,9050,2335,2792,1787,1331,8245
62,Syria,2020,SYR-20/DDA-3558/COVID 19 RA/COVID-19/INGO/15823,8/29/2021 7:54:32 AM,Overall,25200,25200,19800,19800,90000,21138,30816,22778,19191,93923
62,Syria,2020,SYR-20/DDA-3558/COVID 19 RA/COVID-19/INGO/15823,8/29/2021 7:54:32 AM,Returnees,548,548,430,430,1956,1570,4590,3512,3427,13099
62,Syria,2020,SYR-20/DDA-3558/COVID 19 RA/COVID-19/INGO/15845,4/26/2021 8:40:27 AM,Host Communities,1000,1000,500,500,3000,409,1010,324,259,2002
62,Syria,2020,SYR-20/DDA-3558/COVID 19 RA/COVID-19/INGO/15845,4/26/2021 8:40:27 AM,Internally Displaced People,900,900,450,450,2700,1049,1524,716,690,3979
62,Syria,2020,SYR-20/DDA-3558/COVID 19 RA/COVID-19/INGO/15845,4/26/2021 8:40:27 AM,Overall,2000,2000,1000,1000,6000,1495,2561,1048,952,6056
62,Syria,2020,SYR-20/DDA-3558/COVID 19 RA/COVID-19/INGO/15845,4/26/2021 8:40:27 AM,Returnees,100,100,50,50,300,37,27,8,3,75
62,Syria,2020,SYR-20/DDA-3558/COVID 19 RA/COVID-19/INGO/15890,4/2/2021 4:14:16 PM,Internally Displaced People,4000,6000,5000,5000,20000,5379,5355,5303,4004,20041
62,Syria,2020,SYR-20/DDA-3558/COVID 19 RA/COVID-19/INGO/15890,4/2/2021 4:14:16 PM,Overall,4000,6000,5000,5000,20000,5379,5355,5303,4004,20041
62,Syria,2020,SYR-20/DDA-3558/COVID 19 RA/COVID-19/INGO/15930,6/4/2021 8:51:38 PM,Host Communities,3755,4015,2460,2720,12950,2485,4070,1757,1765,10077
62,Syria,2020,SYR-20/DDA-3558/COVID 19 RA/COVID-19/INGO/15930,6/4/2021 8:51:38 PM,Internally Displaced People,1394,1492,913,1011,4810,1656,2714,1172,1177,6719
62,Syria,2020,SYR-20/DDA-3558/COVID 19 RA/COVID-19/INGO/15930,6/4/2021 8:51:38 PM,Overall,5364,5736,3514,3886,18500,4141,6784,2929,2942,16796
62,Syria,2020,SYR-20/DDA-3558/COVID 19 RA/COVID-19/INGO/15930,6/4/2021 8:51:38 PM,Returnees,215,229,141,155,740,0,0,0,0,0
62,Syria,2020,SYR-20/DDA-3558/COVID 19 RA/COVID-19/INGO/15958,5/1/2021 1:31:06 PM,Internally Displaced People,14172,16790,4990,5486,41438,8102,11823,3542,3749,27216
62,Syria,2020,SYR-20/DDA-3558/COVID 19 RA/COVID-19/INGO/15958,5/1/2021 1:31:06 PM,Overall,172672,201790,60052,65486,500000,18311,26332,8663,9079,62385
62,Syria,2020,SYR-20/DDA-3558/COVID 19 RA/COVID-19/INGO/15958,5/1/2021 1:31:06 PM,Returnees,158500,185000,55062,60000,458562,10209,14509,5121,5330,35169
62,Syria,2020,SYR-20/DDA-3558/COVID 19 RA/COVID-19/NGO/15814,4/12/2021 7:14:05 AM,Host Communities,1000,2000,250,250,3500,750,2300,200,360,3610
62,Syria,2020,SYR-20/DDA-3558/COVID 19 RA/COVID-19/NGO/15814,4/12/2021 7:14:05 AM,Internally Displaced People,1300,2500,500,500,4800,1025,2950,400,610,4985
62,Syria,2020,SYR-20/DDA-3558/COVID 19 RA/COVID-19/NGO/15814,4/12/2021 7:14:05 AM,Overall,2950,5650,1150,1150,10900,2235,6250,1000,1510,10995
62,Syria,2020,SYR-20/DDA-3558/COVID 19 RA/COVID-19/NGO/15814,4/12/2021 7:14:05 AM,Returnees,650,1150,400,400,2600,460,1000,400,540,2400
62,Syria,2020,SYR-20/DDA-3558/COVID 19 RA/COVID-19/NGO/15848,5/12/2021 8:05:36 AM,Host Communities,440,475,770,790,2475,440,475,770,790,2475
62,Syria,2020,SYR-20/DDA-3558/COVID 19 RA/COVID-19/NGO/15848,5/12/2021 8:05:36 AM,Internally Displaced People,900,950,1520,1580,4950,900,950,1520,1580,4950
62,Syria,2020,SYR-20/DDA-3558/COVID 19 RA/COVID-19/NGO/15848,5/12/2021 8:05:36 AM,Other,10,15,0,0,25,10,15,0,0,25
62,Syria,2020,SYR-20/DDA-3558/COVID 19 RA/COVID-19/NGO/15848,5/12/2021 8:05:36 AM,Overall,1475,1600,2540,2660,8275,1475,1600,2540,2660,8275
62,Syria,2020,SYR-20/DDA-3558/COVID 19 RA/COVID-19/NGO/15848,5/12/2021 8:05:36 AM,Returnees,125,160,250,290,825,125,160,250,290,825
62,Syria,2020,SYR-20/DDA-3558/COVID 19 RA/COVID-19/NGO/15849,5/2/2021 7:53:44 AM,Host Communities,280,4624,597,2056,7557,850,11198,1775,2734,16557
62,Syria,2020,SYR-20/DDA-3558/COVID 19 RA/COVID-19/NGO/15849,5/2/2021 7:53:44 AM,Overall,560,5136,1165,3424,10285,1700,12443,3550,4557,22250
62,Syria,2020,SYR-20/DDA-3558/COVID 19 RA/COVID-19/NGO/15849,5/2/2021 7:53:44 AM,Returnees,280,512,568,1368,2728,850,1245,1775,1823,5693
62,Syria,2020,SYR-20/DDA-3558/COVID 19 RA/COVID-19/NGO/15897,2/1/2022 10:03:32 AM,Host Communities,3000,3000,3000,3000,12000,3450,3300,4450,3000,14200
62,Syria,2020,SYR-20/DDA-3558/COVID 19 RA/COVID-19/NGO/15897,2/1/2022 10:03:32 AM,Internally Displaced People,2000,4000,5000,3000,14000,2150,4050,5300,3000,14500
62,Syria,2020,SYR-20/DDA-3558/COVID 19 RA/COVID-19/NGO/15897,2/1/2022 10:03:32 AM,Overall,8000,9000,11000,8000,36000,8800,9750,14000,8000,40550
62,Syria,2020,SYR-20/DDA-3558/COVID 19 RA/COVID-19/NGO/15897,2/1/2022 10:03:32 AM,Returnees,3000,2000,3000,2000,10000,3200,2400,4250,2000,11850
62,Syria,2020,SYR-20/DDA-3558/COVID 19 RA/COVID-19/NGO/15899,1/23/2022 8:00:42 AM,Host Communities,120,120,0,0,240,54,46,0,0,100
62,Syria,2020,SYR-20/DDA-3558/COVID 19 RA/COVID-19/NGO/15899,1/23/2022 8:00:42 AM,Internally Displaced People,120,120,0,0,240,44,28,0,0,72
62,Syria,2020,SYR-20/DDA-3558/COVID 19 RA/COVID-19/NGO/15899,1/23/2022 8:00:42 AM,Overall,275,275,0,0,550,139,109,0,0,248
62,Syria,2020,SYR-20/DDA-3558/COVID 19 RA/COVID-19/NGO/15899,1/23/2022 8:00:42 AM,Returnees,35,35,0,0,70,41,35,0,0,76
62,Syria,2020,SYR-20/DDA-3558/COVID 19 RA/COVID-19/NGO/15938,4/24/2022 6:04:44 AM,Internally Displaced People,9310,8006,12165,10639,40120,521,733,265,351,1870
62,Syria,2020,SYR-20/DDA-3558/COVID 19 RA/COVID-19/NGO/15938,4/24/2022 6:04:44 AM,Other,0,2851,3945,3054,9850,0,183,11,14,208
62,Syria,2020,SYR-20/DDA-3558/COVID 19 RA/COVID-19/NGO/15938,4/24/2022 6:04:44 AM,Overall,15860,18417,22417,24011,80705,816,1399,499,649,3363
62,Syria,2020,SYR-20/DDA-3558/COVID 19 RA/COVID-19/NGO/15938,4/24/2022 6:04:44 AM,Refugees,6550,7560,6307,10318,30735,295,483,223,284,1285
62,Syria,2020,SYR-20/DDA-3558/COVID 19 RA/COVID-19/O/15965,3/18/2021 8:31:11 AM,Host Communities,548072,636471,282877,300558,1767978,538917,632247,272493,286559,1730216
62,Syria,2020,SYR-20/DDA-3558/COVID 19 RA/COVID-19/O/15965,3/18/2021 8:31:11 AM,Internally Displaced People,124607,148725,64313,64315,401960,120947,143565,58264,57089,379865
62,Syria,2020,SYR-20/DDA-3558/COVID 19 RA/COVID-19/O/15965,3/18/2021 8:31:11 AM,Overall,1082254,1297164,625113,628172,3632703,1055063,1246245,596349,588295,3485952
62,Syria,2020,SYR-20/DDA-3558/COVID 19 RA/COVID-19/O/15965,3/18/2021 8:31:11 AM,Returnees,409575,511968,277923,263299,1462765,395199,470433,265592,244647,1375871
62,Syria,2020,SYR-20/DDA-3558/COVID 19 RA/COVID-19/UN/15828,8/2/2021 8:57:42 AM,Other,1,0,0,0,1,1,0,0,0,1
62,Syria,2020,SYR-20/DDA-3558/COVID 19 RA/COVID-19/UN/15828,8/2/2021 8:57:42 AM,Overall,1,0,0,0,1,1,0,0,0,1
62,Syria,2020,SYR-20/DDA-3558/COVID 19 RA/COVID-19/UN/15830,12/21/2020 1:54:52 PM,Other,2000,2000,0,0,4000,2000,2000,0,0,4000
62,Syria,2020,SYR-20/DDA-3558/COVID 19 RA/COVID-19/UN/15830,12/21/2020 1:54:52 PM,Overall,2000,2000,0,0,4000,2000,2000,0,0,4000
62,Syria,2020,SYR-20/DDA-3558/COVID 19 RA/COVID-19/UN/15876,2/17/2022 12:17:44 PM,Host Communities,31096,67628,106245,115520,320489,31096,67628,106245,115520,320489
62,Syria,2020,SYR-20/DDA-3558/COVID 19 RA/COVID-19/UN/15876,2/17/2022 12:17:44 PM,Internally Displaced People,1867,2534,4295,4376,13072,1867,2534,4295,4376,13072
62,Syria,2020,SYR-20/DDA-3558/COVID 19 RA/COVID-19/UN/15876,2/17/2022 12:17:44 PM,Overall,35223,75156,127233,136616,374228,35223,75156,127233,136616,374228
62,Syria,2020,SYR-20/DDA-3558/COVID 19 RA/COVID-19/UN/15876,2/17/2022 12:17:44 PM,Returnees,2260,4994,16693,16720,40667,2260,4994,16693,16720,40667
62,Syria,2020,SYR-20/DDA-3558/COVID 19 RA/COVID-19/UN/15900,6/1/2021 9:51:58 AM,Host Communities,1500,7000,0,400,8900,1500,7000,0,373,8873
62,Syria,2020,SYR-20/DDA-3558/COVID 19 RA/COVID-19/UN/15900,6/1/2021 9:51:58 AM,Internally Displaced People,0,2000,0,800,2800,0,2000,0,800,2800
62,Syria,2020,SYR-20/DDA-3558/COVID 19 RA/COVID-19/UN/15900,6/1/2021 9:51:58 AM,Other,450,2150,0,0,2600,450,2150,0,0,2600
62,Syria,2020,SYR-20/DDA-3558/COVID 19 RA/COVID-19/UN/15900,6/1/2021 9:51:58 AM,Overall,1950,11150,0,1200,14300,1950,11150,0,1173,14273
62,Syria,2020,SYR-20/DDA-3558/COVID 19 RA/COVID-19/UN/15911,2/17/2021 10:08:15 AM,Host Communities,201048,201048,148601,148601,699298,194139,216978,163662,139430,714209
62,Syria,2020,SYR-20/DDA-3558/COVID 19 RA/COVID-19/UN/15911,2/17/2021 10:08:15 AM,Internally Displaced People,583040,583040,430942,430942,2027964,563023,629238,474628,404352,2071241
62,Syria,2020,SYR-20/DDA-3558/COVID 19 RA/COVID-19/UN/15911,2/17/2021 10:08:15 AM,Overall,1005241,1005241,743004,743004,3496490,970721,1084892,818322,697160,3571095
62,Syria,2020,SYR-20/DDA-3558/COVID 19 RA/COVID-19/UN/15911,2/17/2021 10:08:15 AM,Returnees,221153,221153,163461,163461,769228,213559,238676,180032,153378,785645
62,Syria,2020,SYR-20/DDA-3558/COVID 19 RA/COVID-19/UN/15914,4/27/2022 6:37:18 AM,Host Communities,14739,30940,4634,4030,54343,127969,112798,1639,1427,243833
62,Syria,2020,SYR-20/DDA-3558/COVID 19 RA/COVID-19/UN/15914,4/27/2022 6:37:18 AM,Internally Displaced People,6675,14012,2099,1825,24611,20567,16700,0,0,37267
62,Syria,2020,SYR-20/DDA-3558/COVID 19 RA/COVID-19/UN/15914,4/27/2022 6:37:18 AM,Overall,21414,44952,6733,5855,78954,148536,129498,1639,1427,281100
62,Syria,2020,SYR-20/DDA-3558/COVID 19 RA/COVID-19/UN/15962,2/22/2021 10:02:33 AM,Other,882,918,0,0,1800,882,918,0,0,1800
62,Syria,2020,SYR-20/DDA-3558/COVID 19 RA/COVID-19/UN/15962,2/22/2021 10:02:33 AM,Overall,882,918,0,0,1800,882,918,0,0,1800
62,Syria,2020,SYR-20/DDA-3558/COVID 19 RA/COVID-19/UN/15970,7/1/2021 1:46:40 PM,Overall,57841,67637,33724,34903,194105,57907,66450,31587,30239,186183
62,Syria,2020,SYR-20/DDA-3558/COVID 19 RA/COVID-19/UN/15970,7/1/2021 1:46:40 PM,Refugees,57841,67637,33724,34903,194105,57907,66450,31587,30239,186183
62,Syria,2020,SYR-20/DDA-3558/COVID 19 RA/COVID-19/UN/15975,7/26/2021 8:03:56 AM,Host Communities,9255,15498,17400,18097,60250,9255,15498,17400,18097,60250
62,Syria,2020,SYR-20/DDA-3558/COVID 19 RA/COVID-19/UN/15975,7/26/2021 8:03:56 AM,Internally Displaced People,1526,2481,2941,3039,9987,1526,2481,2941,3039,9987
62,Syria,2020,SYR-20/DDA-3558/COVID 19 RA/COVID-19/UN/15975,7/26/2021 8:03:56 AM,Overall,11353,18886,20995,21785,73019,11353,18886,20995,21785,73019
62,Syria,2020,SYR-20/DDA-3558/COVID 19 RA/COVID-19/UN/15975,7/26/2021 8:03:56 AM,Returnees,572,907,654,649,2782,572,907,654,649,2782
62,Syria,2020,SYR-20/DDA-3558/COVID 19 RA/H/NGO/15983,5/23/2021 12:08:37 PM,Host Communities,220,658,0,0,878,220,658,0,0,878
62,Syria,2020,SYR-20/DDA-3558/COVID 19 RA/H/NGO/15983,5/23/2021 12:08:37 PM,Internally Displaced People,55,165,0,0,220,55,165,0,0,220
62,Syria,2020,SYR-20/DDA-3558/COVID 19 RA/H/NGO/15983,5/23/2021 12:08:37 PM,Overall,275,823,0,0,1098,275,823,0,0,1098
62,Syria,2020,SYR-20/DDA-3558/COVID 19 RA/WASH/NGO/15811,11/17/2021 8:10:37 AM,Internally Displaced People,2500,4200,3750,3800,14250,1200,1500,1450,1350,5500
62,Syria,2020,SYR-20/DDA-3558/COVID 19 RA/WASH/NGO/15811,11/17/2021 8:10:37 AM,Overall,2500,4200,3750,3800,14250,1200,1500,1450,1350,5500
62,Syria,2020,SYR-20/DDA-3558/RA UNHAS/LOG/UN/15752,2/14/2021 10:31:41 AM,Other,150,150,0,0,300,67,67,0,0,134
62,Syria,2020,SYR-20/DDA-3558/RA UNHAS/LOG/UN/15752,2/14/2021 10:31:41 AM,Overall,150,150,0,0,300,67,67,0,0,134
62,Syria,2020,SYR-20/DDA-3558/RA Winterization/S/NFI/UN/14950,10/25/2020 11:18:49 AM,Overall,46265,62197,22987,22431,153880,61641,82869,30627,29886,205023
62,Syria,2020,SYR-20/DDA-3558/RA Winterization/S/NFI/UN/14950,10/25/2020 11:18:49 AM,Refugees,46265,62197,22987,22431,153880,61641,82869,30627,29886,205023
62,Syria,2020,SYR-20/DDA-3558/SA1/E/INGO/16832,3/3/2022 7:38:03 AM,Host Communities,2,6,287,287,582,2,6,0,0,8
62,Syria,2020,SYR-20/DDA-3558/SA1/E/INGO/16832,3/3/2022 7:38:03 AM,Internally Displaced People,2,6,240,240,488,6,13,71,72,162
62,Syria,2020,SYR-20/DDA-3558/SA1/E/INGO/16832,3/3/2022 7:38:03 AM,Overall,14,63,2000,2000,4077,40,84,1949,1932,4005
62,Syria,2020,SYR-20/DDA-3558/SA1/E/INGO/16832,3/3/2022 7:38:03 AM,Returnees,10,51,1473,1473,3007,32,65,1878,1860,3835
62,Syria,2020,SYR-20/DDA-3558/SA1/E/INGO/17054,12/2/2021 11:52:21 AM,Host Communities,47,69,1304,1958,3378,39,153,1019,1079,2290
62,Syria,2020,SYR-20/DDA-3558/SA1/E/INGO/17054,12/2/2021 11:52:21 AM,Internally Displaced People,5,9,171,259,444,8,35,67,83,193
62,Syria,2020,SYR-20/DDA-3558/SA1/E/INGO/17054,12/2/2021 11:52:21 AM,Overall,62,93,1738,2612,4505,73,265,1998,2113,4449
62,Syria,2020,SYR-20/DDA-3558/SA1/E/INGO/17054,12/2/2021 11:52:21 AM,Returnees,10,15,263,395,683,26,77,912,951,1966
62,Syria,2020,SYR-20/DDA-3558/SA1/E/NGO/16863,2/6/2022 7:45:22 AM,Host Communities,0,0,250,250,500,0,0,270,270,540
62,Syria,2020,SYR-20/DDA-3558/SA1/E/NGO/16863,2/6/2022 7:45:22 AM,Internally Displaced People,0,0,250,250,500,0,0,270,270,540
62,Syria,2020,SYR-20/DDA-3558/SA1/E/NGO/16863,2/6/2022 7:45:22 AM,Overall,0,0,750,750,1500,0,0,810,810,1620
62,Syria,2020,SYR-20/DDA-3558/SA1/E/NGO/16863,2/6/2022 7:45:22 AM,Returnees,0,0,250,250,500,0,0,270,270,540
62,Syria,2020,SYR-20/DDA-3558/SA1/E/NGO/16950,5/22/2022 8:35:50 AM,Host Communities,0,0,600,900,1500,0,0,638,557,1195
62,Syria,2020,SYR-20/DDA-3558/SA1/E/NGO/16950,5/22/2022 8:35:50 AM,Overall,0,0,1250,2100,3350,0,0,1022,924,1946
62,Syria,2020,SYR-20/DDA-3558/SA1/E/NGO/16950,5/22/2022 8:35:50 AM,Returnees,0,0,650,1200,1850,0,0,384,367,751
62,Syria,2020,SYR-20/DDA-3558/SA1/E/NGO/17070,5/25/2022 10:25:22 AM,Host Communities,50,45,215,250,560,54,51,220,291,616
62,Syria,2020,SYR-20/DDA-3558/SA1/E/NGO/17070,5/25/2022 10:25:22 AM,Internally Displaced People,265,700,3035,4000,8000,275,750,3060,4200,8285
62,Syria,2020,SYR-20/DDA-3558/SA1/E/NGO/17070,5/25/2022 10:25:22 AM,Overall,1015,2045,12250,12250,27560,1029,2186,12450,12646,28311
62,Syria,2020,SYR-20/DDA-3558/SA1/E/NGO/17070,5/25/2022 10:25:22 AM,Returnees,700,1300,9000,8000,19000,700,1385,9170,8155,19410
62,Syria,2020,SYR-20/DDA-3558/SA1/E/NGO/17084,3/30/2022 6:05:08 AM,Host Communities,27,74,1495,1605,3201,27,74,1495,1605,3201
62,Syria,2020,SYR-20/DDA-3558/SA1/E/NGO/17084,3/30/2022 6:05:08 AM,Overall,27,74,1495,1605,3201,27,74,1495,1605,3201
62,Syria,2020,SYR-20/DDA-3558/SA1/ERL/INGO/16889,6/12/2022 11:26:54 AM,Host Communities,7701,7701,6046,6045,27493,9566,9565,7509,7510,34150
62,Syria,2020,SYR-20/DDA-3558/SA1/ERL/INGO/16889,6/12/2022 11:26:54 AM,Internally Displaced People,647,646,509,509,2311,803,802,632,634,2871
62,Syria,2020,SYR-20/DDA-3558/SA1/ERL/INGO/16889,6/12/2022 11:26:54 AM,Overall,8502,8500,6676,6675,30353,10561,10557,8292,8295,37705
62,Syria,2020,SYR-20/DDA-3558/SA1/ERL/INGO/16889,6/12/2022 11:26:54 AM,Returnees,154,153,121,121,549,192,190,151,151,684
62,Syria,2020,SYR-20/DDA-3558/SA1/ERL/INGO/17038,2/17/2022 8:25:25 AM,Overall,125,60,0,0,185,108,95,0,0,203
62,Syria,2020,SYR-20/DDA-3558/SA1/ERL/INGO/17038,2/17/2022 8:25:25 AM,Returnees,125,60,0,0,185,108,95,0,0,203
62,Syria,2020,SYR-20/DDA-3558/SA1/ERL/INGO/17106,1/13/2022 1:26:56 PM,Host Communities,120,80,0,0,200,0,0,0,0,0
62,Syria,2020,SYR-20/DDA-3558/SA1/ERL/INGO/17106,1/13/2022 1:26:56 PM,Overall,350,200,0,0,550,559,181,0,0,740
62,Syria,2020,SYR-20/DDA-3558/SA1/ERL/INGO/17106,1/13/2022 1:26:56 PM,Returnees,230,120,0,0,350,559,181,0,0,740
62,Syria,2020,SYR-20/DDA-3558/SA1/ERL/NGO/17073,2/1/2022 2:32:21 PM,Host Communities,20,30,0,0,50,31,28,0,0,59
62,Syria,2020,SYR-20/DDA-3558/SA1/ERL/NGO/17073,2/1/2022 2:32:21 PM,Internally Displaced People,75,100,0,0,175,5,4,0,0,9
62,Syria,2020,SYR-20/DDA-3558/SA1/ERL/NGO/17073,2/1/2022 2:32:21 PM,Overall,220,280,0,0,500,302,231,0,0,533
62,Syria,2020,SYR-20/DDA-3558/SA1/ERL/NGO/17073,2/1/2022 2:32:21 PM,Returnees,125,150,0,0,275,266,199,0,0,465
62,Syria,2020,SYR-20/DDA-3558/SA1/ERL/UN/17104,5/16/2022 7:16:05 AM,Host Communities,17060,18228,5451,6319,47058,17224,18344,5547,6378,47493
62,Syria,2020,SYR-20/DDA-3558/SA1/ERL/UN/17104,5/16/2022 7:16:05 AM,Internally Displaced People,298,391,148,183,1020,298,391,148,183,1020
62,Syria,2020,SYR-20/DDA-3558/SA1/ERL/UN/17104,5/16/2022 7:16:05 AM,Overall,17408,18639,5599,6502,48148,17592,18765,5695,6561,48613
62,Syria,2020,SYR-20/DDA-3558/SA1/ERL/UN/17104,5/16/2022 7:16:05 AM,Returnees,50,20,0,0,70,70,30,0,0,100
62,Syria,2020,SYR-20/DDA-3558/SA1/FSA/INGO/16924,12/6/2022 8:57:41 AM,Host Communities,5,15,10,10,40,11,14,11,13,49
62,Syria,2020,SYR-20/DDA-3558/SA1/FSA/INGO/16924,12/6/2022 8:57:41 AM,Internally Displaced People,7,18,9,10,44,8,19,10,13,50
62,Syria,2020,SYR-20/DDA-3558/SA1/FSA/INGO/16924,12/6/2022 8:57:41 AM,Overall,2145,2400,1640,1640,7825,2160,2736,2196,2232,9324
62,Syria,2020,SYR-20/DDA-3558/SA1/FSA/INGO/16924,12/6/2022 8:57:41 AM,Returnees,2133,2367,1621,1620,7741,2141,2703,2175,2206,9225
62,Syria,2020,SYR-20/DDA-3558/SA1/FSA/INGO/16926,11/17/2021 10:58:37 AM,Overall,1740,1860,1140,1260,6000,3970,4129,2646,2755,13500
62,Syria,2020,SYR-20/DDA-3558/SA1/FSA/INGO/16926,11/17/2021 10:58:37 AM,Returnees,1740,1860,1140,1260,6000,3970,4129,2646,2755,13500
62,Syria,2020,SYR-20/DDA-3558/SA1/FSA/INGO/17056,2/2/2022 1:53:15 PM,Overall,57728,86141,23916,23916,191701,51676,74719,24149,24977,175521
62,Syria,2020,SYR-20/DDA-3558/SA1/FSA/INGO/17056,2/2/2022 1:53:15 PM,Returnees,57728,86141,23916,23916,191701,51676,74719,24149,24977,175521
62,Syria,2020,SYR-20/DDA-3558/SA1/FSA/INGO/17092,3/8/2022 7:12:18 AM,Host Communities,456,456,684,684,2280,414,794,475,543,2226
62,Syria,2020,SYR-20/DDA-3558/SA1/FSA/INGO/17092,3/8/2022 7:12:18 AM,Internally Displaced People,114,114,171,171,570,95,156,153,140,544
62,Syria,2020,SYR-20/DDA-3558/SA1/FSA/INGO/17092,3/8/2022 7:12:18 AM,Overall,570,570,855,855,2850,509,950,628,683,2770
62,Syria,2020,SYR-20/DDA-3558/SA1/FSA/NGO/17078,4/21/2022 8:20:36 AM,Host Communities,134,140,0,0,274,200,106,0,0,306
62,Syria,2020,SYR-20/DDA-3558/SA1/FSA/NGO/17078,4/21/2022 8:20:36 AM,Internally Displaced People,50,50,0,0,100,35,33,0,0,68
62,Syria,2020,SYR-20/DDA-3558/SA1/FSA/NGO/17078,4/21/2022 8:20:36 AM,Overall,184,190,0,0,374,235,139,0,0,374
62,Syria,2020,SYR-20/DDA-3558/SA1/FSA/UN/16952,12/13/2021 7:07:56 AM,Host Communities,9940,10570,13630,14270,48410,9940,10570,13630,14270,48410
62,Syria,2020,SYR-20/DDA-3558/SA1/FSA/UN/16952,12/13/2021 7:07:56 AM,Internally Displaced People,4940,5530,6320,6715,23505,4940,5530,6320,6715,23505
62,Syria,2020,SYR-20/DDA-3558/SA1/FSA/UN/16952,12/13/2021 7:07:56 AM,Overall,16460,18050,21530,22960,79000,16460,18050,21530,22960,79000
62,Syria,2020,SYR-20/DDA-3558/SA1/FSA/UN/16952,12/13/2021 7:07:56 AM,Returnees,1580,1950,1580,1975,7085,1580,1950,1580,1975,7085
62,Syria,2020,SYR-20/DDA-3558/SA1/FSA/UN/17068,3/8/2022 11:39:12 AM,Overall,10005,10695,6900,6900,34500,10005,10695,6900,6900,34500
62,Syria,2020,SYR-20/DDA-3558/SA1/FSA/UN/17068,3/8/2022 11:39:12 AM,Returnees,10005,10695,6900,6900,34500,10005,10695,6900,6900,34500
62,Syria,2020,SYR-20/DDA-3558/SA1/FSA-ERL/INGO/16945,12/7/2021 12:04:46 PM,Host Communities,1000,2000,1000,2000,6000,593,908,808,722,3031
62,Syria,2020,SYR-20/DDA-3558/SA1/FSA-ERL/INGO/16945,12/7/2021 12:04:46 PM,Internally Displaced People,500,500,500,500,2000,215,328,292,261,1096
62,Syria,2020,SYR-20/DDA-3558/SA1/FSA-ERL/INGO/16945,12/7/2021 12:04:46 PM,Overall,2000,3000,2000,3000,10000,2192,3354,2984,2667,11197
62,Syria,2020,SYR-20/DDA-3558/SA1/FSA-ERL/INGO/16945,12/7/2021 12:04:46 PM,Returnees,500,500,500,500,2000,1384,2118,1884,1684,7070
62,Syria,2020,SYR-20/DDA-3558/SA1/FSA-S/NFI/INGO/16919,3/14/2022 2:32:34 PM,Host Communities,504,706,908,908,3026,2140,665,1133,757,4695
62,Syria,2020,SYR-20/DDA-3558/SA1/FSA-S/NFI/INGO/16919,3/14/2022 2:32:34 PM,Internally Displaced People,604,848,1090,1090,3632,4113,1283,2188,1458,9042
62,Syria,2020,SYR-20/DDA-3558/SA1/FSA-S/NFI/INGO/16919,3/14/2022 2:32:34 PM,Overall,2016,2824,3630,3630,12100,6501,2039,3460,2310,14310
62,Syria,2020,SYR-20/DDA-3558/SA1/FSA-S/NFI/INGO/16919,3/14/2022 2:32:34 PM,Refugees,202,282,362,362,1208,64,24,36,24,148
62,Syria,2020,SYR-20/DDA-3558/SA1/FSA-S/NFI/INGO/16919,3/14/2022 2:32:34 PM,Returnees,706,988,1270,1270,4234,184,67,103,71,425
62,Syria,2020,SYR-20/DDA-3558/SA1/FSA-WASH/INGO/16909,3/16/2022 12:10:46 PM,Host Communities,1991,2058,1021,996,6066,1991,2058,1021,996,6066
62,Syria,2020,SYR-20/DDA-3558/SA1/FSA-WASH/INGO/16909,3/16/2022 12:10:46 PM,Internally Displaced People,2062,2324,1508,1369,7263,2062,2324,1508,1369,7263
62,Syria,2020,SYR-20/DDA-3558/SA1/FSA-WASH/INGO/16909,3/16/2022 12:10:46 PM,Overall,5058,5525,3078,2916,16577,5058,5525,3078,2916,16577
62,Syria,2020,SYR-20/DDA-3558/SA1/FSA-WASH/INGO/16909,3/16/2022 12:10:46 PM,Returnees,1005,1143,549,551,3248,1005,1143,549,551,3248
62,Syria,2020,SYR-20/DDA-3558/SA1/H/INGO/16873,7/7/2022 8:34:42 AM,Host Communities,48,49,67,59,223,65,71,67,62,265
62,Syria,2020,SYR-20/DDA-3558/SA1/H/INGO/16873,7/7/2022 8:34:42 AM,Overall,10739,10990,14948,13200,49877,20755,22198,16078,16561,75592
62,Syria,2020,SYR-20/DDA-3558/SA1/H/INGO/16873,7/7/2022 8:34:42 AM,Returnees,10691,10941,14881,13141,49654,20690,22127,16011,16499,75327
62,Syria,2020,SYR-20/DDA-3558/SA1/H/NGO/16897,4/24/2022 7:07:57 AM,Host Communities,3900,5135,4210,4540,17785,1826,7417,4636,4694,18573
62,Syria,2020,SYR-20/DDA-3558/SA1/H/NGO/16897,4/24/2022 7:07:57 AM,Internally Displaced People,5050,6500,4500,4500,20550,1845,4801,2318,2924,11888
62,Syria,2020,SYR-20/DDA-3558/SA1/H/NGO/16897,4/24/2022 7:07:57 AM,Overall,8950,11635,8710,9040,38335,3671,12218,6954,7618,30461
62,Syria,2020,SYR-20/DDA-3558/SA1/H/NGO/16915,4/5/2022 7:34:54 AM,Host Communities,1000,2000,600,600,4200,1348,2484,774,755,5361
62,Syria,2020,SYR-20/DDA-3558/SA1/H/NGO/16915,4/5/2022 7:34:54 AM,Overall,4300,17520,5200,6160,33180,5387,19090,5758,6107,36342
62,Syria,2020,SYR-20/DDA-3558/SA1/H/NGO/16915,4/5/2022 7:34:54 AM,Refugees,300,520,100,60,980,421,763,113,71,1368
62,Syria,2020,SYR-20/DDA-3558/SA1/H/NGO/16915,4/5/2022 7:34:54 AM,Returnees,3000,15000,4500,5500,28000,3618,15843,4871,5281,29613
62,Syria,2020,SYR-20/DDA-3558/SA1/H/NGO/17049,1/31/2022 10:47:16 AM,Host Communities,150,650,185,185,1170,144,629,178,182,1133
62,Syria,2020,SYR-20/DDA-3558/SA1/H/NGO/17049,1/31/2022 10:47:16 AM,Internally Displaced People,50,150,50,50,300,48,145,48,47,288
62,Syria,2020,SYR-20/DDA-3558/SA1/H/NGO/17049,1/31/2022 10:47:16 AM,Overall,200,800,235,235,1470,192,774,226,229,1421
62,Syria,2020,SYR-20/DDA-3558/SA1/H/NGO/17050,1/16/2022 12:30:08 PM,Host Communities,911,1275,765,692,3643,1535,2395,922,1290,6142
62,Syria,2020,SYR-20/DDA-3558/SA1/H/NGO/17050,1/16/2022 12:30:08 PM,Internally Displaced People,1366,1912,1147,1038,5463,870,1357,522,731,3480
62,Syria,2020,SYR-20/DDA-3558/SA1/H/NGO/17050,1/16/2022 12:30:08 PM,Overall,4554,6374,3824,3461,18213,5118,7985,3071,4299,20473
62,Syria,2020,SYR-20/DDA-3558/SA1/H/NGO/17050,1/16/2022 12:30:08 PM,Returnees,2277,3187,1912,1731,9107,2713,4233,1627,2278,10851
62,Syria,2020,SYR-20/DDA-3558/SA1/H/NGO/17060,3/1/2022 7:18:51 AM,Host Communities,5101,10201,5101,5101,25504,9867,19180,3760,3166,35973
62,Syria,2020,SYR-20/DDA-3558/SA1/H/NGO/17060,3/1/2022 7:18:51 AM,Internally Displaced People,2746,5493,2746,2746,13731,3284,6867,2407,2007,14565
62,Syria,2020,SYR-20/DDA-3558/SA1/H/NGO/17060,3/1/2022 7:18:51 AM,Overall,7847,15694,7847,7847,39235,13151,26047,6167,5173,50538
62,Syria,2020,SYR-20/DDA-3558/SA1/H/NGO/17064,3/8/2022 11:33:21 AM,Host Communities,144,144,72,72,432,278,230,83,35,626
62,Syria,2020,SYR-20/DDA-3558/SA1/H/NGO/17064,3/8/2022 11:33:21 AM,Internally Displaced People,18,18,10,10,56,27,13,5,2,47
62,Syria,2020,SYR-20/DDA-3558/SA1/H/NGO/17064,3/8/2022 11:33:21 AM,Overall,180,180,92,92,544,321,249,91,38,699
62,Syria,2020,SYR-20/DDA-3558/SA1/H/NGO/17064,3/8/2022 11:33:21 AM,Returnees,18,18,10,10,56,16,6,3,1,26
62,Syria,2020,SYR-20/DDA-3558/SA1/H/NGO/17071,2/6/2022 8:00:39 AM,Host Communities,200,550,150,150,1050,200,1130,80,90,1500
62,Syria,2020,SYR-20/DDA-3558/SA1/H/NGO/17071,2/6/2022 8:00:39 AM,Internally Displaced People,450,350,300,347,1447,250,788,129,110,1277
62,Syria,2020,SYR-20/DDA-3558/SA1/H/NGO/17071,2/6/2022 8:00:39 AM,Overall,900,1200,600,647,3347,651,2688,279,260,3878
62,Syria,2020,SYR-20/DDA-3558/SA1/H/NGO/17071,2/6/2022 8:00:39 AM,Returnees,250,300,150,150,850,201,770,70,60,1101
62,Syria,2020,SYR-20/DDA-3558/SA1/H/NGO/17072,10/24/2022 8:54:13 AM,Host Communities,690,895,328,328,2241,1056,1635,291,259,3241
62,Syria,2020,SYR-20/DDA-3558/SA1/H/NGO/17072,10/24/2022 8:54:13 AM,Internally Displaced People,430,390,350,350,1520,151,188,49,41,429
62,Syria,2020,SYR-20/DDA-3558/SA1/H/NGO/17072,10/24/2022 8:54:13 AM,Overall,1150,1300,688,688,3826,1208,1824,340,300,3672
62,Syria,2020,SYR-20/DDA-3558/SA1/H/NGO/17072,10/24/2022 8:54:13 AM,Returnees,30,15,10,10,65,1,1,0,0,2
62,Syria,2020,SYR-20/DDA-3558/SA1/H/NGO/17079,11/7/2021 7:31:20 AM,Host Communities,4500,5500,6000,5000,21000,6280,16260,5667,6074,34281
62,Syria,2020,SYR-20/DDA-3558/SA1/H/NGO/17079,11/7/2021 7:31:20 AM,Internally Displaced People,4000,6500,6500,6000,23000,3399,8306,2616,2805,17126
62,Syria,2020,SYR-20/DDA-3558/SA1/H/NGO/17079,11/7/2021 7:31:20 AM,Overall,15000,21000,20000,20864,76864,23238,57176,19560,20671,120645
62,Syria,2020,SYR-20/DDA-3558/SA1/H/NGO/17079,11/7/2021 7:31:20 AM,Returnees,6500,9000,7500,9864,32864,13559,32610,11277,11792,69238
62,Syria,2020,SYR-20/DDA-3558/SA1/H/NGO/17093,11/23/2021 1:38:18 PM,Host Communities,198,126,107,105,536,365,138,100,51,654
62,Syria,2020,SYR-20/DDA-3558/SA1/H/NGO/17093,11/23/2021 1:38:18 PM,Internally Displaced People,258,196,118,86,658,253,252,35,25,565
62,Syria,2020,SYR-20/DDA-3558/SA1/H/NGO/17093,11/23/2021 1:38:18 PM,Overall,810,765,540,353,2468,1262,1120,323,174,2879
62,Syria,2020,SYR-20/DDA-3558/SA1/H/NGO/17093,11/23/2021 1:38:18 PM,Returnees,354,443,315,162,1274,644,730,188,98,1660
62,Syria,2020,SYR-20/DDA-3558/SA1/H/O/17048,4/5/2022 10:58:43 AM,Host Communities,2248,2150,0,0,4398,2248,2150,0,0,4398
62,Syria,2020,SYR-20/DDA-3558/SA1/H/O/17048,4/5/2022 10:58:43 AM,Overall,2248,2150,0,0,4398,2248,2150,0,0,4398
62,Syria,2020,SYR-20/DDA-3558/SA1/N/INGO/17083,3/3/2022 1:32:41 PM,Host Communities,2810,3812,4667,5003,16292,2810,6024,5706,6101,20641
62,Syria,2020,SYR-20/DDA-3558/SA1/N/INGO/17083,3/3/2022 1:32:41 PM,Internally Displaced People,5401,6097,6994,7656,26148,5401,9198,6653,7127,28379
62,Syria,2020,SYR-20/DDA-3558/SA1/N/INGO/17083,3/3/2022 1:32:41 PM,Overall,11988,14572,17869,19357,63786,11988,22533,19812,21250,75583
62,Syria,2020,SYR-20/DDA-3558/SA1/N/INGO/17083,3/3/2022 1:32:41 PM,Returnees,3777,4663,6208,6698,21346,3777,7311,7453,8022,26563
62,Syria,2020,SYR-20/DDA-3558/SA1/N/UN/17077,6/1/2022 7:57:59 PM,Host Communities,0,35283,36314,45822,117419,0,35407,39528,53395,128330
62,Syria,2020,SYR-20/DDA-3558/SA1/N/UN/17077,6/1/2022 7:57:59 PM,Internally Displaced People,0,18878,19016,21441,59335,0,15508,15615,15354,46477
62,Syria,2020,SYR-20/DDA-3558/SA1/N/UN/17077,6/1/2022 7:57:59 PM,Overall,0,66593,67750,79752,214095,0,62873,69141,81837,213851
62,Syria,2020,SYR-20/DDA-3558/SA1/N/UN/17077,6/1/2022 7:57:59 PM,Returnees,0,12432,12420,12489,37341,0,11958,13998,13088,39044
62,Syria,2020,SYR-20/DDA-3558/SA1/P/INGO/16914,5/9/2022 11:01:41 AM,Host Communities,268,217,524,217,1226,71,133,48,35,287
62,Syria,2020,SYR-20/DDA-3558/SA1/P/INGO/16914,5/9/2022 11:01:41 AM,Internally Displaced People,831,371,882,524,2608,58,184,50,35,327
62,Syria,2020,SYR-20/DDA-3558/SA1/P/INGO/16914,5/9/2022 11:01:41 AM,Overall,1470,959,1674,1009,5112,736,1121,1239,1080,4176
62,Syria,2020,SYR-20/DDA-3558/SA1/P/INGO/16914,5/9/2022 11:01:41 AM,Returnees,371,371,268,268,1278,607,804,1141,1010,3562
62,Syria,2020,SYR-20/DDA-3558/SA1/P/INGO/17061,2/15/2022 8:22:16 AM,Host Communities,220,330,3800,5700,10050,131,291,5096,5998,11516
62,Syria,2020,SYR-20/DDA-3558/SA1/P/INGO/17061,2/15/2022 8:22:16 AM,Internally Displaced People,154,231,2660,3990,7035,244,334,2505,2771,5854
62,Syria,2020,SYR-20/DDA-3558/SA1/P/INGO/17061,2/15/2022 8:22:16 AM,Overall,440,660,7600,11400,20100,420,710,8968,10497,20595
62,Syria,2020,SYR-20/DDA-3558/SA1/P/INGO/17061,2/15/2022 8:22:16 AM,Returnees,66,99,1140,1710,3015,45,85,1367,1728,3225
62,Syria,2020,SYR-20/DDA-3558/SA1/P/NGO/17091,5/12/2022 7:57:25 AM,Host Communities,200,200,140,140,680,150,205,150,150,655
62,Syria,2020,SYR-20/DDA-3558/SA1/P/NGO/17091,5/12/2022 7:57:25 AM,Internally Displaced People,800,2200,1900,1800,6700,750,2210,2150,1925,7035
62,Syria,2020,SYR-20/DDA-3558/SA1/P/NGO/17091,5/12/2022 7:57:25 AM,Overall,4305,6350,3925,4750,19330,4030,6345,4150,5025,19550
62,Syria,2020,SYR-20/DDA-3558/SA1/P/NGO/17091,5/12/2022 7:57:25 AM,Returnees,3305,3950,1885,2810,11950,3130,3930,1850,2950,11860
62,Syria,2020,SYR-20/DDA-3558/SA1/P/UN/17032,3/13/2022 10:34:49 AM,Overall,3275,6091,31836,30468,71670,4435,7442,48815,49425,110117
62,Syria,2020,SYR-20/DDA-3558/SA1/P/UN/17032,3/13/2022 10:34:49 AM,Refugees,3275,6091,31836,30468,71670,4435,7442,48815,49425,110117
62,Syria,2020,SYR-20/DDA-3558/SA1/P/UN/17059,12/12/2021 11:26:47 AM,Host Communities,37915,39729,25261,22282,125187,10124,10195,6900,8156,35375
62,Syria,2020,SYR-20/DDA-3558/SA1/P/UN/17059,12/12/2021 11:26:47 AM,Internally Displaced People,60472,57846,37026,36280,191624,507,511,346,408,1772
62,Syria,2020,SYR-20/DDA-3558/SA1/P/UN/17059,12/12/2021 11:26:47 AM,Overall,98854,98086,62657,58878,318475,11575,11658,7890,9326,40449
62,Syria,2020,SYR-20/DDA-3558/SA1/P/UN/17059,12/12/2021 11:26:47 AM,Returnees,467,511,370,316,1664,944,952,644,762,3302
62,Syria,2020,SYR-20/DDA-3558/SA1/P/UN/17100,1/24/2022 11:20:05 AM,Host Communities,1733,1803,1154,1202,5892,1791,2057,1327,1460,6635
62,Syria,2020,SYR-20/DDA-3558/SA1/P/UN/17100,1/24/2022 11:20:05 AM,Internally Displaced People,1830,1903,1219,1270,6222,1576,1868,1110,1284,5838
62,Syria,2020,SYR-20/DDA-3558/SA1/P/UN/17100,1/24/2022 11:20:05 AM,Overall,7239,6730,5628,5023,24620,7164,7160,6516,5698,26538
62,Syria,2020,SYR-20/DDA-3558/SA1/P/UN/17100,1/24/2022 11:20:05 AM,Returnees,3676,3024,3255,2551,12506,3797,3235,4079,2954,14065
62,Syria,2020,SYR-20/DDA-3558/SA1/S/NFI/INGO/16838,2/27/2022 12:41:46 PM,Other,60,75,20,36,191,33,42,27,30,132
62,Syria,2020,SYR-20/DDA-3558/SA1/S/NFI/INGO/16838,2/27/2022 12:41:46 PM,Overall,275,363,210,227,1075,319,397,218,207,1141
62,Syria,2020,SYR-20/DDA-3558/SA1/S/NFI/INGO/16838,2/27/2022 12:41:46 PM,Returnees,215,288,190,191,884,286,355,191,177,1009
62,Syria,2020,SYR-20/DDA-3558/SA1/S/NFI/NGO/16934,10/6/2021 9:55:52 AM,Host Communities,70,55,70,61,256,65,68,20,65,218
62,Syria,2020,SYR-20/DDA-3558/SA1/S/NFI/NGO/16934,10/6/2021 9:55:52 AM,Internally Displaced People,80,185,185,154,604,69,170,48,166,453
62,Syria,2020,SYR-20/DDA-3558/SA1/S/NFI/NGO/16934,10/6/2021 9:55:52 AM,Overall,298,1792,3040,2960,8090,381,1570,2553,3515,8019
62,Syria,2020,SYR-20/DDA-3558/SA1/S/NFI/NGO/16934,10/6/2021 9:55:52 AM,Returnees,148,1552,2785,2745,7230,247,1332,2485,3284,7348
62,Syria,2020,SYR-20/DDA-3558/SA1/S/NFI/NGO/17053,4/5/2022 9:17:33 AM,Overall,175,175,260,270,880,175,175,260,270,880
62,Syria,2020,SYR-20/DDA-3558/SA1/S/NFI/NGO/17053,4/5/2022 9:17:33 AM,Returnees,175,175,260,270,880,175,175,260,270,880
62,Syria,2020,SYR-20/DDA-3558/SA1/S/NFI/NGO/17086,1/12/2022 8:30:47 AM,Host Communities,0,0,98,80,178,0,0,150,216,366
62,Syria,2020,SYR-20/DDA-3558/SA1/S/NFI/NGO/17086,1/12/2022 8:30:47 AM,Internally Displaced People,0,0,2738,3100,5838,0,0,2950,2700,5650
62,Syria,2020,SYR-20/DDA-3558/SA1/S/NFI/NGO/17086,1/12/2022 8:30:47 AM,Overall,0,0,2836,3180,6016,0,0,3100,2916,6016
62,Syria,2020,SYR-20/DDA-3558/SA1/S/NFI/UN/16904,5/31/2022 12:06:14 PM,Host Communities,120,140,200,200,660,120,140,200,200,660
62,Syria,2020,SYR-20/DDA-3558/SA1/S/NFI/UN/16904,5/31/2022 12:06:14 PM,Internally Displaced People,360,440,600,600,2000,360,440,600,600,2000
62,Syria,2020,SYR-20/DDA-3558/SA1/S/NFI/UN/16904,5/31/2022 12:06:14 PM,Overall,1080,1320,1800,1800,6000,1080,1320,1800,1800,6000
62,Syria,2020,SYR-20/DDA-3558/SA1/S/NFI/UN/16904,5/31/2022 12:06:14 PM,Returnees,600,740,1000,1000,3340,600,740,1000,1000,3340
62,Syria,2020,SYR-20/DDA-3558/SA1/S/NFI/UN/17055,12/23/2021 8:02:33 AM,Host Communities,519,626,868,1029,3042,0,0,0,0,0
62,Syria,2020,SYR-20/DDA-3558/SA1/S/NFI/UN/17055,12/23/2021 8:02:33 AM,Internally Displaced People,1044,1287,1811,2167,6309,775,960,1150,1500,4385
62,Syria,2020,SYR-20/DDA-3558/SA1/S/NFI/UN/17055,12/23/2021 8:02:33 AM,Overall,1998,2433,3393,4041,11865,1775,2455,3350,4320,11900
62,Syria,2020,SYR-20/DDA-3558/SA1/S/NFI/UN/17055,12/23/2021 8:02:33 AM,Returnees,435,520,714,845,2514,1000,1495,2200,2820,7515
62,Syria,2020,SYR-20/DDA-3558/SA1/S/NFI/UN/17075,6/27/2021 12:40:48 PM,Host Communities,0,0,625,625,1250,0,0,397,570,967
62,Syria,2020,SYR-20/DDA-3558/SA1/S/NFI/UN/17075,6/27/2021 12:40:48 PM,Internally Displaced People,0,0,5000,5000,10000,0,0,0,0,0
62,Syria,2020,SYR-20/DDA-3558/SA1/S/NFI/UN/17075,6/27/2021 12:40:48 PM,Overall,0,0,12500,12500,25000,0,0,11935,14993,26928
62,Syria,2020,SYR-20/DDA-3558/SA1/S/NFI/UN/17075,6/27/2021 12:40:48 PM,Returnees,0,0,6875,6875,13750,0,0,11538,14423,25961
62,Syria,2020,SYR-20/DDA-3558/SA1/WASH/INGO/16834,1/4/2022 10:07:17 AM,Host Communities,3898,5121,7825,7287,24131,3752,5064,5925,7708,22449
62,Syria,2020,SYR-20/DDA-3558/SA1/WASH/INGO/16834,1/4/2022 10:07:17 AM,Internally Displaced People,1888,2480,3790,3529,11687,1815,2432,3154,3388,10789
62,Syria,2020,SYR-20/DDA-3558/SA1/WASH/INGO/16834,1/4/2022 10:07:17 AM,Overall,6091,8001,12226,11385,37703,5862,7890,11305,13392,38449
62,Syria,2020,SYR-20/DDA-3558/SA1/WASH/INGO/16834,1/4/2022 10:07:17 AM,Returnees,305,400,611,569,1885,295,394,2226,2296,5211
62,Syria,2020,SYR-20/DDA-3558/SA1/WASH/INGO/16836,2/9/2022 1:31:00 PM,Host Communities,23306,32184,26635,28855,110980,23306,32184,26635,28855,110980
62,Syria,2020,SYR-20/DDA-3558/SA1/WASH/INGO/16836,2/9/2022 1:31:00 PM,Internally Displaced People,1412,1951,1614,1749,6726,1412,1951,1614,1749,6726
62,Syria,2020,SYR-20/DDA-3558/SA1/WASH/INGO/16836,2/9/2022 1:31:00 PM,Overall,70624,97528,80713,87440,336305,70624,97528,80713,87440,336305
62,Syria,2020,SYR-20/DDA-3558/SA1/WASH/INGO/16836,2/9/2022 1:31:00 PM,Returnees,45906,63393,52464,56836,218599,45906,63393,52464,56836,218599
62,Syria,2020,SYR-20/DDA-3558/SA1/WASH/INGO/16866,2/21/2022 11:55:07 AM,Host Communities,7846,9807,4203,6164,28020,9514,11892,5097,7474,33977
62,Syria,2020,SYR-20/DDA-3558/SA1/WASH/INGO/16866,2/21/2022 11:55:07 AM,Overall,39626,44078,20503,31591,135798,81851,101758,49825,64194,297628
62,Syria,2020,SYR-20/DDA-3558/SA1/WASH/INGO/16866,2/21/2022 11:55:07 AM,Returnees,31780,34271,16300,25427,107778,72337,89866,44728,56720,263651
62,Syria,2020,SYR-20/DDA-3558/SA1/WASH/INGO/16883,5/21/2022 1:19:12 PM,Internally Displaced People,0,0,396,352,748,0,0,788,699,1487
62,Syria,2020,SYR-20/DDA-3558/SA1/WASH/INGO/16883,5/21/2022 1:19:12 PM,Overall,4009,3910,4891,4251,17061,7061,6779,8696,7194,29730
62,Syria,2020,SYR-20/DDA-3558/SA1/WASH/INGO/16883,5/21/2022 1:19:12 PM,Returnees,4009,3910,4495,3899,16313,7061,6779,7908,6495,28243
62,Syria,2020,SYR-20/DDA-3558/SA1/WASH/INGO/16944,12/12/2021 7:40:00 AM,Host Communities,1042,1429,1200,1229,4900,42,54,97,160,353
62,Syria,2020,SYR-20/DDA-3558/SA1/WASH/INGO/16944,12/12/2021 7:40:00 AM,Internally Displaced People,471,757,557,587,2372,121,45,220,202,588
62,Syria,2020,SYR-20/DDA-3558/SA1/WASH/INGO/16944,12/12/2021 7:40:00 AM,Overall,2000,3000,2460,2540,10000,2483,2774,2847,3299,11403
62,Syria,2020,SYR-20/DDA-3558/SA1/WASH/INGO/16944,12/12/2021 7:40:00 AM,Returnees,487,814,703,724,2728,2320,2675,2530,2937,10462
62,Syria,2020,SYR-20/DDA-3558/SA1/WASH/INGO/17011,11/17/2021 9:03:57 AM,Host Communities,29484,36036,19656,24024,109200,20254,37362,31067,38017,126700
62,Syria,2020,SYR-20/DDA-3558/SA1/WASH/INGO/17011,11/17/2021 9:03:57 AM,Internally Displaced People,12636,15444,8424,10296,46800,8681,15966,13343,16310,54300
62,Syria,2020,SYR-20/DDA-3558/SA1/WASH/INGO/17011,11/17/2021 9:03:57 AM,Overall,42120,51480,28080,34320,156000,28935,53328,44410,54327,181000
62,Syria,2020,SYR-20/DDA-3558/SA1/WASH/INGO/17033,12/12/2021 7:18:22 AM,Host Communities,472,915,1066,1509,3962,1416,1937,881,910,5144
62,Syria,2020,SYR-20/DDA-3558/SA1/WASH/INGO/17033,12/12/2021 7:18:22 AM,Internally Displaced People,226,452,578,885,2141,952,1404,548,585,3489
62,Syria,2020,SYR-20/DDA-3558/SA1/WASH/INGO/17033,12/12/2021 7:18:22 AM,Overall,1305,2240,2683,3863,10091,3679,5150,2158,2346,13333
62,Syria,2020,SYR-20/DDA-3558/SA1/WASH/INGO/17033,12/12/2021 7:18:22 AM,Returnees,607,873,1039,1469,3988,1311,1809,729,851,4700
62,Syria,2020,SYR-20/DDA-3558/SA1/WASH/INGO/17069,12/7/2021 9:15:36 PM,Host Communities,18569,29233,17065,14511,79378,17762,26125,16529,14005,74421
62,Syria,2020,SYR-20/DDA-3558/SA1/WASH/INGO/17069,12/7/2021 9:15:36 PM,Internally Displaced People,3992,5479,3405,2905,15781,3508,5150,3263,2772,14693
62,Syria,2020,SYR-20/DDA-3558/SA1/WASH/INGO/17069,12/7/2021 9:15:36 PM,Overall,23404,35860,21231,18067,98562,22100,32403,20544,17421,92468
62,Syria,2020,SYR-20/DDA-3558/SA1/WASH/INGO/17069,12/7/2021 9:15:36 PM,Returnees,843,1148,761,651,3403,830,1128,752,644,3354
62,Syria,2020,SYR-20/DDA-3558/SA1/WASH/INGO/17094,9/26/2021 6:56:19 AM,Overall,862,1098,902,1058,3920,862,1098,902,1058,3920
62,Syria,2020,SYR-20/DDA-3558/SA1/WASH/INGO/17094,9/26/2021 6:56:19 AM,Returnees,862,1098,902,1058,3920,862,1098,902,1058,3920
62,Syria,2020,SYR-20/DDA-3558/SA1/WASH/UN/16885,11/29/2021 1:50:54 PM,Host Communities,12550,11100,10200,9150,43000,12550,11100,10200,9150,43000
62,Syria,2020,SYR-20/DDA-3558/SA1/WASH/UN/16885,11/29/2021 1:50:54 PM,Overall,14050,12450,12600,11400,50500,14050,12450,12600,11400,50500
62,Syria,2020,SYR-20/DDA-3558/SA1/WASH/UN/16885,11/29/2021 1:50:54 PM,Returnees,1500,1350,2400,2250,7500,1500,1350,2400,2250,7500
62,Syria,2021,SYR-21/DDA-3558/RA1/E/INGO/18035,2/6/2022 12:05:59 PM,Overall,0,0,999,1061,2060,0,0,1446,1866,3312
62,Syria,2021,SYR-21/DDA-3558/RA1/E/INGO/18035,2/6/2022 12:05:59 PM,Returnees,0,0,999,1061,2060,0,0,1446,1866,3312
62,Syria,2021,SYR-21/DDA-3558/RA1/E/NGO/18052,5/29/2022 12:38:39 PM,Host Communities,0,0,300,545,845,0,0,300,545,845
62,Syria,2021,SYR-21/DDA-3558/RA1/E/NGO/18052,5/29/2022 12:38:39 PM,Overall,0,0,772,1153,1925,0,0,772,1153,1925
62,Syria,2021,SYR-21/DDA-3558/RA1/E/NGO/18052,5/29/2022 12:38:39 PM,Returnees,0,0,472,608,1080,0,0,472,608,1080
62,Syria,2021,SYR-21/DDA-3558/RA1/FSA/INGO/18065,2/9/2022 12:15:04 PM,Host Communities,238,357,242,237,1074,238,357,242,237,1074
62,Syria,2021,SYR-21/DDA-3558/RA1/FSA/INGO/18065,2/9/2022 12:15:04 PM,Internally Displaced People,293,314,429,436,1472,293,314,429,436,1472
62,Syria,2021,SYR-21/DDA-3558/RA1/FSA/INGO/18065,2/9/2022 12:15:04 PM,Overall,1439,1927,1521,1545,6432,1439,1927,1521,1545,6432
62,Syria,2021,SYR-21/DDA-3558/RA1/FSA/INGO/18065,2/9/2022 12:15:04 PM,Returnees,908,1256,850,872,3886,908,1256,850,872,3886
62,Syria,2021,SYR-21/DDA-3558/RA1/FSA/NGO/18041,2/2/2022 10:01:28 AM,Internally Displaced People,5694,5694,8540,8542,28470,5694,5851,11470,12689,35704
62,Syria,2021,SYR-21/DDA-3558/RA1/FSA/NGO/18041,2/2/2022 10:01:28 AM,Overall,14235,14235,21350,21355,71175,14235,14626,28673,28673,86207
62,Syria,2021,SYR-21/DDA-3558/RA1/FSA/NGO/18041,2/2/2022 10:01:28 AM,Returnees,8541,8541,12810,12813,42705,8541,8775,17203,15984,50503
62,Syria,2021,SYR-21/DDA-3558/RA1/FSA/UN/18036,11/18/2021 10:59:47 AM,Overall,8282,9649,3988,3787,25706,9966,12025,4209,3903,30103
62,Syria,2021,SYR-21/DDA-3558/RA1/FSA/UN/18036,11/18/2021 10:59:47 AM,Refugees,8282,9649,3988,3787,25706,9966,12025,4209,3903,30103
62,Syria,2021,SYR-21/DDA-3558/RA1/H/NGO/18033,11/28/2021 8:30:30 AM,Host Communities,1500,1800,1900,2000,7200,1718,9811,3435,3661,18625
62,Syria,2021,SYR-21/DDA-3558/RA1/H/NGO/18033,11/28/2021 8:30:30 AM,Internally Displaced People,1700,1600,1800,1800,6900,1889,10686,3822,3931,20328
62,Syria,2021,SYR-21/DDA-3558/RA1/H/NGO/18033,11/28/2021 8:30:30 AM,Overall,4600,4799,5400,5600,20399,5152,29145,10308,10965,55570
62,Syria,2021,SYR-21/DDA-3558/RA1/H/NGO/18033,11/28/2021 8:30:30 AM,Returnees,1400,1399,1700,1800,6299,1545,8648,3051,3373,16617
62,Syria,2021,SYR-21/DDA-3558/RA1/H/NGO/18061,7/20/2022 8:25:09 AM,Host Communities,1827,2869,1270,1043,7009,1573,3723,1462,1453,8211
62,Syria,2021,SYR-21/DDA-3558/RA1/H/NGO/18061,7/20/2022 8:25:09 AM,Internally Displaced People,948,1367,643,537,3495,742,1787,772,826,4127
62,Syria,2021,SYR-21/DDA-3558/RA1/H/NGO/18061,7/20/2022 8:25:09 AM,Overall,3494,5370,2467,2049,13380,2871,6930,2749,2762,15312
62,Syria,2021,SYR-21/DDA-3558/RA1/H/NGO/18061,7/20/2022 8:25:09 AM,Returnees,719,1134,554,469,2876,556,1420,515,483,2974
62,Syria,2021,SYR-21/DDA-3558/RA1/H/UN/18045,6/12/2022 8:33:15 AM,Host Communities,10395,11796,13013,22791,57995,8671,38066,13972,13812,74521
62,Syria,2021,SYR-21/DDA-3558/RA1/H/UN/18045,6/12/2022 8:33:15 AM,Internally Displaced People,3105,3524,3887,5060,15576,1722,6477,2978,3060,14237
62,Syria,2021,SYR-21/DDA-3558/RA1/H/UN/18045,6/12/2022 8:33:15 AM,Overall,13500,15320,16900,27851,73571,10393,44543,16950,16872,88758
62,Syria,2021,SYR-21/DDA-3558/RA1/H/UN/18059,5/12/2022 8:23:51 AM,Host Communities,100,6170,150,150,6570,270,9206,728,856,11060
62,Syria,2021,SYR-21/DDA-3558/RA1/H/UN/18059,5/12/2022 8:23:51 AM,Internally Displaced People,0,330,0,105,435,0,0,0,0,0
62,Syria,2021,SYR-21/DDA-3558/RA1/H/UN/18059,5/12/2022 8:23:51 AM,Overall,150,7500,250,350,8250,270,9206,728,856,11060
62,Syria,2021,SYR-21/DDA-3558/RA1/H/UN/18059,5/12/2022 8:23:51 AM,Returnees,50,1000,100,95,1245,0,0,0,0,0
62,Syria,2021,SYR-21/DDA-3558/RA1/S/NFI/INGO/18044,12/12/2021 7:38:41 AM,Host Communities,395,450,725,752,2322,483,526,702,695,2406
62,Syria,2021,SYR-21/DDA-3558/RA1/S/NFI/INGO/18044,12/12/2021 7:38:41 AM,Internally Displaced People,635,723,1165,1208,3731,734,880,1149,1098,3861
62,Syria,2021,SYR-21/DDA-3558/RA1/S/NFI/INGO/18044,12/12/2021 7:38:41 AM,Overall,1480,1686,2716,2818,8700,1640,1886,2664,2620,8810
62,Syria,2021,SYR-21/DDA-3558/RA1/S/NFI/INGO/18044,12/12/2021 7:38:41 AM,Returnees,450,513,826,858,2647,423,480,813,827,2543
62,Syria,2021,SYR-21/DDA-3558/RA1/WASH/INGO/18047,10/3/2021 8:14:41 AM,Host Communities,2288,2912,2392,2808,10400,2288,2912,2392,2808,10400
62,Syria,2021,SYR-21/DDA-3558/RA1/WASH/INGO/18047,10/3/2021 8:14:41 AM,Internally Displaced People,493,627,515,605,2240,493,627,515,605,2240
62,Syria,2021,SYR-21/DDA-3558/RA1/WASH/INGO/18047,10/3/2021 8:14:41 AM,Overall,3520,4480,3680,4320,16000,3520,4480,3680,4320,16000
62,Syria,2021,SYR-21/DDA-3558/RA1/WASH/INGO/18047,10/3/2021 8:14:41 AM,Returnees,739,941,773,907,3360,739,941,773,907,3360
62,Syria,2021,SYR-21/DDA-3558/RA1/WASH/INGO/18050,12/28/2021 1:57:21 PM,Overall,5600,5600,4400,4400,20000,8400,8400,6600,6600,30000
62,Syria,2021,SYR-21/DDA-3558/RA1/WASH/INGO/18050,12/28/2021 1:57:21 PM,Returnees,5600,5600,4400,4400,20000,8400,8400,6600,6600,30000
62,Syria,2021,SYR-21/DDA-3558/RA1/WASH/INGO/18060,2/17/2022 11:10:28 AM,Overall,3000,2500,2000,2500,10000,3000,2500,2000,2500,10000
62,Syria,2021,SYR-21/DDA-3558/RA1/WASH/INGO/18060,2/17/2022 11:10:28 AM,Returnees,3000,2500,2000,2500,10000,3000,2500,2000,2500,10000
62,Syria,2021,SYR-21/DDA-3558/RA2/E/INGO/20302,2/22/2023 9:17:29 AM,Host Communities,100,100,203,186,589,84,111,329,256,780
62,Syria,2021,SYR-21/DDA-3558/RA2/E/INGO/20302,2/22/2023 9:17:29 AM,Internally Displaced People,0,0,22,14,36,11,19,35,36,101
62,Syria,2021,SYR-21/DDA-3558/RA2/E/INGO/20302,2/22/2023 9:17:29 AM,Other,8,22,0,0,30,8,22,0,0,30
62,Syria,2021,SYR-21/DDA-3558/RA2/E/INGO/20302,2/22/2023 9:17:29 AM,Overall,108,122,225,200,655,103,152,364,292,911
62,Syria,2021,SYR-21/DDA-3558/RA2/E/INGO/20321,11/30/2022 11:50:37 AM,Host Communities,15,67,488,450,1020,4,28,642,570,1244
62,Syria,2021,SYR-21/DDA-3558/RA2/E/INGO/20321,11/30/2022 11:50:37 AM,Internally Displaced People,2,8,150,107,267,0,0,85,63,148
62,Syria,2021,SYR-21/DDA-3558/RA2/E/INGO/20321,11/30/2022 11:50:37 AM,Overall,20,106,1003,927,2056,8,56,1003,927,1994
62,Syria,2021,SYR-21/DDA-3558/RA2/E/INGO/20321,11/30/2022 11:50:37 AM,Returnees,3,31,365,370,769,4,28,276,294,602
62,Syria,2021,SYR-21/DDA-3558/RA2/E/INGO/20327,12/13/2022 5:37:24 PM,Host Communities,57,57,203,203,520,45,633,1329,1435,3442
62,Syria,2021,SYR-21/DDA-3558/RA2/E/INGO/20327,12/13/2022 5:37:24 PM,Internally Displaced People,31,31,112,112,286,10,115,257,276,658
62,Syria,2021,SYR-21/DDA-3558/RA2/E/INGO/20327,12/13/2022 5:37:24 PM,Overall,390,390,1400,1400,3580,56,767,1604,1731,4158
62,Syria,2021,SYR-21/DDA-3558/RA2/E/INGO/20327,12/13/2022 5:37:24 PM,Returnees,302,302,1085,1085,2774,1,19,18,20,58
62,Syria,2021,SYR-21/DDA-3558/RA2/E/INGO/20338,12/13/2022 5:32:37 PM,Overall,0,0,262,298,560,424,880,560,600,2464
62,Syria,2021,SYR-21/DDA-3558/RA2/E/INGO/20338,12/13/2022 5:32:37 PM,Returnees,0,0,262,298,560,424,880,560,600,2464
62,Syria,2021,SYR-21/DDA-3558/RA2/FSA/INGO/20426,7/10/2023 10:32:42 AM,Host Communities,260,400,210,210,1080,397,666,440,409,1912
62,Syria,2021,SYR-21/DDA-3558/RA2/FSA/INGO/20426,7/10/2023 10:32:42 AM,Internally Displaced People,100,180,200,200,680,2,4,6,8,20
62,Syria,2021,SYR-21/DDA-3558/RA2/FSA/INGO/20426,7/10/2023 10:32:42 AM,Overall,380,620,450,450,1900,399,670,446,417,1932
62,Syria,2021,SYR-21/DDA-3558/RA2/FSA/INGO/20426,7/10/2023 10:32:42 AM,Returnees,20,40,40,40,140,0,0,0,0,0
62,Syria,2021,SYR-21/DDA-3558/RA2/FSA/NGO/20371,3/8/2023 10:48:03 AM,Host Communities,1520,1520,2280,2280,7600,1520,1520,2280,2280,7600
62,Syria,2021,SYR-21/DDA-3558/RA2/FSA/NGO/20371,3/8/2023 10:48:03 AM,Internally Displaced People,2280,2280,3420,3420,11400,2280,2280,3420,3420,11400
62,Syria,2021,SYR-21/DDA-3558/RA2/FSA/NGO/20371,3/8/2023 10:48:03 AM,Overall,3800,3800,5700,5700,19000,3800,3800,5700,5700,19000
62,Syria,2021,SYR-21/DDA-3558/RA2/FSA-WASH/INGO/20375,4/26/2023 9:53:53 PM,Overall,69811,61929,52432,55353,239525,72562,83385,59367,68223,283537
62,Syria,2021,SYR-21/DDA-3558/RA2/FSA-WASH/INGO/20375,4/26/2023 9:53:53 PM,Returnees,69811,61929,52432,55353,239525,72562,83385,59367,68223,283537
62,Syria,2021,SYR-21/DDA-3558/RA2/H/INGO/20310,7/3/2023 8:43:38 AM,Host Communities,9526,9915,8114,8445,36000,10771,8124,9175,6921,34991
62,Syria,2021,SYR-21/DDA-3558/RA2/H/INGO/20310,7/3/2023 8:43:38 AM,Overall,9526,9915,8114,8445,36000,10771,8124,9175,6921,34991
62,Syria,2021,SYR-21/DDA-3558/RA2/H/INGO/20458,8/21/2022 8:13:35 AM,Host Communities,11780,17424,8086,11827,49117,9634,24409,10404,11598,56045
62,Syria,2021,SYR-21/DDA-3558/RA2/H/INGO/20458,8/21/2022 8:13:35 AM,Internally Displaced People,5626,8322,3862,5649,23459,4602,11651,4961,5523,26737
62,Syria,2021,SYR-21/DDA-3558/RA2/H/INGO/20458,8/21/2022 8:13:35 AM,Overall,17582,26006,12069,17653,73310,14381,36424,15521,17295,83621
62,Syria,2021,SYR-21/DDA-3558/RA2/H/INGO/20458,8/21/2022 8:13:35 AM,Returnees,176,260,121,177,734,145,364,156,174,839
62,Syria,2021,SYR-21/DDA-3558/RA2/H/NGO/20305,1/30/2023 8:46:10 AM,Host Communities,120,195,95,80,490,383,481,66,51,981
62,Syria,2021,SYR-21/DDA-3558/RA2/H/NGO/20305,1/30/2023 8:46:10 AM,Internally Displaced People,110,115,65,55,345,262,511,119,77,969
62,Syria,2021,SYR-21/DDA-3558/RA2/H/NGO/20305,1/30/2023 8:46:10 AM,Overall,325,415,184,165,1089,738,1171,235,170,2314
62,Syria,2021,SYR-21/DDA-3558/RA2/H/NGO/20305,1/30/2023 8:46:10 AM,Returnees,95,105,24,30,254,93,179,50,42,364
62,Syria,2021,SYR-21/DDA-3558/RA2/H/NGO/20381,10/24/2022 9:53:25 AM,Host Communities,2500,5000,2500,3000,13000,3601,13888,4074,4391,25954
62,Syria,2021,SYR-21/DDA-3558/RA2/H/NGO/20381,10/24/2022 9:53:25 AM,Internally Displaced People,3500,6000,3500,3500,16500,2471,9432,2477,3048,17428
62,Syria,2021,SYR-21/DDA-3558/RA2/H/NGO/20381,10/24/2022 9:53:25 AM,Overall,8500,15000,8068,8500,40068,7354,28433,8026,8942,52755
62,Syria,2021,SYR-21/DDA-3558/RA2/H/NGO/20381,10/24/2022 9:53:25 AM,Returnees,2500,4000,2068,2000,10568,1282,5113,1475,1503,9373
62,Syria,2021,SYR-21/DDA-3558/RA2/H/NGO/20398,12/29/2022 5:51:41 AM,Overall,4870,16838,6385,6419,34512,3442,19835,5847,7601,36725
62,Syria,2021,SYR-21/DDA-3558/RA2/H/NGO/20398,12/29/2022 5:51:41 AM,Returnees,4870,16838,6385,6419,34512,3442,19835,5847,7601,36725
62,Syria,2021,SYR-21/DDA-3558/RA2/H/NGO/20403,1/18/2023 5:11:24 AM,Host Communities,78,122,47,65,312,94,160,53,35,342
62,Syria,2021,SYR-21/DDA-3558/RA2/H/NGO/20403,1/18/2023 5:11:24 AM,Internally Displaced People,44,70,27,40,181,57,90,32,18,197
62,Syria,2021,SYR-21/DDA-3558/RA2/H/NGO/20403,1/18/2023 5:11:24 AM,Overall,260,409,156,225,1050,327,538,167,108,1140
62,Syria,2021,SYR-21/DDA-3558/RA2/H/NGO/20403,1/18/2023 5:11:24 AM,Returnees,138,217,82,120,557,176,288,82,55,601
62,Syria,2021,SYR-21/DDA-3558/RA2/H/NGO/20425,11/15/2022 11:50:11 AM,Overall,1110,1430,1550,1550,5640,1153,2893,1696,1824,7566
62,Syria,2021,SYR-21/DDA-3558/RA2/H/NGO/20425,11/15/2022 11:50:11 AM,Returnees,1110,1430,1550,1550,5640,1153,2893,1696,1824,7566
62,Syria,2021,SYR-21/DDA-3558/RA2/H/UN/20393,10/12/2022 9:18:10 AM,Other,300,16830,500,1430,19060,809,17814,1098,2346,22067
62,Syria,2021,SYR-21/DDA-3558/RA2/H/UN/20393,10/12/2022 9:18:10 AM,Overall,300,16830,500,1430,19060,809,17814,1098,2346,22067
62,Syria,2021,SYR-21/DDA-3558/RA2/P/INGO/20369,5/3/2023 7:43:29 PM,Host Communities,30,30,0,0,60,18,56,0,0,74
62,Syria,2021,SYR-21/DDA-3558/RA2/P/INGO/20369,5/3/2023 7:43:29 PM,Internally Displaced People,30,30,0,4500,4560,20,42,0,5257,5319
62,Syria,2021,SYR-21/DDA-3558/RA2/P/INGO/20369,5/3/2023 7:43:29 PM,Overall,60,60,0,4500,4620,38,98,0,5257,5393
62,Syria,2021,SYR-21/DDA-3558/RA2/S/NFI/INGO/20319,11/21/2022 7:34:45 AM,Host Communities,18,24,17,23,82,19,27,17,23,86
62,Syria,2021,SYR-21/DDA-3558/RA2/S/NFI/INGO/20319,11/21/2022 7:34:45 AM,Overall,151,174,221,254,800,155,179,221,254,809
62,Syria,2021,SYR-21/DDA-3558/RA2/S/NFI/INGO/20319,11/21/2022 7:34:45 AM,Returnees,133,150,204,231,718,136,152,204,231,723
62,Syria,2021,SYR-21/DDA-3558/RA2/S/NFI/INGO/20337,11/23/2022 7:15:25 AM,Host Communities,92,138,115,115,460,75,107,25,34,241
62,Syria,2021,SYR-21/DDA-3558/RA2/S/NFI/INGO/20337,11/23/2022 7:15:25 AM,Internally Displaced People,40,60,50,50,200,39,61,36,42,178
62,Syria,2021,SYR-21/DDA-3558/RA2/S/NFI/INGO/20337,11/23/2022 7:15:25 AM,Overall,455,681,568,571,2275,426,729,528,559,2242
62,Syria,2021,SYR-21/DDA-3558/RA2/S/NFI/INGO/20337,11/23/2022 7:15:25 AM,Returnees,323,483,403,406,1615,312,561,467,483,1823
62,Syria,2021,SYR-21/DDA-3558/RA2/S/NFI/INGO/20340,6/12/2022 11:12:59 AM,Host Communities,3445,4260,1015,1425,10145,916,1124,974,982,3996
62,Syria,2021,SYR-21/DDA-3558/RA2/S/NFI/INGO/20340,6/12/2022 11:12:59 AM,Internally Displaced People,470,580,145,200,1395,16,15,26,13,70
62,Syria,2021,SYR-21/DDA-3558/RA2/S/NFI/INGO/20340,6/12/2022 11:12:59 AM,Overall,4615,5700,1390,1895,13600,3999,4885,4074,3932,16890
62,Syria,2021,SYR-21/DDA-3558/RA2/S/NFI/INGO/20340,6/12/2022 11:12:59 AM,Returnees,700,860,230,270,2060,3067,3746,3074,2937,12824
62,Syria,2021,SYR-21/DDA-3558/RA2/S/NFI/INGO/20343,8/16/2022 9:27:19 AM,Overall,2125,4249,3895,3891,14160,2126,4249,3895,3890,14160
62,Syria,2021,SYR-21/DDA-3558/RA2/S/NFI/INGO/20343,8/16/2022 9:27:19 AM,Returnees,2125,4249,3895,3891,14160,2126,4249,3895,3890,14160
62,Syria,2021,SYR-21/DDA-3558/RA2/S/NFI/INGO/20400,2/7/2023 7:38:29 AM,Overall,5106,7326,4440,5328,22200,6919,5138,6824,8070,26951
62,Syria,2021,SYR-21/DDA-3558/RA2/S/NFI/INGO/20400,2/7/2023 7:38:29 AM,Returnees,5106,7326,4440,5328,22200,6919,5138,6824,8070,26951
62,Syria,2021,SYR-21/DDA-3558/RA2/S/NFI/INGO/20434,5/2/2023 10:28:06 AM,Host Communities,51,70,38,39,198,20,35,25,35,115
62,Syria,2021,SYR-21/DDA-3558/RA2/S/NFI/INGO/20434,5/2/2023 10:28:06 AM,Overall,204,283,154,159,800,245,314,215,216,990
62,Syria,2021,SYR-21/DDA-3558/RA2/S/NFI/INGO/20434,5/2/2023 10:28:06 AM,Returnees,153,213,116,120,602,225,279,190,181,875
62,Syria,2021,SYR-21/DDA-3558/RA2/S/NFI/NGO/20303,8/18/2022 8:16:53 AM,Overall,400,1200,1200,1200,4000,460,1430,1415,1455,4760
62,Syria,2021,SYR-21/DDA-3558/RA2/S/NFI/NGO/20303,8/18/2022 8:16:53 AM,Returnees,400,1200,1200,1200,4000,460,1430,1415,1455,4760
62,Syria,2021,SYR-21/DDA-3558/RA2/S/NFI/NGO/20358,1/26/2023 11:14:56 AM,Host Communities,560,750,1220,1220,3750,591,724,693,693,2701
62,Syria,2021,SYR-21/DDA-3558/RA2/S/NFI/NGO/20358,1/26/2023 11:14:56 AM,Overall,1325,1780,2860,2860,8825,1439,1726,1200,1201,5566
62,Syria,2021,SYR-21/DDA-3558/RA2/S/NFI/NGO/20358,1/26/2023 11:14:56 AM,Returnees,765,1030,1640,1640,5075,848,1002,507,508,2865
62,Syria,2021,SYR-21/DDA-3558/RA2/S/NFI/NGO/20377,11/1/2022 7:58:57 AM,Host Communities,0,0,700,600,1300,0,0,750,650,1400
62,Syria,2021,SYR-21/DDA-3558/RA2/S/NFI/NGO/20377,11/1/2022 7:58:57 AM,Internally Displaced People,0,0,400,500,900,0,0,500,600,1100
62,Syria,2021,SYR-21/DDA-3558/RA2/S/NFI/NGO/20377,11/1/2022 7:58:57 AM,Overall,0,0,4400,5600,10000,0,0,5047,6250,11297
62,Syria,2021,SYR-21/DDA-3558/RA2/S/NFI/NGO/20377,11/1/2022 7:58:57 AM,Returnees,0,0,3300,4500,7800,0,0,3797,5000,8797
62,Syria,2021,SYR-21/DDA-3558/RA2/S/NFI/NGO/20384,8/6/2023 10:03:42 AM,Host Communities,36,79,66,93,274,36,79,66,93,274
62,Syria,2021,SYR-21/DDA-3558/RA2/S/NFI/NGO/20384,8/6/2023 10:03:42 AM,Overall,106,233,192,269,800,106,233,192,269,800
62,Syria,2021,SYR-21/DDA-3558/RA2/S/NFI/NGO/20384,8/6/2023 10:03:42 AM,Returnees,70,154,126,176,526,70,154,126,176,526
62,Syria,2021,SYR-21/DDA-3558/RA2/S/NFI/NGO/20405,5/7/2023 7:18:12 AM,Host Communities,214,356,228,345,1143,215,365,228,345,1153
62,Syria,2021,SYR-21/DDA-3558/RA2/S/NFI/NGO/20405,5/7/2023 7:18:12 AM,Internally Displaced People,21,22,15,16,74,55,32,29,33,149
62,Syria,2021,SYR-21/DDA-3558/RA2/S/NFI/NGO/20405,5/7/2023 7:18:12 AM,Overall,2200,2800,1900,2200,9100,2235,2819,1914,2217,9185
62,Syria,2021,SYR-21/DDA-3558/RA2/S/NFI/NGO/20405,5/7/2023 7:18:12 AM,Returnees,1965,2422,1657,1839,7883,1965,2422,1657,1839,7883
62,Syria,2021,SYR-21/DDA-3558/RA2/S/NFI/O/20306,5/18/2023 11:24:50 AM,Host Communities,0,0,717,716,1433,0,0,717,716,1433
62,Syria,2021,SYR-21/DDA-3558/RA2/S/NFI/O/20306,5/18/2023 11:24:50 AM,Other,0,0,1921,1923,3844,0,0,1921,1923,3844
62,Syria,2021,SYR-21/DDA-3558/RA2/S/NFI/O/20306,5/18/2023 11:24:50 AM,Overall,0,0,3776,3777,7553,0,0,3776,3777,7553
62,Syria,2021,SYR-21/DDA-3558/RA2/S/NFI/O/20306,5/18/2023 11:24:50 AM,Returnees,0,0,1138,1138,2276,0,0,1138,1138,2276
62,Syria,2021,SYR-21/DDA-3558/RA2/WASH/INGO/20304,2/26/2023 11:56:44 AM,Overall,3704,4704,2888,3704,15000,4050,4500,3600,2850,15000
62,Syria,2021,SYR-21/DDA-3558/RA2/WASH/INGO/20304,2/26/2023 11:56:44 AM,Returnees,3704,4704,2888,3704,15000,4050,4500,3600,2850,15000
62,Syria,2021,SYR-21/DDA-3558/RA2/WASH/INGO/20442,2/26/2023 11:43:08 AM,Overall,7820,11220,6800,8160,34000,8590,11220,8787,9133,37730
62,Syria,2021,SYR-21/DDA-3558/RA2/WASH/INGO/20442,2/26/2023 11:43:08 AM,Returnees,7820,11220,6800,8160,34000,8590,11220,8787,9133,37730
62,Syria,2021,SYR-21/DDA-3558/RA2/WASH/INGO/20446,1/1/2023 7:26:15 PM,Host Communities,8233,8233,7013,7013,30492,8377,8377,7136,7136,31026
62,Syria,2021,SYR-21/DDA-3558/RA2/WASH/INGO/20446,1/1/2023 7:26:15 PM,Internally Displaced People,4336,4492,3153,3153,15134,3419,3642,3354,2581,12996
62,Syria,2021,SYR-21/DDA-3558/RA2/WASH/INGO/20446,1/1/2023 7:26:15 PM,Overall,12569,12725,10166,10166,45626,11796,12019,10490,9717,44022
62,Syria,2021,SYR-21/DDA-3558/RA2/WASH/NGO/20367,1/10/2023 10:19:30 AM,Internally Displaced People,2000,2500,1400,1600,7500,2000,2500,1400,1600,7500
62,Syria,2021,SYR-21/DDA-3558/RA2/WASH/NGO/20367,1/10/2023 10:19:30 AM,Overall,2000,2500,1400,1600,7500,2000,2500,1400,1600,7500
62,Syria,2021,SYR-21/DDA-3558/RA2/WASH-ERL-FSA/INGO/20346,6/11/2023 9:19:27 AM,Overall,5670,5770,6255,6255,23950,5200,6100,6821,6138,24259
62,Syria,2021,SYR-21/DDA-3558/RA2/WASH-ERL-FSA/INGO/20346,6/11/2023 9:19:27 AM,Returnees,5670,5770,6255,6255,23950,5200,6100,6821,6138,24259
62,Syria,2021,SYR-21/DDA-3558/RA2/WASH-N/UN/20376,2/27/2023 9:09:20 AM,Host Communities,24000,29925,13625,16800,84350,24000,29925,13625,16800,84350
62,Syria,2021,SYR-21/DDA-3558/RA2/WASH-N/UN/20376,2/27/2023 9:09:20 AM,Overall,24000,29925,13625,16800,84350,24000,29925,13625,16800,84350
62,Syria,2021,SYR-21/DDA-3558/RA3/LOG/UN/21157,9/19/2022 8:50:13 AM,Other,175,175,0,0,350,187,187,0,0,374
62,Syria,2021,SYR-21/DDA-3558/RA3/LOG/UN/21157,9/19/2022 8:50:13 AM,Overall,175,175,0,0,350,187,187,0,0,374
62,Syria,2021,SYR-21/DDA-3558/SA1/E/INGO/19260,2/5/2023 11:59:23 AM,Internally Displaced People,0,0,54,47,101,0,0,54,47,101
62,Syria,2021,SYR-21/DDA-3558/SA1/E/INGO/19260,2/5/2023 11:59:23 AM,Other,9,12,0,0,21,9,12,0,0,21
62,Syria,2021,SYR-21/DDA-3558/SA1/E/INGO/19260,2/5/2023 11:59:23 AM,Overall,49,52,738,672,1511,22,65,698,751,1536
62,Syria,2021,SYR-21/DDA-3558/SA1/E/INGO/19260,2/5/2023 11:59:23 AM,Returnees,40,40,684,625,1389,13,53,644,704,1414
62,Syria,2021,SYR-21/DDA-3558/SA1/E/INGO/19280,1/18/2023 4:46:20 AM,Host Communities,0,0,55,50,105,0,18,293,294,605
62,Syria,2021,SYR-21/DDA-3558/SA1/E/INGO/19280,1/18/2023 4:46:20 AM,Internally Displaced People,0,0,0,0,0,0,0,15,10,25
62,Syria,2021,SYR-21/DDA-3558/SA1/E/INGO/19280,1/18/2023 4:46:20 AM,Overall,0,0,815,894,1709,7,135,955,759,1856
62,Syria,2021,SYR-21/DDA-3558/SA1/E/INGO/19280,1/18/2023 4:46:20 AM,Returnees,0,0,760,844,1604,7,117,647,455,1226
62,Syria,2021,SYR-21/DDA-3558/SA1/E/INGO/19568,12/29/2022 4:33:23 PM,Host Communities,1,2,16,24,43,1,1,8,8,18
62,Syria,2021,SYR-21/DDA-3558/SA1/E/INGO/19568,12/29/2022 4:33:23 PM,Internally Displaced People,1,1,9,13,24,0,0,4,5,9
62,Syria,2021,SYR-21/DDA-3558/SA1/E/INGO/19568,12/29/2022 4:33:23 PM,Overall,20,21,405,360,806,20,23,441,378,862
62,Syria,2021,SYR-21/DDA-3558/SA1/E/INGO/19568,12/29/2022 4:33:23 PM,Returnees,18,18,380,323,739,19,22,429,365,835
62,Syria,2021,SYR-21/DDA-3558/SA1/E/INGO/19707,12/13/2022 5:29:03 PM,Host Communities,44,37,90,89,260,44,37,490,456,1027
62,Syria,2021,SYR-21/DDA-3558/SA1/E/INGO/19707,12/13/2022 5:29:03 PM,Internally Displaced People,76,65,158,156,455,76,65,862,802,1805
62,Syria,2021,SYR-21/DDA-3558/SA1/E/INGO/19707,12/13/2022 5:29:03 PM,Overall,281,229,560,569,1639,281,229,2773,2727,6010
62,Syria,2021,SYR-21/DDA-3558/SA1/E/INGO/19707,12/13/2022 5:29:03 PM,Returnees,161,127,312,324,924,161,127,1421,1469,3178
62,Syria,2021,SYR-21/DDA-3558/SA1/E/INGO/19732,3/8/2023 8:41:19 AM,Overall,144,568,6913,7431,15056,238,694,9425,9423,19780
62,Syria,2021,SYR-21/DDA-3558/SA1/E/INGO/19732,3/8/2023 8:41:19 AM,Returnees,144,568,6913,7431,15056,238,694,9425,9423,19780
62,Syria,2021,SYR-21/DDA-3558/SA1/E/NGO/19468,2/5/2023 12:11:10 PM,Internally Displaced People,0,0,200,200,400,0,0,200,200,400
62,Syria,2021,SYR-21/DDA-3558/SA1/E/NGO/19468,2/5/2023 12:11:10 PM,Overall,0,0,500,500,1000,0,0,500,500,1000
62,Syria,2021,SYR-21/DDA-3558/SA1/E/NGO/19468,2/5/2023 12:11:10 PM,Returnees,0,0,300,300,600,0,0,300,300,600
62,Syria,2021,SYR-21/DDA-3558/SA1/E/NGO/19703,12/29/2022 6:08:09 AM,Overall,14,62,845,830,1751,14,62,845,830,1751
62,Syria,2021,SYR-21/DDA-3558/SA1/E/NGO/19703,12/29/2022 6:08:09 AM,Refugees,0,1,28,24,53,0,1,28,24,53
62,Syria,2021,SYR-21/DDA-3558/SA1/E/NGO/19703,12/29/2022 6:08:09 AM,Returnees,14,61,817,806,1698,14,61,817,806,1698
62,Syria,2021,SYR-21/DDA-3558/SA1/FSA/INGO/19554,4/26/2023 10:23:26 PM,Host Communities,321,642,588,588,2139,521,1094,800,761,3176
62,Syria,2021,SYR-21/DDA-3558/SA1/FSA/INGO/19554,4/26/2023 10:23:26 PM,Internally Displaced People,74,148,136,136,494,10,33,23,19,85
62,Syria,2021,SYR-21/DDA-3558/SA1/FSA/INGO/19554,4/26/2023 10:23:26 PM,Overall,494,987,905,904,3290,565,1209,881,836,3491
62,Syria,2021,SYR-21/DDA-3558/SA1/FSA/INGO/19554,4/26/2023 10:23:26 PM,Returnees,99,197,181,180,657,34,82,58,56,230
62,Syria,2021,SYR-21/DDA-3558/SA1/FSA/INGO/19584,4/4/2023 8:35:35 AM,Host Communities,300,940,410,410,2060,40,53,37,30,160
62,Syria,2021,SYR-21/DDA-3558/SA1/FSA/INGO/19584,4/4/2023 8:35:35 AM,Overall,550,1790,485,485,3310,860,1247,1129,1181,4417
62,Syria,2021,SYR-21/DDA-3558/SA1/FSA/INGO/19584,4/4/2023 8:35:35 AM,Returnees,250,850,75,75,1250,820,1194,1092,1151,4257
62,Syria,2021,SYR-21/DDA-3558/SA1/FSA/NGO/19743,2/28/2023 11:06:34 AM,Overall,200,300,500,500,1500,148,322,518,512,1500
62,Syria,2021,SYR-21/DDA-3558/SA1/FSA/NGO/19743,2/28/2023 11:06:34 AM,Returnees,200,300,500,500,1500,148,322,518,512,1500
62,Syria,2021,SYR-21/DDA-3558/SA1/FSA/UN/19542,2/27/2023 11:30:22 AM,Host Communities,9607,10523,12352,13268,45750,9607,10523,12352,13268,45750
62,Syria,2021,SYR-21/DDA-3558/SA1/FSA/UN/19542,2/27/2023 11:30:22 AM,Internally Displaced People,4725,5175,6075,6525,22500,4725,5175,6075,6525,22500
62,Syria,2021,SYR-21/DDA-3558/SA1/FSA/UN/19542,2/27/2023 11:30:22 AM,Overall,15749,17251,20249,21751,75000,15749,17251,20249,21751,75000
62,Syria,2021,SYR-21/DDA-3558/SA1/FSA/UN/19542,2/27/2023 11:30:22 AM,Returnees,1417,1553,1822,1958,6750,1417,1553,1822,1958,6750
62,Syria,2021,SYR-21/DDA-3558/SA1/FSA/UN/19606,11/14/2022 11:23:53 AM,Overall,12826,15020,6417,6184,40447,12668,14715,6542,6525,40450
62,Syria,2021,SYR-21/DDA-3558/SA1/FSA/UN/19606,11/14/2022 11:23:53 AM,Refugees,12826,15020,6417,6184,40447,12668,14715,6542,6525,40450
62,Syria,2021,SYR-21/DDA-3558/SA1/FSA/UN/19614,5/2/2023 6:15:59 PM,Host Communities,9135,9765,6300,6300,31500,9135,9765,6300,6300,31500
62,Syria,2021,SYR-21/DDA-3558/SA1/FSA/UN/19614,5/2/2023 6:15:59 PM,Overall,18270,19530,12600,12600,63000,18270,19530,12600,12600,63000
62,Syria,2021,SYR-21/DDA-3558/SA1/FSA/UN/19614,5/2/2023 6:15:59 PM,Returnees,9135,9765,6300,6300,31500,9135,9765,6300,6300,31500
62,Syria,2021,SYR-21/DDA-3558/SA1/H/INGO/19274,11/30/2022 12:46:48 PM,Host Communities,19503,21205,16028,17381,74117,20197,22593,17185,18769,78744
62,Syria,2021,SYR-21/DDA-3558/SA1/H/INGO/19274,11/30/2022 12:46:48 PM,Internally Displaced People,1531,1659,1253,1356,5799,1185,967,677,664,3493
62,Syria,2021,SYR-21/DDA-3558/SA1/H/INGO/19274,11/30/2022 12:46:48 PM,Overall,25480,28379,21566,23525,98950,26465,30010,22897,25083,104455
62,Syria,2021,SYR-21/DDA-3558/SA1/H/INGO/19274,11/30/2022 12:46:48 PM,Returnees,4446,5515,4285,4788,19034,5083,6450,5035,5650,22218
62,Syria,2021,SYR-21/DDA-3558/SA1/H/INGO/19387,8/17/2022 7:57:29 AM,Host Communities,1011,1489,478,470,3448,474,1577,936,995,3982
62,Syria,2021,SYR-21/DDA-3558/SA1/H/INGO/19387,8/17/2022 7:57:29 AM,Internally Displaced People,6,14,1,5,26,6,55,30,24,115
62,Syria,2021,SYR-21/DDA-3558/SA1/H/INGO/19387,8/17/2022 7:57:29 AM,Overall,1379,2311,623,602,4915,782,2733,1388,1454,6357
62,Syria,2021,SYR-21/DDA-3558/SA1/H/INGO/19387,8/17/2022 7:57:29 AM,Refugees,1,5,1,2,9,2,12,5,9,28
62,Syria,2021,SYR-21/DDA-3558/SA1/H/INGO/19387,8/17/2022 7:57:29 AM,Returnees,361,803,143,125,1432,300,1089,417,426,2232
62,Syria,2021,SYR-21/DDA-3558/SA1/H/NGO/19315,7/17/2022 9:21:18 AM,Host Communities,8000,31000,10000,10100,59100,9097,34465,10544,11266,65372
62,Syria,2021,SYR-21/DDA-3558/SA1/H/NGO/19315,7/17/2022 9:21:18 AM,Internally Displaced People,6091,23000,7000,8000,44091,6002,22854,6985,7468,43309
62,Syria,2021,SYR-21/DDA-3558/SA1/H/NGO/19315,7/17/2022 9:21:18 AM,Overall,19091,64000,22000,25100,130191,18591,70335,21666,22940,133532
62,Syria,2021,SYR-21/DDA-3558/SA1/H/NGO/19315,7/17/2022 9:21:18 AM,Returnees,5000,10000,5000,7000,27000,3492,13016,4137,4206,24851
62,Syria,2021,SYR-21/DDA-3558/SA1/H/NGO/19433,2/5/2023 12:19:01 PM,Internally Displaced People,895,1434,321,300,2950,725,3102,607,596,5030
62,Syria,2021,SYR-21/DDA-3558/SA1/H/NGO/19433,2/5/2023 12:19:01 PM,Overall,8949,14337,3211,3033,29530,5571,22531,3923,4129,36154
62,Syria,2021,SYR-21/DDA-3558/SA1/H/NGO/19433,2/5/2023 12:19:01 PM,Returnees,8054,12903,2890,2733,26580,4846,19429,3316,3533,31124
62,Syria,2021,SYR-21/DDA-3558/SA1/H/NGO/19492,9/7/2022 7:18:03 AM,Host Communities,27,25,23,25,100,49,163,69,43,324
62,Syria,2021,SYR-21/DDA-3558/SA1/H/NGO/19492,9/7/2022 7:18:03 AM,Internally Displaced People,208,589,82,113,992,161,553,242,153,1109
62,Syria,2021,SYR-21/DDA-3558/SA1/H/NGO/19492,9/7/2022 7:18:03 AM,Overall,235,614,105,138,1092,210,716,311,196,1433
62,Syria,2021,SYR-21/DDA-3558/SA1/H/NGO/19493,4/20/2023 6:55:13 AM,Internally Displaced People,9000,15400,10500,8000,42900,2888,20652,18907,3854,46301
62,Syria,2021,SYR-21/DDA-3558/SA1/H/NGO/19493,4/20/2023 6:55:13 AM,Overall,9000,15400,10500,8000,42900,2888,20652,18907,3854,46301
62,Syria,2021,SYR-21/DDA-3558/SA1/H/NGO/19499,9/25/2022 11:19:51 AM,Host Communities,1900,3040,1520,1140,7600,1944,3612,1207,880,7643
62,Syria,2021,SYR-21/DDA-3558/SA1/H/NGO/19499,9/25/2022 11:19:51 AM,Internally Displaced People,862,1380,690,518,3450,894,1687,579,458,3618
62,Syria,2021,SYR-21/DDA-3558/SA1/H/NGO/19499,9/25/2022 11:19:51 AM,Overall,4999,8000,4000,3001,20000,5056,8632,2634,2127,18449
62,Syria,2021,SYR-21/DDA-3558/SA1/H/NGO/19499,9/25/2022 11:19:51 AM,Returnees,2237,3580,1790,1343,8950,2218,3333,848,789,7188
62,Syria,2021,SYR-21/DDA-3558/SA1/H/NGO/19516,7/3/2023 8:23:03 AM,Host Communities,980,5960,1950,1800,10690,1275,7725,2990,2191,14181
62,Syria,2021,SYR-21/DDA-3558/SA1/H/NGO/19516,7/3/2023 8:23:03 AM,Internally Displaced People,300,700,350,950,2300,240,485,256,702,1683
62,Syria,2021,SYR-21/DDA-3558/SA1/H/NGO/19516,7/3/2023 8:23:03 AM,Overall,3730,11660,4950,6160,26500,2935,13779,5380,5447,27541
62,Syria,2021,SYR-21/DDA-3558/SA1/H/NGO/19516,7/3/2023 8:23:03 AM,Returnees,2450,5000,2650,3410,13510,1420,5569,2134,2554,11677
62,Syria,2021,SYR-21/DDA-3558/SA1/H/NGO/19586,10/24/2022 1:20:27 PM,Host Communities,208,395,98,95,796,436,122,38,21,617
62,Syria,2021,SYR-21/DDA-3558/SA1/H/NGO/19586,10/24/2022 1:20:27 PM,Internally Displaced People,70,109,55,42,276,301,261,71,51,684
62,Syria,2021,SYR-21/DDA-3558/SA1/H/NGO/19586,10/24/2022 1:20:27 PM,Overall,388,709,258,202,1557,863,1018,909,133,2923
62,Syria,2021,SYR-21/DDA-3558/SA1/H/NGO/19586,10/24/2022 1:20:27 PM,Returnees,110,205,105,65,485,126,635,800,61,1622
62,Syria,2021,SYR-21/DDA-3558/SA1/H/NGO/19663,12/29/2022 6:33:15 AM,Host Communities,4232,8465,4232,4232,21161,10014,18738,2744,2435,33931
62,Syria,2021,SYR-21/DDA-3558/SA1/H/NGO/19663,12/29/2022 6:33:15 AM,Internally Displaced People,2279,4558,2279,2279,11395,2226,3485,1598,1579,8888
62,Syria,2021,SYR-21/DDA-3558/SA1/H/NGO/19663,12/29/2022 6:33:15 AM,Overall,6511,13023,6511,6511,32556,12240,22223,4342,4014,42819
62,Syria,2021,SYR-21/DDA-3558/SA1/H/NGO/19718,11/2/2022 7:56:20 AM,Host Communities,1650,1650,1100,1000,5400,1892,1612,885,980,5369
62,Syria,2021,SYR-21/DDA-3558/SA1/H/NGO/19718,11/2/2022 7:56:20 AM,Internally Displaced People,900,995,650,650,3195,946,806,440,490,2682
62,Syria,2021,SYR-21/DDA-3558/SA1/H/NGO/19718,11/2/2022 7:56:20 AM,Other,620,430,200,150,1400,707,602,331,365,2005
62,Syria,2021,SYR-21/DDA-3558/SA1/H/NGO/19718,11/2/2022 7:56:20 AM,Overall,4220,3725,2400,2150,12495,4730,4030,2206,2450,13416
62,Syria,2021,SYR-21/DDA-3558/SA1/H/NGO/19718,11/2/2022 7:56:20 AM,Returnees,1050,650,450,350,2500,1185,1010,550,615,3360
62,Syria,2021,SYR-21/DDA-3558/SA1/H/NGO/19727,10/16/2023 7:28:11 AM,Host Communities,200,196,413,391,1200,297,303,511,486,1597
62,Syria,2021,SYR-21/DDA-3558/SA1/H/NGO/19727,10/16/2023 7:28:11 AM,Internally Displaced People,320,1095,73,100,1588,350,1135,74,100,1659
62,Syria,2021,SYR-21/DDA-3558/SA1/H/NGO/19727,10/16/2023 7:28:11 AM,Overall,530,1371,496,501,2898,658,1526,590,592,3366
62,Syria,2021,SYR-21/DDA-3558/SA1/H/NGO/19727,10/16/2023 7:28:11 AM,Refugees,10,80,10,10,110,11,88,5,6,110
62,Syria,2021,SYR-21/DDA-3558/SA1/H/UN/19340,10/26/2022 10:01:46 AM,Host Communities,0,0,500000,500000,1000000,0,0,495000,495000,990000
62,Syria,2021,SYR-21/DDA-3558/SA1/H/UN/19340,10/26/2022 10:01:46 AM,Internally Displaced People,0,0,700000,700000,1400000,0,0,600000,600000,1200000
62,Syria,2021,SYR-21/DDA-3558/SA1/H/UN/19340,10/26/2022 10:01:46 AM,Overall,0,0,1400000,1400000,2800000,0,0,1225130,1225125,2450255
62,Syria,2021,SYR-21/DDA-3558/SA1/H/UN/19340,10/26/2022 10:01:46 AM,Returnees,0,0,200000,200000,400000,0,0,130130,130125,260255
62,Syria,2021,SYR-21/DDA-3558/SA1/H/UN/19373,12/4/2022 11:44:15 AM,Host Communities,46499,51520,48602,43007,189628,86008,65356,38006,85367,274737
62,Syria,2021,SYR-21/DDA-3558/SA1/H/UN/19373,12/4/2022 11:44:15 AM,Internally Displaced People,10407,12305,10612,9102,42426,5892,6073,2855,7897,22717
62,Syria,2021,SYR-21/DDA-3558/SA1/H/UN/19373,12/4/2022 11:44:15 AM,Overall,56906,63825,59214,52109,232054,91900,71429,40861,93264,297454
62,Syria,2021,SYR-21/DDA-3558/SA1/H/UN/19677,11/30/2022 12:33:59 PM,Overall,136406,158912,66419,64039,425776,128266,150473,70436,68632,417807
62,Syria,2021,SYR-21/DDA-3558/SA1/H/UN/19677,11/30/2022 12:33:59 PM,Refugees,136406,158912,66419,64039,425776,128266,150473,70436,68632,417807
62,Syria,2021,SYR-21/DDA-3558/SA1/H/UN/19748,12/13/2022 6:06:58 PM,Other,350,18000,500,4000,22850,0,2610,0,159,2769
62,Syria,2021,SYR-21/DDA-3558/SA1/H/UN/19748,12/13/2022 6:06:58 PM,Overall,350,18000,500,4000,22850,0,2610,0,159,2769
62,Syria,2021,SYR-21/DDA-3558/SA1/N/NGO/19745,8/27/2023 11:59:20 AM,Host Communities,0,6141,1714,1916,9771,0,6544,1975,2196,10715
62,Syria,2021,SYR-21/DDA-3558/SA1/N/NGO/19745,8/27/2023 11:59:20 AM,Internally Displaced People,0,200,100,100,400,0,67,21,15,103
62,Syria,2021,SYR-21/DDA-3558/SA1/N/NGO/19745,8/27/2023 11:59:20 AM,Overall,0,6691,1939,2141,10771,0,6940,2107,2305,11352
62,Syria,2021,SYR-21/DDA-3558/SA1/N/NGO/19745,8/27/2023 11:59:20 AM,Returnees,0,350,125,125,600,0,329,111,94,534
62,Syria,2021,SYR-21/DDA-3558/SA1/N/UN/19336,1/23/2023 9:41:59 AM,Host Communities,0,29932,33305,33342,96579,0,35137,33699,51246,120082
62,Syria,2021,SYR-21/DDA-3558/SA1/N/UN/19336,1/23/2023 9:41:59 AM,Internally Displaced People,0,14513,16148,16166,46827,0,10535,10009,16057,36601
62,Syria,2021,SYR-21/DDA-3558/SA1/N/UN/19336,1/23/2023 9:41:59 AM,Overall,0,45352,50462,50518,146332,0,47654,45262,69979,162895
62,Syria,2021,SYR-21/DDA-3558/SA1/N/UN/19336,1/23/2023 9:41:59 AM,Returnees,0,907,1009,1010,2926,0,1982,1554,2676,6212
62,Syria,2021,SYR-21/DDA-3558/SA1/P/INGO/19284,3/19/2023 10:47:32 AM,Internally Displaced People,0,0,7,6,13,0,16,6,9,31
62,Syria,2021,SYR-21/DDA-3558/SA1/P/INGO/19284,3/19/2023 10:47:32 AM,Other,5,20,0,0,25,13,20,0,0,33
62,Syria,2021,SYR-21/DDA-3558/SA1/P/INGO/19284,3/19/2023 10:47:32 AM,Overall,5,140,494,441,1080,13,169,358,500,1040
62,Syria,2021,SYR-21/DDA-3558/SA1/P/INGO/19284,3/19/2023 10:47:32 AM,Returnees,0,120,487,435,1042,0,133,352,491,976
62,Syria,2021,SYR-21/DDA-3558/SA1/P/INGO/19623,12/27/2022 7:20:15 AM,Host Communities,1202,2356,2243,2329,8130,36,535,938,1415,2924
62,Syria,2021,SYR-21/DDA-3558/SA1/P/INGO/19623,12/27/2022 7:20:15 AM,Internally Displaced People,135,265,252,262,914,27,112,178,273,590
62,Syria,2021,SYR-21/DDA-3558/SA1/P/INGO/19623,12/27/2022 7:20:15 AM,Overall,1351,2647,2520,2616,9134,160,1622,3855,6263,11900
62,Syria,2021,SYR-21/DDA-3558/SA1/P/INGO/19623,12/27/2022 7:20:15 AM,Returnees,14,26,25,25,90,97,975,2739,4575,8386
62,Syria,2021,SYR-21/DDA-3558/SA1/P/INGO/19646,1/20/2023 5:09:48 PM,Host Communities,86,282,163,191,722,26,284,274,193,777
62,Syria,2021,SYR-21/DDA-3558/SA1/P/INGO/19646,1/20/2023 5:09:48 PM,Internally Displaced People,86,282,163,191,722,236,367,339,356,1298
62,Syria,2021,SYR-21/DDA-3558/SA1/P/INGO/19646,1/20/2023 5:09:48 PM,Overall,430,1409,816,955,3610,568,1891,1298,1588,5345
62,Syria,2021,SYR-21/DDA-3558/SA1/P/INGO/19646,1/20/2023 5:09:48 PM,Returnees,258,845,490,573,2166,306,1240,685,1039,3270
62,Syria,2021,SYR-21/DDA-3558/SA1/P/NGO/19648,3/15/2023 8:28:58 AM,Host Communities,0,10575,6000,9000,25575,0,16741,6200,9749,32690
62,Syria,2021,SYR-21/DDA-3558/SA1/P/NGO/19648,3/15/2023 8:28:58 AM,Internally Displaced People,0,3525,2000,3000,8525,0,7174,1923,2436,11533
62,Syria,2021,SYR-21/DDA-3558/SA1/P/NGO/19648,3/15/2023 8:28:58 AM,Overall,0,14100,8000,12000,34100,0,23915,8123,12185,44223
62,Syria,2021,SYR-21/DDA-3558/SA1/P/NGO/19715,3/14/2023 7:45:57 AM,Overall,890,2485,1600,2200,7175,923,2633,1648,2275,7479
62,Syria,2021,SYR-21/DDA-3558/SA1/P/NGO/19715,3/14/2023 7:45:57 AM,Returnees,890,2485,1600,2200,7175,923,2633,1648,2275,7479
62,Syria,2021,SYR-21/DDA-3558/SA1/P/UN/19563,6/5/2022 8:51:22 AM,Host Communities,106244,124751,118816,110463,460274,1404,1463,1053,687,4607
62,Syria,2021,SYR-21/DDA-3558/SA1/P/UN/19563,6/5/2022 8:51:22 AM,Internally Displaced People,18627,20814,19926,18655,78022,0,0,0,0,0
62,Syria,2021,SYR-21/DDA-3558/SA1/P/UN/19563,6/5/2022 8:51:22 AM,Overall,125357,146094,139205,129521,540177,1404,1463,1053,687,4607
62,Syria,2021,SYR-21/DDA-3558/SA1/P/UN/19563,6/5/2022 8:51:22 AM,Returnees,486,529,463,403,1881,0,0,0,0,0
62,Syria,2021,SYR-21/DDA-3558/SA1/P/UN/19759,2/7/2023 7:09:53 AM,Host Communities,69,3417,15,258,3759,62,3611,13,276,3962
62,Syria,2021,SYR-21/DDA-3558/SA1/P/UN/19759,2/7/2023 7:09:53 AM,Internally Displaced People,182,9367,45,696,10290,163,9717,35,744,10659
62,Syria,2021,SYR-21/DDA-3558/SA1/P/UN/19759,2/7/2023 7:09:53 AM,Overall,300,15164,75,1136,16675,267,15703,56,1204,17230
62,Syria,2021,SYR-21/DDA-3558/SA1/P/UN/19759,2/7/2023 7:09:53 AM,Returnees,49,2380,15,182,2626,42,2375,8,184,2609
62,Syria,2021,SYR-21/DDA-3558/SA1/S/NFI/INGO/19377,5/9/2023 9:31:51 AM,Overall,158,201,124,158,641,151,173,101,128,553
62,Syria,2021,SYR-21/DDA-3558/SA1/S/NFI/INGO/19377,5/9/2023 9:31:51 AM,Returnees,158,201,124,158,641,151,173,101,128,553
62,Syria,2021,SYR-21/DDA-3558/SA1/S/NFI/INGO/19521,7/5/2022 12:23:02 PM,Host Communities,500,700,1400,1700,4300,368,462,395,338,1563
62,Syria,2021,SYR-21/DDA-3558/SA1/S/NFI/INGO/19521,7/5/2022 12:23:02 PM,Internally Displaced People,200,300,800,1000,2300,350,405,253,246,1254
62,Syria,2021,SYR-21/DDA-3558/SA1/S/NFI/INGO/19521,7/5/2022 12:23:02 PM,Overall,1100,1450,2700,3250,8500,2160,2479,2202,2041,8882
62,Syria,2021,SYR-21/DDA-3558/SA1/S/NFI/INGO/19521,7/5/2022 12:23:02 PM,Returnees,400,450,500,550,1900,1442,1612,1554,1457,6065
62,Syria,2021,SYR-21/DDA-3558/SA1/S/NFI/INGO/19558,1/23/2023 10:29:36 AM,Overall,266,217,177,325,985,269,218,179,326,992
62,Syria,2021,SYR-21/DDA-3558/SA1/S/NFI/INGO/19558,1/23/2023 10:29:36 AM,Returnees,266,217,177,325,985,269,218,179,326,992
62,Syria,2021,SYR-21/DDA-3558/SA1/S/NFI/INGO/19744,2/15/2023 12:46:08 PM,Host Communities,988,1821,1517,1855,6181,0,0,0,0,0
62,Syria,2021,SYR-21/DDA-3558/SA1/S/NFI/INGO/19744,2/15/2023 12:46:08 PM,Internally Displaced People,8,12,13,20,53,32,59,49,60,200
62,Syria,2021,SYR-21/DDA-3558/SA1/S/NFI/INGO/19744,2/15/2023 12:46:08 PM,Overall,1306,2405,2006,2458,8175,2848,5237,4371,5344,17800
62,Syria,2021,SYR-21/DDA-3558/SA1/S/NFI/INGO/19744,2/15/2023 12:46:08 PM,Returnees,310,572,476,583,1941,2816,5178,4322,5284,17600
62,Syria,2021,SYR-21/DDA-3558/SA1/S/NFI/NGO/19393,4/19/2023 8:00:55 AM,Overall,155,155,232,233,775,155,155,232,233,775
62,Syria,2021,SYR-21/DDA-3558/SA1/S/NFI/NGO/19393,4/19/2023 8:00:55 AM,Returnees,155,155,232,233,775,155,155,232,233,775
62,Syria,2021,SYR-21/DDA-3558/SA1/S/NFI/NGO/19618,10/26/2022 8:12:05 AM,Host Communities,0,0,1000,1500,2500,0,0,1580,1960,3540
62,Syria,2021,SYR-21/DDA-3558/SA1/S/NFI/NGO/19618,10/26/2022 8:12:05 AM,Internally Displaced People,0,0,1000,1500,2500,0,0,1790,1983,3773
62,Syria,2021,SYR-21/DDA-3558/SA1/S/NFI/NGO/19618,10/26/2022 8:12:05 AM,Overall,0,0,4900,6500,11400,0,0,7260,8303,15563
62,Syria,2021,SYR-21/DDA-3558/SA1/S/NFI/NGO/19618,10/26/2022 8:12:05 AM,Returnees,0,0,2900,3500,6400,0,0,3890,4360,8250
62,Syria,2021,SYR-21/DDA-3558/SA1/S/NFI/NGO/19750,8/11/2022 9:58:49 AM,Host Communities,630,770,1260,1540,4200,630,770,1310,1620,4330
62,Syria,2021,SYR-21/DDA-3558/SA1/S/NFI/NGO/19750,8/11/2022 9:58:49 AM,Internally Displaced People,270,330,540,660,1800,270,330,580,706,1886
62,Syria,2021,SYR-21/DDA-3558/SA1/S/NFI/NGO/19750,8/11/2022 9:58:49 AM,Overall,900,1100,1800,2200,6000,900,1100,1890,2326,6216
62,Syria,2021,SYR-21/DDA-3558/SA1/S/NFI/UN/19508,2/23/2023 9:45:37 AM,Overall,1800,2200,3000,3000,10000,1800,2200,3000,3000,10000
62,Syria,2021,SYR-21/DDA-3558/SA1/S/NFI/UN/19508,2/23/2023 9:45:37 AM,Returnees,1800,2200,3000,3000,10000,1800,2200,3000,3000,10000
62,Syria,2021,SYR-21/DDA-3558/SA1/S/NFI/UN/19615,11/17/2022 10:56:53 AM,Internally Displaced People,772,895,741,679,3087,798,1091,885,905,3679
62,Syria,2021,SYR-21/DDA-3558/SA1/S/NFI/UN/19615,11/17/2022 10:56:53 AM,Overall,1544,1790,1482,1359,6175,1821,2332,1497,1653,7303
62,Syria,2021,SYR-21/DDA-3558/SA1/S/NFI/UN/19615,11/17/2022 10:56:53 AM,Returnees,772,895,741,680,3088,1023,1241,612,748,3624
62,Syria,2021,SYR-21/DDA-3558/SA1/WASH/INGO/19276,4/26/2023 9:26:12 PM,Host Communities,7321,7876,6685,5957,27839,8068,8743,7403,6615,30829
62,Syria,2021,SYR-21/DDA-3558/SA1/WASH/INGO/19276,4/26/2023 9:26:12 PM,Internally Displaced People,3905,4282,3605,3228,15020,4693,5197,4362,3921,18173
62,Syria,2021,SYR-21/DDA-3558/SA1/WASH/INGO/19276,4/26/2023 9:26:12 PM,Overall,11870,13370,11298,10370,46908,13443,15196,12809,11754,53202
62,Syria,2021,SYR-21/DDA-3558/SA1/WASH/INGO/19276,4/26/2023 9:26:12 PM,Returnees,644,1212,1008,1185,4049,682,1256,1044,1218,4200
62,Syria,2021,SYR-21/DDA-3558/SA1/WASH/INGO/19380,2/4/2023 7:56:31 PM,Host Communities,5474,5474,8210,8210,27368,8045,8971,7733,6188,30937
62,Syria,2021,SYR-21/DDA-3558/SA1/WASH/INGO/19380,2/4/2023 7:56:31 PM,Internally Displaced People,917,917,1376,1376,4586,223,248,214,170,855
62,Syria,2021,SYR-21/DDA-3558/SA1/WASH/INGO/19380,2/4/2023 7:56:31 PM,Overall,6400,6400,9600,9600,32000,8411,9377,8084,6468,32340
62,Syria,2021,SYR-21/DDA-3558/SA1/WASH/INGO/19380,2/4/2023 7:56:31 PM,Returnees,9,9,14,14,46,143,158,137,110,548
62,Syria,2021,SYR-21/DDA-3558/SA1/WASH/INGO/19438,2/7/2023 10:47:41 AM,Host Communities,6376,5407,4683,8110,24576,7783,6586,5690,9880,29939
62,Syria,2021,SYR-21/DDA-3558/SA1/WASH/INGO/19438,2/7/2023 10:47:41 AM,Internally Displaced People,1328,1126,976,1690,5120,1561,1321,1139,1980,6001
62,Syria,2021,SYR-21/DDA-3558/SA1/WASH/INGO/19438,2/7/2023 10:47:41 AM,Overall,13283,11264,9757,16896,51200,16437,14223,11959,20481,63100
62,Syria,2021,SYR-21/DDA-3558/SA1/WASH/INGO/19438,2/7/2023 10:47:41 AM,Returnees,5579,4731,4098,7096,21504,7093,6316,5130,8621,27160
62,Syria,2021,SYR-21/DDA-3558/SA1/WASH/INGO/19571,2/4/2023 8:47:16 PM,Host Communities,3392,4465,6819,6377,21053,3314,4262,6425,7337,21338
62,Syria,2021,SYR-21/DDA-3558/SA1/WASH/INGO/19571,2/4/2023 8:47:16 PM,Internally Displaced People,81,107,163,152,503,68,88,132,151,439
62,Syria,2021,SYR-21/DDA-3558/SA1/WASH/INGO/19571,2/4/2023 8:47:16 PM,Overall,3536,4655,7108,6644,21943,3416,4395,6623,7565,21999
62,Syria,2021,SYR-21/DDA-3558/SA1/WASH/INGO/19571,2/4/2023 8:47:16 PM,Returnees,63,83,126,115,387,34,45,66,77,222
62,Syria,2021,SYR-21/DDA-3558/SA1/WASH/INGO/19673,4/28/2023 1:08:13 PM,Host Communities,67457,79087,46523,39543,232610,36063,43909,29775,24546,134293
62,Syria,2021,SYR-21/DDA-3558/SA1/WASH/INGO/19673,4/28/2023 1:08:13 PM,Internally Displaced People,2841,3331,1959,1665,9796,1519,1849,1254,1715,6337
62,Syria,2021,SYR-21/DDA-3558/SA1/WASH/INGO/19673,4/28/2023 1:08:13 PM,Overall,71008,83251,48971,41625,244855,37961,46220,31341,26525,142047
62,Syria,2021,SYR-21/DDA-3558/SA1/WASH/INGO/19673,4/28/2023 1:08:13 PM,Returnees,710,833,489,417,2449,379,462,312,264,1417
62,Syria,2021,SYR-21/DDA-3558/SA1/WASH/INGO/19698,2/5/2023 7:53:52 AM,Host Communities,1476,1879,1543,1812,6710,1476,1879,1543,1812,6710
62,Syria,2021,SYR-21/DDA-3558/SA1/WASH/INGO/19698,2/5/2023 7:53:52 AM,Internally Displaced People,2281,2904,2385,2800,10370,2281,2904,2385,2800,10370
62,Syria,2021,SYR-21/DDA-3558/SA1/WASH/INGO/19698,2/5/2023 7:53:52 AM,Overall,6709,8541,7015,8235,30500,6709,8541,7015,8235,30500
62,Syria,2021,SYR-21/DDA-3558/SA1/WASH/INGO/19698,2/5/2023 7:53:52 AM,Returnees,2952,3758,3087,3623,13420,2952,3758,3087,3623,13420
62,Syria,2021,SYR-21/DDA-3558/SA1/WASH/INGO/19749,2/26/2023 12:16:54 PM,Overall,9200,10800,7600,12400,40000,9708,11397,8020,13085,42210
62,Syria,2021,SYR-21/DDA-3558/SA1/WASH/INGO/19749,2/26/2023 12:16:54 PM,Returnees,9200,10800,7600,12400,40000,9708,11397,8020,13085,42210
62,Syria,2021,SYR-21/DDA-3558/SA1/WASH/UN/19400,2/28/2023 12:25:45 PM,Host Communities,20117,23537,17117,19935,80706,20117,23537,17117,19935,80706
62,Syria,2021,SYR-21/DDA-3558/SA1/WASH/UN/19400,2/28/2023 12:25:45 PM,Internally Displaced People,12502,14939,12187,14365,53993,12502,14939,12187,14365,53993
62,Syria,2021,SYR-21/DDA-3558/SA1/WASH/UN/19400,2/28/2023 12:25:45 PM,Overall,32619,38476,29304,34300,134699,32619,38476,29304,34300,134699
62,Syria,2022,SYR-22/DDA-3558/RA1/WASH/INGO/23703,8/21/2023 6:43:35 AM,Host Communities,9185,16099,10416,5067,40767,10417,18260,11813,5747,46237
62,Syria,2022,SYR-22/DDA-3558/RA1/WASH/INGO/23703,8/21/2023 6:43:35 AM,Internally Displaced People,7037,12334,7980,3882,31233,7981,13988,9051,4403,35423
62,Syria,2022,SYR-22/DDA-3558/RA1/WASH/INGO/23703,8/21/2023 6:43:35 AM,Overall,16222,28433,18396,8949,72000,18398,32248,20864,10150,81660
62,Syria,2022,SYR-22/DDA-3558/RA1/WASH/INGO/23760,9/3/2023 5:26:28 AM,Host Communities,4940,5700,4180,4180,19000,4940,5700,4180,4180,19000
62,Syria,2022,SYR-22/DDA-3558/RA1/WASH/INGO/23760,9/3/2023 5:26:28 AM,Internally Displaced People,260,300,220,220,1000,260,300,220,220,1000
62,Syria,2022,SYR-22/DDA-3558/RA1/WASH/INGO/23760,9/3/2023 5:26:28 AM,Overall,5200,6000,4400,4400,20000,5200,6000,4400,4400,20000
62,Syria,2022,SYR-22/DDA-3558/RA2/S/NFI/INGO/23963,6/5/2023 9:29:42 AM,Host Communities,1881,1974,798,787,5440,1709,1793,698,669,4869
62,Syria,2022,SYR-22/DDA-3558/RA2/S/NFI/INGO/23963,6/5/2023 9:29:42 AM,Internally Displaced People,395,415,160,156,1126,372,427,172,170,1141
62,Syria,2022,SYR-22/DDA-3558/RA2/S/NFI/INGO/23963,6/5/2023 9:29:42 AM,Overall,2434,2555,1022,1005,7016,2655,2793,1155,1137,7740
62,Syria,2022,SYR-22/DDA-3558/RA2/S/NFI/INGO/23963,6/5/2023 9:29:42 AM,Returnees,158,166,64,62,450,574,573,285,298,1730
62,Syria,2022,SYR-22/DDA-3558/RA2/S/NFI/INGO/23984,7/20/2023 6:45:05 AM,Host Communities,0,0,3908,3908,7816,0,0,405,381,786
62,Syria,2022,SYR-22/DDA-3558/RA2/S/NFI/INGO/23984,7/20/2023 6:45:05 AM,Internally Displaced People,0,0,4782,4781,9563,0,0,4558,4545,9103
62,Syria,2022,SYR-22/DDA-3558/RA2/S/NFI/INGO/23984,7/20/2023 6:45:05 AM,Overall,0,0,8810,8809,17619,0,0,8920,8699,17619
62,Syria,2022,SYR-22/DDA-3558/RA2/S/NFI/INGO/23984,7/20/2023 6:45:05 AM,Returnees,0,0,120,120,240,0,0,3957,3773,7730
62,Syria,2022,SYR-22/DDA-3558/RA2/S/NFI/NGO/23968,7/30/2023 1:57:45 PM,Host Communities,3039,4559,4559,6838,18995,3037,4555,4555,6833,18980
62,Syria,2022,SYR-22/DDA-3558/RA2/S/NFI/NGO/23968,7/30/2023 1:57:45 PM,Internally Displaced People,1120,1680,1680,2520,7000,1120,1680,1680,2520,7000
62,Syria,2022,SYR-22/DDA-3558/RA2/S/NFI/NGO/23968,7/30/2023 1:57:45 PM,Overall,4159,6239,6239,9358,25995,4157,6235,6235,9353,25980
62,Syria,2022,SYR-22/DDA-3558/RA2/S/NFI/UN/23905,9/21/2023 7:18:56 AM,Internally Displaced People,2135,2457,2140,1876,8608,2701,3049,2606,2543,10899
62,Syria,2022,SYR-22/DDA-3558/RA2/S/NFI/UN/23905,9/21/2023 7:18:56 AM,Other,1565,1718,2038,2032,7353,973,1237,951,1069,4230
62,Syria,2022,SYR-22/DDA-3558/RA2/S/NFI/UN/23905,9/21/2023 7:18:56 AM,Overall,20562,21307,19977,20941,82787,20859,21811,19809,21043,83522
62,Syria,2022,SYR-22/DDA-3558/RA2/S/NFI/UN/23905,9/21/2023 7:18:56 AM,Refugees,3456,3579,2333,2330,11698,3774,3815,2672,2566,12827
62,Syria,2022,SYR-22/DDA-3558/RA2/S/NFI/UN/23905,9/21/2023 7:18:56 AM,Returnees,13406,13553,13466,14703,55128,13411,13710,13580,14865,55566
62,Syria,2022,SYR-22/DDA-3558/RA2/S/NFI/UN/23960,6/14/2023 7:10:52 AM,Overall,9927,9670,6783,6626,33006,9982,9854,6477,6314,32627
62,Syria,2022,SYR-22/DDA-3558/RA2/S/NFI/UN/23960,6/14/2023 7:10:52 AM,Refugees,9927,9670,6783,6626,33006,9982,9854,6477,6314,32627
62,Syria,2022,SYR-22/DDA-3558/SA1/H/NGO/22929,10/16/2023 7:19:35 AM,Host Communities,2170,3510,1504,2190,9374,2610,4200,1803,2631,11244
62,Syria,2022,SYR-22/DDA-3558/SA1/H/NGO/22929,10/16/2023 7:19:35 AM,Internally Displaced People,245,396,170,245,1056,296,473,204,295,1268
62,Syria,2022,SYR-22/DDA-3558/SA1/H/NGO/22929,10/16/2023 7:19:35 AM,Overall,2415,3906,1674,2435,10430,2906,4673,2007,2926,12512
70,Syria Cross border,2014,TUR-14/CP/CCM/INGO/1125,3/22/2016 9:39:01 AM,Internally Displaced People,18668,18045,13690,11822,62225,22681,21925,16633,14365,75604
70,Syria Cross border,2014,TUR-14/CP/CCM/INGO/1125,3/22/2016 9:39:01 AM,Overall,18668,18045,13690,11822,62225,22681,21925,16633,14365,75604
70,Syria Cross border,2014,TUR-14/CP/E/NGO/1121,8/29/2016 7:09:18 AM,Host Communities,350,527,5498,6444,12819,350,527,5498,6444,12819
70,Syria Cross border,2014,TUR-14/CP/E/NGO/1121,8/29/2016 7:09:18 AM,Internally Displaced People,62,58,971,1137,2228,62,58,971,1137,2228
70,Syria Cross border,2014,TUR-14/CP/E/NGO/1121,8/29/2016 7:09:18 AM,Overall,412,585,6469,7581,15047,412,585,6469,7581,15047
70,Syria Cross border,2014,TUR-14/CP/E/NGO/1127,2/5/2017 10:25:38 AM,Host Communities,125,200,1900,2800,5025,47,68,2068,2953,5136
70,Syria Cross border,2014,TUR-14/CP/E/NGO/1127,2/5/2017 10:25:38 AM,Internally Displaced People,75,100,1100,1200,2475,28,39,1379,1968,3414
70,Syria Cross border,2014,TUR-14/CP/E/NGO/1127,2/5/2017 10:25:38 AM,Overall,200,300,3000,4000,7500,75,107,3447,4921,8550
70,Syria Cross border,2014,TUR-14/CP/FS/INGO/1084,3/16/2016 12:21:22 PM,Host Communities,1075,1575,1075,1175,4900,1458,1756,2219,2440,7873
70,Syria Cross border,2014,TUR-14/CP/FS/INGO/1084,3/16/2016 12:21:22 PM,Internally Displaced People,2000,2500,1700,1500,7700,1920,2242,3116,3257,10535
70,Syria Cross border,2014,TUR-14/CP/FS/INGO/1084,3/16/2016 12:21:22 PM,Overall,3075,4075,2775,2675,12600,3378,3998,5335,5697,18408
70,Syria Cross border,2014,TUR-14/CP/FS/INGO/1100,12/14/2015 9:22:02 AM,Host Communities,400,400,800,800,2400,1180,1180,2360,2360,7080
70,Syria Cross border,2014,TUR-14/CP/FS/INGO/1100,12/14/2015 9:22:02 AM,Internally Displaced People,100,100,200,200,600,295,295,590,590,1770
70,Syria Cross border,2014,TUR-14/CP/FS/INGO/1100,12/14/2015 9:22:02 AM,Overall,500,500,1000,1000,3000,1475,1475,2950,2950,8850
70,Syria Cross border,2014,TUR-14/CP/FS/NGO/1096,2/19/2016 12:29:27 PM,Host Communities,2000,3520,5520,5520,16560,2625,2895,5520,5520,16560
70,Syria Cross border,2014,TUR-14/CP/FS/NGO/1096,2/19/2016 12:29:27 PM,Internally Displaced People,980,1780,2760,2760,8280,1250,1510,2760,2760,8280
70,Syria Cross border,2014,TUR-14/CP/FS/NGO/1096,2/19/2016 12:29:27 PM,Overall,1180,1580,0,0,2760,3875,4405,8280,8280,24840
70,Syria Cross border,2014,TUR-14/CP/FS/NGO/1113,11/5/2016 3:38:39 PM,Host Communities,715,1036,1185,1185,4121,257,437,445,495,1634
70,Syria Cross border,2014,TUR-14/CP/FS/NGO/1113,11/5/2016 3:38:39 PM,Internally Displaced People,273,346,395,395,1409,52,90,100,119,361
70,Syria Cross border,2014,TUR-14/CP/FS/NGO/1113,11/5/2016 3:38:39 PM,Overall,988,1382,1580,1580,5530,309,527,545,614,1995
70,Syria Cross border,2014,TUR-14/CP/FS/NGO/1122,7/11/2016 8:10:55 AM,Host Communities,108,162,216,324,810,302,300,484,1243,2329
70,Syria Cross border,2014,TUR-14/CP/FS/NGO/1122,7/11/2016 8:10:55 AM,Internally Displaced People,12,18,24,36,90,3,5,13,5,26
70,Syria Cross border,2014,TUR-14/CP/FS/NGO/1122,7/11/2016 8:10:55 AM,Overall,120,180,240,360,900,305,305,497,1248,2355
70,Syria Cross border,2014,TUR-14/CP/FS/UN/1095,8/16/2016 1:21:23 PM,Overall,3822,3978,0,0,7800,3022,2905,5905,5775,17607
70,Syria Cross border,2014,TUR-14/CP/H/NGO/1065,9/15/2015 9:30:57 AM,Host Communities,0,2000,900,1000,3900,0,10678,4884,4922,20484
70,Syria Cross border,2014,TUR-14/CP/H/NGO/1065,9/15/2015 9:30:57 AM,Internally Displaced People,0,1100,600,600,2300,0,6029,3254,2774,12057
70,Syria Cross border,2014,TUR-14/CP/H/NGO/1065,9/15/2015 9:30:57 AM,Overall,0,3100,1500,1600,6200,0,16707,8138,7696,32541
70,Syria Cross border,2014,TUR-14/CP/H/NGO/1072,9/22/2016 1:59:31 PM,Host Communities,28654,14732,7402,5438,56226,1312,401,176,71,1960
70,Syria Cross border,2014,TUR-14/CP/H/NGO/1072,9/22/2016 1:59:31 PM,Internally Displaced People,21497,9674,5471,2285,38927,706,216,95,38,1055
70,Syria Cross border,2014,TUR-14/CP/H/NGO/1072,9/22/2016 1:59:31 PM,Overall,947,418,157,74,1596,2018,617,271,109,3015
70,Syria Cross border,2014,TUR-14/CP/H/NGO/1082,9/30/2015 8:14:40 AM,Host Communities,2730,1470,1624,1176,7000,5448,1437,1245,537,8667
70,Syria Cross border,2014,TUR-14/CP/H/NGO/1082,9/30/2015 8:14:40 AM,Internally Displaced People,1170,630,696,504,3000,1769,708,704,321,3502
70,Syria Cross border,2014,TUR-14/CP/H/NGO/1082,9/30/2015 8:14:40 AM,Overall,3900,2100,2320,1680,10000,7217,2145,1949,858,12169
70,Syria Cross border,2014,TUR-14/CP/H/NGO/1101,7/18/2016 7:43:32 AM,Host Communities,0,720,420,300,1440,0,455,270,212,937
70,Syria Cross border,2014,TUR-14/CP/H/NGO/1101,7/18/2016 7:43:32 AM,Internally Displaced People,0,480,280,200,960,0,303,162,148,613
70,Syria Cross border,2014,TUR-14/CP/H/NGO/1101,7/18/2016 7:43:32 AM,Overall,0,1200,700,500,2400,0,758,432,360,1550
70,Syria Cross border,2014,TUR-14/CP/H/NGO/1103,2/16/2016 1:34:55 PM,Host Communities,8008,2710,985,616,12319,6307,2604,484,289,9684
70,Syria Cross border,2014,TUR-14/CP/H/NGO/1103,2/16/2016 1:34:55 PM,Internally Displaced People,3432,1662,423,264,5781,3397,1403,261,157,5218
70,Syria Cross border,2014,TUR-14/CP/H/NGO/1103,2/16/2016 1:34:55 PM,Overall,11440,3872,1408,880,17600,9704,4007,745,446,14902
70,Syria Cross border,2014,TUR-14/CP/H/NGO/1108,10/20/2016 8:35:25 AM,Host Communities,10708,20946,6654,9872,48180,6216,16002,6295,8022,36535
70,Syria Cross border,2014,TUR-14/CP/H/NGO/1108,10/20/2016 8:35:25 AM,Internally Displaced People,7138,13964,4437,6581,32120,4143,11586,4196,5347,25272
70,Syria Cross border,2014,TUR-14/CP/H/NGO/1108,10/20/2016 8:35:25 AM,Overall,17846,34910,11091,16453,80300,10359,27588,10491,13369,61807
70,Syria Cross border,2014,TUR-14/CP/NFI/INGO/1104,3/22/2016 10:06:00 AM,Host Communities,231,231,231,231,924,332,323,685,638,1978
70,Syria Cross border,2014,TUR-14/CP/NFI/INGO/1104,3/22/2016 10:06:00 AM,Internally Displaced People,924,924,924,924,3696,616,599,1272,1184,3671
70,Syria Cross border,2014,TUR-14/CP/NFI/INGO/1104,3/22/2016 10:06:00 AM,Overall,1155,1155,1155,1155,4620,948,922,1957,1822,5649
70,Syria Cross border,2014,TUR-14/CP/NFI/NGO/1120,3/22/2016 12:52:26 PM,Internally Displaced People,14000,14000,27000,29000,84000,13255,15230,25322,31753,85560
70,Syria Cross border,2014,TUR-14/CP/NFI/NGO/1120,3/22/2016 12:52:26 PM,Overall,14000,14000,27000,29000,84000,13255,15230,25322,31753,85560
70,Syria Cross border,2014,TUR-14/CP/NFI/UN/1091,3/21/2016 8:15:33 AM,Internally Displaced People,8000,8000,16000,16000,48000,7190,7190,14383,14384,43147
70,Syria Cross border,2014,TUR-14/CP/NFI/UN/1091,3/21/2016 8:15:33 AM,Overall,8000,8000,16000,16000,48000,7191,7191,14383,14382,43147
70,Syria Cross border,2014,TUR-14/CP/P/NGO/1099,9/15/2016 11:46:08 AM,Host Communities,60,40,800,1200,2100,50,40,800,1200,2090
70,Syria Cross border,2014,TUR-14/CP/P/NGO/1099,9/15/2016 11:46:08 AM,Internally Displaced People,240,160,3200,4800,8400,192,120,3258,4800,8370
70,Syria Cross border,2014,TUR-14/CP/P/NGO/1099,9/15/2016 11:46:08 AM,Overall,300,200,4000,6000,10500,242,160,4058,6000,10460
70,Syria Cross border,2014,TUR-14/CP/P/NGO/1123,7/18/2016 8:55:27 AM,Host Communities,1033,0,0,0,1033,174,708,450,1522,2854
70,Syria Cross border,2014,TUR-14/CP/P/NGO/1123,7/18/2016 8:55:27 AM,Internally Displaced People,1345,0,0,0,1345,276,792,732,1319,3119
70,Syria Cross border,2014,TUR-14/CP/P/NGO/1123,7/18/2016 8:55:27 AM,Overall,29,454,817,1075,2375,450,1500,1182,2841,5973
70,Syria Cross border,2014,TUR-14/CP/WASH/NGO/1079,5/23/2017 9:04:03 AM,Internally Displaced People,2547,3816,3498,5247,15108,2231,2712,3218,4625,12786
70,Syria Cross border,2014,TUR-14/CP/WASH/NGO/1079,5/23/2017 9:04:03 AM,Overall,11740,14654,14088,17618,58100,9262,10238,14335,16165,50000
70,Syria Cross border,2014,TUR-14/CP/WASH/NGO/1102,5/29/2017 10:13:19 AM,Internally Displaced People,1350,2025,1650,2475,7500,1350,2025,1650,2475,7500
70,Syria Cross border,2014,TUR-14/CP/WASH/NGO/1102,5/29/2017 10:13:19 AM,Overall,5130,7695,7270,9405,29500,5130,7695,7270,9405,29500
70,Syria Cross border,2014,TUR-14/CP/WASH/NGO/1114,7/18/2016 2:11:47 PM,Host Communities,33215,32644,8110,8222,82191,29144,31122,6854,7445,74565
70,Syria Cross border,2014,TUR-14/CP/WASH/NGO/1114,7/18/2016 2:11:47 PM,Internally Displaced People,11017,11924,3501,3819,30261,9766,10671,2486,3496,26419
70,Syria Cross border,2014,TUR-14/CP/WASH/NGO/1114,7/18/2016 2:11:47 PM,Overall,44232,44568,11611,12041,112452,38910,41793,9340,10941,100984
70,Syria Cross border,2014,TUR-14/CP/WASH/NGO/1115,8/17/2016 12:03:50 PM,Host Communities,3750,5850,1400,2000,13000,983,1637,1639,2292,6551
70,Syria Cross border,2014,TUR-14/CP/WASH/NGO/1115,8/17/2016 12:03:50 PM,Internally Displaced People,5625,8775,2100,3000,19500,3391,5652,5653,7914,22610
70,Syria Cross border,2014,TUR-14/CP/WASH/NGO/1115,8/17/2016 12:03:50 PM,Overall,9375,14625,3500,5000,32500,4374,7289,7292,10206,29161
70,Syria Cross border,2015,TUR-15/3559/CP/E/INGO/1174,7/18/2016 7:31:30 AM,Internally Displaced People,19,20,600,800,1439,25,12,709,744,1490
70,Syria Cross border,2015,TUR-15/3559/CP/E/INGO/1174,7/18/2016 7:31:30 AM,Overall,19,20,600,800,1439,25,12,709,744,1490
70,Syria Cross border,2015,TUR-15/3559/CP/E/NGO/1187,7/12/2016 11:50:53 AM,Host Communities,147,176,2170,2061,4554,147,176,2170,2061,4554
70,Syria Cross border,2015,TUR-15/3559/CP/E/NGO/1187,7/12/2016 11:50:53 AM,Internally Displaced People,0,0,336,190,526,0,0,336,190,526
70,Syria Cross border,2015,TUR-15/3559/CP/E/NGO/1187,7/12/2016 11:50:53 AM,Overall,157,216,2506,2251,5130,157,216,2506,2251,5130
70,Syria Cross border,2015,TUR-15/3559/CP/E/NGO/1234,3/29/2017 1:39:45 PM,Host Communities,62,63,482,420,1027,23,32,332,306,693
70,Syria Cross border,2015,TUR-15/3559/CP/E/NGO/1234,3/29/2017 1:39:45 PM,Internally Displaced People,6,10,406,351,773,41,41,613,658,1353
70,Syria Cross border,2015,TUR-15/3559/CP/E/NGO/1234,3/29/2017 1:39:45 PM,Overall,68,73,888,771,1800,64,71,945,964,2044
70,Syria Cross border,2015,TUR-15/3559/CP/E/NGO/1256,12/19/2016 9:18:39 AM,Other,15,35,0,0,50,15,35,4059,5262,9371
70,Syria Cross border,2015,TUR-15/3559/CP/E/NGO/1256,12/19/2016 9:18:39 AM,Overall,0,0,4000,5000,9000,15,35,4059,5262,9371
70,Syria Cross border,2015,TUR-15/3559/CP/FS/INGO/1162,12/2/2016 11:08:26 AM,Host Communities,1400,450,3663,5495,11008,2821,3134,4230,5171,15356
70,Syria Cross border,2015,TUR-15/3559/CP/FS/INGO/1162,12/2/2016 11:08:26 AM,Internally Displaced People,153,50,407,610,1220,498,553,746,913,2710
70,Syria Cross border,2015,TUR-15/3559/CP/FS/INGO/1162,12/2/2016 11:08:26 AM,Overall,1535,500,0,0,2035,3318,3687,4977,6084,18066
70,Syria Cross border,2015,TUR-15/3559/CP/FS/INGO/1175,8/26/2016 8:58:14 AM,Host Communities,3963,5596,3296,3480,16335,3501,3723,3655,3299,14178
70,Syria Cross border,2015,TUR-15/3559/CP/FS/INGO/1175,8/26/2016 8:58:14 AM,Internally Displaced People,841,1187,699,738,3465,2128,2906,3671,4065,12770
70,Syria Cross border,2015,TUR-15/3559/CP/FS/INGO/1175,8/26/2016 8:58:14 AM,Overall,4803,6783,3996,4218,19800,5629,6629,7326,7364,26948
70,Syria Cross border,2015,TUR-15/3559/CP/FS/INGO/1188,2/14/2017 7:20:51 AM,Host Communities,1535,1535,2980,2980,9030,3022,3547,4314,3821,14704
70,Syria Cross border,2015,TUR-15/3559/CP/FS/INGO/1188,2/14/2017 7:20:51 AM,Internally Displaced People,709,709,1376,1376,4170,47,57,71,65,240
70,Syria Cross border,2015,TUR-15/3559/CP/FS/INGO/1188,2/14/2017 7:20:51 AM,Overall,2244,2244,4356,4356,13200,3069,3514,4385,3886,14854
70,Syria Cross border,2015,TUR-15/3559/CP/FS/NGO/1160,1/31/2017 5:37:13 AM,Host Communities,0,0,1425,1290,2715,379,123,1877,1225,3604
70,Syria Cross border,2015,TUR-15/3559/CP/FS/NGO/1160,1/31/2017 5:37:13 AM,Overall,377,125,0,0,502,379,123,1877,1225,3604
70,Syria Cross border,2015,TUR-15/3559/CP/FS/NGO/1163,2/13/2017 2:08:32 PM,Host Communities,1642,1825,3650,3650,10767,1596,1774,3548,3548,10466
70,Syria Cross border,2015,TUR-15/3559/CP/FS/NGO/1163,2/13/2017 2:08:32 PM,Internally Displaced People,1787,1467,3685,3685,10624,489,519,1038,1038,3084
70,Syria Cross border,2015,TUR-15/3559/CP/FS/NGO/1163,2/13/2017 2:08:32 PM,Overall,2058,197,0,0,2255,2085,2293,4586,4586,13550
70,Syria Cross border,2015,TUR-15/3559/CP/FS/NGO/1164,7/12/2016 8:50:20 AM,Host Communities,240,160,800,800,2000,144,194,757,1062,2157
70,Syria Cross border,2015,TUR-15/3559/CP/FS/NGO/1164,7/12/2016 8:50:20 AM,Internally Displaced People,60,40,200,200,500,64,98,420,535,1117
70,Syria Cross border,2015,TUR-15/3559/CP/FS/NGO/1164,7/12/2016 8:50:20 AM,Overall,200,300,0,0,500,208,292,1177,1597,3274
70,Syria Cross border,2015,TUR-15/3559/CP/FS/NGO/1192,9/20/2016 6:47:38 AM,Host Communities,3219,3219,4292,4599,15329,7543,7417,5133,4696,24789
70,Syria Cross border,2015,TUR-15/3559/CP/FS/NGO/1192,9/20/2016 6:47:38 AM,Internally Displaced People,0,0,0,0,0,267,271,28,33,599
70,Syria Cross border,2015,TUR-15/3559/CP/FS/NGO/1192,9/20/2016 6:47:38 AM,Overall,3219,3219,4292,4599,15329,7810,7688,5161,4729,25388
70,Syria Cross border,2015,TUR-15/3559/CP/FS/NGO/1196,5/9/2017 11:48:00 AM,Host Communities,0,600,900,1350,2850,1897,446,7056,7068,16467
70,Syria Cross border,2015,TUR-15/3559/CP/FS/NGO/1196,5/9/2017 11:48:00 AM,Internally Displaced People,0,200,300,450,950,45,12,208,216,481
70,Syria Cross border,2015,TUR-15/3559/CP/FS/NGO/1196,5/9/2017 11:48:00 AM,Overall,800,200,0,0,1000,1942,458,7264,7284,16948
70,Syria Cross border,2015,TUR-15/3559/CP/FS/NGO/1214,3/27/2017 8:50:17 AM,Host Communities,14480,16880,24120,24920,80400,14000,16400,18400,20840,69640
70,Syria Cross border,2015,TUR-15/3559/CP/FS/NGO/1214,3/27/2017 8:50:17 AM,Internally Displaced People,3620,4220,6030,6230,20100,3500,4100,4600,5210,17410
70,Syria Cross border,2015,TUR-15/3559/CP/FS/NGO/1214,3/27/2017 8:50:17 AM,Overall,18100,21100,30150,31150,100500,17500,20500,23000,26050,87050
70,Syria Cross border,2015,TUR-15/3559/CP/FS/NGO/1244,9/23/2016 8:50:12 AM,Host Communities,174,126,0,0,300,443,609,471,484,2007
70,Syria Cross border,2015,TUR-15/3559/CP/FS/NGO/1244,9/23/2016 8:50:12 AM,Internally Displaced People,229,141,0,0,370,542,601,483,511,2137
70,Syria Cross border,2015,TUR-15/3559/CP/FS/NGO/1244,9/23/2016 8:50:12 AM,Overall,403,267,0,0,670,985,1210,954,995,4144
70,Syria Cross border,2015,TUR-15/3559/CP/FS/NGO/1260,6/7/2017 11:05:27 AM,Host Communities,200,200,332,278,1010,191,200,332,278,1001
70,Syria Cross border,2015,TUR-15/3559/CP/FS/NGO/1260,6/7/2017 11:05:27 AM,Overall,200,0,0,0,200,191,200,332,278,1001
70,Syria Cross border,2015,TUR-15/3559/CP/FS/UN/1165,4/20/2017 12:08:37 PM,Host Communities,100,100,0,0,200,149,54,0,0,203
70,Syria Cross border,2015,TUR-15/3559/CP/FS/UN/1165,4/20/2017 12:08:37 PM,Internally Displaced People,100,100,0,0,200,151,52,0,0,203
70,Syria Cross border,2015,TUR-15/3559/CP/FS/UN/1165,4/20/2017 12:08:37 PM,Overall,200,200,0,0,400,300,106,0,0,406
70,Syria Cross border,2015,TUR-15/3559/CP/FS/UN/1202,3/22/2018 1:12:23 PM,Host Communities,570,871,0,0,1441,739,69,569,65,1442
70,Syria Cross border,2015,TUR-15/3559/CP/FS/UN/1202,3/22/2018 1:12:23 PM,Internally Displaced People,1071,1570,0,0,2641,955,202,1500,241,2898
70,Syria Cross border,2015,TUR-15/3559/CP/FS/UN/1202,3/22/2018 1:12:23 PM,Overall,1641,2441,0,0,4082,1694,271,2069,306,4340
70,Syria Cross border,2015,TUR-15/3559/CP/H/INGO/1182,2/14/2017 6:51:49 AM,Host Communities,22810,30413,11405,11405,76033,15056,18035,9923,9124,52138
70,Syria Cross border,2015,TUR-15/3559/CP/H/INGO/1182,2/14/2017 6:51:49 AM,Internally Displaced People,5702,7603,2851,2851,19007,3763,4509,2481,3903,14656
70,Syria Cross border,2015,TUR-15/3559/CP/H/INGO/1182,2/14/2017 6:51:49 AM,Overall,28512,38016,14256,14256,95040,18819,22544,12404,13027,66794
70,Syria Cross border,2015,TUR-15/3559/CP/H/INGO/1206,2/14/2017 6:52:42 AM,Host Communities,1000,24666,16666,16666,58998,675,29815,9866,9225,49581
70,Syria Cross border,2015,TUR-15/3559/CP/H/INGO/1206,2/14/2017 6:52:42 AM,Internally Displaced People,500,12334,8334,8334,29502,330,14685,4858,4544,24417
70,Syria Cross border,2015,TUR-15/3559/CP/H/INGO/1206,2/14/2017 6:52:42 AM,Overall,1500,37000,25000,25000,88500,1005,44500,14724,13769,73998
70,Syria Cross border,2015,TUR-15/3559/CP/H/NGO/1153,11/29/2016 12:03:53 PM,Host Communities,0,0,0,0,0,8440,23807,18841,16894,67982
70,Syria Cross border,2015,TUR-15/3559/CP/H/NGO/1153,11/29/2016 12:03:53 PM,Internally Displaced People,0,0,0,0,0,5988,16861,13397,12514,48760
70,Syria Cross border,2015,TUR-15/3559/CP/H/NGO/1153,11/29/2016 12:03:53 PM,Overall,17646,26957,14897,26957,86457,14428,40668,32238,29408,116742
70,Syria Cross border,2015,TUR-15/3559/CP/H/NGO/1171,5/9/2017 10:31:32 AM,Host Communities,49416,74632,26558,37281,187887,40254,22778,9806,9942,82780
70,Syria Cross border,2015,TUR-15/3559/CP/H/NGO/1171,5/9/2017 10:31:32 AM,Internally Displaced People,20184,30368,10978,15423,76953,16442,9304,4006,4061,33813
70,Syria Cross border,2015,TUR-15/3559/CP/H/NGO/1171,5/9/2017 10:31:32 AM,Overall,69600,105000,37536,52704,264840,56696,32082,13812,14003,116593
70,Syria Cross border,2015,TUR-15/3559/CP/H/NGO/1179,5/5/2017 6:56:26 AM,Host Communities,4870,9160,12180,13959,40169,23461,36688,20047,29022,109218
70,Syria Cross border,2015,TUR-15/3559/CP/H/NGO/1179,5/5/2017 6:56:26 AM,Internally Displaced People,4044,9933,14996,15492,44465,16522,24672,12606,18574,72374
70,Syria Cross border,2015,TUR-15/3559/CP/H/NGO/1179,5/5/2017 6:56:26 AM,Overall,8914,19093,27176,29451,84634,39983,61360,32653,47596,181592
70,Syria Cross border,2015,TUR-15/3559/CP/H/NGO/1191,6/15/2017 8:44:11 AM,Host Communities,6930,23170,13804,9996,53900,7110,22225,13254,15892,58481
70,Syria Cross border,2015,TUR-15/3559/CP/H/NGO/1191,6/15/2017 8:44:11 AM,Internally Displaced People,2970,9930,5916,4284,23100,3663,8643,8124,3973,24403
70,Syria Cross border,2015,TUR-15/3559/CP/H/NGO/1191,6/15/2017 8:44:11 AM,Overall,9900,33100,19720,14280,77000,10773,30868,21378,19865,82884
70,Syria Cross border,2015,TUR-15/3559/CP/H/NGO/1223,4/21/2017 11:27:11 AM,Host Communities,12263,24413,12150,12150,60976,11422,12848,9426,8509,42205
70,Syria Cross border,2015,TUR-15/3559/CP/H/NGO/1223,4/21/2017 11:27:11 AM,Internally Displaced People,4087,8137,4050,4050,20324,6745,7588,5566,5023,24922
70,Syria Cross border,2015,TUR-15/3559/CP/H/NGO/1223,4/21/2017 11:27:11 AM,Overall,16350,32550,16200,16200,81300,18167,20436,14992,13532,67127
70,Syria Cross border,2015,TUR-15/3559/CP/H/NGO/1229,10/19/2017 8:07:16 AM,Host Communities,11567,17347,2652,2448,34014,9638,15994,7052,6344,39028
70,Syria Cross border,2015,TUR-15/3559/CP/H/NGO/1229,10/19/2017 8:07:16 AM,Internally Displaced People,5784,8674,1326,1224,17008,6163,11065,4406,3570,25204
70,Syria Cross border,2015,TUR-15/3559/CP/H/NGO/1229,10/19/2017 8:07:16 AM,Overall,17351,26021,3978,3672,51022,15801,27059,11458,9914,64232
70,Syria Cross border,2015,TUR-15/3559/CP/H/NGO/1245,6/15/2017 12:18:28 PM,Overall,2340,2908,1830,1170,8248,3269,3762,1385,1560,9976
70,Syria Cross border,2015,TUR-15/3559/CP/H/NGO/1246,4/21/2017 11:27:04 AM,Host Communities,3375,6615,3240,3240,16470,5341,5486,2340,2555,15722
70,Syria Cross border,2015,TUR-15/3559/CP/H/NGO/1246,4/21/2017 11:27:04 AM,Internally Displaced People,1687,3309,1620,1620,8236,2075,2120,905,988,6088
70,Syria Cross border,2015,TUR-15/3559/CP/H/NGO/1246,4/21/2017 11:27:04 AM,Overall,5063,9923,4860,4860,24706,7416,7606,3245,3543,21810
70,Syria Cross border,2015,TUR-15/3559/CP/H/NGO/1263,11/29/2016 1:02:28 PM,Host Communities,0,13000,2900,2900,18800,0,14264,3726,3902,21892
70,Syria Cross border,2015,TUR-15/3559/CP/H/NGO/1263,11/29/2016 1:02:28 PM,Internally Displaced People,0,7000,1400,1400,9800,0,9508,2484,2601,14593
70,Syria Cross border,2015,TUR-15/3559/CP/H/NGO/1263,11/29/2016 1:02:28 PM,Overall,0,20000,4000,4000,28000,0,23772,6210,6503,36485
70,Syria Cross border,2015,TUR-15/3559/CP/N/INGO/1189,4/7/2017 3:08:48 PM,Host Communities,0,4989,7131,6727,18847,2228,6030,8557,7624,24439
70,Syria Cross border,2015,TUR-15/3559/CP/N/INGO/1189,4/7/2017 3:08:48 PM,Internally Displaced People,0,26,37,35,98,427,963,461,436,2287
70,Syria Cross border,2015,TUR-15/3559/CP/N/INGO/1189,4/7/2017 3:08:48 PM,Overall,0,5015,7168,6762,18945,2655,6993,9018,8060,26726
70,Syria Cross border,2015,TUR-15/3559/CP/N/NGO/1204,5/2/2017 8:42:01 AM,Host Communities,950,50000,16000,16000,82950,1133,27911,24684,24197,77925
70,Syria Cross border,2015,TUR-15/3559/CP/N/NGO/1204,5/2/2017 8:42:01 AM,Internally Displaced People,850,30000,9000,9000,48850,694,17106,15129,14831,47760
70,Syria Cross border,2015,TUR-15/3559/CP/N/NGO/1204,5/2/2017 8:42:01 AM,Overall,1800,80000,25000,25000,131800,1827,45017,39813,39028,125685
70,Syria Cross border,2015,TUR-15/3559/CP/N/NGO/1226,3/28/2017 12:27:11 PM,Host Communities,0,12000,8720,10000,30720,0,14317,8543,8026,30886
70,Syria Cross border,2015,TUR-15/3559/CP/N/NGO/1226,3/28/2017 12:27:11 PM,Internally Displaced People,0,6000,4360,5000,15360,0,6019,3964,4414,14397
70,Syria Cross border,2015,TUR-15/3559/CP/N/NGO/1226,3/28/2017 12:27:11 PM,Overall,0,18000,13500,14580,46080,0,20336,12507,12440,45283
70,Syria Cross border,2015,TUR-15/3559/CP/N/NGO/1232,3/31/2017 1:38:55 PM,Host Communities,0,36520,6120,7480,50120,0,34267,13359,13457,61083
70,Syria Cross border,2015,TUR-15/3559/CP/N/NGO/1232,3/31/2017 1:38:55 PM,Internally Displaced People,0,4565,765,935,6265,0,4600,900,1000,6500
70,Syria Cross border,2015,TUR-15/3559/CP/N/NGO/1232,3/31/2017 1:38:55 PM,Overall,0,0,6885,8415,15300,0,38867,14259,14457,67583
70,Syria Cross border,2015,TUR-15/3559/CP/P/INGO/1166,8/1/2017 7:42:03 AM,Other,0,872,66,770,1708,0,0,0,0,0
70,Syria Cross border,2015,TUR-15/3559/CP/P/INGO/1166,8/1/2017 7:42:03 AM,Overall,0,872,66,770,1708,0,2084,68,380,2532
70,Syria Cross border,2015,TUR-15/3559/CP/P/NGO/1169,2/24/2017 7:14:29 AM,Host Communities,200,500,2500,2500,5700,790,1226,4656,4788,11460
70,Syria Cross border,2015,TUR-15/3559/CP/P/NGO/1169,2/24/2017 7:14:29 AM,Internally Displaced People,300,1000,4500,4500,10300,350,540,2400,2475,5765
70,Syria Cross border,2015,TUR-15/3559/CP/P/NGO/1169,2/24/2017 7:14:29 AM,Overall,500,1500,7000,7000,16000,1140,1766,7056,7263,17225
70,Syria Cross border,2015,TUR-15/3559/CP/P/NGO/1178,1/31/2017 5:39:40 AM,Host Communities,103647,104073,114902,120689,443311,26500,27600,29510,35150,118760
70,Syria Cross border,2015,TUR-15/3559/CP/P/NGO/1178,1/31/2017 5:39:40 AM,Internally Displaced People,44421,44603,49244,51724,189992,15620,11560,14990,15350,57520
70,Syria Cross border,2015,TUR-15/3559/CP/P/NGO/1178,1/31/2017 5:39:40 AM,Overall,148068,148676,164146,172413,633303,42120,39160,44500,50300,176080
70,Syria Cross border,2015,TUR-15/3559/CP/P/NGO/1210,3/30/2017 11:46:33 AM,Host Communities,10244,36641,11873,10863,69621,26261,65432,40600,42110,174403
70,Syria Cross border,2015,TUR-15/3559/CP/P/NGO/1210,3/30/2017 11:46:33 AM,Internally Displaced People,15366,27647,7256,8266,58535,16009,29176,15360,15369,75914
70,Syria Cross border,2015,TUR-15/3559/CP/P/NGO/1210,3/30/2017 11:46:33 AM,Overall,25610,64288,19129,19129,128156,42270,94608,55960,57479,250317
70,Syria Cross border,2015,TUR-15/3559/R/CCM/INGO/2321,7/14/2016 8:32:20 AM,Internally Displaced People,21920,19289,21043,25427,87679,25234,22206,24225,29272,100937
70,Syria Cross border,2015,TUR-15/3559/R/CCM/INGO/2321,7/14/2016 8:32:20 AM,Overall,21920,19289,21043,25427,87679,25234,22206,24225,29272,100937
70,Syria Cross border,2015,TUR-15/3559/R/CCS/INGO/2078,3/7/2018 9:35:59 AM,Overall,0,0,0,0,0,151,46,0,0,197
70,Syria Cross border,2015,TUR-15/3559/R/CCS/UN/1557,5/11/2017 6:28:04 AM,Overall,106,106,0,0,212,200,130,0,0,330
70,Syria Cross border,2015,TUR-15/3559/R/FS/INGO/1279,10/9/2015 12:48:46 PM,Overall,5627,5990,3448,3085,18150,4194,4465,2571,2300,13530
70,Syria Cross border,2015,TUR-15/3559/R/FS/NGO/1274,9/2/2016 7:43:55 AM,Overall,2526,3100,2300,2600,10526,2526,3100,2300,2600,10526
70,Syria Cross border,2015,TUR-15/3559/R/FS/UN/1272,12/10/2015 11:58:37 AM,Host Communities,2151,2261,2737,2878,10027,2490,2617,3169,3331,11607
70,Syria Cross border,2015,TUR-15/3559/R/FS/UN/1272,12/10/2015 11:58:37 AM,Internally Displaced People,19356,20349,24635,25898,90238,22408,23557,28519,29981,104465
70,Syria Cross border,2015,TUR-15/3559/R/FS/UN/1272,12/10/2015 11:58:37 AM,Overall,21507,22610,27372,28776,100265,24897,26174,31688,33313,116072
70,Syria Cross border,2015,TUR-15/3559/R/H/NGO/1268,3/15/2016 9:08:54 AM,Host Communities,1920,480,740,610,3750,6079,2820,2364,1151,12414
70,Syria Cross border,2015,TUR-15/3559/R/H/NGO/1268,3/15/2016 9:08:54 AM,Internally Displaced People,2716,1606,1928,1590,7840,9746,4969,3702,2418,20835
70,Syria Cross border,2015,TUR-15/3559/R/H/NGO/1268,3/15/2016 9:08:54 AM,Overall,4636,2086,2668,2200,11590,15825,7789,6066,3569,33249
70,Syria Cross border,2015,TUR-15/3559/R/H/NGO/1270,1/3/2016 3:25:51 PM,Host Communities,800,900,500,744,2944,765,844,523,750,2882
70,Syria Cross border,2015,TUR-15/3559/R/H/NGO/1270,1/3/2016 3:25:51 PM,Internally Displaced People,4800,5200,5500,4980,20480,4751,5109,5448,4901,20209
70,Syria Cross border,2015,TUR-15/3559/R/H/NGO/1270,1/3/2016 3:25:51 PM,Overall,5600,6100,6000,5724,23424,5503,6002,5976,5610,23091
70,Syria Cross border,2015,TUR-15/3559/R/H/NGO/1278,9/8/2016 1:22:17 PM,Overall,2954,2953,2417,2416,10740,4950,1700,1200,1200,9050
70,Syria Cross border,2015,TUR-15/3559/R/NFI/INGO/1275,12/18/2015 12:16:23 PM,Internally Displaced People,850,850,1700,1700,5100,1131,1131,2261,2261,6784
70,Syria Cross border,2015,TUR-15/3559/R/NFI/INGO/1275,12/18/2015 12:16:23 PM,Overall,850,850,1700,1700,5100,1131,1131,2261,2261,6784
70,Syria Cross border,2015,TUR-15/3559/R/NFI/UN/1269,3/21/2016 3:02:31 PM,Host Communities,1850,1850,3700,3700,11100,0,0,0,0,0
70,Syria Cross border,2015,TUR-15/3559/R/NFI/UN/1269,3/21/2016 3:02:31 PM,Internally Displaced People,1850,1850,3700,3700,11100,3700,3700,7429,7429,22258
70,Syria Cross border,2015,TUR-15/3559/R/NFI/UN/1269,3/21/2016 3:02:31 PM,Overall,3700,3700,7400,7400,22200,3700,3700,7429,7429,22258
70,Syria Cross border,2015,TUR-15/3559/R/P/UN/2290,11/28/2017 11:31:24 AM,Host Communities,152180,147700,89117,87003,476000,16422,63841,782026,841310,1703599
70,Syria Cross border,2015,TUR-15/3559/R/P/UN/2290,11/28/2017 11:31:24 AM,Internally Displaced People,65220,63300,38193,37287,204000,68289,42230,30426,7870,148815
70,Syria Cross border,2015,TUR-15/3559/R/P/UN/2290,11/28/2017 11:31:24 AM,Overall,217400,211000,127310,124290,680000,84711,106071,812452,849180,1852414
70,Syria Cross border,2015,TUR-15/3559/R/WASH/INGO/1277,3/8/2016 8:39:16 AM,Overall,29400,30600,29400,30600,120000,29400,30600,29400,30600,120000
70,Syria Cross border,2015,TUR-15/3559/R/WASH/NGO/1271,3/29/2016 8:24:41 AM,Host Communities,12400,21280,16160,23040,72880,13866,23769,18071,25793,81499
70,Syria Cross border,2015,TUR-15/3559/R/WASH/NGO/1271,3/29/2016 8:24:41 AM,Internally Displaced People,1400,2550,2300,3250,9500,3024,5508,4968,7002,20502
70,Syria Cross border,2015,TUR-15/3559/R/WASH/NGO/1271,3/29/2016 8:24:41 AM,Overall,13800,23830,18460,26290,82380,16890,29277,23039,32795,102001
70,Syria Cross border,2015,TUR-15/3559/RB2/CCM/O/2261,6/7/2017 9:09:02 AM,Internally Displaced People,2000,2000,2500,3500,10000,2000,2000,2500,3500,10000
70,Syria Cross border,2015,TUR-15/3559/RB2/CCM/O/2261,6/7/2017 9:09:02 AM,Overall,2000,2000,2500,3500,10000,2000,2000,2500,3500,10000
70,Syria Cross border,2015,TUR-15/3559/RB2/CCM/UN/2077,4/20/2017 12:03:35 PM,Internally Displaced People,6000,6000,12000,12000,36000,6668,6668,13338,13338,40012
70,Syria Cross border,2015,TUR-15/3559/RB2/CCM/UN/2077,4/20/2017 12:03:35 PM,Overall,6000,6000,12000,12000,36000,6668,6668,13338,13338,40012
70,Syria Cross border,2015,TUR-15/3559/RB2/FS/INGO/2089,8/26/2016 8:44:06 AM,Overall,38871,46275,48977,50976,185099,42383,46147,62251,60337,211118
70,Syria Cross border,2015,TUR-15/3559/RB2/H/UN/2082,6/15/2017 6:38:32 AM,Host Communities,32607,27994,14756,10767,86124,32607,27994,14756,10767,86124
70,Syria Cross border,2015,TUR-15/3559/RB2/H/UN/2082,6/15/2017 6:38:32 AM,Internally Displaced People,8388,7303,4322,5618,25631,8388,7303,4322,5618,25631
70,Syria Cross border,2015,TUR-15/3559/RB2/H/UN/2082,6/15/2017 6:38:32 AM,Overall,34535,35311,20228,19941,110015,34535,35311,20228,19941,110015
70,Syria Cross border,2015,TUR-15/3559/RB2/NFI/INGO/2088,4/18/2017 8:20:13 AM,Internally Displaced People,5376,5376,5376,5376,21504,4829,5881,7068,7593,25371
70,Syria Cross border,2015,TUR-15/3559/RB2/NFI/INGO/2088,4/18/2017 8:20:13 AM,Overall,5376,5376,5376,5376,21504,4829,5881,7068,7593,25371
70,Syria Cross border,2015,TUR-15/3559/RB2/WASH/INGO/2081,9/6/2016 7:08:26 AM,Internally Displaced People,123957,122915,102307,84691,433870,32100,32100,21400,21400,107000
70,Syria Cross border,2015,TUR-15/3559/RB2/WASH/INGO/2081,9/6/2016 7:08:26 AM,Overall,123957,122915,102307,84691,433870,133774,133774,89183,89183,445914
70,Syria Cross border,2015,TUR-15/3559/SA2/CCM/INGO/1918,9/8/2016 1:30:40 PM,Internally Displaced People,1860,2266,3070,2857,10053,1881,2178,2772,3069,9900
70,Syria Cross border,2015,TUR-15/3559/SA2/CCM/INGO/1918,9/8/2016 1:30:40 PM,Overall,1860,2266,3070,2857,10053,1881,2178,2772,3069,9900
70,Syria Cross border,2015,TUR-15/3559/SA2/CCM/INGO/1926,9/15/2016 12:39:44 PM,Internally Displaced People,2013,2331,3602,2649,10595,2558,2962,4578,3367,13465
70,Syria Cross border,2015,TUR-15/3559/SA2/CCM/INGO/1926,9/15/2016 12:39:44 PM,Overall,2013,2331,3602,2649,10595,2558,2962,4578,3367,13465
70,Syria Cross border,2015,TUR-15/3559/SA2/CCM/NGO/1826,4/4/2017 11:25:28 AM,Internally Displaced People,45630,51374,38458,50035,185497,156178,163435,203865,211013,734491
70,Syria Cross border,2015,TUR-15/3559/SA2/CCM/NGO/1826,4/4/2017 11:25:28 AM,Overall,45630,51374,38458,50035,185497,156178,163435,203865,211013,734491
70,Syria Cross border,2015,TUR-15/3559/SA2/CCM/NGO/1842,8/18/2016 12:14:48 PM,Internally Displaced People,1923,2309,1308,2155,7695,1821,2076,1795,2131,7823
70,Syria Cross border,2015,TUR-15/3559/SA2/CCM/NGO/1842,8/18/2016 12:14:48 PM,Overall,1923,2309,1308,2155,7695,1821,2076,1795,2131,7823
70,Syria Cross border,2015,TUR-15/3559/SA2/CCM/NGO/1917,4/27/2017 11:16:58 AM,Internally Displaced People,1522,1802,3756,3781,10861,3236,3429,3835,3838,14338
70,Syria Cross border,2015,TUR-15/3559/SA2/CCM/NGO/1917,4/27/2017 11:16:58 AM,Overall,1522,1802,3756,3781,10861,3236,3429,3835,3838,14338
70,Syria Cross border,2015,TUR-15/3559/SA2/E/INGO/1904,4/4/2017 12:16:03 PM,Host Communities,101,95,1085,1400,2681,101,95,1020,1371,2587
70,Syria Cross border,2015,TUR-15/3559/SA2/E/INGO/1904,4/4/2017 12:16:03 PM,Internally Displaced People,0,0,936,1206,2142,0,0,885,1188,2073
70,Syria Cross border,2015,TUR-15/3559/SA2/E/INGO/1904,4/4/2017 12:16:03 PM,Overall,101,95,2021,2606,4823,101,95,1905,2559,4660
70,Syria Cross border,2015,TUR-15/3559/SA2/E/NGO/1828,11/6/2016 2:50:03 PM,Host Communities,0,0,4360,4920,9280,0,0,4360,4920,9280
70,Syria Cross border,2015,TUR-15/3559/SA2/E/NGO/1828,11/6/2016 2:50:03 PM,Internally Displaced People,0,0,6540,7380,13920,0,0,6540,7380,13920
70,Syria Cross border,2015,TUR-15/3559/SA2/E/NGO/1828,11/6/2016 2:50:03 PM,Overall,0,0,10900,12300,23200,0,0,10900,12300,23200
70,Syria Cross border,2015,TUR-15/3559/SA2/E/NGO/1914,2/14/2017 7:18:59 AM,Other,36,38,0,0,74,0,24,103,390,517
70,Syria Cross border,2015,TUR-15/3559/SA2/E/NGO/1914,2/14/2017 7:18:59 AM,Overall,0,0,225,300,525,0,24,103,390,517
70,Syria Cross border,2015,TUR-15/3559/SA2/E/NGO/1915,2/13/2017 1:49:03 PM,Host Communities,45,65,840,1260,2210,45,65,840,1260,2210
70,Syria Cross border,2015,TUR-15/3559/SA2/E/NGO/1915,2/13/2017 1:49:03 PM,Overall,45,65,840,1260,2210,45,65,840,1260,2210
70,Syria Cross border,2015,TUR-15/3559/SA2/FS/INGO/1863,3/28/2017 11:01:17 AM,Host Communities,780,780,390,390,2340,1181,1435,1682,1691,5989
70,Syria Cross border,2015,TUR-15/3559/SA2/FS/INGO/1863,3/28/2017 11:01:17 AM,Internally Displaced People,180,180,90,90,540,33,34,72,44,183
70,Syria Cross border,2015,TUR-15/3559/SA2/FS/INGO/1863,3/28/2017 11:01:17 AM,Other,180,180,90,90,540,0,0,0,0,0
70,Syria Cross border,2015,TUR-15/3559/SA2/FS/INGO/1863,3/28/2017 11:01:17 AM,Overall,210,390,0,0,600,802,184,0,0,986
70,Syria Cross border,2015,TUR-15/3559/SA2/FS/INGO/1863,3/28/2017 11:01:17 AM,Refugees,60,60,30,30,180,16,18,22,24,80
70,Syria Cross border,2015,TUR-15/3559/SA2/FS/INGO/1912,5/15/2017 12:27:22 PM,Host Communities,200,250,700,750,1900,189,258,368,364,1179
70,Syria Cross border,2015,TUR-15/3559/SA2/FS/INGO/1912,5/15/2017 12:27:22 PM,Internally Displaced People,150,200,450,450,1250,172,217,297,267,953
70,Syria Cross border,2015,TUR-15/3559/SA2/FS/INGO/1912,5/15/2017 12:27:22 PM,Overall,175,175,0,0,350,361,475,665,631,2132
70,Syria Cross border,2015,TUR-15/3559/SA2/FS/NGO/1830,12/19/2016 9:14:27 AM,Other,425,150,1150,1725,3450,221,351,1715,1772,4059
70,Syria Cross border,2015,TUR-15/3559/SA2/FS/NGO/1830,12/19/2016 9:14:27 AM,Overall,150,425,0,0,575,221,351,1715,1772,4059
70,Syria Cross border,2015,TUR-15/3559/SA2/FS/NGO/1880,5/31/2017 6:54:38 AM,Host Communities,1180,220,0,0,1400,4699,3038,2947,2334,13018
70,Syria Cross border,2015,TUR-15/3559/SA2/FS/NGO/1880,5/31/2017 6:54:38 AM,Internally Displaced People,320,80,0,0,400,490,338,514,377,1719
70,Syria Cross border,2015,TUR-15/3559/SA2/FS/NGO/1880,5/31/2017 6:54:38 AM,Overall,1500,300,0,0,1800,5189,3376,3461,2711,14737
70,Syria Cross border,2015,TUR-15/3559/SA2/FS/NGO/1921,10/1/2016 1:39:14 PM,Host Communities,90,127,152,121,490,83,132,157,238,610
70,Syria Cross border,2015,TUR-15/3559/SA2/FS/NGO/1921,10/1/2016 1:39:14 PM,Internally Displaced People,40,43,48,29,160,48,42,79,65,234
70,Syria Cross border,2015,TUR-15/3559/SA2/FS/NGO/1921,10/1/2016 1:39:14 PM,Overall,130,170,0,0,300,131,174,236,303,844
70,Syria Cross border,2015,TUR-15/3559/SA2/H/INGO/1866,10/13/2017 10:46:22 AM,Host Communities,26735,16635,8318,7724,59412,0,0,0,0,0
70,Syria Cross border,2015,TUR-15/3559/SA2/H/INGO/1866,10/13/2017 10:46:22 AM,Internally Displaced People,7449,4635,2317,2152,16553,0,0,0,0,0
70,Syria Cross border,2015,TUR-15/3559/SA2/H/INGO/1866,10/13/2017 10:46:22 AM,Other,15,10,5,5,35,0,0,0,0,0
70,Syria Cross border,2015,TUR-15/3559/SA2/H/INGO/1866,10/13/2017 10:46:22 AM,Overall,34200,21280,10640,9880,76000,0,0,0,0,0
70,Syria Cross border,2015,TUR-15/3559/SA2/H/INGO/1885,6/15/2017 9:33:42 AM,Host Communities,1312,982,393,585,3272,1027,828,371,489,2715
70,Syria Cross border,2015,TUR-15/3559/SA2/H/INGO/1885,6/15/2017 9:33:42 AM,Internally Displaced People,288,218,87,135,728,485,292,130,220,1127
70,Syria Cross border,2015,TUR-15/3559/SA2/H/INGO/1885,6/15/2017 9:33:42 AM,Overall,1600,1200,480,720,4000,1512,1120,501,709,3842
70,Syria Cross border,2015,TUR-15/3559/SA2/H/NGO/1901,2/14/2017 7:25:51 AM,Host Communities,6930,12789,3465,3465,26649,14324,22138,4822,4318,45602
70,Syria Cross border,2015,TUR-15/3559/SA2/H/NGO/1901,2/14/2017 7:25:51 AM,Internally Displaced People,2970,5481,1485,1485,11421,4985,6180,1735,1377,14277
70,Syria Cross border,2015,TUR-15/3559/SA2/H/NGO/1901,2/14/2017 7:25:51 AM,Overall,9900,18270,4950,4950,38070,19309,28318,6557,5695,59879
70,Syria Cross border,2015,TUR-15/3559/SA2/H/NGO/1913,9/19/2016 6:40:39 AM,Host Communities,1710,1494,803,414,4421,1952,1489,959,628,5028
70,Syria Cross border,2015,TUR-15/3559/SA2/H/NGO/1913,9/19/2016 6:40:39 AM,Internally Displaced People,1140,996,535,276,2947,870,710,426,289,2295
70,Syria Cross border,2015,TUR-15/3559/SA2/H/NGO/1913,9/19/2016 6:40:39 AM,Overall,2850,2490,1338,690,7368,2822,2199,1385,917,7323
70,Syria Cross border,2015,TUR-15/3559/SA2/N/NGO/1821,2/14/2017 7:01:19 AM,Host Communities,122,9180,0,0,9302,122,9180,0,0,9302
70,Syria Cross border,2015,TUR-15/3559/SA2/N/NGO/1821,2/14/2017 7:01:19 AM,Internally Displaced People,43,3225,0,0,3268,43,3225,0,0,3268
70,Syria Cross border,2015,TUR-15/3559/SA2/N/NGO/1821,2/14/2017 7:01:19 AM,Overall,165,12405,0,0,12570,165,12405,0,0,12570
70,Syria Cross border,2015,TUR-15/3559/SA2/N/NGO/1910,5/3/2017 6:56:09 AM,Host Communities,6003,22050,4065,3905,36023,6250,16849,4834,4645,32578
70,Syria Cross border,2015,TUR-15/3559/SA2/N/NGO/1910,5/3/2017 6:56:09 AM,Internally Displaced People,4000,16832,2043,1963,24838,4171,11232,3222,3096,21721
70,Syria Cross border,2015,TUR-15/3559/SA2/N/NGO/1910,5/3/2017 6:56:09 AM,Overall,10003,38882,6108,5868,60861,10421,28081,8056,7741,54299
70,Syria Cross border,2015,TUR-15/3559/SA2/NFI/INGO/1892,8/9/2016 8:54:09 AM,Host Communities,478,478,584,1115,2655,590,508,1146,1315,3559
70,Syria Cross border,2015,TUR-15/3559/SA2/NFI/INGO/1892,8/9/2016 8:54:09 AM,Internally Displaced People,164,379,468,834,1845,203,404,919,985,2511
70,Syria Cross border,2015,TUR-15/3559/SA2/NFI/INGO/1892,8/9/2016 8:54:09 AM,Overall,642,857,1052,1949,4500,793,912,2065,2300,6070
70,Syria Cross border,2015,TUR-15/3559/SA2/NFI/NGO/1777,7/18/2017 7:56:45 AM,Internally Displaced People,115,155,264,248,782,132,161,263,251,807
70,Syria Cross border,2015,TUR-15/3559/SA2/NFI/NGO/1777,7/18/2017 7:56:45 AM,Overall,115,155,264,248,782,132,161,263,251,807
70,Syria Cross border,2015,TUR-15/3559/SA2/P/INGO/1883,2/14/2017 7:15:04 AM,Host Communities,1155,1455,1500,1500,5610,2526,2526,3789,3789,12630
70,Syria Cross border,2015,TUR-15/3559/SA2/P/INGO/1883,2/14/2017 7:15:04 AM,Other,45,45,450,450,990,55,127,490,929,1601
70,Syria Cross border,2015,TUR-15/3559/SA2/P/INGO/1883,2/14/2017 7:15:04 AM,Overall,1200,1500,1950,1950,6600,2581,2653,4279,4718,14231
70,Syria Cross border,2015,TUR-15/3559/SA2/P/INGO/1909,2/13/2017 2:12:14 PM,Host Communities,45,89,1717,2123,3974,67,65,1102,965,2199
70,Syria Cross border,2015,TUR-15/3559/SA2/P/INGO/1909,2/13/2017 2:12:14 PM,Internally Displaced People,0,0,170,210,380,0,0,1489,1171,2660
70,Syria Cross border,2015,TUR-15/3559/SA2/P/INGO/1909,2/13/2017 2:12:14 PM,Overall,45,89,1887,2333,4354,67,65,2591,2136,4859
70,Syria Cross border,2015,TUR-15/3559/SA2/P/NGO/1849,12/27/2016 1:40:54 PM,Host Communities,951,3803,407,1630,6791,1567,6217,558,2127,10469
70,Syria Cross border,2015,TUR-15/3559/SA2/P/NGO/1849,12/27/2016 1:40:54 PM,Internally Displaced People,634,2536,272,1087,4529,629,2766,689,1098,5182
70,Syria Cross border,2015,TUR-15/3559/SA2/P/NGO/1849,12/27/2016 1:40:54 PM,Overall,1585,6339,679,2717,11320,2196,8983,1247,3225,15651
70,Syria Cross border,2015,TUR-15/3559/SA2/P/NGO/1850,4/4/2017 12:43:39 PM,Host Communities,60,200,40,140,440,279,766,227,989,2261
70,Syria Cross border,2015,TUR-15/3559/SA2/P/NGO/1850,4/4/2017 12:43:39 PM,Internally Displaced People,40,320,80,180,620,186,511,152,654,1503
70,Syria Cross border,2015,TUR-15/3559/SA2/P/NGO/1850,4/4/2017 12:43:39 PM,Overall,100,520,120,420,1160,465,1277,379,1643,3764
70,Syria Cross border,2015,TUR-15/3559/SA2/P/NGO/1898,9/27/2017 8:35:30 AM,Host Communities,0,579,78,156,813,65,2352,40,140,2597
70,Syria Cross border,2015,TUR-15/3559/SA2/P/NGO/1898,9/27/2017 8:35:30 AM,Internally Displaced People,0,360,15,85,460,0,1380,23,82,1485
70,Syria Cross border,2015,TUR-15/3559/SA2/P/NGO/1898,9/27/2017 8:35:30 AM,Overall,0,939,120,241,1300,65,3732,63,222,4082
70,Syria Cross border,2015,TUR-15/3559/SA2/WASH/INGO/1838,12/2/2016 12:18:33 PM,Host Communities,6145,7115,9701,9379,32340,3230,3742,5100,4930,17002
70,Syria Cross border,2015,TUR-15/3559/SA2/WASH/INGO/1838,12/2/2016 12:18:33 PM,Internally Displaced People,3165,3665,4998,4832,16660,1664,1927,2627,2540,8758
70,Syria Cross border,2015,TUR-15/3559/SA2/WASH/INGO/1838,12/2/2016 12:18:33 PM,Overall,9310,10780,14700,14210,49000,4894,5669,7727,7470,25760
70,Syria Cross border,2015,TUR-15/3559/SA2/WASH/INGO/1895,12/19/2016 11:58:47 AM,Host Communities,11053,17804,12709,16434,58000,7680,13560,7120,9840,38200
70,Syria Cross border,2015,TUR-15/3559/SA2/WASH/INGO/1895,12/19/2016 11:58:47 AM,Internally Displaced People,1947,3196,2291,2566,10000,2820,4690,2380,3160,13050
70,Syria Cross border,2015,TUR-15/3559/SA2/WASH/INGO/1895,12/19/2016 11:58:47 AM,Overall,13000,21000,15000,19000,68000,10500,18250,9500,13000,51250
70,Syria Cross border,2015,TUR-15/3559/SA2/WASH/INGO/1900,10/1/2016 1:41:43 PM,Host Communities,1920,2880,2880,4320,12000,1555,2600,2650,4220,11025
70,Syria Cross border,2015,TUR-15/3559/SA2/WASH/INGO/1900,10/1/2016 1:41:43 PM,Internally Displaced People,480,720,720,1080,3000,300,656,611,1225,2792
70,Syria Cross border,2015,TUR-15/3559/SA2/WASH/INGO/1900,10/1/2016 1:41:43 PM,Overall,2400,3600,3600,5400,15000,1855,3256,3261,5445,13817
70,Syria Cross border,2015,TUR-15/3559/SA2/WASH/INGO/1922,5/4/2017 7:45:16 AM,Host Communities,48701,55987,44887,44799,194374,45598,51069,41951,43774,182392
70,Syria Cross border,2015,TUR-15/3559/SA2/WASH/INGO/1922,5/4/2017 7:45:16 AM,Internally Displaced People,6019,6920,5548,5537,24024,4509,5051,4149,4329,18038
70,Syria Cross border,2015,TUR-15/3559/SA2/WASH/INGO/1922,5/4/2017 7:45:16 AM,Overall,54720,62907,50435,50336,218398,50108,56121,46098,48103,200430
70,Syria Cross border,2015,TUR-15/3559/SA2/WASH/NGO/1889,12/28/2016 10:21:09 AM,Host Communities,25554,43593,33070,48103,150320,25796,43538,32987,49733,152054
70,Syria Cross border,2015,TUR-15/3559/SA2/WASH/NGO/1889,12/28/2016 10:21:09 AM,Internally Displaced People,2944,5023,3811,5542,17320,3529,3425,4218,5680,16852
70,Syria Cross border,2015,TUR-15/3559/SA2/WASH/NGO/1889,12/28/2016 10:21:09 AM,Overall,28499,48616,36881,53645,167641,29325,46963,37205,55413,168906
70,Syria Cross border,2016,TUR-16/3559/RA/CCM/INGO/2448,12/20/2016 7:13:03 AM,Internally Displaced People,240,528,400,432,1600,1597,1178,1446,1843,6064
70,Syria Cross border,2016,TUR-16/3559/RA/CCM/INGO/2448,12/20/2016 7:13:03 AM,Overall,240,528,400,432,1600,1597,1178,1446,1843,6064
70,Syria Cross border,2016,TUR-16/3559/RA/CCM/INGO/2460,10/1/2016 1:48:05 PM,Internally Displaced People,7455,7657,2620,2418,20150,7743,8051,12057,11723,39574
70,Syria Cross border,2016,TUR-16/3559/RA/CCM/INGO/2460,10/1/2016 1:48:05 PM,Overall,7455,7657,2620,2418,20150,7743,8051,12057,11723,39574
70,Syria Cross border,2016,TUR-16/3559/RA/CCM/INGO/2473,12/13/2016 7:40:23 AM,Internally Displaced People,6274,7594,9359,10617,33844,19184,21399,29740,30916,101239
70,Syria Cross border,2016,TUR-16/3559/RA/CCM/INGO/2473,12/13/2016 7:40:23 AM,Overall,6274,7594,9359,10617,33844,19184,21399,29740,30916,101239
70,Syria Cross border,2016,TUR-16/3559/RA/CCM/INGO/2530,8/11/2017 12:40:23 PM,Internally Displaced People,1032,2268,1435,2450,7185,1803,3112,2190,3337,10442
70,Syria Cross border,2016,TUR-16/3559/RA/CCM/INGO/2530,8/11/2017 12:40:23 PM,Overall,1032,2268,1435,2450,7185,1803,3112,2190,3337,10442
70,Syria Cross border,2016,TUR-16/3559/RA/CCM/NGO/2471,9/8/2016 1:45:39 PM,Internally Displaced People,10830,18164,8823,14531,52348,6626,8269,13236,11403,39534
70,Syria Cross border,2016,TUR-16/3559/RA/CCM/NGO/2471,9/8/2016 1:45:39 PM,Overall,10380,18164,8823,14531,51898,6626,8269,13236,11403,39534
70,Syria Cross border,2016,TUR-16/3559/RA/CCM/O/4457,7/27/2018 12:12:56 PM,Internally Displaced People,5000,5000,7500,7500,25000,5000,5000,7500,7500,25000
70,Syria Cross border,2016,TUR-16/3559/RA/CCM/O/4457,7/27/2018 12:12:56 PM,Overall,5000,5000,7500,7500,25000,5000,5000,7500,7500,25000
70,Syria Cross border,2016,TUR-16/3559/RA/CCM/UN/3174,2/9/2018 5:51:03 AM,Internally Displaced People,15840,15840,32760,32760,97200,18304,19505,28191,26929,92929
70,Syria Cross border,2016,TUR-16/3559/RA/CCM/UN/3174,2/9/2018 5:51:03 AM,Overall,15840,15840,32760,32760,97200,18304,19505,28191,26929,92929
70,Syria Cross border,2016,TUR-16/3559/RA/CCM/UN/4459,7/25/2018 9:50:08 AM,Internally Displaced People,9036,9036,18073,18074,54219,7545,9208,14015,13489,44257
70,Syria Cross border,2016,TUR-16/3559/RA/CCM/UN/4459,7/25/2018 9:50:08 AM,Overall,9036,9036,18073,18074,54219,7545,9208,14015,13489,44257
70,Syria Cross border,2016,TUR-16/3559/RA/CCM/UN/4490,1/16/2019 12:45:54 PM,Internally Displaced People,7200,7200,14400,14400,43200,6153,6423,7210,6640,26426
70,Syria Cross border,2016,TUR-16/3559/RA/CCM/UN/4490,1/16/2019 12:45:54 PM,Overall,7200,7200,14400,14400,43200,6153,6423,7210,6640,26426
70,Syria Cross border,2016,TUR-16/3559/RA/FS/INGO/2408,9/25/2016 10:51:27 AM,Internally Displaced People,4200,4600,5400,5800,20000,12640,14517,17240,15335,59732
70,Syria Cross border,2016,TUR-16/3559/RA/FS/INGO/2408,9/25/2016 10:51:27 AM,Overall,4200,4600,5400,5800,20000,12640,14517,17240,15335,59732
70,Syria Cross border,2016,TUR-16/3559/RA/FS/INGO/2412,2/24/2017 6:58:55 AM,Internally Displaced People,1570,1890,3220,3460,10140,1825,2036,3195,3084,10140
70,Syria Cross border,2016,TUR-16/3559/RA/FS/INGO/2412,2/24/2017 6:58:55 AM,Overall,1570,1890,3220,3460,10140,1825,2036,3195,3084,10140
70,Syria Cross border,2016,TUR-16/3559/RA/FS/INGO/2414,12/4/2016 10:37:46 AM,Internally Displaced People,900,900,900,1800,4500,1100,1100,1100,2200,5500
70,Syria Cross border,2016,TUR-16/3559/RA/FS/INGO/2414,12/4/2016 10:37:46 AM,Overall,100,100,100,200,500,1100,1100,1100,2200,5500
70,Syria Cross border,2016,TUR-16/3559/RA/FS/INGO/2433,9/1/2016 1:13:24 PM,Internally Displaced People,484,486,960,980,2910,584,713,958,1145,3400
70,Syria Cross border,2016,TUR-16/3559/RA/FS/INGO/2433,9/1/2016 1:13:24 PM,Overall,484,486,960,980,2910,584,713,958,1145,3400
70,Syria Cross border,2016,TUR-16/3559/RA/FS/INGO/2441,10/9/2016 10:58:43 AM,Internally Displaced People,819,855,1623,1623,4920,2641,2839,4889,4931,15300
70,Syria Cross border,2016,TUR-16/3559/RA/FS/INGO/2441,10/9/2016 10:58:43 AM,Overall,819,855,1623,1623,4920,2641,2839,4889,4931,15300
70,Syria Cross border,2016,TUR-16/3559/RA/FS/INGO/2442,9/1/2016 12:56:31 PM,Internally Displaced People,1500,2250,1875,1875,7500,2201,1933,3936,4000,12070
70,Syria Cross border,2016,TUR-16/3559/RA/FS/INGO/2442,9/1/2016 12:56:31 PM,Overall,1500,2250,1875,1875,7500,2201,1933,3936,4000,12070
70,Syria Cross border,2016,TUR-16/3559/RA/FS/NGO/2429,9/22/2016 11:38:26 AM,Internally Displaced People,12483,12991,8322,8662,42458,23220,23917,15443,16074,78654
70,Syria Cross border,2016,TUR-16/3559/RA/FS/NGO/2429,9/22/2016 11:38:26 AM,Overall,12483,12991,8322,8662,42458,23220,23917,15443,16074,78654
70,Syria Cross border,2016,TUR-16/3559/RA/FS/NGO/2443,9/22/2016 11:27:31 AM,Internally Displaced People,1914,3451,3335,5800,14500,1914,3451,3335,5800,14500
70,Syria Cross border,2016,TUR-16/3559/RA/FS/NGO/2443,9/22/2016 11:27:31 AM,Overall,1914,3451,3335,5800,14500,1914,3451,3335,5800,14500
70,Syria Cross border,2016,TUR-16/3559/RA/FS/UN/3179,1/15/2018 6:07:56 PM,Host Communities,5100,900,0,0,6000,6631,1058,2358,218,10265
70,Syria Cross border,2016,TUR-16/3559/RA/FS/UN/3179,1/15/2018 6:07:56 PM,Internally Displaced People,5100,900,0,0,6000,7015,1675,3574,850,13114
70,Syria Cross border,2016,TUR-16/3559/RA/FS/UN/3179,1/15/2018 6:07:56 PM,Overall,10200,1800,0,0,12000,13646,2733,5932,1068,23379
70,Syria Cross border,2016,TUR-16/3559/RA/FS/UN/4503,9/6/2017 7:42:22 AM,Internally Displaced People,50759,53363,64603,67916,236641,44586,57962,55732,64650,222930
70,Syria Cross border,2016,TUR-16/3559/RA/FS/UN/4503,9/6/2017 7:42:22 AM,Overall,50759,53363,64603,67916,236641,44586,57962,55732,64650,222930
70,Syria Cross border,2016,TUR-16/3559/RA/H/INGO/2398,11/29/2016 12:59:43 PM,Host Communities,16801,30227,15900,17456,80384,11361,26526,15888,11925,65700
70,Syria Cross border,2016,TUR-16/3559/RA/H/INGO/2398,11/29/2016 12:59:43 PM,Internally Displaced People,8375,15621,7693,8418,40107,9306,16375,9039,8105,42825
70,Syria Cross border,2016,TUR-16/3559/RA/H/INGO/2398,11/29/2016 12:59:43 PM,Overall,25175,45848,23593,25874,120490,20667,42901,24927,20030,108525
70,Syria Cross border,2016,TUR-16/3559/RA/H/INGO/2468,5/2/2017 11:28:32 AM,Host Communities,6837,5473,4043,3395,19748,7526,4041,3416,2226,17209
70,Syria Cross border,2016,TUR-16/3559/RA/H/INGO/2468,5/2/2017 11:28:32 AM,Internally Displaced People,2726,2181,1612,1353,7872,1902,1978,1433,1311,6624
70,Syria Cross border,2016,TUR-16/3559/RA/H/INGO/2468,5/2/2017 11:28:32 AM,Overall,9563,7654,5655,4748,27620,9428,6019,4849,3537,23833
70,Syria Cross border,2016,TUR-16/3559/RA/H/INGO/2548,9/20/2016 10:51:44 AM,Host Communities,3000,1700,1650,1050,7400,0,0,280149,291587,571736
70,Syria Cross border,2016,TUR-16/3559/RA/H/INGO/2548,9/20/2016 10:51:44 AM,Other,0,0,314313,327146,641459,4656,1320,1642,876,8494
70,Syria Cross border,2016,TUR-16/3559/RA/H/INGO/2548,9/20/2016 10:51:44 AM,Overall,3000,1700,315963,328196,648859,4656,1320,281791,292463,580230
70,Syria Cross border,2016,TUR-16/3559/RA/H/NGO/2432,5/4/2017 1:40:42 PM,Host Communities,675,725,525,575,2500,2324,3352,2908,2571,11155
70,Syria Cross border,2016,TUR-16/3559/RA/H/NGO/2432,5/4/2017 1:40:42 PM,Internally Displaced People,4981,11648,7959,8263,32851,10000,22000,10000,15000,57000
70,Syria Cross border,2016,TUR-16/3559/RA/H/NGO/2432,5/4/2017 1:40:42 PM,Overall,5656,12373,8484,8838,35351,12324,25352,12908,17571,68155
70,Syria Cross border,2016,TUR-16/3559/RA/H/NGO/2467,5/3/2017 6:56:57 AM,Host Communities,5266,5122,2139,1643,14170,6525,3750,5713,3168,19156
70,Syria Cross border,2016,TUR-16/3559/RA/H/NGO/2467,5/3/2017 6:56:57 AM,Internally Displaced People,3255,3400,1304,1049,9008,803,586,805,570,2764
70,Syria Cross border,2016,TUR-16/3559/RA/H/NGO/2467,5/3/2017 6:56:57 AM,Overall,8521,8522,3443,2692,23178,7328,4336,6518,3738,21920
70,Syria Cross border,2016,TUR-16/3559/RA/H/NGO/2531,5/11/2017 1:28:07 PM,Host Communities,1855,1985,2255,2265,8360,1692,2475,635,607,5409
70,Syria Cross border,2016,TUR-16/3559/RA/H/NGO/2531,5/11/2017 1:28:07 PM,Internally Displaced People,2570,2695,2880,2995,11140,2539,3713,953,912,8117
70,Syria Cross border,2016,TUR-16/3559/RA/H/NGO/2531,5/11/2017 1:28:07 PM,Overall,4425,4680,5135,5260,19500,4231,6188,1588,1519,13526
70,Syria Cross border,2016,TUR-16/3559/RA/H/NGO/2546,11/29/2016 12:08:35 PM,Host Communities,0,0,40000,45000,85000,0,0,0,0,0
70,Syria Cross border,2016,TUR-16/3559/RA/H/NGO/2546,11/29/2016 12:08:35 PM,Overall,0,0,40000,45000,85000,0,0,33172,35936,69108
70,Syria Cross border,2016,TUR-16/3559/RA/H/UN/3178,1/18/2018 6:57:49 AM,Host Communities,314600,367100,157100,209600,1048400,314600,367100,157100,209600,1048400
70,Syria Cross border,2016,TUR-16/3559/RA/H/UN/3178,1/18/2018 6:57:49 AM,Internally Displaced People,78500,91700,39300,52500,262000,78500,91700,39300,52500,262000
70,Syria Cross border,2016,TUR-16/3559/RA/H/UN/3178,1/18/2018 6:57:49 AM,Overall,393100,458800,196400,262100,1310400,393100,458800,196400,262100,1310400
70,Syria Cross border,2016,TUR-16/3559/RA/H/UN/4492,6/20/2019 12:08:23 PM,Host Communities,100000,100700,60000,70000,330700,92423,96423,69100,72754,330700
70,Syria Cross border,2016,TUR-16/3559/RA/H/UN/4492,6/20/2019 12:08:23 PM,Internally Displaced People,68000,100000,41000,60300,269300,75263,78520,56271,59246,269300
70,Syria Cross border,2016,TUR-16/3559/RA/H/UN/4492,6/20/2019 12:08:23 PM,Overall,168000,200700,101000,130300,600000,167686,174943,125371,132000,600000
70,Syria Cross border,2016,TUR-16/3559/RA/NFI/INGO/2421,8/9/2016 11:40:14 AM,Internally Displaced People,2168,2434,4466,4478,13546,3880,3841,3611,2719,14051
70,Syria Cross border,2016,TUR-16/3559/RA/NFI/INGO/2421,8/9/2016 11:40:14 AM,Overall,2168,2434,4466,4478,13546,3880,3841,3611,2719,14051
70,Syria Cross border,2016,TUR-16/3559/RA/NFI/INGO/2455,9/23/2016 10:46:32 AM,Internally Displaced People,5420,5567,1905,1758,14650,6308,6759,4506,4857,22430
70,Syria Cross border,2016,TUR-16/3559/RA/NFI/INGO/2455,9/23/2016 10:46:32 AM,Overall,5420,5567,1905,1758,14650,6308,6759,4506,4857,22430
70,Syria Cross border,2016,TUR-16/3559/RA/NFI/INGO/2456,5/12/2017 11:46:42 AM,Internally Displaced People,1335,1335,1335,1335,5340,1619,1703,2543,3021,8886
70,Syria Cross border,2016,TUR-16/3559/RA/NFI/INGO/2456,5/12/2017 11:46:42 AM,Overall,1335,1335,1335,1335,5340,1619,1703,2543,3021,8886
70,Syria Cross border,2016,TUR-16/3559/RA/NFI/UN/2439,4/5/2017 7:07:01 AM,Internally Displaced People,8000,8000,16000,16000,48000,8923,8923,17846,17846,53538
70,Syria Cross border,2016,TUR-16/3559/RA/NFI/UN/2439,4/5/2017 7:07:01 AM,Overall,8000,8000,16000,16000,48000,8923,8923,17846,17846,53538
70,Syria Cross border,2016,TUR-16/3559/RA/NFI/UN/3173,7/5/2017 9:18:50 AM,Internally Displaced People,5000,5000,10000,10000,30000,6187,6187,10999,11000,34373
70,Syria Cross border,2016,TUR-16/3559/RA/NFI/UN/3173,7/5/2017 9:18:50 AM,Overall,5000,5000,10000,10000,30000,6187,6187,10999,11000,34373
70,Syria Cross border,2016,TUR-16/3559/RA/NFI/UN/3177,6/28/2017 7:42:07 AM,Overall,0,0,9000,9000,18000,0,0,14412,15570,29982
70,Syria Cross border,2016,TUR-16/3559/RA/NFI/UN/4489,7/24/2018 9:44:47 AM,Internally Displaced People,11700,11700,13400,13400,50200,10742,10975,15726,15965,53408
70,Syria Cross border,2016,TUR-16/3559/RA/NFI/UN/4489,7/24/2018 9:44:47 AM,Overall,11700,11700,13400,13400,50200,10742,10975,15726,15965,53408
70,Syria Cross border,2016,TUR-16/3559/RA/P/INGO/2431,11/29/2016 12:02:10 PM,Internally Displaced People,864,6912,3456,10368,21600,2351,5292,11575,11990,31208
70,Syria Cross border,2016,TUR-16/3559/RA/P/INGO/2431,11/29/2016 12:02:10 PM,Other,30,30,0,0,60,26,31,0,0,57
70,Syria Cross border,2016,TUR-16/3559/RA/P/INGO/2431,11/29/2016 12:02:10 PM,Overall,894,6942,3456,10368,21660,2377,5323,11575,11990,31265
70,Syria Cross border,2016,TUR-16/3559/RA/WASH/INGO/2427,9/20/2016 6:53:15 AM,Internally Displaced People,4919,5934,7190,6157,24200,5700,6439,8342,6983,27464
70,Syria Cross border,2016,TUR-16/3559/RA/WASH/INGO/2427,9/20/2016 6:53:15 AM,Overall,6377,7134,9292,8379,31182,8196,9489,12078,13371,43134
70,Syria Cross border,2016,TUR-16/3559/RA/WASH/INGO/2434,12/19/2016 9:29:34 AM,Internally Displaced People,5400,8100,6615,6885,27000,10949,16423,13412,13959,54743
70,Syria Cross border,2016,TUR-16/3559/RA/WASH/INGO/2434,12/19/2016 9:29:34 AM,Overall,5400,8100,6615,6885,27000,10949,16423,13412,13959,54743
70,Syria Cross border,2016,TUR-16/3559/RA/WASH/INGO/2444,4/5/2017 7:23:40 AM,Host Communities,3488,5813,6278,7673,23252,21383,35637,38489,47041,142550
70,Syria Cross border,2016,TUR-16/3559/RA/WASH/INGO/2444,4/5/2017 7:23:40 AM,Internally Displaced People,8137,13562,14647,17902,54248,11514,19189,20724,25330,76757
70,Syria Cross border,2016,TUR-16/3559/RA/WASH/INGO/2444,4/5/2017 7:23:40 AM,Overall,11625,19375,20925,25575,77500,32897,54826,59213,72371,219307
70,Syria Cross border,2016,TUR-16/3559/RA/WASH/INGO/2466,2/5/2017 10:36:04 AM,Internally Displaced People,22189,20163,29257,29233,100842,22105,20102,29144,29131,100482
70,Syria Cross border,2016,TUR-16/3559/RA/WASH/INGO/2466,2/5/2017 10:36:04 AM,Overall,22189,20163,29257,29233,100842,22105,20102,29144,29131,100482
70,Syria Cross border,2016,TUR-16/3559/RA/WASH/INGO/2524,9/19/2016 1:32:16 PM,Internally Displaced People,6486,6962,10046,10190,33684,6486,6962,10046,10190,33684
70,Syria Cross border,2016,TUR-16/3559/RA/WASH/INGO/2524,9/19/2016 1:32:16 PM,Overall,6486,6962,10046,10190,33684,6486,6962,10046,10190,33684
70,Syria Cross border,2016,TUR-16/3559/RA/WASH/INGO/2527,9/25/2016 10:44:00 AM,Internally Displaced People,10000,15000,17500,7500,50000,15084,16297,21025,18141,70547
70,Syria Cross border,2016,TUR-16/3559/RA/WASH/INGO/2527,9/25/2016 10:44:00 AM,Overall,10000,15000,17500,7500,50000,15084,16297,21025,18141,70547
70,Syria Cross border,2016,TUR-16/3559/RA/WASH/INGO/4493,4/2/2018 8:43:22 AM,Internally Displaced People,38000,35200,30000,27600,130800,29176,29746,53497,43789,156208
70,Syria Cross border,2016,TUR-16/3559/RA/WASH/INGO/4493,4/2/2018 8:43:22 AM,Overall,38000,35200,30000,27600,130800,29176,29746,53497,43789,156208
70,Syria Cross border,2016,TUR-16/3559/RA/WASH/NGO/2507,12/19/2016 9:08:28 AM,Internally Displaced People,1464,2034,1621,2172,7291,1464,2034,1621,2172,7291
70,Syria Cross border,2016,TUR-16/3559/RA/WASH/NGO/2507,12/19/2016 9:08:28 AM,Overall,1464,2034,1621,2172,7291,1464,2034,1621,2172,7291
70,Syria Cross border,2016,TUR-16/3559/RA/WASH/NGO/2529,4/27/2017 11:24:53 AM,Host Communities,0,0,0,0,0,6831,6831,8316,7722,29700
70,Syria Cross border,2016,TUR-16/3559/RA/WASH/NGO/2529,4/27/2017 11:24:53 AM,Overall,13909,15730,17046,15815,62500,6831,6831,8316,7722,29700
70,Syria Cross border,2016,TUR-16/3559/RA/WASH/NGO/4488,7/4/2017 8:30:08 AM,Internally Displaced People,11880,10800,16200,15120,54000,17628,17967,15594,16611,67800
70,Syria Cross border,2016,TUR-16/3559/RA/WASH/NGO/4488,7/4/2017 8:30:08 AM,Overall,11880,10800,16200,15120,54000,17628,17967,15594,16611,67800
70,Syria Cross border,2016,TUR-16/3559/RA/WASH/UN/3171,6/21/2017 8:25:02 AM,Internally Displaced People,25000,25000,25000,25000,100000,17891,24446,48536,45823,136696
70,Syria Cross border,2016,TUR-16/3559/RA/WASH/UN/3171,6/21/2017 8:25:02 AM,Overall,25000,25000,25000,25000,100000,17891,24446,48536,45823,136696
70,Syria Cross border,2016,TUR-16/3559/SA 2016/CCM/INGO/2758,1/31/2017 5:46:38 AM,Internally Displaced People,14395,14279,10059,9532,48265,14713,14587,10276,9740,49316
70,Syria Cross border,2016,TUR-16/3559/SA 2016/CCM/INGO/2758,1/31/2017 5:46:38 AM,Overall,14395,14279,10059,9532,48265,14713,14587,10276,9740,49316
70,Syria Cross border,2016,TUR-16/3559/SA 2016/CCM/NGO/2719,9/14/2017 7:35:55 AM,Internally Displaced People,2717,2908,2827,2798,11250,2729,2913,2827,2798,11267
70,Syria Cross border,2016,TUR-16/3559/SA 2016/CCM/NGO/2719,9/14/2017 7:35:55 AM,Overall,39,23,0,0,62,39,23,0,0,62
70,Syria Cross border,2016,TUR-16/3559/SA 2016/CCM/NGO/2783,9/25/2017 10:41:26 AM,Internally Displaced People,3120,4000,2840,2840,12800,2021,2780,1803,1910,8514
70,Syria Cross border,2016,TUR-16/3559/SA 2016/CCM/NGO/2783,9/25/2017 10:41:26 AM,Overall,3120,4000,2840,2840,12800,2021,2780,1803,1910,8514
70,Syria Cross border,2016,TUR-16/3559/SA 2016/E/INGO/2707,4/4/2017 11:02:47 AM,Host Communities,127,80,1641,1419,3267,200,148,2966,2988,6302
70,Syria Cross border,2016,TUR-16/3559/SA 2016/E/INGO/2707,4/4/2017 11:02:47 AM,Internally Displaced People,0,0,80,75,155,0,0,173,169,342
70,Syria Cross border,2016,TUR-16/3559/SA 2016/E/INGO/2707,4/4/2017 11:02:47 AM,Overall,127,80,1721,1494,3422,200,148,3139,3157,6644
70,Syria Cross border,2016,TUR-16/3559/SA 2016/E/NGO/2612,6/6/2017 1:48:10 PM,Host Communities,400,400,145,223,1168,400,400,325,475,1600
70,Syria Cross border,2016,TUR-16/3559/SA 2016/E/NGO/2612,6/6/2017 1:48:10 PM,Internally Displaced People,1000,1000,980,1352,4332,1000,1000,800,1100,3900
70,Syria Cross border,2016,TUR-16/3559/SA 2016/E/NGO/2612,6/6/2017 1:48:10 PM,Overall,1400,1400,1125,1575,5500,1400,1400,1125,1575,5500
70,Syria Cross border,2016,TUR-16/3559/SA 2016/E/NGO/2720,9/21/2017 8:12:27 AM,Host Communities,42,22,556,700,1320,48,21,556,700,1325
70,Syria Cross border,2016,TUR-16/3559/SA 2016/E/NGO/2720,9/21/2017 8:12:27 AM,Internally Displaced People,2,0,200,273,475,2,0,200,273,475
70,Syria Cross border,2016,TUR-16/3559/SA 2016/E/NGO/2720,9/21/2017 8:12:27 AM,Overall,44,22,756,973,1795,50,21,756,973,1800
70,Syria Cross border,2016,TUR-16/3559/SA 2016/E/NGO/2738,8/17/2017 7:51:06 AM,Host Communities,182,216,1813,2255,4466,182,216,1813,2255,4466
70,Syria Cross border,2016,TUR-16/3559/SA 2016/E/NGO/2738,8/17/2017 7:51:06 AM,Internally Displaced People,41,24,320,390,775,41,24,320,390,775
70,Syria Cross border,2016,TUR-16/3559/SA 2016/E/NGO/2738,8/17/2017 7:51:06 AM,Overall,223,240,2133,2645,5241,222,240,2134,2645,5241
70,Syria Cross border,2016,TUR-16/3559/SA 2016/E/NGO/2750,6/30/2017 12:34:23 PM,Host Communities,210,2155,1135,1030,4530,4352,3982,7269,7955,23558
70,Syria Cross border,2016,TUR-16/3559/SA 2016/E/NGO/2750,6/30/2017 12:34:23 PM,Internally Displaced People,0,0,65,80,145,0,0,65,80,145
70,Syria Cross border,2016,TUR-16/3559/SA 2016/E/NGO/2750,6/30/2017 12:34:23 PM,Overall,210,2155,1200,1110,4675,4352,3982,7334,8035,23703
70,Syria Cross border,2016,TUR-16/3559/SA 2016/E/NGO/2785,8/17/2017 8:14:27 AM,Host Communities,85,63,1002,1060,2210,135,119,1074,1336,2664
70,Syria Cross border,2016,TUR-16/3559/SA 2016/E/NGO/2785,8/17/2017 8:14:27 AM,Internally Displaced People,0,0,84,98,182,0,0,688,655,1343
70,Syria Cross border,2016,TUR-16/3559/SA 2016/E/NGO/2785,8/17/2017 8:14:27 AM,Overall,85,63,1086,1158,2392,135,119,1762,1991,4007
70,Syria Cross border,2016,TUR-16/3559/SA 2016/FS/INGO/2725,6/8/2017 7:01:08 AM,Host Communities,934,585,1637,2455,5611,934,585,1637,2455,5611
70,Syria Cross border,2016,TUR-16/3559/SA 2016/FS/INGO/2725,6/8/2017 7:01:08 AM,Internally Displaced People,440,571,1090,1635,3736,440,571,1090,1635,3736
70,Syria Cross border,2016,TUR-16/3559/SA 2016/FS/INGO/2725,6/8/2017 7:01:08 AM,Overall,1374,1156,2727,4090,9347,1374,1156,2727,4090,9347
70,Syria Cross border,2016,TUR-16/3559/SA 2016/FS/INGO/2733,2/15/2018 8:39:02 AM,Host Communities,192,90,526,532,1340,192,90,526,532,1340
70,Syria Cross border,2016,TUR-16/3559/SA 2016/FS/INGO/2733,2/15/2018 8:39:02 AM,Internally Displaced People,10,2,29,31,72,10,2,29,31,72
70,Syria Cross border,2016,TUR-16/3559/SA 2016/FS/INGO/2733,2/15/2018 8:39:02 AM,Overall,202,92,555,563,1412,202,92,555,563,1412
70,Syria Cross border,2016,TUR-16/3559/SA 2016/FS/NGO/2755,8/10/2017 8:01:20 AM,Host Communities,976,916,0,0,1892,702,761,2046,2144,5653
70,Syria Cross border,2016,TUR-16/3559/SA 2016/FS/NGO/2755,8/10/2017 8:01:20 AM,Internally Displaced People,158,150,0,0,308,201,186,507,515,1409
70,Syria Cross border,2016,TUR-16/3559/SA 2016/FS/NGO/2755,8/10/2017 8:01:20 AM,Other,0,0,1701,1599,3300,0,0,0,0,0
70,Syria Cross border,2016,TUR-16/3559/SA 2016/FS/NGO/2755,8/10/2017 8:01:20 AM,Overall,567,533,0,0,1100,903,947,2553,2659,7062
70,Syria Cross border,2016,TUR-16/3559/SA 2016/FS/NGO/2760,6/1/2017 8:40:30 AM,Host Communities,100,150,625,625,1500,261,319,309,312,1201
70,Syria Cross border,2016,TUR-16/3559/SA 2016/FS/NGO/2760,6/1/2017 8:40:30 AM,Internally Displaced People,40,60,250,250,600,141,196,207,204,748
70,Syria Cross border,2016,TUR-16/3559/SA 2016/FS/NGO/2760,6/1/2017 8:40:30 AM,Overall,140,210,875,875,2100,402,515,516,516,1949
70,Syria Cross border,2016,TUR-16/3559/SA 2016/FS/NGO/2771,7/19/2017 6:28:41 AM,Host Communities,593,630,579,579,2381,594,635,590,593,2412
70,Syria Cross border,2016,TUR-16/3559/SA 2016/FS/NGO/2771,7/19/2017 6:28:41 AM,Internally Displaced People,153,157,195,179,684,200,168,295,281,944
70,Syria Cross border,2016,TUR-16/3559/SA 2016/FS/NGO/2771,7/19/2017 6:28:41 AM,Overall,746,787,774,758,3065,794,803,888,871,3356
70,Syria Cross border,2016,TUR-16/3559/SA 2016/FS/UN/2779,3/22/2018 1:39:35 PM,Host Communities,4079,1323,0,0,5402,177,62,60,22,321
70,Syria Cross border,2016,TUR-16/3559/SA 2016/FS/UN/2779,3/22/2018 1:39:35 PM,Internally Displaced People,396,202,0,0,598,2721,1010,1096,402,5229
70,Syria Cross border,2016,TUR-16/3559/SA 2016/FS/UN/2779,3/22/2018 1:39:35 PM,Overall,4475,1525,0,0,6000,3048,1004,1127,371,5550
70,Syria Cross border,2016,TUR-16/3559/SA 2016/H/INGO/2599,5/10/2017 7:06:43 AM,Host Communities,0,15225,3458,3674,22357,0,7245,5182,5384,17811
70,Syria Cross border,2016,TUR-16/3559/SA 2016/H/INGO/2599,5/10/2017 7:06:43 AM,Internally Displaced People,3854,6211,7246,8281,25592,3900,7028,7458,7728,26114
70,Syria Cross border,2016,TUR-16/3559/SA 2016/H/INGO/2599,5/10/2017 7:06:43 AM,Overall,3854,21436,10704,11955,47949,3900,14273,12640,13112,43925
70,Syria Cross border,2016,TUR-16/3559/SA 2016/H/INGO/2706,6/23/2017 6:53:53 AM,Host Communities,12554,29803,15813,18560,76730,8125,29065,14279,19805,71274
70,Syria Cross border,2016,TUR-16/3559/SA 2016/H/INGO/2706,6/23/2017 6:53:53 AM,Internally Displaced People,3138,7451,3953,4640,19182,2188,4044,3237,4672,14141
70,Syria Cross border,2016,TUR-16/3559/SA 2016/H/INGO/2706,6/23/2017 6:53:53 AM,Overall,15692,37254,19766,23200,95912,10313,33109,17516,24477,85415
70,Syria Cross border,2016,TUR-16/3559/SA 2016/H/NGO/2712,5/8/2017 6:46:50 AM,Host Communities,15778,33661,14270,17379,81088,17680,23333,15562,15681,72256
70,Syria Cross border,2016,TUR-16/3559/SA 2016/H/NGO/2712,5/8/2017 6:46:50 AM,Internally Displaced People,4450,11826,4263,5191,25730,7465,14347,7744,7239,36795
70,Syria Cross border,2016,TUR-16/3559/SA 2016/H/NGO/2712,5/8/2017 6:46:50 AM,Overall,20228,45487,18533,22570,106818,25145,37680,23306,22920,109051
70,Syria Cross border,2016,TUR-16/3559/SA 2016/H/NGO/2736,8/18/2017 8:54:37 AM,Host Communities,0,13200,528,792,14520,0,26613,1288,1980,29881
70,Syria Cross border,2016,TUR-16/3559/SA 2016/H/NGO/2736,8/18/2017 8:54:37 AM,Internally Displaced People,0,19800,792,1188,21780,0,17743,860,1320,19923
70,Syria Cross border,2016,TUR-16/3559/SA 2016/H/NGO/2736,8/18/2017 8:54:37 AM,Overall,0,33000,1320,1980,36300,0,44356,2148,3300,49804
70,Syria Cross border,2016,TUR-16/3559/SA 2016/H/NGO/2752,8/18/2017 8:35:48 AM,Host Communities,1210,505,202,101,2018,1273,579,627,444,2923
70,Syria Cross border,2016,TUR-16/3559/SA 2016/H/NGO/2752,8/18/2017 8:35:48 AM,Internally Displaced People,807,336,134,67,1344,176,24,51,30,281
70,Syria Cross border,2016,TUR-16/3559/SA 2016/H/NGO/2752,8/18/2017 8:35:48 AM,Overall,2017,841,336,168,3362,1449,603,678,474,3204
70,Syria Cross border,2016,TUR-16/3559/SA 2016/H/NGO/2757,5/24/2017 10:47:26 AM,Host Communities,20902,48915,18338,25155,113310,18613,47309,22026,19774,107722
70,Syria Cross border,2016,TUR-16/3559/SA 2016/H/NGO/2757,5/24/2017 10:47:26 AM,Internally Displaced People,9836,23019,8630,11838,53323,8759,22263,10365,9306,50693
70,Syria Cross border,2016,TUR-16/3559/SA 2016/H/NGO/2757,5/24/2017 10:47:26 AM,Overall,30738,71934,26968,36993,166633,27372,69572,32391,29080,158415
70,Syria Cross border,2016,TUR-16/3559/SA 2016/H/NGO/2778,6/13/2017 9:27:05 AM,Other,14144,20768,13424,15194,63530,21918,26871,17039,19720,85548
70,Syria Cross border,2016,TUR-16/3559/SA 2016/H/NGO/2778,6/13/2017 9:27:05 AM,Overall,14144,20768,13424,15194,63530,21918,26871,17039,19720,85548
70,Syria Cross border,2016,TUR-16/3559/SA 2016/H-N/NGO/2739,8/17/2017 1:56:33 PM,Host Communities,0,2520,10250,9072,21842,0,10353,9572,10262,30187
70,Syria Cross border,2016,TUR-16/3559/SA 2016/H-N/NGO/2739,8/17/2017 1:56:33 PM,Internally Displaced People,0,1680,6834,6048,14562,0,4602,3803,4021,12426
70,Syria Cross border,2016,TUR-16/3559/SA 2016/H-N/NGO/2739,8/17/2017 1:56:33 PM,Overall,0,4200,17084,15120,36404,0,14955,13375,14283,42613
70,Syria Cross border,2016,TUR-16/3559/SA 2016/H-N/NGO/2754,5/17/2017 11:11:25 AM,Host Communities,800,1750,1103,1347,5000,1604,6055,2330,3036,13025
70,Syria Cross border,2016,TUR-16/3559/SA 2016/H-N/NGO/2754,5/17/2017 11:11:25 AM,Internally Displaced People,7200,15750,9922,12128,45000,14439,54504,20974,27330,117247
70,Syria Cross border,2016,TUR-16/3559/SA 2016/H-N/NGO/2754,5/17/2017 11:11:25 AM,Overall,8000,17500,11025,13475,50000,16043,60559,23304,30366,130272
70,Syria Cross border,2016,TUR-16/3559/SA 2016/H-N/NGO/2767,6/30/2017 8:04:49 AM,Host Communities,4464,15256,12110,12679,44509,6919,18468,15031,13408,53826
70,Syria Cross border,2016,TUR-16/3559/SA 2016/H-N/NGO/2767,6/30/2017 8:04:49 AM,Internally Displaced People,2977,10171,8074,8453,29675,4613,12313,10021,8939,35886
70,Syria Cross border,2016,TUR-16/3559/SA 2016/H-N/NGO/2767,6/30/2017 8:04:49 AM,Overall,7441,25427,20184,21132,74184,11532,30781,25052,22347,89712
70,Syria Cross border,2016,TUR-16/3559/SA 2016/NFI/INGO/2776,4/7/2017 12:45:25 PM,Overall,4823,6416,6867,7694,25800,4300,5614,7711,7666,25291
70,Syria Cross border,2016,TUR-16/3559/SA 2016/NFI/NGO/2762,5/5/2017 7:00:51 AM,Host Communities,250,350,300,600,1500,460,510,640,690,2300
70,Syria Cross border,2016,TUR-16/3559/SA 2016/NFI/NGO/2762,5/5/2017 7:00:51 AM,Overall,250,350,300,600,1500,460,510,640,690,2300
70,Syria Cross border,2016,TUR-16/3559/SA 2016/NFI/NGO/2765,4/21/2017 6:42:06 AM,Host Communities,292,310,336,330,1268,313,317,313,487,1430
70,Syria Cross border,2016,TUR-16/3559/SA 2016/NFI/NGO/2765,4/21/2017 6:42:06 AM,Internally Displaced People,82,89,91,95,357,151,157,163,189,660
70,Syria Cross border,2016,TUR-16/3559/SA 2016/NFI/NGO/2765,4/21/2017 6:42:06 AM,Overall,370,403,425,427,1625,464,474,476,676,2090
70,Syria Cross border,2016,TUR-16/3559/SA 2016/NFI/NGO/2775,2/14/2017 7:15:57 AM,Host Communities,95,115,95,115,420,475,728,996,941,3140
70,Syria Cross border,2016,TUR-16/3559/SA 2016/NFI/NGO/2775,2/14/2017 7:15:57 AM,Internally Displaced People,0,0,0,0,0,253,366,551,506,1676
70,Syria Cross border,2016,TUR-16/3559/SA 2016/NFI/NGO/2775,2/14/2017 7:15:57 AM,Overall,1160,1225,1230,1285,4900,728,1094,1547,1447,4816
70,Syria Cross border,2016,TUR-16/3559/SA 2016/P/INGO/2586,7/17/2017 12:29:40 PM,Host Communities,698,734,3082,3432,7946,4165,1582,5617,6220,17584
70,Syria Cross border,2016,TUR-16/3559/SA 2016/P/INGO/2586,7/17/2017 12:29:40 PM,Internally Displaced People,480,507,2162,2406,5555,1779,1372,3054,3536,9741
70,Syria Cross border,2016,TUR-16/3559/SA 2016/P/INGO/2586,7/17/2017 12:29:40 PM,Overall,1178,1241,5244,5838,13501,5944,2954,8671,9756,27325
70,Syria Cross border,2016,TUR-16/3559/SA 2016/P/INGO/2749,6/7/2017 8:47:51 AM,Host Communities,1112,1423,1732,1980,6247,1776,2281,2664,3108,9829
70,Syria Cross border,2016,TUR-16/3559/SA 2016/P/INGO/2749,6/7/2017 8:47:51 AM,Internally Displaced People,488,1231,1456,1567,4742,1508,1813,2569,3022,8912
70,Syria Cross border,2016,TUR-16/3559/SA 2016/P/INGO/2749,6/7/2017 8:47:51 AM,Other,98,98,0,0,196,165,158,0,0,323
70,Syria Cross border,2016,TUR-16/3559/SA 2016/P/INGO/2749,6/7/2017 8:47:51 AM,Overall,1698,2752,3188,3547,11185,3486,4215,5233,6130,19064
70,Syria Cross border,2016,TUR-16/3559/SA 2016/P/INGO/2769,11/8/2017 7:03:08 AM,Host Communities,8000,10000,18000,18000,54000,9095,11065,19478,19590,59228
70,Syria Cross border,2016,TUR-16/3559/SA 2016/P/INGO/2769,11/8/2017 7:03:08 AM,Internally Displaced People,1500,3000,1500,1500,7500,2556,3299,1917,2182,9954
70,Syria Cross border,2016,TUR-16/3559/SA 2016/P/INGO/2769,11/8/2017 7:03:08 AM,Overall,9500,13000,19500,19500,61500,11651,14364,21395,21772,69182
70,Syria Cross border,2016,TUR-16/3559/SA 2016/P/INGO/2770,5/23/2017 10:27:14 AM,Host Communities,7468,9445,8219,7073,32205,8109,11829,12102,8850,40890
70,Syria Cross border,2016,TUR-16/3559/SA 2016/P/INGO/2770,5/23/2017 10:27:14 AM,Internally Displaced People,5634,7306,6200,5335,24475,6495,8847,9626,8236,33204
70,Syria Cross border,2016,TUR-16/3559/SA 2016/P/INGO/2770,5/23/2017 10:27:14 AM,Overall,13102,16751,14419,12408,56680,14604,20676,21728,17086,74094
70,Syria Cross border,2016,TUR-16/3559/SA 2016/P/NGO/2600,5/8/2017 6:49:54 AM,Host Communities,400,900,3800,4200,9300,352,890,3602,3383,8227
70,Syria Cross border,2016,TUR-16/3559/SA 2016/P/NGO/2600,5/8/2017 6:49:54 AM,Internally Displaced People,500,1300,4800,4900,11500,528,1280,4513,4715,11036
70,Syria Cross border,2016,TUR-16/3559/SA 2016/P/NGO/2600,5/8/2017 6:49:54 AM,Overall,900,2200,8700,9000,20800,880,2170,8115,8098,19263
70,Syria Cross border,2016,TUR-16/3559/SA 2016/WASH/INGO/2729,9/21/2017 7:32:27 AM,Host Communities,3095,7369,7566,6510,24540,4343,7315,5715,5486,22859
70,Syria Cross border,2016,TUR-16/3559/SA 2016/WASH/INGO/2729,9/21/2017 7:32:27 AM,Internally Displaced People,6433,9085,5351,5648,26517,6937,11685,9129,8764,36515
70,Syria Cross border,2016,TUR-16/3559/SA 2016/WASH/INGO/2729,9/21/2017 7:32:27 AM,Overall,9528,16454,12917,12158,51057,11281,19000,14844,14249,59374
70,Syria Cross border,2016,TUR-16/3559/SA 2016/WASH/NGO/2721,2/13/2017 1:51:02 PM,Host Communities,8110,15070,9490,14890,47560,7900,11570,14500,17787,51757
70,Syria Cross border,2016,TUR-16/3559/SA 2016/WASH/NGO/2721,2/13/2017 1:51:02 PM,Internally Displaced People,19105,27415,24440,31520,102480,17592,20470,28881,33100,100043
70,Syria Cross border,2016,TUR-16/3559/SA 2016/WASH/NGO/2721,2/13/2017 1:51:02 PM,Overall,27215,42485,33890,46410,150000,25492,32040,43381,50887,151800
70,Syria Cross border,2016,TUR-16/3559/SA 2016/WASH/NGO/2723,4/5/2018 10:51:00 AM,Host Communities,1750,6125,4375,5250,17500,1650,6200,4150,5500,17500
70,Syria Cross border,2016,TUR-16/3559/SA 2016/WASH/NGO/2723,4/5/2018 10:51:00 AM,Internally Displaced People,450,1575,1125,1350,4500,550,1500,1350,1100,4500
70,Syria Cross border,2016,TUR-16/3559/SA 2016/WASH/NGO/2723,4/5/2018 10:51:00 AM,Overall,2200,7700,5500,6600,22000,2200,7700,5500,6600,22000
70,Syria Cross border,2016,TUR-16/3559/SA 2016/WASH/NGO/2766,7/3/2017 8:54:00 AM,Host Communities,9005,9005,18120,18120,54250,7522,7989,14727,16544,46782
70,Syria Cross border,2016,TUR-16/3559/SA 2016/WASH/NGO/2766,7/3/2017 8:54:00 AM,Internally Displaced People,4195,4195,8405,8405,25200,3530,4347,8502,9679,26058
70,Syria Cross border,2016,TUR-16/3559/SA 2016/WASH/NGO/2766,7/3/2017 8:54:00 AM,Overall,13200,13200,26525,26525,79450,11052,12336,23229,26223,72840
70,Syria Cross border,2016,TUR-16/3559/SA 2016/WASH/NGO/2780,6/8/2017 6:36:54 AM,Host Communities,0,0,0,0,0,25430,23581,20807,22658,92476
70,Syria Cross border,2016,TUR-16/3559/SA 2016/WASH/NGO/2780,6/8/2017 6:36:54 AM,Internally Displaced People,0,0,0,0,0,7172,6650,5868,6392,26082
70,Syria Cross border,2016,TUR-16/3559/SA 2016/WASH/NGO/2780,6/8/2017 6:36:54 AM,Overall,39566,44096,31124,40714,155500,32603,30232,26675,29048,118558
70,Syria Cross border,2016,TUR-16/3559/SA 2016/WASH-E/NGO/2746,10/12/2017 7:02:47 AM,Host Communities,20348,23740,18165,21238,83491,18368,19203,22543,23377,83491
70,Syria Cross border,2016,TUR-16/3559/SA 2016/WASH-E/NGO/2746,10/12/2017 7:02:47 AM,Internally Displaced People,2523,3118,2917,3565,12123,2673,2796,3281,3403,12153
70,Syria Cross border,2016,TUR-16/3559/SA 2016/WASH-E/NGO/2746,10/12/2017 7:02:47 AM,Other,19,20,397,473,909,20,22,446,551,1039
70,Syria Cross border,2016,TUR-16/3559/SA 2016/WASH-E/NGO/2746,10/12/2017 7:02:47 AM,Overall,22890,26878,21479,25276,96523,21061,22021,26270,27331,96683
70,Syria Cross border,2016,TUR-16/3559/SA2/CCM/INGO/3792,6/30/2017 11:10:42 AM,Internally Displaced People,5365,6213,9587,7050,28215,5568,6042,3999,3520,19129
70,Syria Cross border,2016,TUR-16/3559/SA2/CCM/INGO/3792,6/30/2017 11:10:42 AM,Overall,5365,6213,9587,7050,28215,5568,6042,3999,3520,19129
70,Syria Cross border,2016,TUR-16/3559/SA2/CCM/INGO/3861,6/1/2017 8:22:58 AM,Internally Displaced People,3019,3319,4290,4306,14934,3285,3737,5086,5155,17263
70,Syria Cross border,2016,TUR-16/3559/SA2/CCM/INGO/3861,6/1/2017 8:22:58 AM,Overall,3019,3319,4290,4306,14934,3285,3737,5086,5155,17263
70,Syria Cross border,2016,TUR-16/3559/SA2/CCM/NGO/3651,6/28/2017 8:14:24 AM,Internally Displaced People,680,990,1800,1700,5170,1243,1028,1341,1067,4679
70,Syria Cross border,2016,TUR-16/3559/SA2/CCM/NGO/3651,6/28/2017 8:14:24 AM,Overall,680,990,1800,1700,5170,1243,1028,1341,1067,4679
70,Syria Cross border,2016,TUR-16/3559/SA2/CCM/NGO/3758,8/1/2017 11:51:52 AM,Internally Displaced People,11560,13988,14146,13221,52915,11344,13631,13708,12814,51497
70,Syria Cross border,2016,TUR-16/3559/SA2/CCM/NGO/3758,8/1/2017 11:51:52 AM,Overall,11560,13988,14146,13221,52915,11344,13631,13708,12814,51497
70,Syria Cross border,2016,TUR-16/3559/SA2/CCM/NGO/3781,3/7/2018 8:57:12 AM,Internally Displaced People,2270,4205,2514,2647,11636,2270,4205,2514,2647,11636
70,Syria Cross border,2016,TUR-16/3559/SA2/CCM/NGO/3781,3/7/2018 8:57:12 AM,Overall,2270,4205,2514,2647,11636,2270,4205,2514,2647,11636
70,Syria Cross border,2016,TUR-16/3559/SA2/CCM-FS-NFI/UN/3818,4/2/2018 8:54:14 AM,Internally Displaced People,11740,11700,43000,43000,109440,13596,12866,40030,39937,106429
70,Syria Cross border,2016,TUR-16/3559/SA2/CCM-FS-NFI/UN/3818,4/2/2018 8:54:14 AM,Overall,11740,11700,43000,43000,109440,13596,12866,40030,39937,106429
70,Syria Cross border,2016,TUR-16/3559/SA2/E/NGO/3428,6/4/2018 12:08:55 PM,Host Communities,22,33,240,420,715,24,35,340,625,1024
70,Syria Cross border,2016,TUR-16/3559/SA2/E/NGO/3428,6/4/2018 12:08:55 PM,Internally Displaced People,15,22,160,280,477,26,3,60,150,239
70,Syria Cross border,2016,TUR-16/3559/SA2/E/NGO/3428,6/4/2018 12:08:55 PM,Overall,37,55,400,700,1192,50,38,400,775,1263
70,Syria Cross border,2016,TUR-16/3559/SA2/E/NGO/3794,7/27/2017 11:07:08 AM,Host Communities,127,142,3345,4870,8484,127,142,3345,4870,8484
70,Syria Cross border,2016,TUR-16/3559/SA2/E/NGO/3794,7/27/2017 11:07:08 AM,Internally Displaced People,0,0,259,348,607,0,0,259,348,607
70,Syria Cross border,2016,TUR-16/3559/SA2/E/NGO/3794,7/27/2017 11:07:08 AM,Overall,127,142,3604,5218,9091,127,142,3604,5218,9091
70,Syria Cross border,2016,TUR-16/3559/SA2/E/NGO/3813,2/15/2018 10:08:04 AM,Host Communities,12,13,369,245,639,32,1,298,228,559
70,Syria Cross border,2016,TUR-16/3559/SA2/E/NGO/3813,2/15/2018 10:08:04 AM,Internally Displaced People,4,6,120,75,205,2,0,104,76,182
70,Syria Cross border,2016,TUR-16/3559/SA2/E/NGO/3813,2/15/2018 10:08:04 AM,Overall,16,19,489,320,844,34,1,402,304,741
70,Syria Cross border,2016,TUR-16/3559/SA2/E/NGO/3835,3/7/2018 8:42:58 AM,Host Communities,18,122,1665,1690,3495,22,150,1830,1686,3688
70,Syria Cross border,2016,TUR-16/3559/SA2/E/NGO/3835,3/7/2018 8:42:58 AM,Internally Displaced People,3,14,143,156,316,5,15,152,142,314
70,Syria Cross border,2016,TUR-16/3559/SA2/E/NGO/3835,3/7/2018 8:42:58 AM,Overall,21,136,1808,1846,3811,27,165,1982,1828,4002
70,Syria Cross border,2016,TUR-16/3559/SA2/E/NGO/3842,9/28/2017 7:42:54 AM,Host Communities,30,32,421,443,926,57,21,460,456,994
70,Syria Cross border,2016,TUR-16/3559/SA2/E/NGO/3842,9/28/2017 7:42:54 AM,Internally Displaced People,12,16,285,291,604,22,8,252,292,574
70,Syria Cross border,2016,TUR-16/3559/SA2/E/NGO/3842,9/28/2017 7:42:54 AM,Overall,42,48,706,734,1530,79,29,712,748,1568
70,Syria Cross border,2016,TUR-16/3559/SA2/E/NGO/3866,11/6/2017 10:43:48 AM,Host Communities,45,67,1330,1826,3268,45,67,1330,1826,3268
70,Syria Cross border,2016,TUR-16/3559/SA2/E/NGO/3866,11/6/2017 10:43:48 AM,Internally Displaced People,15,23,665,609,1312,15,23,665,609,1312
70,Syria Cross border,2016,TUR-16/3559/SA2/E/NGO/3866,11/6/2017 10:43:48 AM,Overall,60,90,1995,2435,4580,60,90,1995,2435,4580
70,Syria Cross border,2016,TUR-16/3559/SA2/E/NGO/3878,12/14/2018 12:22:34 PM,Internally Displaced People,37,29,533,545,1144,23,21,404,478,926
70,Syria Cross border,2016,TUR-16/3559/SA2/E/NGO/3878,12/14/2018 12:22:34 PM,Other,149,84,2637,2092,4962,94,54,1974,1868,3990
70,Syria Cross border,2016,TUR-16/3559/SA2/E/NGO/3878,12/14/2018 12:22:34 PM,Overall,186,113,3170,2637,6106,117,75,2378,2346,4916
70,Syria Cross border,2016,TUR-16/3559/SA2/E/NGO/3883,12/17/2017 1:31:22 PM,Overall,200,219,518,562,1499,251,164,588,551,1554
70,Syria Cross border,2016,TUR-16/3559/SA2/E-P/NGO/3669,10/12/2017 10:38:58 AM,Host Communities,174,114,1489,1621,3398,174,114,1489,1621,3398
70,Syria Cross border,2016,TUR-16/3559/SA2/E-P/NGO/3669,10/12/2017 10:38:58 AM,Overall,174,114,1489,1621,3398,174,114,1489,1621,3398
70,Syria Cross border,2016,TUR-16/3559/SA2/FS/INGO/3788,2/6/2018 8:21:21 AM,Host Communities,4650,4538,4500,4500,18188,4394,915,8788,1830,15927
70,Syria Cross border,2016,TUR-16/3559/SA2/FS/INGO/3788,2/6/2018 8:21:21 AM,Internally Displaced People,1550,1512,1500,1500,6062,232,50,464,100,846
70,Syria Cross border,2016,TUR-16/3559/SA2/FS/INGO/3788,2/6/2018 8:21:21 AM,Overall,6200,6050,6000,6000,24250,5544,5394,11088,11000,33026
70,Syria Cross border,2016,TUR-16/3559/SA2/FS/NGO/3393,9/29/2017 12:29:14 PM,Host Communities,414,476,1656,1904,4450,680,913,1986,1931,5510
70,Syria Cross border,2016,TUR-16/3559/SA2/FS/NGO/3393,9/29/2017 12:29:14 PM,Internally Displaced People,51,59,205,235,550,97,122,269,311,799
70,Syria Cross border,2016,TUR-16/3559/SA2/FS/NGO/3393,9/29/2017 12:29:14 PM,Overall,465,535,1861,2139,5000,777,1035,2255,2242,6309
70,Syria Cross border,2016,TUR-16/3559/SA2/FS/NGO/3649,10/12/2017 7:26:39 AM,Host Communities,107,157,168,168,600,140,197,141,159,637
70,Syria Cross border,2016,TUR-16/3559/SA2/FS/NGO/3649,10/12/2017 7:26:39 AM,Overall,107,157,168,168,600,140,197,141,159,637
70,Syria Cross border,2016,TUR-16/3559/SA2/FS/NGO/3754,2/21/2018 9:06:50 AM,Host Communities,14175,13720,33495,34265,95655,23123,17509,40505,53991,135128
70,Syria Cross border,2016,TUR-16/3559/SA2/FS/NGO/3754,2/21/2018 9:06:50 AM,Internally Displaced People,6075,5880,14355,14685,40995,6222,5941,15236,14963,42362
70,Syria Cross border,2016,TUR-16/3559/SA2/FS/NGO/3754,2/21/2018 9:06:50 AM,Overall,20250,19600,47850,48950,136650,29345,23450,55741,68954,177490
70,Syria Cross border,2016,TUR-16/3559/SA2/FS/NGO/3843,11/23/2017 10:32:43 AM,Host Communities,214,226,273,287,1000,277,304,401,343,1325
70,Syria Cross border,2016,TUR-16/3559/SA2/FS/NGO/3843,11/23/2017 10:32:43 AM,Internally Displaced People,107,112,137,144,500,114,143,157,200,614
70,Syria Cross border,2016,TUR-16/3559/SA2/FS/NGO/3843,11/23/2017 10:32:43 AM,Overall,321,338,410,431,1500,391,447,558,543,1939
70,Syria Cross border,2016,TUR-16/3559/SA2/FS/NGO/3852,7/25/2018 1:52:33 PM,Host Communities,630,240,1240,1520,3630,904,271,2683,3145,7003
70,Syria Cross border,2016,TUR-16/3559/SA2/FS/NGO/3852,7/25/2018 1:52:33 PM,Internally Displaced People,320,110,460,680,1570,101,24,321,377,823
70,Syria Cross border,2016,TUR-16/3559/SA2/FS/NGO/3852,7/25/2018 1:52:33 PM,Overall,950,350,1700,2200,5200,1005,295,3004,3522,7826
70,Syria Cross border,2016,TUR-16/3559/SA2/FS/NGO/3859,10/13/2017 7:57:53 AM,Host Communities,918,918,1782,1782,5400,374,523,752,682,2331
70,Syria Cross border,2016,TUR-16/3559/SA2/FS/NGO/3859,10/13/2017 7:57:53 AM,Internally Displaced People,102,102,198,198,600,417,720,684,639,2460
70,Syria Cross border,2016,TUR-16/3559/SA2/FS/NGO/3859,10/13/2017 7:57:53 AM,Overall,1020,1020,1980,1980,6000,791,1243,1436,1321,4791
70,Syria Cross border,2016,TUR-16/3559/SA2/FS/NGO/3879,11/7/2017 1:37:41 PM,Host Communities,800,900,1400,1700,4800,1415,1428,1501,1460,5804
70,Syria Cross border,2016,TUR-16/3559/SA2/FS/NGO/3879,11/7/2017 1:37:41 PM,Overall,800,900,1400,1700,4800,1415,1428,1501,1460,5804
70,Syria Cross border,2016,TUR-16/3559/SA2/FS/UN/3757,8/1/2018 12:07:55 PM,Host Communities,0,0,0,0,0,2251,2464,2860,3141,10716
70,Syria Cross border,2016,TUR-16/3559/SA2/FS/UN/3757,8/1/2018 12:07:55 PM,Overall,1350,450,0,0,1800,635,666,238,247,1786
70,Syria Cross border,2016,TUR-16/3559/SA2/H/INGO/3874,10/24/2017 7:41:18 AM,Host Communities,12375,12828,6791,4631,36625,21819,20535,13691,10458,66503
70,Syria Cross border,2016,TUR-16/3559/SA2/H/INGO/3874,10/24/2017 7:41:18 AM,Internally Displaced People,1524,1451,830,522,4327,2492,1376,1114,473,5455
70,Syria Cross border,2016,TUR-16/3559/SA2/H/INGO/3874,10/24/2017 7:41:18 AM,Overall,13899,14279,7621,5153,40952,24311,21911,14805,10931,71958
70,Syria Cross border,2016,TUR-16/3559/SA2/H/INGO/3876,9/6/2017 9:00:14 AM,Host Communities,1620,505,250,125,2500,3280,1084,468,206,5038
70,Syria Cross border,2016,TUR-16/3559/SA2/H/INGO/3876,9/6/2017 9:00:14 AM,Internally Displaced People,800,245,120,60,1225,119,82,18,12,231
70,Syria Cross border,2016,TUR-16/3559/SA2/H/INGO/3876,9/6/2017 9:00:14 AM,Overall,2420,750,370,185,3725,3399,1166,486,218,5269
70,Syria Cross border,2016,TUR-16/3559/SA2/H/NGO/3761,10/24/2017 7:51:24 AM,Host Communities,5103,3626,2996,2415,14140,9674,5709,3172,1520,20075
70,Syria Cross border,2016,TUR-16/3559/SA2/H/NGO/3761,10/24/2017 7:51:24 AM,Internally Displaced People,5537,3955,3248,2639,15379,10479,5269,3047,1234,20029
70,Syria Cross border,2016,TUR-16/3559/SA2/H/NGO/3761,10/24/2017 7:51:24 AM,Overall,10640,7581,6244,5054,29519,20153,10978,6219,2754,40104
70,Syria Cross border,2016,TUR-16/3559/SA2/H/NGO/3780,10/6/2017 2:22:11 PM,Host Communities,9360,16640,4160,3900,34060,11093,16059,9326,7606,44084
70,Syria Cross border,2016,TUR-16/3559/SA2/H/NGO/3780,10/6/2017 2:22:11 PM,Internally Displaced People,5040,8960,2240,2100,18340,5057,8100,4394,3323,20874
70,Syria Cross border,2016,TUR-16/3559/SA2/H/NGO/3780,10/6/2017 2:22:11 PM,Overall,14400,25600,6400,6000,52400,16150,24159,13720,10929,64958
70,Syria Cross border,2016,TUR-16/3559/SA2/H/NGO/3837,1/15/2018 12:17:29 PM,Host Communities,5758,9946,3926,6543,26173,8034,4062,4126,2001,18223
70,Syria Cross border,2016,TUR-16/3559/SA2/H/NGO/3837,1/15/2018 12:17:29 PM,Internally Displaced People,5315,9181,3624,6040,24160,1017,446,366,152,1981
70,Syria Cross border,2016,TUR-16/3559/SA2/H/NGO/3837,1/15/2018 12:17:29 PM,Overall,11073,19127,7550,12584,50334,9051,4499,4492,2153,20195
70,Syria Cross border,2016,TUR-16/3559/SA2/H/NGO/3860,1/18/2018 6:43:12 AM,Host Communities,1663,1940,1109,831,5543,4802,2121,2841,1247,11011
70,Syria Cross border,2016,TUR-16/3559/SA2/H/NGO/3860,1/18/2018 6:43:12 AM,Internally Displaced People,647,755,432,324,2158,1921,871,1223,509,4524
70,Syria Cross border,2016,TUR-16/3559/SA2/H/NGO/3860,1/18/2018 6:43:12 AM,Overall,2310,2695,1541,1155,7701,6723,3936,3120,1756,15535
70,Syria Cross border,2016,TUR-16/3559/SA2/H/NGO/3862,11/3/2017 12:32:02 PM,Host Communities,19693,11298,8097,8743,47831,24045,10131,10935,7661,52772
70,Syria Cross border,2016,TUR-16/3559/SA2/H/NGO/3862,11/3/2017 12:32:02 PM,Internally Displaced People,3476,3970,2152,2050,11648,6847,3303,3416,2404,15970
70,Syria Cross border,2016,TUR-16/3559/SA2/H/NGO/3862,11/3/2017 12:32:02 PM,Overall,23169,15268,10249,10793,59479,30892,13434,14351,10065,68742
70,Syria Cross border,2016,TUR-16/3559/SA2/H/NGO/3869,2/9/2018 5:37:35 AM,Host Communities,3402,5014,5741,7016,21173,12218,24702,9666,19448,66034
70,Syria Cross border,2016,TUR-16/3559/SA2/H/NGO/3869,2/9/2018 5:37:35 AM,Internally Displaced People,1134,1700,1914,2338,7086,4072,8234,3222,6482,22010
70,Syria Cross border,2016,TUR-16/3559/SA2/H/NGO/3869,2/9/2018 5:37:35 AM,Overall,4536,6804,7655,9355,28350,16290,32936,12888,25930,88044
70,Syria Cross border,2016,TUR-16/3559/SA2/H/NGO/3877,6/1/2017 8:20:31 AM,Host Communities,15533,17883,8824,9523,51763,3558,1890,1694,1332,8474
70,Syria Cross border,2016,TUR-16/3559/SA2/H/NGO/3877,6/1/2017 8:20:31 AM,Internally Displaced People,3181,3663,1807,1950,10601,17372,9226,8271,6503,41372
70,Syria Cross border,2016,TUR-16/3559/SA2/H/NGO/3877,6/1/2017 8:20:31 AM,Overall,18714,21546,10631,11473,62364,20930,11116,9965,7835,49846
70,Syria Cross border,2016,TUR-16/3559/SA2/H-N/INGO/3444,6/14/2017 1:24:41 PM,Host Communities,1680,2788,1556,1658,7682,3381,4709,3204,2378,13672
70,Syria Cross border,2016,TUR-16/3559/SA2/H-N/INGO/3444,6/14/2017 1:24:41 PM,Internally Displaced People,3120,5412,3019,3217,14768,4573,4401,3714,2429,15117
70,Syria Cross border,2016,TUR-16/3559/SA2/H-N/INGO/3444,6/14/2017 1:24:41 PM,Overall,4800,8200,4575,4875,22450,7954,9110,6918,4807,28789
70,Syria Cross border,2016,TUR-16/3559/SA2/H-N/NGO/3716,5/17/2018 8:50:38 AM,Host Communities,2413,5011,2198,2069,11691,2111,5426,1368,1213,10118
70,Syria Cross border,2016,TUR-16/3559/SA2/H-N/NGO/3716,5/17/2018 8:50:38 AM,Internally Displaced People,2489,4845,2112,2023,11469,5356,12226,2556,2289,22427
70,Syria Cross border,2016,TUR-16/3559/SA2/H-N/NGO/3716,5/17/2018 8:50:38 AM,Overall,4902,9856,4310,4092,23160,7467,17652,3924,3502,32545
70,Syria Cross border,2016,TUR-16/3559/SA2/H-N/NGO/3790,3/27/2018 12:41:28 PM,Host Communities,16848,21216,11232,14352,63648,6472,13194,8850,9469,37985
70,Syria Cross border,2016,TUR-16/3559/SA2/H-N/NGO/3790,3/27/2018 12:41:28 PM,Internally Displaced People,3120,3744,1872,2496,11232,2523,5545,3361,2777,14206
70,Syria Cross border,2016,TUR-16/3559/SA2/H-N/NGO/3790,3/27/2018 12:41:28 PM,Overall,19968,24960,13104,16848,74880,8995,18739,12211,12246,52191
70,Syria Cross border,2016,TUR-16/3559/SA2/H-N/NGO/3834,1/23/2018 8:21:07 AM,Host Communities,5604,9676,3819,6369,25468,11721,11640,6672,5153,35186
70,Syria Cross border,2016,TUR-16/3559/SA2/H-N/NGO/3834,1/23/2018 8:21:07 AM,Internally Displaced People,5192,8965,3538,5900,23595,3658,8205,3706,3774,19343
70,Syria Cross border,2016,TUR-16/3559/SA2/H-N/NGO/3834,1/23/2018 8:21:07 AM,Overall,10796,18641,7357,12269,49063,15379,19845,10378,8947,54549
70,Syria Cross border,2016,TUR-16/3559/SA2/NFI/INGO/3770,6/1/2017 8:22:16 AM,Host Communities,4399,4399,3457,3457,15712,1809,2259,4575,4937,13580
70,Syria Cross border,2016,TUR-16/3559/SA2/NFI/INGO/3770,6/1/2017 8:22:16 AM,Internally Displaced People,1032,1032,811,811,3686,1847,2344,3476,3517,11184
70,Syria Cross border,2016,TUR-16/3559/SA2/NFI/INGO/3770,6/1/2017 8:22:16 AM,Overall,5431,5431,4268,4268,19398,3656,4603,8051,8454,24764
70,Syria Cross border,2016,TUR-16/3559/SA2/NFI/NGO/3875,4/27/2017 12:22:26 PM,Host Communities,1055,1332,1499,1665,5551,850,1256,1666,1538,5310
70,Syria Cross border,2016,TUR-16/3559/SA2/NFI/NGO/3875,4/27/2017 12:22:26 PM,Internally Displaced People,3163,3996,4495,4995,16649,3010,3787,5659,5495,17951
70,Syria Cross border,2016,TUR-16/3559/SA2/NFI/NGO/3875,4/27/2017 12:22:26 PM,Overall,4218,5328,5994,6660,22200,3860,5043,7325,7033,23261
70,Syria Cross border,2016,TUR-16/3559/SA2/N-H/NGO/3737,2/15/2018 8:51:23 AM,Host Communities,3500,52500,15750,15750,87500,249,26019,15451,15977,57696
70,Syria Cross border,2016,TUR-16/3559/SA2/N-H/NGO/3737,2/15/2018 8:51:23 AM,Internally Displaced People,1500,22500,6750,6750,37500,59,9422,7178,7914,24573
70,Syria Cross border,2016,TUR-16/3559/SA2/N-H/NGO/3737,2/15/2018 8:51:23 AM,Overall,5000,75000,22500,22500,125000,308,35441,22629,23891,82269
70,Syria Cross border,2016,TUR-16/3559/SA2/P/INGO/3773,10/20/2017 11:12:07 AM,Host Communities,2500,1500,2000,2000,8000,1052,1257,3565,3688,9562
70,Syria Cross border,2016,TUR-16/3559/SA2/P/INGO/3773,10/20/2017 11:12:07 AM,Internally Displaced People,2500,1500,2000,2000,8000,1052,1257,3565,3688,9562
70,Syria Cross border,2016,TUR-16/3559/SA2/P/INGO/3773,10/20/2017 11:12:07 AM,Overall,5000,3000,4000,4000,16000,2104,2514,7130,7376,19124
70,Syria Cross border,2016,TUR-16/3559/SA2/P/INGO/3782,7/9/2018 8:52:59 AM,Host Communities,166,1036,2765,4658,8625,1688,3557,5839,6562,17646
70,Syria Cross border,2016,TUR-16/3559/SA2/P/INGO/3782,7/9/2018 8:52:59 AM,Internally Displaced People,84,509,1185,1997,3775,830,1751,2875,3231,8687
70,Syria Cross border,2016,TUR-16/3559/SA2/P/INGO/3782,7/9/2018 8:52:59 AM,Overall,250,1545,3950,6655,12400,2518,5308,8714,9793,26333
70,Syria Cross border,2016,TUR-16/3559/SA2/P/INGO/3821,11/5/2018 9:06:33 AM,Host Communities,0,0,185,223,408,4,4,98,84,190
70,Syria Cross border,2016,TUR-16/3559/SA2/P/INGO/3821,11/5/2018 9:06:33 AM,Internally Displaced People,230,2555,2550,3100,8435,785,4356,3776,5246,14163
70,Syria Cross border,2016,TUR-16/3559/SA2/P/INGO/3821,11/5/2018 9:06:33 AM,Overall,230,2555,2735,3323,8843,789,4360,3874,5330,14353
70,Syria Cross border,2016,TUR-16/3559/SA2/P/INGO/3867,5/17/2018 12:15:44 PM,Host Communities,8550,8550,12750,12750,42600,13914,13377,37137,32793,97221
70,Syria Cross border,2016,TUR-16/3559/SA2/P/INGO/3867,5/17/2018 12:15:44 PM,Internally Displaced People,8500,8500,12750,12750,42500,2374,2149,3730,3711,11964
70,Syria Cross border,2016,TUR-16/3559/SA2/P/INGO/3867,5/17/2018 12:15:44 PM,Overall,17050,17050,25500,25500,85100,15695,16615,40805,36070,109185
70,Syria Cross border,2016,TUR-16/3559/SA2/P/INGO/3868,3/22/2018 1:25:37 PM,Host Communities,5582,6068,6068,6553,24271,5663,6842,12113,12504,37122
70,Syria Cross border,2016,TUR-16/3559/SA2/P/INGO/3868,3/22/2018 1:25:37 PM,Internally Displaced People,1758,4570,5449,5802,17579,3502,4339,6279,6319,20439
70,Syria Cross border,2016,TUR-16/3559/SA2/P/INGO/3868,3/22/2018 1:25:37 PM,Other,546,546,0,0,1092,626,690,0,0,1316
70,Syria Cross border,2016,TUR-16/3559/SA2/P/INGO/3868,3/22/2018 1:25:37 PM,Overall,7886,11184,11517,12355,42942,8706,12778,18593,18249,58326
70,Syria Cross border,2016,TUR-16/3559/SA2/P/INGO/3882,8/14/2018 12:31:03 PM,Other,20,32,0,0,52,0,0,0,0,0
70,Syria Cross border,2016,TUR-16/3559/SA2/P/INGO/3882,8/14/2018 12:31:03 PM,Overall,20,32,0,0,52,71,114,0,0,185
70,Syria Cross border,2016,TUR-16/3559/SA2/P/NGO/3756,6/1/2018 7:05:28 AM,Host Communities,1857,4031,12109,12179,30176,2956,9098,34419,35920,82393
70,Syria Cross border,2016,TUR-16/3559/SA2/P/NGO/3756,6/1/2018 7:05:28 AM,Internally Displaced People,796,1728,5190,5220,12934,1266,3898,14750,15394,35308
70,Syria Cross border,2016,TUR-16/3559/SA2/P/NGO/3756,6/1/2018 7:05:28 AM,Overall,2653,5759,17299,17399,43110,4222,12996,49169,51314,117701
70,Syria Cross border,2016,TUR-16/3559/SA2/P/NGO/3785,1/23/2018 7:57:04 AM,Host Communities,1188,2288,1425,2820,7721,945,782,940,690,3357
70,Syria Cross border,2016,TUR-16/3559/SA2/P/NGO/3785,1/23/2018 7:57:04 AM,Internally Displaced People,396,762,475,940,2573,4286,3171,2306,1467,11230
70,Syria Cross border,2016,TUR-16/3559/SA2/P/NGO/3785,1/23/2018 7:57:04 AM,Overall,1584,3050,1900,3760,10294,2157,3246,3953,5231,14587
70,Syria Cross border,2016,TUR-16/3559/SA2/P/NGO/3857,12/7/2017 8:30:18 AM,Host Communities,10,27942,18410,18090,64452,14,28890,18560,25333,72797
70,Syria Cross border,2016,TUR-16/3559/SA2/P/NGO/3857,12/7/2017 8:30:18 AM,Internally Displaced People,0,3300,2000,2880,8180,1744,2429,1723,750,6646
70,Syria Cross border,2016,TUR-16/3559/SA2/P/NGO/3857,12/7/2017 8:30:18 AM,Overall,10,31242,20410,20970,72632,1758,31319,20283,26083,79443
70,Syria Cross border,2016,TUR-16/3559/SA2/P/NGO/3871,3/7/2018 9:45:53 AM,Overall,230,121,0,0,351,361,77,0,0,438
70,Syria Cross border,2016,TUR-16/3559/SA2/WASH/INGO/3769,1/23/2018 8:18:58 AM,Host Communities,425,825,625,625,2500,2861,2966,2247,2245,10319
70,Syria Cross border,2016,TUR-16/3559/SA2/WASH/INGO/3769,1/23/2018 8:18:58 AM,Internally Displaced People,954,1411,1396,1222,4983,2356,2452,1570,1635,8013
70,Syria Cross border,2016,TUR-16/3559/SA2/WASH/INGO/3769,1/23/2018 8:18:58 AM,Overall,1379,2236,2021,1847,7483,5217,5418,3817,3880,18332
70,Syria Cross border,2016,TUR-16/3559/SA2/WASH/INGO/3799,7/3/2017 7:14:53 AM,Internally Displaced People,9299,9977,11359,12003,42638,9395,10853,14808,13195,48251
70,Syria Cross border,2016,TUR-16/3559/SA2/WASH/INGO/3799,7/3/2017 7:14:53 AM,Overall,9299,9977,11359,12003,42638,9395,10853,14808,13195,48251
70,Syria Cross border,2016,TUR-16/3559/SA2/WASH/INGO/3808,3/7/2018 9:42:56 AM,Host Communities,6057,10988,4751,8377,30173,6057,10998,4751,8377,30183
70,Syria Cross border,2016,TUR-16/3559/SA2/WASH/INGO/3808,3/7/2018 9:42:56 AM,Internally Displaced People,1125,3375,1125,3375,9000,1125,3375,1125,3375,9000
70,Syria Cross border,2016,TUR-16/3559/SA2/WASH/INGO/3808,3/7/2018 9:42:56 AM,Overall,7182,14363,5876,11752,39173,7182,14383,5876,11752,39193
70,Syria Cross border,2016,TUR-16/3559/SA2/WASH/NGO/3489,5/31/2017 7:45:07 AM,Internally Displaced People,2146,2090,2830,2924,9990,2701,3142,2721,2895,11459
70,Syria Cross border,2016,TUR-16/3559/SA2/WASH/NGO/3489,5/31/2017 7:45:07 AM,Overall,2146,2090,2830,2924,9990,2701,3142,2721,2895,11459
70,Syria Cross border,2016,TUR-16/3559/SA2/WASH/NGO/3858,10/12/2017 11:32:32 AM,Host Communities,18650,27540,24310,32300,102800,18650,27540,24310,32300,102800
70,Syria Cross border,2016,TUR-16/3559/SA2/WASH/NGO/3858,10/12/2017 11:32:32 AM,Internally Displaced People,700,960,1290,1750,4700,700,960,1290,1750,4700
70,Syria Cross border,2016,TUR-16/3559/SA2/WASH/NGO/3858,10/12/2017 11:32:32 AM,Overall,19350,28500,25600,34050,107500,19350,28500,25600,34050,107500
70,Syria Cross border,2016,TUR-16/3559/SA2/WASH/NGO/3881,3/20/2018 12:38:43 PM,Host Communities,5749,7738,8962,8590,31039,0,0,0,0,0
70,Syria Cross border,2016,TUR-16/3559/SA2/WASH/NGO/3881,3/20/2018 12:38:43 PM,Internally Displaced People,1437,1935,2240,2148,7760,0,0,0,0,0
70,Syria Cross border,2016,TUR-16/3559/SA2/WASH/NGO/3881,3/20/2018 12:38:43 PM,Other,10,5,0,0,15,0,0,0,0,0
70,Syria Cross border,2016,TUR-16/3559/SA2/WASH/NGO/3881,3/20/2018 12:38:43 PM,Overall,7196,9678,11202,10738,38814,0,0,0,0,0
70,Syria Cross border,2017,TUR-17/3559/RA/CCM/UN/6367,9/16/2019 10:56:52 AM,Internally Displaced People,900,900,1800,1800,5400,636,790,1028,969,3423
70,Syria Cross border,2017,TUR-17/3559/RA/CCM/UN/6367,9/16/2019 10:56:52 AM,Overall,900,900,1800,1800,5400,636,790,1028,969,3423
70,Syria Cross border,2017,TUR-17/3559/RA/CCS/NGO/6401,8/1/2019 10:56:43 AM,Host Communities,50,50,0,0,100,100,100,0,0,200
70,Syria Cross border,2017,TUR-17/3559/RA/CCS/NGO/6401,8/1/2019 10:56:43 AM,Internally Displaced People,50,50,0,0,100,100,100,0,0,200
70,Syria Cross border,2017,TUR-17/3559/RA/CCS/NGO/6401,8/1/2019 10:56:43 AM,Overall,100,100,0,0,200,100,100,0,0,200
70,Syria Cross border,2017,TUR-17/3559/RA/CCS/O/5030,8/27/2018 12:57:50 PM,Overall,1,1,1,1,4,1,1,1,1,4
70,Syria Cross border,2017,TUR-17/3559/RA/CCS/UN/4766,11/9/2018 1:32:40 PM,Overall,1070,430,0,0,1500,264,130,0,0,394
70,Syria Cross border,2017,TUR-17/3559/RA/P/NGO/6297,11/9/2018 11:48:44 AM,Overall,0,300,0,0,300,11,380,0,0,391
70,Syria Cross border,2017,TUR-17/3559/RA/P/NGO/6297,11/9/2018 11:48:44 AM,Refugees,0,300,0,0,300,100,806,0,146,1052
70,Syria Cross border,2017,TUR-17/3559/RA/P/UN/6248,12/28/2018 7:12:27 AM,Overall,100,100,0,0,200,100,100,0,0,200
70,Syria Cross border,2017,TUR-17/3559/RA2/N/UN/7658,1/16/2019 1:48:07 PM,Host Communities,0,30624,18130,18870,67624,0,0,0,0,0
70,Syria Cross border,2017,TUR-17/3559/RA2/N/UN/7658,1/16/2019 1:48:07 PM,Internally Displaced People,0,0,9908,10312,20220,0,0,0,0,0
70,Syria Cross border,2017,TUR-17/3559/RA2/N/UN/7658,1/16/2019 1:48:07 PM,Overall,0,30624,28038,29182,87844,0,34296,32168,33483,99947
70,Syria Cross border,2017,TUR-17/3559/RA2/WASH/INGO/7653,10/5/2018 11:33:29 AM,Internally Displaced People,5371,5445,6941,7144,24901,12996,15608,11272,12875,52751
70,Syria Cross border,2017,TUR-17/3559/RA2/WASH/INGO/7653,10/5/2018 11:33:29 AM,Overall,6794,6950,8963,9179,31886,14419,17113,13294,14910,59736
70,Syria Cross border,2017,TUR-17/3559/RA2/WASH/INGO/7653,10/5/2018 11:33:29 AM,Refugees,1423,1505,2022,2035,6985,1423,1505,2022,2035,6985
70,Syria Cross border,2017,TUR-17/3559/RA2/WASH/NGO/7655,10/8/2018 6:49:40 AM,Host Communities,1452,2910,1182,2376,7920,2380,2693,2355,2662,10090
70,Syria Cross border,2017,TUR-17/3559/RA2/WASH/NGO/7655,10/8/2018 6:49:40 AM,Internally Displaced People,479,1015,413,821,2728,545,825,725,645,2740
70,Syria Cross border,2017,TUR-17/3559/RA2/WASH/NGO/7655,10/8/2018 6:49:40 AM,Overall,1931,3925,1595,3197,10648,2480,3530,3350,3470,12830
70,Syria Cross border,2017,TUR-17/3559/RA2/WASH/UN/7654,10/15/2019 8:06:24 AM,Internally Displaced People,4496,5069,5230,4936,19731,2749,3098,3195,3015,12057
70,Syria Cross border,2017,TUR-17/3559/RA2/WASH/UN/7654,10/15/2019 8:06:24 AM,Overall,8499,9580,9881,9323,37283,8329,9388,9683,9137,36537
70,Syria Cross border,2017,TUR-17/3559/SA 2017/CCM/INGO/5321,11/1/2018 7:37:37 AM,Internally Displaced People,11284,11284,13812,13812,50192,7882,9095,11602,9999,38578
70,Syria Cross border,2017,TUR-17/3559/SA 2017/CCM/INGO/5321,11/1/2018 7:37:37 AM,Overall,11284,11284,13812,13812,50192,7882,9095,11602,9999,38578
70,Syria Cross border,2017,TUR-17/3559/SA 2017/CCM/NGO/5315,1/18/2018 6:52:50 AM,Overall,2919,3393,2901,3061,12274,2919,3393,2901,3061,12274
70,Syria Cross border,2017,TUR-17/3559/SA 2017/CCM/NGO/5340,1/10/2018 6:49:36 AM,Internally Displaced People,778,934,940,878,3530,914,1098,1105,1033,4150
70,Syria Cross border,2017,TUR-17/3559/SA 2017/CCM/NGO/5340,1/10/2018 6:49:36 AM,Overall,778,934,940,878,3530,914,1098,1105,1033,4150
70,Syria Cross border,2017,TUR-17/3559/SA 2017/CCM/NGO/5354,7/27/2018 12:39:21 PM,Internally Displaced People,2195,2484,2630,2670,9979,2490,3148,2880,3275,11793
70,Syria Cross border,2017,TUR-17/3559/SA 2017/CCM/NGO/5354,7/27/2018 12:39:21 PM,Overall,2195,2484,2630,2670,9979,2490,3148,2880,3275,11793
70,Syria Cross border,2017,TUR-17/3559/SA 2017/E/NGO/5299,12/4/2018 11:29:29 AM,Host Communities,55,90,1150,1349,2644,67,99,1091,1205,2462
70,Syria Cross border,2017,TUR-17/3559/SA 2017/E/NGO/5299,12/4/2018 11:29:29 AM,Internally Displaced People,0,0,50,70,120,13,10,139,194,356
70,Syria Cross border,2017,TUR-17/3559/SA 2017/E/NGO/5299,12/4/2018 11:29:29 AM,Overall,55,90,1200,1419,2764,80,109,1230,1399,2818
70,Syria Cross border,2017,TUR-17/3559/SA 2017/E/NGO/5347,12/13/2018 10:30:22 AM,Internally Displaced People,61,69,1003,1207,2340,58,59,946,1143,2206
70,Syria Cross border,2017,TUR-17/3559/SA 2017/E/NGO/5347,12/13/2018 10:30:22 AM,Overall,61,69,1003,1207,2340,58,59,946,1143,2206
70,Syria Cross border,2017,TUR-17/3559/SA 2017/E/NGO/5371,6/23/2020 9:38:31 AM,Host Communities,29,49,876,988,1942,32,53,1337,741,2163
70,Syria Cross border,2017,TUR-17/3559/SA 2017/E/NGO/5371,6/23/2020 9:38:31 AM,Internally Displaced People,13,21,393,443,870,10,17,419,311,757
70,Syria Cross border,2017,TUR-17/3559/SA 2017/E/NGO/5371,6/23/2020 9:38:31 AM,Overall,42,70,1269,1431,2812,42,70,1756,1052,2920
70,Syria Cross border,2017,TUR-17/3559/SA 2017/E/NGO/5373,8/27/2018 1:47:38 PM,Internally Displaced People,34,39,804,1113,1990,32,26,986,1023,2067
70,Syria Cross border,2017,TUR-17/3559/SA 2017/E/NGO/5373,8/27/2018 1:47:38 PM,Overall,34,39,804,1113,1990,32,26,986,1023,2067
70,Syria Cross border,2017,TUR-17/3559/SA 2017/E/NGO/5378,6/23/2020 9:25:41 AM,Host Communities,188,101,841,943,2073,225,69,1453,1169,2916
70,Syria Cross border,2017,TUR-17/3559/SA 2017/E/NGO/5378,6/23/2020 9:25:41 AM,Internally Displaced People,47,26,215,239,527,58,18,467,292,835
70,Syria Cross border,2017,TUR-17/3559/SA 2017/E/NGO/5378,6/23/2020 9:25:41 AM,Overall,235,127,1056,1182,2600,238,87,1920,1425,3670
70,Syria Cross border,2017,TUR-17/3559/SA 2017/E/NGO/5399,11/14/2018 8:31:10 AM,Host Communities,855,950,760,800,3365,0,0,0,0,0
70,Syria Cross border,2017,TUR-17/3559/SA 2017/E/NGO/5399,11/14/2018 8:31:10 AM,Internally Displaced People,719,605,695,885,2904,230,423,1966,1922,4541
70,Syria Cross border,2017,TUR-17/3559/SA 2017/E/NGO/5399,11/14/2018 8:31:10 AM,Overall,1574,1555,1455,1685,6269,230,423,1966,1922,4541
70,Syria Cross border,2017,TUR-17/3559/SA 2017/ER/INGO/5345,6/7/2018 10:26:07 AM,Host Communities,152,159,171,178,660,163,174,198,203,738
70,Syria Cross border,2017,TUR-17/3559/SA 2017/ER/INGO/5345,6/7/2018 10:26:07 AM,Internally Displaced People,41,43,47,49,180,32,35,41,45,153
70,Syria Cross border,2017,TUR-17/3559/SA 2017/ER/INGO/5345,6/7/2018 10:26:07 AM,Other,83,86,94,97,360,70,73,84,88,315
70,Syria Cross border,2017,TUR-17/3559/SA 2017/ER/INGO/5345,6/7/2018 10:26:07 AM,Overall,276,288,312,324,1200,265,282,323,336,1206
70,Syria Cross border,2017,TUR-17/3559/SA 2017/ER/NGO/5328,12/17/2018 2:10:27 PM,Host Communities,319,140,0,0,459,323,21,0,0,344
70,Syria Cross border,2017,TUR-17/3559/SA 2017/ER/NGO/5328,12/17/2018 2:10:27 PM,Internally Displaced People,115,60,0,0,175,169,11,0,0,180
70,Syria Cross border,2017,TUR-17/3559/SA 2017/ER/NGO/5328,12/17/2018 2:10:27 PM,Overall,434,200,0,0,634,492,32,0,0,524
70,Syria Cross border,2017,TUR-17/3559/SA 2017/ER/UN/5352,1/31/2020 6:27:40 AM,Host Communities,250,250,0,0,500,364,248,88,307,1007
70,Syria Cross border,2017,TUR-17/3559/SA 2017/ER/UN/5352,1/31/2020 6:27:40 AM,Internally Displaced People,250,250,0,0,500,203,202,0,0,405
70,Syria Cross border,2017,TUR-17/3559/SA 2017/ER/UN/5352,1/31/2020 6:27:40 AM,Overall,500,500,0,0,1000,567,450,88,307,1412
70,Syria Cross border,2017,TUR-17/3559/SA 2017/ER-NFI/UN/5327,4/29/2020 2:36:33 PM,Host Communities,80,10,0,0,90,88,8,0,0,96
70,Syria Cross border,2017,TUR-17/3559/SA 2017/ER-NFI/UN/5327,4/29/2020 2:36:33 PM,Internally Displaced People,2122,2122,4244,4244,12732,2432,2640,3802,3762,12636
70,Syria Cross border,2017,TUR-17/3559/SA 2017/ER-NFI/UN/5327,4/29/2020 2:36:33 PM,Overall,2202,2132,4244,4244,12822,2520,2648,3802,3762,12732
70,Syria Cross border,2017,TUR-17/3559/SA 2017/FS/INGO/5297,12/7/2018 12:40:58 PM,Host Communities,962,511,0,0,1473,0,0,0,0,0
70,Syria Cross border,2017,TUR-17/3559/SA 2017/FS/INGO/5297,12/7/2018 12:40:58 PM,Internally Displaced People,608,210,0,0,818,0,0,0,0,0
70,Syria Cross border,2017,TUR-17/3559/SA 2017/FS/INGO/5297,12/7/2018 12:40:58 PM,Overall,1570,721,0,0,2291,2318,455,0,0,2773
70,Syria Cross border,2017,TUR-17/3559/SA 2017/FS/INGO/5333,10/2/2018 1:42:50 PM,Host Communities,1140,1243,1580,1573,5536,720,1037,1610,1785,5152
70,Syria Cross border,2017,TUR-17/3559/SA 2017/FS/INGO/5333,10/2/2018 1:42:50 PM,Internally Displaced People,140,197,347,396,1080,225,413,652,719,2009
70,Syria Cross border,2017,TUR-17/3559/SA 2017/FS/INGO/5333,10/2/2018 1:42:50 PM,Overall,1280,1440,1927,1969,6616,945,1450,2262,2504,7161
70,Syria Cross border,2017,TUR-17/3559/SA 2017/FS/NGO/5288,10/1/2018 1:18:18 PM,Host Communities,450,150,0,0,600,845,897,1300,1261,4303
70,Syria Cross border,2017,TUR-17/3559/SA 2017/FS/NGO/5288,10/1/2018 1:18:18 PM,Internally Displaced People,75,25,0,0,100,76,102,194,209,581
70,Syria Cross border,2017,TUR-17/3559/SA 2017/FS/NGO/5288,10/1/2018 1:18:18 PM,Overall,525,175,0,0,700,921,999,1494,1470,4884
70,Syria Cross border,2017,TUR-17/3559/SA 2017/FS/NGO/5308,6/5/2018 10:54:46 AM,Host Communities,3343,3518,4320,5638,16819,3834,4343,7351,6779,22307
70,Syria Cross border,2017,TUR-17/3559/SA 2017/FS/NGO/5308,6/5/2018 10:54:46 AM,Internally Displaced People,2653,2875,3526,4255,13309,3239,4000,6475,5825,19539
70,Syria Cross border,2017,TUR-17/3559/SA 2017/FS/NGO/5308,6/5/2018 10:54:46 AM,Overall,5996,6393,7846,9893,30128,7073,8343,13826,12604,41846
70,Syria Cross border,2017,TUR-17/3559/SA 2017/FS/NGO/5375,7/6/2018 1:40:17 PM,Host Communities,125,1180,0,0,1305,583,1556,1824,1671,5634
70,Syria Cross border,2017,TUR-17/3559/SA 2017/FS/NGO/5375,7/6/2018 1:40:17 PM,Internally Displaced People,25,80,0,0,105,102,105,140,163,510
70,Syria Cross border,2017,TUR-17/3559/SA 2017/FS/NGO/5375,7/6/2018 1:40:17 PM,Overall,150,1260,0,0,1410,685,1661,1964,1834,6144
70,Syria Cross border,2017,TUR-17/3559/SA 2017/FS/UN/5407,11/1/2019 6:57:56 AM,Host Communities,1730,1665,1800,3600,8795,1890,2070,2406,2634,9000
70,Syria Cross border,2017,TUR-17/3559/SA 2017/FS/UN/5407,11/1/2019 6:57:56 AM,Internally Displaced People,70,135,0,0,205,0,0,0,0,0
70,Syria Cross border,2017,TUR-17/3559/SA 2017/FS/UN/5407,11/1/2019 6:57:56 AM,Overall,1800,1800,1800,3600,9000,1890,2070,2406,2634,9000
70,Syria Cross border,2017,TUR-17/3559/SA 2017/H/NGO/5300,5/2/2018 11:31:38 AM,Host Communities,22685,13344,4448,4003,44480,23502,11475,12641,9193,56811
70,Syria Cross border,2017,TUR-17/3559/SA 2017/H/NGO/5300,5/2/2018 11:31:38 AM,Internally Displaced People,5671,3336,1112,1001,11120,9955,4660,4158,3481,22254
70,Syria Cross border,2017,TUR-17/3559/SA 2017/H/NGO/5300,5/2/2018 11:31:38 AM,Overall,28356,16680,5560,5004,55600,33457,16135,16799,12674,79065
70,Syria Cross border,2017,TUR-17/3559/SA 2017/H/NGO/5331,10/31/2018 9:20:24 AM,Host Communities,10923,17777,4926,4961,38587,14714,19704,10881,9637,54936
70,Syria Cross border,2017,TUR-17/3559/SA 2017/H/NGO/5331,10/31/2018 9:20:24 AM,Internally Displaced People,6303,10611,3921,3587,24422,6531,8981,5042,3963,24517
70,Syria Cross border,2017,TUR-17/3559/SA 2017/H/NGO/5331,10/31/2018 9:20:24 AM,Overall,17226,28388,8847,8548,63009,21245,28685,15923,13600,79453
70,Syria Cross border,2017,TUR-17/3559/SA 2017/H/NGO/5401,5/17/2018 8:37:15 AM,Host Communities,0,22098,11730,12724,46552,0,10230,7565,6132,23927
70,Syria Cross border,2017,TUR-17/3559/SA 2017/H/NGO/5401,5/17/2018 8:37:15 AM,Internally Displaced People,0,5874,4221,4322,14417,0,17655,9168,9672,36495
70,Syria Cross border,2017,TUR-17/3559/SA 2017/H/NGO/5401,5/17/2018 8:37:15 AM,Overall,0,27972,15951,17046,60969,0,27885,16733,15804,60422
70,Syria Cross border,2017,TUR-17/3559/SA 2017/H-N/NGO/5314,9/7/2018 11:17:41 AM,Host Communities,3349,7036,4361,4262,19008,3167,8435,5291,5005,21898
70,Syria Cross border,2017,TUR-17/3559/SA 2017/H-N/NGO/5314,9/7/2018 11:17:41 AM,Internally Displaced People,3041,6354,3210,3200,15805,2040,6256,2903,2881,14080
70,Syria Cross border,2017,TUR-17/3559/SA 2017/H-N/NGO/5314,9/7/2018 11:17:41 AM,Overall,6390,13390,7571,7462,34813,5207,14691,8194,7886,35978
70,Syria Cross border,2017,TUR-17/3559/SA 2017/H-N/NGO/5390,7/17/2018 6:39:50 AM,Host Communities,720,4053,1179,1425,7377,720,4053,1179,1425,7377
70,Syria Cross border,2017,TUR-17/3559/SA 2017/H-N/NGO/5390,7/17/2018 6:39:50 AM,Internally Displaced People,9060,36064,11552,13560,70236,7410,34244,10492,12480,64626
70,Syria Cross border,2017,TUR-17/3559/SA 2017/H-N/NGO/5390,7/17/2018 6:39:50 AM,Overall,10500,44170,13910,16410,84990,10500,44170,13910,16410,84990
70,Syria Cross border,2017,TUR-17/3559/SA 2017/H-N/NGO/5390,7/17/2018 6:39:50 AM,Refugees,720,4053,1179,1425,7377,720,4053,1179,1425,7377
70,Syria Cross border,2017,TUR-17/3559/SA 2017/H-N/UN/5409,6/21/2019 9:04:50 AM,Host Communities,54204,59351,38804,36706,189065,177,156,80,53,466
70,Syria Cross border,2017,TUR-17/3559/SA 2017/H-N/UN/5409,6/21/2019 9:04:50 AM,Internally Displaced People,36135,39566,25868,24470,126039,0,0,0,0,0
70,Syria Cross border,2017,TUR-17/3559/SA 2017/H-N/UN/5409,6/21/2019 9:04:50 AM,Overall,90339,98917,64672,61176,315104,54776,80543,45672,39810,220801
70,Syria Cross border,2017,TUR-17/3559/SA 2017/NFI/INGO/5353,7/27/2018 12:02:18 PM,Internally Displaced People,2952,3076,3333,3469,12830,3678,4432,6465,6585,21160
70,Syria Cross border,2017,TUR-17/3559/SA 2017/NFI/INGO/5353,7/27/2018 12:02:18 PM,Overall,2952,3076,3333,3469,12830,5188,6071,8315,8460,28034
70,Syria Cross border,2017,TUR-17/3559/SA 2017/NFI/NGO/5294,8/2/2018 1:49:30 PM,Host Communities,187,230,480,415,1312,431,532,598,554,2115
70,Syria Cross border,2017,TUR-17/3559/SA 2017/NFI/NGO/5294,8/2/2018 1:49:30 PM,Internally Displaced People,163,205,455,365,1188,172,205,206,153,736
70,Syria Cross border,2017,TUR-17/3559/SA 2017/NFI/NGO/5294,8/2/2018 1:49:30 PM,Other,80,20,0,0,100,157,32,0,0,189
70,Syria Cross border,2017,TUR-17/3559/SA 2017/NFI/NGO/5294,8/2/2018 1:49:30 PM,Overall,430,455,935,780,2600,760,769,804,707,3040
70,Syria Cross border,2017,TUR-17/3559/SA 2017/NFI/NGO/5335,5/29/2018 12:54:24 PM,Internally Displaced People,256,358,606,608,1828,306,372,408,396,1482
70,Syria Cross border,2017,TUR-17/3559/SA 2017/NFI/NGO/5335,5/29/2018 12:54:24 PM,Overall,256,358,606,608,1828,306,372,408,396,1482
70,Syria Cross border,2017,TUR-17/3559/SA 2017/NFI/NGO/5350,1/23/2018 7:44:28 AM,Host Communities,611,731,659,778,2779,641,659,853,829,2982
70,Syria Cross border,2017,TUR-17/3559/SA 2017/NFI/NGO/5350,1/23/2018 7:44:28 AM,Internally Displaced People,68,82,74,87,311,103,101,129,134,467
70,Syria Cross border,2017,TUR-17/3559/SA 2017/NFI/NGO/5350,1/23/2018 7:44:28 AM,Overall,679,813,733,865,3090,744,760,982,963,3449
70,Syria Cross border,2017,TUR-17/3559/SA 2017/NFI/NGO/5379,6/23/2020 9:29:54 AM,Host Communities,535,585,758,830,2708,493,597,684,613,2387
70,Syria Cross border,2017,TUR-17/3559/SA 2017/NFI/NGO/5379,6/23/2020 9:29:54 AM,Internally Displaced People,129,146,190,207,672,150,125,300,426,1001
70,Syria Cross border,2017,TUR-17/3559/SA 2017/NFI/NGO/5379,6/23/2020 9:29:54 AM,Overall,664,731,948,1037,3380,643,722,984,1039,3388
70,Syria Cross border,2017,TUR-17/3559/SA 2017/P/INGO/5396,12/4/2018 10:19:19 AM,Host Communities,2520,2981,5839,4809,16149,3011,3473,6536,5309,18329
70,Syria Cross border,2017,TUR-17/3559/SA 2017/P/INGO/5396,12/4/2018 10:19:19 AM,Internally Displaced People,2095,2016,2550,2190,8851,874,1284,1451,1303,4912
70,Syria Cross border,2017,TUR-17/3559/SA 2017/P/INGO/5396,12/4/2018 10:19:19 AM,Overall,4615,4997,8389,6999,25000,3885,4757,7987,6612,23241
70,Syria Cross border,2017,TUR-17/3559/SA 2017/P/INGO/5412,11/9/2018 10:43:43 AM,Host Communities,1057,2485,746,828,5116,679,1711,1712,2112,6214
70,Syria Cross border,2017,TUR-17/3559/SA 2017/P/INGO/5412,11/9/2018 10:43:43 AM,Internally Displaced People,1133,1925,454,672,4184,725,1689,1035,1303,4752
70,Syria Cross border,2017,TUR-17/3559/SA 2017/P/INGO/5412,11/9/2018 10:43:43 AM,Overall,2190,4410,1200,1500,9300,1404,3400,2747,3415,10966
70,Syria Cross border,2017,TUR-17/3559/SA 2017/P/NGO/5318,4/9/2019 7:10:24 AM,Host Communities,1617,6125,693,4725,13160,1257,5214,1267,2730,10468
70,Syria Cross border,2017,TUR-17/3559/SA 2017/P/NGO/5318,4/9/2019 7:10:24 AM,Internally Displaced People,693,2625,279,2025,5622,2535,3507,2498,5857,14397
70,Syria Cross border,2017,TUR-17/3559/SA 2017/P/NGO/5318,4/9/2019 7:10:24 AM,Overall,2310,8750,990,6750,18800,3792,8721,3765,8587,24865
70,Syria Cross border,2017,TUR-17/3559/SA 2017/P/NGO/5338,12/28/2018 7:14:03 AM,Host Communities,600,1610,300,815,3325,355,1434,267,702,2758
70,Syria Cross border,2017,TUR-17/3559/SA 2017/P/NGO/5338,12/28/2018 7:14:03 AM,Internally Displaced People,300,805,170,300,1575,1037,2063,674,1132,4906
70,Syria Cross border,2017,TUR-17/3559/SA 2017/P/NGO/5338,12/28/2018 7:14:03 AM,Overall,900,2415,470,1115,4900,1392,3497,941,1834,7664
70,Syria Cross border,2017,TUR-17/3559/SA 2017/P/NGO/5359,8/1/2018 1:01:38 PM,Host Communities,0,0,0,0,0,263442,304791,122104,122104,812441
70,Syria Cross border,2017,TUR-17/3559/SA 2017/P/NGO/5359,8/1/2018 1:01:38 PM,Internally Displaced People,0,0,0,0,0,99045,129841,68468,68468,365822
70,Syria Cross border,2017,TUR-17/3559/SA 2017/P/NGO/5359,8/1/2018 1:01:38 PM,Overall,309752,384564,162638,162638,1019592,362487,434632,190572,190572,1178263
70,Syria Cross border,2017,TUR-17/3559/SA 2017/P/NGO/5384,9/14/2018 11:58:56 AM,Host Communities,228,738,1605,2045,4616,113,126,406,393,1038
70,Syria Cross border,2017,TUR-17/3559/SA 2017/P/NGO/5384,9/14/2018 11:58:56 AM,Internally Displaced People,238,728,1575,1875,4416,80,100,275,265,720
70,Syria Cross border,2017,TUR-17/3559/SA 2017/P/NGO/5384,9/14/2018 11:58:56 AM,Overall,466,1466,3180,3920,9032,193,226,681,658,1758
70,Syria Cross border,2017,TUR-17/3559/SA 2017/P/NGO/5432,8/27/2018 1:30:49 PM,Host Communities,1247,4411,8325,10782,24765,3602,13058,12351,17974,46985
70,Syria Cross border,2017,TUR-17/3559/SA 2017/P/NGO/5432,8/27/2018 1:30:49 PM,Internally Displaced People,416,2983,2775,3710,9884,3425,12999,11969,17900,46293
70,Syria Cross border,2017,TUR-17/3559/SA 2017/P/NGO/5432,8/27/2018 1:30:49 PM,Overall,1663,7394,11100,14492,34649,7027,26057,24320,35874,93278
70,Syria Cross border,2017,TUR-17/3559/SA 2017/P/UN/5302,12/28/2018 7:11:30 AM,Internally Displaced People,1200,1200,2400,2400,7200,823,4656,4966,5900,16345
70,Syria Cross border,2017,TUR-17/3559/SA 2017/P/UN/5302,12/28/2018 7:11:30 AM,Other,1200,1200,2400,2400,7200,0,0,0,0,0
70,Syria Cross border,2017,TUR-17/3559/SA 2017/P/UN/5302,12/28/2018 7:11:30 AM,Overall,2400,2400,4800,4800,14400,823,4656,4966,5900,16345
70,Syria Cross border,2017,TUR-17/3559/SA 2017/WASH/INGO/5311,5/16/2018 10:03:04 AM,Host Communities,145952,140338,123500,151565,561355,194822,198985,224761,194744,813312
70,Syria Cross border,2017,TUR-17/3559/SA 2017/WASH/INGO/5311,5/16/2018 10:03:04 AM,Internally Displaced People,84506,81210,73699,90175,329590,34219,34714,38559,33437,140929
70,Syria Cross border,2017,TUR-17/3559/SA 2017/WASH/INGO/5311,5/16/2018 10:03:04 AM,Overall,230458,221548,197199,241740,890945,229041,233700,263319,228181,954241
70,Syria Cross border,2017,TUR-17/3559/SA 2017/WASH/INGO/5323,3/21/2018 9:21:11 AM,Internally Displaced People,5776,6383,9556,8054,29769,7045,8034,11743,10817,37639
70,Syria Cross border,2017,TUR-17/3559/SA 2017/WASH/INGO/5323,3/21/2018 9:21:11 AM,Overall,5776,6383,9556,8054,29769,7045,8034,11743,10817,37639
70,Syria Cross border,2017,TUR-17/3559/SA 2017/WASH/INGO/5366,10/6/2017 7:13:03 AM,Internally Displaced People,7298,7911,8518,8224,31951,7298,7911,8518,8224,31951
70,Syria Cross border,2017,TUR-17/3559/SA 2017/WASH/INGO/5366,10/6/2017 7:13:03 AM,Overall,7298,7911,8518,8224,31951,7298,7911,8518,8224,31951
70,Syria Cross border,2017,TUR-17/3559/SA 2017/WASH/NGO/5400,7/18/2018 12:01:06 PM,Host Communities,424,636,657,803,2520,787,793,746,687,3013
70,Syria Cross border,2017,TUR-17/3559/SA 2017/WASH/NGO/5400,7/18/2018 12:01:06 PM,Internally Displaced People,841,1262,1308,1598,5009,1127,1147,1243,1265,4782
70,Syria Cross border,2017,TUR-17/3559/SA 2017/WASH/NGO/5400,7/18/2018 12:01:06 PM,Overall,1265,1898,1965,2401,7529,1914,1940,1989,1952,7795
70,Syria Cross border,2017,TUR-17/3559/SA 2017/WASH/NGO/5405,7/18/2018 9:48:37 AM,Host Communities,14686,17244,21432,7096,60458,18368,19204,22542,23377,83491
70,Syria Cross border,2017,TUR-17/3559/SA 2017/WASH/NGO/5405,7/18/2018 9:48:37 AM,Internally Displaced People,1754,2483,1989,2834,9060,5588,5841,6859,7112,25400
70,Syria Cross border,2017,TUR-17/3559/SA 2017/WASH/NGO/5405,7/18/2018 9:48:37 AM,Overall,16440,19727,23421,9930,69518,23956,25045,29401,30489,108891
70,Syria Cross border,2017,TUR-17/3559/SA 2017/WASH/NGO/5468,2/25/2020 11:32:25 AM,Host Communities,2160,2640,2880,4320,12000,1000,1100,1100,1700,4900
70,Syria Cross border,2017,TUR-17/3559/SA 2017/WASH/NGO/5468,2/25/2020 11:32:25 AM,Internally Displaced People,540,660,720,1080,3000,400,700,1000,1000,3100
70,Syria Cross border,2017,TUR-17/3559/SA 2017/WASH/NGO/5468,2/25/2020 11:32:25 AM,Overall,2700,3300,3600,5400,15000,1400,1800,2100,2700,8000
70,Syria Cross border,2017,TUR-17/3559/SA2/CCM/INGO/7237,10/3/2018 10:03:26 AM,Internally Displaced People,5627,5499,5364,6104,22594,11254,10998,10728,12208,45188
70,Syria Cross border,2017,TUR-17/3559/SA2/CCM/INGO/7237,10/3/2018 10:03:26 AM,Overall,5627,5499,5364,6104,22594,5627,5499,5364,6104,22594
70,Syria Cross border,2017,TUR-17/3559/SA2/CCM/INGO/7239,11/1/2018 7:20:34 AM,Internally Displaced People,29718,32692,20306,20125,102841,19704,23120,28584,25529,96937
70,Syria Cross border,2017,TUR-17/3559/SA2/CCM/INGO/7239,11/1/2018 7:20:34 AM,Overall,29718,32692,20306,20125,102841,19704,23120,28584,25529,96937
70,Syria Cross border,2017,TUR-17/3559/SA2/CCM/NGO/7020,8/2/2018 6:31:32 AM,Internally Displaced People,1200,2000,1800,1800,6800,2064,2264,2692,2353,9373
70,Syria Cross border,2017,TUR-17/3559/SA2/CCM/NGO/7020,8/2/2018 6:31:32 AM,Overall,1200,2000,1800,1800,6800,2064,2264,2692,2353,9373
70,Syria Cross border,2017,TUR-17/3559/SA2/CCM/NGO/7219,11/5/2018 11:23:41 AM,Internally Displaced People,2722,2810,4131,3929,13592,3091,3426,3357,3753,13627
70,Syria Cross border,2017,TUR-17/3559/SA2/CCM/NGO/7219,11/5/2018 11:23:41 AM,Overall,2722,2810,4131,3929,13592,3090,3427,3357,3753,13627
70,Syria Cross border,2017,TUR-17/3559/SA2/E/NGO/7001,7/9/2018 1:22:43 PM,Host Communities,71,58,1237,1179,2545,23,111,1193,1206,2533
70,Syria Cross border,2017,TUR-17/3559/SA2/E/NGO/7001,7/9/2018 1:22:43 PM,Internally Displaced People,78,69,2595,3040,5782,145,115,2740,2912,5912
70,Syria Cross border,2017,TUR-17/3559/SA2/E/NGO/7001,7/9/2018 1:22:43 PM,Overall,149,127,3832,4219,8327,168,226,3933,4118,8445
70,Syria Cross border,2017,TUR-17/3559/SA2/E/NGO/7071,6/1/2018 7:20:03 AM,Host Communities,502,286,8351,10115,19254,472,626,12985,14303,28386
70,Syria Cross border,2017,TUR-17/3559/SA2/E/NGO/7071,6/1/2018 7:20:03 AM,Internally Displaced People,25,14,1940,2475,4454,37,53,2737,3365,6192
70,Syria Cross border,2017,TUR-17/3559/SA2/E/NGO/7071,6/1/2018 7:20:03 AM,Overall,527,300,10291,12590,23708,509,679,15722,17668,34578
70,Syria Cross border,2017,TUR-17/3559/SA2/E/NGO/7111,7/9/2018 1:18:40 PM,Host Communities,777,547,11359,10759,23442,798,555,11948,11327,24628
70,Syria Cross border,2017,TUR-17/3559/SA2/E/NGO/7111,7/9/2018 1:18:40 PM,Internally Displaced People,11,8,2005,1898,3922,8,8,1678,1608,3302
70,Syria Cross border,2017,TUR-17/3559/SA2/E/NGO/7111,7/9/2018 1:18:40 PM,Overall,788,555,13364,12657,27364,806,563,13646,12934,27949
70,Syria Cross border,2017,TUR-17/3559/SA2/E/NGO/7197,6/26/2018 10:07:27 AM,Host Communities,0,0,625,525,1150,0,0,568,648,1216
70,Syria Cross border,2017,TUR-17/3559/SA2/E/NGO/7197,6/26/2018 10:07:27 AM,Internally Displaced People,0,0,825,675,1500,0,0,802,755,1557
70,Syria Cross border,2017,TUR-17/3559/SA2/E/NGO/7197,6/26/2018 10:07:27 AM,Overall,0,0,1450,1200,2650,0,0,1370,1403,2773
70,Syria Cross border,2017,TUR-17/3559/SA2/E/NGO/7273,11/5/2018 9:01:43 AM,Host Communities,0,0,9599,10020,19619,0,0,12766,12853,25619
70,Syria Cross border,2017,TUR-17/3559/SA2/E/NGO/7273,11/5/2018 9:01:43 AM,Internally Displaced People,0,0,2400,2504,4904,0,0,3697,3563,7260
70,Syria Cross border,2017,TUR-17/3559/SA2/E/NGO/7273,11/5/2018 9:01:43 AM,Overall,0,0,11999,12524,24523,0,0,16401,16047,32448
70,Syria Cross border,2017,TUR-17/3559/SA2/FS/INGO/7045,1/24/2019 11:38:19 AM,Host Communities,1175,1175,1523,2027,5900,1455,1666,2786,2701,8608
70,Syria Cross border,2017,TUR-17/3559/SA2/FS/INGO/7045,1/24/2019 11:38:19 AM,Internally Displaced People,1225,1225,1573,2077,6100,1490,1331,3056,2497,8374
70,Syria Cross border,2017,TUR-17/3559/SA2/FS/INGO/7045,1/24/2019 11:38:19 AM,Overall,2400,2400,3096,4104,12000,2945,2997,5842,5198,16982
70,Syria Cross border,2017,TUR-17/3559/SA2/FS/INGO/7064,10/31/2018 10:47:26 AM,Host Communities,264,234,220,205,923,1796,2373,2869,2701,9739
70,Syria Cross border,2017,TUR-17/3559/SA2/FS/INGO/7064,10/31/2018 10:47:26 AM,Internally Displaced People,275,122,161,219,777,0,0,0,0,0
70,Syria Cross border,2017,TUR-17/3559/SA2/FS/INGO/7064,10/31/2018 10:47:26 AM,Overall,539,356,381,424,1700,1603,97,0,0,1700
70,Syria Cross border,2017,TUR-17/3559/SA2/FS/INGO/7124,10/3/2018 11:35:15 AM,Host Communities,90,900,1800,1800,4590,403,1268,1682,1544,4897
70,Syria Cross border,2017,TUR-17/3559/SA2/FS/INGO/7124,10/3/2018 11:35:15 AM,Internally Displaced People,10,100,200,200,510,121,373,395,430,1319
70,Syria Cross border,2017,TUR-17/3559/SA2/FS/INGO/7124,10/3/2018 11:35:15 AM,Overall,100,1000,2000,2000,5100,524,1641,2077,1974,6216
70,Syria Cross border,2017,TUR-17/3559/SA2/FS/NGO/7040,10/4/2018 11:39:01 AM,Host Communities,1314,1426,1535,1785,6060,1077,692,3308,2615,7692
70,Syria Cross border,2017,TUR-17/3559/SA2/FS/NGO/7040,10/4/2018 11:39:01 AM,Internally Displaced People,948,981,1063,1188,4180,322,207,988,781,2298
70,Syria Cross border,2017,TUR-17/3559/SA2/FS/NGO/7040,10/4/2018 11:39:01 AM,Overall,2262,2407,2598,2973,10240,1399,899,4296,3397,9991
70,Syria Cross border,2017,TUR-17/3559/SA2/FS/NGO/7178,9/5/2018 1:18:13 PM,Host Communities,515,541,655,689,2400,1251,1274,973,840,4338
70,Syria Cross border,2017,TUR-17/3559/SA2/FS/NGO/7178,9/5/2018 1:18:13 PM,Internally Displaced People,1396,2138,1904,2134,7572,236,247,337,349,1169
70,Syria Cross border,2017,TUR-17/3559/SA2/FS/NGO/7178,9/5/2018 1:18:13 PM,Overall,1911,2679,2559,2823,9972,2803,2947,1562,1577,8889
70,Syria Cross border,2017,TUR-17/3559/SA2/FS/NGO/7193,7/18/2018 9:07:25 AM,Host Communities,889,1123,1263,1404,4679,1162,1205,1545,1567,5479
70,Syria Cross border,2017,TUR-17/3559/SA2/FS/NGO/7193,7/18/2018 9:07:25 AM,Internally Displaced People,479,605,681,756,2521,448,512,833,456,2249
70,Syria Cross border,2017,TUR-17/3559/SA2/FS/NGO/7193,7/18/2018 9:07:25 AM,Overall,1368,1728,1944,2160,7200,1610,1717,2378,2023,7728
70,Syria Cross border,2017,TUR-17/3559/SA2/FS/NGO/7262,5/28/2020 10:04:13 AM,Host Communities,1600,2000,2000,2400,8000,1485,1656,1875,2235,7251
70,Syria Cross border,2017,TUR-17/3559/SA2/FS/NGO/7262,5/28/2020 10:04:13 AM,Internally Displaced People,400,500,500,600,2000,480,380,595,756,2211
70,Syria Cross border,2017,TUR-17/3559/SA2/FS/NGO/7262,5/28/2020 10:04:13 AM,Overall,2000,2500,2500,3000,10000,1960,2036,2470,2996,9462
70,Syria Cross border,2017,TUR-17/3559/SA2/FS/UN/7248,1/24/2019 11:51:06 AM,Host Communities,714,706,790,758,2968,2708,2969,3444,3773,12894
70,Syria Cross border,2017,TUR-17/3559/SA2/FS/UN/7248,1/24/2019 11:51:06 AM,Internally Displaced People,18,14,0,0,32,1466,1604,1863,2038,6971
70,Syria Cross border,2017,TUR-17/3559/SA2/FS/UN/7248,1/24/2019 11:51:06 AM,Overall,3785,4144,4796,5275,18000,5545,6073,7058,7730,26406
70,Syria Cross border,2017,TUR-17/3559/SA2/H/INGO/7006,11/2/2018 11:41:10 AM,Host Communities,922,6283,4320,3817,15342,901,7381,4814,4288,17384
70,Syria Cross border,2017,TUR-17/3559/SA2/H/INGO/7006,11/2/2018 11:41:10 AM,Internally Displaced People,1382,9424,6481,5725,23012,1351,11070,7221,6430,26072
70,Syria Cross border,2017,TUR-17/3559/SA2/H/INGO/7006,11/2/2018 11:41:10 AM,Overall,2304,15707,10801,9542,38354,2252,18451,12035,10718,43456
70,Syria Cross border,2017,TUR-17/3559/SA2/H/INGO/7110,9/13/2018 10:40:57 AM,Host Communities,3885,7714,4850,4637,21086,5348,7256,5895,4828,23327
70,Syria Cross border,2017,TUR-17/3559/SA2/H/INGO/7110,9/13/2018 10:40:57 AM,Internally Displaced People,6429,15233,9749,9280,40691,4885,7970,6431,5844,25130
70,Syria Cross border,2017,TUR-17/3559/SA2/H/INGO/7110,9/13/2018 10:40:57 AM,Overall,10315,22947,14599,13918,61779,10233,15226,12326,10672,48457
70,Syria Cross border,2017,TUR-17/3559/SA2/H/INGO/7266,11/2/2018 8:11:39 AM,Host Communities,1023,1661,1512,1460,5656,266,368,340,267,1241
70,Syria Cross border,2017,TUR-17/3559/SA2/H/INGO/7266,11/2/2018 8:11:39 AM,Internally Displaced People,1365,2215,2016,1948,7544,2429,3486,3599,2811,12325
70,Syria Cross border,2017,TUR-17/3559/SA2/H/INGO/7266,11/2/2018 8:11:39 AM,Overall,2388,3876,3528,3408,13200,2711,3926,3931,2998,13566
70,Syria Cross border,2017,TUR-17/3559/SA2/H/NGO/6988,10/26/2018 9:06:04 AM,Host Communities,6258,5038,4710,3112,19118,8749,7200,2701,2293,20943
70,Syria Cross border,2017,TUR-17/3559/SA2/H/NGO/6988,10/26/2018 9:06:04 AM,Internally Displaced People,3168,2554,2364,3112,11198,4378,3604,1353,1151,10486
70,Syria Cross border,2017,TUR-17/3559/SA2/H/NGO/6988,10/26/2018 9:06:04 AM,Overall,9426,7592,7074,6224,30316,13127,10804,4054,3444,31429
70,Syria Cross border,2017,TUR-17/3559/SA2/H/NGO/7000,10/4/2018 7:34:43 AM,Host Communities,5759,6239,4654,4085,20737,9537,7870,5371,3063,25841
70,Syria Cross border,2017,TUR-17/3559/SA2/H/NGO/7000,10/4/2018 7:34:43 AM,Internally Displaced People,3921,4604,2103,2843,13471,5868,4576,3044,1849,15337
70,Syria Cross border,2017,TUR-17/3559/SA2/H/NGO/7000,10/4/2018 7:34:43 AM,Overall,9680,10843,6757,6928,34208,15405,12446,8415,4912,41178
70,Syria Cross border,2017,TUR-17/3559/SA2/H/NGO/7010,9/14/2018 10:37:56 AM,Host Communities,4297,5859,4518,4883,19557,15474,23886,17352,26280,82992
70,Syria Cross border,2017,TUR-17/3559/SA2/H/NGO/7010,9/14/2018 10:37:56 AM,Internally Displaced People,1841,2511,1936,2092,8380,8146,12434,8640,13044,42264
70,Syria Cross border,2017,TUR-17/3559/SA2/H/NGO/7010,9/14/2018 10:37:56 AM,Overall,6138,8370,6454,6975,27937,19096,27753,6498,9831,63178
70,Syria Cross border,2017,TUR-17/3559/SA2/H/NGO/7068,10/30/2018 9:51:30 AM,Host Communities,7840,12250,4620,4340,29050,1862,2110,785,674,5431
70,Syria Cross border,2017,TUR-17/3559/SA2/H/NGO/7068,10/30/2018 9:51:30 AM,Internally Displaced People,3360,5250,1980,1860,12450,6731,9132,8936,7444,32243
70,Syria Cross border,2017,TUR-17/3559/SA2/H/NGO/7068,10/30/2018 9:51:30 AM,Overall,11200,17500,6600,6200,41500,8593,11242,9721,8118,37674
70,Syria Cross border,2017,TUR-17/3559/SA2/H/NGO/7176,10/9/2018 8:25:18 AM,Host Communities,3100,4850,5134,5450,18534,4655,7453,6059,5794,23961
70,Syria Cross border,2017,TUR-17/3559/SA2/H/NGO/7176,10/9/2018 8:25:18 AM,Internally Displaced People,2477,3826,3620,4006,13929,2091,4766,3611,2984,13452
70,Syria Cross border,2017,TUR-17/3559/SA2/H/NGO/7176,10/9/2018 8:25:18 AM,Overall,5577,8676,8754,9456,32463,6746,12219,9670,8778,37413
70,Syria Cross border,2017,TUR-17/3559/SA2/H/NGO/7201,9/17/2018 12:48:07 PM,Host Communities,1855,5243,1600,1350,10048,2948,6225,1381,1291,11845
70,Syria Cross border,2017,TUR-17/3559/SA2/H/NGO/7201,9/17/2018 12:48:07 PM,Internally Displaced People,795,2247,500,450,3992,1274,2221,498,397,4390
70,Syria Cross border,2017,TUR-17/3559/SA2/H/NGO/7201,9/17/2018 12:48:07 PM,Overall,2650,7490,2100,1800,14040,4222,8446,1879,1688,16235
70,Syria Cross border,2017,TUR-17/3559/SA2/H/NGO/7220,12/7/2018 7:40:23 AM,Host Communities,4886,9739,2398,2038,19061,5554,9431,3039,2663,20687
70,Syria Cross border,2017,TUR-17/3559/SA2/H/NGO/7220,12/7/2018 7:40:23 AM,Internally Displaced People,7330,14609,3596,3056,28591,6520,11073,3568,3128,24289
70,Syria Cross border,2017,TUR-17/3559/SA2/H/NGO/7220,12/7/2018 7:40:23 AM,Overall,12216,24348,5994,5094,47652,12074,20504,6607,5791,44976
70,Syria Cross border,2017,TUR-17/3559/SA2/H/NGO/7250,7/18/2018 1:53:12 PM,Host Communities,5421,9661,5671,5304,26057,6626,15499,10439,9159,41723
70,Syria Cross border,2017,TUR-17/3559/SA2/H/NGO/7250,7/18/2018 1:53:12 PM,Internally Displaced People,2919,5202,3053,2856,14030,3130,6938,4586,4144,18798
70,Syria Cross border,2017,TUR-17/3559/SA2/H/NGO/7250,7/18/2018 1:53:12 PM,Overall,8340,14863,8724,8160,40087,9756,22437,15025,13303,60521
70,Syria Cross border,2017,TUR-17/3559/SA2/NFI/INGO/6985,7/14/2018 11:08:30 AM,Internally Displaced People,6293,7293,10337,10294,34217,5467,6234,9406,9357,30464
70,Syria Cross border,2017,TUR-17/3559/SA2/NFI/INGO/6985,7/14/2018 11:08:30 AM,Overall,6293,7293,10337,10294,34217,5467,6234,9406,9357,30464
70,Syria Cross border,2017,TUR-17/3559/SA2/NFI/INGO/7185,1/2/2019 8:20:04 AM,Host Communities,322,322,644,644,1932,598,685,814,770,2867
70,Syria Cross border,2017,TUR-17/3559/SA2/NFI/INGO/7185,1/2/2019 8:20:04 AM,Internally Displaced People,895,895,1790,1790,5370,987,1044,1295,1198,4524
70,Syria Cross border,2017,TUR-17/3559/SA2/NFI/INGO/7185,1/2/2019 8:20:04 AM,Overall,1217,1217,2434,2434,7302,1585,1729,2109,1968,7391
70,Syria Cross border,2017,TUR-17/3559/SA2/NFI/INGO/7198,11/1/2018 7:10:43 AM,Host Communities,295,373,466,420,1554,471,339,640,716,2166
70,Syria Cross border,2017,TUR-17/3559/SA2/NFI/INGO/7198,11/1/2018 7:10:43 AM,Internally Displaced People,127,160,200,179,666,66,56,79,106,307
70,Syria Cross border,2017,TUR-17/3559/SA2/NFI/INGO/7198,11/1/2018 7:10:43 AM,Overall,422,533,666,599,2220,537,395,719,822,2473
70,Syria Cross border,2017,TUR-17/3559/SA2/NFI/NGO/7213,7/5/2018 9:21:01 AM,Host Communities,800,950,1950,2200,5900,777,1276,1723,1632,5408
70,Syria Cross border,2017,TUR-17/3559/SA2/NFI/NGO/7213,7/5/2018 9:21:01 AM,Internally Displaced People,1430,1620,2500,2950,8500,1303,1988,2951,2835,9077
70,Syria Cross border,2017,TUR-17/3559/SA2/NFI/NGO/7213,7/5/2018 9:21:01 AM,Overall,2230,2570,4450,5150,14400,2080,3264,4674,4467,14485
70,Syria Cross border,2017,TUR-17/3559/SA2/NFI/NGO/7236,7/30/2018 7:53:17 AM,Host Communities,361,584,493,622,2060,283,445,634,644,2006
70,Syria Cross border,2017,TUR-17/3559/SA2/NFI/NGO/7236,7/30/2018 7:53:17 AM,Internally Displaced People,1444,2332,1970,2485,8231,1113,1668,2543,2519,7843
70,Syria Cross border,2017,TUR-17/3559/SA2/NFI/NGO/7236,7/30/2018 7:53:17 AM,Overall,1805,2916,2463,3107,10291,1396,2113,3177,3163,9849
70,Syria Cross border,2017,TUR-17/3559/SA2/NFI/O/7222,6/29/2018 9:26:55 AM,Host Communities,508,400,1502,1510,3920,718,1081,1752,1744,5295
70,Syria Cross border,2017,TUR-17/3559/SA2/NFI/O/7222,6/29/2018 9:26:55 AM,Internally Displaced People,950,1600,2190,2140,6880,1153,1220,1678,1549,5600
70,Syria Cross border,2017,TUR-17/3559/SA2/NFI/O/7222,6/29/2018 9:26:55 AM,Overall,1458,2000,3692,3650,10800,1871,2301,3430,3293,10895
70,Syria Cross border,2017,TUR-17/3559/SA2/NFI-CCM/UN/7031,4/16/2019 11:02:21 AM,Host Communities,2050,2050,4098,4098,12296,2868,2912,3324,3740,12844
70,Syria Cross border,2017,TUR-17/3559/SA2/NFI-CCM/UN/7031,4/16/2019 11:02:21 AM,Internally Displaced People,38442,38442,56884,56884,190652,48855,53492,72243,72776,247366
70,Syria Cross border,2017,TUR-17/3559/SA2/NFI-CCM/UN/7031,4/16/2019 11:02:21 AM,Overall,40492,40492,80982,80982,242948,51723,56404,75567,76516,260210
70,Syria Cross border,2017,TUR-17/3559/SA2/P/NGO/6995,1/31/2019 11:42:03 AM,Host Communities,270,940,280,760,2250,230,1877,243,615,2965
70,Syria Cross border,2017,TUR-17/3559/SA2/P/NGO/6995,1/31/2019 11:42:03 AM,Internally Displaced People,33,112,20,19,184,135,797,138,344,1414
70,Syria Cross border,2017,TUR-17/3559/SA2/P/NGO/6995,1/31/2019 11:42:03 AM,Overall,303,1058,300,779,2440,365,2674,381,959,4379
70,Syria Cross border,2017,TUR-17/3559/SA2/P/NGO/7012,8/21/2020 10:55:39 AM,Host Communities,145,660,310,1110,2225,96,1641,391,1639,3767
70,Syria Cross border,2017,TUR-17/3559/SA2/P/NGO/7012,8/21/2020 10:55:39 AM,Internally Displaced People,55,290,90,240,675,84,340,90,253,767
70,Syria Cross border,2017,TUR-17/3559/SA2/P/NGO/7012,8/21/2020 10:55:39 AM,Overall,200,950,400,1350,2900,180,1981,481,1892,4534
70,Syria Cross border,2017,TUR-17/3559/SA2/P/NGO/7057,9/20/2018 1:38:59 PM,Host Communities,1176,1176,2352,2352,7056,103,130,7345,5626,13204
70,Syria Cross border,2017,TUR-17/3559/SA2/P/NGO/7057,9/20/2018 1:38:59 PM,Internally Displaced People,504,504,2318,2318,5644,80,169,5168,4485,9902
70,Syria Cross border,2017,TUR-17/3559/SA2/P/NGO/7057,9/20/2018 1:38:59 PM,Overall,1680,1680,4670,4670,12700,183,299,12513,10111,23106
70,Syria Cross border,2017,TUR-17/3559/SA2/P/NGO/7066,12/4/2018 11:35:15 AM,Host Communities,221,222,740,740,1923,431,293,1120,1126,2970
70,Syria Cross border,2017,TUR-17/3559/SA2/P/NGO/7066,12/4/2018 11:35:15 AM,Internally Displaced People,129,128,435,435,1127,17,6,99,103,225
70,Syria Cross border,2017,TUR-17/3559/SA2/P/NGO/7066,12/4/2018 11:35:15 AM,Overall,350,350,1175,1175,3050,448,299,1219,1229,3195
70,Syria Cross border,2017,TUR-17/3559/SA2/P/NGO/7087,4/9/2019 1:36:49 PM,Host Communities,2000,2000,2500,2600,9100,1442,1589,2628,2293,7952
70,Syria Cross border,2017,TUR-17/3559/SA2/P/NGO/7087,4/9/2019 1:36:49 PM,Internally Displaced People,1100,2150,2900,2650,8800,1678,2688,3114,3146,10626
70,Syria Cross border,2017,TUR-17/3559/SA2/P/NGO/7087,4/9/2019 1:36:49 PM,Overall,3100,4150,5400,5250,17900,3120,4277,5742,5439,18578
70,Syria Cross border,2017,TUR-17/3559/SA2/P/NGO/7196,10/11/2018 8:58:13 AM,Host Communities,250,3000,1350,1100,5700,214,4718,1096,2627,8655
70,Syria Cross border,2017,TUR-17/3559/SA2/P/NGO/7196,10/11/2018 8:58:13 AM,Internally Displaced People,250,2364,1002,2378,5994,138,4788,436,1792,7154
70,Syria Cross border,2017,TUR-17/3559/SA2/P/NGO/7196,10/11/2018 8:58:13 AM,Overall,500,5364,2352,3478,11694,352,9506,1532,4419,15809
70,Syria Cross border,2017,TUR-17/3559/SA2/P/NGO/7233,9/14/2018 12:14:31 PM,Host Communities,365,7625,825,1650,10465,1592,6878,4339,5440,18249
70,Syria Cross border,2017,TUR-17/3559/SA2/P/NGO/7233,9/14/2018 12:14:31 PM,Internally Displaced People,130,1235,215,520,2100,13292,11826,5759,5722,36599
70,Syria Cross border,2017,TUR-17/3559/SA2/P/NGO/7233,9/14/2018 12:14:31 PM,Overall,495,8860,1040,2170,12565,14221,18505,10884,12743,56353
70,Syria Cross border,2018,TUR-18/3559/RA1/CCM/O/8330,12/3/2019 6:37:21 PM,Internally Displaced People,2939,3542,3556,3789,13826,2463,2565,4532,4763,14323
70,Syria Cross border,2018,TUR-18/3559/RA1/CCM/O/8330,12/3/2019 6:37:21 PM,Overall,2939,3542,3556,3789,13826,2463,2565,4532,4763,14323
70,Syria Cross border,2018,TUR-18/3559/RA1/FS/INGO/8293,11/6/2018 1:24:43 PM,Internally Displaced People,2336,2856,3894,3894,12980,3883,4481,7409,7455,23228
70,Syria Cross border,2018,TUR-18/3559/RA1/FS/INGO/8293,11/6/2018 1:24:43 PM,Overall,2336,2856,3894,3894,12980,3883,4481,7409,7455,23228
70,Syria Cross border,2018,TUR-18/3559/RA1/FS/INGO/8350,1/24/2019 11:38:30 AM,Internally Displaced People,3050,3480,7400,7830,21760,2496,3387,4164,4387,14434
70,Syria Cross border,2018,TUR-18/3559/RA1/FS/INGO/8350,1/24/2019 11:38:30 AM,Overall,3050,3480,7400,7830,21760,2496,3387,4164,4387,14434
70,Syria Cross border,2018,TUR-18/3559/RA1/FS/INGO/8359,12/20/2018 10:34:47 AM,Internally Displaced People,8334,7693,9972,8843,34842,6866,9441,11621,10769,38697
70,Syria Cross border,2018,TUR-18/3559/RA1/FS/INGO/8359,12/20/2018 10:34:47 AM,Overall,8334,7693,9972,8843,34842,6866,9441,11621,10769,38697
70,Syria Cross border,2018,TUR-18/3559/RA1/FS/NGO/8337,11/1/2018 1:26:53 PM,Internally Displaced People,2640,3960,4554,5346,16500,3394,5824,5783,7531,22532
70,Syria Cross border,2018,TUR-18/3559/RA1/FS/NGO/8337,11/1/2018 1:26:53 PM,Overall,2640,3960,4554,5346,16500,3394,5824,5783,7531,22532
70,Syria Cross border,2018,TUR-18/3559/RA1/FS/NGO/8354,8/31/2018 8:12:03 AM,Internally Displaced People,2561,2898,4960,4336,14755,10886,11745,15606,14195,52432
70,Syria Cross border,2018,TUR-18/3559/RA1/FS/NGO/8354,8/31/2018 8:12:03 AM,Overall,2561,2898,4960,4336,14755,11539,12496,16686,15339,56060
70,Syria Cross border,2018,TUR-18/3559/RA1/H/INGO/8362,11/28/2018 1:23:34 PM,Overall,69042,95515,63459,51567,279583,99271,68066,98912,114974,381223
70,Syria Cross border,2018,TUR-18/3559/RA1/H/NGO/8346,1/16/2019 1:49:09 PM,Host Communities,2600,2400,850,750,6600,1802,1187,869,517,4375
70,Syria Cross border,2018,TUR-18/3559/RA1/H/NGO/8346,1/16/2019 1:49:09 PM,Internally Displaced People,2050,1800,650,600,5100,627,335,251,121,1334
70,Syria Cross border,2018,TUR-18/3559/RA1/H/NGO/8346,1/16/2019 1:49:09 PM,Overall,4650,4200,1500,1350,11700,2429,1522,1120,638,5709
70,Syria Cross border,2018,TUR-18/3559/RA1/H/NGO/8367,11/27/2018 8:45:39 AM,Host Communities,15161,15633,8056,8529,47379,6191,17838,11836,10272,46137
70,Syria Cross border,2018,TUR-18/3559/RA1/H/NGO/8367,11/27/2018 8:45:39 AM,Internally Displaced People,8528,8794,4532,4797,26651,5637,11320,5659,5327,27943
70,Syria Cross border,2018,TUR-18/3559/RA1/H/NGO/8367,11/27/2018 8:45:39 AM,Overall,23689,24427,12588,13326,74030,13668,28549,17100,14763,74080
70,Syria Cross border,2018,TUR-18/3559/RA1/H-N/NGO/8332,12/11/2018 10:56:43 AM,Host Communities,46220,25575,19084,10489,101368,8313,26212,15748,14966,65239
70,Syria Cross border,2018,TUR-18/3559/RA1/H-N/NGO/8332,12/11/2018 10:56:43 AM,Internally Displaced People,29748,24055,12348,7922,74073,4235,18234,12788,12027,47284
70,Syria Cross border,2018,TUR-18/3559/RA1/H-N/NGO/8332,12/11/2018 10:56:43 AM,Overall,75968,49630,31432,18411,175441,53138,70028,36324,34219,193709
70,Syria Cross border,2018,TUR-18/3559/RA1/N/INGO/8339,11/13/2018 7:18:09 AM,Host Communities,0,2000,2028,1823,5851,0,2777,2788,2704,8269
70,Syria Cross border,2018,TUR-18/3559/RA1/N/INGO/8339,11/13/2018 7:18:09 AM,Internally Displaced People,0,3862,2380,2267,8509,0,4164,4281,4075,12520
70,Syria Cross border,2018,TUR-18/3559/RA1/N/INGO/8339,11/13/2018 7:18:09 AM,Overall,0,5862,4408,4090,14360,0,6941,7069,6779,20789
70,Syria Cross border,2018,TUR-18/3559/RA1/N/NGO/8360,9/7/2018 11:37:06 AM,Host Communities,1800,4800,5738,5512,17850,2112,13522,13660,13217,42511
70,Syria Cross border,2018,TUR-18/3559/RA1/N/NGO/8360,9/7/2018 11:37:06 AM,Internally Displaced People,2700,7200,8605,8270,26775,705,4509,4555,4407,14176
70,Syria Cross border,2018,TUR-18/3559/RA1/N/NGO/8360,9/7/2018 11:37:06 AM,Overall,4500,12000,14343,13782,44625,2817,18031,18215,17624,56687
70,Syria Cross border,2018,TUR-18/3559/RA1/N/O/8365,11/22/2018 1:01:50 PM,Internally Displaced People,4529,5279,2573,2619,15000,4283,5710,8568,9994,28555
70,Syria Cross border,2018,TUR-18/3559/RA1/N/O/8365,11/22/2018 1:01:50 PM,Overall,4529,5279,2573,2619,15000,5504,7453,4557,4329,21843
70,Syria Cross border,2018,TUR-18/3559/RA1/NFI/NGO/8320,10/2/2018 1:40:07 PM,Internally Displaced People,1832,2126,1319,2053,7330,1610,1452,1743,1764,6569
70,Syria Cross border,2018,TUR-18/3559/RA1/NFI/NGO/8320,10/2/2018 1:40:07 PM,Overall,1832,2126,1319,2053,7330,1610,1452,1743,1764,6569
70,Syria Cross border,2018,TUR-18/3559/RA1/NFI-CCM/UN/7767,10/11/2019 6:01:56 AM,Host Communities,1325,1325,2775,2775,8200,1392,1487,1863,1873,6615
70,Syria Cross border,2018,TUR-18/3559/RA1/NFI-CCM/UN/7767,10/11/2019 6:01:56 AM,Internally Displaced People,11925,11925,24975,24975,73800,16459,17431,22979,22950,79819
70,Syria Cross border,2018,TUR-18/3559/RA1/NFI-CCM/UN/7767,10/11/2019 6:01:56 AM,Overall,13250,13250,27750,27750,82000,17851,18918,24842,24822,86433
70,Syria Cross border,2018,TUR-18/3559/RA1/P/INGO/8335,5/13/2019 8:07:18 AM,Host Communities,570,1130,2242,1682,5624,1247,1511,5380,5743,13881
70,Syria Cross border,2018,TUR-18/3559/RA1/P/INGO/8335,5/13/2019 8:07:18 AM,Internally Displaced People,2279,4521,8968,6726,22494,1606,2189,9501,10351,23647
70,Syria Cross border,2018,TUR-18/3559/RA1/P/INGO/8335,5/13/2019 8:07:18 AM,Overall,2849,5651,11210,8408,28118,2853,3700,14881,16094,37528
70,Syria Cross border,2018,TUR-18/3559/RA1/P/NGO/8344,2/23/2019 7:24:41 AM,Host Communities,1215,3125,5622,3685,13647,0,0,0,0,0
70,Syria Cross border,2018,TUR-18/3559/RA1/P/NGO/8344,2/23/2019 7:24:41 AM,Internally Displaced People,4435,7605,15304,15222,42566,5424,13977,30151,29045,78597
70,Syria Cross border,2018,TUR-18/3559/RA1/P/NGO/8344,2/23/2019 7:24:41 AM,Overall,5650,10730,20926,18907,56213,5423,13978,30151,29045,78597
70,Syria Cross border,2018,TUR-18/3559/RA1/P/NGO/8373,2/21/2019 1:07:11 PM,Host Communities,1070,1130,2242,1682,6124,2295,4113,11277,14891,32576
70,Syria Cross border,2018,TUR-18/3559/RA1/P/NGO/8373,2/21/2019 1:07:11 PM,Internally Displaced People,4430,4521,8968,6726,24645,574,1028,2819,3722,8143
70,Syria Cross border,2018,TUR-18/3559/RA1/P/NGO/8373,2/21/2019 1:07:11 PM,Overall,5500,5651,11210,8408,30769,2869,5141,14096,18613,40719
70,Syria Cross border,2018,TUR-18/3559/RA1/WASH/NGO/8280,7/16/2018 9:40:08 AM,Host Communities,14676,15152,28786,29444,88058,17020,18257,31501,33198,99976
70,Syria Cross border,2018,TUR-18/3559/RA1/WASH/NGO/8280,7/16/2018 9:40:08 AM,Internally Displaced People,14021,14475,27502,28129,84127,15894,17359,28860,30491,92604
70,Syria Cross border,2018,TUR-18/3559/RA1/WASH/NGO/8280,7/16/2018 9:40:08 AM,Overall,28698,29627,56288,57573,172186,32913,35616,60290,63690,192509
70,Syria Cross border,2018,TUR-18/3559/RA1/WASH/NGO/8370,12/21/2018 9:26:04 AM,Host Communities,5372,6228,7429,7592,26621,16475,21658,22859,19079,80071
70,Syria Cross border,2018,TUR-18/3559/RA1/WASH/NGO/8370,12/21/2018 9:26:04 AM,Internally Displaced People,14748,20523,16784,16033,68088,22900,29933,32603,26361,111797
70,Syria Cross border,2018,TUR-18/3559/RA1/WASH/NGO/8370,12/21/2018 9:26:04 AM,Overall,20120,26751,24213,23625,94709,39476,51899,54775,45718,191868
70,Syria Cross border,2018,TUR-18/3559/RA2/H/NGO/8406,6/21/2019 8:51:22 AM,Host Communities,9688,10349,9539,9017,38593,11736,12656,10842,10442,45676
70,Syria Cross border,2018,TUR-18/3559/RA2/H/NGO/8406,6/21/2019 8:51:22 AM,Internally Displaced People,5219,6767,6472,6851,25309,5717,7378,6792,7204,27091
70,Syria Cross border,2018,TUR-18/3559/RA2/H/NGO/8406,6/21/2019 8:51:22 AM,Overall,14907,17116,16011,15868,63902,17453,20034,17634,17646,72767
70,Syria Cross border,2018,TUR-18/3559/RA2/H/NGO/8407,6/26/2019 8:28:13 AM,Host Communities,2900,6000,7000,9000,24900,5014,7487,10610,10578,33689
70,Syria Cross border,2018,TUR-18/3559/RA2/H/NGO/8407,6/26/2019 8:28:13 AM,Internally Displaced People,3940,8895,11003,14170,38008,3474,5644,12050,12999,34167
70,Syria Cross border,2018,TUR-18/3559/RA2/H/NGO/8407,6/26/2019 8:28:13 AM,Overall,6840,14895,18803,23170,63708,8488,13131,22660,23577,67856
70,Syria Cross border,2018,TUR-18/3559/RA3/CCM/NGO/9453,10/11/2019 7:41:58 AM,Internally Displaced People,2756,2650,2650,2544,10600,705,991,1450,1403,4549
70,Syria Cross border,2018,TUR-18/3559/RA3/CCM/NGO/9453,10/11/2019 7:41:58 AM,Overall,2756,2650,2650,2544,10600,705,991,1450,1403,4549
70,Syria Cross border,2018,TUR-18/3559/RA3/CCM/UN/9455,1/22/2020 7:45:01 AM,Internally Displaced People,13920,14234,16689,15683,60526,7913,7830,10255,9918,35916
70,Syria Cross border,2018,TUR-18/3559/RA3/CCM/UN/9455,1/22/2020 7:45:01 AM,Other,150,35,0,0,185,179,35,0,0,214
70,Syria Cross border,2018,TUR-18/3559/RA3/CCM/UN/9455,1/22/2020 7:45:01 AM,Overall,14070,14269,16689,15683,60711,8092,7865,10255,9918,36130
70,Syria Cross border,2018,TUR-18/3559/RA3/CCM-CCS/UN/8990,8/30/2019 10:35:14 AM,Internally Displaced People,1500,1500,3000,3000,9000,2473,2622,3965,3927,12987
70,Syria Cross border,2018,TUR-18/3559/RA3/CCM-CCS/UN/8990,8/30/2019 10:35:14 AM,Other,250,250,0,0,500,254,173,0,0,427
70,Syria Cross border,2018,TUR-18/3559/RA3/CCM-CCS/UN/8990,8/30/2019 10:35:14 AM,Overall,1750,1750,3000,3000,9500,2727,2795,3965,3927,13414
70,Syria Cross border,2018,TUR-18/3559/RA3/CCS/O/9219,9/20/2019 7:09:46 AM,Overall,1,1,1,1,4,1,1,1,1,4
70,Syria Cross border,2018,TUR-18/3559/RA3/FS/NGO/9020,12/28/2018 8:51:45 AM,Internally Displaced People,3600,3600,2400,2400,12000,5889,6367,8105,8588,28949
70,Syria Cross border,2018,TUR-18/3559/RA3/FS/NGO/9020,12/28/2018 8:51:45 AM,Overall,3600,3600,2400,2400,12000,5798,6368,8105,8678,28949
70,Syria Cross border,2018,TUR-18/3559/RA3/FS/NGO/9021,1/24/2019 11:45:49 AM,Internally Displaced People,4375,5157,2654,3438,15624,3694,4204,3801,4005,15704
70,Syria Cross border,2018,TUR-18/3559/RA3/FS/NGO/9021,1/24/2019 11:45:49 AM,Overall,4375,5157,2654,3438,15624,3694,4204,3801,4005,15704
70,Syria Cross border,2018,TUR-18/3559/RA3/FS/NGO/9023,12/20/2018 10:33:03 AM,Internally Displaced People,2969,3368,4284,3719,14340,2663,2520,3121,3249,11553
70,Syria Cross border,2018,TUR-18/3559/RA3/FS/NGO/9023,12/20/2018 10:33:03 AM,Overall,2969,3368,4284,3719,14340,2663,2520,3121,3249,11553
70,Syria Cross border,2018,TUR-18/3559/RA3/FS/O/9024,1/31/2019 5:23:02 PM,Internally Displaced People,1580,1580,1580,3160,7900,2413,2509,1982,3152,10056
70,Syria Cross border,2018,TUR-18/3559/RA3/FS/O/9024,1/31/2019 5:23:02 PM,Overall,1580,1580,1580,3160,7900,2413,2509,1982,3152,10056
70,Syria Cross border,2018,TUR-18/3559/RA3/NFI/INGO/9014,7/19/2019 7:11:57 AM,Internally Displaced People,300,300,600,600,1800,262,284,297,310,1153
70,Syria Cross border,2018,TUR-18/3559/RA3/NFI/INGO/9014,7/19/2019 7:11:57 AM,Overall,300,300,600,600,1800,262,284,297,310,1153
70,Syria Cross border,2018,TUR-18/3559/RA3/NFI/UN/9001,6/27/2019 6:11:54 AM,Host Communities,1000,1000,2000,2000,6000,6970,7720,10723,10020,35433
70,Syria Cross border,2018,TUR-18/3559/RA3/NFI/UN/9001,6/27/2019 6:11:54 AM,Internally Displaced People,9000,9000,18000,18000,54000,3470,3993,6184,5762,19409
70,Syria Cross border,2018,TUR-18/3559/RA3/NFI/UN/9001,6/27/2019 6:11:54 AM,Overall,10000,10000,20000,20000,60000,10440,11713,16907,15782,54842
70,Syria Cross border,2018,TUR-18/3559/RANOV18/E/NGO/11269,3/5/2020 12:22:19 PM,Host Communities,127,121,3927,4763,8938,196,203,7148,7856,15403
70,Syria Cross border,2018,TUR-18/3559/RANOV18/E/NGO/11269,3/5/2020 12:22:19 PM,Internally Displaced People,91,87,2843,3448,6469,52,48,1927,2313,4340
70,Syria Cross border,2018,TUR-18/3559/RANOV18/E/NGO/11269,3/5/2020 12:22:19 PM,Overall,218,208,6770,8211,15407,248,251,9075,10169,19743
70,Syria Cross border,2018,TUR-18/3559/RANOV18/E/NGO/11281,2/4/2020 2:28:35 PM,Host Communities,282,300,7355,7539,15476,624,941,6268,6448,14281
70,Syria Cross border,2018,TUR-18/3559/RANOV18/E/NGO/11281,2/4/2020 2:28:35 PM,Internally Displaced People,188,200,4912,5039,10339,608,800,6263,6614,14285
70,Syria Cross border,2018,TUR-18/3559/RANOV18/E/NGO/11281,2/4/2020 2:28:35 PM,Overall,470,547,12411,12710,26138,1232,1741,12531,13062,28566
70,Syria Cross border,2018,TUR-18/3559/RANOV18/E/NGO/11303,1/23/2020 2:13:16 PM,Internally Displaced People,1619,1525,6241,6262,15647,1812,1497,6084,5928,15321
70,Syria Cross border,2018,TUR-18/3559/RANOV18/E/NGO/11303,1/23/2020 2:13:16 PM,Overall,1619,1525,6241,6262,15647,1812,1497,6084,5928,15321
70,Syria Cross border,2018,TUR-18/3559/RANOV18/E/NGO/11326,11/1/2019 6:41:27 AM,Host Communities,164,134,3056,2821,6175,116,110,2131,2268,4625
70,Syria Cross border,2018,TUR-18/3559/RANOV18/E/NGO/11326,11/1/2019 6:41:27 AM,Internally Displaced People,515,455,9833,11266,22069,574,516,11833,12734,25657
70,Syria Cross border,2018,TUR-18/3559/RANOV18/E/NGO/11326,11/1/2019 6:41:27 AM,Overall,679,589,12889,14087,28244,690,626,13964,15002,30282
70,Syria Cross border,2018,TUR-18/3559/RANOV18/E/NGO/11329,1/14/2020 12:13:57 PM,Host Communities,344,240,6051,5657,12292,580,416,11837,10646,23479
70,Syria Cross border,2018,TUR-18/3559/RANOV18/E/NGO/11329,1/14/2020 12:13:57 PM,Internally Displaced People,175,123,3116,2913,6327,228,120,5719,5037,11104
70,Syria Cross border,2018,TUR-18/3559/RANOV18/E/NGO/11329,1/14/2020 12:13:57 PM,Overall,519,363,9167,8570,18619,808,536,17556,15683,34583
70,Syria Cross border,2018,TUR-18/3559/RANOV18/FS/INGO/11283,10/7/2019 11:27:54 AM,Internally Displaced People,2600,3046,4461,4587,14694,4208,5023,7651,7250,24132
70,Syria Cross border,2018,TUR-18/3559/RANOV18/FS/INGO/11283,10/7/2019 11:27:54 AM,Overall,2600,3046,4461,4587,14694,4208,5023,7651,7250,24132
70,Syria Cross border,2018,TUR-18/3559/RANOV18/FS/INGO/11312,10/7/2019 10:39:06 AM,Internally Displaced People,664,790,794,752,3000,6233,7272,6784,7023,27312
70,Syria Cross border,2018,TUR-18/3559/RANOV18/FS/INGO/11312,10/7/2019 10:39:06 AM,Overall,664,790,794,752,3000,6233,7272,6784,7023,27312
70,Syria Cross border,2018,TUR-18/3559/RANOV18/FS/INGO/11366,10/22/2019 1:47:14 PM,Host Communities,4142,6568,7810,7644,26164,3612,5795,6739,6493,22639
70,Syria Cross border,2018,TUR-18/3559/RANOV18/FS/INGO/11366,10/22/2019 1:47:14 PM,Internally Displaced People,429,637,771,784,2621,764,1029,1334,1241,4368
70,Syria Cross border,2018,TUR-18/3559/RANOV18/FS/INGO/11366,10/22/2019 1:47:14 PM,Overall,4571,7205,8581,8428,28785,4376,6824,8073,7734,27007
70,Syria Cross border,2018,TUR-18/3559/RANOV18/FS/NGO/11288,10/7/2019 1:32:32 PM,Host Communities,1795,1982,2109,1739,7625,498,2074,1779,1946,6297
70,Syria Cross border,2018,TUR-18/3559/RANOV18/FS/NGO/11288,10/7/2019 1:32:32 PM,Internally Displaced People,339,382,407,337,1465,338,1053,1108,1277,3776
70,Syria Cross border,2018,TUR-18/3559/RANOV18/FS/NGO/11288,10/7/2019 1:32:32 PM,Overall,2134,2364,2516,2076,9090,836,3127,2887,3223,10073
70,Syria Cross border,2018,TUR-18/3559/RANOV18/FS/NGO/11304,8/14/2019 6:33:13 AM,Internally Displaced People,1800,1800,2700,2700,9000,2108,2460,2340,2092,9000
70,Syria Cross border,2018,TUR-18/3559/RANOV18/FS/NGO/11304,8/14/2019 6:33:13 AM,Overall,1800,1800,2700,2700,9000,2108,2460,2340,2092,9000
70,Syria Cross border,2018,TUR-18/3559/RANOV18/FS/NGO/11314,6/24/2020 11:08:51 AM,Internally Displaced People,2201,2679,3336,3350,11566,2201,2679,3336,3350,11566
70,Syria Cross border,2018,TUR-18/3559/RANOV18/FS/NGO/11314,6/24/2020 11:08:51 AM,Overall,2201,2679,3336,3350,11566,2201,2679,3336,3350,11566
70,Syria Cross border,2018,TUR-18/3559/RANOV18/FS/NGO/11320,8/14/2019 11:07:11 AM,Host Communities,332,437,439,542,1750,462,534,506,500,2002
70,Syria Cross border,2018,TUR-18/3559/RANOV18/FS/NGO/11320,8/14/2019 11:07:11 AM,Internally Displaced People,858,1123,1129,1390,4500,1251,1446,1368,1352,5417
70,Syria Cross border,2018,TUR-18/3559/RANOV18/FS/NGO/11320,8/14/2019 11:07:11 AM,Overall,1190,1560,1568,1932,6250,1713,1980,1874,1852,7419
70,Syria Cross border,2018,TUR-18/3559/RANOV18/FS/NGO/11334,11/28/2019 8:34:06 AM,Internally Displaced People,1103,1653,1722,2412,6890,1103,1653,1722,2412,6890
70,Syria Cross border,2018,TUR-18/3559/RANOV18/FS/NGO/11334,11/28/2019 8:34:06 AM,Overall,1103,1653,1722,2412,6890,1103,1653,1722,2412,6890
70,Syria Cross border,2018,TUR-18/3559/RANOV18/FS/NGO/11343,8/30/2019 11:57:11 AM,Host Communities,295,475,365,410,1545,482,691,693,719,2585
70,Syria Cross border,2018,TUR-18/3559/RANOV18/FS/NGO/11343,8/30/2019 11:57:11 AM,Internally Displaced People,820,1085,760,1100,3765,771,894,1118,1292,4075
70,Syria Cross border,2018,TUR-18/3559/RANOV18/FS/NGO/11343,8/30/2019 11:57:11 AM,Overall,1115,1560,1155,1520,5350,1253,1585,1811,2011,6660
70,Syria Cross border,2018,TUR-18/3559/RANOV18/FS/NGO/11348,9/10/2019 11:12:47 AM,Host Communities,756,859,951,989,3555,715,1340,1145,1385,4585
70,Syria Cross border,2018,TUR-18/3559/RANOV18/FS/NGO/11348,9/10/2019 11:12:47 AM,Internally Displaced People,1763,2004,2218,2310,8295,2087,2535,3469,3463,11554
70,Syria Cross border,2018,TUR-18/3559/RANOV18/FS/NGO/11348,9/10/2019 11:12:47 AM,Overall,2519,2863,3169,3299,11850,2802,3875,4614,4848,16139
70,Syria Cross border,2018,TUR-18/3559/RANOV18/FS/NGO/11361,10/24/2020 8:57:56 AM,Host Communities,1437,1585,1808,1827,6657,753,897,960,981,3591
70,Syria Cross border,2018,TUR-18/3559/RANOV18/FS/NGO/11361,10/24/2020 8:57:56 AM,Internally Displaced People,3000,3309,3773,3811,13893,1887,2247,2418,2436,8988
70,Syria Cross border,2018,TUR-18/3559/RANOV18/FS/NGO/11361,10/24/2020 8:57:56 AM,Overall,4437,4894,5581,5638,20550,2640,3144,3378,3417,12579
70,Syria Cross border,2018,TUR-18/3559/RANOV18/FS/NGO/11368,8/30/2019 12:05:03 PM,Host Communities,690,779,778,877,3124,672,1092,591,626,2981
70,Syria Cross border,2018,TUR-18/3559/RANOV18/FS/NGO/11368,8/30/2019 12:05:03 PM,Internally Displaced People,690,779,778,877,3124,861,947,1122,1113,4043
70,Syria Cross border,2018,TUR-18/3559/RANOV18/FS/NGO/11368,8/30/2019 12:05:03 PM,Overall,1380,1558,1558,1754,6250,1533,2039,1713,1739,7024
70,Syria Cross border,2018,TUR-18/3559/RANOV18/H/INGO/11352,3/10/2020 8:32:33 AM,Host Communities,138521,133193,117210,143848,532772,104740,100711,88627,108767,402845
70,Syria Cross border,2018,TUR-18/3559/RANOV18/H/INGO/11352,3/10/2020 8:32:33 AM,Internally Displaced People,156204,150196,132173,162212,600785,97463,93715,82469,101211,374858
70,Syria Cross border,2018,TUR-18/3559/RANOV18/H/INGO/11352,3/10/2020 8:32:33 AM,Overall,294725,283389,249383,306060,1133557,202203,194426,171096,209978,777703
70,Syria Cross border,2018,TUR-18/3559/RANOV18/H/NGO/11261,9/17/2019 12:10:07 PM,Host Communities,17500,17100,0,0,34600,18874,18584,0,0,37458
70,Syria Cross border,2018,TUR-18/3559/RANOV18/H/NGO/11261,9/17/2019 12:10:07 PM,Internally Displaced People,5300,6900,0,0,12200,4739,4461,0,0,9200
70,Syria Cross border,2018,TUR-18/3559/RANOV18/H/NGO/11261,9/17/2019 12:10:07 PM,Overall,22800,24000,0,0,46800,23613,23045,0,0,46658
70,Syria Cross border,2018,TUR-18/3559/RANOV18/H/NGO/11286,8/26/2020 7:56:47 AM,Host Communities,3242,1865,3204,3365,11676,6996,6162,5978,4045,23181
70,Syria Cross border,2018,TUR-18/3559/RANOV18/H/NGO/11286,8/26/2020 7:56:47 AM,Internally Displaced People,2548,1465,2517,2644,9174,3551,3190,2275,2024,11040
70,Syria Cross border,2018,TUR-18/3559/RANOV18/H/NGO/11286,8/26/2020 7:56:47 AM,Overall,5790,3330,5721,6009,20850,10547,9352,8253,6069,34221
70,Syria Cross border,2018,TUR-18/3559/RANOV18/H/NGO/11290,10/24/2019 1:27:43 PM,Host Communities,23311,24263,11189,11646,70409,12144,24291,7895,16398,60728
70,Syria Cross border,2018,TUR-18/3559/RANOV18/H/NGO/11290,10/24/2019 1:27:43 PM,Internally Displaced People,15541,16175,7460,4658,43834,8101,16199,5264,10932,40496
70,Syria Cross border,2018,TUR-18/3559/RANOV18/H/NGO/11290,10/24/2019 1:27:43 PM,Overall,38852,40438,18649,19410,117349,20245,40490,13159,27330,101224
70,Syria Cross border,2018,TUR-18/3559/RANOV18/H/NGO/11311,9/17/2019 12:06:43 PM,Host Communities,99,40,5,3,147,79,62,4,1,146
70,Syria Cross border,2018,TUR-18/3559/RANOV18/H/NGO/11311,9/17/2019 12:06:43 PM,Internally Displaced People,55,20,2,1,78,21,15,0,0,36
70,Syria Cross border,2018,TUR-18/3559/RANOV18/H/NGO/11311,9/17/2019 12:06:43 PM,Overall,154,60,7,4,225,100,77,4,1,182
70,Syria Cross border,2018,TUR-18/3559/RANOV18/H/NGO/11321,10/24/2020 8:56:14 AM,Host Communities,1562,2812,937,937,6248,3552,6090,1608,1633,12883
70,Syria Cross border,2018,TUR-18/3559/RANOV18/H/NGO/11321,10/24/2020 8:56:14 AM,Internally Displaced People,4688,8438,2813,2813,18752,8113,10072,4740,4573,27498
70,Syria Cross border,2018,TUR-18/3559/RANOV18/H/NGO/11321,10/24/2020 8:56:14 AM,Overall,6250,11250,3750,3750,25000,11665,16162,6348,6206,40381
70,Syria Cross border,2018,TUR-18/3559/RANOV18/H/NGO/11325,3/10/2020 8:30:01 AM,Host Communities,10047,14281,10171,9961,44460,14569,19290,9041,7582,50482
70,Syria Cross border,2018,TUR-18/3559/RANOV18/H/NGO/11325,3/10/2020 8:30:01 AM,Internally Displaced People,11795,16765,11940,11684,52184,15803,26660,14390,13084,69937
70,Syria Cross border,2018,TUR-18/3559/RANOV18/H/NGO/11325,3/10/2020 8:30:01 AM,Overall,21842,31046,22111,21655,96654,30372,45950,23431,20666,120419
70,Syria Cross border,2018,TUR-18/3559/RANOV18/H/NGO/11331,10/24/2020 8:56:39 AM,Host Communities,13051,14052,3346,3011,33460,3602,7183,3217,1996,15998
70,Syria Cross border,2018,TUR-18/3559/RANOV18/H/NGO/11331,10/24/2020 8:56:39 AM,Internally Displaced People,7028,7569,1802,1621,18020,8401,15842,4438,4312,32993
70,Syria Cross border,2018,TUR-18/3559/RANOV18/H/NGO/11331,10/24/2020 8:56:39 AM,Overall,20079,21621,5148,4632,51480,12003,23025,7655,6308,48991
70,Syria Cross border,2018,TUR-18/3559/RANOV18/H/NGO/11340,9/23/2019 8:23:07 AM,Host Communities,49,39,3,2,93,105,81,2,4,192
70,Syria Cross border,2018,TUR-18/3559/RANOV18/H/NGO/11340,9/23/2019 8:23:07 AM,Internally Displaced People,73,60,5,3,141,51,46,1,4,102
70,Syria Cross border,2018,TUR-18/3559/RANOV18/H/NGO/11340,9/23/2019 8:23:07 AM,Overall,122,99,8,5,234,156,127,3,8,294
70,Syria Cross border,2018,TUR-18/3559/RANOV18/H/UN/11310,9/15/2020 7:02:30 AM,Host Communities,275,275,25,25,600,90,86,16,16,208
70,Syria Cross border,2018,TUR-18/3559/RANOV18/H/UN/11310,9/15/2020 7:02:30 AM,Internally Displaced People,275,275,25,25,600,130,123,27,22,302
70,Syria Cross border,2018,TUR-18/3559/RANOV18/H/UN/11310,9/15/2020 7:02:30 AM,Overall,550,550,50,50,1200,220,209,43,38,510
70,Syria Cross border,2018,TUR-18/3559/RANOV18/N/NGO/11355,7/22/2019 2:09:57 PM,Host Communities,0,50050,82550,82550,215150,0,48328,69056,67795,185179
70,Syria Cross border,2018,TUR-18/3559/RANOV18/N/NGO/11355,7/22/2019 2:09:57 PM,Internally Displaced People,0,26950,44450,44450,115850,0,16109,23018,22597,61724
70,Syria Cross border,2018,TUR-18/3559/RANOV18/N/NGO/11355,7/22/2019 2:09:57 PM,Overall,0,77000,127000,127000,331000,0,64437,92074,90392,246903
70,Syria Cross border,2018,TUR-18/3559/RANOV18/NFI/NGO/11253,1/23/2020 2:15:32 PM,Host Communities,220,245,350,350,1165,286,310,300,245,1141
70,Syria Cross border,2018,TUR-18/3559/RANOV18/NFI/NGO/11253,1/23/2020 2:15:32 PM,Internally Displaced People,510,575,825,825,2735,610,653,701,682,2646
70,Syria Cross border,2018,TUR-18/3559/RANOV18/NFI/NGO/11253,1/23/2020 2:15:32 PM,Overall,730,820,1175,1175,3900,896,963,1001,927,3787
70,Syria Cross border,2018,TUR-18/3559/RANOV18/NFI/NGO/11255,11/1/2019 6:42:55 AM,Host Communities,496,532,640,670,2338,517,677,808,822,2824
70,Syria Cross border,2018,TUR-18/3559/RANOV18/NFI/NGO/11255,11/1/2019 6:42:55 AM,Internally Displaced People,900,949,1155,1197,4201,1127,1314,1733,1624,5798
70,Syria Cross border,2018,TUR-18/3559/RANOV18/NFI/NGO/11255,11/1/2019 6:42:55 AM,Overall,1396,1481,1795,1867,6539,1644,1991,2541,2446,8622
70,Syria Cross border,2018,TUR-18/3559/RANOV18/NFI/O/11365,1/27/2020 6:32:26 AM,Host Communities,123,151,223,223,720,178,202,186,167,733
70,Syria Cross border,2018,TUR-18/3559/RANOV18/NFI/O/11365,1/27/2020 6:32:26 AM,Internally Displaced People,285,353,521,521,1680,335,321,356,349,1361
70,Syria Cross border,2018,TUR-18/3559/RANOV18/NFI/O/11365,1/27/2020 6:32:26 AM,Overall,408,504,744,744,2400,513,523,542,516,2094
70,Syria Cross border,2018,TUR-18/3559/RANOV18/NFI/UN/11350,4/7/2020 11:12:22 AM,Host Communities,1000,1000,1500,1500,5000,0,0,0,0,0
70,Syria Cross border,2018,TUR-18/3559/RANOV18/NFI/UN/11350,4/7/2020 11:12:22 AM,Internally Displaced People,12000,12000,18000,18000,60000,12437,14806,23028,21424,71695
70,Syria Cross border,2018,TUR-18/3559/RANOV18/NFI/UN/11350,4/7/2020 11:12:22 AM,Overall,13000,13000,19500,19500,65000,12437,14806,23028,21424,71695
70,Syria Cross border,2018,TUR-18/3559/RANOV18/P/INGO/11244,12/5/2019 11:02:42 AM,Host Communities,1156,1563,2344,2344,7407,304,647,6920,7228,15099
70,Syria Cross border,2018,TUR-18/3559/RANOV18/P/INGO/11244,12/5/2019 11:02:42 AM,Internally Displaced People,3677,5137,7755,7819,24388,2450,3673,16711,18366,41200
70,Syria Cross border,2018,TUR-18/3559/RANOV18/P/INGO/11244,12/5/2019 11:02:42 AM,Overall,4833,6700,10099,10163,31795,2754,4320,23631,25594,56299
70,Syria Cross border,2018,TUR-18/3559/RANOV18/P/NGO/11262,12/10/2019 11:36:10 AM,Host Communities,380,886,1218,1716,4200,720,1533,3409,3864,9526
70,Syria Cross border,2018,TUR-18/3559/RANOV18/P/NGO/11262,12/10/2019 11:36:10 AM,Internally Displaced People,1520,3544,4871,6865,16800,2063,3293,3532,4028,12916
70,Syria Cross border,2018,TUR-18/3559/RANOV18/P/NGO/11262,12/10/2019 11:36:10 AM,Overall,1900,4430,6089,8581,21000,2783,4826,6941,7892,22442
70,Syria Cross border,2018,TUR-18/3559/RANOV18/P/NGO/11307,12/5/2019 1:13:07 PM,Host Communities,2471,2714,5258,4157,14600,722,1364,4446,3799,10331
70,Syria Cross border,2018,TUR-18/3559/RANOV18/P/NGO/11307,12/5/2019 1:13:07 PM,Internally Displaced People,3707,4071,7887,6235,21900,4677,6771,7916,8006,27370
70,Syria Cross border,2018,TUR-18/3559/RANOV18/P/NGO/11307,12/5/2019 1:13:07 PM,Overall,6178,6785,13145,10392,36500,5399,8135,12362,11805,37701
70,Syria Cross border,2018,TUR-18/3559/RANOV18/P-WASH/NGO/11251,5/6/2020 3:19:20 PM,Host Communities,26643,30347,32684,38178,127852,25858,26982,28106,31479,112425
70,Syria Cross border,2018,TUR-18/3559/RANOV18/P-WASH/NGO/11251,5/6/2020 3:19:20 PM,Internally Displaced People,15813,24752,30592,38453,109610,18250,27365,43906,56452,145973
70,Syria Cross border,2018,TUR-18/3559/RANOV18/P-WASH/NGO/11251,5/6/2020 3:19:20 PM,Overall,42456,55099,63276,76631,237462,44108,54347,72012,87931,258398
70,Syria Cross border,2018,TUR-18/3559/RANOV18/WASH/INGO/11144,2/13/2020 11:02:11 AM,Internally Displaced People,34147,39824,46776,43912,164659,30924,36168,44397,41172,152661
70,Syria Cross border,2018,TUR-18/3559/RANOV18/WASH/INGO/11144,2/13/2020 11:02:11 AM,Overall,34147,39824,46776,43912,164659,30924,36168,44397,41172,152661
70,Syria Cross border,2018,TUR-18/3559/RANOV18/WASH/INGO/11148,7/22/2019 6:17:28 AM,Internally Displaced People,15314,17668,22557,19461,75000,15314,17668,22557,19461,75000
70,Syria Cross border,2018,TUR-18/3559/RANOV18/WASH/INGO/11148,7/22/2019 6:17:28 AM,Overall,15314,17668,22557,19461,75000,15314,17668,22557,19461,75000
70,Syria Cross border,2018,TUR-18/3559/RANOV18/WASH/NGO/11302,4/27/2020 6:47:25 AM,Host Communities,9000,9200,9000,9000,36200,7048,7775,8273,8081,31177
70,Syria Cross border,2018,TUR-18/3559/RANOV18/WASH/NGO/11302,4/27/2020 6:47:25 AM,Internally Displaced People,7500,7500,10000,11000,36000,7240,7505,8345,8308,31398
70,Syria Cross border,2018,TUR-18/3559/RANOV18/WASH/NGO/11302,4/27/2020 6:47:25 AM,Overall,16700,17000,19000,20000,72700,14288,15280,16618,16389,62575
70,Syria Cross border,2018,TUR-18/3559/SA1/E/NGO/9387,11/1/2019 6:35:25 AM,Host Communities,105,71,1250,1209,2635,154,63,2756,2130,5103
70,Syria Cross border,2018,TUR-18/3559/SA1/E/NGO/9387,11/1/2019 6:35:25 AM,Internally Displaced People,51,35,1250,1209,2545,63,32,675,515,1285
70,Syria Cross border,2018,TUR-18/3559/SA1/E/NGO/9387,11/1/2019 6:35:25 AM,Overall,156,106,2500,2418,5180,217,95,3431,2645,6388
70,Syria Cross border,2018,TUR-18/3559/SA1/E/NGO/9432,1/14/2020 12:20:30 PM,Host Communities,46,54,686,720,1506,77,90,797,1031,1995
70,Syria Cross border,2018,TUR-18/3559/SA1/E/NGO/9432,1/14/2020 12:20:30 PM,Internally Displaced People,24,28,390,444,886,9,21,836,1041,1907
70,Syria Cross border,2018,TUR-18/3559/SA1/E/NGO/9432,1/14/2020 12:20:30 PM,Overall,70,82,1076,1164,2392,86,111,1633,2072,3902
70,Syria Cross border,2018,TUR-18/3559/SA1/E/NGO/9443,7/1/2020 10:07:40 AM,Host Communities,73,87,3552,3873,7585,74,45,5026,4368,9513
70,Syria Cross border,2018,TUR-18/3559/SA1/E/NGO/9443,7/1/2020 10:07:40 AM,Internally Displaced People,11,16,3552,3873,7452,41,27,2918,2878,5864
70,Syria Cross border,2018,TUR-18/3559/SA1/E/NGO/9443,7/1/2020 10:07:40 AM,Overall,84,103,7104,7746,15037,115,72,7944,7246,15377
70,Syria Cross border,2018,TUR-18/3559/SA1/E-H/NGO/9485,10/24/2020 8:57:21 AM,Host Communities,7216,7605,3258,3211,21290,9135,9847,3179,3616,25777
70,Syria Cross border,2018,TUR-18/3559/SA1/E-H/NGO/9485,10/24/2020 8:57:21 AM,Internally Displaced People,5833,6130,1620,1491,15074,8983,11992,3280,3705,27960
70,Syria Cross border,2018,TUR-18/3559/SA1/E-H/NGO/9485,10/24/2020 8:57:21 AM,Overall,13049,13735,4878,4702,36364,18118,21839,6459,7321,53737
70,Syria Cross border,2018,TUR-18/3559/SA1/E-P/NGO/9461,12/10/2019 10:49:39 AM,Host Communities,590,274,852,832,2548,403,285,1367,1494,3549
70,Syria Cross border,2018,TUR-18/3559/SA1/E-P/NGO/9461,12/10/2019 10:49:39 AM,Internally Displaced People,230,106,331,323,990,97,67,216,191,571
70,Syria Cross border,2018,TUR-18/3559/SA1/E-P/NGO/9461,12/10/2019 10:49:39 AM,Overall,820,380,1183,1155,3538,500,352,1583,1685,4120
70,Syria Cross border,2018,TUR-18/3559/SA1/E-P/NGO/9470,4/2/2020 1:05:23 PM,Host Communities,77,31,828,742,1678,80,24,998,897,1999
70,Syria Cross border,2018,TUR-18/3559/SA1/E-P/NGO/9470,4/2/2020 1:05:23 PM,Internally Displaced People,50,18,490,486,1044,48,23,403,392,866
70,Syria Cross border,2018,TUR-18/3559/SA1/E-P/NGO/9470,4/2/2020 1:05:23 PM,Overall,127,49,1318,1228,2722,128,47,1401,1289,2865
70,Syria Cross border,2018,TUR-18/3559/SA1/H/NGO/9454,7/8/2019 3:12:11 PM,Host Communities,3839,15557,4293,5380,29069,14741,59781,20661,20661,115844
70,Syria Cross border,2018,TUR-18/3559/SA1/H/NGO/9454,7/8/2019 3:12:11 PM,Internally Displaced People,5759,23336,8078,8070,45243,9826,39852,13774,13774,77226
70,Syria Cross border,2018,TUR-18/3559/SA1/H/NGO/9454,7/8/2019 3:12:11 PM,Overall,9598,38893,13464,13450,75405,26064,98466,33787,34753,193070
70,Syria Cross border,2018,TUR-18/3559/SA1/H-P/NGO/9503,10/24/2020 8:57:36 AM,Host Communities,2494,2693,948,1207,7342,1436,5967,1340,3068,11811
70,Syria Cross border,2018,TUR-18/3559/SA1/H-P/NGO/9503,10/24/2020 8:57:36 AM,Internally Displaced People,2690,3490,986,1698,8864,2361,8961,2984,4304,18610
70,Syria Cross border,2018,TUR-18/3559/SA1/H-P/NGO/9503,10/24/2020 8:57:36 AM,Overall,5184,6183,1934,2905,16206,3797,14928,4324,7372,30421
70,Syria Cross border,2018,TUR-18/3559/SA1/NFI/O/9488,7/25/2019 1:38:23 PM,Host Communities,90,100,115,115,420,93,99,147,145,484
70,Syria Cross border,2018,TUR-18/3559/SA1/NFI/O/9488,7/25/2019 1:38:23 PM,Internally Displaced People,185,215,355,355,1110,220,226,271,273,990
70,Syria Cross border,2018,TUR-18/3559/SA1/NFI/O/9488,7/25/2019 1:38:23 PM,Overall,275,315,470,470,1530,316,328,412,418,1474
70,Syria Cross border,2018,TUR-18/3559/SA1/P/INGO/9465,7/4/2019 7:32:36 AM,Host Communities,1725,1725,4600,3450,11500,2497,2590,10160,5811,21058
70,Syria Cross border,2018,TUR-18/3559/SA1/P/INGO/9465,7/4/2019 7:32:36 AM,Internally Displaced People,1725,1725,4600,3450,11500,2129,2294,3033,6047,13503
70,Syria Cross border,2018,TUR-18/3559/SA1/P/INGO/9465,7/4/2019 7:32:36 AM,Overall,3450,3450,9200,6900,23000,4630,4891,13193,11858,34572
70,Syria Cross border,2018,TUR-18/3559/SA1/P/NGO/9297,8/21/2020 9:10:18 AM,Host Communities,700,3500,1100,3700,9000,106,642,156,546,1450
70,Syria Cross border,2018,TUR-18/3559/SA1/P/NGO/9297,8/21/2020 9:10:18 AM,Internally Displaced People,1400,3000,2000,2500,8900,1609,3626,2433,3128,10796
70,Syria Cross border,2018,TUR-18/3559/SA1/P/NGO/9297,8/21/2020 9:10:18 AM,Overall,2100,6500,3100,6200,17900,1715,4268,2589,3674,12246
70,Syria Cross border,2018,TUR-18/3559/SA1/P/NGO/9476,9/25/2019 7:35:38 AM,Host Communities,665,1225,1575,1575,5040,1431,1850,2434,2492,8207
70,Syria Cross border,2018,TUR-18/3559/SA1/P/NGO/9476,9/25/2019 7:35:38 AM,Internally Displaced People,1235,2275,2925,2925,9360,2472,3395,3733,3676,13276
70,Syria Cross border,2018,TUR-18/3559/SA1/P/NGO/9476,9/25/2019 7:35:38 AM,Overall,1900,3500,4500,4500,14400,3903,5245,6167,6168,21483
70,Syria Cross border,2018,TUR-18/3559/SA1/P/NGO/9484,11/28/2019 1:50:48 PM,Host Communities,672,105,115,67,959,1158,553,322,263,2296
70,Syria Cross border,2018,TUR-18/3559/SA1/P/NGO/9484,11/28/2019 1:50:48 PM,Internally Displaced People,168,27,29,17,241,214,201,42,34,491
70,Syria Cross border,2018,TUR-18/3559/SA1/P/NGO/9484,11/28/2019 1:50:48 PM,Other,2,1,0,0,3,0,0,0,0,0
70,Syria Cross border,2018,TUR-18/3559/SA1/P/NGO/9484,11/28/2019 1:50:48 PM,Overall,842,133,144,84,1203,1372,754,364,297,2787
70,Syria Cross border,2018,TUR-18/3559/SA1/P-E/NGO/9313,12/10/2019 11:17:27 AM,Host Communities,870,8819,0,7700,17389,387,12375,114,11388,24264
70,Syria Cross border,2018,TUR-18/3559/SA1/P-E/NGO/9313,12/10/2019 11:17:27 AM,Internally Displaced People,309,2680,1854,1765,6608,588,3518,2520,3896,10522
70,Syria Cross border,2018,TUR-18/3559/SA1/P-E/NGO/9313,12/10/2019 11:17:27 AM,Overall,1179,11499,1854,9465,23997,975,15893,2634,15284,34786
70,Syria Cross border,2018,TUR-18/3559/SA1/P-E/NGO/9446,3/27/2020 9:10:39 AM,Host Communities,971,1127,27993,30764,60855,1984,2366,25660,23673,53683
70,Syria Cross border,2018,TUR-18/3559/SA1/P-E/NGO/9446,3/27/2020 9:10:39 AM,Internally Displaced People,1000,1060,10880,11120,24060,774,762,13400,11239,26175
70,Syria Cross border,2018,TUR-18/3559/SA1/P-E/NGO/9446,3/27/2020 9:10:39 AM,Overall,2304,2652,38873,41884,85713,2758,3128,39060,34912,79858
70,Syria Cross border,2018,TUR-18/3559/SA1/P-H/NGO/9494,12/10/2019 10:35:19 AM,Host Communities,3659,8417,4585,4293,20954,1529,10688,3283,4527,20027
70,Syria Cross border,2018,TUR-18/3559/SA1/P-H/NGO/9494,12/10/2019 10:35:19 AM,Internally Displaced People,4358,9174,4662,7057,25251,2330,12652,5969,7539,28490
70,Syria Cross border,2018,TUR-18/3559/SA1/P-H/NGO/9494,12/10/2019 10:35:19 AM,Overall,8017,17591,9247,11350,46205,3859,23340,9252,12066,48517
70,Syria Cross border,2018,TUR-18/3559/SA1/P-NFI/UN/9505,12/26/2019 10:10:39 AM,Host Communities,339,610,210,238,1397,699,1129,241,623,2692
70,Syria Cross border,2018,TUR-18/3559/SA1/P-NFI/UN/9505,12/26/2019 10:10:39 AM,Internally Displaced People,1083,1646,905,1185,4819,1622,2043,707,866,5238
70,Syria Cross border,2018,TUR-18/3559/SA1/P-NFI/UN/9505,12/26/2019 10:10:39 AM,Overall,1422,2256,1115,1423,6216,2321,3172,948,1489,7930
70,Syria Cross border,2018,TUR-18/3559/SA1/WASH/INGO/9373,8/1/2019 11:25:06 AM,Internally Displaced People,8082,11723,8103,8834,36742,11608,12296,17053,16767,57724
70,Syria Cross border,2018,TUR-18/3559/SA1/WASH/INGO/9373,8/1/2019 11:25:06 AM,Overall,8712,12672,8711,9504,39599,17964,17618,12166,12852,60600
70,Syria Cross border,2018,TUR-18/3559/SA1/WASH/INGO/9373,8/1/2019 11:25:06 AM,Refugees,630,949,608,670,2857,558,556,911,851,2876
70,Syria Cross border,2018,TUR-18/3559/SA1/WASH/NGO/9397,7/18/2019 8:52:26 AM,Internally Displaced People,2754,3204,2777,2953,11688,2720,3019,2817,3297,11853
70,Syria Cross border,2018,TUR-18/3559/SA1/WASH/NGO/9397,7/18/2019 8:52:26 AM,Overall,2754,3204,2777,2953,11688,2720,3019,2817,3297,11853
70,Syria Cross border,2018,TUR-18/3559/SA1/WASH/NGO/9425,7/2/2019 6:19:01 AM,Host Communities,5360,5640,6870,7130,25000,4685,4742,6802,7624,23853
70,Syria Cross border,2018,TUR-18/3559/SA1/WASH/NGO/9425,7/2/2019 6:19:01 AM,Internally Displaced People,2960,3112,3792,3936,13800,3133,3183,4551,5084,15951
70,Syria Cross border,2018,TUR-18/3559/SA1/WASH/NGO/9425,7/2/2019 6:19:01 AM,Overall,8320,8752,10662,11066,38800,7818,7925,11353,12708,39804
70,Syria Cross border,2018,TUR-18/3559/SA1/WASH/NGO/9496,5/15/2019 12:47:44 PM,Host Communities,4645,4857,5701,5915,21118,5279,5578,6524,6748,24129
70,Syria Cross border,2018,TUR-18/3559/SA1/WASH/NGO/9496,5/15/2019 12:47:44 PM,Internally Displaced People,2226,2328,2732,2835,10121,2483,2573,3057,3208,11321
70,Syria Cross border,2018,TUR-18/3559/SA1/WASH/NGO/9496,5/15/2019 12:47:44 PM,Overall,6871,7185,8433,8750,31239,7762,8151,9581,9956,35450
70,Syria Cross border,2018,TUR-18/3559/SA2/CCM/INGO/10198,12/15/2020 11:59:36 AM,Internally Displaced People,26074,30720,39019,35166,130979,28028,32956,39415,35481,135880
70,Syria Cross border,2018,TUR-18/3559/SA2/CCM/INGO/10198,12/15/2020 11:59:36 AM,Overall,26074,30720,39019,35166,130979,28028,32956,39415,35481,135880
70,Syria Cross border,2018,TUR-18/3559/SA2/CCM/O/10199,4/16/2019 6:55:08 AM,Internally Displaced People,2803,3151,4559,4474,14987,3188,3536,5136,5052,16912
70,Syria Cross border,2018,TUR-18/3559/SA2/CCM/O/10199,4/16/2019 6:55:08 AM,Overall,2803,3151,4559,4474,14987,3188,3536,5136,5052,16912
70,Syria Cross border,2018,TUR-18/3559/SA2/CCM-NFI/UN/10169,2/5/2020 6:46:18 AM,Internally Displaced People,28204,30768,34614,34614,128200,30882,34079,46425,45841,157227
70,Syria Cross border,2018,TUR-18/3559/SA2/CCM-NFI/UN/10169,2/5/2020 6:46:18 AM,Overall,28204,30768,34614,34614,128200,30882,34079,46425,45841,157227
70,Syria Cross border,2018,TUR-18/3559/SA2/FS/NGO/10168,8/14/2019 6:30:00 AM,Host Communities,910,1950,2585,2705,8150,2534,3005,2766,2435,10740
70,Syria Cross border,2018,TUR-18/3559/SA2/FS/NGO/10168,8/14/2019 6:30:00 AM,Internally Displaced People,165,165,236,249,815,127,164,186,157,634
70,Syria Cross border,2018,TUR-18/3559/SA2/FS/NGO/10168,8/14/2019 6:30:00 AM,Overall,1075,2115,2821,2954,8965,2661,3169,2952,2592,11374
70,Syria Cross border,2018,TUR-18/3559/SA2/FS/NGO/10196,10/10/2019 10:54:17 AM,Host Communities,100,100,0,0,200,243,97,0,0,340
70,Syria Cross border,2018,TUR-18/3559/SA2/FS/NGO/10196,10/10/2019 10:54:17 AM,Internally Displaced People,235,215,0,0,450,158,152,0,0,310
70,Syria Cross border,2018,TUR-18/3559/SA2/FS/NGO/10196,10/10/2019 10:54:17 AM,Overall,335,315,0,0,650,401,249,0,0,650
70,Syria Cross border,2018,TUR-18/3559/SA2/FS/NGO/10200,8/30/2019 12:23:55 PM,Host Communities,921,1131,1349,1624,5025,756,238,918,1120,3032
70,Syria Cross border,2018,TUR-18/3559/SA2/FS/NGO/10200,8/30/2019 12:23:55 PM,Internally Displaced People,453,557,665,800,2475,284,53,530,548,1415
70,Syria Cross border,2018,TUR-18/3559/SA2/FS/NGO/10200,8/30/2019 12:23:55 PM,Overall,1374,1688,2014,2424,7500,1040,291,1448,1668,4447
70,Syria Cross border,2018,TUR-18/3559/SA2/FS/NGO/10202,7/3/2019 12:15:49 PM,Host Communities,2485,2579,1657,1724,8445,1155,1303,1472,1313,5243
70,Syria Cross border,2018,TUR-18/3559/SA2/FS/NGO/10202,7/3/2019 12:15:49 PM,Internally Displaced People,276,288,186,195,945,132,171,187,165,655
70,Syria Cross border,2018,TUR-18/3559/SA2/FS/NGO/10202,7/3/2019 12:15:49 PM,Overall,2761,2867,1843,1919,9390,1287,1474,1659,1478,5898
70,Syria Cross border,2018,TUR-18/3559/SA2/FS/NGO/10231,8/14/2019 1:28:32 PM,Host Communities,799,836,983,1018,3636,803,854,1038,1072,3767
70,Syria Cross border,2018,TUR-18/3559/SA2/FS/NGO/10231,8/14/2019 1:28:32 PM,Internally Displaced People,84,88,104,108,384,71,82,111,124,388
70,Syria Cross border,2018,TUR-18/3559/SA2/FS/NGO/10231,8/14/2019 1:28:32 PM,Overall,883,924,1087,1126,4020,874,936,1149,1196,4155
70,Syria Cross border,2018,TUR-18/3559/SA2/FS/NGO/10234,9/4/2019 8:20:21 AM,Host Communities,1027,1027,268,345,2667,1812,2038,2572,1948,8370
70,Syria Cross border,2018,TUR-18/3559/SA2/FS/NGO/10234,9/4/2019 8:20:21 AM,Internally Displaced People,173,173,268,300,914,76,86,108,82,352
70,Syria Cross border,2018,TUR-18/3559/SA2/FS/NGO/10234,9/4/2019 8:20:21 AM,Overall,1200,1200,2500,2300,7200,1888,2124,2680,2030,8722
70,Syria Cross border,2018,TUR-18/3559/SA2/FS/UN/10222,11/8/2019 2:41:44 PM,Overall,151200,165600,192447,210753,720000,95383,109009,119236,130577,454205
70,Syria Cross border,2018,TUR-18/3559/SA2/H/NGO/10232,7/22/2019 12:41:01 PM,Host Communities,49,41,3,2,95,184,141,4,10,339
70,Syria Cross border,2018,TUR-18/3559/SA2/H/NGO/10232,7/22/2019 12:41:01 PM,Internally Displaced People,113,95,6,5,219,45,64,6,5,120
70,Syria Cross border,2018,TUR-18/3559/SA2/H/NGO/10232,7/22/2019 12:41:01 PM,Overall,162,136,9,7,314,229,205,10,15,459
70,Syria Cross border,2018,TUR-18/3559/SA2/H-N/INGO/10171,11/28/2019 1:54:19 PM,Host Communities,890,4312,4287,4813,14302,1968,19962,27343,20222,69495
70,Syria Cross border,2018,TUR-18/3559/SA2/H-N/INGO/10171,11/28/2019 1:54:19 PM,Internally Displaced People,1630,11240,6856,6790,26516,1060,6134,14724,10889,32807
70,Syria Cross border,2018,TUR-18/3559/SA2/H-N/INGO/10171,11/28/2019 1:54:19 PM,Overall,2520,15552,11143,11603,40818,3028,26096,42067,31111,102302
70,Syria Cross border,2018,TUR-18/3559/SA2/H-N/NGO/10176,10/24/2020 8:58:14 AM,Host Communities,6878,5666,4019,3121,19684,5486,9796,5112,4864,25258
70,Syria Cross border,2018,TUR-18/3559/SA2/H-N/NGO/10176,10/24/2020 8:58:14 AM,Internally Displaced People,10318,8500,6029,4683,29530,4613,8047,4193,3946,20799
70,Syria Cross border,2018,TUR-18/3559/SA2/H-N/NGO/10176,10/24/2020 8:58:14 AM,Overall,17196,14166,10048,7804,49214,10099,17843,9305,8810,46057
70,Syria Cross border,2018,TUR-18/3559/SA2/H-N/NGO/10185,8/1/2019 1:10:18 PM,Host Communities,1442,11459,2982,2904,18787,3870,30745,8001,7792,50408
70,Syria Cross border,2018,TUR-18/3559/SA2/H-N/NGO/10185,8/1/2019 1:10:18 PM,Internally Displaced People,3365,26739,6958,6776,43838,2578,20499,5332,5197,33606
70,Syria Cross border,2018,TUR-18/3559/SA2/H-N/NGO/10185,8/1/2019 1:10:18 PM,Overall,4808,38198,9940,9680,62626,6448,51245,13334,12989,84016
70,Syria Cross border,2018,TUR-18/3559/SA2/H-N/NGO/10211,8/15/2019 8:57:42 AM,Host Communities,4206,10958,4363,4177,23704,2261,2112,1942,2383,8698
70,Syria Cross border,2018,TUR-18/3559/SA2/H-N/NGO/10211,8/15/2019 8:57:42 AM,Internally Displaced People,8937,23286,9271,8875,50369,13027,27677,11113,13641,65458
70,Syria Cross border,2018,TUR-18/3559/SA2/H-N/NGO/10211,8/15/2019 8:57:42 AM,Overall,13143,34244,13634,13052,74073,15288,29789,13055,16024,74156
70,Syria Cross border,2018,TUR-18/3559/SA2/H-N/NGO/10214,8/6/2019 12:34:30 PM,Host Communities,1000,3000,1880,1400,7280,2697,6945,5586,5052,20280
70,Syria Cross border,2018,TUR-18/3559/SA2/H-N/NGO/10214,8/6/2019 12:34:30 PM,Internally Displaced People,340,1900,800,600,3640,1147,2836,880,869,5732
70,Syria Cross border,2018,TUR-18/3559/SA2/H-N/NGO/10214,8/6/2019 12:34:30 PM,Overall,1340,4900,2680,2000,10920,3844,9781,6466,5921,26012
70,Syria Cross border,2018,TUR-18/3559/SA2/H-N/NGO/10229,10/21/2019 1:44:22 PM,Host Communities,3571,6807,6823,6459,23660,1325,1690,1968,2057,7040
70,Syria Cross border,2018,TUR-18/3559/SA2/H-N/NGO/10229,10/21/2019 1:44:22 PM,Internally Displaced People,1759,15565,17830,18306,53460,12989,18201,19193,18881,69264
70,Syria Cross border,2018,TUR-18/3559/SA2/H-N/NGO/10229,10/21/2019 1:44:22 PM,Overall,5331,22463,24653,24765,77212,14314,19891,21161,20938,76304
70,Syria Cross border,2018,TUR-18/3559/SA2/H-WASH/NGO/10175,2/17/2020 9:01:32 AM,Host Communities,5631,6051,5037,5659,22378,4604,4945,4215,3937,17701
70,Syria Cross border,2018,TUR-18/3559/SA2/H-WASH/NGO/10175,2/17/2020 9:01:32 AM,Internally Displaced People,4609,5241,5112,5326,20288,8482,15716,12877,14204,51279
70,Syria Cross border,2018,TUR-18/3559/SA2/H-WASH/NGO/10175,2/17/2020 9:01:32 AM,Overall,11130,12172,11044,11820,46166,13086,20661,17092,18141,68980
70,Syria Cross border,2018,TUR-18/3559/SA2/N/NGO/10228,7/22/2019 11:43:32 AM,Host Communities,0,40950,5850,5850,52650,0,34810,12026,12901,59737
70,Syria Cross border,2018,TUR-18/3559/SA2/N/NGO/10228,7/22/2019 11:43:32 AM,Internally Displaced People,0,22050,3150,3150,28350,0,13163,4384,4700,22247
70,Syria Cross border,2018,TUR-18/3559/SA2/N/NGO/10228,7/22/2019 11:43:32 AM,Overall,0,63000,9000,9000,81000,0,47973,16410,17601,81984
70,Syria Cross border,2018,TUR-18/3559/SA2/NFI/INGO/10172,8/26/2019 7:34:27 AM,Host Communities,1408,1482,2149,2371,7410,3794,4379,5850,5799,19822
70,Syria Cross border,2018,TUR-18/3559/SA2/NFI/INGO/10172,8/26/2019 7:34:27 AM,Internally Displaced People,3285,3458,5014,5533,17290,4844,5959,9261,8896,28960
70,Syria Cross border,2018,TUR-18/3559/SA2/NFI/INGO/10172,8/26/2019 7:34:27 AM,Overall,4693,4940,7163,7904,24700,8638,10338,15111,14695,48782
70,Syria Cross border,2018,TUR-18/3559/SA2/NFI/INGO/10242,7/19/2019 11:51:25 AM,Host Communities,720,1080,1800,1800,5400,1233,1514,1583,1563,5893
70,Syria Cross border,2018,TUR-18/3559/SA2/NFI/INGO/10242,7/19/2019 11:51:25 AM,Internally Displaced People,720,1080,1800,1800,5400,1248,1515,1697,1565,6025
70,Syria Cross border,2018,TUR-18/3559/SA2/NFI/INGO/10242,7/19/2019 11:51:25 AM,Overall,1440,2160,3600,3600,10800,2481,3029,3280,3128,11918
70,Syria Cross border,2018,TUR-18/3559/SA2/NFI/NGO/10217,8/2/2019 8:23:37 AM,Host Communities,330,396,462,462,1650,250,413,511,469,1643
70,Syria Cross border,2018,TUR-18/3559/SA2/NFI/NGO/10217,8/2/2019 8:23:37 AM,Internally Displaced People,990,1188,1386,1386,4950,918,1082,1355,1162,4517
70,Syria Cross border,2018,TUR-18/3559/SA2/NFI/NGO/10217,8/2/2019 8:23:37 AM,Overall,1320,1584,1848,1848,6600,1168,1495,1866,1631,6160
70,Syria Cross border,2018,TUR-18/3559/SA2/NFI/NGO/10230,8/17/2019 2:53:42 PM,Host Communities,372,406,440,474,1692,827,1026,1409,1365,4627
70,Syria Cross border,2018,TUR-18/3559/SA2/NFI/NGO/10230,8/17/2019 2:53:42 PM,Internally Displaced People,1116,1218,1319,1420,5073,319,380,586,592,1877
70,Syria Cross border,2018,TUR-18/3559/SA2/NFI/NGO/10230,8/17/2019 2:53:42 PM,Overall,1488,1624,1759,1894,6765,1146,1406,1995,1957,6504
70,Syria Cross border,2018,TUR-18/3559/SA2/NFI/NGO/10238,8/27/2019 10:38:22 AM,Host Communities,410,431,816,865,2522,223,522,495,541,1781
70,Syria Cross border,2018,TUR-18/3559/SA2/NFI/NGO/10238,8/27/2019 10:38:22 AM,Internally Displaced People,760,799,1515,1604,4678,518,940,1507,1524,4489
70,Syria Cross border,2018,TUR-18/3559/SA2/NFI/NGO/10238,8/27/2019 10:38:22 AM,Overall,1170,1230,2331,2469,7200,741,1462,2002,2065,6270
70,Syria Cross border,2018,TUR-18/3559/SA2/NFI-CCM/NGO/10183,11/1/2019 6:47:13 AM,Host Communities,232,243,297,308,1080,149,189,233,254,825
70,Syria Cross border,2018,TUR-18/3559/SA2/NFI-CCM/NGO/10183,11/1/2019 6:47:13 AM,Internally Displaced People,4490,4871,7241,7422,24024,4569,4789,6745,6906,23009
70,Syria Cross border,2018,TUR-18/3559/SA2/NFI-CCM/NGO/10183,11/1/2019 6:47:13 AM,Overall,4722,5114,7538,7730,25104,4718,4978,6978,7160,23834
70,Syria Cross border,2018,TUR-18/3559/SA2/WASH/INGO/10221,9/19/2019 8:50:50 AM,Internally Displaced People,7554,9147,12154,12058,40913,9550,9330,17230,16707,52817
70,Syria Cross border,2018,TUR-18/3559/SA2/WASH/INGO/10221,9/19/2019 8:50:50 AM,Overall,7554,9147,12154,12058,40913,9550,9330,17230,16707,52817
70,Syria Cross border,2018,TUR-18/3559/SA2/WASH/INGO/10252,8/29/2019 11:04:34 AM,Internally Displaced People,6909,8906,11835,11960,39610,7198,9293,12473,12376,41340
70,Syria Cross border,2018,TUR-18/3559/SA2/WASH/INGO/10252,8/29/2019 11:04:34 AM,Overall,6909,8906,11835,11960,39610,7198,9293,12473,12376,41340
70,Syria Cross border,2018,TUR-18/3559/SA2/WASH/NGO/10219,10/4/2019 2:01:01 PM,Internally Displaced People,2080,3120,3900,3900,13000,2150,2361,2716,2587,9814
70,Syria Cross border,2018,TUR-18/3559/SA2/WASH/NGO/10219,10/4/2019 2:01:01 PM,Overall,2080,3120,3900,3900,13000,2150,2361,2716,2587,9814
70,Syria Cross border,2018,TUR-18/3559/SA2/WASH/NGO/10220,11/27/2019 1:16:01 PM,Host Communities,2180,2500,3480,3718,11878,1783,1970,2625,3000,9378
70,Syria Cross border,2018,TUR-18/3559/SA2/WASH/NGO/10220,11/27/2019 1:16:01 PM,Internally Displaced People,6368,7031,9227,10712,33338,8399,9285,12367,14145,44196
70,Syria Cross border,2018,TUR-18/3559/SA2/WASH/NGO/10220,11/27/2019 1:16:01 PM,Overall,8622,9531,12707,14522,45382,10182,11255,14992,17145,53574
70,Syria Cross border,2018,TUR-18/3559/SA2/WASH-CCM/NGO/10210,1/16/2020 1:35:43 PM,Internally Displaced People,2250,2400,2575,3175,10400,1951,1664,1644,1467,6726
70,Syria Cross border,2018,TUR-18/3559/SA2/WASH-CCM/NGO/10210,1/16/2020 1:35:43 PM,Overall,2250,2400,2575,3175,10400,1951,1664,1644,1467,6726
70,Syria Cross border,2019,TUR-19/3559/RA1/WASH/INGO/12238,9/24/2019 1:03:57 PM,Internally Displaced People,8378,10768,14280,14236,47662,7068,9101,12235,11938,40342
70,Syria Cross border,2019,TUR-19/3559/RA1/WASH/INGO/12238,9/24/2019 1:03:57 PM,Overall,8378,10768,14280,14236,47662,7068,9101,12235,11938,40342
70,Syria Cross border,2019,TUR-19/3559/RA2/CCS/O/13786,5/12/2020 1:12:26 PM,Other,25,25,25,25,100,29,29,30,30,118
70,Syria Cross border,2019,TUR-19/3559/RA2/CCS/O/13786,5/12/2020 1:12:26 PM,Overall,25,25,25,25,100,29,29,30,30,118
70,Syria Cross border,2019,TUR-19/3559/RA2/H/NGO/13710,7/6/2020 7:15:21 AM,Host Communities,14580,14200,0,0,28780,21776,21631,0,0,43407
70,Syria Cross border,2019,TUR-19/3559/RA2/H/NGO/13710,7/6/2020 7:15:21 AM,Internally Displaced People,4860,3800,0,0,8660,5098,4678,0,0,9776
70,Syria Cross border,2019,TUR-19/3559/RA2/H/NGO/13710,7/6/2020 7:15:21 AM,Overall,19440,18000,0,0,37440,26874,26309,0,0,53183
70,Syria Cross border,2019,TUR-19/3559/RA2/H/NGO/13755,8/14/2020 7:41:26 AM,Host Communities,2200,7499,3208,3208,16115,184,3158,1767,2036,7145
70,Syria Cross border,2019,TUR-19/3559/RA2/H/NGO/13755,8/14/2020 7:41:26 AM,Internally Displaced People,800,4125,1830,1830,8585,95,5451,3209,4145,12900
70,Syria Cross border,2019,TUR-19/3559/RA2/H/NGO/13755,8/14/2020 7:41:26 AM,Overall,3000,11624,5038,5038,24700,279,8609,4976,6181,20045
70,Syria Cross border,2019,TUR-19/3559/RA2/H/NGO/13768,8/12/2020 6:02:42 PM,Host Communities,6958,7199,4542,4270,22969,10151,9078,6762,5068,31059
70,Syria Cross border,2019,TUR-19/3559/RA2/H/NGO/13768,8/12/2020 6:02:42 PM,Internally Displaced People,6639,6911,4685,4285,22520,6788,6339,5573,4659,23359
70,Syria Cross border,2019,TUR-19/3559/RA2/H/NGO/13768,8/12/2020 6:02:42 PM,Overall,13597,14110,9227,8555,45489,16939,15417,12335,9727,54418
70,Syria Cross border,2019,TUR-19/3559/RA2/H/NGO/13778,6/8/2020 6:15:08 PM,Host Communities,400,3100,1825,2300,7625,241,3139,1343,1603,6326
70,Syria Cross border,2019,TUR-19/3559/RA2/H/NGO/13778,6/8/2020 6:15:08 PM,Internally Displaced People,200,2180,1400,1760,5540,435,5306,3724,3905,13370
70,Syria Cross border,2019,TUR-19/3559/RA2/H/NGO/13778,6/8/2020 6:15:08 PM,Overall,600,5280,3225,4060,13165,676,8445,5067,5508,19696
70,Syria Cross border,2019,TUR-19/3559/RA2/H/NGO/13781,8/11/2020 8:16:22 AM,Host Communities,4600,6133,2300,2300,15333,1933,1072,752,361,4118
70,Syria Cross border,2019,TUR-19/3559/RA2/H/NGO/13781,8/11/2020 8:16:22 AM,Internally Displaced People,3066,4089,1534,1534,10223,1161,837,493,251,2742
70,Syria Cross border,2019,TUR-19/3559/RA2/H/NGO/13781,8/11/2020 8:16:22 AM,Overall,7666,10222,3834,3834,25556,3094,1909,1245,612,6860
70,Syria Cross border,2019,TUR-19/3559/RA2/H/NGO/13793,9/20/2020 6:20:50 PM,Host Communities,125,350,75,45,595,91,1044,59,128,1322
70,Syria Cross border,2019,TUR-19/3559/RA2/H/NGO/13793,9/20/2020 6:20:50 PM,Internally Displaced People,250,350,120,70,790,22,821,21,54,918
70,Syria Cross border,2019,TUR-19/3559/RA2/H/NGO/13793,9/20/2020 6:20:50 PM,Overall,375,700,195,115,1385,113,1865,80,182,2240
70,Syria Cross border,2019,TUR-19/3559/RA2/H/NGO/13797,6/23/2020 9:43:51 AM,Host Communities,1045,697,665,760,3167,3038,1699,5640,2834,13211
70,Syria Cross border,2019,TUR-19/3559/RA2/H/NGO/13797,6/23/2020 9:43:51 AM,Internally Displaced People,539,359,343,392,1633,1496,1085,2650,1665,6896
70,Syria Cross border,2019,TUR-19/3559/RA2/H/NGO/13797,6/23/2020 9:43:51 AM,Overall,1584,1056,1008,1152,4800,4534,2784,8290,4499,20107
70,Syria Cross border,2019,TUR-19/3559/RA2/H/UN/13817,3/24/2021 8:59:51 AM,Host Communities,47792,35142,30925,26708,140567,15372,11123,21826,9699,58020
70,Syria Cross border,2019,TUR-19/3559/RA2/H/UN/13817,3/24/2021 8:59:51 AM,Internally Displaced People,95586,70284,61849,53415,281134,52893,25781,37774,19045,135493
70,Syria Cross border,2019,TUR-19/3559/RA2/H/UN/13817,3/24/2021 8:59:51 AM,Overall,143378,105426,92774,80123,421701,68265,36904,59600,28744,193513
70,Syria Cross border,2019,TUR-19/3559/RA2/H-P/UN/13769,8/17/2020 11:53:21 AM,Internally Displaced People,0,19255,0,6111,25366,0,19255,0,6111,25366
70,Syria Cross border,2019,TUR-19/3559/RA2/H-P/UN/13769,8/17/2020 11:53:21 AM,Overall,0,19255,0,6111,25366,0,19255,0,6111,25366
70,Syria Cross border,2019,TUR-19/3559/RA2/NFI/INGO/13720,8/31/2020 8:49:48 AM,Internally Displaced People,3809,4454,6563,6357,21183,4514,5234,7464,7146,24358
70,Syria Cross border,2019,TUR-19/3559/RA2/NFI/INGO/13720,8/31/2020 8:49:48 AM,Overall,3809,4454,6563,6357,21183,4514,5234,7464,7146,24358
70,Syria Cross border,2019,TUR-19/3559/RA2/NFI/NGO/13711,8/14/2020 6:58:05 AM,Host Communities,180,190,230,240,840,132,232,259,246,869
70,Syria Cross border,2019,TUR-19/3559/RA2/NFI/NGO/13711,8/14/2020 6:58:05 AM,Internally Displaced People,1620,1705,2075,2160,7560,1525,1908,2408,2296,8137
70,Syria Cross border,2019,TUR-19/3559/RA2/NFI/NGO/13711,8/14/2020 6:58:05 AM,Overall,1800,1895,2305,2400,8400,1657,2140,2667,2542,9006
70,Syria Cross border,2019,TUR-19/3559/RA2/NFI/NGO/13719,9/18/2020 2:11:54 PM,Internally Displaced People,2076,2294,2612,2643,9625,2016,2107,2737,2618,9478
70,Syria Cross border,2019,TUR-19/3559/RA2/NFI/NGO/13719,9/18/2020 2:11:54 PM,Overall,2076,2294,2612,2643,9625,2016,2107,2737,2618,9478
70,Syria Cross border,2019,TUR-19/3559/RA2/NFI/NGO/13756,8/18/2020 8:58:04 AM,Host Communities,197,290,313,360,1160,268,311,418,384,1381
70,Syria Cross border,2019,TUR-19/3559/RA2/NFI/NGO/13756,8/18/2020 8:58:04 AM,Internally Displaced People,789,1160,1253,1438,4640,1109,1361,1772,1550,5792
70,Syria Cross border,2019,TUR-19/3559/RA2/NFI/NGO/13756,8/18/2020 8:58:04 AM,Overall,986,1450,1566,1798,5800,1377,1672,2190,1934,7173
70,Syria Cross border,2019,TUR-19/3559/RA2/NFI/NGO/13758,7/24/2020 4:09:41 PM,Internally Displaced People,2752,3011,3840,3277,12880,2754,3010,3849,3286,12899
70,Syria Cross border,2019,TUR-19/3559/RA2/NFI/NGO/13758,7/24/2020 4:09:41 PM,Overall,2752,3011,3840,3277,12880,2754,3010,3849,3286,12899
70,Syria Cross border,2019,TUR-19/3559/RA2/NFI/NGO/13780,8/14/2020 10:32:33 AM,Host Communities,799,913,1093,1189,3994,795,944,967,903,3609
70,Syria Cross border,2019,TUR-19/3559/RA2/NFI/NGO/13780,8/14/2020 10:32:33 AM,Internally Displaced People,2396,2738,3278,3566,11978,2415,2779,3305,2929,11428
70,Syria Cross border,2019,TUR-19/3559/RA2/NFI/NGO/13780,8/14/2020 10:32:33 AM,Overall,3195,3651,4371,4755,15972,3210,3723,4272,3832,15037
70,Syria Cross border,2019,TUR-19/3559/RA2/NFI/NGO/13796,7/10/2020 6:39:39 AM,Internally Displaced People,1403,1560,1642,1841,6446,1403,1560,1642,1841,6446
70,Syria Cross border,2019,TUR-19/3559/RA2/NFI/NGO/13796,7/10/2020 6:39:39 AM,Overall,1403,1560,1642,1841,6446,1403,1560,1642,1841,6446
70,Syria Cross border,2019,TUR-19/3559/RA2/NFI/NGO/13804,7/24/2020 3:59:32 PM,Host Communities,86,124,72,106,388,88,97,143,129,457
70,Syria Cross border,2019,TUR-19/3559/RA2/NFI/NGO/13804,7/24/2020 3:59:32 PM,Internally Displaced People,3470,4064,4510,4670,16714,2674,3614,5967,5755,18010
70,Syria Cross border,2019,TUR-19/3559/RA2/NFI/NGO/13804,7/24/2020 3:59:32 PM,Overall,3556,4188,4582,4776,17102,2762,3711,6110,5884,18467
70,Syria Cross border,2019,TUR-19/3559/RA2/NFI/NGO/13816,12/3/2020 7:19:52 AM,Internally Displaced People,1200,1300,1150,1350,5000,1316,1898,1810,1636,6660
70,Syria Cross border,2019,TUR-19/3559/RA2/NFI/NGO/13816,12/3/2020 7:19:52 AM,Overall,1200,1300,1150,1350,5000,1316,1898,1810,1636,6660
70,Syria Cross border,2019,TUR-19/3559/RA2/NFI-CCM/NGO/13742,1/5/2021 7:07:14 AM,Internally Displaced People,3914,4661,5987,5730,20292,5221,6189,8542,7793,27745
70,Syria Cross border,2019,TUR-19/3559/RA2/NFI-CCM/NGO/13742,1/5/2021 7:07:14 AM,Overall,3914,4661,5987,5730,20292,5221,6189,8542,7793,27745
70,Syria Cross border,2019,TUR-19/3559/RA2/NFI-CCM-WASH/UN/13735,2/25/2021 10:50:42 AM,Internally Displaced People,12000,12000,18000,18000,60000,19624,20400,30709,29170,99903
70,Syria Cross border,2019,TUR-19/3559/RA2/NFI-CCM-WASH/UN/13735,2/25/2021 10:50:42 AM,Overall,12000,12000,18000,18000,60000,19624,20400,30709,29170,99903
70,Syria Cross border,2019,TUR-19/3559/RA2/P/INGO/13767,12/11/2020 10:30:27 AM,Host Communities,706,1113,5249,5716,12784,672,295,633,822,2422
70,Syria Cross border,2019,TUR-19/3559/RA2/P/INGO/13767,12/11/2020 10:30:27 AM,Internally Displaced People,2308,3799,16567,18048,40722,18672,18869,13430,3649,54620
70,Syria Cross border,2019,TUR-19/3559/RA2/P/INGO/13767,12/11/2020 10:30:27 AM,Overall,3014,4912,21816,23764,53506,19344,19164,14063,4471,57042
70,Syria Cross border,2019,TUR-19/3559/RA2/P/NGO/13733,8/28/2020 7:06:03 AM,Internally Displaced People,9800,9600,13000,15000,47400,10026,13672,16241,22442,62381
70,Syria Cross border,2019,TUR-19/3559/RA2/P/NGO/13733,8/28/2020 7:06:03 AM,Overall,9800,9600,13000,15000,47400,10026,13672,16241,22442,62381
70,Syria Cross border,2019,TUR-19/3559/RA2/P/NGO/13784,7/18/2020 2:08:46 PM,Host Communities,1323,1721,2799,2549,8392,110,652,3010,3524,7296
70,Syria Cross border,2019,TUR-19/3559/RA2/P/NGO/13784,7/18/2020 2:08:46 PM,Internally Displaced People,3086,4016,6531,5947,19580,3813,5279,7187,6503,22782
70,Syria Cross border,2019,TUR-19/3559/RA2/P/NGO/13784,7/18/2020 2:08:46 PM,Overall,4409,5737,9330,8496,27972,3923,5931,10197,10027,30078
70,Syria Cross border,2019,TUR-19/3559/RA2/WASH/NGO/13712,10/26/2020 9:58:34 AM,Internally Displaced People,3467,3645,4440,4611,16163,3666,4165,5627,5381,18839
70,Syria Cross border,2019,TUR-19/3559/RA2/WASH/NGO/13712,10/26/2020 9:58:34 AM,Overall,3467,3645,4440,4611,16163,3666,4165,5627,5381,18839
70,Syria Cross border,2019,TUR-19/3559/RA2/WASH/NGO/13713,4/16/2020 8:27:51 AM,Host Communities,1925,2116,3432,3798,11271,2979,3181,5882,6202,18244
70,Syria Cross border,2019,TUR-19/3559/RA2/WASH/NGO/13713,4/16/2020 8:27:51 AM,Internally Displaced People,2453,2553,4906,5088,15000,4981,5277,10064,10500,30822
70,Syria Cross border,2019,TUR-19/3559/RA2/WASH/NGO/13713,4/16/2020 8:27:51 AM,Overall,4378,4669,8338,8886,26271,7960,8458,15946,16702,49066
70,Syria Cross border,2019,TUR-19/3559/RA2/WASH/NGO/13723,5/8/2020 7:10:46 AM,Internally Displaced People,2638,3240,2498,2647,11023,2638,3240,2498,2647,11023
70,Syria Cross border,2019,TUR-19/3559/RA2/WASH/NGO/13723,5/8/2020 7:10:46 AM,Overall,2638,3240,2498,2647,11023,2638,3240,2498,2647,11023
70,Syria Cross border,2019,TUR-19/3559/RA2/WASH/NGO/13731,7/23/2020 7:42:42 AM,Internally Displaced People,1842,2756,2877,4025,11500,1842,2756,2877,4025,11500
70,Syria Cross border,2019,TUR-19/3559/RA2/WASH/NGO/13731,7/23/2020 7:42:42 AM,Overall,1842,2756,2877,4025,11500,1842,2756,2877,4025,11500
70,Syria Cross border,2019,TUR-19/3559/RA2/WASH/NGO/13736,8/11/2020 12:08:51 PM,Internally Displaced People,2931,3418,4167,4484,15000,5391,6517,7653,7076,26637
70,Syria Cross border,2019,TUR-19/3559/RA2/WASH/NGO/13736,8/11/2020 12:08:51 PM,Overall,2931,3418,4167,4484,15000,5391,6517,7653,7076,26637
70,Syria Cross border,2019,TUR-19/3559/RA2/WASH/NGO/13751,10/20/2020 6:12:41 AM,Internally Displaced People,2702,3000,4062,4424,14188,2793,2973,4095,3845,13706
70,Syria Cross border,2019,TUR-19/3559/RA2/WASH/NGO/13751,10/20/2020 6:12:41 AM,Overall,2702,3000,4062,4424,14188,2793,2973,4095,3845,13706
70,Syria Cross border,2019,TUR-19/3559/RA2/WASH/NGO/13757,5/12/2020 6:43:00 AM,Internally Displaced People,1611,2216,2518,3726,10071,3644,4207,5555,5746,19152
70,Syria Cross border,2019,TUR-19/3559/RA2/WASH/NGO/13757,5/12/2020 6:43:00 AM,Overall,1611,2216,2518,3726,10071,3644,4207,5555,5746,19152
70,Syria Cross border,2019,TUR-19/3559/RA2/WASH/NGO/13782,8/10/2020 10:34:34 AM,Internally Displaced People,3220,4103,3769,3923,15015,3698,4281,3997,4109,16085
70,Syria Cross border,2019,TUR-19/3559/RA2/WASH/NGO/13782,8/10/2020 10:34:34 AM,Overall,3220,4103,3769,3923,15015,3698,4281,3997,4109,16085
70,Syria Cross border,2019,TUR-19/3559/RA2/WASH/NGO/13785,7/23/2020 6:53:07 AM,Host Communities,10035,10975,11825,12763,45598,10035,10975,11825,12763,45598
70,Syria Cross border,2019,TUR-19/3559/RA2/WASH/NGO/13785,7/23/2020 6:53:07 AM,Internally Displaced People,5070,5500,6025,6460,23055,8480,8568,8065,9112,34225
70,Syria Cross border,2019,TUR-19/3559/RA2/WASH/NGO/13785,7/23/2020 6:53:07 AM,Overall,15105,16475,17850,19223,68653,18515,19543,19890,21875,79823
70,Syria Cross border,2019,TUR-19/3559/RA2/WASH/NGO/13801,5/8/2020 9:23:36 AM,Internally Displaced People,3776,3803,3704,3569,14852,3776,3803,3704,3569,14852
70,Syria Cross border,2019,TUR-19/3559/RA2/WASH/NGO/13801,5/8/2020 9:23:36 AM,Overall,3776,3803,3704,3569,14852,3776,3803,3704,3569,14852
70,Syria Cross border,2019,TUR-19/3559/RA2/WASH/NGO/13809,7/23/2020 7:11:38 AM,Internally Displaced People,7446,7903,11435,10556,37340,7446,7903,11435,10556,37340
70,Syria Cross border,2019,TUR-19/3559/RA2/WASH/NGO/13809,7/23/2020 7:11:38 AM,Overall,7446,7903,11435,10556,37340,7446,7903,11435,10556,37340
70,Syria Cross border,2019,TUR-19/3559/RA2/WASH/NGO/13813,10/22/2020 6:02:53 AM,Internally Displaced People,5986,6289,7421,6172,25868,7255,7612,9076,7441,31384
70,Syria Cross border,2019,TUR-19/3559/RA2/WASH/NGO/13813,10/22/2020 6:02:53 AM,Overall,5986,6289,7421,6172,25868,7255,7612,9076,7441,31384
70,Syria Cross border,2019,TUR-19/3559/RA2/WASH-NFI/NGO/13775,8/11/2020 8:24:21 AM,Host Communities,40029,41849,49128,50949,181955,40030,41850,49129,50946,181955
70,Syria Cross border,2019,TUR-19/3559/RA2/WASH-NFI/NGO/13775,8/11/2020 8:24:21 AM,Internally Displaced People,23376,24440,28691,29753,106260,23376,24440,28691,29753,106260
70,Syria Cross border,2019,TUR-19/3559/RA2/WASH-NFI/NGO/13775,8/11/2020 8:24:21 AM,Overall,63405,66289,77819,80702,288215,63406,66290,77820,80699,288215
70,Syria Cross border,2019,TUR-19/3559/RA3/FS/INGO/14900,8/10/2020 8:18:59 AM,Internally Displaced People,3735,4799,6216,5550,20300,3822,6277,5325,5030,20454
70,Syria Cross border,2019,TUR-19/3559/RA3/FS/INGO/14900,8/10/2020 8:18:59 AM,Overall,3735,4799,6216,5550,20300,3822,6277,5325,5030,20454
70,Syria Cross border,2019,TUR-19/3559/RA3/FS/INGO/14912,7/17/2020 6:24:48 AM,Internally Displaced People,4753,5228,6417,7367,23765,8866,9797,13728,15075,47466
70,Syria Cross border,2019,TUR-19/3559/RA3/FS/INGO/14912,7/17/2020 6:24:48 AM,Overall,4753,5228,6417,7367,23765,8866,9797,13728,15075,47466
70,Syria Cross border,2019,TUR-19/3559/RA3/FS/NGO/14899,8/10/2020 9:43:20 AM,Internally Displaced People,6729,8093,8155,7613,30590,6787,7487,8537,8624,31435
70,Syria Cross border,2019,TUR-19/3559/RA3/FS/NGO/14899,8/10/2020 9:43:20 AM,Overall,6729,8093,8155,7613,30590,6787,7487,8537,8624,31435
70,Syria Cross border,2019,TUR-19/3559/RA3/FS/NGO/14901,7/17/2020 6:09:45 AM,Internally Displaced People,2227,2673,1515,2495,8910,2069,2288,2935,2579,9871
70,Syria Cross border,2019,TUR-19/3559/RA3/FS/NGO/14901,7/17/2020 6:09:45 AM,Overall,2227,2673,1515,2495,8910,2069,2288,2935,2579,9871
70,Syria Cross border,2019,TUR-19/3559/RA3/FS/NGO/14921,7/10/2020 11:52:18 AM,Internally Displaced People,2802,3237,4885,4428,15352,2800,3243,4904,4429,15376
70,Syria Cross border,2019,TUR-19/3559/RA3/FS/NGO/14921,7/10/2020 11:52:18 AM,Overall,2802,3237,4885,4428,15352,2800,3243,4904,4429,15376
70,Syria Cross border,2019,TUR-19/3559/RA3/H/NGO/14908,10/5/2020 8:49:43 AM,Host Communities,92,72,0,1,165,114,88,0,1,203
70,Syria Cross border,2019,TUR-19/3559/RA3/H/NGO/14908,10/5/2020 8:49:43 AM,Internally Displaced People,186,100,1,1,288,135,112,1,1,249
70,Syria Cross border,2019,TUR-19/3559/RA3/H/NGO/14908,10/5/2020 8:49:43 AM,Overall,278,172,1,2,453,249,200,1,2,452
70,Syria Cross border,2019,TUR-19/3559/RA3/N/UN/14909,2/3/2021 1:55:33 PM,Internally Displaced People,0,10455,19600,19600,49655,0,14029,24131,23186,61346
70,Syria Cross border,2019,TUR-19/3559/RA3/N/UN/14909,2/3/2021 1:55:33 PM,Overall,0,10455,19600,19600,49655,0,14029,24131,23186,61346
70,Syria Cross border,2019,TUR-19/3559/RA3/NFI/INGO/14914,10/7/2020 2:51:27 PM,Internally Displaced People,3735,4799,6216,5550,20300,4142,5093,5858,5309,20402
70,Syria Cross border,2019,TUR-19/3559/RA3/NFI/INGO/14914,10/7/2020 2:51:27 PM,Overall,3735,4799,6216,5550,20300,4142,5093,5858,5309,20402
70,Syria Cross border,2019,TUR-19/3559/RA3/NFI/NGO/14913,9/18/2020 2:05:48 PM,Internally Displaced People,5016,5244,6156,6384,22800,3361,4293,5589,5211,18454
70,Syria Cross border,2019,TUR-19/3559/RA3/NFI/NGO/14913,9/18/2020 2:05:48 PM,Overall,5016,5244,6156,6384,22800,3361,4293,5589,5211,18454
70,Syria Cross border,2019,TUR-19/3559/RA3/NFI/NGO/14915,10/7/2020 6:24:59 AM,Internally Displaced People,4563,5934,6048,6277,22822,4146,6623,6455,5591,22815
70,Syria Cross border,2019,TUR-19/3559/RA3/NFI/NGO/14915,10/7/2020 6:24:59 AM,Overall,4563,5934,6048,6277,22822,4146,6623,6455,5591,22815
70,Syria Cross border,2019,TUR-19/3559/RA3/NFI/NGO/14916,1/5/2021 6:55:18 AM,Internally Displaced People,2959,3042,5621,6379,18001,2157,3671,4325,4334,14487
70,Syria Cross border,2019,TUR-19/3559/RA3/NFI/NGO/14916,1/5/2021 6:55:18 AM,Overall,2959,3042,5621,6379,18001,2157,3671,4325,4334,14487
70,Syria Cross border,2019,TUR-19/3559/RA3/NFI/NGO/14917,10/13/2020 11:57:44 AM,Internally Displaced People,4312,5176,2932,4830,17250,3693,4274,5807,5323,19097
70,Syria Cross border,2019,TUR-19/3559/RA3/NFI/NGO/14917,10/13/2020 11:57:44 AM,Overall,4312,5176,2932,4830,17250,3693,4274,5807,5323,19097
70,Syria Cross border,2019,TUR-19/3559/RA3/NFI/UN/14910,12/3/2020 7:00:31 AM,Internally Displaced People,25200,25200,37800,37800,126000,21524,27039,27485,31832,107880
70,Syria Cross border,2019,TUR-19/3559/RA3/NFI/UN/14910,12/3/2020 7:00:31 AM,Overall,25200,25200,37800,37800,126000,21524,27039,27485,31832,107880
70,Syria Cross border,2019,TUR-19/3559/RA3/P/NGO/14906,8/25/2020 7:29:57 AM,Internally Displaced People,2185,2950,9265,8650,23050,3726,3693,7900,7322,22641
70,Syria Cross border,2019,TUR-19/3559/RA3/P/NGO/14906,8/25/2020 7:29:57 AM,Overall,2185,2950,9265,8650,23050,3726,3693,7900,7322,22641
70,Syria Cross border,2019,TUR-19/3559/RA3/P/NGO/14907,10/5/2020 7:19:25 AM,Internally Displaced People,3260,5070,57405,59500,125235,4746,7611,59029,58332,129718
70,Syria Cross border,2019,TUR-19/3559/RA3/P/NGO/14907,10/5/2020 7:19:25 AM,Overall,3260,5070,57405,59500,125235,4746,7611,59029,58332,129718
70,Syria Cross border,2019,TUR-19/3559/RA3/WASH/NGO/14902,10/26/2020 12:36:53 PM,Internally Displaced People,2786,3077,4774,5291,15928,2786,3077,4774,5291,15928
70,Syria Cross border,2019,TUR-19/3559/RA3/WASH/NGO/14902,10/26/2020 12:36:53 PM,Overall,2786,3077,4774,5291,15928,2786,3077,4774,5291,15928
70,Syria Cross border,2019,TUR-19/3559/RA3/WASH/NGO/14903,10/26/2020 12:41:38 PM,Internally Displaced People,3753,5630,7038,7038,23459,3753,5630,7038,7038,23459
70,Syria Cross border,2019,TUR-19/3559/RA3/WASH/NGO/14903,10/26/2020 12:41:38 PM,Overall,3753,5630,7038,7038,23459,3753,5630,7038,7038,23459
70,Syria Cross border,2019,TUR-19/3559/RA3/WASH/NGO/14904,10/30/2020 8:34:33 AM,Host Communities,6480,7104,9810,10486,33880,4653,5141,7101,7591,24486
70,Syria Cross border,2019,TUR-19/3559/RA3/WASH/NGO/14904,10/30/2020 8:34:33 AM,Internally Displaced People,34784,38130,52657,56287,181858,29424,32524,44913,48009,154870
70,Syria Cross border,2019,TUR-19/3559/RA3/WASH/NGO/14904,10/30/2020 8:34:33 AM,Overall,41264,45234,62467,66773,215738,34077,37665,52014,55600,179356
70,Syria Cross border,2019,TUR-19/3559/RA3/WASH/NGO/14905,10/13/2020 8:13:34 AM,Internally Displaced People,4401,7164,5212,7120,23897,4649,7176,5403,7244,24472
70,Syria Cross border,2019,TUR-19/3559/RA3/WASH/NGO/14905,10/13/2020 8:13:34 AM,Overall,4401,7164,5212,7120,23897,4649,7176,5403,7244,24472
70,Syria Cross border,2019,TUR-19/3559/SA1/CCM/NGO/12859,10/20/2020 3:17:03 PM,Internally Displaced People,6766,7008,5830,5548,25152,7561,9308,9700,10047,36616
70,Syria Cross border,2019,TUR-19/3559/SA1/CCM/NGO/12859,10/20/2020 3:17:03 PM,Overall,6766,7008,5830,5548,25152,7561,9308,9700,10047,36616
70,Syria Cross border,2019,TUR-19/3559/SA1/CCM/NGO/12922,8/7/2020 12:55:44 PM,Internally Displaced People,3245,3564,3853,4318,14980,3701,4036,5283,4961,17981
70,Syria Cross border,2019,TUR-19/3559/SA1/CCM/NGO/12922,8/7/2020 12:55:44 PM,Overall,3245,3564,3853,4318,14980,3701,4036,5283,4961,17981
70,Syria Cross border,2019,TUR-19/3559/SA1/CCM/UN/11711,4/20/2020 8:42:22 AM,Internally Displaced People,5250,5750,7000,7000,25000,5242,5531,8131,7316,26220
70,Syria Cross border,2019,TUR-19/3559/SA1/CCM/UN/11711,4/20/2020 8:42:22 AM,Overall,5250,5750,7000,7000,25000,5242,5531,8131,7316,26220
70,Syria Cross border,2019,TUR-19/3559/SA1/CCM-P/UN/12989,12/14/2020 11:45:38 AM,Host Communities,840,750,337,337,2264,727,751,305,323,2106
70,Syria Cross border,2019,TUR-19/3559/SA1/CCM-P/UN/12989,12/14/2020 11:45:38 AM,Internally Displaced People,22399,22785,26835,26672,98691,24048,29439,37481,33908,124876
70,Syria Cross border,2019,TUR-19/3559/SA1/CCM-P/UN/12989,12/14/2020 11:45:38 AM,Other,6,6,0,0,12,7,6,0,0,13
70,Syria Cross border,2019,TUR-19/3559/SA1/CCM-P/UN/12989,12/14/2020 11:45:38 AM,Overall,23245,23541,27172,27009,100967,24782,30196,37786,34231,126995
70,Syria Cross border,2019,TUR-19/3559/SA1/CCS/NGO/12926,9/11/2020 10:37:22 AM,Host Communities,990,976,182,190,2338,990,976,182,190,2338
70,Syria Cross border,2019,TUR-19/3559/SA1/CCS/NGO/12926,9/11/2020 10:37:22 AM,Internally Displaced People,990,990,187,179,2346,990,990,187,179,2346
70,Syria Cross border,2019,TUR-19/3559/SA1/CCS/NGO/12926,9/11/2020 10:37:22 AM,Other,32,0,0,0,32,32,5,0,0,37
70,Syria Cross border,2019,TUR-19/3559/SA1/CCS/NGO/12926,9/11/2020 10:37:22 AM,Overall,2012,1966,369,369,4716,2012,1971,369,369,4721
70,Syria Cross border,2019,TUR-19/3559/SA1/CCS/O/11651,10/31/2019 6:59:06 AM,Other,56,48,48,48,200,56,48,48,48,200
70,Syria Cross border,2019,TUR-19/3559/SA1/CCS/O/11651,10/31/2019 6:59:06 AM,Overall,56,48,48,48,200,56,48,48,48,200
70,Syria Cross border,2019,TUR-19/3559/SA1/E/INGO/12943,11/1/2021 9:41:30 AM,Host Communities,12,12,265,315,604,6,9,182,237,434
70,Syria Cross border,2019,TUR-19/3559/SA1/E/INGO/12943,11/1/2021 9:41:30 AM,Internally Displaced People,12,12,265,315,604,9,12,395,367,783
70,Syria Cross border,2019,TUR-19/3559/SA1/E/INGO/12943,11/1/2021 9:41:30 AM,Overall,25,25,550,650,1250,15,21,577,604,1217
70,Syria Cross border,2019,TUR-19/3559/SA1/E/INGO/12943,11/1/2021 9:41:30 AM,Returnees,1,1,20,20,42,0,0,0,0,0
70,Syria Cross border,2019,TUR-19/3559/SA1/E/NGO/12630,8/14/2020 1:17:36 PM,Host Communities,91,82,1228,2140,3541,86,77,1065,1903,3131
70,Syria Cross border,2019,TUR-19/3559/SA1/E/NGO/12630,8/14/2020 1:17:36 PM,Internally Displaced People,105,118,4548,5062,9833,94,108,4548,5062,9812
70,Syria Cross border,2019,TUR-19/3559/SA1/E/NGO/12630,8/14/2020 1:17:36 PM,Overall,196,200,5776,7202,13374,180,185,5613,6965,12943
70,Syria Cross border,2019,TUR-19/3559/SA1/E/NGO/12682,8/14/2020 11:37:16 AM,Host Communities,104,224,3048,2636,6012,100,117,2538,2568,5323
70,Syria Cross border,2019,TUR-19/3559/SA1/E/NGO/12682,8/14/2020 11:37:16 AM,Internally Displaced People,24,52,1071,926,2073,128,88,1956,1779,3951
70,Syria Cross border,2019,TUR-19/3559/SA1/E/NGO/12682,8/14/2020 11:37:16 AM,Overall,128,276,4119,3562,8085,228,205,4494,4347,9274
70,Syria Cross border,2019,TUR-19/3559/SA1/E/NGO/12799,1/17/2021 1:09:15 PM,Host Communities,45,55,1034,1158,2292,53,70,1192,1153,2468
70,Syria Cross border,2019,TUR-19/3559/SA1/E/NGO/12799,1/17/2021 1:09:15 PM,Internally Displaced People,59,77,1420,1543,3099,61,67,1139,1000,2267
70,Syria Cross border,2019,TUR-19/3559/SA1/E/NGO/12799,1/17/2021 1:09:15 PM,Overall,104,132,2454,2701,5391,114,137,2331,2153,4735
70,Syria Cross border,2019,TUR-19/3559/SA1/E/NGO/12825,11/11/2020 9:37:54 AM,Host Communities,67,60,1656,1656,3439,62,38,1756,1922,3778
70,Syria Cross border,2019,TUR-19/3559/SA1/E/NGO/12825,11/11/2020 9:37:54 AM,Internally Displaced People,43,38,1049,1049,2179,61,32,1536,1464,3093
70,Syria Cross border,2019,TUR-19/3559/SA1/E/NGO/12825,11/11/2020 9:37:54 AM,Overall,112,100,2760,2760,5732,123,70,3292,3386,6871
70,Syria Cross border,2019,TUR-19/3559/SA1/E/NGO/12825,11/11/2020 9:37:54 AM,Returnees,2,2,55,55,114,0,0,0,0,0
70,Syria Cross border,2019,TUR-19/3559/SA1/E/NGO/12856,11/23/2020 1:42:01 PM,Internally Displaced People,233,133,4381,4277,9024,208,158,5809,6144,12319
70,Syria Cross border,2019,TUR-19/3559/SA1/E/NGO/12856,11/23/2020 1:42:01 PM,Overall,233,133,4381,4277,9024,208,158,5809,6144,12319
70,Syria Cross border,2019,TUR-19/3559/SA1/E/NGO/12879,10/22/2020 6:47:07 PM,Host Communities,290,117,2678,2161,5246,114,79,3565,2903,6661
70,Syria Cross border,2019,TUR-19/3559/SA1/E/NGO/12879,10/22/2020 6:47:07 PM,Internally Displaced People,8,5,805,640,1458,1,1,794,807,1603
70,Syria Cross border,2019,TUR-19/3559/SA1/E/NGO/12879,10/22/2020 6:47:07 PM,Overall,298,122,3483,2801,6704,115,80,4359,3710,8264
70,Syria Cross border,2019,TUR-19/3559/SA1/E/NGO/13002,8/17/2020 11:57:53 AM,Host Communities,20,15,312,285,632,21,23,908,1025,1977
70,Syria Cross border,2019,TUR-19/3559/SA1/E/NGO/13002,8/17/2020 11:57:53 AM,Internally Displaced People,39,25,1506,1231,2801,47,16,542,681,1286
70,Syria Cross border,2019,TUR-19/3559/SA1/E/NGO/13002,8/17/2020 11:57:53 AM,Overall,69,45,1839,1533,3486,72,42,1453,1713,3280
70,Syria Cross border,2019,TUR-19/3559/SA1/E/NGO/13002,8/17/2020 11:57:53 AM,Returnees,10,5,21,17,53,4,3,3,7,17
70,Syria Cross border,2019,TUR-19/3559/SA1/ER/UN/12794,7/29/2021 8:49:35 AM,Internally Displaced People,19303,20642,30028,32240,102213,19786,20828,30200,32284,103098
70,Syria Cross border,2019,TUR-19/3559/SA1/ER/UN/12794,7/29/2021 8:49:35 AM,Overall,19303,20642,30028,32240,102213,19786,20828,30200,32284,103098
70,Syria Cross border,2019,TUR-19/3559/SA1/ER-CCM/INGO/12798,7/15/2020 10:10:18 AM,Host Communities,3874,4220,3937,4031,16062,2526,2751,2566,2628,10471
70,Syria Cross border,2019,TUR-19/3559/SA1/ER-CCM/INGO/12798,7/15/2020 10:10:18 AM,Internally Displaced People,50803,55346,51629,52868,210646,32261,46825,77495,64043,220624
70,Syria Cross border,2019,TUR-19/3559/SA1/ER-CCM/INGO/12798,7/15/2020 10:10:18 AM,Overall,54677,59566,55566,56899,226708,34787,49576,80061,66671,231095
70,Syria Cross border,2019,TUR-19/3559/SA1/FS/INGO/12730,8/31/2020 6:55:33 AM,Host Communities,246,394,715,821,2176,306,597,803,841,2547
70,Syria Cross border,2019,TUR-19/3559/SA1/FS/INGO/12730,8/31/2020 6:55:33 AM,Internally Displaced People,277,466,845,930,2518,143,559,708,839,2249
70,Syria Cross border,2019,TUR-19/3559/SA1/FS/INGO/12730,8/31/2020 6:55:33 AM,Other,53,25,47,19,144,114,117,159,170,560
70,Syria Cross border,2019,TUR-19/3559/SA1/FS/INGO/12730,8/31/2020 6:55:33 AM,Overall,576,885,1607,1770,4838,563,1273,1670,1850,5356
70,Syria Cross border,2019,TUR-19/3559/SA1/FS/INGO/12732,8/17/2020 9:42:13 AM,Internally Displaced People,5328,5550,5550,5772,22200,9267,10221,11656,11776,42920
70,Syria Cross border,2019,TUR-19/3559/SA1/FS/INGO/12732,8/17/2020 9:42:13 AM,Overall,5328,5550,5550,5772,22200,9267,10221,11656,11776,42920
70,Syria Cross border,2019,TUR-19/3559/SA1/FS/INGO/12940,12/28/2020 1:16:36 PM,Host Communities,3420,3559,5130,5339,17448,3420,3559,5130,5339,17448
70,Syria Cross border,2019,TUR-19/3559/SA1/FS/INGO/12940,12/28/2020 1:16:36 PM,Internally Displaced People,1183,1231,1774,1847,6035,1183,1231,1774,1847,6035
70,Syria Cross border,2019,TUR-19/3559/SA1/FS/INGO/12940,12/28/2020 1:16:36 PM,Other,129,134,193,201,657,129,134,193,201,657
70,Syria Cross border,2019,TUR-19/3559/SA1/FS/INGO/12940,12/28/2020 1:16:36 PM,Overall,4732,4924,7097,7387,24140,4732,4924,7097,7387,24140
70,Syria Cross border,2019,TUR-19/3559/SA1/FS/NGO/12621,8/10/2020 11:22:18 AM,Host Communities,1517,1895,2047,2122,7581,1987,2272,1875,2034,8168
70,Syria Cross border,2019,TUR-19/3559/SA1/FS/NGO/12621,8/10/2020 11:22:18 AM,Internally Displaced People,302,376,405,420,1503,805,828,661,621,2915
70,Syria Cross border,2019,TUR-19/3559/SA1/FS/NGO/12621,8/10/2020 11:22:18 AM,Overall,1819,2271,2452,2542,9084,2792,3100,2536,2655,11083
70,Syria Cross border,2019,TUR-19/3559/SA1/FS/NGO/12681,4/9/2020 9:35:51 AM,Host Communities,355,235,0,0,590,400,203,0,0,603
70,Syria Cross border,2019,TUR-19/3559/SA1/FS/NGO/12681,4/9/2020 9:35:51 AM,Overall,360,240,0,0,600,400,203,0,0,603
70,Syria Cross border,2019,TUR-19/3559/SA1/FS/NGO/12681,4/9/2020 9:35:51 AM,Returnees,5,5,0,0,10,0,0,0,0,0
70,Syria Cross border,2019,TUR-19/3559/SA1/FS/NGO/12790,9/14/2020 6:30:46 AM,Host Communities,300,130,0,0,430,348,134,0,0,482
70,Syria Cross border,2019,TUR-19/3559/SA1/FS/NGO/12790,9/14/2020 6:30:46 AM,Internally Displaced People,60,20,0,0,80,22,6,0,0,28
70,Syria Cross border,2019,TUR-19/3559/SA1/FS/NGO/12790,9/14/2020 6:30:46 AM,Overall,360,150,0,0,510,370,140,0,0,510
70,Syria Cross border,2019,TUR-19/3559/SA1/FS/NGO/12843,10/24/2020 7:52:57 AM,Host Communities,873,1021,1136,1148,4178,1117,1189,1585,1546,5437
70,Syria Cross border,2019,TUR-19/3559/SA1/FS/NGO/12843,10/24/2020 7:52:57 AM,Internally Displaced People,28,30,40,35,133,27,26,35,34,122
70,Syria Cross border,2019,TUR-19/3559/SA1/FS/NGO/12843,10/24/2020 7:52:57 AM,Overall,901,1051,1176,1183,4311,1144,1215,1620,1580,5559
70,Syria Cross border,2019,TUR-19/3559/SA1/FS/NGO/12886,8/11/2020 8:12:15 AM,Host Communities,7185,6994,6374,6016,26569,2504,2893,4223,3554,13174
70,Syria Cross border,2019,TUR-19/3559/SA1/FS/NGO/12886,8/11/2020 8:12:15 AM,Internally Displaced People,1595,1639,1874,1770,6878,1352,1495,2692,2252,7791
70,Syria Cross border,2019,TUR-19/3559/SA1/FS/NGO/12886,8/11/2020 8:12:15 AM,Overall,8780,8633,8248,7786,33447,3856,4388,6915,5806,20965
70,Syria Cross border,2019,TUR-19/3559/SA1/FS/NGO/12921,4/27/2020 8:33:45 AM,Host Communities,1765,1525,715,717,4722,1787,1552,747,748,4834
70,Syria Cross border,2019,TUR-19/3559/SA1/FS/NGO/12921,4/27/2020 8:33:45 AM,Internally Displaced People,1480,1540,1765,1950,6735,1594,1766,2243,2393,7996
70,Syria Cross border,2019,TUR-19/3559/SA1/FS/NGO/12921,4/27/2020 8:33:45 AM,Overall,3245,3065,2480,2667,11457,3381,3318,2990,3141,12830
70,Syria Cross border,2019,TUR-19/3559/SA1/FS/NGO/13011,7/7/2020 2:22:19 PM,Host Communities,559,651,862,953,3025,1354,1362,1817,1691,6224
70,Syria Cross border,2019,TUR-19/3559/SA1/FS/NGO/13011,7/7/2020 2:22:19 PM,Internally Displaced People,407,473,627,693,2200,432,374,528,484,1818
70,Syria Cross border,2019,TUR-19/3559/SA1/FS/NGO/13011,7/7/2020 2:22:19 PM,Overall,1017,1183,1567,1733,5500,1786,1736,2345,2176,8043
70,Syria Cross border,2019,TUR-19/3559/SA1/FS/NGO/13011,7/7/2020 2:22:19 PM,Returnees,51,59,78,87,275,0,0,0,1,1
70,Syria Cross border,2019,TUR-19/3559/SA1/FS/O/12923,1/4/2021 8:45:59 AM,Host Communities,1217,1395,1607,1819,6038,2044,1531,1465,1493,6533
70,Syria Cross border,2019,TUR-19/3559/SA1/FS/O/12923,1/4/2021 8:45:59 AM,Internally Displaced People,205,227,259,260,951,19,22,24,26,91
70,Syria Cross border,2019,TUR-19/3559/SA1/FS/O/12923,1/4/2021 8:45:59 AM,Overall,1422,1622,1866,2079,6989,2063,1553,1489,1519,6624
70,Syria Cross border,2019,TUR-19/3559/SA1/FS/UN/12747,1/4/2021 12:09:38 PM,Host Communities,4488,5304,5100,5508,20400,5482,5855,5758,5696,22791
70,Syria Cross border,2019,TUR-19/3559/SA1/FS/UN/12747,1/4/2021 12:09:38 PM,Internally Displaced People,792,936,900,972,3600,2892,3025,2871,2781,11569
70,Syria Cross border,2019,TUR-19/3559/SA1/FS/UN/12747,1/4/2021 12:09:38 PM,Overall,5280,6240,6000,6480,24000,8374,8880,8629,8477,34360
70,Syria Cross border,2019,TUR-19/3559/SA1/FS-WASH/INGO/12813,1/6/2020 1:34:55 PM,Internally Displaced People,2114,2114,3171,3171,10570,2256,3011,5179,3876,14322
70,Syria Cross border,2019,TUR-19/3559/SA1/FS-WASH/INGO/12813,1/6/2020 1:34:55 PM,Overall,2114,2114,3171,3171,10570,2256,3011,5179,3876,14322
70,Syria Cross border,2019,TUR-19/3559/SA1/H/INGO/12882,8/20/2020 6:50:12 AM,Host Communities,3161,5000,3195,3119,14475,1521,4841,2516,2742,11620
70,Syria Cross border,2019,TUR-19/3559/SA1/H/INGO/12882,8/20/2020 6:50:12 AM,Internally Displaced People,1227,1231,1236,1208,4902,4034,7512,6676,6872,25094
70,Syria Cross border,2019,TUR-19/3559/SA1/H/INGO/12882,8/20/2020 6:50:12 AM,Overall,4388,6231,4431,4327,19377,5555,12353,9192,9614,36714
70,Syria Cross border,2019,TUR-19/3559/SA1/H/INGO/13010,4/6/2020 8:36:39 AM,Host Communities,11229,11606,8348,6038,37221,12921,11201,10795,7858,42775
70,Syria Cross border,2019,TUR-19/3559/SA1/H/INGO/13010,4/6/2020 8:36:39 AM,Internally Displaced People,13707,14167,10185,7362,45421,16637,19746,15779,13126,65288
70,Syria Cross border,2019,TUR-19/3559/SA1/H/INGO/13010,4/6/2020 8:36:39 AM,Overall,24936,25773,18533,13400,82642,29558,30947,26574,20984,108063
70,Syria Cross border,2019,TUR-19/3559/SA1/H/NGO/12616,8/12/2020 7:24:59 AM,Internally Displaced People,6587,9880,10292,14408,41167,2409,3619,3767,5275,15070
70,Syria Cross border,2019,TUR-19/3559/SA1/H/NGO/12616,8/12/2020 7:24:59 AM,Overall,6587,9880,10292,14408,41167,2409,3619,3767,5275,15070
70,Syria Cross border,2019,TUR-19/3559/SA1/H/NGO/12628,2/10/2021 1:47:46 PM,Host Communities,1472,1589,276,288,3625,1538,1415,244,175,3372
70,Syria Cross border,2019,TUR-19/3559/SA1/H/NGO/12628,2/10/2021 1:47:46 PM,Internally Displaced People,678,684,116,121,1599,671,537,85,94,1387
70,Syria Cross border,2019,TUR-19/3559/SA1/H/NGO/12628,2/10/2021 1:47:46 PM,Overall,2150,2273,392,409,5224,2209,1952,329,269,4759
70,Syria Cross border,2019,TUR-19/3559/SA1/H/NGO/12640,10/5/2020 9:05:51 AM,Host Communities,10150,9900,6550,3850,30450,11141,11017,6579,3722,32459
70,Syria Cross border,2019,TUR-19/3559/SA1/H/NGO/12640,10/5/2020 9:05:51 AM,Internally Displaced People,4150,3077,2163,1650,11040,4904,4451,2241,1512,13108
70,Syria Cross border,2019,TUR-19/3559/SA1/H/NGO/12640,10/5/2020 9:05:51 AM,Overall,14300,12977,8713,5500,41490,16045,15468,8820,5234,45567
70,Syria Cross border,2019,TUR-19/3559/SA1/H/NGO/12745,3/18/2020 1:11:14 PM,Host Communities,6309,4461,2428,1988,15186,2873,1712,868,503,5956
70,Syria Cross border,2019,TUR-19/3559/SA1/H/NGO/12745,3/18/2020 1:11:14 PM,Internally Displaced People,4233,2997,1904,1492,10626,1643,1151,508,298,3600
70,Syria Cross border,2019,TUR-19/3559/SA1/H/NGO/12745,3/18/2020 1:11:14 PM,Overall,10542,7458,4332,3480,25812,4516,2863,1376,801,9556
70,Syria Cross border,2019,TUR-19/3559/SA1/H/NGO/12820,10/8/2020 11:37:26 AM,Host Communities,1584,6126,4157,4349,16216,2557,8419,2992,3003,16971
70,Syria Cross border,2019,TUR-19/3559/SA1/H/NGO/12820,10/8/2020 11:37:26 AM,Internally Displaced People,1465,5376,5143,5105,17089,2153,6401,2396,2462,13412
70,Syria Cross border,2019,TUR-19/3559/SA1/H/NGO/12820,10/8/2020 11:37:26 AM,Overall,3049,11502,9300,9454,33305,4710,14820,5388,5465,30383
70,Syria Cross border,2019,TUR-19/3559/SA1/H/NGO/12860,8/11/2020 12:32:21 PM,Host Communities,2074,1937,2651,2501,9163,484,544,358,350,1736
70,Syria Cross border,2019,TUR-19/3559/SA1/H/NGO/12860,8/11/2020 12:32:21 PM,Internally Displaced People,4359,4227,5972,5839,20397,7369,17442,8258,10222,43291
70,Syria Cross border,2019,TUR-19/3559/SA1/H/NGO/12860,8/11/2020 12:32:21 PM,Overall,6433,6164,8623,8340,29560,7853,17986,8616,10572,45027
70,Syria Cross border,2019,TUR-19/3559/SA1/H/NGO/12881,4/9/2020 10:12:21 AM,Host Communities,3300,5360,5320,5500,19480,5312,17320,7550,8032,38214
70,Syria Cross border,2019,TUR-19/3559/SA1/H/NGO/12881,4/9/2020 10:12:21 AM,Internally Displaced People,1310,1200,3700,1200,7410,2886,7847,3408,3520,17661
70,Syria Cross border,2019,TUR-19/3559/SA1/H/NGO/12881,4/9/2020 10:12:21 AM,Overall,4670,6620,9040,6730,27060,8278,25488,11027,11625,56418
70,Syria Cross border,2019,TUR-19/3559/SA1/H/NGO/12881,4/9/2020 10:12:21 AM,Returnees,60,60,20,30,170,80,321,69,73,543
70,Syria Cross border,2019,TUR-19/3559/SA1/H/NGO/12889,6/23/2020 9:51:33 AM,Host Communities,19846,49265,14949,15719,99779,20686,58295,20779,21435,121195
70,Syria Cross border,2019,TUR-19/3559/SA1/H/NGO/12889,6/23/2020 9:51:33 AM,Internally Displaced People,26195,56214,19589,18781,120779,29757,74647,29619,29387,163410
70,Syria Cross border,2019,TUR-19/3559/SA1/H/NGO/12889,6/23/2020 9:51:33 AM,Overall,46041,105479,34538,34500,220558,50443,132942,50398,50822,284605
70,Syria Cross border,2019,TUR-19/3559/SA1/H/NGO/12891,9/25/2023 11:18:26 AM,Host Communities,3111,11922,4001,4141,23175,4710,13319,4828,4177,27034
70,Syria Cross border,2019,TUR-19/3559/SA1/H/NGO/12891,9/25/2023 11:18:26 AM,Internally Displaced People,2026,7756,2603,2697,15082,7080,13479,4412,3870,28841
70,Syria Cross border,2019,TUR-19/3559/SA1/H/NGO/12891,9/25/2023 11:18:26 AM,Overall,5137,19678,6604,6838,38257,11790,26798,9240,8047,55875
70,Syria Cross border,2019,TUR-19/3559/SA1/H/NGO/12973,7/21/2020 12:20:57 PM,Host Communities,12566,13814,9934,5838,42152,13218,14275,10579,6223,44295
70,Syria Cross border,2019,TUR-19/3559/SA1/H/NGO/12973,7/21/2020 12:20:57 PM,Internally Displaced People,6552,9795,2687,2119,21153,6831,10054,2839,2130,21854
70,Syria Cross border,2019,TUR-19/3559/SA1/H/NGO/12973,7/21/2020 12:20:57 PM,Overall,19118,23609,12621,7957,63305,20049,24329,13418,8353,66149
70,Syria Cross border,2019,TUR-19/3559/SA1/H/UN/13018,12/14/2020 8:44:43 AM,Host Communities,4889,5089,4082,4248,18308,10053,10467,8396,8734,37650
70,Syria Cross border,2019,TUR-19/3559/SA1/H/UN/13018,12/14/2020 8:44:43 AM,Internally Displaced People,4131,4299,3448,3589,15467,8495,8845,7094,7381,31815
70,Syria Cross border,2019,TUR-19/3559/SA1/H/UN/13018,12/14/2020 8:44:43 AM,Overall,9020,9388,7530,7837,33775,18548,19312,15490,16115,69465
70,Syria Cross border,2019,TUR-19/3559/SA1/H-N/NGO/12800,8/12/2020 7:13:36 PM,Host Communities,1442,11459,2982,2904,18787,4867,39587,10068,9809,64331
70,Syria Cross border,2019,TUR-19/3559/SA1/H-N/NGO/12800,8/12/2020 7:13:36 PM,Internally Displaced People,3365,26738,6958,6776,43837,7403,58791,15320,14943,96457
70,Syria Cross border,2019,TUR-19/3559/SA1/H-N/NGO/12800,8/12/2020 7:13:36 PM,Overall,4807,38197,9940,9680,62624,12270,98378,25388,24752,160788
70,Syria Cross border,2019,TUR-19/3559/SA1/N/INGO/12615,6/8/2020 10:52:27 AM,Host Communities,0,2123,2831,2641,7595,0,2772,3342,3096,9210
70,Syria Cross border,2019,TUR-19/3559/SA1/N/INGO/12615,6/8/2020 10:52:27 AM,Internally Displaced People,0,1608,1969,1883,5460,0,2237,2506,2384,7127
70,Syria Cross border,2019,TUR-19/3559/SA1/N/INGO/12615,6/8/2020 10:52:27 AM,Overall,0,4751,6004,5730,16485,0,6203,7254,6821,20278
70,Syria Cross border,2019,TUR-19/3559/SA1/N/INGO/12615,6/8/2020 10:52:27 AM,Returnees,0,1020,1204,1206,3430,0,1194,1406,1341,3941
70,Syria Cross border,2019,TUR-19/3559/SA1/N/NGO/12660,3/10/2020 7:53:39 AM,Host Communities,126,3251,1506,1666,6549,214,3525,1492,1584,6815
70,Syria Cross border,2019,TUR-19/3559/SA1/N/NGO/12660,3/10/2020 7:53:39 AM,Internally Displaced People,101,3862,1829,2009,7801,116,5239,1923,1998,9276
70,Syria Cross border,2019,TUR-19/3559/SA1/N/NGO/12660,3/10/2020 7:53:39 AM,Overall,227,7113,3335,3675,14350,330,8764,3415,3582,16091
70,Syria Cross border,2019,TUR-19/3559/SA1/N/NGO/12954,3/10/2020 7:57:36 AM,Host Communities,99,3342,4325,4126,11892,60,3922,2800,3019,9801
70,Syria Cross border,2019,TUR-19/3559/SA1/N/NGO/12954,3/10/2020 7:57:36 AM,Internally Displaced People,87,2091,2704,2748,7630,289,7027,4337,4379,16032
70,Syria Cross border,2019,TUR-19/3559/SA1/N/NGO/12954,3/10/2020 7:57:36 AM,Overall,186,5433,7029,6874,19522,349,10949,7137,7398,25833
70,Syria Cross border,2019,TUR-19/3559/SA1/N/NGO/12967,1/18/2021 6:35:29 AM,Host Communities,4,8639,10996,10568,30207,1,12303,7197,7824,27325
70,Syria Cross border,2019,TUR-19/3559/SA1/N/NGO/12967,1/18/2021 6:35:29 AM,Internally Displaced People,2,5758,7330,7044,20134,1,4374,2997,2772,10144
70,Syria Cross border,2019,TUR-19/3559/SA1/N/NGO/12967,1/18/2021 6:35:29 AM,Overall,6,14397,18326,17612,50341,2,16677,10194,10596,37469
70,Syria Cross border,2019,TUR-19/3559/SA1/NFI/NGO/12970,5/5/2020 7:54:49 AM,Host Communities,515,540,660,685,2400,752,861,1180,1080,3873
70,Syria Cross border,2019,TUR-19/3559/SA1/NFI/NGO/12970,5/5/2020 7:54:49 AM,Internally Displaced People,576,594,714,748,2632,514,611,806,669,2600
70,Syria Cross border,2019,TUR-19/3559/SA1/NFI/NGO/12970,5/5/2020 7:54:49 AM,Overall,1091,1134,1374,1433,5032,1266,1472,1986,1749,6473
70,Syria Cross border,2019,TUR-19/3559/SA1/NFI/NGO/13005,5/13/2020 8:19:31 AM,Host Communities,141,167,158,170,636,388,410,343,278,1419
70,Syria Cross border,2019,TUR-19/3559/SA1/NFI/NGO/13005,5/13/2020 8:19:31 AM,Internally Displaced People,307,361,341,369,1378,83,88,102,78,351
70,Syria Cross border,2019,TUR-19/3559/SA1/NFI/NGO/13005,5/13/2020 8:19:31 AM,Overall,472,556,525,567,2120,514,544,501,395,1954
70,Syria Cross border,2019,TUR-19/3559/SA1/NFI/NGO/13005,5/13/2020 8:19:31 AM,Returnees,24,28,26,28,106,43,46,56,39,184
70,Syria Cross border,2019,TUR-19/3559/SA1/NFI/O/12885,2/4/2021 9:31:43 AM,Host Communities,224,252,362,362,1200,330,377,506,483,1696
70,Syria Cross border,2019,TUR-19/3559/SA1/NFI/O/12885,2/4/2021 9:31:43 AM,Internally Displaced People,338,378,542,542,1800,395,456,564,563,1978
70,Syria Cross border,2019,TUR-19/3559/SA1/NFI/O/12885,2/4/2021 9:31:43 AM,Overall,562,630,904,904,3000,725,833,1070,1046,3674
70,Syria Cross border,2019,TUR-19/3559/SA1/NFI-CCS/UN/12981,3/26/2021 9:45:14 AM,Internally Displaced People,9459,10571,12539,12431,45000,7891,8970,12042,11020,39923
70,Syria Cross border,2019,TUR-19/3559/SA1/NFI-CCS/UN/12981,3/26/2021 9:45:14 AM,Other,290,330,0,0,620,335,173,0,0,508
70,Syria Cross border,2019,TUR-19/3559/SA1/NFI-CCS/UN/12981,3/26/2021 9:45:14 AM,Overall,9749,10901,12539,12431,45620,8226,9143,12042,11020,40431
70,Syria Cross border,2019,TUR-19/3559/SA1/P/INGO/12863,11/26/2020 1:49:21 PM,Host Communities,589,390,16,3,998,594,327,25,7,953
70,Syria Cross border,2019,TUR-19/3559/SA1/P/INGO/12863,11/26/2020 1:49:21 PM,Internally Displaced People,252,273,6,10,541,423,344,19,21,807
70,Syria Cross border,2019,TUR-19/3559/SA1/P/INGO/12863,11/26/2020 1:49:21 PM,Overall,841,663,22,13,1539,1017,671,44,28,1760
70,Syria Cross border,2019,TUR-19/3559/SA1/P/INGO/12927,10/8/2020 1:14:14 PM,Host Communities,1000,1000,1000,1000,4000,729,756,1022,914,3421
70,Syria Cross border,2019,TUR-19/3559/SA1/P/INGO/12927,10/8/2020 1:14:14 PM,Internally Displaced People,1000,1500,3000,2500,8000,1038,2105,3415,3165,9723
70,Syria Cross border,2019,TUR-19/3559/SA1/P/INGO/12927,10/8/2020 1:14:14 PM,Overall,2000,2500,4000,3500,12000,1767,2861,4437,4079,13144
70,Syria Cross border,2019,TUR-19/3559/SA1/P/INGO/13014,11/15/2020 12:33:57 PM,Host Communities,1692,2276,793,800,5561,1613,2736,889,1469,6707
70,Syria Cross border,2019,TUR-19/3559/SA1/P/INGO/13014,11/15/2020 12:33:57 PM,Internally Displaced People,1883,1676,551,502,4612,3089,3610,1239,1027,8965
70,Syria Cross border,2019,TUR-19/3559/SA1/P/INGO/13014,11/15/2020 12:33:57 PM,Overall,3575,3952,1344,1302,10173,4702,6346,2128,2496,15672
70,Syria Cross border,2019,TUR-19/3559/SA1/P/NGO/12612,10/12/2020 1:21:13 PM,Host Communities,1115,4465,1115,4462,11157,1499,5502,3889,5961,16851
70,Syria Cross border,2019,TUR-19/3559/SA1/P/NGO/12612,10/12/2020 1:21:13 PM,Internally Displaced People,3350,13375,3350,13400,33475,5968,20224,10835,16802,53829
70,Syria Cross border,2019,TUR-19/3559/SA1/P/NGO/12612,10/12/2020 1:21:13 PM,Overall,4465,17840,4465,17862,44632,7467,25726,14724,22763,70680
70,Syria Cross border,2019,TUR-19/3559/SA1/P/NGO/12670,4/26/2022 2:35:51 PM,Host Communities,4240,3595,120,80,8035,2944,1356,102,63,4465
70,Syria Cross border,2019,TUR-19/3559/SA1/P/NGO/12670,4/26/2022 2:35:51 PM,Internally Displaced People,3035,2675,175,100,5985,4286,4375,162,162,8985
70,Syria Cross border,2019,TUR-19/3559/SA1/P/NGO/12670,4/26/2022 2:35:51 PM,Overall,7637,6463,310,190,14600,7243,5766,269,232,13510
70,Syria Cross border,2019,TUR-19/3559/SA1/P/NGO/12670,4/26/2022 2:35:51 PM,Returnees,362,193,15,10,580,13,35,5,7,60
70,Syria Cross border,2019,TUR-19/3559/SA1/P/NGO/12822,10/6/2020 8:55:33 AM,Host Communities,464,2900,418,2446,6228,391,3985,217,2217,6810
70,Syria Cross border,2019,TUR-19/3559/SA1/P/NGO/12822,10/6/2020 8:55:33 AM,Internally Displaced People,555,1348,565,1468,3936,364,1054,175,655,2248
70,Syria Cross border,2019,TUR-19/3559/SA1/P/NGO/12822,10/6/2020 8:55:33 AM,Overall,1019,4248,983,3914,10164,755,5039,392,2872,9058
70,Syria Cross border,2019,TUR-19/3559/SA1/P/NGO/12850,11/12/2020 6:24:56 AM,Host Communities,92,243,875,875,2085,66,121,381,294,862
70,Syria Cross border,2019,TUR-19/3559/SA1/P/NGO/12850,11/12/2020 6:24:56 AM,Internally Displaced People,92,243,875,875,2085,203,351,1706,1416,3676
70,Syria Cross border,2019,TUR-19/3559/SA1/P/NGO/12850,11/12/2020 6:24:56 AM,Overall,184,486,1750,1750,4170,269,472,2087,1710,4538
70,Syria Cross border,2019,TUR-19/3559/SA1/P/NGO/12925,10/8/2020 7:35:17 AM,Host Communities,243,3323,739,1377,5682,111,4329,584,1399,6423
70,Syria Cross border,2019,TUR-19/3559/SA1/P/NGO/12925,10/8/2020 7:35:17 AM,Internally Displaced People,162,2214,492,740,3608,296,2703,724,1078,4801
70,Syria Cross border,2019,TUR-19/3559/SA1/P/NGO/12925,10/8/2020 7:35:17 AM,Overall,405,5537,1231,2117,9290,407,7032,1308,2477,11224
70,Syria Cross border,2019,TUR-19/3559/SA1/P/NGO/12976,9/25/2023 2:26:43 PM,Host Communities,0,922,0,614,1536,0,420,0,302,722
70,Syria Cross border,2019,TUR-19/3559/SA1/P/NGO/12976,9/25/2023 2:26:43 PM,Internally Displaced People,0,922,0,614,1536,0,616,0,298,914
70,Syria Cross border,2019,TUR-19/3559/SA1/P/NGO/12976,9/25/2023 2:26:43 PM,Overall,0,1844,0,1228,3072,0,1036,0,600,1636
70,Syria Cross border,2019,TUR-19/3559/SA1/WASH/INGO/12709,1/20/2021 6:41:57 PM,Host Communities,403369,472207,320753,251918,1448247,301977,323908,383364,349678,1358927
70,Syria Cross border,2019,TUR-19/3559/SA1/WASH/INGO/12709,1/20/2021 6:41:57 PM,Overall,403369,472207,320753,251918,1448247,301977,323908,383364,349678,1358927
70,Syria Cross border,2019,TUR-19/3559/SA1/WASH/INGO/12851,5/6/2020 11:09:21 AM,Host Communities,17050,17746,23524,22601,80921,15754,23909,27154,26006,92823
70,Syria Cross border,2019,TUR-19/3559/SA1/WASH/INGO/12851,5/6/2020 11:09:21 AM,Internally Displaced People,16017,16671,22099,21232,76019,10515,15549,17583,16899,60546
70,Syria Cross border,2019,TUR-19/3559/SA1/WASH/INGO/12851,5/6/2020 11:09:21 AM,Overall,33067,34417,45623,43833,156940,26269,39458,44737,42905,153369
70,Syria Cross border,2019,TUR-19/3559/SA1/WASH/INGO/12877,5/6/2020 3:08:55 PM,Internally Displaced People,8252,8911,12265,12244,41672,8953,9654,13445,13353,45405
70,Syria Cross border,2019,TUR-19/3559/SA1/WASH/INGO/12877,5/6/2020 3:08:55 PM,Overall,8252,8911,12265,12244,41672,8953,9654,13445,13353,45405
70,Syria Cross border,2019,TUR-19/3559/SA1/WASH/INGO/12924,3/18/2020 2:25:01 PM,Internally Displaced People,1437,1574,1917,1917,6845,1443,2254,2202,2561,8460
70,Syria Cross border,2019,TUR-19/3559/SA1/WASH/INGO/12924,3/18/2020 2:25:01 PM,Overall,1437,1574,1917,1917,6845,1443,2254,2202,2561,8460
70,Syria Cross border,2019,TUR-19/3559/SA1/WASH/NGO/12607,1/17/2020 7:23:33 PM,Host Communities,2584,2764,4378,4429,14155,2584,2764,4378,4429,14155
70,Syria Cross border,2019,TUR-19/3559/SA1/WASH/NGO/12607,1/17/2020 7:23:33 PM,Internally Displaced People,3011,3226,4900,5126,16263,3441,3688,5766,6041,18936
70,Syria Cross border,2019,TUR-19/3559/SA1/WASH/NGO/12607,1/17/2020 7:23:33 PM,Overall,5698,6099,9467,9773,31037,6128,6561,10333,10688,33710
70,Syria Cross border,2019,TUR-19/3559/SA1/WASH/NGO/12607,1/17/2020 7:23:33 PM,Returnees,103,109,189,218,619,103,109,189,218,619
70,Syria Cross border,2019,TUR-19/3559/SA1/WASH/NGO/12687,2/24/2020 2:16:08 PM,Internally Displaced People,4375,5311,6698,6794,23178,7215,10823,11408,10431,39877
70,Syria Cross border,2019,TUR-19/3559/SA1/WASH/NGO/12687,2/24/2020 2:16:08 PM,Overall,4375,5311,6698,6794,23178,7215,10823,11408,10431,39877
70,Syria Cross border,2019,TUR-19/3559/SA1/WASH/NGO/12797,10/16/2020 10:38:10 AM,Internally Displaced People,3575,4060,4473,4507,16615,3771,4169,5229,5037,18206
70,Syria Cross border,2019,TUR-19/3559/SA1/WASH/NGO/12797,10/16/2020 10:38:10 AM,Overall,3575,4060,4473,4507,16615,3771,4169,5229,5037,18206
70,Syria Cross border,2019,TUR-19/3559/SA1/WASH/NGO/12805,4/15/2020 2:41:12 PM,Host Communities,18206,19033,22341,23169,82749,20197,21113,24785,25705,91800
70,Syria Cross border,2019,TUR-19/3559/SA1/WASH/NGO/12805,4/15/2020 2:41:12 PM,Internally Displaced People,3609,3775,4429,4595,16408,5504,5773,6777,7028,25082
70,Syria Cross border,2019,TUR-19/3559/SA1/WASH/NGO/12805,4/15/2020 2:41:12 PM,Overall,21815,22808,26770,27764,99157,25701,26886,31562,32733,116882
70,Syria Cross border,2019,TUR-19/3559/SA1/WASH/NGO/12869,4/15/2020 12:35:26 PM,Host Communities,1375,1985,1060,1330,5750,1426,2028,1098,1397,5949
70,Syria Cross border,2019,TUR-19/3559/SA1/WASH/NGO/12869,4/15/2020 12:35:26 PM,Internally Displaced People,675,865,480,620,2640,788,884,718,948,3338
70,Syria Cross border,2019,TUR-19/3559/SA1/WASH/NGO/12869,4/15/2020 12:35:26 PM,Overall,2050,2850,1540,1950,8390,2214,2912,1816,2345,9287
70,Syria Cross border,2019,TUR-19/3559/SA1/WASH/NGO/12969,4/16/2020 8:39:01 PM,Internally Displaced People,7008,8676,9389,9856,34929,7765,9361,10527,10756,38409
70,Syria Cross border,2019,TUR-19/3559/SA1/WASH/NGO/12969,4/16/2020 8:39:01 PM,Overall,7008,8676,9389,9856,34929,7765,9361,10527,10756,38409
70,Syria Cross border,2019,TUR-19/3559/SA1/WASH-CCM/INGO/12841,12/9/2020 6:29:12 AM,Internally Displaced People,23238,22131,33198,32091,110658,23238,22131,33198,32091,110658
70,Syria Cross border,2019,TUR-19/3559/SA1/WASH-CCM/INGO/12841,12/9/2020 6:29:12 AM,Overall,23238,22131,33198,32091,110658,23238,22131,33198,32091,110658
70,Syria Cross border,2019,TUR-19/3559/SA2/CCM/NGO/14480,9/25/2020 1:28:33 PM,Internally Displaced People,2645,3262,3585,3187,12679,7039,8820,5359,5732,26950
70,Syria Cross border,2019,TUR-19/3559/SA2/CCM/NGO/14480,9/25/2020 1:28:33 PM,Overall,2645,3262,3585,3187,12679,7039,8820,5359,5732,26950
70,Syria Cross border,2019,TUR-19/3559/SA2/E/NGO/14406,2/3/2021 11:51:46 AM,Host Communities,89,49,1341,1143,2622,90,45,1238,1074,2447
70,Syria Cross border,2019,TUR-19/3559/SA2/E/NGO/14406,2/3/2021 11:51:46 AM,Internally Displaced People,48,23,734,573,1378,51,25,1038,748,1862
70,Syria Cross border,2019,TUR-19/3559/SA2/E/NGO/14406,2/3/2021 11:51:46 AM,Overall,137,72,2075,1716,4000,141,70,2276,1822,4309
70,Syria Cross border,2019,TUR-19/3559/SA2/E/NGO/14429,2/17/2021 2:39:35 PM,Host Communities,95,107,3824,3690,7716,156,160,3484,3978,7778
70,Syria Cross border,2019,TUR-19/3559/SA2/E/NGO/14429,2/17/2021 2:39:35 PM,Internally Displaced People,39,65,2513,2750,5367,61,95,2701,3432,6289
70,Syria Cross border,2019,TUR-19/3559/SA2/E/NGO/14429,2/17/2021 2:39:35 PM,Overall,134,172,6337,6440,13083,217,255,6185,7410,14067
70,Syria Cross border,2019,TUR-19/3559/SA2/E/NGO/14458,1/13/2021 10:09:41 AM,Internally Displaced People,215,135,4631,4680,9661,234,116,4505,4908,9763
70,Syria Cross border,2019,TUR-19/3559/SA2/E/NGO/14458,1/13/2021 10:09:41 AM,Overall,215,135,4631,4680,9661,234,116,4505,4908,9763
70,Syria Cross border,2019,TUR-19/3559/SA2/E/NGO/14463,7/30/2021 10:26:13 AM,Host Communities,80,47,1736,1736,3599,66,51,1595,1975,3687
70,Syria Cross border,2019,TUR-19/3559/SA2/E/NGO/14463,7/30/2021 10:26:13 AM,Internally Displaced People,44,23,739,739,1545,51,31,1425,1962,3469
70,Syria Cross border,2019,TUR-19/3559/SA2/E/NGO/14463,7/30/2021 10:26:13 AM,Overall,124,70,2475,2475,5144,117,82,3020,3937,7156
70,Syria Cross border,2019,TUR-19/3559/SA2/E-P/NGO/14455,6/7/2021 9:39:04 AM,Host Communities,2816,3590,5684,6610,18700,16902,17945,13684,14891,63422
70,Syria Cross border,2019,TUR-19/3559/SA2/E-P/NGO/14455,6/7/2021 9:39:04 AM,Internally Displaced People,1849,2638,4892,5174,14553,19656,12415,9371,10173,51615
70,Syria Cross border,2019,TUR-19/3559/SA2/E-P/NGO/14455,6/7/2021 9:39:04 AM,Overall,4665,6228,10576,11784,33253,36558,30360,23055,25064,115037
70,Syria Cross border,2019,TUR-19/3559/SA2/E-P/NGO/14490,8/19/2021 7:11:28 AM,Internally Displaced People,4295,4991,6532,6272,22090,3957,5343,6268,7481,23049
70,Syria Cross border,2019,TUR-19/3559/SA2/E-P/NGO/14490,8/19/2021 7:11:28 AM,Overall,4295,4991,6532,6272,22090,3957,5343,6268,7481,23049
70,Syria Cross border,2019,TUR-19/3559/SA2/E-P-WASH/NGO/14414,5/22/2021 4:34:34 PM,Host Communities,73,49,1239,580,1941,62,29,2103,1518,3712
70,Syria Cross border,2019,TUR-19/3559/SA2/E-P-WASH/NGO/14414,5/22/2021 4:34:34 PM,Internally Displaced People,32,21,961,767,1781,85,49,1505,1254,2893
70,Syria Cross border,2019,TUR-19/3559/SA2/E-P-WASH/NGO/14414,5/22/2021 4:34:34 PM,Overall,105,70,2200,1347,3722,147,78,3608,2772,6605
70,Syria Cross border,2019,TUR-19/3559/SA2/ER/INGO/14503,8/18/2021 12:41:54 PM,Host Communities,480,80,0,0,560,243,104,0,0,347
70,Syria Cross border,2019,TUR-19/3559/SA2/ER/INGO/14503,8/18/2021 12:41:54 PM,Internally Displaced People,720,120,0,0,840,195,108,0,0,303
70,Syria Cross border,2019,TUR-19/3559/SA2/ER/INGO/14503,8/18/2021 12:41:54 PM,Overall,1200,200,0,0,1400,438,212,0,0,650
70,Syria Cross border,2019,TUR-19/3559/SA2/ER-FS/NGO/14415,1/4/2021 8:42:54 AM,Host Communities,332,324,396,304,1356,664,772,733,711,2880
70,Syria Cross border,2019,TUR-19/3559/SA2/ER-FS/NGO/14415,1/4/2021 8:42:54 AM,Internally Displaced People,222,216,264,202,904,124,152,223,230,729
70,Syria Cross border,2019,TUR-19/3559/SA2/ER-FS/NGO/14415,1/4/2021 8:42:54 AM,Overall,554,540,660,506,2260,788,924,956,941,3609
70,Syria Cross border,2019,TUR-19/3559/SA2/ER-FS/NGO/14445,3/15/2021 10:37:49 AM,Host Communities,2634,3687,2107,2107,10535,2228,3078,2584,3545,11435
70,Syria Cross border,2019,TUR-19/3559/SA2/ER-FS/NGO/14445,3/15/2021 10:37:49 AM,Internally Displaced People,1750,2450,1400,1400,7000,2138,2241,2581,2398,9358
70,Syria Cross border,2019,TUR-19/3559/SA2/ER-FS/NGO/14445,3/15/2021 10:37:49 AM,Overall,4384,6137,3507,3507,17535,4366,5319,5165,5943,20793
70,Syria Cross border,2019,TUR-19/3559/SA2/E-WASH/NGO/14401,3/10/2021 8:19:18 AM,Host Communities,378,328,6846,7020,14572,374,323,6859,7037,14593
70,Syria Cross border,2019,TUR-19/3559/SA2/E-WASH/NGO/14401,3/10/2021 8:19:18 AM,Internally Displaced People,374,317,7131,7106,14928,335,312,7143,7116,14906
70,Syria Cross border,2019,TUR-19/3559/SA2/E-WASH/NGO/14401,3/10/2021 8:19:18 AM,Overall,752,645,13977,14126,29500,709,635,14002,14153,29499
70,Syria Cross border,2019,TUR-19/3559/SA2/E-WASH/NGO/14413,10/19/2021 1:51:12 PM,Internally Displaced People,60,48,1450,1430,2988,84,24,1711,1675,3494
70,Syria Cross border,2019,TUR-19/3559/SA2/E-WASH/NGO/14413,10/19/2021 1:51:12 PM,Overall,60,48,1450,1430,2988,84,24,1711,1675,3494
70,Syria Cross border,2019,TUR-19/3559/SA2/E-WASH/NGO/14430,2/8/2021 12:04:57 PM,Host Communities,186,311,1647,1608,3752,267,259,2084,1907,4517
70,Syria Cross border,2019,TUR-19/3559/SA2/E-WASH/NGO/14430,2/8/2021 12:04:57 PM,Internally Displaced People,114,189,823,833,1959,91,70,502,418,1081
70,Syria Cross border,2019,TUR-19/3559/SA2/E-WASH/NGO/14430,2/8/2021 12:04:57 PM,Overall,300,500,2470,2441,5711,358,329,2586,2325,5598
70,Syria Cross border,2019,TUR-19/3559/SA2/E-WASH-P/NGO/14417,8/13/2021 12:32:40 PM,Host Communities,19392,21425,29284,33625,103726,20467,22523,32980,36141,112111
70,Syria Cross border,2019,TUR-19/3559/SA2/E-WASH-P/NGO/14417,8/13/2021 12:32:40 PM,Internally Displaced People,29195,32605,43699,50246,155745,38041,41871,61278,67165,208355
70,Syria Cross border,2019,TUR-19/3559/SA2/E-WASH-P/NGO/14417,8/13/2021 12:32:40 PM,Overall,48587,54030,72983,83871,259471,58508,64394,94258,103306,320466
70,Syria Cross border,2019,TUR-19/3559/SA2/FS/INGO/14507,8/25/2020 7:34:27 AM,Internally Displaced People,500,500,750,750,2500,544,839,1167,1157,3707
70,Syria Cross border,2019,TUR-19/3559/SA2/FS/INGO/14507,8/25/2020 7:34:27 AM,Overall,500,500,750,750,2500,544,839,1167,1157,3707
70,Syria Cross border,2019,TUR-19/3559/SA2/FS/NGO/14403,1/4/2021 2:07:50 PM,Host Communities,568,817,987,1128,3500,1049,1022,1199,1155,4425
70,Syria Cross border,2019,TUR-19/3559/SA2/FS/NGO/14403,1/4/2021 2:07:50 PM,Internally Displaced People,4522,6828,6605,8545,26500,7679,8468,9258,8185,33590
70,Syria Cross border,2019,TUR-19/3559/SA2/FS/NGO/14403,1/4/2021 2:07:50 PM,Overall,5090,7645,7592,9673,30000,8728,9490,10457,9340,38015
70,Syria Cross border,2019,TUR-19/3559/SA2/FS/NGO/14418,3/19/2021 9:08:54 AM,Host Communities,1156,1274,1620,1736,5786,876,1059,1455,1465,4855
70,Syria Cross border,2019,TUR-19/3559/SA2/FS/NGO/14418,3/19/2021 9:08:54 AM,Internally Displaced People,203,223,284,304,1014,400,498,782,733,2413
70,Syria Cross border,2019,TUR-19/3559/SA2/FS/NGO/14418,3/19/2021 9:08:54 AM,Overall,1359,1497,1904,2040,6800,1276,1557,2237,2198,7268
70,Syria Cross border,2019,TUR-19/3559/SA2/FS/NGO/14461,10/26/2020 6:41:06 AM,Host Communities,120,50,0,0,170,87,75,0,0,162
70,Syria Cross border,2019,TUR-19/3559/SA2/FS/NGO/14461,10/26/2020 6:41:06 AM,Internally Displaced People,22,8,0,0,30,24,14,0,0,38
70,Syria Cross border,2019,TUR-19/3559/SA2/FS/NGO/14461,10/26/2020 6:41:06 AM,Overall,142,58,0,0,200,111,89,0,0,200
70,Syria Cross border,2019,TUR-19/3559/SA2/FS/NGO/14487,12/8/2020 6:03:53 AM,Host Communities,360,140,0,0,500,315,185,0,0,500
70,Syria Cross border,2019,TUR-19/3559/SA2/FS/NGO/14487,12/8/2020 6:03:53 AM,Internally Displaced People,40,60,0,0,100,40,60,0,0,100
70,Syria Cross border,2019,TUR-19/3559/SA2/FS/NGO/14487,12/8/2020 6:03:53 AM,Overall,400,200,0,0,600,355,245,0,0,600
70,Syria Cross border,2019,TUR-19/3559/SA2/FS/NGO/14497,4/13/2021 7:39:25 AM,Host Communities,1038,1144,1827,1728,5737,1088,1182,1890,1756,5916
70,Syria Cross border,2019,TUR-19/3559/SA2/FS/NGO/14497,4/13/2021 7:39:25 AM,Internally Displaced People,536,574,684,731,2525,627,740,1363,1348,4078
70,Syria Cross border,2019,TUR-19/3559/SA2/FS/NGO/14497,4/13/2021 7:39:25 AM,Overall,1574,1718,2511,2459,8262,1715,1922,3253,3104,9994
70,Syria Cross border,2019,TUR-19/3559/SA2/FS/UN/14486,5/6/2021 7:06:32 AM,Host Communities,10786,11246,11475,12393,45900,20309,19216,31471,28549,99545
70,Syria Cross border,2019,TUR-19/3559/SA2/FS/UN/14486,5/6/2021 7:06:32 AM,Internally Displaced People,1904,1984,2025,2187,8100,10943,9798,15613,14233,50587
70,Syria Cross border,2019,TUR-19/3559/SA2/FS/UN/14486,5/6/2021 7:06:32 AM,Overall,12690,13230,13500,14580,54000,31252,29014,47084,42782,150132
70,Syria Cross border,2019,TUR-19/3559/SA2/FS-ER/NGO/14448,1/8/2021 6:26:43 AM,Host Communities,1722,2067,1171,1929,6889,1826,2115,1669,2241,7851
70,Syria Cross border,2019,TUR-19/3559/SA2/FS-ER/NGO/14448,1/8/2021 6:26:43 AM,Internally Displaced People,574,689,390,643,2296,620,694,528,752,2594
70,Syria Cross border,2019,TUR-19/3559/SA2/FS-ER/NGO/14448,1/8/2021 6:26:43 AM,Overall,2296,2756,1561,2572,9185,2446,2809,2197,2993,10445
70,Syria Cross border,2019,TUR-19/3559/SA2/FS-ER/NGO/14465,3/5/2021 10:46:13 AM,Host Communities,4949,4969,5783,5397,21098,4686,5107,10903,9406,30102
70,Syria Cross border,2019,TUR-19/3559/SA2/FS-ER/NGO/14465,3/5/2021 10:46:13 AM,Internally Displaced People,3408,3425,3972,3716,14521,8765,10099,21614,19090,59568
70,Syria Cross border,2019,TUR-19/3559/SA2/FS-ER/NGO/14465,3/5/2021 10:46:13 AM,Overall,8357,8394,9755,9113,35619,13451,15206,32517,28496,89670
70,Syria Cross border,2019,TUR-19/3559/SA2/FS-ER/O/14531,4/1/2021 5:24:57 AM,Host Communities,2372,2823,2750,2953,10898,1892,6185,1867,7278,17222
70,Syria Cross border,2019,TUR-19/3559/SA2/FS-ER/O/14531,4/1/2021 5:24:57 AM,Internally Displaced People,911,995,1112,884,3902,1268,4228,1209,4921,11626
70,Syria Cross border,2019,TUR-19/3559/SA2/FS-ER/O/14531,4/1/2021 5:24:57 AM,Overall,3283,3818,3862,3837,14800,3160,10413,3076,12199,28848
70,Syria Cross border,2019,TUR-19/3559/SA2/H/NGO/14506,6/10/2021 9:31:50 AM,Host Communities,1933,4012,604,604,7153,937,1439,239,223,2838
70,Syria Cross border,2019,TUR-19/3559/SA2/H/NGO/14506,6/10/2021 9:31:50 AM,Internally Displaced People,5985,12278,5894,5897,30054,8077,12404,4590,4284,29355
70,Syria Cross border,2019,TUR-19/3559/SA2/H/NGO/14506,6/10/2021 9:31:50 AM,Overall,7918,16290,6498,6501,37207,9014,13843,4829,4507,32193
70,Syria Cross border,2019,TUR-19/3559/SA2/H/UN/14504,6/24/2021 1:05:07 PM,Host Communities,531847,553555,132961,138388,1356751,551350,618792,707084,1794168,3671394
70,Syria Cross border,2019,TUR-19/3559/SA2/H/UN/14504,6/24/2021 1:05:07 PM,Overall,531847,553555,132961,138388,1356751,551350,618792,707084,1794168,3671394
70,Syria Cross border,2019,TUR-19/3559/SA2/H-N/NGO/14408,6/9/2021 8:01:31 AM,Host Communities,0,3170,4894,6598,14662,0,1532,2252,2404,6188
70,Syria Cross border,2019,TUR-19/3559/SA2/H-N/NGO/14408,6/9/2021 8:01:31 AM,Internally Displaced People,0,2296,3544,4778,10618,0,5058,5851,5645,16554
70,Syria Cross border,2019,TUR-19/3559/SA2/H-N/NGO/14408,6/9/2021 8:01:31 AM,Overall,0,5466,8438,11376,25280,0,6590,8103,8049,22742
70,Syria Cross border,2019,TUR-19/3559/SA2/H-P/INGO/14412,4/27/2021 8:08:21 AM,Host Communities,478,571,192,220,1461,704,709,182,158,1753
70,Syria Cross border,2019,TUR-19/3559/SA2/H-P/INGO/14412,4/27/2021 8:08:21 AM,Internally Displaced People,1616,1611,620,632,4479,2452,2588,625,437,6102
70,Syria Cross border,2019,TUR-19/3559/SA2/H-P/INGO/14412,4/27/2021 8:08:21 AM,Overall,2094,2182,812,852,5940,3156,3297,807,595,7855
70,Syria Cross border,2019,TUR-19/3559/SA2/N/NGO/14436,6/1/2021 1:24:10 PM,Host Communities,50,6383,1660,2490,10583,0,838,1559,1691,4088
70,Syria Cross border,2019,TUR-19/3559/SA2/N/NGO/14436,6/1/2021 1:24:10 PM,Internally Displaced People,77,4200,1020,1530,6827,0,8389,8930,9365,26684
70,Syria Cross border,2019,TUR-19/3559/SA2/N/NGO/14436,6/1/2021 1:24:10 PM,Overall,127,10583,2680,4020,17410,0,9227,10489,11056,30772
70,Syria Cross border,2019,TUR-19/3559/SA2/N/NGO/14517,3/24/2021 1:32:34 PM,Internally Displaced People,0,8582,6545,6327,21454,0,12870,11468,11376,35714
70,Syria Cross border,2019,TUR-19/3559/SA2/N/NGO/14517,3/24/2021 1:32:34 PM,Overall,0,8582,6545,6327,21454,0,12870,11468,11376,35714
70,Syria Cross border,2019,TUR-19/3559/SA2/NFI/NGO/14495,4/22/2021 8:08:55 PM,Host Communities,303,337,481,481,1602,392,470,607,533,2002
70,Syria Cross border,2019,TUR-19/3559/SA2/NFI/NGO/14495,4/22/2021 8:08:55 PM,Internally Displaced People,454,506,719,719,2398,638,720,950,894,3202
70,Syria Cross border,2019,TUR-19/3559/SA2/NFI/NGO/14495,4/22/2021 8:08:55 PM,Overall,757,843,1200,1200,4000,1030,1190,1557,1427,5204
70,Syria Cross border,2019,TUR-19/3559/SA2/NFI/NGO/14522,1/21/2021 9:49:51 AM,Host Communities,223,284,244,264,1015,341,414,611,601,1967
70,Syria Cross border,2019,TUR-19/3559/SA2/NFI/NGO/14522,1/21/2021 9:49:51 AM,Internally Displaced People,305,388,333,360,1386,481,545,783,695,2504
70,Syria Cross border,2019,TUR-19/3559/SA2/NFI/NGO/14522,1/21/2021 9:49:51 AM,Overall,544,693,595,643,2475,825,962,1397,1302,4486
70,Syria Cross border,2019,TUR-19/3559/SA2/NFI/NGO/14522,1/21/2021 9:49:51 AM,Returnees,16,21,18,19,74,3,3,3,6,15
70,Syria Cross border,2019,TUR-19/3559/SA2/NFI-P/NGO/14447,4/16/2021 11:30:08 AM,Host Communities,825,1231,592,639,3287,895,1251,609,660,3415
70,Syria Cross border,2019,TUR-19/3559/SA2/NFI-P/NGO/14447,4/16/2021 11:30:08 AM,Internally Displaced People,1009,1487,822,903,4221,892,1202,837,927,3858
70,Syria Cross border,2019,TUR-19/3559/SA2/NFI-P/NGO/14447,4/16/2021 11:30:08 AM,Overall,1834,2718,1414,1542,7508,1787,2453,1446,1587,7273
70,Syria Cross border,2019,TUR-19/3559/SA2/NFI-WASH/NGO/14500,2/3/2021 1:44:45 PM,Host Communities,25633,36655,36524,39097,137909,25032,30079,27580,33833,116524
70,Syria Cross border,2019,TUR-19/3559/SA2/NFI-WASH/NGO/14500,2/3/2021 1:44:45 PM,Internally Displaced People,27453,39475,40156,43174,150258,21412,26017,23629,28236,99294
70,Syria Cross border,2019,TUR-19/3559/SA2/NFI-WASH/NGO/14500,2/3/2021 1:44:45 PM,Overall,53086,76130,76680,82271,288167,46444,56096,51209,62069,215818
70,Syria Cross border,2019,TUR-19/3559/SA2/NFI-WASH/NGO/14512,1/21/2021 5:50:13 AM,Internally Displaced People,716,747,914,947,3324,566,668,846,818,2898
70,Syria Cross border,2019,TUR-19/3559/SA2/NFI-WASH/NGO/14512,1/21/2021 5:50:13 AM,Overall,716,747,914,947,3324,566,668,846,818,2898
70,Syria Cross border,2019,TUR-19/3559/SA2/N-H/INGO/14453,5/4/2021 10:01:29 AM,Host Communities,20,8739,6331,6090,21180,0,1235,1308,1302,3845
70,Syria Cross border,2019,TUR-19/3559/SA2/N-H/INGO/14453,5/4/2021 10:01:29 AM,Internally Displaced People,20,4128,4909,4956,14013,0,11079,12077,10696,33852
70,Syria Cross border,2019,TUR-19/3559/SA2/N-H/INGO/14453,5/4/2021 10:01:29 AM,Overall,40,12867,11240,11046,35193,0,12314,13385,11998,37697
70,Syria Cross border,2019,TUR-19/3559/SA2/N-H/NGO/14428,3/30/2021 1:59:24 PM,Host Communities,1760,3520,2116,2160,9556,1906,2261,2096,1664,7927
70,Syria Cross border,2019,TUR-19/3559/SA2/N-H/NGO/14428,3/30/2021 1:59:24 PM,Internally Displaced People,1104,2346,1411,1440,6301,878,1607,1315,1050,4850
70,Syria Cross border,2019,TUR-19/3559/SA2/N-H/NGO/14428,3/30/2021 1:59:24 PM,Overall,2864,5866,3527,3600,15857,2784,3868,3411,2714,12777
70,Syria Cross border,2019,TUR-19/3559/SA2/P/INGO/14450,1/28/2021 12:16:20 PM,Host Communities,6,4,0,0,10,116,87,0,0,203
70,Syria Cross border,2019,TUR-19/3559/SA2/P/INGO/14450,1/28/2021 12:16:20 PM,Internally Displaced People,0,0,0,0,0,231,170,0,0,401
70,Syria Cross border,2019,TUR-19/3559/SA2/P/INGO/14450,1/28/2021 12:16:20 PM,Overall,6,4,0,0,10,347,257,0,0,604
70,Syria Cross border,2019,TUR-19/3559/SA2/WASH/INGO/14416,7/23/2020 9:08:44 AM,Internally Displaced People,7313,8743,10591,11924,38571,8309,9763,11527,13178,42777
70,Syria Cross border,2019,TUR-19/3559/SA2/WASH/INGO/14416,7/23/2020 9:08:44 AM,Overall,7313,8743,10591,11924,38571,8309,9763,11527,13178,42777
70,Syria Cross border,2019,TUR-19/3559/SA2/WASH/INGO/14482,8/26/2020 8:20:36 AM,Host Communities,9225,11675,15557,15076,51533,10974,11254,15651,16428,54307
70,Syria Cross border,2019,TUR-19/3559/SA2/WASH/INGO/14482,8/26/2020 8:20:36 AM,Internally Displaced People,3300,3600,7871,8779,23550,6142,6828,9410,9765,32145
70,Syria Cross border,2019,TUR-19/3559/SA2/WASH/INGO/14482,8/26/2020 8:20:36 AM,Other,0,0,1932,2149,4081,0,0,5859,5887,11746
70,Syria Cross border,2019,TUR-19/3559/SA2/WASH/INGO/14482,8/26/2020 8:20:36 AM,Overall,12525,15275,25360,26004,79164,17116,18082,30920,32080,98198
70,Syria Cross border,2019,TUR-19/3559/SA2/WASH/INGO/14484,1/20/2021 11:24:46 AM,Host Communities,135215,159591,105755,81207,481768,145684,151626,160581,140012,597903
70,Syria Cross border,2019,TUR-19/3559/SA2/WASH/INGO/14484,1/20/2021 11:24:46 AM,Internally Displaced People,329821,389121,258658,199359,1176959,271454,289510,359146,331728,1251838
70,Syria Cross border,2019,TUR-19/3559/SA2/WASH/INGO/14484,1/20/2021 11:24:46 AM,Overall,465036,548712,364413,280566,1658727,417138,441136,519727,471740,1849741
70,Syria Cross border,2019,TUR-19/3559/SA2/WASH/INGO/14491,3/29/2021 12:09:11 PM,Host Communities,5808,6072,6336,8184,26400,15639,16349,17061,22035,71084
70,Syria Cross border,2019,TUR-19/3559/SA2/WASH/INGO/14491,3/29/2021 12:09:11 PM,Internally Displaced People,13552,14168,14784,19096,61600,15857,16581,17302,22345,72085
70,Syria Cross border,2019,TUR-19/3559/SA2/WASH/INGO/14491,3/29/2021 12:09:11 PM,Overall,19360,20240,21120,27280,88000,31496,32930,34363,44380,143169
70,Syria Cross border,2019,TUR-19/3559/SA2/WASH/INGO/14498,10/19/2020 12:02:15 PM,Host Communities,14522,22016,24840,23844,85222,40676,46750,10522,11292,109240
70,Syria Cross border,2019,TUR-19/3559/SA2/WASH/INGO/14498,10/19/2020 12:02:15 PM,Internally Displaced People,9760,14407,16199,15586,55952,16502,19045,4192,4390,44129
70,Syria Cross border,2019,TUR-19/3559/SA2/WASH/INGO/14498,10/19/2020 12:02:15 PM,Overall,24282,36423,41039,39430,141174,57178,65795,14714,15682,153369
70,Syria Cross border,2019,TUR-19/3559/SA2/WASH/INGO/14525,5/26/2021 6:17:36 PM,Host Communities,3437,3929,4747,4272,16385,4218,4822,5826,5243,20109
70,Syria Cross border,2019,TUR-19/3559/SA2/WASH/INGO/14525,5/26/2021 6:17:36 PM,Internally Displaced People,2107,2407,2909,2592,10015,2586,2954,3570,3181,12291
70,Syria Cross border,2019,TUR-19/3559/SA2/WASH/INGO/14525,5/26/2021 6:17:36 PM,Overall,5544,6336,7656,6864,26400,6804,7776,9396,8424,32400
70,Syria Cross border,2019,TUR-19/3559/SA2/WASH/NGO/14402,1/21/2021 2:23:20 PM,Host Communities,2596,2678,2638,2558,10470,2596,2678,2638,2558,10470
70,Syria Cross border,2019,TUR-19/3559/SA2/WASH/NGO/14402,1/21/2021 2:23:20 PM,Internally Displaced People,63712,65702,64748,62760,256922,68652,84105,108465,95278,356500
70,Syria Cross border,2019,TUR-19/3559/SA2/WASH/NGO/14402,1/21/2021 2:23:20 PM,Overall,66308,68380,67386,65318,267392,71248,86783,111103,97836,366970
70,Syria Cross border,2019,TUR-19/3559/SA2/WASH/NGO/14452,3/30/2021 10:24:57 AM,Host Communities,18050,20900,26600,29450,95000,19391,20385,24679,25945,90400
70,Syria Cross border,2019,TUR-19/3559/SA2/WASH/NGO/14452,3/30/2021 10:24:57 AM,Internally Displaced People,2448,2498,1348,1222,7516,1481,1768,2553,2457,8259
70,Syria Cross border,2019,TUR-19/3559/SA2/WASH/NGO/14452,3/30/2021 10:24:57 AM,Overall,20498,23398,27948,30672,102516,20872,22153,27232,28402,98659
70,Syria Cross border,2019,TUR-19/3559/SA2/WASH/O/14528,6/22/2021 9:02:22 AM,Host Communities,1907,2160,2121,2312,8500,2099,2464,2677,2973,10213
70,Syria Cross border,2019,TUR-19/3559/SA2/WASH/O/14528,6/22/2021 9:02:22 AM,Internally Displaced People,8070,10272,8922,10277,37541,4608,5633,5695,5564,21500
70,Syria Cross border,2019,TUR-19/3559/SA2/WASH/O/14528,6/22/2021 9:02:22 AM,Overall,9977,12432,11043,12589,46041,6707,8097,8372,8537,31713
70,Syria Cross border,2019,TUR-19/3559/SA2/WASH-CCM/NGO/14501,1/21/2021 7:11:26 PM,Internally Displaced People,7577,9129,10275,10493,37474,9668,11665,13026,13314,47673
70,Syria Cross border,2019,TUR-19/3559/SA2/WASH-CCM/NGO/14501,1/21/2021 7:11:26 PM,Overall,7577,9129,10275,10493,37474,9668,11665,13026,13314,47673
70,Syria Cross border,2020,TUR-20/3559/RA1/CCM-NFI-WASH/NGO/14981,9/6/2021 9:37:04 AM,Internally Displaced People,700,600,800,900,3000,490,511,680,606,2287
70,Syria Cross border,2020,TUR-20/3559/RA1/CCM-NFI-WASH/NGO/14981,9/6/2021 9:37:04 AM,Overall,700,600,800,900,3000,490,511,680,606,2287
70,Syria Cross border,2020,TUR-20/3559/RA1/CCM-NFI-WASH/NGO/15002,8/3/2021 9:26:37 AM,Internally Displaced People,159,180,273,238,850,165,194,273,238,870
70,Syria Cross border,2020,TUR-20/3559/RA1/CCM-NFI-WASH/NGO/15002,8/3/2021 9:26:37 AM,Overall,159,180,273,238,850,165,194,273,238,870
70,Syria Cross border,2020,TUR-20/3559/RA1/CCM-NFI-WASH/NGO/15006,5/23/2021 5:29:48 AM,Internally Displaced People,144,163,231,177,715,154,169,231,177,731
70,Syria Cross border,2020,TUR-20/3559/RA1/CCM-NFI-WASH/NGO/15006,5/23/2021 5:29:48 AM,Overall,144,163,231,177,715,154,169,231,177,731
70,Syria Cross border,2020,TUR-20/3559/RA1/CCM-NFI-WASH/NGO/15036,7/6/2021 8:18:26 AM,Internally Displaced People,1903,2076,2249,2422,8650,1716,1850,2366,2061,7993
70,Syria Cross border,2020,TUR-20/3559/RA1/CCM-NFI-WASH/NGO/15036,7/6/2021 8:18:26 AM,Overall,1903,2076,2249,2422,8650,1716,1850,2366,2061,7993
70,Syria Cross border,2020,TUR-20/3559/RA1/CCM-NFI-WASH-P/NGO/14975,4/22/2021 8:17:48 PM,Internally Displaced People,1724,1813,2209,2294,8040,1294,1586,2317,2167,7364
70,Syria Cross border,2020,TUR-20/3559/RA1/CCM-NFI-WASH-P/NGO/14975,4/22/2021 8:17:48 PM,Overall,1724,1813,2209,2294,8040,1294,1586,2317,2167,7364
70,Syria Cross border,2020,TUR-20/3559/RA1/CCM-P/UN/14987,8/9/2021 11:16:55 AM,Host Communities,704,1057,704,1056,3521,886,1218,1218,1395,4717
70,Syria Cross border,2020,TUR-20/3559/RA1/CCM-P/UN/14987,8/9/2021 11:16:55 AM,Internally Displaced People,2603,3819,3507,4288,14217,2086,3643,3021,3323,12073
70,Syria Cross border,2020,TUR-20/3559/RA1/CCM-P/UN/14987,8/9/2021 11:16:55 AM,Overall,3307,4876,4211,5344,17738,2972,4861,4239,4718,16790
70,Syria Cross border,2020,TUR-20/3559/RA1/CCM-WASH-NFI/NGO/14964,2/11/2021 11:29:15 AM,Host Communities,504,530,985,1010,3029,504,530,985,1010,3029
70,Syria Cross border,2020,TUR-20/3559/RA1/CCM-WASH-NFI/NGO/14964,2/11/2021 11:29:15 AM,Internally Displaced People,1275,1337,2487,2550,7649,1215,1278,2134,2113,6740
70,Syria Cross border,2020,TUR-20/3559/RA1/CCM-WASH-NFI/NGO/14964,2/11/2021 11:29:15 AM,Overall,1779,1867,3472,3560,10678,1719,1808,3119,3123,9769
70,Syria Cross border,2020,TUR-20/3559/RA1/CCM-WASH-NFI/NGO/15039,8/3/2021 7:05:06 AM,Internally Displaced People,342,532,456,570,1900,297,348,498,458,1601
70,Syria Cross border,2020,TUR-20/3559/RA1/CCM-WASH-NFI/NGO/15039,8/3/2021 7:05:06 AM,Overall,342,532,456,570,1900,297,348,498,458,1601
70,Syria Cross border,2020,TUR-20/3559/RA1/CCS/O/15011,2/19/2021 12:29:35 PM,Other,37,37,38,38,150,21,21,22,22,86
70,Syria Cross border,2020,TUR-20/3559/RA1/CCS/O/15011,2/19/2021 12:29:35 PM,Overall,37,37,38,38,150,21,21,22,22,86
70,Syria Cross border,2020,TUR-20/3559/RA1/FS/INGO/15028,1/5/2021 7:40:58 AM,Internally Displaced People,6298,6927,8502,9761,31488,9133,10695,14319,14811,48958
70,Syria Cross border,2020,TUR-20/3559/RA1/FS/INGO/15028,1/5/2021 7:40:58 AM,Overall,6298,6927,8502,9761,31488,9133,10695,14319,14811,48958
70,Syria Cross border,2020,TUR-20/3559/RA1/FS/NGO/14969,1/12/2021 6:35:52 AM,Internally Displaced People,1567,2223,2478,2829,9097,1572,2301,2713,2848,9434
70,Syria Cross border,2020,TUR-20/3559/RA1/FS/NGO/14969,1/12/2021 6:35:52 AM,Overall,1567,2223,2478,2829,9097,1572,2301,2713,2848,9434
70,Syria Cross border,2020,TUR-20/3559/RA1/FS/NGO/14982,11/3/2020 7:01:39 AM,Host Communities,165,191,180,178,714,164,275,296,282,1017
70,Syria Cross border,2020,TUR-20/3559/RA1/FS/NGO/14982,11/3/2020 7:01:39 AM,Internally Displaced People,3179,3694,3495,3455,13823,2714,3301,4712,4301,15028
70,Syria Cross border,2020,TUR-20/3559/RA1/FS/NGO/14982,11/3/2020 7:01:39 AM,Overall,3344,3885,3675,3633,14537,2878,3576,5008,4583,16045
70,Syria Cross border,2020,TUR-20/3559/RA1/FS/NGO/14988,11/18/2020 6:16:41 PM,Internally Displaced People,1625,2032,2193,2274,8124,1611,1341,2960,2850,8762
70,Syria Cross border,2020,TUR-20/3559/RA1/FS/NGO/14988,11/18/2020 6:16:41 PM,Overall,1625,2032,2193,2274,8124,1611,1341,2960,2850,8762
70,Syria Cross border,2020,TUR-20/3559/RA1/FS/NGO/14991,2/12/2021 7:59:58 AM,Internally Displaced People,3789,3983,4823,5070,17665,5143,6281,7335,6100,24859
70,Syria Cross border,2020,TUR-20/3559/RA1/FS/NGO/14991,2/12/2021 7:59:58 AM,Overall,3789,3983,4823,5070,17665,5143,6281,7335,6100,24859
70,Syria Cross border,2020,TUR-20/3559/RA1/FS/NGO/14999,1/4/2021 12:28:49 PM,Internally Displaced People,2976,3168,3670,3786,13600,2686,3259,5559,5579,17083
70,Syria Cross border,2020,TUR-20/3559/RA1/FS/NGO/14999,1/4/2021 12:28:49 PM,Overall,2976,3168,3670,3786,13600,2686,3259,5559,5579,17083
70,Syria Cross border,2020,TUR-20/3559/RA1/FS/NGO/15000,2/12/2021 10:47:07 AM,Host Communities,215,226,273,286,1000,211,225,289,311,1036
70,Syria Cross border,2020,TUR-20/3559/RA1/FS/NGO/15000,2/12/2021 10:47:07 AM,Internally Displaced People,3003,3157,3822,4018,14000,1931,2260,2454,2751,9396
70,Syria Cross border,2020,TUR-20/3559/RA1/FS/NGO/15000,2/12/2021 10:47:07 AM,Overall,3218,3383,4095,4304,15000,2142,2485,2743,3062,10432
70,Syria Cross border,2020,TUR-20/3559/RA1/FS/NGO/15008,1/6/2021 9:04:49 AM,Internally Displaced People,11432,12636,17449,18653,60170,11393,10947,19398,18637,60375
70,Syria Cross border,2020,TUR-20/3559/RA1/FS/NGO/15008,1/6/2021 9:04:49 AM,Overall,11432,12636,17449,18653,60170,11393,10947,19398,18637,60375
70,Syria Cross border,2020,TUR-20/3559/RA1/FS/NGO/15012,1/4/2021 1:05:20 PM,Internally Displaced People,5543,6860,10766,9689,32858,5565,6958,11053,9888,33464
70,Syria Cross border,2020,TUR-20/3559/RA1/FS/NGO/15012,1/4/2021 1:05:20 PM,Overall,5543,6860,10766,9689,32858,5565,6958,11053,9888,33464
70,Syria Cross border,2020,TUR-20/3559/RA1/FS/NGO/15024,2/22/2021 11:13:29 AM,Internally Displaced People,7787,8590,9795,9895,36067,7833,8640,9853,9954,36280
70,Syria Cross border,2020,TUR-20/3559/RA1/FS/NGO/15024,2/22/2021 11:13:29 AM,Overall,7787,8590,9795,9895,36067,7833,8640,9853,9954,36280
70,Syria Cross border,2020,TUR-20/3559/RA1/FS/NGO/15027,1/5/2021 8:04:31 AM,Internally Displaced People,6941,8525,9728,10603,35797,6808,8458,10623,10991,36880
70,Syria Cross border,2020,TUR-20/3559/RA1/FS/NGO/15027,1/5/2021 8:04:31 AM,Overall,6941,8525,9728,10603,35797,6808,8458,10623,10991,36880
70,Syria Cross border,2020,TUR-20/3559/RA1/FS/NGO/15035,11/10/2020 11:00:40 AM,Internally Displaced People,1239,1281,823,857,4200,718,832,1454,1493,4497
70,Syria Cross border,2020,TUR-20/3559/RA1/FS/NGO/15035,11/10/2020 11:00:40 AM,Overall,1239,1281,823,857,4200,718,832,1454,1493,4497
70,Syria Cross border,2020,TUR-20/3559/RA1/FS/NGO/15041,1/4/2021 11:56:26 AM,Internally Displaced People,1200,1500,1680,1620,6000,3765,3946,8836,8010,24557
70,Syria Cross border,2020,TUR-20/3559/RA1/FS/NGO/15041,1/4/2021 11:56:26 AM,Overall,1200,1500,1680,1620,6000,3765,3946,8836,8010,24557
70,Syria Cross border,2020,TUR-20/3559/RA1/FS/NGO/15055,12/28/2020 1:25:09 PM,Internally Displaced People,6050,7700,6600,7150,27500,6176,7277,9397,8613,31463
70,Syria Cross border,2020,TUR-20/3559/RA1/FS/NGO/15055,12/28/2020 1:25:09 PM,Overall,6050,7700,6600,7150,27500,6176,7277,9397,8613,31463
70,Syria Cross border,2020,TUR-20/3559/RA1/FS/UN/14974,1/8/2021 7:00:27 AM,Host Communities,49910,52034,53096,57344,212384,15488,15818,21709,19942,72957
70,Syria Cross border,2020,TUR-20/3559/RA1/FS/UN/14974,1/8/2021 7:00:27 AM,Internally Displaced People,8807,9183,9370,10120,37480,14425,15214,26065,21915,77619
70,Syria Cross border,2020,TUR-20/3559/RA1/FS/UN/14974,1/8/2021 7:00:27 AM,Overall,58717,61217,62466,67464,249864,29913,31032,47774,41857,150576
70,Syria Cross border,2020,TUR-20/3559/RA1/FS/UN/15048,1/12/2021 6:37:07 AM,Internally Displaced People,40817,45113,62299,66596,214825,40817,45113,62299,66596,214825
70,Syria Cross border,2020,TUR-20/3559/RA1/FS/UN/15048,1/12/2021 6:37:07 AM,Overall,40817,45113,62299,66596,214825,40817,45113,62299,66596,214825
70,Syria Cross border,2020,TUR-20/3559/RA1/FS-NFI/NGO/15037,3/1/2021 9:13:04 AM,Internally Displaced People,4510,5103,5512,5755,20880,3660,4521,5642,5667,19490
70,Syria Cross border,2020,TUR-20/3559/RA1/FS-NFI/NGO/15037,3/1/2021 9:13:04 AM,Overall,4510,5103,5512,5755,20880,3660,4521,5642,5667,19490
70,Syria Cross border,2020,TUR-20/3559/RA1/FS-NFI-WASH/INGO/15017,1/4/2021 2:03:24 PM,Internally Displaced People,800,1000,1200,2000,5000,819,1138,1545,1516,5018
70,Syria Cross border,2020,TUR-20/3559/RA1/FS-NFI-WASH/INGO/15017,1/4/2021 2:03:24 PM,Overall,800,1000,1200,2000,5000,819,1138,1545,1516,5018
70,Syria Cross border,2020,TUR-20/3559/RA1/H/INGO/14989,2/28/2021 4:15:35 PM,Host Communities,1078,1271,847,654,3850,1089,1083,1657,1463,5292
70,Syria Cross border,2020,TUR-20/3559/RA1/H/INGO/14989,2/28/2021 4:15:35 PM,Internally Displaced People,2002,2359,1573,1216,7150,5071,4745,7854,6608,24278
70,Syria Cross border,2020,TUR-20/3559/RA1/H/INGO/14989,2/28/2021 4:15:35 PM,Overall,3080,3630,2420,1870,11000,6160,5828,9511,8071,29570
70,Syria Cross border,2020,TUR-20/3559/RA1/H/INGO/15052,1/12/2021 12:15:53 PM,Host Communities,161,116,0,1,278,161,147,4,2,314
70,Syria Cross border,2020,TUR-20/3559/RA1/H/INGO/15052,1/12/2021 12:15:53 PM,Internally Displaced People,196,162,2,2,362,201,148,7,10,366
70,Syria Cross border,2020,TUR-20/3559/RA1/H/INGO/15052,1/12/2021 12:15:53 PM,Overall,357,278,2,3,640,362,295,11,12,680
70,Syria Cross border,2020,TUR-20/3559/RA1/H/NGO/14965,2/10/2021 7:32:59 AM,Host Communities,450,2070,1505,1555,5580,1244,5229,2123,2245,10841
70,Syria Cross border,2020,TUR-20/3559/RA1/H/NGO/14965,2/10/2021 7:32:59 AM,Internally Displaced People,1350,6210,4515,4670,16745,2564,18120,10967,11078,42729
70,Syria Cross border,2020,TUR-20/3559/RA1/H/NGO/14965,2/10/2021 7:32:59 AM,Overall,1800,8280,6020,6225,22325,3808,23349,13090,13323,53570
70,Syria Cross border,2020,TUR-20/3559/RA1/H/NGO/14968,1/26/2021 12:39:41 PM,Internally Displaced People,8174,12262,12773,17884,51093,9491,25210,12024,14446,61171
70,Syria Cross border,2020,TUR-20/3559/RA1/H/NGO/14968,1/26/2021 12:39:41 PM,Overall,8174,12262,12773,17884,51093,9491,25210,12024,14446,61171
70,Syria Cross border,2020,TUR-20/3559/RA1/H/NGO/14971,2/10/2021 7:37:21 AM,Host Communities,103,82,2,5,192,90,71,3,2,166
70,Syria Cross border,2020,TUR-20/3559/RA1/H/NGO/14971,2/10/2021 7:37:21 AM,Internally Displaced People,121,137,5,3,266,144,145,4,5,298
70,Syria Cross border,2020,TUR-20/3559/RA1/H/NGO/14971,2/10/2021 7:37:21 AM,Overall,224,219,7,8,458,234,216,7,7,464
70,Syria Cross border,2020,TUR-20/3559/RA1/H/NGO/14997,2/10/2021 7:26:58 AM,Host Communities,1375,1286,1758,1661,6080,12,26,45,44,127
70,Syria Cross border,2020,TUR-20/3559/RA1/H/NGO/14997,2/10/2021 7:26:58 AM,Internally Displaced People,3898,3779,5339,5221,18237,4472,12520,7154,9421,33567
70,Syria Cross border,2020,TUR-20/3559/RA1/H/NGO/14997,2/10/2021 7:26:58 AM,Overall,5273,5065,7097,6882,24317,4484,12546,7199,9465,33694
70,Syria Cross border,2020,TUR-20/3559/RA1/H/NGO/15029,3/26/2021 12:03:15 PM,Host Communities,6202,6097,4872,2821,19992,7957,7237,4863,3293,23350
70,Syria Cross border,2020,TUR-20/3559/RA1/H/NGO/15029,3/26/2021 12:03:15 PM,Internally Displaced People,10367,12880,5453,6181,34881,9571,16056,8814,8002,42443
70,Syria Cross border,2020,TUR-20/3559/RA1/H/NGO/15029,3/26/2021 12:03:15 PM,Overall,16569,18977,10325,9002,54873,17528,23293,13677,11295,65793
70,Syria Cross border,2020,TUR-20/3559/RA1/H/NGO/15032,2/10/2021 7:21:40 AM,Host Communities,2476,2971,2229,2229,9905,2967,5056,1239,1327,10589
70,Syria Cross border,2020,TUR-20/3559/RA1/H/NGO/15032,2/10/2021 7:21:40 AM,Internally Displaced People,2476,2971,2229,2229,9905,2967,5056,1239,1327,10589
70,Syria Cross border,2020,TUR-20/3559/RA1/H/NGO/15032,2/10/2021 7:21:40 AM,Overall,4952,5942,4458,4458,19810,5934,10112,2478,2654,21178
70,Syria Cross border,2020,TUR-20/3559/RA1/H/NGO/15034,4/14/2021 8:11:16 AM,Host Communities,5088,8326,5319,4394,23127,9881,11631,8626,6731,36869
70,Syria Cross border,2020,TUR-20/3559/RA1/H/NGO/15034,4/14/2021 8:11:16 AM,Internally Displaced People,10690,28935,15436,15423,70484,19004,39725,21470,20458,100657
70,Syria Cross border,2020,TUR-20/3559/RA1/H/NGO/15034,4/14/2021 8:11:16 AM,Overall,15778,37261,20755,19817,93611,28885,51356,30096,27189,137526
70,Syria Cross border,2020,TUR-20/3559/RA1/H-N/NGO/15009,4/14/2021 8:05:08 AM,Host Communities,6001,6832,3905,3099,19837,2911,9884,2410,2301,17506
70,Syria Cross border,2020,TUR-20/3559/RA1/H-N/NGO/15009,4/14/2021 8:05:08 AM,Internally Displaced People,6812,7053,699,620,15184,2711,7282,888,860,11741
70,Syria Cross border,2020,TUR-20/3559/RA1/H-N/NGO/15009,4/14/2021 8:05:08 AM,Overall,12813,13885,4604,3719,35021,5622,17166,3298,3161,29247
70,Syria Cross border,2020,TUR-20/3559/RA1/H-N/NGO/15013,2/3/2021 12:44:39 PM,Host Communities,1750,3532,2798,3046,11126,1890,4444,4999,5359,16692
70,Syria Cross border,2020,TUR-20/3559/RA1/H-N/NGO/15013,2/3/2021 12:44:39 PM,Internally Displaced People,1820,13965,11062,13053,39900,2375,13832,15112,12537,43856
70,Syria Cross border,2020,TUR-20/3559/RA1/H-N/NGO/15013,2/3/2021 12:44:39 PM,Overall,3570,17497,13860,16099,51026,4265,18276,20111,17896,60548
70,Syria Cross border,2020,TUR-20/3559/RA1/NFI/NGO/14976,2/4/2021 2:58:23 PM,Internally Displaced People,14616,18602,11493,14621,59332,31227,39745,25324,31704,128000
70,Syria Cross border,2020,TUR-20/3559/RA1/NFI/NGO/14976,2/4/2021 2:58:23 PM,Overall,14616,18602,11493,14621,59332,31227,39745,25324,31704,128000
70,Syria Cross border,2020,TUR-20/3559/RA1/NFI/NGO/14979,2/24/2021 8:54:00 AM,Internally Displaced People,1250,1893,1798,2784,7725,1783,2179,2129,2819,8910
70,Syria Cross border,2020,TUR-20/3559/RA1/NFI/NGO/14979,2/24/2021 8:54:00 AM,Overall,1250,1893,1798,2784,7725,1783,2179,2129,2819,8910
70,Syria Cross border,2020,TUR-20/3559/RA1/NFI/NGO/14980,11/16/2020 7:08:55 PM,Host Communities,910,1050,996,983,3939,852,1055,1116,1046,4069
70,Syria Cross border,2020,TUR-20/3559/RA1/NFI/NGO/14980,11/16/2020 7:08:55 PM,Internally Displaced People,5152,5956,5635,5568,22311,4832,5603,7291,6650,24376
70,Syria Cross border,2020,TUR-20/3559/RA1/NFI/NGO/14980,11/16/2020 7:08:55 PM,Overall,6062,7006,6631,6551,26250,5684,6658,8407,7696,28445
70,Syria Cross border,2020,TUR-20/3559/RA1/NFI/NGO/15031,1/26/2021 10:48:15 AM,Host Communities,185,195,235,245,860,245,319,381,348,1293
70,Syria Cross border,2020,TUR-20/3559/RA1/NFI/NGO/15031,1/26/2021 10:48:15 AM,Internally Displaced People,1050,1105,1345,1400,4900,1180,1399,1793,1577,5949
70,Syria Cross border,2020,TUR-20/3559/RA1/NFI/NGO/15031,1/26/2021 10:48:15 AM,Overall,1235,1300,1580,1645,5760,1425,1718,2174,1925,7242
70,Syria Cross border,2020,TUR-20/3559/RA1/NFI/NGO/15054,2/9/2021 11:34:47 AM,Host Communities,194,246,211,229,880,30,27,23,23,103
70,Syria Cross border,2020,TUR-20/3559/RA1/NFI/NGO/15054,2/9/2021 11:34:47 AM,Internally Displaced People,774,986,845,915,3520,1268,1453,1826,1636,6183
70,Syria Cross border,2020,TUR-20/3559/RA1/NFI/NGO/15054,2/9/2021 11:34:47 AM,Overall,968,1232,1056,1144,4400,1298,1480,1849,1659,6286
70,Syria Cross border,2020,TUR-20/3559/RA1/NFI-CCM/NGO/15019,4/16/2021 11:06:22 AM,Internally Displaced People,4272,4855,3759,4870,17756,2228,2482,3622,3402,11734
70,Syria Cross border,2020,TUR-20/3559/RA1/NFI-CCM/NGO/15019,4/16/2021 11:06:22 AM,Overall,4272,4855,3759,4870,17756,2228,2482,3622,3402,11734
70,Syria Cross border,2020,TUR-20/3559/RA1/NFI-CCM-WASH/NGO/15003,7/5/2021 8:57:37 AM,Internally Displaced People,3583,4529,5714,7134,20960,3583,4529,5714,7134,20960
70,Syria Cross border,2020,TUR-20/3559/RA1/NFI-CCM-WASH/NGO/15003,7/5/2021 8:57:37 AM,Overall,3583,4529,5714,7134,20960,3583,4529,5714,7134,20960
70,Syria Cross border,2020,TUR-20/3559/RA1/NFI-CCM-WASH/NGO/15051,3/26/2021 8:26:03 AM,Internally Displaced People,570,690,870,870,3000,407,553,674,716,2350
70,Syria Cross border,2020,TUR-20/3559/RA1/NFI-CCM-WASH/NGO/15051,3/26/2021 8:26:03 AM,Overall,570,690,870,870,3000,407,553,674,716,2350
70,Syria Cross border,2020,TUR-20/3559/RA1/NFI-P/NGO/15043,2/8/2021 12:12:44 PM,Host Communities,219,2233,179,608,3239,89,845,11,185,1130
70,Syria Cross border,2020,TUR-20/3559/RA1/NFI-P/NGO/15043,2/8/2021 12:12:44 PM,Internally Displaced People,2265,5608,2375,2987,13235,4377,8207,4074,4117,20775
70,Syria Cross border,2020,TUR-20/3559/RA1/NFI-P/NGO/15043,2/8/2021 12:12:44 PM,Overall,2484,7841,2554,3595,16474,4466,9052,4085,4302,21905
70,Syria Cross border,2020,TUR-20/3559/RA1/NFI-WASH/NGO/14994,10/23/2020 7:10:32 AM,Host Communities,424,587,516,537,2064,534,680,576,629,2419
70,Syria Cross border,2020,TUR-20/3559/RA1/NFI-WASH/NGO/14994,10/23/2020 7:10:32 AM,Internally Displaced People,5628,6908,6396,6652,25584,6500,7615,6930,7099,28144
70,Syria Cross border,2020,TUR-20/3559/RA1/NFI-WASH/NGO/14994,10/23/2020 7:10:32 AM,Overall,6052,7495,6912,7189,27648,7034,8295,7506,7728,30563
70,Syria Cross border,2020,TUR-20/3559/RA1/NFI-WASH/UN/14986,4/16/2021 1:08:53 PM,Internally Displaced People,12079,12899,17528,17617,60123,11010,10202,14727,14189,50128
70,Syria Cross border,2020,TUR-20/3559/RA1/NFI-WASH/UN/14986,4/16/2021 1:08:53 PM,Overall,12079,12899,17528,17617,60123,11010,10202,14727,14189,50128
70,Syria Cross border,2020,TUR-20/3559/RA1/NFI-WASH-CCM/INGO/15021,1/18/2021 7:18:43 AM,Internally Displaced People,1770,2180,2598,2452,9000,957,1216,1529,1350,5052
70,Syria Cross border,2020,TUR-20/3559/RA1/NFI-WASH-CCM/INGO/15021,1/18/2021 7:18:43 AM,Overall,1770,2180,2598,2452,9000,957,1216,1529,1350,5052
70,Syria Cross border,2020,TUR-20/3559/RA1/P/NGO/14978,5/22/2021 4:08:22 PM,Internally Displaced People,3070,8320,12700,16630,40720,4680,11763,13666,17610,47719
70,Syria Cross border,2020,TUR-20/3559/RA1/P/NGO/14978,5/22/2021 4:08:22 PM,Overall,3070,8320,12700,16630,40720,4680,11763,13666,17610,47719
70,Syria Cross border,2020,TUR-20/3559/RA1/P/NGO/14995,5/22/2021 4:13:04 PM,Host Communities,825,1045,654,784,3308,4910,8550,8534,10020,32014
70,Syria Cross border,2020,TUR-20/3559/RA1/P/NGO/14995,5/22/2021 4:13:04 PM,Internally Displaced People,16953,22130,12222,16837,68142,7366,12824,12800,14031,47021
70,Syria Cross border,2020,TUR-20/3559/RA1/P/NGO/14995,5/22/2021 4:13:04 PM,Overall,17778,23175,12876,17621,71450,12276,21374,21334,24051,79035
70,Syria Cross border,2020,TUR-20/3559/RA1/P/UN/14977,12/14/2021 9:44:19 AM,Internally Displaced People,0,165908,0,52392,218300,0,176770,0,55826,232596
70,Syria Cross border,2020,TUR-20/3559/RA1/P/UN/14977,12/14/2021 9:44:19 AM,Overall,0,165908,0,52392,218300,0,176770,0,55826,232596
70,Syria Cross border,2020,TUR-20/3559/RA1/P-N/NGO/14983,2/25/2021 7:53:08 AM,Host Communities,65,208,243,243,759,6,10,0,0,16
70,Syria Cross border,2020,TUR-20/3559/RA1/P-N/NGO/14983,2/25/2021 7:53:08 AM,Internally Displaced People,1235,3953,4607,4608,14403,1404,6700,7026,7942,23072
70,Syria Cross border,2020,TUR-20/3559/RA1/P-N/NGO/14983,2/25/2021 7:53:08 AM,Overall,1300,4161,4850,4851,15162,1410,6710,7026,7942,23088
70,Syria Cross border,2020,TUR-20/3559/RA1/P-NFI/NGO/15016,6/17/2021 1:32:13 PM,Internally Displaced People,11994,14266,10055,13624,49939,2843,3209,4294,3382,13728
70,Syria Cross border,2020,TUR-20/3559/RA1/P-NFI/NGO/15016,6/17/2021 1:32:13 PM,Overall,11994,14266,10055,13624,49939,2843,3209,4294,3382,13728
70,Syria Cross border,2020,TUR-20/3559/RA1/WASH/INGO/15004,10/22/2020 5:49:54 AM,Internally Displaced People,1791,1922,1400,1400,6513,1553,2187,1572,1667,6979
70,Syria Cross border,2020,TUR-20/3559/RA1/WASH/INGO/15004,10/22/2020 5:49:54 AM,Overall,1791,1922,1400,1400,6513,1553,2187,1572,1667,6979
70,Syria Cross border,2020,TUR-20/3559/RA1/WASH/INGO/15038,2/8/2021 2:05:58 PM,Host Communities,19944,22052,25764,23890,91650,32685,35998,42061,39004,149748
70,Syria Cross border,2020,TUR-20/3559/RA1/WASH/INGO/15038,2/8/2021 2:05:58 PM,Internally Displaced People,10739,11874,13873,12864,49350,17409,19390,22654,21004,80457
70,Syria Cross border,2020,TUR-20/3559/RA1/WASH/INGO/15038,2/8/2021 2:05:58 PM,Overall,30683,33926,39637,36754,141000,50094,55388,64715,60008,230205
70,Syria Cross border,2020,TUR-20/3559/RA1/WASH/NGO/14967,1/21/2021 11:48:26 AM,Internally Displaced People,4708,4927,5133,6634,21402,4708,4929,5133,6653,21423
70,Syria Cross border,2020,TUR-20/3559/RA1/WASH/NGO/14967,1/21/2021 11:48:26 AM,Overall,4708,4927,5133,6634,21402,4708,4929,5133,6653,21423
70,Syria Cross border,2020,TUR-20/3559/RA1/WASH/NGO/14973,12/2/2020 12:31:39 PM,Host Communities,3015,3119,5878,6091,18103,3015,3119,5878,6091,18103
70,Syria Cross border,2020,TUR-20/3559/RA1/WASH/NGO/14973,12/2/2020 12:31:39 PM,Internally Displaced People,3976,4125,7707,8071,23879,3976,4125,7707,8071,23879
70,Syria Cross border,2020,TUR-20/3559/RA1/WASH/NGO/14973,12/2/2020 12:31:39 PM,Overall,6991,7244,13585,14162,41982,6991,7244,13585,14162,41982
70,Syria Cross border,2020,TUR-20/3559/RA1/WASH/NGO/15014,12/14/2020 7:43:40 AM,Internally Displaced People,6099,6372,8300,8237,29008,5168,5771,10923,9533,31395
70,Syria Cross border,2020,TUR-20/3559/RA1/WASH/NGO/15014,12/14/2020 7:43:40 AM,Overall,6099,6372,8300,8237,29008,5168,5771,10923,9533,31395
70,Syria Cross border,2020,TUR-20/3559/RA1/WASH/NGO/15030,1/18/2021 6:26:57 AM,Host Communities,34516,36084,42360,43930,156890,39387,41178,48338,50129,179032
70,Syria Cross border,2020,TUR-20/3559/RA1/WASH/NGO/15030,1/18/2021 6:26:57 AM,Internally Displaced People,23492,24559,28831,29899,106781,34297,35856,42092,43651,155896
70,Syria Cross border,2020,TUR-20/3559/RA1/WASH/NGO/15030,1/18/2021 6:26:57 AM,Overall,58008,60643,71191,73829,263671,73684,77034,90430,93780,334928
70,Syria Cross border,2020,TUR-20/3559/RA1/WASH/NGO/15040,1/20/2021 6:58:03 AM,Host Communities,18150,20250,17405,16850,72655,18520,19850,17611,17455,73436
70,Syria Cross border,2020,TUR-20/3559/RA1/WASH/NGO/15040,1/20/2021 6:58:03 AM,Internally Displaced People,11203,13740,12905,13180,51028,12758,16164,11651,13823,54396
70,Syria Cross border,2020,TUR-20/3559/RA1/WASH/NGO/15040,1/20/2021 6:58:03 AM,Overall,29353,33990,30310,30030,123683,31278,36014,29262,31278,127832
70,Syria Cross border,2020,TUR-20/3559/RA1/WASH/NGO/15042,2/18/2021 7:39:05 AM,Internally Displaced People,4222,4738,5915,5928,20803,4690,5736,8482,7943,26851
70,Syria Cross border,2020,TUR-20/3559/RA1/WASH/NGO/15042,2/18/2021 7:39:05 AM,Overall,4222,4738,5915,5928,20803,4690,5736,8482,7943,26851
70,Syria Cross border,2020,TUR-20/3559/RA1/WASH/NGO/15047,12/3/2020 1:31:52 PM,Host Communities,124,128,82,86,420,0,0,0,0,0
70,Syria Cross border,2020,TUR-20/3559/RA1/WASH/NGO/15047,12/3/2020 1:31:52 PM,Internally Displaced People,1115,1153,741,771,3780,1116,949,1431,1192,4688
70,Syria Cross border,2020,TUR-20/3559/RA1/WASH/NGO/15047,12/3/2020 1:31:52 PM,Overall,1239,1281,823,857,4200,1116,949,1431,1192,4688
70,Syria Cross border,2020,TUR-20/3559/RA1/WASH-P/NGO/15022,4/9/2021 7:37:55 AM,Host Communities,494,585,1024,951,3054,638,1319,1713,1851,5521
70,Syria Cross border,2020,TUR-20/3559/RA1/WASH-P/NGO/15022,4/9/2021 7:37:55 AM,Internally Displaced People,8800,14294,22239,22232,67565,9791,16555,25430,26025,77801
70,Syria Cross border,2020,TUR-20/3559/RA1/WASH-P/NGO/15022,4/9/2021 7:37:55 AM,Overall,9294,14879,23263,23183,70619,10429,17874,27143,27876,83322
70,Syria Cross border,2020,TUR-20/3559/RA2/H/INGO/15992,9/30/2021 6:57:31 AM,Host Communities,300,240,30,30,600,467,308,61,30,866
70,Syria Cross border,2020,TUR-20/3559/RA2/H/INGO/15992,9/30/2021 6:57:31 AM,Internally Displaced People,450,360,45,45,900,451,403,102,78,1034
70,Syria Cross border,2020,TUR-20/3559/RA2/H/INGO/15992,9/30/2021 6:57:31 AM,Overall,750,600,75,75,1500,918,711,163,108,1900
70,Syria Cross border,2020,TUR-20/3559/RA2/H/INGO/15994,2/14/2021 6:49:09 PM,Host Communities,414,414,518,725,2071,1096,621,99,86,1902
70,Syria Cross border,2020,TUR-20/3559/RA2/H/INGO/15994,2/14/2021 6:49:09 PM,Internally Displaced People,146,146,182,255,729,525,306,79,68,978
70,Syria Cross border,2020,TUR-20/3559/RA2/H/INGO/15994,2/14/2021 6:49:09 PM,Overall,560,560,700,980,2800,1621,927,178,154,2880
70,Syria Cross border,2020,TUR-20/3559/RA2/H/INGO/16441,3/30/2021 1:49:12 PM,Host Communities,465,305,63,56,889,645,208,2,1,856
70,Syria Cross border,2020,TUR-20/3559/RA2/H/INGO/16441,3/30/2021 1:49:12 PM,Internally Displaced People,338,226,48,43,655,376,175,1,1,553
70,Syria Cross border,2020,TUR-20/3559/RA2/H/INGO/16441,3/30/2021 1:49:12 PM,Overall,803,531,111,99,1544,1021,383,3,2,1409
70,Syria Cross border,2020,TUR-20/3559/RA2/H/NGO/15990,1/19/2022 11:35:26 AM,Host Communities,475,285,44,15,819,707,415,88,54,1264
70,Syria Cross border,2020,TUR-20/3559/RA2/H/NGO/15990,1/19/2022 11:35:26 AM,Internally Displaced People,670,415,65,20,1170,1231,723,152,94,2200
70,Syria Cross border,2020,TUR-20/3559/RA2/H/NGO/15990,1/19/2022 11:35:26 AM,Overall,1145,700,109,35,1989,1938,1138,240,148,3464
70,Syria Cross border,2020,TUR-20/3559/RA2/H/NGO/15991,3/24/2021 1:06:14 PM,Host Communities,550,250,40,40,880,655,260,62,41,1018
70,Syria Cross border,2020,TUR-20/3559/RA2/H/NGO/15991,3/24/2021 1:06:14 PM,Internally Displaced People,150,150,10,10,320,915,444,102,71,1532
70,Syria Cross border,2020,TUR-20/3559/RA2/H/NGO/15991,3/24/2021 1:06:14 PM,Overall,700,400,50,50,1200,1570,704,164,112,2550
70,Syria Cross border,2020,TUR-20/3559/RA2/H/NGO/15995,5/22/2021 4:20:03 PM,Host Communities,219,147,18,16,400,145,105,11,10,271
70,Syria Cross border,2020,TUR-20/3559/RA2/H/NGO/15995,5/22/2021 4:20:03 PM,Internally Displaced People,438,294,36,32,800,173,97,3,1,274
70,Syria Cross border,2020,TUR-20/3559/RA2/H/NGO/15995,5/22/2021 4:20:03 PM,Overall,657,441,54,48,1200,318,202,14,11,545
70,Syria Cross border,2020,TUR-20/3559/RA2/H/NGO/16030,6/1/2021 1:17:08 PM,Host Communities,125,150,85,140,500,1528,890,219,102,2739
70,Syria Cross border,2020,TUR-20/3559/RA2/H/NGO/16030,6/1/2021 1:17:08 PM,Internally Displaced People,125,150,85,140,500,143,47,44,29,263
70,Syria Cross border,2020,TUR-20/3559/RA2/H/NGO/16030,6/1/2021 1:17:08 PM,Overall,250,300,170,280,1000,1671,937,263,131,3002
70,Syria Cross border,2020,TUR-20/3559/RA2/H/O/15993,6/24/2021 1:17:23 PM,Host Communities,500,500,0,0,1000,500,500,0,0,1000
70,Syria Cross border,2020,TUR-20/3559/RA2/H/O/15993,6/24/2021 1:17:23 PM,Overall,500,500,0,0,1000,500,500,0,0,1000
70,Syria Cross border,2020,TUR-20/3559/RA2/H/O/16565,2/24/2021 1:46:56 PM,Other,8,0,0,0,8,8,0,0,0,8
70,Syria Cross border,2020,TUR-20/3559/RA2/H/O/16565,2/24/2021 1:46:56 PM,Overall,8,0,0,0,8,8,0,0,0,8
70,Syria Cross border,2020,TUR-20/3559/RA2/H/UN/15728,8/10/2021 8:43:44 AM,Host Communities,816672,1029717,745657,958701,3550747,367116,398157,470141,417758,1653172
70,Syria Cross border,2020,TUR-20/3559/RA2/H/UN/15728,8/10/2021 8:43:44 AM,Internally Displaced People,305138,384739,278604,358204,1326685,550676,597236,705212,626637,2479761
70,Syria Cross border,2020,TUR-20/3559/RA2/H/UN/15728,8/10/2021 8:43:44 AM,Overall,1121810,1414456,1024261,1316905,4877432,917792,995393,1175353,1044395,4132933
70,Syria Cross border,2020,TUR-20/3559/RA3/ER/UN/17205,9/15/2021 10:58:15 AM,Host Communities,19622,25658,52310,53345,150935,19622,25658,52310,53345,150935
70,Syria Cross border,2020,TUR-20/3559/RA3/ER/UN/17205,9/15/2021 10:58:15 AM,Internally Displaced People,57596,75319,144359,165775,443049,57596,75319,144359,165775,443049
70,Syria Cross border,2020,TUR-20/3559/RA3/ER/UN/17205,9/15/2021 10:58:15 AM,Overall,83976,109813,214122,238052,645963,83976,109813,214122,238052,645963
70,Syria Cross border,2020,TUR-20/3559/RA3/ER/UN/17205,9/15/2021 10:58:15 AM,Returnees,6758,8836,17453,18932,51979,6758,8836,17453,18932,51979
70,Syria Cross border,2020,TUR-20/3559/RAUNDSS/CCS/UN/15737,6/21/2022 1:57:27 PM,Host Communities,300000,1000000,750000,1000000,3050000,1,1,1,1,4
70,Syria Cross border,2020,TUR-20/3559/RAUNDSS/CCS/UN/15737,6/21/2022 1:57:27 PM,Internally Displaced People,50000,400000,250000,250000,950000,1,1,1,1,4
70,Syria Cross border,2020,TUR-20/3559/RAUNDSS/CCS/UN/15737,6/21/2022 1:57:27 PM,Overall,350000,1400000,1000000,1250000,4000000,2,2,2,2,8
70,Syria Cross border,2020,TUR-20/3559/SA1/CCM/NGO/16394,5/24/2021 1:11:25 PM,Internally Displaced People,4254,4595,7068,8243,24160,4711,5606,6970,8441,25728
70,Syria Cross border,2020,TUR-20/3559/SA1/CCM/NGO/16394,5/24/2021 1:11:25 PM,Overall,4254,4595,7068,8243,24160,4711,5606,6970,8441,25728
70,Syria Cross border,2020,TUR-20/3559/SA1/CCM-FS-WASH/NGO/16342,11/10/2021 10:47:15 AM,Internally Displaced People,6389,6666,9248,9293,31596,3516,4768,7970,7796,24050
70,Syria Cross border,2020,TUR-20/3559/SA1/CCM-FS-WASH/NGO/16342,11/10/2021 10:47:15 AM,Overall,6389,6666,9248,9293,31596,3516,4768,7970,7796,24050
70,Syria Cross border,2020,TUR-20/3559/SA1/CCM-NFI-P-WASH/UN/16172,2/25/2022 12:05:25 PM,Host Communities,3011,3538,2379,2445,11373,2710,3025,2205,2166,10106
70,Syria Cross border,2020,TUR-20/3559/SA1/CCM-NFI-P-WASH/UN/16172,2/25/2022 12:05:25 PM,Internally Displaced People,13875,17460,21635,20484,73454,18492,22741,24191,23113,88537
70,Syria Cross border,2020,TUR-20/3559/SA1/CCM-NFI-P-WASH/UN/16172,2/25/2022 12:05:25 PM,Overall,16886,20998,24014,22929,84827,21202,25766,26396,25279,98643
70,Syria Cross border,2020,TUR-20/3559/SA1/CCS/NGO/16384,6/22/2021 8:51:12 AM,Host Communities,2500,2500,1200,1200,7400,2505,2505,1200,1200,7410
70,Syria Cross border,2020,TUR-20/3559/SA1/CCS/NGO/16384,6/22/2021 8:51:12 AM,Internally Displaced People,2500,2500,1200,1000,7200,2500,2500,1200,1000,7200
70,Syria Cross border,2020,TUR-20/3559/SA1/CCS/NGO/16384,6/22/2021 8:51:12 AM,Overall,5200,5200,2650,2450,15500,5205,5205,2653,2453,15516
70,Syria Cross border,2020,TUR-20/3559/SA1/CCS/NGO/16384,6/22/2021 8:51:12 AM,Returnees,200,200,250,250,900,200,200,253,253,906
70,Syria Cross border,2020,TUR-20/3559/SA1/CCS/UN/16174,3/8/2022 11:24:59 AM,Other,360,240,0,0,600,229,135,0,0,364
70,Syria Cross border,2020,TUR-20/3559/SA1/CCS/UN/16174,3/8/2022 11:24:59 AM,Overall,360,240,0,0,600,229,135,0,0,364
70,Syria Cross border,2020,TUR-20/3559/SA1/E/INGO/16280,7/30/2021 10:34:00 AM,Host Communities,95,149,1477,2198,3919,83,163,1363,1964,3573
70,Syria Cross border,2020,TUR-20/3559/SA1/E/INGO/16280,7/30/2021 10:34:00 AM,Internally Displaced People,0,0,440,676,1116,0,0,778,990,1768
70,Syria Cross border,2020,TUR-20/3559/SA1/E/INGO/16280,7/30/2021 10:34:00 AM,Overall,95,149,1917,2874,5035,83,163,2141,2954,5341
70,Syria Cross border,2020,TUR-20/3559/SA1/E/NGO/16153,9/16/2021 11:30:02 AM,Host Communities,44,34,333,416,827,20,22,378,391,811
70,Syria Cross border,2020,TUR-20/3559/SA1/E/NGO/16153,9/16/2021 11:30:02 AM,Internally Displaced People,153,125,2935,3673,6886,199,132,3949,4095,8375
70,Syria Cross border,2020,TUR-20/3559/SA1/E/NGO/16153,9/16/2021 11:30:02 AM,Overall,197,159,3268,4089,7713,219,154,4327,4486,9186
70,Syria Cross border,2020,TUR-20/3559/SA1/E/NGO/16157,9/29/2021 12:11:20 PM,Host Communities,120,120,2710,2650,5600,119,170,2700,2745,5734
70,Syria Cross border,2020,TUR-20/3559/SA1/E/NGO/16157,9/29/2021 12:11:20 PM,Internally Displaced People,180,180,4065,3975,8400,120,200,3443,4535,8298
70,Syria Cross border,2020,TUR-20/3559/SA1/E/NGO/16157,9/29/2021 12:11:20 PM,Overall,300,300,6775,6625,14000,239,370,6143,7280,14032
70,Syria Cross border,2020,TUR-20/3559/SA1/E/NGO/16191,10/25/2021 7:46:19 AM,Host Communities,110,74,1679,2418,4281,64,75,1917,2502,4558
70,Syria Cross border,2020,TUR-20/3559/SA1/E/NGO/16191,10/25/2021 7:46:19 AM,Internally Displaced People,227,151,4431,5360,10169,189,249,6148,7011,13597
70,Syria Cross border,2020,TUR-20/3559/SA1/E/NGO/16191,10/25/2021 7:46:19 AM,Overall,337,225,6110,7778,14450,253,324,8065,9513,18155
70,Syria Cross border,2020,TUR-20/3559/SA1/E/NGO/16195,9/6/2021 8:32:56 AM,Host Communities,115,89,2408,2516,5128,71,115,2075,1804,4065
70,Syria Cross border,2020,TUR-20/3559/SA1/E/NGO/16195,9/6/2021 8:32:56 AM,Internally Displaced People,67,46,1155,1185,2453,102,48,2159,1691,4000
70,Syria Cross border,2020,TUR-20/3559/SA1/E/NGO/16195,9/6/2021 8:32:56 AM,Overall,193,144,3816,3954,8107,173,163,4234,3495,8065
70,Syria Cross border,2020,TUR-20/3559/SA1/E/NGO/16195,9/6/2021 8:32:56 AM,Returnees,11,9,253,253,526,0,0,0,0,0
70,Syria Cross border,2020,TUR-20/3559/SA1/E/NGO/16212,10/13/2021 9:59:17 AM,Host Communities,68,69,2767,3091,5995,72,73,2668,2170,4983
70,Syria Cross border,2020,TUR-20/3559/SA1/E/NGO/16212,10/13/2021 9:59:17 AM,Internally Displaced People,64,52,2036,2084,4236,93,63,2398,1990,4544
70,Syria Cross border,2020,TUR-20/3559/SA1/E/NGO/16212,10/13/2021 9:59:17 AM,Overall,132,121,4803,5175,10231,165,136,5066,4160,9527
70,Syria Cross border,2020,TUR-20/3559/SA1/E/NGO/16219,10/19/2021 12:12:12 PM,Host Communities,523,677,2524,1806,5530,4069,4882,6147,5965,21063
70,Syria Cross border,2020,TUR-20/3559/SA1/E/NGO/16219,10/19/2021 12:12:12 PM,Internally Displaced People,784,1015,3799,2710,8308,2713,3256,9224,8954,24147
70,Syria Cross border,2020,TUR-20/3559/SA1/E/NGO/16219,10/19/2021 12:12:12 PM,Overall,1307,1692,6323,4516,13838,6782,8138,15371,14919,45210
70,Syria Cross border,2020,TUR-20/3559/SA1/E/NGO/16228,10/19/2021 11:22:53 AM,Internally Displaced People,219,176,6116,6399,12910,250,145,8405,9081,17881
70,Syria Cross border,2020,TUR-20/3559/SA1/E/NGO/16228,10/19/2021 11:22:53 AM,Overall,219,176,6116,6399,12910,250,145,8405,9081,17881
70,Syria Cross border,2020,TUR-20/3559/SA1/E/NGO/16300,10/25/2021 7:29:36 AM,Host Communities,161,116,4007,4518,8802,106,123,3987,4581,8797
70,Syria Cross border,2020,TUR-20/3559/SA1/E/NGO/16300,10/25/2021 7:29:36 AM,Internally Displaced People,107,78,2671,3012,5868,171,93,3430,3351,7045
70,Syria Cross border,2020,TUR-20/3559/SA1/E/NGO/16300,10/25/2021 7:29:36 AM,Overall,268,194,6678,7530,14670,277,216,7417,7932,15842
70,Syria Cross border,2020,TUR-20/3559/SA1/E-P/INGO/16298,10/22/2021 11:32:41 AM,Host Communities,322,512,765,1045,2644,753,723,1473,1806,4755
70,Syria Cross border,2020,TUR-20/3559/SA1/E-P/INGO/16298,10/22/2021 11:32:41 AM,Internally Displaced People,788,1038,1830,2110,5766,743,770,1662,1802,4977
70,Syria Cross border,2020,TUR-20/3559/SA1/E-P/INGO/16298,10/22/2021 11:32:41 AM,Overall,1110,1550,2595,3155,8410,1496,1493,3135,3608,9732
70,Syria Cross border,2020,TUR-20/3559/SA1/E-P/NGO/16209,8/17/2021 2:52:52 PM,Host Communities,34,21,277,245,577,21,16,314,325,676
70,Syria Cross border,2020,TUR-20/3559/SA1/E-P/NGO/16209,8/17/2021 2:52:52 PM,Internally Displaced People,160,113,4203,4250,8726,222,151,6561,6435,13369
70,Syria Cross border,2020,TUR-20/3559/SA1/E-P/NGO/16209,8/17/2021 2:52:52 PM,Overall,194,134,4480,4495,9303,243,167,6875,6760,14045
70,Syria Cross border,2020,TUR-20/3559/SA1/ER/NGO/16159,8/4/2021 8:25:22 AM,Internally Displaced People,1149,1417,1756,1618,5940,42808,54275,35566,45265,177914
70,Syria Cross border,2020,TUR-20/3559/SA1/ER/NGO/16159,8/4/2021 8:25:22 AM,Overall,1149,1417,1756,1618,5940,42808,54275,35566,45265,177914
70,Syria Cross border,2020,TUR-20/3559/SA1/ER/NGO/16190,8/18/2021 9:15:33 AM,Host Communities,3947,4118,5148,3949,17162,3947,4118,5148,3949,17162
70,Syria Cross border,2020,TUR-20/3559/SA1/ER/NGO/16190,8/18/2021 9:15:33 AM,Internally Displaced People,5921,6179,7722,5920,25742,5921,6179,7722,5920,25742
70,Syria Cross border,2020,TUR-20/3559/SA1/ER/NGO/16190,8/18/2021 9:15:33 AM,Overall,9868,10297,12870,9869,42904,9868,10297,12870,9869,42904
70,Syria Cross border,2020,TUR-20/3559/SA1/ER/NGO/16246,9/10/2021 11:02:12 AM,Host Communities,7749,8109,9010,11173,36041,7449,8109,9010,11173,35741
70,Syria Cross border,2020,TUR-20/3559/SA1/ER/NGO/16246,9/10/2021 11:02:12 AM,Internally Displaced People,10005,10470,11634,14426,46535,11149,11442,12726,15602,50919
70,Syria Cross border,2020,TUR-20/3559/SA1/ER/NGO/16246,9/10/2021 11:02:12 AM,Overall,17754,18579,20644,25599,82576,18598,19551,21736,26775,86660
70,Syria Cross border,2020,TUR-20/3559/SA1/ER/UN/16248,12/2/2021 11:23:17 AM,Host Communities,724,721,960,961,3366,7517,7552,11290,11314,37673
70,Syria Cross border,2020,TUR-20/3559/SA1/ER/UN/16248,12/2/2021 11:23:17 AM,Internally Displaced People,906,915,1458,1453,4732,1718,1718,2570,2577,8583
70,Syria Cross border,2020,TUR-20/3559/SA1/ER/UN/16248,12/2/2021 11:23:17 AM,Overall,6562,6565,8955,8950,31032,9251,9286,13882,13917,46336
70,Syria Cross border,2020,TUR-20/3559/SA1/ER/UN/16248,12/2/2021 11:23:17 AM,Returnees,4932,4929,6537,6536,22934,16,16,22,26,80
70,Syria Cross border,2020,TUR-20/3559/SA1/ER-FS/NGO/16327,5/6/2021 12:31:52 PM,Host Communities,2082,2499,1416,2332,8329,622,881,1096,1046,3645
70,Syria Cross border,2020,TUR-20/3559/SA1/ER-FS/NGO/16327,5/6/2021 12:31:52 PM,Internally Displaced People,1121,1346,762,1257,4486,1727,2533,3380,3490,11130
70,Syria Cross border,2020,TUR-20/3559/SA1/ER-FS/NGO/16327,5/6/2021 12:31:52 PM,Overall,3203,3845,2178,3589,12815,2349,3414,4476,4536,14775
70,Syria Cross border,2020,TUR-20/3559/SA1/FS/INGO/16283,10/8/2021 11:53:21 AM,Host Communities,326,530,888,1133,2877,1182,1492,1782,1763,6219
70,Syria Cross border,2020,TUR-20/3559/SA1/FS/INGO/16283,10/8/2021 11:53:21 AM,Internally Displaced People,259,457,739,813,2268,540,696,675,733,2644
70,Syria Cross border,2020,TUR-20/3559/SA1/FS/INGO/16283,10/8/2021 11:53:21 AM,Other,25,23,62,76,186,77,36,98,80,291
70,Syria Cross border,2020,TUR-20/3559/SA1/FS/INGO/16283,10/8/2021 11:53:21 AM,Overall,610,1010,1689,2022,5331,1799,2224,2555,2576,9154
70,Syria Cross border,2020,TUR-20/3559/SA1/FS/INGO/16373,9/1/2021 9:44:58 AM,Host Communities,740,814,999,1147,3700,1319,1408,1119,1103,4949
70,Syria Cross border,2020,TUR-20/3559/SA1/FS/INGO/16373,9/1/2021 9:44:58 AM,Internally Displaced People,986,1085,1331,1528,4930,3795,3778,4008,3970,15551
70,Syria Cross border,2020,TUR-20/3559/SA1/FS/INGO/16373,9/1/2021 9:44:58 AM,Overall,2466,2713,3329,3822,12330,5114,5186,5127,5073,20500
70,Syria Cross border,2020,TUR-20/3559/SA1/FS/INGO/16373,9/1/2021 9:44:58 AM,Returnees,740,814,999,1147,3700,0,0,0,0,0
70,Syria Cross border,2020,TUR-20/3559/SA1/FS/NGO/16149,5/24/2021 9:56:15 AM,Host Communities,1072,1128,1365,1435,5000,1494,1712,1620,1541,6367
70,Syria Cross border,2020,TUR-20/3559/SA1/FS/NGO/16149,5/24/2021 9:56:15 AM,Internally Displaced People,2467,2593,3140,3300,11500,2400,2660,3858,3569,12487
70,Syria Cross border,2020,TUR-20/3559/SA1/FS/NGO/16149,5/24/2021 9:56:15 AM,Overall,3539,3721,4505,4735,16500,3894,4372,5478,5110,18854
70,Syria Cross border,2020,TUR-20/3559/SA1/FS/NGO/16162,3/18/2021 12:17:06 PM,Internally Displaced People,1758,2463,2975,3090,10286,1776,2724,2990,3145,10635
70,Syria Cross border,2020,TUR-20/3559/SA1/FS/NGO/16162,3/18/2021 12:17:06 PM,Overall,1758,2463,2975,3090,10286,1776,2724,2990,3145,10635
70,Syria Cross border,2020,TUR-20/3559/SA1/FS/NGO/16169,8/27/2021 9:53:32 AM,Host Communities,726,858,825,891,3300,831,855,1121,1000,3807
70,Syria Cross border,2020,TUR-20/3559/SA1/FS/NGO/16169,8/27/2021 9:53:32 AM,Internally Displaced People,1212,1430,1375,1485,5502,1075,1497,1725,1628,5925
70,Syria Cross border,2020,TUR-20/3559/SA1/FS/NGO/16169,8/27/2021 9:53:32 AM,Overall,1938,2288,2200,2376,8802,1906,2352,2846,2628,9732
70,Syria Cross border,2020,TUR-20/3559/SA1/FS/NGO/16192,10/11/2021 9:26:56 AM,Host Communities,1380,1503,1800,1380,6063,2133,2534,2579,2570,9816
70,Syria Cross border,2020,TUR-20/3559/SA1/FS/NGO/16192,10/11/2021 9:26:56 AM,Internally Displaced People,345,549,450,345,1689,133,382,521,610,1646
70,Syria Cross border,2020,TUR-20/3559/SA1/FS/NGO/16192,10/11/2021 9:26:56 AM,Overall,1725,2052,2250,1725,7752,2266,2916,3100,3180,11462
70,Syria Cross border,2020,TUR-20/3559/SA1/FS/NGO/16221,10/13/2021 1:14:21 PM,Host Communities,3618,3988,5231,4885,17722,3324,3669,4808,4474,16275
70,Syria Cross border,2020,TUR-20/3559/SA1/FS/NGO/16221,10/13/2021 1:14:21 PM,Internally Displaced People,2001,2448,3454,3425,11328,2001,2448,3454,3425,11328
70,Syria Cross border,2020,TUR-20/3559/SA1/FS/NGO/16221,10/13/2021 1:14:21 PM,Overall,5619,6436,8685,8310,29050,5325,6117,8262,7899,27603
70,Syria Cross border,2020,TUR-20/3559/SA1/FS/NGO/16222,10/21/2021 8:02:43 AM,Host Communities,617,165,0,0,782,647,131,0,0,778
70,Syria Cross border,2020,TUR-20/3559/SA1/FS/NGO/16222,10/21/2021 8:02:43 AM,Internally Displaced People,2439,2525,3105,3279,11348,2555,2682,3209,3308,11754
70,Syria Cross border,2020,TUR-20/3559/SA1/FS/NGO/16222,10/21/2021 8:02:43 AM,Overall,3229,2867,3334,3521,12951,3439,3075,3514,3654,13682
70,Syria Cross border,2020,TUR-20/3559/SA1/FS/NGO/16222,10/21/2021 8:02:43 AM,Returnees,173,177,229,242,821,237,262,305,346,1150
70,Syria Cross border,2020,TUR-20/3559/SA1/FS/NGO/16245,10/8/2021 11:41:06 AM,Host Communities,432,228,0,0,660,401,325,0,0,726
70,Syria Cross border,2020,TUR-20/3559/SA1/FS/NGO/16245,10/8/2021 11:41:06 AM,Internally Displaced People,743,397,0,0,1140,644,649,0,0,1293
70,Syria Cross border,2020,TUR-20/3559/SA1/FS/NGO/16245,10/8/2021 11:41:06 AM,Overall,1175,625,0,0,1800,1045,974,0,0,2019
70,Syria Cross border,2020,TUR-20/3559/SA1/FS/NGO/16255,11/22/2021 7:51:20 AM,Host Communities,4668,4858,2741,2853,15120,2612,2789,3833,3641,12875
70,Syria Cross border,2020,TUR-20/3559/SA1/FS/NGO/16255,11/22/2021 7:51:20 AM,Internally Displaced People,2454,2554,1441,1500,7949,3271,3739,6021,5451,18482
70,Syria Cross border,2020,TUR-20/3559/SA1/FS/NGO/16255,11/22/2021 7:51:20 AM,Overall,9585,9976,5629,5859,31049,7497,8220,12141,11027,38885
70,Syria Cross border,2020,TUR-20/3559/SA1/FS/NGO/16255,11/22/2021 7:51:20 AM,Returnees,2463,2564,1447,1506,7980,1614,1692,2287,1935,7528
70,Syria Cross border,2020,TUR-20/3559/SA1/FS/NGO/16261,1/13/2022 6:25:05 AM,Host Communities,881,135,0,0,1016,1056,180,0,0,1236
70,Syria Cross border,2020,TUR-20/3559/SA1/FS/NGO/16261,1/13/2022 6:25:05 AM,Internally Displaced People,220,43,0,0,263,445,56,0,0,501
70,Syria Cross border,2020,TUR-20/3559/SA1/FS/NGO/16261,1/13/2022 6:25:05 AM,Overall,1336,214,0,0,1550,1501,236,0,0,1737
70,Syria Cross border,2020,TUR-20/3559/SA1/FS/NGO/16261,1/13/2022 6:25:05 AM,Returnees,235,36,0,0,271,0,0,0,0,0
70,Syria Cross border,2020,TUR-20/3559/SA1/FS/NGO/16318,7/20/2021 8:00:42 AM,Internally Displaced People,4500,3000,6750,4500,18750,5064,5713,8132,7869,26778
70,Syria Cross border,2020,TUR-20/3559/SA1/FS/NGO/16318,7/20/2021 8:00:42 AM,Overall,4500,3000,6750,4500,18750,5064,5713,8132,7869,26778
70,Syria Cross border,2020,TUR-20/3559/SA1/FS/NGO/16323,11/8/2021 9:56:20 AM,Host Communities,2818,2932,3180,3288,12218,3480,4249,6326,5958,20013
70,Syria Cross border,2020,TUR-20/3559/SA1/FS/NGO/16323,11/8/2021 9:56:20 AM,Internally Displaced People,4366,4538,4914,5095,18913,3785,4811,7496,7198,23290
70,Syria Cross border,2020,TUR-20/3559/SA1/FS/NGO/16323,11/8/2021 9:56:20 AM,Overall,7184,7470,8094,8383,31131,7265,9060,13822,13156,43303
70,Syria Cross border,2020,TUR-20/3559/SA1/FS/NGO/16351,6/10/2021 5:57:45 PM,Internally Displaced People,8879,10319,10836,13187,43221,9115,10421,14668,13289,47493
70,Syria Cross border,2020,TUR-20/3559/SA1/FS/NGO/16351,6/10/2021 5:57:45 PM,Overall,8879,10319,10836,13187,43221,9115,10421,14668,13289,47493
70,Syria Cross border,2020,TUR-20/3559/SA1/FS/NGO/16358,5/10/2021 6:46:18 AM,Internally Displaced People,7344,8366,10129,10166,36005,11040,12280,14104,13911,51335
70,Syria Cross border,2020,TUR-20/3559/SA1/FS/NGO/16358,5/10/2021 6:46:18 AM,Overall,7344,8366,10129,10166,36005,11040,12280,14104,13911,51335
70,Syria Cross border,2020,TUR-20/3559/SA1/FS/NGO/16360,8/27/2021 10:10:44 AM,Host Communities,2665,2908,3392,3150,12115,5625,5812,5225,5136,21798
70,Syria Cross border,2020,TUR-20/3559/SA1/FS/NGO/16360,8/27/2021 10:10:44 AM,Internally Displaced People,1814,1979,2309,2143,8245,1521,1784,2552,2497,8354
70,Syria Cross border,2020,TUR-20/3559/SA1/FS/NGO/16360,8/27/2021 10:10:44 AM,Overall,4479,4887,5701,5293,20360,7146,7596,7777,7633,30152
70,Syria Cross border,2020,TUR-20/3559/SA1/FS/NGO/16380,12/1/2021 1:03:31 PM,Internally Displaced People,4098,5143,6492,7447,23180,4697,5904,8025,8279,26905
70,Syria Cross border,2020,TUR-20/3559/SA1/FS/NGO/16380,12/1/2021 1:03:31 PM,Overall,4098,5143,6492,7447,23180,4697,5904,8025,8279,26905
70,Syria Cross border,2020,TUR-20/3559/SA1/FS/O/16386,11/1/2021 11:21:13 AM,Host Communities,1235,1380,1590,1613,5818,671,523,558,583,2335
70,Syria Cross border,2020,TUR-20/3559/SA1/FS/O/16386,11/1/2021 11:21:13 AM,Internally Displaced People,60,60,90,90,300,34,35,32,37,138
70,Syria Cross border,2020,TUR-20/3559/SA1/FS/O/16386,11/1/2021 11:21:13 AM,Overall,1295,1440,1680,1703,6118,705,558,590,620,2473
70,Syria Cross border,2020,TUR-20/3559/SA1/FS-NFI/NGO/16291,8/27/2021 9:25:27 AM,Host Communities,144,165,156,155,620,156,189,203,189,737
70,Syria Cross border,2020,TUR-20/3559/SA1/FS-NFI/NGO/16291,8/27/2021 9:25:27 AM,Internally Displaced People,1294,1484,1409,1393,5580,1004,1278,1819,1729,5830
70,Syria Cross border,2020,TUR-20/3559/SA1/FS-NFI/NGO/16291,8/27/2021 9:25:27 AM,Overall,1438,1649,1565,1548,6200,1160,1467,2022,1918,6567
70,Syria Cross border,2020,TUR-20/3559/SA1/FS-NFI/NGO/16353,7/19/2021 7:26:26 AM,Host Communities,963,1006,1181,1225,4375,1808,2531,1431,1408,7178
70,Syria Cross border,2020,TUR-20/3559/SA1/FS-NFI/NGO/16353,7/19/2021 7:26:26 AM,Internally Displaced People,4867,5089,6064,6105,22125,4540,5765,6527,6306,23138
70,Syria Cross border,2020,TUR-20/3559/SA1/FS-NFI/NGO/16353,7/19/2021 7:26:26 AM,Overall,5830,6095,7245,7330,26500,6348,8296,7958,7714,30316
70,Syria Cross border,2020,TUR-20/3559/SA1/FS-WASH-NFI/INGO/16181,10/19/2021 12:18:46 PM,Internally Displaced People,1179,1267,1191,1238,4875,1161,1539,1322,1719,5741
70,Syria Cross border,2020,TUR-20/3559/SA1/FS-WASH-NFI/INGO/16181,10/19/2021 12:18:46 PM,Overall,1179,1267,1191,1238,4875,1161,1539,1322,1719,5741
70,Syria Cross border,2020,TUR-20/3559/SA1/H/INGO/16214,12/1/2021 1:47:58 PM,Host Communities,1625,1642,1821,4375,9463,4010,4819,4159,2707,15695
70,Syria Cross border,2020,TUR-20/3559/SA1/H/INGO/16214,12/1/2021 1:47:58 PM,Internally Displaced People,10600,10713,11880,28539,61732,11124,17348,11681,11572,51725
70,Syria Cross border,2020,TUR-20/3559/SA1/H/INGO/16214,12/1/2021 1:47:58 PM,Overall,12225,12355,13701,32914,71195,15134,22167,15840,14279,67420
70,Syria Cross border,2020,TUR-20/3559/SA1/H/INGO/16253,12/1/2021 1:16:43 PM,Host Communities,357,443,1150,1048,2998,497,371,917,801,2586
70,Syria Cross border,2020,TUR-20/3559/SA1/H/INGO/16253,12/1/2021 1:16:43 PM,Internally Displaced People,312,385,995,910,2602,899,766,1754,1546,4965
70,Syria Cross border,2020,TUR-20/3559/SA1/H/INGO/16253,12/1/2021 1:16:43 PM,Other,26,10,0,0,36,22,14,0,0,36
70,Syria Cross border,2020,TUR-20/3559/SA1/H/INGO/16253,12/1/2021 1:16:43 PM,Overall,695,838,2145,1958,5636,1418,1151,2671,2347,7587
70,Syria Cross border,2020,TUR-20/3559/SA1/H/INGO/16369,8/26/2021 10:57:12 AM,Host Communities,1188,6336,2898,3024,13446,827,4677,1926,1907,9337
70,Syria Cross border,2020,TUR-20/3559/SA1/H/INGO/16369,8/26/2021 10:57:12 AM,Internally Displaced People,6552,36144,16092,16776,75564,4656,30811,14489,14550,64506
70,Syria Cross border,2020,TUR-20/3559/SA1/H/INGO/16369,8/26/2021 10:57:12 AM,Overall,7740,42480,18990,19800,89010,5483,35488,16415,16457,73843
70,Syria Cross border,2020,TUR-20/3559/SA1/H/NGO/16176,3/14/2022 10:55:05 AM,Host Communities,0,14309,8470,8272,31051,0,14334,8489,8936,31759
70,Syria Cross border,2020,TUR-20/3559/SA1/H/NGO/16176,3/14/2022 10:55:05 AM,Internally Displaced People,0,8747,5178,5057,18982,0,13539,7663,6907,28109
70,Syria Cross border,2020,TUR-20/3559/SA1/H/NGO/16176,3/14/2022 10:55:05 AM,Overall,0,23056,13648,13329,50033,0,27873,16152,15843,59868
70,Syria Cross border,2020,TUR-20/3559/SA1/H/NGO/16197,12/1/2021 1:26:37 PM,Host Communities,5827,5706,2371,2442,16346,6309,6455,2993,1811,17568
70,Syria Cross border,2020,TUR-20/3559/SA1/H/NGO/16197,12/1/2021 1:26:37 PM,Internally Displaced People,7123,6974,2899,2983,19979,8122,8567,4326,3355,24370
70,Syria Cross border,2020,TUR-20/3559/SA1/H/NGO/16197,12/1/2021 1:26:37 PM,Overall,12950,12680,5270,5425,36325,14431,15022,7319,5166,41938
70,Syria Cross border,2020,TUR-20/3559/SA1/H/NGO/16227,6/7/2021 7:02:15 AM,Host Communities,2794,3726,1397,1397,9314,2157,1602,1042,521,5322
70,Syria Cross border,2020,TUR-20/3559/SA1/H/NGO/16227,6/7/2021 7:02:15 AM,Internally Displaced People,4191,5588,2096,2096,13971,4058,2918,1599,874,9449
70,Syria Cross border,2020,TUR-20/3559/SA1/H/NGO/16227,6/7/2021 7:02:15 AM,Overall,6985,9314,3493,3493,23285,6215,4520,2641,1395,14771
70,Syria Cross border,2020,TUR-20/3559/SA1/H/NGO/16229,2/1/2022 2:37:26 PM,Host Communities,14400,16320,8640,8640,48000,7563,8521,3225,2823,22132
70,Syria Cross border,2020,TUR-20/3559/SA1/H/NGO/16229,2/1/2022 2:37:26 PM,Internally Displaced People,9600,10880,5760,5760,32000,4743,5256,2137,1835,13971
70,Syria Cross border,2020,TUR-20/3559/SA1/H/NGO/16229,2/1/2022 2:37:26 PM,Overall,24000,27200,14400,14400,80000,12306,13777,5362,4658,36103
70,Syria Cross border,2020,TUR-20/3559/SA1/H/NGO/16288,6/7/2021 6:35:10 AM,Host Communities,0,0,3881,3176,7057,0,0,1891,2312,4203
70,Syria Cross border,2020,TUR-20/3559/SA1/H/NGO/16288,6/7/2021 6:35:10 AM,Internally Displaced People,0,0,21993,17995,39988,0,0,21749,26583,48332
70,Syria Cross border,2020,TUR-20/3559/SA1/H/NGO/16288,6/7/2021 6:35:10 AM,Overall,0,0,25874,21171,47045,0,0,23640,28895,52535
70,Syria Cross border,2020,TUR-20/3559/SA1/H/NGO/16315,12/7/2021 10:11:51 AM,Host Communities,2694,13002,16884,14844,47424,2654,11467,4457,4184,22762
70,Syria Cross border,2020,TUR-20/3559/SA1/H/NGO/16315,12/7/2021 10:11:51 AM,Internally Displaced People,864,47082,9072,10860,67878,631,42987,15480,16553,75651
70,Syria Cross border,2020,TUR-20/3559/SA1/H/NGO/16315,12/7/2021 10:11:51 AM,Overall,3558,60084,25956,25704,115302,3285,54454,19937,20737,98413
70,Syria Cross border,2020,TUR-20/3559/SA1/H/NGO/16397,12/1/2021 1:36:37 PM,Host Communities,1472,1589,276,288,3625,384,332,28,42,786
70,Syria Cross border,2020,TUR-20/3559/SA1/H/NGO/16397,12/1/2021 1:36:37 PM,Internally Displaced People,678,684,116,121,1599,1289,1732,168,116,3305
70,Syria Cross border,2020,TUR-20/3559/SA1/H/NGO/16397,12/1/2021 1:36:37 PM,Overall,2150,2273,392,409,5224,1673,2064,196,158,4091
70,Syria Cross border,2020,TUR-20/3559/SA1/H/UN/16319,12/2/2021 11:43:18 AM,Host Communities,29283,41879,25675,29016,125853,26263,45169,22438,27197,121067
70,Syria Cross border,2020,TUR-20/3559/SA1/H/UN/16319,12/2/2021 11:43:18 AM,Internally Displaced People,39627,75928,38600,38116,192271,41349,98079,53410,53781,246619
70,Syria Cross border,2020,TUR-20/3559/SA1/H/UN/16319,12/2/2021 11:43:18 AM,Other,4333,4127,3235,1460,13155,5451,6672,6938,5429,24490
70,Syria Cross border,2020,TUR-20/3559/SA1/H/UN/16319,12/2/2021 11:43:18 AM,Overall,73243,121934,67510,68592,331279,73063,149920,82786,86407,392176
70,Syria Cross border,2020,TUR-20/3559/SA1/H-N/NGO/16239,12/17/2021 3:19:43 PM,Host Communities,4200,20700,9360,9960,44220,5481,14249,7841,8104,35675
70,Syria Cross border,2020,TUR-20/3559/SA1/H-N/NGO/16239,12/17/2021 3:19:43 PM,Internally Displaced People,3000,25320,19500,20880,68700,6448,34821,25774,25898,92941
70,Syria Cross border,2020,TUR-20/3559/SA1/H-N/NGO/16239,12/17/2021 3:19:43 PM,Overall,7200,46020,28860,30840,112920,11929,49070,33615,34002,128616
70,Syria Cross border,2020,TUR-20/3559/SA1/N/INGO/16316,12/1/2021 1:09:55 PM,Internally Displaced People,0,29750,26520,28730,85000,0,34095,32257,30750,97102
70,Syria Cross border,2020,TUR-20/3559/SA1/N/INGO/16316,12/1/2021 1:09:55 PM,Overall,0,29750,26520,28730,85000,0,34095,32257,30750,97102
70,Syria Cross border,2020,TUR-20/3559/SA1/N/INGO/16370,11/24/2021 9:02:29 AM,Host Communities,134,5700,6000,6198,18032,0,1571,2518,2620,6709
70,Syria Cross border,2020,TUR-20/3559/SA1/N/INGO/16370,11/24/2021 9:02:29 AM,Internally Displaced People,106,5662,5702,6144,17614,0,4348,7355,7831,19534
70,Syria Cross border,2020,TUR-20/3559/SA1/N/INGO/16370,11/24/2021 9:02:29 AM,Overall,240,11362,11702,12342,35646,0,5919,9873,10451,26243
70,Syria Cross border,2020,TUR-20/3559/SA1/N/NGO/16268,1/19/2022 11:42:20 AM,Host Communities,50,2945,2960,3044,8999,104,4371,4175,4368,13018
70,Syria Cross border,2020,TUR-20/3559/SA1/N/NGO/16268,1/19/2022 11:42:20 AM,Internally Displaced People,450,26855,26864,27900,82069,459,30318,30792,30847,92416
70,Syria Cross border,2020,TUR-20/3559/SA1/N/NGO/16268,1/19/2022 11:42:20 AM,Overall,500,29800,29824,30944,91068,563,34689,34967,35215,105434
70,Syria Cross border,2020,TUR-20/3559/SA1/N/NGO/16289,1/19/2022 11:37:45 AM,Host Communities,0,2808,2904,2376,8088,1939,8928,2253,2131,15251
70,Syria Cross border,2020,TUR-20/3559/SA1/N/NGO/16289,1/19/2022 11:37:45 AM,Internally Displaced People,0,15912,16456,13464,45832,21017,22364,20329,19240,82950
70,Syria Cross border,2020,TUR-20/3559/SA1/N/NGO/16289,1/19/2022 11:37:45 AM,Overall,0,18720,19360,15840,53920,22956,31292,22582,21371,98201
70,Syria Cross border,2020,TUR-20/3559/SA1/N/NGO/16346,2/24/2022 10:44:53 AM,Host Communities,552,10560,9804,9840,30756,0,15808,14664,14880,45352
70,Syria Cross border,2020,TUR-20/3559/SA1/N/NGO/16346,2/24/2022 10:44:53 AM,Internally Displaced People,648,19440,24036,16320,60444,0,25327,23214,21132,69673
70,Syria Cross border,2020,TUR-20/3559/SA1/N/NGO/16346,2/24/2022 10:44:53 AM,Overall,1200,30000,33840,26160,91200,0,41135,37878,36012,115025
70,Syria Cross border,2020,TUR-20/3559/SA1/N/O/16348,8/13/2021 11:21:41 AM,Host Communities,5940,31490,6830,6860,51120,6632,29744,7069,7454,50899
70,Syria Cross border,2020,TUR-20/3559/SA1/N/O/16348,8/13/2021 11:21:41 AM,Internally Displaced People,8900,47240,10270,10270,76680,10676,43447,10320,10945,75388
70,Syria Cross border,2020,TUR-20/3559/SA1/N/O/16348,8/13/2021 11:21:41 AM,Overall,14840,78730,17100,17130,127800,17308,73191,17389,18399,126287
70,Syria Cross border,2020,TUR-20/3559/SA1/NFI/INGO/16210,8/16/2021 6:05:03 AM,Internally Displaced People,4729,5202,6384,7330,23645,5250,6005,6703,6245,24203
70,Syria Cross border,2020,TUR-20/3559/SA1/NFI/INGO/16210,8/16/2021 6:05:03 AM,Overall,4729,5202,6384,7330,23645,5250,6005,6703,6245,24203
70,Syria Cross border,2020,TUR-20/3559/SA1/NFI/INGO/16357,9/7/2021 7:09:43 AM,Host Communities,9262,8549,11082,9827,38720,6539,11754,8997,8389,35679
70,Syria Cross border,2020,TUR-20/3559/SA1/NFI/INGO/16357,9/7/2021 7:09:43 AM,Internally Displaced People,4486,4141,5368,4760,18755,5315,9059,7398,6874,28646
70,Syria Cross border,2020,TUR-20/3559/SA1/NFI/INGO/16357,9/7/2021 7:09:43 AM,Overall,14472,13358,17316,15354,60500,11854,20813,16395,15263,64325
70,Syria Cross border,2020,TUR-20/3559/SA1/NFI/INGO/16357,9/7/2021 7:09:43 AM,Returnees,724,668,866,767,3025,0,0,0,0,0
70,Syria Cross border,2020,TUR-20/3559/SA1/NFI/NGO/16175,5/23/2021 6:33:50 AM,Host Communities,198,192,209,200,799,115,110,143,135,503
70,Syria Cross border,2020,TUR-20/3559/SA1/NFI/NGO/16175,5/23/2021 6:33:50 AM,Internally Displaced People,309,287,262,300,1158,368,390,373,345,1476
70,Syria Cross border,2020,TUR-20/3559/SA1/NFI/NGO/16175,5/23/2021 6:33:50 AM,Overall,543,513,501,525,2082,505,525,533,499,2062
70,Syria Cross border,2020,TUR-20/3559/SA1/NFI/NGO/16175,5/23/2021 6:33:50 AM,Returnees,36,34,30,25,125,22,25,17,19,83
70,Syria Cross border,2020,TUR-20/3559/SA1/NFI/NGO/16183,9/13/2021 8:59:30 AM,Internally Displaced People,810,1330,1720,1640,5500,810,1330,1720,1640,5500
70,Syria Cross border,2020,TUR-20/3559/SA1/NFI/NGO/16183,9/13/2021 8:59:30 AM,Overall,810,1330,1720,1640,5500,810,1330,1720,1640,5500
70,Syria Cross border,2020,TUR-20/3559/SA1/NFI/NGO/16217,8/19/2021 11:55:49 AM,Host Communities,264,294,396,546,1500,322,395,462,437,1616
70,Syria Cross border,2020,TUR-20/3559/SA1/NFI/NGO/16217,8/19/2021 11:55:49 AM,Internally Displaced People,880,980,1320,1820,5000,1527,1756,2382,2130,7795
70,Syria Cross border,2020,TUR-20/3559/SA1/NFI/NGO/16217,8/19/2021 11:55:49 AM,Overall,1144,1274,1716,2366,6500,1849,2151,2844,2567,9411
70,Syria Cross border,2020,TUR-20/3559/SA1/NFI/NGO/16238,6/17/2021 1:25:17 PM,Host Communities,186,196,239,246,867,98,130,100,126,454
70,Syria Cross border,2020,TUR-20/3559/SA1/NFI/NGO/16238,6/17/2021 1:25:17 PM,Internally Displaced People,751,792,965,1000,3508,857,1017,992,1069,3935
70,Syria Cross border,2020,TUR-20/3559/SA1/NFI/NGO/16238,6/17/2021 1:25:17 PM,Overall,937,988,1204,1246,4375,955,1147,1092,1195,4389
70,Syria Cross border,2020,TUR-20/3559/SA1/NFI/NGO/16273,8/23/2021 12:23:24 PM,Host Communities,593,615,880,917,3005,846,1158,1073,1179,4256
70,Syria Cross border,2020,TUR-20/3559/SA1/NFI/NGO/16273,8/23/2021 12:23:24 PM,Internally Displaced People,1639,1704,2447,2555,8345,2399,3037,3262,3379,12077
70,Syria Cross border,2020,TUR-20/3559/SA1/NFI/NGO/16273,8/23/2021 12:23:24 PM,Overall,2232,2319,3327,3472,11350,3245,4195,4335,4558,16333
70,Syria Cross border,2020,TUR-20/3559/SA1/NFI/NGO/16278,8/16/2021 12:40:53 PM,Host Communities,962,1155,654,1078,3849,766,988,1158,1035,3947
70,Syria Cross border,2020,TUR-20/3559/SA1/NFI/NGO/16278,8/16/2021 12:40:53 PM,Internally Displaced People,8133,9761,5535,9111,32540,9458,11128,15021,13215,48822
70,Syria Cross border,2020,TUR-20/3559/SA1/NFI/NGO/16278,8/16/2021 12:40:53 PM,Overall,13076,15694,8893,14648,52311,10862,12918,17447,15330,56557
70,Syria Cross border,2020,TUR-20/3559/SA1/NFI/NGO/16278,8/16/2021 12:40:53 PM,Returnees,3981,4778,2704,4459,15922,638,802,1268,1080,3788
70,Syria Cross border,2020,TUR-20/3559/SA1/NFI/NGO/16345,8/3/2021 7:39:21 AM,Host Communities,1020,1380,1693,1907,6000,1404,1689,1872,1776,6741
70,Syria Cross border,2020,TUR-20/3559/SA1/NFI/NGO/16345,8/3/2021 7:39:21 AM,Internally Displaced People,2460,3140,3946,4454,14000,3737,4523,6628,6390,21278
70,Syria Cross border,2020,TUR-20/3559/SA1/NFI/NGO/16345,8/3/2021 7:39:21 AM,Overall,3480,4520,5639,6361,20000,5141,6212,8500,8166,28019
70,Syria Cross border,2020,TUR-20/3559/SA1/NFI/NGO/16363,8/2/2021 7:00:19 AM,Host Communities,665,714,561,610,2550,728,866,1154,937,3685
70,Syria Cross border,2020,TUR-20/3559/SA1/NFI/NGO/16363,8/2/2021 7:00:19 AM,Internally Displaced People,1872,2012,1588,1728,7200,2253,2619,3743,3074,11689
70,Syria Cross border,2020,TUR-20/3559/SA1/NFI/NGO/16363,8/2/2021 7:00:19 AM,Overall,2537,2726,2149,2338,9750,2981,3485,4897,4011,15374
70,Syria Cross border,2020,TUR-20/3559/SA1/NFI/NGO/16388,6/17/2021 1:15:15 PM,Host Communities,187,238,204,221,850,288,368,625,608,1889
70,Syria Cross border,2020,TUR-20/3559/SA1/NFI/NGO/16388,6/17/2021 1:15:15 PM,Internally Displaced People,308,392,336,364,1400,182,214,273,285,954
70,Syria Cross border,2020,TUR-20/3559/SA1/NFI/NGO/16388,6/17/2021 1:15:15 PM,Overall,550,700,600,650,2500,506,617,940,937,3000
70,Syria Cross border,2020,TUR-20/3559/SA1/NFI/NGO/16388,6/17/2021 1:15:15 PM,Returnees,55,70,60,65,250,36,35,42,44,157
70,Syria Cross border,2020,TUR-20/3559/SA1/NFI/NGO/16393,6/17/2021 1:20:46 PM,Internally Displaced People,797,1015,870,943,3625,905,1150,1591,1281,4927
70,Syria Cross border,2020,TUR-20/3559/SA1/NFI/NGO/16393,6/17/2021 1:20:46 PM,Overall,797,1015,870,943,3625,905,1150,1591,1281,4927
70,Syria Cross border,2020,TUR-20/3559/SA1/NFI-ER/NGO/16237,9/28/2021 1:52:01 PM,Internally Displaced People,1835,2002,2309,2566,8712,1492,1855,2663,3117,9127
70,Syria Cross border,2020,TUR-20/3559/SA1/NFI-ER/NGO/16237,9/28/2021 1:52:01 PM,Overall,1835,2002,2309,2566,8712,1492,1855,2663,3117,9127
70,Syria Cross border,2020,TUR-20/3559/SA1/NFI-FS/UN/16173,9/22/2021 11:25:57 AM,Host Communities,3782,3782,5674,5674,18912,498,746,589,536,2369
70,Syria Cross border,2020,TUR-20/3559/SA1/NFI-FS/UN/16173,9/22/2021 11:25:57 AM,Other,13069,11741,16700,17363,58873,17862,20679,27346,25678,91565
70,Syria Cross border,2020,TUR-20/3559/SA1/NFI-FS/UN/16173,9/22/2021 11:25:57 AM,Overall,16851,15523,22374,23037,77785,18360,21425,27935,26214,93934
70,Syria Cross border,2020,TUR-20/3559/SA1/P/INGO/16213,9/8/2021 11:25:03 AM,Host Communities,1522,1499,1454,1453,5928,1021,942,1256,953,4172
70,Syria Cross border,2020,TUR-20/3559/SA1/P/INGO/16213,9/8/2021 11:25:03 AM,Internally Displaced People,3552,3497,3392,3391,13832,1738,1971,2088,2038,7835
70,Syria Cross border,2020,TUR-20/3559/SA1/P/INGO/16213,9/8/2021 11:25:03 AM,Overall,5074,4996,4846,4844,19760,2759,2913,3344,2991,12007
70,Syria Cross border,2020,TUR-20/3559/SA1/P/INGO/16254,6/2/2021 11:07:29 AM,Host Communities,199,200,400,400,1199,187,497,468,344,1496
70,Syria Cross border,2020,TUR-20/3559/SA1/P/INGO/16254,6/2/2021 11:07:29 AM,Internally Displaced People,748,749,1500,1500,4497,746,1989,1875,1374,5984
70,Syria Cross border,2020,TUR-20/3559/SA1/P/INGO/16254,6/2/2021 11:07:29 AM,Overall,997,999,2000,2000,5996,933,2486,2343,1718,7480
70,Syria Cross border,2020,TUR-20/3559/SA1/P/INGO/16254,6/2/2021 11:07:29 AM,Returnees,50,50,100,100,300,0,0,0,0,0
70,Syria Cross border,2020,TUR-20/3559/SA1/P/INGO/16282,1/19/2022 11:53:35 AM,Host Communities,787,1617,425,569,3398,1638,1913,423,475,4449
70,Syria Cross border,2020,TUR-20/3559/SA1/P/INGO/16282,1/19/2022 11:53:35 AM,Internally Displaced People,1056,1760,513,543,3872,3273,3662,817,810,8562
70,Syria Cross border,2020,TUR-20/3559/SA1/P/INGO/16282,1/19/2022 11:53:35 AM,Overall,1843,3377,938,1112,7270,4911,5575,1240,1285,13011
70,Syria Cross border,2020,TUR-20/3559/SA1/P/NGO/16203,11/2/2021 7:29:50 AM,Host Communities,1444,5276,1350,1756,9826,1461,5290,1453,1849,10053
70,Syria Cross border,2020,TUR-20/3559/SA1/P/NGO/16203,11/2/2021 7:29:50 AM,Internally Displaced People,2166,7914,2024,2635,14739,2166,7914,2231,2808,15119
70,Syria Cross border,2020,TUR-20/3559/SA1/P/NGO/16203,11/2/2021 7:29:50 AM,Overall,3610,13190,3374,4391,24565,3627,13204,3684,4657,25172
70,Syria Cross border,2020,TUR-20/3559/SA1/P/NGO/16220,11/3/2021 11:48:11 AM,Host Communities,4000,5950,9779,8456,28185,7486,9971,13242,13209,43908
70,Syria Cross border,2020,TUR-20/3559/SA1/P/NGO/16220,11/3/2021 11:48:11 AM,Internally Displaced People,7100,9050,12271,12544,40965,5987,7980,10593,10569,35129
70,Syria Cross border,2020,TUR-20/3559/SA1/P/NGO/16220,11/3/2021 11:48:11 AM,Overall,14550,19150,25350,26150,85200,14971,19944,26484,26418,87817
70,Syria Cross border,2020,TUR-20/3559/SA1/P/NGO/16220,11/3/2021 11:48:11 AM,Returnees,3450,4150,3300,5150,16050,1498,1993,2649,2640,8780
70,Syria Cross border,2020,TUR-20/3559/SA1/P/NGO/16270,11/10/2021 10:16:43 AM,Host Communities,880,1428,135,375,2818,959,1677,168,487,3291
70,Syria Cross border,2020,TUR-20/3559/SA1/P/NGO/16270,11/10/2021 10:16:43 AM,Internally Displaced People,2055,3332,315,875,6577,2125,3314,359,761,6559
70,Syria Cross border,2020,TUR-20/3559/SA1/P/NGO/16270,11/10/2021 10:16:43 AM,Overall,2935,4760,450,1250,9395,3084,4991,527,1248,9850
70,Syria Cross border,2020,TUR-20/3559/SA1/P/NGO/16274,11/8/2021 9:14:32 AM,Internally Displaced People,84,256,935,264,1539,397,1198,613,985,3193
70,Syria Cross border,2020,TUR-20/3559/SA1/P/NGO/16274,11/8/2021 9:14:32 AM,Overall,828,2982,1812,2643,8265,1508,3982,2119,2801,10410
70,Syria Cross border,2020,TUR-20/3559/SA1/P/NGO/16274,11/8/2021 9:14:32 AM,Returnees,744,2726,877,2379,6726,1111,2784,1506,1816,7217
70,Syria Cross border,2020,TUR-20/3559/SA1/P/NGO/16277,9/15/2021 6:54:28 AM,Host Communities,2344,2280,1510,1509,7643,1364,1503,4129,3320,10316
70,Syria Cross border,2020,TUR-20/3559/SA1/P/NGO/16277,9/15/2021 6:54:28 AM,Internally Displaced People,3517,3420,2267,2263,11467,1392,1394,3799,2966,9551
70,Syria Cross border,2020,TUR-20/3559/SA1/P/NGO/16277,9/15/2021 6:54:28 AM,Overall,5861,5700,3777,3772,19110,2756,2897,7928,6286,19867
70,Syria Cross border,2020,TUR-20/3559/SA1/P/NGO/16299,7/12/2021 11:12:08 AM,Internally Displaced People,2200,12000,1800,7500,23500,2878,15923,2669,10249,31719
70,Syria Cross border,2020,TUR-20/3559/SA1/P/NGO/16299,7/12/2021 11:12:08 AM,Overall,2200,12000,1800,7500,23500,2878,15923,2669,10249,31719
70,Syria Cross border,2020,TUR-20/3559/SA1/P/NGO/16322,10/22/2021 10:49:06 AM,Host Communities,981,2291,3140,3457,9869,1386,2223,2444,3284,9337
70,Syria Cross border,2020,TUR-20/3559/SA1/P/NGO/16322,10/22/2021 10:49:06 AM,Internally Displaced People,1633,2365,6555,6688,17241,2243,3397,8053,7710,21403
70,Syria Cross border,2020,TUR-20/3559/SA1/P/NGO/16322,10/22/2021 10:49:06 AM,Overall,2614,4656,9695,10145,27110,3629,5620,10497,10994,30740
70,Syria Cross border,2020,TUR-20/3559/SA1/P/NGO/16333,9/15/2021 11:18:06 AM,Host Communities,1994,5714,2539,3338,13585,2926,5997,4210,3450,16583
70,Syria Cross border,2020,TUR-20/3559/SA1/P/NGO/16333,9/15/2021 11:18:06 AM,Internally Displaced People,4652,13332,5923,7788,31695,5245,13469,7823,9889,36426
70,Syria Cross border,2020,TUR-20/3559/SA1/P/NGO/16333,9/15/2021 11:18:06 AM,Overall,6646,19046,8462,11126,45280,8171,19466,12033,13339,53009
70,Syria Cross border,2020,TUR-20/3559/SA1/P/NGO/16337,9/8/2021 9:39:40 AM,Host Communities,1565,1565,743,743,4616,2126,2148,1745,1713,7732
70,Syria Cross border,2020,TUR-20/3559/SA1/P/NGO/16337,9/8/2021 9:39:40 AM,Internally Displaced People,895,895,241,241,2272,879,948,589,657,3073
70,Syria Cross border,2020,TUR-20/3559/SA1/P/NGO/16337,9/8/2021 9:39:40 AM,Overall,3000,3000,1200,1200,8400,3836,3971,3233,3234,14274
70,Syria Cross border,2020,TUR-20/3559/SA1/P/NGO/16337,9/8/2021 9:39:40 AM,Returnees,540,540,216,216,1512,831,875,899,864,3469
70,Syria Cross border,2020,TUR-20/3559/SA1/P/NGO/16343,8/5/2021 1:05:42 PM,Host Communities,1088,1355,964,1330,4737,1570,1673,1508,1337,6088
70,Syria Cross border,2020,TUR-20/3559/SA1/P/NGO/16343,8/5/2021 1:05:42 PM,Internally Displaced People,1854,4359,1250,2325,9788,2083,3884,1642,2001,9610
70,Syria Cross border,2020,TUR-20/3559/SA1/P/NGO/16343,8/5/2021 1:05:42 PM,Overall,2942,5714,2214,3655,14525,3653,5557,3150,3338,15698
70,Syria Cross border,2020,TUR-20/3559/SA1/P/NGO/16361,9/13/2021 8:26:46 AM,Host Communities,272,2799,501,1315,4887,315,1756,641,1094,3806
70,Syria Cross border,2020,TUR-20/3559/SA1/P/NGO/16361,9/13/2021 8:26:46 AM,Internally Displaced People,314,2963,549,1343,5169,603,3474,959,1745,6781
70,Syria Cross border,2020,TUR-20/3559/SA1/P/NGO/16361,9/13/2021 8:26:46 AM,Overall,586,5762,1050,2658,10056,918,5230,1600,2839,10587
70,Syria Cross border,2020,TUR-20/3559/SA1/WASH/INGO/16250,6/28/2021 9:11:05 AM,Host Communities,22926,26668,6622,6911,63127,20424,30937,28247,25754,105362
70,Syria Cross border,2020,TUR-20/3559/SA1/WASH/INGO/16250,6/28/2021 9:11:05 AM,Internally Displaced People,44341,50935,10594,11372,117242,18834,28728,25852,23660,97074
70,Syria Cross border,2020,TUR-20/3559/SA1/WASH/INGO/16250,6/28/2021 9:11:05 AM,Overall,67267,77603,17216,18283,180369,39258,59665,54099,49414,202436
70,Syria Cross border,2020,TUR-20/3559/SA1/WASH/INGO/16306,3/30/2021 11:28:57 AM,Host Communities,11670,11997,16156,16838,56661,11933,12277,17381,17278,58869
70,Syria Cross border,2020,TUR-20/3559/SA1/WASH/INGO/16306,3/30/2021 11:28:57 AM,Internally Displaced People,6247,7004,10220,10171,33642,4024,4462,7648,7956,24090
70,Syria Cross border,2020,TUR-20/3559/SA1/WASH/INGO/16306,3/30/2021 11:28:57 AM,Other,0,0,11101,11478,22579,0,0,13220,13349,26569
70,Syria Cross border,2020,TUR-20/3559/SA1/WASH/INGO/16306,3/30/2021 11:28:57 AM,Overall,17917,19001,37477,38487,112882,15957,16739,38249,38583,109528
70,Syria Cross border,2020,TUR-20/3559/SA1/WASH/INGO/16354,6/22/2021 11:32:32 AM,Host Communities,4312,4770,6583,7039,22704,4312,4770,6659,7039,22780
70,Syria Cross border,2020,TUR-20/3559/SA1/WASH/INGO/16354,6/22/2021 11:32:32 AM,Internally Displaced People,9911,10958,15128,16175,52172,10494,11605,16023,17131,55253
70,Syria Cross border,2020,TUR-20/3559/SA1/WASH/INGO/16354,6/22/2021 11:32:32 AM,Overall,14223,15728,21711,23214,74876,14806,16375,22682,24170,78033
70,Syria Cross border,2020,TUR-20/3559/SA1/WASH/NGO/16143,4/12/2021 8:20:02 AM,Host Communities,4286,4372,8486,8572,25716,4582,4374,8486,8572,26014
70,Syria Cross border,2020,TUR-20/3559/SA1/WASH/NGO/16143,4/12/2021 8:20:02 AM,Internally Displaced People,23479,23949,46489,46959,140876,23183,23947,46489,46959,140578
70,Syria Cross border,2020,TUR-20/3559/SA1/WASH/NGO/16143,4/12/2021 8:20:02 AM,Overall,27765,28321,54975,55531,166592,27765,28321,54975,55531,166592
70,Syria Cross border,2020,TUR-20/3559/SA1/WASH/NGO/16158,6/28/2021 7:41:38 AM,Internally Displaced People,17256,20464,28998,24898,91616,20583,24605,33468,28568,107224
70,Syria Cross border,2020,TUR-20/3559/SA1/WASH/NGO/16158,6/28/2021 7:41:38 AM,Overall,17256,20464,28998,24898,91616,20583,24605,33468,28568,107224
70,Syria Cross border,2020,TUR-20/3559/SA1/WASH/NGO/16287,10/28/2021 11:44:29 AM,Host Communities,1239,1381,1549,1591,5760,1239,1381,1549,1591,5760
70,Syria Cross border,2020,TUR-20/3559/SA1/WASH/NGO/16287,10/28/2021 11:44:29 AM,Internally Displaced People,4110,4548,4644,4973,18275,4170,4457,4543,4789,17959
70,Syria Cross border,2020,TUR-20/3559/SA1/WASH/NGO/16287,10/28/2021 11:44:29 AM,Overall,5349,5929,6193,6564,24035,5409,5838,6092,6380,23719
70,Syria Cross border,2020,TUR-20/3559/SA1/WASH/NGO/16296,7/13/2021 11:53:17 AM,Host Communities,990,1035,1215,1260,4500,6911,7225,8482,8796,31414
70,Syria Cross border,2020,TUR-20/3559/SA1/WASH/NGO/16296,7/13/2021 11:53:17 AM,Internally Displaced People,2299,2403,2822,2926,10450,1929,2017,2368,2456,8770
70,Syria Cross border,2020,TUR-20/3559/SA1/WASH/NGO/16296,7/13/2021 11:53:17 AM,Overall,12859,13443,15782,16366,58450,15070,15755,18496,19182,68503
70,Syria Cross border,2020,TUR-20/3559/SA1/WASH/NGO/16296,7/13/2021 11:53:17 AM,Returnees,9570,10005,11745,12180,43500,6230,6513,7646,7930,28319
70,Syria Cross border,2020,TUR-20/3559/SA1/WASH/NGO/16332,6/3/2021 9:29:16 AM,Host Communities,7450,8692,6704,6954,29800,5100,6000,8100,10600,29800
70,Syria Cross border,2020,TUR-20/3559/SA1/WASH/NGO/16332,6/3/2021 9:29:16 AM,Internally Displaced People,9475,11054,8528,8843,37900,8871,11419,13034,18311,51635
70,Syria Cross border,2020,TUR-20/3559/SA1/WASH/NGO/16332,6/3/2021 9:29:16 AM,Overall,16925,19746,15232,15797,67700,13971,17419,21134,28911,81435
70,Syria Cross border,2020,TUR-20/3559/SA1/WASH/NGO/16336,7/6/2021 1:19:42 PM,Host Communities,6137,6386,6579,7061,26163,5855,6104,6226,6726,24911
70,Syria Cross border,2020,TUR-20/3559/SA1/WASH/NGO/16336,7/6/2021 1:19:42 PM,Internally Displaced People,3909,4071,4179,4495,16654,4220,4401,4491,4849,17961
70,Syria Cross border,2020,TUR-20/3559/SA1/WASH/NGO/16336,7/6/2021 1:19:42 PM,Overall,13592,14147,14558,15636,57933,13614,14194,14483,15642,57933
70,Syria Cross border,2020,TUR-20/3559/SA1/WASH/NGO/16336,7/6/2021 1:19:42 PM,Returnees,3546,3690,3800,4080,15116,3539,3689,3766,4067,15061
70,Syria Cross border,2020,TUR-20/3559/SA1/WASH/NGO/16347,9/2/2021 9:12:10 AM,Host Communities,1763,1806,497,509,4575,1763,1806,497,509,4575
70,Syria Cross border,2020,TUR-20/3559/SA1/WASH/NGO/16347,9/2/2021 9:12:10 AM,Internally Displaced People,11059,11991,6727,6988,36765,10759,11631,6277,6498,35165
70,Syria Cross border,2020,TUR-20/3559/SA1/WASH/NGO/16347,9/2/2021 9:12:10 AM,Overall,12822,13797,7224,7497,41340,12522,13437,6774,7007,39740
70,Syria Cross border,2020,TUR-20/3559/SA1/WASH/NGO/16379,10/28/2021 7:51:48 AM,Internally Displaced People,6009,6847,9991,10194,33041,5086,5764,8841,8834,28525
70,Syria Cross border,2020,TUR-20/3559/SA1/WASH/NGO/16379,10/28/2021 7:51:48 AM,Overall,6009,6847,9991,10194,33041,5086,5764,8841,8834,28525
70,Syria Cross border,2020,TUR-20/3559/SA1/WASH-NFI/NGO/16340,12/16/2021 1:05:13 PM,Internally Displaced People,3152,3518,4330,3733,14733,3018,3462,4531,4286,15297
70,Syria Cross border,2020,TUR-20/3559/SA1/WASH-NFI/NGO/16340,12/16/2021 1:05:13 PM,Overall,3152,3518,4330,3733,14733,3018,3462,4531,4286,15297
70,Syria Cross border,2020,TUR-20/3559/SA2/CCM-FS/NGO/17763,11/23/2021 12:46:23 PM,Internally Displaced People,29430,32816,39002,43819,145067,25537,29703,35334,35801,126375
70,Syria Cross border,2020,TUR-20/3559/SA2/CCM-FS/NGO/17763,11/23/2021 12:46:23 PM,Overall,29430,32816,39002,43819,145067,25537,29703,35334,35801,126375
70,Syria Cross border,2020,TUR-20/3559/SA2/CCM-NFI-FS/NGO/17649,1/20/2022 11:48:54 AM,Internally Displaced People,3228,4283,5216,5424,18151,3233,3961,5373,4976,17543
70,Syria Cross border,2020,TUR-20/3559/SA2/CCM-NFI-FS/NGO/17649,1/20/2022 11:48:54 AM,Overall,3228,4283,5216,5424,18151,3233,3961,5373,4976,17543
70,Syria Cross border,2020,TUR-20/3559/SA2/E/INGO/17666,9/7/2021 1:37:40 PM,Internally Displaced People,110,80,1250,1350,2790,134,105,1687,1800,3726
70,Syria Cross border,2020,TUR-20/3559/SA2/E/INGO/17666,9/7/2021 1:37:40 PM,Overall,110,80,1250,1350,2790,134,105,1687,1800,3726
70,Syria Cross border,2020,TUR-20/3559/SA2/E/NGO/17648,10/5/2021 10:11:20 AM,Host Communities,355,366,4288,4713,9722,360,369,4606,4785,10120
70,Syria Cross border,2020,TUR-20/3559/SA2/E/NGO/17648,10/5/2021 10:11:20 AM,Internally Displaced People,433,446,5240,5759,11878,341,561,6655,5980,13537
70,Syria Cross border,2020,TUR-20/3559/SA2/E/NGO/17648,10/5/2021 10:11:20 AM,Overall,788,812,9528,10472,21600,701,930,11261,10765,23657
70,Syria Cross border,2020,TUR-20/3559/SA2/E/NGO/17793,10/25/2021 7:35:14 AM,Host Communities,182,201,1602,1930,3915,284,260,1302,1163,3009
70,Syria Cross border,2020,TUR-20/3559/SA2/E/NGO/17793,10/25/2021 7:35:14 AM,Internally Displaced People,557,513,4409,5295,10774,1327,996,4473,4802,11598
70,Syria Cross border,2020,TUR-20/3559/SA2/E/NGO/17793,10/25/2021 7:35:14 AM,Overall,739,714,6011,7225,14689,1611,1256,5775,5965,14607
70,Syria Cross border,2020,TUR-20/3559/SA2/ER-FS/NGO/17690,1/28/2022 8:09:29 AM,Host Communities,2521,2651,3209,3374,11755,4598,3702,6055,5210,19565
70,Syria Cross border,2020,TUR-20/3559/SA2/ER-FS/NGO/17690,1/28/2022 8:09:29 AM,Internally Displaced People,5465,5746,6956,7313,25480,3863,3177,5250,4933,17223
70,Syria Cross border,2020,TUR-20/3559/SA2/ER-FS/NGO/17690,1/28/2022 8:09:29 AM,Overall,8016,8429,10203,10727,37375,8659,7059,11487,10323,37528
70,Syria Cross border,2020,TUR-20/3559/SA2/ER-FS/NGO/17690,1/28/2022 8:09:29 AM,Returnees,30,32,38,40,140,198,180,182,180,740
70,Syria Cross border,2020,TUR-20/3559/SA2/ER-NFI/UN/17766,3/23/2022 11:08:19 AM,Host Communities,10328,10342,14594,14580,49844,28384,30670,41245,42298,142597
70,Syria Cross border,2020,TUR-20/3559/SA2/ER-NFI/UN/17766,3/23/2022 11:08:19 AM,Internally Displaced People,21277,21306,30066,30037,102686,16569,18610,24303,24939,84421
70,Syria Cross border,2020,TUR-20/3559/SA2/ER-NFI/UN/17766,3/23/2022 11:08:19 AM,Overall,36550,36602,51650,51598,176400,45259,49607,65997,67672,228535
70,Syria Cross border,2020,TUR-20/3559/SA2/ER-NFI/UN/17766,3/23/2022 11:08:19 AM,Returnees,4945,4954,6990,6981,23870,306,327,449,435,1517
70,Syria Cross border,2020,TUR-20/3559/SA2/FS/NGO/17664,1/14/2022 1:35:28 PM,Host Communities,1116,707,121,81,2025,1554,903,191,114,2762
70,Syria Cross border,2020,TUR-20/3559/SA2/FS/NGO/17664,1/14/2022 1:35:28 PM,Internally Displaced People,1469,938,161,107,2675,1442,1167,182,155,2946
70,Syria Cross border,2020,TUR-20/3559/SA2/FS/NGO/17664,1/14/2022 1:35:28 PM,Overall,2585,1645,282,188,4700,2996,2070,373,269,5708
70,Syria Cross border,2020,TUR-20/3559/SA2/FS/NGO/17680,8/30/2021 2:27:23 PM,Internally Displaced People,1135,1264,1410,1512,5321,1292,1472,1789,1538,6091
70,Syria Cross border,2020,TUR-20/3559/SA2/FS/NGO/17680,8/30/2021 2:27:23 PM,Overall,1135,1264,1410,1512,5321,1292,1472,1789,1538,6091
70,Syria Cross border,2020,TUR-20/3559/SA2/FS/NGO/17721,10/22/2021 10:56:26 AM,Host Communities,550,650,575,725,2500,420,492,567,524,2003
70,Syria Cross border,2020,TUR-20/3559/SA2/FS/NGO/17721,10/22/2021 10:56:26 AM,Internally Displaced People,1732,2018,2146,2207,8103,1708,1995,2294,2121,8118
70,Syria Cross border,2020,TUR-20/3559/SA2/FS/NGO/17721,10/22/2021 10:56:26 AM,Overall,2502,2928,2951,3222,11603,2233,2610,3003,2776,10622
70,Syria Cross border,2020,TUR-20/3559/SA2/FS/NGO/17721,10/22/2021 10:56:26 AM,Returnees,220,260,230,290,1000,105,123,142,131,501
70,Syria Cross border,2020,TUR-20/3559/SA2/FS-H-P/NGO/17677,1/24/2022 8:02:21 AM,Host Communities,2846,3340,1856,1907,9949,3282,2889,3150,2689,12010
70,Syria Cross border,2020,TUR-20/3559/SA2/FS-H-P/NGO/17677,1/24/2022 8:02:21 AM,Internally Displaced People,4582,4944,2899,2886,15311,5721,5388,4827,4945,20881
70,Syria Cross border,2020,TUR-20/3559/SA2/FS-H-P/NGO/17677,1/24/2022 8:02:21 AM,Overall,7428,8284,4755,4793,25260,9003,8277,7977,7634,32891
70,Syria Cross border,2020,TUR-20/3559/SA2/FS-WASH-ER/INGO/17772,3/11/2022 10:27:12 AM,Internally Displaced People,300,470,400,550,1720,326,426,513,468,1733
70,Syria Cross border,2020,TUR-20/3559/SA2/FS-WASH-ER/INGO/17772,3/11/2022 10:27:12 AM,Overall,300,470,400,550,1720,326,426,513,468,1733
70,Syria Cross border,2020,TUR-20/3559/SA2/H/NGO/17651,1/20/2022 11:00:16 AM,Host Communities,350,250,120,80,800,1411,1005,195,106,2717
70,Syria Cross border,2020,TUR-20/3559/SA2/H/NGO/17651,1/20/2022 11:00:16 AM,Internally Displaced People,850,550,105,95,1600,1757,1521,253,195,3726
70,Syria Cross border,2020,TUR-20/3559/SA2/H/NGO/17651,1/20/2022 11:00:16 AM,Overall,1200,800,225,175,2400,3168,2526,448,301,6443
70,Syria Cross border,2020,TUR-20/3559/SA2/H/NGO/17669,11/22/2021 7:54:54 AM,Host Communities,669,281,0,10,960,473,306,138,105,1022
70,Syria Cross border,2020,TUR-20/3559/SA2/H/NGO/17669,11/22/2021 7:54:54 AM,Internally Displaced People,704,420,74,25,1223,1756,1646,800,734,4936
70,Syria Cross border,2020,TUR-20/3559/SA2/H/NGO/17669,11/22/2021 7:54:54 AM,Overall,1373,701,74,35,2183,2229,1952,938,839,5958
70,Syria Cross border,2020,TUR-20/3559/SA2/H/NGO/17764,5/9/2022 4:12:21 PM,Host Communities,126,98,14,14,252,318,336,7,11,672
70,Syria Cross border,2020,TUR-20/3559/SA2/H/NGO/17764,5/9/2022 4:12:21 PM,Internally Displaced People,252,196,28,28,504,419,361,14,18,812
70,Syria Cross border,2020,TUR-20/3559/SA2/H/NGO/17764,5/9/2022 4:12:21 PM,Overall,378,294,42,42,756,737,697,21,29,1484
70,Syria Cross border,2020,TUR-20/3559/SA2/H/NGO/17779,1/20/2022 8:39:45 AM,Host Communities,3039,1417,303,303,5062,6358,4514,1010,791,12673
70,Syria Cross border,2020,TUR-20/3559/SA2/H/NGO/17779,1/20/2022 8:39:45 AM,Internally Displaced People,4956,2312,495,495,8258,5908,4516,1383,1141,12948
70,Syria Cross border,2020,TUR-20/3559/SA2/H/NGO/17779,1/20/2022 8:39:45 AM,Overall,7995,3729,798,798,13320,12266,9030,2393,1932,25621
70,Syria Cross border,2020,TUR-20/3559/SA2/H-FS/NGO/17756,4/22/2022 11:22:33 AM,Host Communities,660,792,449,739,2640,2076,2427,784,713,6000
70,Syria Cross border,2020,TUR-20/3559/SA2/H-FS/NGO/17756,4/22/2022 11:22:33 AM,Internally Displaced People,1440,1728,980,1612,5760,3113,3248,2118,1883,10362
70,Syria Cross border,2020,TUR-20/3559/SA2/H-FS/NGO/17756,4/22/2022 11:22:33 AM,Overall,2100,2520,1429,2351,8400,5189,5675,2902,2596,16362
70,Syria Cross border,2020,TUR-20/3559/SA2/NFI/INGO/17665,8/17/2021 12:11:41 PM,Host Communities,315,347,425,488,1575,317,365,221,231,1134
70,Syria Cross border,2020,TUR-20/3559/SA2/NFI/INGO/17665,8/17/2021 12:11:41 PM,Internally Displaced People,3277,3582,4397,5049,16305,4315,4922,4991,4652,18880
70,Syria Cross border,2020,TUR-20/3559/SA2/NFI/INGO/17665,8/17/2021 12:11:41 PM,Overall,3592,3929,4822,5537,17880,4632,5287,5212,4883,20014
70,Syria Cross border,2020,TUR-20/3559/SA2/NFI/NGO/17657,10/19/2021 12:38:56 PM,Host Communities,884,953,1395,1418,4650,1096,1375,1158,1047,4676
70,Syria Cross border,2020,TUR-20/3559/SA2/NFI/NGO/17657,10/19/2021 12:38:56 PM,Internally Displaced People,5006,5401,7905,8038,26350,6340,6951,9035,8293,30619
70,Syria Cross border,2020,TUR-20/3559/SA2/NFI/NGO/17657,10/19/2021 12:38:56 PM,Overall,5890,6354,9300,9456,31000,7436,8326,10193,9340,35295
70,Syria Cross border,2020,TUR-20/3559/SA2/NFI/NGO/17684,8/18/2021 11:50:18 AM,Internally Displaced People,1976,2305,3710,3183,11174,2052,2399,3901,3403,11755
70,Syria Cross border,2020,TUR-20/3559/SA2/NFI/NGO/17684,8/18/2021 11:50:18 AM,Overall,1976,2305,3710,3183,11174,2052,2399,3901,3403,11755
70,Syria Cross border,2020,TUR-20/3559/SA2/NFI-CCM/NGO/17754,10/19/2021 11:47:50 AM,Internally Displaced People,3718,3880,4849,3718,16165,3256,3706,4690,4716,16368
70,Syria Cross border,2020,TUR-20/3559/SA2/NFI-CCM/NGO/17754,10/19/2021 11:47:50 AM,Overall,3718,3880,4849,3718,16165,3256,3706,4690,4716,16368
70,Syria Cross border,2020,TUR-20/3559/SA2/P-ER-WASH/NGO/17760,2/16/2022 1:11:40 PM,Host Communities,15865,14772,12580,11489,54706,5738,6849,6802,7212,26601
70,Syria Cross border,2020,TUR-20/3559/SA2/P-ER-WASH/NGO/17760,2/16/2022 1:11:40 PM,Internally Displaced People,10576,9847,8387,7659,36469,13389,15984,15875,16830,62078
70,Syria Cross border,2020,TUR-20/3559/SA2/P-ER-WASH/NGO/17760,2/16/2022 1:11:40 PM,Overall,26441,24619,20967,19148,91175,19127,22833,22677,24042,88679
70,Syria Cross border,2020,TUR-20/3559/SA2/P-WASH/NGO/17729,11/23/2021 12:32:12 PM,Host Communities,22810,24244,25854,29087,101995,23815,25680,28165,31178,108838
70,Syria Cross border,2020,TUR-20/3559/SA2/P-WASH/NGO/17729,11/23/2021 12:32:12 PM,Internally Displaced People,24716,26147,28750,31634,111247,25893,27840,30676,33786,118195
70,Syria Cross border,2020,TUR-20/3559/SA2/P-WASH/NGO/17729,11/23/2021 12:32:12 PM,Overall,47526,50391,54604,60721,213242,49708,53520,58841,64964,227033
70,Syria Cross border,2020,TUR-20/3559/SA2/WASH/INGO/17722,3/15/2022 11:57:59 AM,Internally Displaced People,2893,3662,4614,4081,15250,4500,4748,5913,5508,20669
70,Syria Cross border,2020,TUR-20/3559/SA2/WASH/INGO/17722,3/15/2022 11:57:59 AM,Overall,2893,3662,4614,4081,15250,4500,4748,5913,5508,20669
70,Syria Cross border,2020,TUR-20/3559/SA2/WASH/NGO/17758,2/14/2022 10:26:15 AM,Host Communities,7144,7468,8767,9091,32470,11850,12453,14362,14539,53204
70,Syria Cross border,2020,TUR-20/3559/SA2/WASH/NGO/17758,2/14/2022 10:26:15 AM,Internally Displaced People,6167,6447,7568,7848,28030,11310,11760,14061,14938,52069
70,Syria Cross border,2020,TUR-20/3559/SA2/WASH/NGO/17758,2/14/2022 10:26:15 AM,Overall,13311,13915,16335,16939,60500,23160,24213,28423,29477,105273
70,Syria Cross border,2020,TUR-20/3559/SA2/WASH-ER/NGO/17692,10/28/2021 11:41:45 AM,Host Communities,11069,12075,13145,14026,50315,11069,12075,13145,14026,50315
70,Syria Cross border,2020,TUR-20/3559/SA2/WASH-ER/NGO/17692,10/28/2021 11:41:45 AM,Internally Displaced People,8515,9010,10155,11022,38702,10704,11885,12509,13413,48511
70,Syria Cross border,2020,TUR-20/3559/SA2/WASH-ER/NGO/17692,10/28/2021 11:41:45 AM,Overall,19584,21085,23300,25048,89017,21773,23960,25654,27439,98826
70,Syria Cross border,2020,TUR-20/3559/SA2/WASH-P/NGO/17778,12/3/2021 12:46:40 PM,Internally Displaced People,2367,2475,2904,3012,10758,8393,10008,10632,12437,41470
70,Syria Cross border,2020,TUR-20/3559/SA2/WASH-P/NGO/17778,12/3/2021 12:46:40 PM,Overall,2367,2475,2904,3012,10758,8393,10008,10632,12437,41470
70,Syria Cross border,2021,TUR-21/3559/RA1/CCS/NGO/18294,10/11/2022 12:45:18 PM,Host Communities,3500,3500,1250,1250,9500,3506,3502,1250,1250,9508
70,Syria Cross border,2021,TUR-21/3559/RA1/CCS/NGO/18294,10/11/2022 12:45:18 PM,Internally Displaced People,2500,2500,1200,1200,7400,2520,2500,1205,1205,7430
70,Syria Cross border,2021,TUR-21/3559/RA1/CCS/NGO/18294,10/11/2022 12:45:18 PM,Overall,6200,6200,2700,2700,17800,6226,6202,2705,2705,17838
70,Syria Cross border,2021,TUR-21/3559/RA1/CCS/NGO/18294,10/11/2022 12:45:18 PM,Returnees,200,200,250,250,900,200,200,250,250,900
70,Syria Cross border,2021,TUR-21/3559/RA1/L/O/18289,8/10/2022 7:08:10 AM,Other,40,40,40,40,160,40,40,40,49,169
70,Syria Cross border,2021,TUR-21/3559/RA1/L/O/18289,8/10/2022 7:08:10 AM,Overall,40,40,40,40,160,40,40,40,49,169
70,Syria Cross border,2021,TUR-21/3559/RA2/E-WASH/UN/18505,12/1/2021 1:18:15 PM,Host Communities,0,0,18295,21986,40281,0,0,1615,2923,4538
70,Syria Cross border,2021,TUR-21/3559/RA2/E-WASH/UN/18505,12/1/2021 1:18:15 PM,Internally Displaced People,160140,166676,56265,58562,441643,0,0,16649,9545,26194
70,Syria Cross border,2021,TUR-21/3559/RA2/E-WASH/UN/18505,12/1/2021 1:18:15 PM,Overall,160140,166676,74560,80548,481924,0,0,18264,12468,30732
70,Syria Cross border,2021,TUR-21/3559/RA2/H/UN/18501,4/18/2022 10:38:09 AM,Host Communities,63987,63618,24050,24500,176155,85000,83000,10100,10200,188300
70,Syria Cross border,2021,TUR-21/3559/RA2/H/UN/18501,4/18/2022 10:38:09 AM,Internally Displaced People,153558,152665,104169,103453,513845,205700,215300,60900,52900,534800
70,Syria Cross border,2021,TUR-21/3559/RA2/H/UN/18501,4/18/2022 10:38:09 AM,Overall,217545,216283,128219,127953,690000,290700,298300,71000,63100,723100
70,Syria Cross border,2021,TUR-21/3559/RA2/P/UN/18502,7/5/2022 7:38:28 AM,Host Communities,0,26699,0,11420,38119,0,25238,0,10909,36147
70,Syria Cross border,2021,TUR-21/3559/RA2/P/UN/18502,7/5/2022 7:38:28 AM,Internally Displaced People,0,65220,0,26661,91881,0,66044,0,27856,93900
70,Syria Cross border,2021,TUR-21/3559/RA2/P/UN/18502,7/5/2022 7:38:28 AM,Overall,0,91919,0,38081,130000,0,91282,0,38765,130047
70,Syria Cross border,2021,TUR-21/3559/RA3/CCM/NGO/18958,2/16/2022 12:44:35 PM,Internally Displaced People,9924,11014,15443,17623,54004,12543,14751,18548,19451,65293
70,Syria Cross border,2021,TUR-21/3559/RA3/CCM/NGO/18958,2/16/2022 12:44:35 PM,Overall,9924,11014,15443,17623,54004,12543,14751,18548,19451,65293
70,Syria Cross border,2021,TUR-21/3559/RA3/E/NGO/18966,7/13/2022 9:38:32 AM,Host Communities,542,555,8358,10014,19469,551,540,8444,9867,19402
70,Syria Cross border,2021,TUR-21/3559/RA3/E/NGO/18966,7/13/2022 9:38:32 AM,Internally Displaced People,555,339,10071,10641,21606,552,346,10044,10790,21732
70,Syria Cross border,2021,TUR-21/3559/RA3/E/NGO/18966,7/13/2022 9:38:32 AM,Overall,1100,898,18511,20732,41241,1106,890,18539,20708,41243
70,Syria Cross border,2021,TUR-21/3559/RA3/E/NGO/18966,7/13/2022 9:38:32 AM,Returnees,3,4,82,77,166,3,4,51,51,109
70,Syria Cross border,2021,TUR-21/3559/RA3/E-CCM-NFI/NGO/18964,8/3/2022 12:34:27 PM,Host Communities,0,0,1618,2250,3868,0,0,1795,2265,4060
70,Syria Cross border,2021,TUR-21/3559/RA3/E-CCM-NFI/NGO/18964,8/3/2022 12:34:27 PM,Internally Displaced People,15970,16719,42288,44885,119862,15974,17344,38063,42769,114150
70,Syria Cross border,2021,TUR-21/3559/RA3/E-CCM-NFI/NGO/18964,8/3/2022 12:34:27 PM,Overall,15970,16719,43906,47135,123730,15974,17344,39858,45034,118210
70,Syria Cross border,2021,TUR-21/3559/RA3/FS/INGO/18973,11/15/2022 8:41:48 AM,Host Communities,7721,8364,12870,13944,42899,6853,7426,12700,13759,40738
70,Syria Cross border,2021,TUR-21/3559/RA3/FS/INGO/18973,11/15/2022 8:41:48 AM,Internally Displaced People,2829,3064,4320,4679,14892,2395,2594,4427,4798,14214
70,Syria Cross border,2021,TUR-21/3559/RA3/FS/INGO/18973,11/15/2022 8:41:48 AM,Overall,10550,11428,17190,18623,57791,9248,10020,17127,18557,54952
70,Syria Cross border,2021,TUR-21/3559/RA3/FS/INGO/18977,9/28/2022 8:19:43 AM,Host Communities,2297,2494,3486,3779,12056,260,225,337,352,1174
70,Syria Cross border,2021,TUR-21/3559/RA3/FS/INGO/18977,9/28/2022 8:19:43 AM,Internally Displaced People,5539,6003,8315,8997,28854,10844,11922,15323,16376,54465
70,Syria Cross border,2021,TUR-21/3559/RA3/FS/INGO/18977,9/28/2022 8:19:43 AM,Overall,7836,8497,11801,12776,40910,11104,12147,15660,16728,55639
70,Syria Cross border,2021,TUR-21/3559/RA3/FS/INGO/18978,7/25/2022 12:14:51 PM,Host Communities,742,685,887,787,3101,0,0,0,0,0
70,Syria Cross border,2021,TUR-21/3559/RA3/FS/INGO/18978,7/25/2022 12:14:51 PM,Internally Displaced People,359,332,430,381,1502,941,1256,1403,1376,4976
70,Syria Cross border,2021,TUR-21/3559/RA3/FS/INGO/18978,7/25/2022 12:14:51 PM,Overall,1159,1070,1386,1230,4845,941,1256,1403,1376,4976
70,Syria Cross border,2021,TUR-21/3559/RA3/FS/INGO/18978,7/25/2022 12:14:51 PM,Returnees,58,53,69,62,242,0,0,0,0,0
70,Syria Cross border,2021,TUR-21/3559/RA3/FS/NGO/18963,7/20/2022 12:02:44 PM,Internally Displaced People,2151,2144,3308,3201,10804,2207,2237,3372,3321,11137
70,Syria Cross border,2021,TUR-21/3559/RA3/FS/NGO/18963,7/20/2022 12:02:44 PM,Overall,2151,2144,3308,3201,10804,2207,2237,3372,3321,11137
70,Syria Cross border,2021,TUR-21/3559/RA3/FS/NGO/18976,7/7/2022 11:17:48 AM,Host Communities,2168,2268,1776,1859,8071,1501,1647,2224,2216,7588
70,Syria Cross border,2021,TUR-21/3559/RA3/FS/NGO/18976,7/7/2022 11:17:48 AM,Internally Displaced People,929,971,761,797,3458,1880,1968,2295,2402,8545
70,Syria Cross border,2021,TUR-21/3559/RA3/FS/NGO/18976,7/7/2022 11:17:48 AM,Overall,3097,3239,2537,2656,11529,3381,3615,4519,4618,16133
70,Syria Cross border,2021,TUR-21/3559/RA3/FS-E/NGO/18974,9/16/2022 7:25:21 AM,Host Communities,3146,3350,13102,13001,32599,3639,3720,12895,14052,34306
70,Syria Cross border,2021,TUR-21/3559/RA3/FS-E/NGO/18974,9/16/2022 7:25:21 AM,Internally Displaced People,614,547,10505,12167,23833,596,449,11057,11474,23576
70,Syria Cross border,2021,TUR-21/3559/RA3/FS-E/NGO/18974,9/16/2022 7:25:21 AM,Overall,3760,3897,23607,25168,56432,4235,4169,23952,25526,57882
70,Syria Cross border,2021,TUR-21/3559/RA3/H/NGO/18979,7/4/2022 8:18:15 AM,Host Communities,0,0,1108,1084,2192,0,0,1289,1073,2362
70,Syria Cross border,2021,TUR-21/3559/RA3/H/NGO/18979,7/4/2022 8:18:15 AM,Internally Displaced People,0,0,27413,22532,49945,0,0,27483,23285,50768
70,Syria Cross border,2021,TUR-21/3559/RA3/H/NGO/18979,7/4/2022 8:18:15 AM,Overall,0,0,28521,23616,52137,0,0,28772,24358,53130
70,Syria Cross border,2021,TUR-21/3559/RA3/NFI/INGO/18968,7/6/2022 1:10:59 PM,Internally Displaced People,325,389,492,377,1583,719,897,1265,1082,3963
70,Syria Cross border,2021,TUR-21/3559/RA3/NFI/INGO/18968,7/6/2022 1:10:59 PM,Overall,325,389,492,377,1583,719,897,1265,1082,3963
70,Syria Cross border,2021,TUR-21/3559/RA3/NFI/INGO/18969,6/9/2022 6:54:56 AM,Host Communities,5890,5437,7047,6250,24624,4658,6373,6889,6655,24575
70,Syria Cross border,2021,TUR-21/3559/RA3/NFI/INGO/18969,6/9/2022 6:54:56 AM,Internally Displaced People,2853,2633,3414,3027,11927,3137,4060,4446,4442,16085
70,Syria Cross border,2021,TUR-21/3559/RA3/NFI/INGO/18969,6/9/2022 6:54:56 AM,Overall,9203,8495,11012,9765,38475,7795,10433,11335,11097,40660
70,Syria Cross border,2021,TUR-21/3559/RA3/NFI/INGO/18969,6/9/2022 6:54:56 AM,Returnees,460,425,551,488,1924,0,0,0,0,0
70,Syria Cross border,2021,TUR-21/3559/RA3/NFI/NGO/18970,6/7/2022 6:39:53 AM,Host Communities,941,1014,1485,1510,4950,993,1441,1239,1220,4893
70,Syria Cross border,2021,TUR-21/3559/RA3/NFI/NGO/18970,6/7/2022 6:39:53 AM,Internally Displaced People,6033,6518,9277,9422,31250,7192,8521,10753,10022,36488
70,Syria Cross border,2021,TUR-21/3559/RA3/NFI/NGO/18970,6/7/2022 6:39:53 AM,Overall,6974,7532,10762,10932,36200,8185,9962,11992,11242,41381
70,Syria Cross border,2021,TUR-21/3559/RA3/NFI/NGO/18971,4/18/2022 8:10:18 AM,Host Communities,119,112,133,163,527,135,166,188,153,642
70,Syria Cross border,2021,TUR-21/3559/RA3/NFI/NGO/18971,4/18/2022 8:10:18 AM,Internally Displaced People,6322,6862,8447,9016,30647,5948,7172,8974,8761,30855
70,Syria Cross border,2021,TUR-21/3559/RA3/NFI/NGO/18971,4/18/2022 8:10:18 AM,Overall,6441,6974,8580,9179,31174,6083,7338,9162,8914,31497
70,Syria Cross border,2021,TUR-21/3559/RA3/NFI/NGO/18972,7/21/2022 8:45:08 AM,Internally Displaced People,6708,8251,15699,14063,44721,9812,14280,18953,17335,60380
70,Syria Cross border,2021,TUR-21/3559/RA3/NFI/NGO/18972,7/21/2022 8:45:08 AM,Overall,6708,8251,15699,14063,44721,9812,14280,18953,17335,60380
70,Syria Cross border,2021,TUR-21/3559/RA3/NFI-CCM/INGO/18956,5/17/2022 11:32:17 AM,Host Communities,1160,1277,1565,1798,5800,1033,1242,961,943,4179
70,Syria Cross border,2021,TUR-21/3559/RA3/NFI-CCM/INGO/18956,5/17/2022 11:32:17 AM,Internally Displaced People,7135,7848,9633,11059,35675,7241,8620,10985,9802,36648
70,Syria Cross border,2021,TUR-21/3559/RA3/NFI-CCM/INGO/18956,5/17/2022 11:32:17 AM,Overall,8295,9125,11198,12857,41475,8274,9862,11946,10745,40827
70,Syria Cross border,2021,TUR-21/3559/RA3/NFI-CCM/NGO/18961,6/22/2022 10:17:57 AM,Internally Displaced People,11589,13701,15862,15684,56836,11165,12953,15470,16317,55905
70,Syria Cross border,2021,TUR-21/3559/RA3/NFI-CCM/NGO/18961,6/22/2022 10:17:57 AM,Overall,11589,13701,15862,15684,56836,11165,12953,15470,16317,55905
70,Syria Cross border,2021,TUR-21/3559/RA3/P/INGO/18981,12/9/2022 11:23:32 AM,Host Communities,300,350,900,900,2450,0,0,0,0,0
70,Syria Cross border,2021,TUR-21/3559/RA3/P/INGO/18981,12/9/2022 11:23:32 AM,Internally Displaced People,200,4610,1100,3740,9650,462,6475,2429,3982,13348
70,Syria Cross border,2021,TUR-21/3559/RA3/P/INGO/18981,12/9/2022 11:23:32 AM,Overall,500,4960,2000,4640,12100,462,6475,2429,3982,13348
70,Syria Cross border,2021,TUR-21/3559/RA3/P/INGO/18982,11/11/2022 10:01:15 AM,Host Communities,6518,5608,1819,1213,15158,5910,6282,3143,3209,18544
70,Syria Cross border,2021,TUR-21/3559/RA3/P/INGO/18982,11/11/2022 10:01:15 AM,Internally Displaced People,5214,4487,1455,970,12126,4276,5692,3945,4366,18279
70,Syria Cross border,2021,TUR-21/3559/RA3/P/INGO/18982,11/11/2022 10:01:15 AM,Other,2752,2367,768,512,6399,2633,2053,2060,1398,8144
70,Syria Cross border,2021,TUR-21/3559/RA3/P/INGO/18982,11/11/2022 10:01:15 AM,Overall,14484,12462,4042,2695,33683,12819,14027,9148,8973,44967
70,Syria Cross border,2021,TUR-21/3559/RA3/WASH/INGO/18986,2/15/2022 12:15:31 PM,Host Communities,1894,2386,3819,3380,11479,1829,2234,3592,3111,10766
70,Syria Cross border,2021,TUR-21/3559/RA3/WASH/INGO/18986,2/15/2022 12:15:31 PM,Internally Displaced People,4772,5912,9452,8086,28222,5044,6105,9800,8544,29493
70,Syria Cross border,2021,TUR-21/3559/RA3/WASH/INGO/18986,2/15/2022 12:15:31 PM,Overall,6666,8298,13271,11466,39701,6873,8339,13392,11655,40259
70,Syria Cross border,2021,TUR-21/3559/RA3/WASH/NGO/18983,7/27/2022 11:37:59 AM,Internally Displaced People,5806,6047,6533,6200,24586,5207,5817,6326,7080,24430
70,Syria Cross border,2021,TUR-21/3559/RA3/WASH/NGO/18983,7/27/2022 11:37:59 AM,Overall,5806,6047,6533,6200,24586,5207,5817,6326,7080,24430
70,Syria Cross border,2021,TUR-21/3559/RA3/WASH/NGO/18984,7/6/2022 11:54:32 AM,Internally Displaced People,5354,6267,7304,7660,26585,5002,5941,7073,7311,25327
70,Syria Cross border,2021,TUR-21/3559/RA3/WASH/NGO/18984,7/6/2022 11:54:32 AM,Overall,5354,6267,7304,7660,26585,5002,5941,7073,7311,25327
70,Syria Cross border,2021,TUR-21/3559/RA3/WASH/NGO/18985,7/12/2022 4:49:31 PM,Internally Displaced People,7917,8926,13313,13835,43991,9040,9785,13480,13842,46147
70,Syria Cross border,2021,TUR-21/3559/RA3/WASH/NGO/18985,7/12/2022 4:49:31 PM,Overall,7917,8926,13313,13835,43991,9040,9785,13480,13842,46147
70,Syria Cross border,2021,TUR-21/3559/RA3/WASH/NGO/18987,5/24/2022 10:12:50 AM,Internally Displaced People,5380,6054,6196,6703,24333,9996,11363,11384,13119,45862
70,Syria Cross border,2021,TUR-21/3559/RA3/WASH/NGO/18987,5/24/2022 10:12:50 AM,Overall,5380,6054,6196,6703,24333,9996,11363,11384,13119,45862
70,Syria Cross border,2021,TUR-21/3559/RA3/WASH/NGO/18988,7/7/2022 8:44:15 AM,Internally Displaced People,8099,8936,8100,9168,34303,7884,8618,7822,8834,33158
70,Syria Cross border,2021,TUR-21/3559/RA3/WASH/NGO/18988,7/7/2022 8:44:15 AM,Overall,8099,8936,8100,9168,34303,7884,8618,7822,8834,33158
70,Syria Cross border,2021,TUR-21/3559/RA4/H/UN/20201,2/19/2023 7:37:31 AM,Host Communities,11727,12362,4126,4185,32400,1141,1088,1138,1030,4397
70,Syria Cross border,2021,TUR-21/3559/RA4/H/UN/20201,2/19/2023 7:37:31 AM,Internally Displaced People,15545,14545,4320,4261,38671,35859,37989,42957,42705,159510
70,Syria Cross border,2021,TUR-21/3559/RA4/H/UN/20201,2/19/2023 7:37:31 AM,Overall,27272,26907,8446,8446,71071,37000,39077,44095,43735,163907
70,Syria Cross border,2021,TUR-21/3559/SA1/CCM-NFI/NGO/18344,10/6/2022 11:31:52 AM,Internally Displaced People,12997,14472,19890,20249,67608,12997,14472,19890,20249,67608
70,Syria Cross border,2021,TUR-21/3559/SA1/CCM-NFI/NGO/18344,10/6/2022 11:31:52 AM,Overall,12997,14472,19890,20249,67608,12997,14472,19890,20249,67608
70,Syria Cross border,2021,TUR-21/3559/SA1/CCM-NFI-WASH/NGO/18341,7/6/2022 11:45:57 AM,Internally Displaced People,21237,23599,27943,31075,103854,21607,23596,38467,36328,119998
70,Syria Cross border,2021,TUR-21/3559/SA1/CCM-NFI-WASH/NGO/18341,7/6/2022 11:45:57 AM,Overall,21237,23599,27943,31075,103854,21607,23596,38467,36328,119998
70,Syria Cross border,2021,TUR-21/3559/SA1/CCM-P-ER/UN/18324,4/11/2023 8:51:34 AM,Host Communities,2140,2331,1258,1641,7370,2384,3131,2674,2787,10976
70,Syria Cross border,2021,TUR-21/3559/SA1/CCM-P-ER/UN/18324,4/11/2023 8:51:34 AM,Internally Displaced People,13554,15304,13194,13534,55586,14569,17227,15683,15332,62811
70,Syria Cross border,2021,TUR-21/3559/SA1/CCM-P-ER/UN/18324,4/11/2023 8:51:34 AM,Other,723,100,0,0,823,0,0,0,0,0
70,Syria Cross border,2021,TUR-21/3559/SA1/CCM-P-ER/UN/18324,4/11/2023 8:51:34 AM,Overall,16417,17735,14452,15175,63779,16953,20358,18357,18119,73787
70,Syria Cross border,2021,TUR-21/3559/SA1/E/INGO/18337,9/9/2022 10:22:05 AM,Host Communities,80,160,1300,1880,3420,97,197,1506,2037,3837
70,Syria Cross border,2021,TUR-21/3559/SA1/E/INGO/18337,9/9/2022 10:22:05 AM,Internally Displaced People,0,0,700,920,1620,0,0,854,1127,1981
70,Syria Cross border,2021,TUR-21/3559/SA1/E/INGO/18337,9/9/2022 10:22:05 AM,Overall,80,160,2000,2800,5040,97,197,2360,3164,5818
70,Syria Cross border,2021,TUR-21/3559/SA1/E/NGO/18334,11/3/2022 8:04:47 AM,Host Communities,162,160,3224,3231,6777,133,173,3455,3563,7324
70,Syria Cross border,2021,TUR-21/3559/SA1/E/NGO/18334,11/3/2022 8:04:47 AM,Internally Displaced People,139,77,3082,3095,6393,165,77,3465,3245,6952
70,Syria Cross border,2021,TUR-21/3559/SA1/E/NGO/18334,11/3/2022 8:04:47 AM,Overall,305,243,6376,6396,13320,298,250,6920,6808,14276
70,Syria Cross border,2021,TUR-21/3559/SA1/E/NGO/18334,11/3/2022 8:04:47 AM,Returnees,4,6,70,70,150,0,0,0,0,0
70,Syria Cross border,2021,TUR-21/3559/SA1/E/NGO/18350,8/31/2022 2:54:52 PM,Host Communities,140,80,2097,2030,4347,172,75,1921,2200,4368
70,Syria Cross border,2021,TUR-21/3559/SA1/E/NGO/18350,8/31/2022 2:54:52 PM,Internally Displaced People,160,100,3484,4155,7899,149,84,4420,4459,9112
70,Syria Cross border,2021,TUR-21/3559/SA1/E/NGO/18350,8/31/2022 2:54:52 PM,Overall,300,180,5581,6185,12246,321,159,6341,6659,13480
70,Syria Cross border,2021,TUR-21/3559/SA1/E-P/NGO/18325,12/19/2022 8:13:23 AM,Internally Displaced People,606,3719,6113,8125,18563,493,1153,7805,10317,19768
70,Syria Cross border,2021,TUR-21/3559/SA1/E-P/NGO/18325,12/19/2022 8:13:23 AM,Overall,606,3719,6113,8125,18563,493,1153,7805,10317,19768
70,Syria Cross border,2021,TUR-21/3559/SA1/ER/INGO/18373,9/2/2022 12:32:57 PM,Host Communities,154,84,0,0,238,239,60,0,0,299
70,Syria Cross border,2021,TUR-21/3559/SA1/ER/INGO/18373,9/2/2022 12:32:57 PM,Internally Displaced People,173,95,0,0,268,162,90,0,0,252
70,Syria Cross border,2021,TUR-21/3559/SA1/ER/INGO/18373,9/2/2022 12:32:57 PM,Overall,384,212,0,0,596,424,154,0,0,578
70,Syria Cross border,2021,TUR-21/3559/SA1/ER/INGO/18373,9/2/2022 12:32:57 PM,Refugees,19,11,0,0,30,0,0,0,0,0
70,Syria Cross border,2021,TUR-21/3559/SA1/ER/INGO/18373,9/2/2022 12:32:57 PM,Returnees,38,22,0,0,60,23,4,0,0,27
70,Syria Cross border,2021,TUR-21/3559/SA1/ER/INGO/18446,9/5/2022 10:32:13 AM,Host Communities,3330,4014,5291,4800,17435,3719,4619,4750,5812,18900
70,Syria Cross border,2021,TUR-21/3559/SA1/ER/INGO/18446,9/5/2022 10:32:13 AM,Internally Displaced People,20651,25342,31187,27773,104953,29604,34320,45024,41324,150272
70,Syria Cross border,2021,TUR-21/3559/SA1/ER/INGO/18446,9/5/2022 10:32:13 AM,Overall,23981,29356,36478,32573,122388,33323,38939,49774,47136,169172
70,Syria Cross border,2021,TUR-21/3559/SA1/ER/NGO/18432,9/30/2022 8:06:32 AM,Host Communities,347,104,0,0,451,289,89,0,0,378
70,Syria Cross border,2021,TUR-21/3559/SA1/ER/NGO/18432,9/30/2022 8:06:32 AM,Internally Displaced People,232,69,0,0,301,369,105,0,0,474
70,Syria Cross border,2021,TUR-21/3559/SA1/ER/NGO/18432,9/30/2022 8:06:32 AM,Overall,579,173,0,0,752,658,194,0,0,852
70,Syria Cross border,2021,TUR-21/3559/SA1/ER/UN/18368,9/15/2022 11:02:45 AM,Host Communities,82975,34925,29725,37050,184675,82975,34925,29725,37050,184675
70,Syria Cross border,2021,TUR-21/3559/SA1/ER/UN/18368,9/15/2022 11:02:45 AM,Internally Displaced People,45750,55720,31700,40650,173820,45750,55720,31700,40650,173820
70,Syria Cross border,2021,TUR-21/3559/SA1/ER/UN/18368,9/15/2022 11:02:45 AM,Overall,132980,94450,64410,81480,373320,132980,94450,64410,81480,373320
70,Syria Cross border,2021,TUR-21/3559/SA1/ER/UN/18368,9/15/2022 11:02:45 AM,Returnees,4255,3805,2985,3780,14825,4255,3805,2985,3780,14825
70,Syria Cross border,2021,TUR-21/3559/SA1/ER-L/UN/18369,7/5/2022 8:18:14 AM,Host Communities,41321,43117,44915,50302,179655,64611,68030,73498,64611,270750
70,Syria Cross border,2021,TUR-21/3559/SA1/ER-L/UN/18369,7/5/2022 8:18:14 AM,Internally Displaced People,75695,79312,83247,92694,330948,62612,75789,88968,102086,329455
70,Syria Cross border,2021,TUR-21/3559/SA1/ER-L/UN/18369,7/5/2022 8:18:14 AM,Overall,117016,122429,128162,142996,510603,127223,143819,162466,166697,600205
70,Syria Cross border,2021,TUR-21/3559/SA1/ER-WASH/NGO/18355,7/5/2022 9:27:58 AM,Host Communities,4654,5266,5113,5422,20455,4710,5323,5212,5489,20734
70,Syria Cross border,2021,TUR-21/3559/SA1/ER-WASH/NGO/18355,7/5/2022 9:27:58 AM,Internally Displaced People,38615,43757,42472,45044,169888,38720,43800,42500,45100,170120
70,Syria Cross border,2021,TUR-21/3559/SA1/ER-WASH/NGO/18355,7/5/2022 9:27:58 AM,Overall,43269,49023,47585,50466,190343,43430,49123,47712,50589,190854
70,Syria Cross border,2021,TUR-21/3559/SA1/E-WASH-P/NGO/18352,8/17/2022 7:26:52 AM,Host Communities,31,22,241,222,516,191,191,904,890,2176
70,Syria Cross border,2021,TUR-21/3559/SA1/E-WASH-P/NGO/18352,8/17/2022 7:26:52 AM,Internally Displaced People,655,484,5170,4785,11094,4011,4007,19100,18832,45950
70,Syria Cross border,2021,TUR-21/3559/SA1/E-WASH-P/NGO/18352,8/17/2022 7:26:52 AM,Overall,686,506,5411,5007,11610,4202,4198,20004,19722,48126
70,Syria Cross border,2021,TUR-21/3559/SA1/FS/INGO/18359,11/15/2022 8:43:51 AM,Host Communities,4397,4763,6594,7145,22899,4617,5001,6897,7418,23933
70,Syria Cross border,2021,TUR-21/3559/SA1/FS/INGO/18359,11/15/2022 8:43:51 AM,Internally Displaced People,2619,2837,3930,4256,13642,2772,3003,4135,4457,14367
70,Syria Cross border,2021,TUR-21/3559/SA1/FS/INGO/18359,11/15/2022 8:43:51 AM,Overall,7016,7600,10524,11401,36541,7389,8004,11032,11875,38300
70,Syria Cross border,2021,TUR-21/3559/SA1/FS/INGO/18433,7/14/2022 10:18:05 AM,Internally Displaced People,1799,1979,2429,2788,8995,2035,2128,2512,2362,9037
70,Syria Cross border,2021,TUR-21/3559/SA1/FS/INGO/18433,7/14/2022 10:18:05 AM,Overall,1799,1979,2429,2788,8995,2035,2128,2512,2362,9037
70,Syria Cross border,2021,TUR-21/3559/SA1/FS/NGO/18338,4/14/2022 7:05:53 AM,Host Communities,832,168,0,0,1000,880,140,0,0,1020
70,Syria Cross border,2021,TUR-21/3559/SA1/FS/NGO/18338,4/14/2022 7:05:53 AM,Internally Displaced People,2914,3016,3648,3836,13414,2688,2872,3372,3381,12313
70,Syria Cross border,2021,TUR-21/3559/SA1/FS/NGO/18338,4/14/2022 7:05:53 AM,Overall,3750,3186,3648,3836,14420,3572,3014,3372,3381,13339
70,Syria Cross border,2021,TUR-21/3559/SA1/FS/NGO/18338,4/14/2022 7:05:53 AM,Returnees,4,2,0,0,6,4,2,0,0,6
70,Syria Cross border,2021,TUR-21/3559/SA1/FS/NGO/18346,9/29/2022 10:21:10 AM,Host Communities,4566,5070,6044,5689,21369,4190,4402,5868,5706,20166
70,Syria Cross border,2021,TUR-21/3559/SA1/FS/NGO/18346,9/29/2022 10:21:10 AM,Internally Displaced People,4379,4849,4301,5695,19224,3634,4058,3921,5142,16755
70,Syria Cross border,2021,TUR-21/3559/SA1/FS/NGO/18346,9/29/2022 10:21:10 AM,Overall,8945,9919,10345,11384,40593,7824,8460,9789,10848,36921
70,Syria Cross border,2021,TUR-21/3559/SA1/FS/NGO/18351,7/5/2022 7:51:13 AM,Host Communities,783,823,997,1047,3650,864,1231,1456,1396,4947
70,Syria Cross border,2021,TUR-21/3559/SA1/FS/NGO/18351,7/5/2022 7:51:13 AM,Internally Displaced People,1470,1544,1870,1965,6849,1610,2026,2783,2578,8997
70,Syria Cross border,2021,TUR-21/3559/SA1/FS/NGO/18351,7/5/2022 7:51:13 AM,Overall,2253,2367,2867,3012,10499,2474,3257,4239,3974,13944
70,Syria Cross border,2021,TUR-21/3559/SA1/FS/NGO/18385,12/9/2022 1:14:15 PM,Internally Displaced People,968,1060,1337,1245,4610,889,1141,1412,1336,4778
70,Syria Cross border,2021,TUR-21/3559/SA1/FS/NGO/18385,12/9/2022 1:14:15 PM,Overall,968,1060,1337,1245,4610,889,1141,1412,1336,4778
70,Syria Cross border,2021,TUR-21/3559/SA1/FS/NGO/18405,7/14/2022 9:35:07 AM,Host Communities,562,687,904,968,3121,737,878,728,714,3057
70,Syria Cross border,2021,TUR-21/3559/SA1/FS/NGO/18405,7/14/2022 9:35:07 AM,Internally Displaced People,2888,3401,4851,4977,16117,2738,3244,3699,3705,13386
70,Syria Cross border,2021,TUR-21/3559/SA1/FS/NGO/18405,7/14/2022 9:35:07 AM,Overall,3450,4088,5755,5945,19238,3475,4122,4427,4419,16443
70,Syria Cross border,2021,TUR-21/3559/SA1/FS/NGO/18422,10/4/2022 12:42:01 PM,Internally Displaced People,4706,5787,7527,7768,25788,5214,6169,7501,7469,26353
70,Syria Cross border,2021,TUR-21/3559/SA1/FS/NGO/18422,10/4/2022 12:42:01 PM,Overall,4706,5787,7527,7768,25788,5214,6169,7501,7469,26353
70,Syria Cross border,2021,TUR-21/3559/SA1/FS/NGO/18434,3/14/2022 1:26:27 PM,Internally Displaced People,4659,5191,4760,4354,18964,3558,4156,4356,4082,16152
70,Syria Cross border,2021,TUR-21/3559/SA1/FS/NGO/18434,3/14/2022 1:26:27 PM,Overall,4659,5191,4760,4354,18964,3558,4156,4356,4082,16152
70,Syria Cross border,2021,TUR-21/3559/SA1/FS/NGO/18445,5/12/2022 12:33:24 PM,Internally Displaced People,2886,3268,3172,3364,12690,2417,2653,4008,3832,12910
70,Syria Cross border,2021,TUR-21/3559/SA1/FS/NGO/18445,5/12/2022 12:33:24 PM,Overall,2886,3268,3172,3364,12690,2417,2653,4008,3832,12910
70,Syria Cross border,2021,TUR-21/3559/SA1/FS/O/18431,9/1/2022 12:50:05 PM,Host Communities,5461,6031,6875,6951,25318,6055,6677,7619,7697,28048
70,Syria Cross border,2021,TUR-21/3559/SA1/FS/O/18431,9/1/2022 12:50:05 PM,Internally Displaced People,126,140,160,162,588,53,54,73,85,265
70,Syria Cross border,2021,TUR-21/3559/SA1/FS/O/18431,9/1/2022 12:50:05 PM,Overall,5587,6171,7035,7113,25906,6108,6731,7692,7782,28313
70,Syria Cross border,2021,TUR-21/3559/SA1/FS/O/18444,7/13/2022 12:45:23 PM,Internally Displaced People,904,785,1322,1341,4352,904,785,1322,1341,4352
70,Syria Cross border,2021,TUR-21/3559/SA1/FS/O/18444,7/13/2022 12:45:23 PM,Overall,904,785,1322,1341,4352,904,785,1322,1341,4352
70,Syria Cross border,2021,TUR-21/3559/SA1/FS/UN/18323,8/4/2022 7:35:16 AM,Host Communities,29727,27767,43146,39350,139990,36317,37467,51086,45574,170444
70,Syria Cross border,2021,TUR-21/3559/SA1/FS/UN/18323,8/4/2022 7:35:16 AM,Internally Displaced People,14754,13539,20228,18183,66704,16707,16865,23524,20978,78074
70,Syria Cross border,2021,TUR-21/3559/SA1/FS/UN/18323,8/4/2022 7:35:16 AM,Overall,44481,41306,63374,57533,206694,53024,54332,74610,66552,248518
70,Syria Cross border,2021,TUR-21/3559/SA1/FS-ER/NGO/18329,8/1/2022 7:46:05 AM,Host Communities,25,16,30,30,101,11,17,16,12,56
70,Syria Cross border,2021,TUR-21/3559/SA1/FS-ER/NGO/18329,8/1/2022 7:46:05 AM,Internally Displaced People,1199,1389,2050,2385,7023,1227,1579,2038,1906,6750
70,Syria Cross border,2021,TUR-21/3559/SA1/FS-ER/NGO/18329,8/1/2022 7:46:05 AM,Overall,1224,1405,2080,2415,7124,1238,1596,2054,1918,6806
70,Syria Cross border,2021,TUR-21/3559/SA1/FS-N/NGO/18342,4/18/2022 7:51:35 AM,Internally Displaced People,30208,43903,52191,50152,176454,9788,27538,22390,21454,81170
70,Syria Cross border,2021,TUR-21/3559/SA1/FS-N/NGO/18342,4/18/2022 7:51:35 AM,Overall,30208,43903,52191,50152,176454,9788,27538,22390,21454,81170
70,Syria Cross border,2021,TUR-21/3559/SA1/FS-N/NGO/18409,8/16/2022 3:12:24 PM,Host Communities,0,4369,6185,6044,16598,8,13797,12977,13274,40056
70,Syria Cross border,2021,TUR-21/3559/SA1/FS-N/NGO/18409,8/16/2022 3:12:24 PM,Internally Displaced People,0,15549,18344,18101,51994,23,18006,20471,19859,58359
70,Syria Cross border,2021,TUR-21/3559/SA1/FS-N/NGO/18409,8/16/2022 3:12:24 PM,Overall,0,21506,26394,26155,74055,33,31827,33504,33173,98537
70,Syria Cross border,2021,TUR-21/3559/SA1/FS-N/NGO/18409,8/16/2022 3:12:24 PM,Returnees,0,1588,1865,2010,5463,2,24,56,40,122
70,Syria Cross border,2021,TUR-21/3559/SA1/FS-WASH-ER/INGO/18447,10/25/2022 7:15:14 AM,Host Communities,138,160,129,137,564,130,153,123,132,538
70,Syria Cross border,2021,TUR-21/3559/SA1/FS-WASH-ER/INGO/18447,10/25/2022 7:15:14 AM,Internally Displaced People,1104,1312,1711,1508,5635,1423,1625,1689,2049,6786
70,Syria Cross border,2021,TUR-21/3559/SA1/FS-WASH-ER/INGO/18447,10/25/2022 7:15:14 AM,Overall,1242,1472,1840,1645,6199,1553,1778,1812,2181,7324
70,Syria Cross border,2021,TUR-21/3559/SA1/H/INGO/18365,9/20/2022 11:34:55 AM,Host Communities,583,570,1388,1541,4082,363,334,1085,993,2775
70,Syria Cross border,2021,TUR-21/3559/SA1/H/INGO/18365,9/20/2022 11:34:55 AM,Internally Displaced People,795,685,1628,1810,4918,1425,1190,3207,2655,8477
70,Syria Cross border,2021,TUR-21/3559/SA1/H/INGO/18365,9/20/2022 11:34:55 AM,Other,30,18,0,0,48,36,12,0,0,48
70,Syria Cross border,2021,TUR-21/3559/SA1/H/INGO/18365,9/20/2022 11:34:55 AM,Overall,1408,1273,3016,3351,9048,1824,1536,4292,3648,11300
70,Syria Cross border,2021,TUR-21/3559/SA1/H/INGO/18386,8/29/2022 6:44:28 AM,Host Communities,364,2778,1145,1282,5569,598,3482,1487,1585,7152
70,Syria Cross border,2021,TUR-21/3559/SA1/H/INGO/18386,8/29/2022 6:44:28 AM,Internally Displaced People,4840,36901,15216,17034,73991,5273,44010,17173,18558,85014
70,Syria Cross border,2021,TUR-21/3559/SA1/H/INGO/18386,8/29/2022 6:44:28 AM,Overall,5204,39679,16361,18316,79560,5871,47492,18660,20143,92166
70,Syria Cross border,2021,TUR-21/3559/SA1/H/INGO/18407,7/4/2022 8:03:50 AM,Host Communities,392,303,13,12,720,426,402,20,10,858
70,Syria Cross border,2021,TUR-21/3559/SA1/H/INGO/18407,7/4/2022 8:03:50 AM,Internally Displaced People,168,130,6,5,309,189,169,6,3,367
70,Syria Cross border,2021,TUR-21/3559/SA1/H/INGO/18407,7/4/2022 8:03:50 AM,Overall,560,433,19,17,1029,615,571,26,13,1225
70,Syria Cross border,2021,TUR-21/3559/SA1/H/NGO/18328,9/26/2022 12:22:25 PM,Host Communities,13500,22500,14000,10700,60700,14269,30515,13542,11442,69768
70,Syria Cross border,2021,TUR-21/3559/SA1/H/NGO/18328,9/26/2022 12:22:25 PM,Internally Displaced People,10300,19300,10400,14300,54300,10658,29423,14667,15536,70284
70,Syria Cross border,2021,TUR-21/3559/SA1/H/NGO/18328,9/26/2022 12:22:25 PM,Overall,23800,41800,24400,25000,115000,24927,59938,28209,26978,140052
70,Syria Cross border,2021,TUR-21/3559/SA1/H/NGO/18353,7/18/2022 10:57:39 AM,Host Communities,2739,4430,2474,3624,13267,4159,2882,1656,838,9535
70,Syria Cross border,2021,TUR-21/3559/SA1/H/NGO/18353,7/18/2022 10:57:39 AM,Internally Displaced People,5087,8228,4595,6730,24640,6114,4138,2023,1100,13375
70,Syria Cross border,2021,TUR-21/3559/SA1/H/NGO/18353,7/18/2022 10:57:39 AM,Overall,7826,12658,7069,10354,37907,10273,7020,3679,1938,22910
70,Syria Cross border,2021,TUR-21/3559/SA1/H/NGO/18358,10/5/2022 11:49:43 AM,Host Communities,4827,4906,2371,2242,14346,8296,9377,3479,2374,23526
70,Syria Cross border,2021,TUR-21/3559/SA1/H/NGO/18358,10/5/2022 11:49:43 AM,Internally Displaced People,7123,8474,3399,2983,21979,9565,9099,4655,2937,26256
70,Syria Cross border,2021,TUR-21/3559/SA1/H/NGO/18358,10/5/2022 11:49:43 AM,Overall,11970,13400,5780,5235,36385,17916,18502,8136,5311,49865
70,Syria Cross border,2021,TUR-21/3559/SA1/H/NGO/18358,10/5/2022 11:49:43 AM,Returnees,20,20,10,10,60,55,26,2,0,83
70,Syria Cross border,2021,TUR-21/3559/SA1/H/NGO/18364,8/19/2022 9:31:34 AM,Host Communities,6708,9503,4560,4392,25163,14666,15702,12176,11339,53883
70,Syria Cross border,2021,TUR-21/3559/SA1/H/NGO/18364,8/19/2022 9:31:34 AM,Internally Displaced People,11508,16327,7512,7248,42595,17925,20830,15608,14375,68738
70,Syria Cross border,2021,TUR-21/3559/SA1/H/NGO/18364,8/19/2022 9:31:34 AM,Overall,18216,25830,12072,11640,67758,32591,36532,27784,25714,122621
70,Syria Cross border,2021,TUR-21/3559/SA1/H/NGO/18370,10/17/2022 8:51:46 AM,Host Communities,2021,2553,372,372,5318,4262,5137,1475,2346,13220
70,Syria Cross border,2021,TUR-21/3559/SA1/H/NGO/18370,10/17/2022 8:51:46 AM,Internally Displaced People,13523,17082,2491,2492,35588,21153,28935,13109,19265,82462
70,Syria Cross border,2021,TUR-21/3559/SA1/H/NGO/18370,10/17/2022 8:51:46 AM,Overall,15544,19635,2863,2864,40906,25415,34072,14584,21611,95682
70,Syria Cross border,2021,TUR-21/3559/SA1/H/NGO/18374,6/9/2022 7:00:34 AM,Host Communities,8141,5817,4333,2345,20636,7447,5792,4767,2579,20585
70,Syria Cross border,2021,TUR-21/3559/SA1/H/NGO/18374,6/9/2022 7:00:34 AM,Internally Displaced People,5012,4529,2107,1645,13293,5083,4773,3201,2184,15241
70,Syria Cross border,2021,TUR-21/3559/SA1/H/NGO/18374,6/9/2022 7:00:34 AM,Overall,13153,10346,6440,3990,33929,12530,10565,7968,4763,35826
70,Syria Cross border,2021,TUR-21/3559/SA1/H/UN/18421,10/17/2022 7:49:48 AM,Host Communities,15562,27908,13027,12118,68615,13538,42291,23214,19998,99041
70,Syria Cross border,2021,TUR-21/3559/SA1/H/UN/18421,10/17/2022 7:49:48 AM,Internally Displaced People,22277,36711,15625,14401,89014,23912,59813,28440,27039,139204
70,Syria Cross border,2021,TUR-21/3559/SA1/H/UN/18421,10/17/2022 7:49:48 AM,Overall,37839,64619,28652,26519,157629,37450,102104,51654,47037,238245
70,Syria Cross border,2021,TUR-21/3559/SA1/H-E/NGO/18362,9/12/2022 7:21:26 AM,Host Communities,7684,11412,9964,10079,39139,7169,13653,9775,8388,38985
70,Syria Cross border,2021,TUR-21/3559/SA1/H-E/NGO/18362,9/12/2022 7:21:26 AM,Internally Displaced People,4162,6165,5944,5893,22164,4433,9520,5647,5371,24971
70,Syria Cross border,2021,TUR-21/3559/SA1/H-E/NGO/18362,9/12/2022 7:21:26 AM,Overall,11846,17577,15908,15972,61303,11602,23173,15422,13759,63956
70,Syria Cross border,2021,TUR-21/3559/SA1/H-P/NGO/18360,9/26/2022 6:29:22 AM,Host Communities,1214,2116,1075,1325,5730,827,823,2127,1689,5466
70,Syria Cross border,2021,TUR-21/3559/SA1/H-P/NGO/18360,9/26/2022 6:29:22 AM,Internally Displaced People,10927,19041,9680,11924,51572,5951,15126,13330,17449,51856
70,Syria Cross border,2021,TUR-21/3559/SA1/H-P/NGO/18360,9/26/2022 6:29:22 AM,Overall,12141,21157,10755,13249,57302,6778,15949,15457,19138,57322
70,Syria Cross border,2021,TUR-21/3559/SA1/L/NGO/18415,7/6/2022 12:57:52 PM,Internally Displaced People,32657,35496,45435,28397,141985,28007,33655,60287,62501,184450
70,Syria Cross border,2021,TUR-21/3559/SA1/L/NGO/18415,7/6/2022 12:57:52 PM,Overall,32657,35496,45435,28397,141985,28007,33655,60287,62501,184450
70,Syria Cross border,2021,TUR-21/3559/SA1/N/INGO/18438,9/8/2022 7:19:30 AM,Internally Displaced People,0,22051,19133,20055,61239,0,22146,20168,20271,62585
70,Syria Cross border,2021,TUR-21/3559/SA1/N/INGO/18438,9/8/2022 7:19:30 AM,Overall,0,22051,19133,20055,61239,0,22146,20168,20271,62585
70,Syria Cross border,2021,TUR-21/3559/SA1/N/INGO/18449,10/11/2022 12:56:44 PM,Host Communities,85,1531,991,1022,3629,180,3776,2239,2647,8842
70,Syria Cross border,2021,TUR-21/3559/SA1/N/INGO/18449,10/11/2022 12:56:44 PM,Internally Displaced People,415,34406,21932,23165,79918,879,41467,31304,33186,106836
70,Syria Cross border,2021,TUR-21/3559/SA1/N/INGO/18449,10/11/2022 12:56:44 PM,Overall,500,35937,22923,24187,83547,1059,45243,33543,35833,115678
70,Syria Cross border,2021,TUR-21/3559/SA1/N/NGO/18441,8/18/2022 8:37:26 AM,Host Communities,0,741,1064,1049,2854,0,552,893,892,2337
70,Syria Cross border,2021,TUR-21/3559/SA1/N/NGO/18441,8/18/2022 8:37:26 AM,Internally Displaced People,0,21259,27811,30576,79646,0,17914,30104,29187,77205
70,Syria Cross border,2021,TUR-21/3559/SA1/N/NGO/18441,8/18/2022 8:37:26 AM,Overall,0,22000,28875,31625,82500,0,18466,30997,30079,79542
70,Syria Cross border,2021,TUR-21/3559/SA1/N/O/18402,10/17/2022 2:27:26 PM,Host Communities,6670,11880,12010,12050,42610,10341,25068,14735,15538,65682
70,Syria Cross border,2021,TUR-21/3559/SA1/N/O/18402,10/17/2022 2:27:26 PM,Internally Displaced People,8605,14540,16645,16690,56480,13120,39694,18176,19099,90089
70,Syria Cross border,2021,TUR-21/3559/SA1/N/O/18402,10/17/2022 2:27:26 PM,Overall,15275,26420,28655,28740,99090,23461,64762,32911,34637,155771
70,Syria Cross border,2021,TUR-21/3559/SA1/NFI/INGO/18448,4/21/2022 7:39:17 AM,Internally Displaced People,1501,1836,2059,2262,7658,3215,3716,4540,4635,16106
70,Syria Cross border,2021,TUR-21/3559/SA1/NFI/INGO/18448,4/21/2022 7:39:17 AM,Overall,1501,1836,2059,2262,7658,3215,3716,4540,4635,16106
70,Syria Cross border,2021,TUR-21/3559/SA1/NFI-CCM/NGO/18408,9/15/2022 10:09:14 AM,Internally Displaced People,11906,12988,14617,14783,54294,11998,14785,17447,15988,60218
70,Syria Cross border,2021,TUR-21/3559/SA1/NFI-CCM/NGO/18408,9/15/2022 10:09:14 AM,Overall,11906,12988,14617,14783,54294,11998,14785,17447,15988,60218
70,Syria Cross border,2021,TUR-21/3559/SA1/NFI-FS/UN/18332,9/1/2022 11:39:42 AM,Host Communities,400,400,600,600,2000,5,6,10,12,33
70,Syria Cross border,2021,TUR-21/3559/SA1/NFI-FS/UN/18332,9/1/2022 11:39:42 AM,Internally Displaced People,12751,13445,19443,18853,64492,16382,18924,26430,24071,85807
70,Syria Cross border,2021,TUR-21/3559/SA1/NFI-FS/UN/18332,9/1/2022 11:39:42 AM,Overall,13151,13845,20043,19453,66492,16387,18930,26440,24083,85840
70,Syria Cross border,2021,TUR-21/3559/SA1/NFI-WASH/NGO/18417,9/8/2022 8:27:53 AM,Host Communities,29124,44889,35472,40279,149764,5309,11028,11436,13070,40843
70,Syria Cross border,2021,TUR-21/3559/SA1/NFI-WASH/NGO/18417,9/8/2022 8:27:53 AM,Internally Displaced People,13446,18142,13289,15102,59979,15851,32950,34150,39049,122000
70,Syria Cross border,2021,TUR-21/3559/SA1/NFI-WASH/NGO/18417,9/8/2022 8:27:53 AM,Overall,42570,63031,48761,55381,209743,21160,43978,45586,52119,162843
70,Syria Cross border,2021,TUR-21/3559/SA1/P/INGO/18327,10/6/2022 6:35:14 AM,Host Communities,744,747,1103,1098,3692,1600,2595,7038,5680,16913
70,Syria Cross border,2021,TUR-21/3559/SA1/P/INGO/18327,10/6/2022 6:35:14 AM,Internally Displaced People,1736,1744,2575,2561,8616,2515,2802,5431,4504,15252
70,Syria Cross border,2021,TUR-21/3559/SA1/P/INGO/18327,10/6/2022 6:35:14 AM,Overall,2480,2491,3678,3659,12308,4115,5397,12469,10184,32165
70,Syria Cross border,2021,TUR-21/3559/SA1/P/NGO/18339,8/3/2022 9:50:02 AM,Host Communities,1463,2455,1064,2355,7337,2415,4011,2065,2505,10996
70,Syria Cross border,2021,TUR-21/3559/SA1/P/NGO/18339,8/3/2022 9:50:02 AM,Internally Displaced People,3519,5959,3300,3600,16378,4158,6230,3724,3942,18054
70,Syria Cross border,2021,TUR-21/3559/SA1/P/NGO/18339,8/3/2022 9:50:02 AM,Overall,4982,8414,4364,5955,23715,6573,10241,5789,6447,29050
70,Syria Cross border,2021,TUR-21/3559/SA1/P/NGO/18349,10/19/2022 8:08:04 AM,Host Communities,2925,4121,7140,8927,23113,2180,2975,6504,8763,20422
70,Syria Cross border,2021,TUR-21/3559/SA1/P/NGO/18349,10/19/2022 8:08:04 AM,Internally Displaced People,6229,8788,14614,18176,47807,6296,10289,17756,17738,52079
70,Syria Cross border,2021,TUR-21/3559/SA1/P/NGO/18349,10/19/2022 8:08:04 AM,Overall,9154,12909,21754,27103,70920,8476,13264,24260,26501,72501
70,Syria Cross border,2021,TUR-21/3559/SA1/P/NGO/18372,9/19/2022 1:22:25 PM,Host Communities,300,1100,330,450,2180,120,1002,160,517,1799
70,Syria Cross border,2021,TUR-21/3559/SA1/P/NGO/18372,9/19/2022 1:22:25 PM,Internally Displaced People,700,2500,770,1050,5020,893,3085,989,1281,6248
70,Syria Cross border,2021,TUR-21/3559/SA1/P/NGO/18372,9/19/2022 1:22:25 PM,Overall,1000,3600,1100,1500,7200,1013,4087,1149,1798,8047
70,Syria Cross border,2021,TUR-21/3559/SA1/P/NGO/18390,10/3/2022 10:54:32 AM,Host Communities,740,2509,698,1448,5395,532,2103,182,1178,3995
70,Syria Cross border,2021,TUR-21/3559/SA1/P/NGO/18390,10/3/2022 10:54:32 AM,Internally Displaced People,1060,4576,1072,2577,9285,1316,4469,1360,2999,10144
70,Syria Cross border,2021,TUR-21/3559/SA1/P/NGO/18390,10/3/2022 10:54:32 AM,Overall,1800,7085,1770,4025,14680,1848,6572,1542,4177,14139
70,Syria Cross border,2021,TUR-21/3559/SA1/P/NGO/18395,9/9/2022 7:59:53 AM,Internally Displaced People,75,75,127,128,405,80,100,298,120,598
70,Syria Cross border,2021,TUR-21/3559/SA1/P/NGO/18395,9/9/2022 7:59:53 AM,Overall,75,75,127,128,405,80,100,298,120,598
70,Syria Cross border,2021,TUR-21/3559/SA1/P/NGO/18416,9/9/2022 7:25:43 AM,Host Communities,1258,1866,5744,5144,14012,774,1857,2504,3170,8305
70,Syria Cross border,2021,TUR-21/3559/SA1/P/NGO/18416,9/9/2022 7:25:43 AM,Internally Displaced People,1867,3036,2652,4111,11666,2545,4008,6145,6651,19349
70,Syria Cross border,2021,TUR-21/3559/SA1/P/NGO/18416,9/9/2022 7:25:43 AM,Overall,3125,4902,8396,9255,25678,3319,5865,8649,9821,27654
70,Syria Cross border,2021,TUR-21/3559/SA1/P-ER/NGO/18347,9/9/2022 7:21:19 AM,Internally Displaced People,3000,11000,4500,6500,25000,3228,12633,5052,7226,28139
70,Syria Cross border,2021,TUR-21/3559/SA1/P-ER/NGO/18347,9/9/2022 7:21:19 AM,Overall,3000,11000,4500,6500,25000,3228,12633,5052,7226,28139
70,Syria Cross border,2021,TUR-21/3559/SA1/WASH/INGO/18393,7/6/2022 2:43:46 PM,Host Communities,2225,2541,2753,3070,10589,2225,2541,2753,3070,10589
70,Syria Cross border,2021,TUR-21/3559/SA1/WASH/INGO/18393,7/6/2022 2:43:46 PM,Internally Displaced People,3973,4821,4275,4595,17664,3974,4822,4277,4597,17670
70,Syria Cross border,2021,TUR-21/3559/SA1/WASH/INGO/18393,7/6/2022 2:43:46 PM,Overall,6198,7362,7028,7665,28253,6199,7363,7030,7667,28259
70,Syria Cross border,2021,TUR-21/3559/SA1/WASH/INGO/18411,9/20/2022 11:52:39 AM,Host Communities,177728,187903,205226,179952,750809,132510,139457,154319,139725,566011
70,Syria Cross border,2021,TUR-21/3559/SA1/WASH/INGO/18411,9/20/2022 11:52:39 AM,Internally Displaced People,216154,234015,286076,252888,989133,243129,259296,317907,305287,1125619
70,Syria Cross border,2021,TUR-21/3559/SA1/WASH/INGO/18411,9/20/2022 11:52:39 AM,Overall,393882,421918,491302,432840,1739942,375639,398753,472226,445012,1691630
70,Syria Cross border,2021,TUR-21/3559/SA1/WASH/INGO/18429,3/24/2022 6:59:15 AM,Host Communities,2122,2765,4229,3727,12843,2806,3637,5627,4844,16914
70,Syria Cross border,2021,TUR-21/3559/SA1/WASH/INGO/18429,3/24/2022 6:59:15 AM,Internally Displaced People,11211,17915,21938,15760,66824,14361,18577,28339,24553,85830
70,Syria Cross border,2021,TUR-21/3559/SA1/WASH/INGO/18429,3/24/2022 6:59:15 AM,Overall,13333,20680,26167,19487,79667,17167,22214,33966,29397,102744
70,Syria Cross border,2021,TUR-21/3559/SA1/WASH/INGO/18443,7/4/2022 8:11:17 AM,Host Communities,18211,16993,12443,13052,60699,13939,19639,20325,19501,73404
70,Syria Cross border,2021,TUR-21/3559/SA1/WASH/INGO/18443,7/4/2022 8:11:17 AM,Internally Displaced People,14224,13273,9719,10192,47408,7211,10161,10518,10092,37982
70,Syria Cross border,2021,TUR-21/3559/SA1/WASH/INGO/18443,7/4/2022 8:11:17 AM,Overall,32435,30266,22162,23244,108107,21150,29800,30843,29593,111386
70,Syria Cross border,2021,TUR-21/3559/SA1/WASH/NGO/18343,4/6/2022 1:28:02 PM,Host Communities,4644,5096,6263,6534,22537,4644,5096,6263,6534,22537
70,Syria Cross border,2021,TUR-21/3559/SA1/WASH/NGO/18343,4/6/2022 1:28:02 PM,Internally Displaced People,3688,3891,4701,5096,17376,3688,3891,4701,5096,17376
70,Syria Cross border,2021,TUR-21/3559/SA1/WASH/NGO/18343,4/6/2022 1:28:02 PM,Overall,8448,9113,11113,11796,40470,8448,9113,11113,11796,40470
70,Syria Cross border,2021,TUR-21/3559/SA1/WASH/NGO/18343,4/6/2022 1:28:02 PM,Returnees,116,126,149,166,557,116,126,149,166,557
70,Syria Cross border,2021,TUR-21/3559/SA1/WASH/NGO/18387,9/12/2022 2:13:26 PM,Host Communities,10115,11712,14907,16505,53239,10115,11712,14907,16505,53239
70,Syria Cross border,2021,TUR-21/3559/SA1/WASH/NGO/18387,9/12/2022 2:13:26 PM,Internally Displaced People,8297,9608,12227,13538,43670,8481,8916,10795,11349,39541
70,Syria Cross border,2021,TUR-21/3559/SA1/WASH/NGO/18387,9/12/2022 2:13:26 PM,Overall,18412,21320,27134,30043,96909,18596,20628,25702,27854,92780
70,Syria Cross border,2021,TUR-21/3559/SA1/WASH/NGO/18412,9/8/2022 7:14:50 AM,Host Communities,9617,11846,14247,17946,53656,9003,9195,8092,9368,35658
70,Syria Cross border,2021,TUR-21/3559/SA1/WASH/NGO/18412,9/8/2022 7:14:50 AM,Internally Displaced People,21791,25698,32382,38940,118811,20470,21711,20097,23426,85704
70,Syria Cross border,2021,TUR-21/3559/SA1/WASH/NGO/18412,9/8/2022 7:14:50 AM,Overall,31408,37544,46629,56886,172467,29473,30906,28189,32794,121362
70,Syria Cross border,2021,TUR-21/3559/SA1/WASH-CCM/NGO/18389,9/6/2022 12:28:59 PM,Host Communities,3081,3221,3779,3919,14000,3081,3221,3779,3919,14000
70,Syria Cross border,2021,TUR-21/3559/SA1/WASH-CCM/NGO/18389,9/6/2022 12:28:59 PM,Internally Displaced People,3829,4003,4697,4871,17400,2153,2400,3579,3140,11272
70,Syria Cross border,2021,TUR-21/3559/SA1/WASH-CCM/NGO/18389,9/6/2022 12:28:59 PM,Overall,6910,7224,8476,8790,31400,5234,5621,7358,7059,25272
70,Syria Cross border,2021,TUR-21/3559/SA1/WASH-CCM/NGO/18436,7/12/2022 5:08:21 PM,Internally Displaced People,2299,2727,3556,3978,12560,2299,2727,3556,3978,12560
70,Syria Cross border,2021,TUR-21/3559/SA1/WASH-CCM/NGO/18436,7/12/2022 5:08:21 PM,Overall,2299,2727,3556,3978,12560,2299,2727,3556,3978,12560
70,Syria Cross border,2021,TUR-21/3559/SA1/WASH-FS/NGO/18348,8/10/2022 7:35:15 AM,Host Communities,1874,1971,2399,2491,8735,1980,2112,2399,2617,9108
70,Syria Cross border,2021,TUR-21/3559/SA1/WASH-FS/NGO/18348,8/10/2022 7:35:15 AM,Internally Displaced People,7141,7509,9237,9417,33304,6631,7357,8864,8373,31225
70,Syria Cross border,2021,TUR-21/3559/SA1/WASH-FS/NGO/18348,8/10/2022 7:35:15 AM,Overall,9015,9480,11636,11908,42039,8611,9469,11263,10990,40333
70,Syria Cross border,2021,TUR-21/3559/SA1/WASH-NFI/NGO/18383,6/23/2022 11:27:58 AM,Host Communities,4860,5940,7560,8640,27000,4860,5940,7560,8640,27000
70,Syria Cross border,2021,TUR-21/3559/SA1/WASH-NFI/NGO/18383,6/23/2022 11:27:58 AM,Internally Displaced People,7713,9103,11616,12961,41393,8923,11352,9784,11382,41441
70,Syria Cross border,2021,TUR-21/3559/SA1/WASH-NFI/NGO/18383,6/23/2022 11:27:58 AM,Overall,12573,15043,19176,21601,68393,13783,17292,17344,20022,68441
70,Syria Cross border,2021,TUR-21/3559/SA1/WASH-P/INGO/18366,6/21/2022 11:44:30 AM,Host Communities,6075,6590,7495,7840,28000,17325,19800,21450,23925,82500
70,Syria Cross border,2021,TUR-21/3559/SA1/WASH-P/INGO/18366,6/21/2022 11:44:30 AM,Internally Displaced People,8108,8782,10054,10476,37420,16448,18905,20257,22704,78314
70,Syria Cross border,2021,TUR-21/3559/SA1/WASH-P/INGO/18366,6/21/2022 11:44:30 AM,Overall,14183,15372,17549,18316,65420,33773,38705,41707,46629,160814
70,Syria Cross border,2021,TUR-21/3559/SA2/E-ER/NGO/20800,3/28/2023 9:53:40 AM,Host Communities,91,197,2201,2640,5129,113,372,2955,3899,7339
70,Syria Cross border,2021,TUR-21/3559/SA2/E-ER/NGO/20800,3/28/2023 9:53:40 AM,Internally Displaced People,129,350,3030,3969,7478,89,203,2209,2759,5260
70,Syria Cross border,2021,TUR-21/3559/SA2/E-ER/NGO/20800,3/28/2023 9:53:40 AM,Overall,220,547,5231,6609,12607,202,575,5164,6658,12599
70,Syria Cross border,2021,TUR-21/3559/SA2/ER/NGO/20718,3/10/2023 8:39:22 AM,Host Communities,300,150,120,120,690,161,217,217,208,803
70,Syria Cross border,2021,TUR-21/3559/SA2/ER/NGO/20718,3/10/2023 8:39:22 AM,Internally Displaced People,280,140,100,100,620,341,361,249,256,1207
70,Syria Cross border,2021,TUR-21/3559/SA2/ER/NGO/20718,3/10/2023 8:39:22 AM,Overall,580,290,220,220,1310,502,578,466,464,2010
70,Syria Cross border,2021,TUR-21/3559/SA2/ER/NGO/20846,5/9/2023 1:41:29 PM,Host Communities,200,90,0,0,290,131,85,0,0,216
70,Syria Cross border,2021,TUR-21/3559/SA2/ER/NGO/20846,5/9/2023 1:41:29 PM,Internally Displaced People,380,150,0,0,530,338,137,0,0,475
70,Syria Cross border,2021,TUR-21/3559/SA2/ER/NGO/20846,5/9/2023 1:41:29 PM,Overall,600,250,0,0,850,505,246,0,0,751
70,Syria Cross border,2021,TUR-21/3559/SA2/ER/NGO/20846,5/9/2023 1:41:29 PM,Returnees,20,10,0,0,30,36,24,0,0,60
70,Syria Cross border,2021,TUR-21/3559/SA2/ER/UN/20630,7/7/2023 10:25:03 AM,Host Communities,1113,566,234,234,2147,7457,7354,10128,18719,43658
70,Syria Cross border,2021,TUR-21/3559/SA2/ER/UN/20630,7/7/2023 10:25:03 AM,Internally Displaced People,2156,1065,366,366,3953,7135,7114,8588,8589,31426
70,Syria Cross border,2021,TUR-21/3559/SA2/ER/UN/20630,7/7/2023 10:25:03 AM,Overall,3269,1631,600,600,6100,14592,14468,18716,27308,75084
70,Syria Cross border,2021,TUR-21/3559/SA2/ER-FS/INGO/20691,4/4/2023 6:14:49 AM,Host Communities,295,319,548,593,1755,337,351,399,416,1503
70,Syria Cross border,2021,TUR-21/3559/SA2/ER-FS/INGO/20691,4/4/2023 6:14:49 AM,Internally Displaced People,194,210,360,391,1155,230,277,469,466,1442
70,Syria Cross border,2021,TUR-21/3559/SA2/ER-FS/INGO/20691,4/4/2023 6:14:49 AM,Overall,489,529,908,984,2910,567,628,868,882,2945
70,Syria Cross border,2021,TUR-21/3559/SA2/ER-FS/NGO/20581,4/3/2023 10:19:17 AM,Host Communities,2119,1832,2222,2336,8509,2035,1772,2261,2098,8166
70,Syria Cross border,2021,TUR-21/3559/SA2/ER-FS/NGO/20581,4/3/2023 10:19:17 AM,Internally Displaced People,1623,1700,2059,2164,7546,1727,1966,2174,2030,7897
70,Syria Cross border,2021,TUR-21/3559/SA2/ER-FS/NGO/20581,4/3/2023 10:19:17 AM,Overall,3860,3659,4428,4653,16600,3882,3865,4580,4280,16607
70,Syria Cross border,2021,TUR-21/3559/SA2/ER-FS/NGO/20581,4/3/2023 10:19:17 AM,Returnees,118,127,147,153,545,120,127,145,152,544
70,Syria Cross border,2021,TUR-21/3559/SA2/ER-FS/NGO/20659,3/30/2023 11:05:54 AM,Host Communities,1061,1271,848,1061,4241,932,949,1129,1106,4116
70,Syria Cross border,2021,TUR-21/3559/SA2/ER-FS/NGO/20659,3/30/2023 11:05:54 AM,Internally Displaced People,3481,4176,2782,3481,13920,3464,4320,3726,4384,15894
70,Syria Cross border,2021,TUR-21/3559/SA2/ER-FS/NGO/20659,3/30/2023 11:05:54 AM,Overall,4542,5447,3630,4542,18161,4396,5269,4855,5490,20010
70,Syria Cross border,2021,TUR-21/3559/SA2/ER-FS-E-P/UN/20640,7/7/2023 10:22:14 AM,Host Communities,9575,11939,12639,13543,47696,9575,11939,12639,13543,47696
70,Syria Cross border,2021,TUR-21/3559/SA2/ER-FS-E-P/UN/20640,7/7/2023 10:22:14 AM,Internally Displaced People,14948,18683,19428,21643,74702,14948,18683,19428,21643,74702
70,Syria Cross border,2021,TUR-21/3559/SA2/ER-FS-E-P/UN/20640,7/7/2023 10:22:14 AM,Overall,24523,30622,32067,35186,122398,24523,30622,32067,35186,122398
70,Syria Cross border,2021,TUR-21/3559/SA2/ER-NFI/UN/20751,4/11/2023 8:31:13 AM,Host Communities,45879,45879,68822,68831,229411,45879,45879,68822,68831,229411
70,Syria Cross border,2021,TUR-21/3559/SA2/ER-NFI/UN/20751,4/11/2023 8:31:13 AM,Internally Displaced People,59399,59180,88293,88541,295413,59399,59180,88293,88541,295413
70,Syria Cross border,2021,TUR-21/3559/SA2/ER-NFI/UN/20751,4/11/2023 8:31:13 AM,Overall,105278,105059,157115,157372,524824,105278,105059,157115,157372,524824
70,Syria Cross border,2021,TUR-21/3559/SA2/ER-P/NGO/20730,4/3/2023 8:01:48 AM,Host Communities,120,316,130,156,722,114,244,117,85,560
70,Syria Cross border,2021,TUR-21/3559/SA2/ER-P/NGO/20730,4/3/2023 8:01:48 AM,Internally Displaced People,180,474,195,234,1083,289,869,280,300,1738
70,Syria Cross border,2021,TUR-21/3559/SA2/ER-P/NGO/20730,4/3/2023 8:01:48 AM,Overall,300,790,325,390,1805,403,1113,397,385,2298
70,Syria Cross border,2021,TUR-21/3559/SA2/ER-WASH/NGO/20611,12/15/2022 11:28:20 AM,Host Communities,116259,174097,93914,62630,446900,116259,174097,93914,62630,446900
70,Syria Cross border,2021,TUR-21/3559/SA2/ER-WASH/NGO/20611,12/15/2022 11:28:20 AM,Internally Displaced People,22002,33016,11855,17777,84650,22002,33016,12730,17518,85266
70,Syria Cross border,2021,TUR-21/3559/SA2/ER-WASH/NGO/20611,12/15/2022 11:28:20 AM,Overall,138261,207113,105769,80407,531550,138261,207113,106644,80148,532166
70,Syria Cross border,2021,TUR-21/3559/SA2/FS/NGO/20566,3/27/2023 6:28:37 AM,Host Communities,2055,2151,1683,1762,7651,1685,2095,1861,1739,7380
70,Syria Cross border,2021,TUR-21/3559/SA2/FS/NGO/20566,3/27/2023 6:28:37 AM,Internally Displaced People,4427,4634,3626,3796,16483,3052,3776,5227,5100,17155
70,Syria Cross border,2021,TUR-21/3559/SA2/FS/NGO/20566,3/27/2023 6:28:37 AM,Overall,6482,6785,5309,5558,24134,4737,5871,7088,6839,24535
70,Syria Cross border,2021,TUR-21/3559/SA2/FS/NGO/20634,3/27/2023 8:59:26 AM,Host Communities,483,507,614,646,2250,616,637,659,644,2556
70,Syria Cross border,2021,TUR-21/3559/SA2/FS/NGO/20634,3/27/2023 8:59:26 AM,Internally Displaced People,5470,5750,6961,7319,25500,5845,6343,7952,7459,27599
70,Syria Cross border,2021,TUR-21/3559/SA2/FS/NGO/20634,3/27/2023 8:59:26 AM,Overall,5953,6257,7575,7965,27750,6461,6980,8611,8103,30155
70,Syria Cross border,2021,TUR-21/3559/SA2/FS/NGO/20698,3/27/2023 6:36:04 AM,Host Communities,1506,1671,1478,1377,6032,1944,2119,2101,2039,8203
70,Syria Cross border,2021,TUR-21/3559/SA2/FS/NGO/20698,3/27/2023 6:36:04 AM,Internally Displaced People,5146,5687,4333,4178,19344,4076,4834,6434,5918,21262
70,Syria Cross border,2021,TUR-21/3559/SA2/FS/NGO/20698,3/27/2023 6:36:04 AM,Overall,6652,7358,5811,5555,25376,6020,6953,8535,7957,29465
70,Syria Cross border,2021,TUR-21/3559/SA2/FS/NGO/20809,7/24/2023 7:43:55 AM,Host Communities,979,1469,1714,1958,6120,736,774,951,829,3290
70,Syria Cross border,2021,TUR-21/3559/SA2/FS/NGO/20809,7/24/2023 7:43:55 AM,Internally Displaced People,5078,6883,8030,9178,29169,5600,6239,8513,9080,29432
70,Syria Cross border,2021,TUR-21/3559/SA2/FS/NGO/20809,7/24/2023 7:43:55 AM,Overall,6057,8352,9744,11136,35289,6336,7013,9464,9909,32722
70,Syria Cross border,2021,TUR-21/3559/SA2/FS/NGO/20816,2/10/2023 12:53:24 PM,Host Communities,877,376,0,0,1253,882,438,0,0,1320
70,Syria Cross border,2021,TUR-21/3559/SA2/FS/NGO/20816,2/10/2023 12:53:24 PM,Internally Displaced People,506,217,0,0,723,324,278,0,0,602
70,Syria Cross border,2021,TUR-21/3559/SA2/FS/NGO/20816,2/10/2023 12:53:24 PM,Overall,1400,600,0,0,2000,1259,741,0,0,2000
70,Syria Cross border,2021,TUR-21/3559/SA2/FS/NGO/20816,2/10/2023 12:53:24 PM,Returnees,17,7,0,0,24,53,25,0,0,78
70,Syria Cross border,2021,TUR-21/3559/SA2/FS/NGO/20863,1/18/2023 11:22:29 AM,Host Communities,784,907,1017,1075,3783,784,907,1017,1075,3783
70,Syria Cross border,2021,TUR-21/3559/SA2/FS/NGO/20863,1/18/2023 11:22:29 AM,Internally Displaced People,4171,4855,5229,5062,19317,4184,4878,5411,5263,19736
70,Syria Cross border,2021,TUR-21/3559/SA2/FS/NGO/20863,1/18/2023 11:22:29 AM,Overall,4955,5762,6246,6137,23100,4968,5785,6428,6338,23519
70,Syria Cross border,2021,TUR-21/3559/SA2/FS-ER/NGO/20842,4/14/2023 6:17:42 AM,Host Communities,1330,2450,2268,2352,8400,3657,3912,4279,4124,15972
70,Syria Cross border,2021,TUR-21/3559/SA2/FS-ER/NGO/20842,4/14/2023 6:17:42 AM,Internally Displaced People,570,1050,972,1008,3600,338,331,438,401,1508
70,Syria Cross border,2021,TUR-21/3559/SA2/FS-ER/NGO/20842,4/14/2023 6:17:42 AM,Overall,1900,3500,3240,3360,12000,3995,4243,4717,4525,17480
70,Syria Cross border,2021,TUR-21/3559/SA2/FS-ER-P/NGO/20555,2/19/2023 8:58:27 AM,Host Communities,1941,3359,1976,2002,9278,1488,2884,1827,1967,8166
70,Syria Cross border,2021,TUR-21/3559/SA2/FS-ER-P/NGO/20555,2/19/2023 8:58:27 AM,Internally Displaced People,6063,11013,6466,6563,30105,5534,8320,8790,7766,30410
70,Syria Cross border,2021,TUR-21/3559/SA2/FS-ER-P/NGO/20555,2/19/2023 8:58:27 AM,Overall,8004,14372,8442,8565,39383,7022,11204,10617,9733,38576
70,Syria Cross border,2021,TUR-21/3559/SA2/H/INGO/20744,3/27/2023 6:31:45 AM,Host Communities,612,640,10,7,1269,499,587,21,20,1127
70,Syria Cross border,2021,TUR-21/3559/SA2/H/INGO/20744,3/27/2023 6:31:45 AM,Internally Displaced People,281,289,7,6,583,281,299,14,12,606
70,Syria Cross border,2021,TUR-21/3559/SA2/H/INGO/20744,3/27/2023 6:31:45 AM,Overall,893,929,17,13,1852,780,886,35,32,1733
70,Syria Cross border,2021,TUR-21/3559/SA2/H/INGO/20745,3/30/2023 11:18:18 AM,Host Communities,4690,9462,1760,1468,17380,12341,14326,2311,2802,31780
70,Syria Cross border,2021,TUR-21/3559/SA2/H/INGO/20745,3/30/2023 11:18:18 AM,Internally Displaced People,4330,9854,1980,1656,17820,5011,13287,8426,9895,36619
70,Syria Cross border,2021,TUR-21/3559/SA2/H/INGO/20745,3/30/2023 11:18:18 AM,Overall,9020,19316,3740,3124,35200,17352,27613,10737,12697,68399
70,Syria Cross border,2021,TUR-21/3559/SA2/H/NGO/20556,3/28/2023 7:26:32 AM,Host Communities,968,803,473,440,2684,1361,1832,627,396,4216
70,Syria Cross border,2021,TUR-21/3559/SA2/H/NGO/20556,3/28/2023 7:26:32 AM,Internally Displaced People,3443,3542,1804,1276,10065,2763,3695,1593,1102,9153
70,Syria Cross border,2021,TUR-21/3559/SA2/H/NGO/20556,3/28/2023 7:26:32 AM,Overall,4411,4345,2277,1716,12749,4124,5527,2220,1498,13369
70,Syria Cross border,2021,TUR-21/3559/SA2/H/NGO/20602,2/19/2023 9:32:24 AM,Host Communities,19056,21690,4421,4354,49521,21832,26415,7701,6084,62032
70,Syria Cross border,2021,TUR-21/3559/SA2/H/NGO/20602,2/19/2023 9:32:24 AM,Internally Displaced People,18317,19214,4124,4061,45716,24244,28264,7377,6483,66368
70,Syria Cross border,2021,TUR-21/3559/SA2/H/NGO/20602,2/19/2023 9:32:24 AM,Overall,37373,40904,8545,8415,95237,46076,54679,15078,12567,128400
70,Syria Cross border,2021,TUR-21/3559/SA2/H/NGO/20650,2/22/2023 7:39:24 AM,Host Communities,6458,3229,4037,2422,16146,6597,5214,4644,2523,18978
70,Syria Cross border,2021,TUR-21/3559/SA2/H/NGO/20650,2/22/2023 7:39:24 AM,Internally Displaced People,1615,807,1009,606,4037,1968,1428,1422,636,5454
70,Syria Cross border,2021,TUR-21/3559/SA2/H/NGO/20650,2/22/2023 7:39:24 AM,Overall,8073,4036,5046,3028,20183,8565,6642,6066,3159,24432
70,Syria Cross border,2021,TUR-21/3559/SA2/H/NGO/20699,5/26/2023 8:49:14 AM,Host Communities,346,8859,862,1326,11393,227,8176,638,1072,10113
70,Syria Cross border,2021,TUR-21/3559/SA2/H/NGO/20699,5/26/2023 8:49:14 AM,Internally Displaced People,296,15939,1600,2246,20081,209,14338,1292,1857,17696
70,Syria Cross border,2021,TUR-21/3559/SA2/H/NGO/20699,5/26/2023 8:49:14 AM,Overall,642,24798,2462,3572,31474,436,22514,1930,2929,27809
70,Syria Cross border,2021,TUR-21/3559/SA2/H/NGO/20820,4/11/2023 8:34:11 AM,Host Communities,2320,4177,1407,1405,9309,689,1095,397,321,2502
70,Syria Cross border,2021,TUR-21/3559/SA2/H/NGO/20820,4/11/2023 8:34:11 AM,Internally Displaced People,7212,12629,4217,4219,28277,1052,1771,1193,960,4976
70,Syria Cross border,2021,TUR-21/3559/SA2/H/NGO/20820,4/11/2023 8:34:11 AM,Overall,9532,16806,5624,5624,37586,1741,2866,1590,1281,7478
70,Syria Cross border,2021,TUR-21/3559/SA2/H/NGO/20829,4/14/2023 7:53:05 AM,Host Communities,0,20484,11760,11652,43896,0,20941,14089,14495,49525
70,Syria Cross border,2021,TUR-21/3559/SA2/H/NGO/20829,4/14/2023 7:53:05 AM,Internally Displaced People,0,18252,10488,10512,39252,0,14783,10932,11177,36892
70,Syria Cross border,2021,TUR-21/3559/SA2/H/NGO/20829,4/14/2023 7:53:05 AM,Overall,0,38736,22248,22164,83148,0,35724,25021,25672,86417
70,Syria Cross border,2021,TUR-21/3559/SA2/H/NGO/20847,11/30/2022 12:17:22 PM,Host Communities,19245,13143,8684,5868,46940,11514,10139,7109,4604,33366
70,Syria Cross border,2021,TUR-21/3559/SA2/H/NGO/20847,11/30/2022 12:17:22 PM,Internally Displaced People,11577,4337,4981,2890,23785,6547,6631,4166,2805,20149
70,Syria Cross border,2021,TUR-21/3559/SA2/H/NGO/20847,11/30/2022 12:17:22 PM,Overall,30822,17480,13665,8758,70725,18061,16770,11275,7409,53515
70,Syria Cross border,2021,TUR-21/3559/SA2/H/UN/20632,7/7/2023 11:30:54 AM,Host Communities,8373,13193,9856,10176,41598,3208,13508,8519,8459,33694
70,Syria Cross border,2021,TUR-21/3559/SA2/H/UN/20632,7/7/2023 11:30:54 AM,Internally Displaced People,6932,11730,7985,8082,34729,5791,21719,13106,13884,54500
70,Syria Cross border,2021,TUR-21/3559/SA2/H/UN/20632,7/7/2023 11:30:54 AM,Overall,15305,24923,17841,18258,76327,8999,35227,21625,22343,88194
70,Syria Cross border,2021,TUR-21/3559/SA2/H-NFI/NGO/20564,2/13/2023 8:50:03 AM,Host Communities,1710,1809,1695,1462,6676,1110,1337,1376,1253,5076
70,Syria Cross border,2021,TUR-21/3559/SA2/H-NFI/NGO/20564,2/13/2023 8:50:03 AM,Internally Displaced People,2392,2561,2505,2162,9620,1980,2296,2695,2253,9224
70,Syria Cross border,2021,TUR-21/3559/SA2/H-NFI/NGO/20564,2/13/2023 8:50:03 AM,Overall,4102,4370,4200,3624,16296,3090,3633,4071,3506,14300
70,Syria Cross border,2021,TUR-21/3559/SA2/NFI/INGO/20729,4/11/2023 8:21:37 AM,Host Communities,137,204,398,420,1159,309,419,370,369,1467
70,Syria Cross border,2021,TUR-21/3559/SA2/NFI/INGO/20729,4/11/2023 8:21:37 AM,Internally Displaced People,1476,2196,4270,4517,12459,2394,2683,3171,3116,11364
70,Syria Cross border,2021,TUR-21/3559/SA2/NFI/INGO/20729,4/11/2023 8:21:37 AM,Overall,1613,2400,4668,4937,13618,2703,3102,3541,3485,12831
70,Syria Cross border,2021,TUR-21/3559/SA2/NFI/NGO/20752,7/5/2022 11:03:49 AM,Host Communities,660,735,990,1365,3750,895,1203,917,877,3892
70,Syria Cross border,2021,TUR-21/3559/SA2/NFI/NGO/20752,7/5/2022 11:03:49 AM,Internally Displaced People,2640,2940,3960,5460,15000,3427,4220,4848,4494,16989
70,Syria Cross border,2021,TUR-21/3559/SA2/NFI/NGO/20752,7/5/2022 11:03:49 AM,Overall,3300,3675,4950,6825,18750,4322,5423,5765,5371,20881
70,Syria Cross border,2021,TUR-21/3559/SA2/NFI/NGO/20765,8/24/2022 3:39:39 PM,Host Communities,1044,1092,1282,1329,4747,1220,1551,997,954,4722
70,Syria Cross border,2021,TUR-21/3559/SA2/NFI/NGO/20765,8/24/2022 3:39:39 PM,Internally Displaced People,2239,2341,2748,2850,10178,2064,2505,2653,2602,9824
70,Syria Cross border,2021,TUR-21/3559/SA2/NFI/NGO/20765,8/24/2022 3:39:39 PM,Overall,3299,3450,4050,4201,15000,3284,4056,3650,3556,14546
70,Syria Cross border,2021,TUR-21/3559/SA2/NFI/NGO/20765,8/24/2022 3:39:39 PM,Returnees,16,17,20,22,75,0,0,0,0,0
70,Syria Cross border,2021,TUR-21/3559/SA2/NFI/O/20875,4/13/2023 7:14:18 AM,Internally Displaced People,263,386,540,772,1961,383,450,633,652,2118
70,Syria Cross border,2021,TUR-21/3559/SA2/NFI/O/20875,4/13/2023 7:14:18 AM,Overall,263,386,540,772,1961,383,450,633,652,2118
70,Syria Cross border,2021,TUR-21/3559/SA2/NFI-ER/INGO/20716,2/22/2023 7:40:35 AM,Host Communities,230,280,460,550,1520,683,735,444,428,2290
70,Syria Cross border,2021,TUR-21/3559/SA2/NFI-ER/INGO/20716,2/22/2023 7:40:35 AM,Internally Displaced People,2163,2229,2512,2441,9345,3458,3619,3206,3117,13400
70,Syria Cross border,2021,TUR-21/3559/SA2/NFI-ER/INGO/20716,2/22/2023 7:40:35 AM,Overall,2393,2509,2972,2991,10865,4141,4354,3650,3545,15690
70,Syria Cross border,2021,TUR-21/3559/SA2/NFI-ER/UN/20631,4/11/2023 11:13:43 AM,Internally Displaced People,862,844,945,945,3596,669,698,962,866,3195
70,Syria Cross border,2021,TUR-21/3559/SA2/NFI-ER/UN/20631,4/11/2023 11:13:43 AM,Overall,862,844,945,945,3596,669,698,962,866,3195
70,Syria Cross border,2021,TUR-21/3559/SA2/NFI-ER-WASH/INGO/20663,2/19/2023 8:53:17 AM,Internally Displaced People,2894,3360,4185,4189,14628,3308,3409,4157,4411,15285
70,Syria Cross border,2021,TUR-21/3559/SA2/NFI-ER-WASH/INGO/20663,2/19/2023 8:53:17 AM,Overall,2894,3360,4185,4189,14628,3308,3409,4157,4411,15285
70,Syria Cross border,2021,TUR-21/3559/SA2/NFI-L/O/20714,5/26/2023 8:46:27 AM,Internally Displaced People,255,281,372,409,1317,255,277,330,322,1184
70,Syria Cross border,2021,TUR-21/3559/SA2/NFI-L/O/20714,5/26/2023 8:46:27 AM,Overall,255,281,372,409,1317,255,277,330,322,1184
70,Syria Cross border,2021,TUR-21/3559/SA2/NFI-WASH/NGO/20832,2/16/2023 8:48:16 AM,Host Communities,539,699,451,563,2252,539,699,451,563,2252
70,Syria Cross border,2021,TUR-21/3559/SA2/NFI-WASH/NGO/20832,2/16/2023 8:48:16 AM,Internally Displaced People,271,295,376,408,1350,437,549,549,552,2087
70,Syria Cross border,2021,TUR-21/3559/SA2/NFI-WASH/NGO/20832,2/16/2023 8:48:16 AM,Overall,810,994,827,971,3602,976,1248,1000,1115,4339
70,Syria Cross border,2021,TUR-21/3559/SA2/NFI-WASH-ER/NGO/20574,1/30/2023 11:03:14 AM,Host Communities,15,1,0,0,16,10,0,0,0,10
70,Syria Cross border,2021,TUR-21/3559/SA2/NFI-WASH-ER/NGO/20574,1/30/2023 11:03:14 AM,Internally Displaced People,593,657,512,633,2395,468,455,616,614,2153
70,Syria Cross border,2021,TUR-21/3559/SA2/NFI-WASH-ER/NGO/20574,1/30/2023 11:03:14 AM,Overall,608,658,512,633,2411,478,455,616,614,2163
70,Syria Cross border,2021,TUR-21/3559/SA2/WASH/INGO/20576,2/13/2023 8:43:47 AM,Host Communities,5638,6444,6981,7786,26849,5638,6444,6981,7786,26849
70,Syria Cross border,2021,TUR-21/3559/SA2/WASH/INGO/20576,2/13/2023 8:43:47 AM,Internally Displaced People,6263,7157,7755,8649,29824,6201,7135,7764,8670,29770
70,Syria Cross border,2021,TUR-21/3559/SA2/WASH/INGO/20576,2/13/2023 8:43:47 AM,Overall,11901,13601,14736,16435,56673,11839,13579,14745,16456,56619
70,Syria Cross border,2021,TUR-21/3559/SA2/WASH/INGO/20769,2/19/2023 8:19:47 AM,Host Communities,17398,10278,21427,21643,70746,17205,10132,21209,21407,69953
70,Syria Cross border,2021,TUR-21/3559/SA2/WASH/INGO/20769,2/19/2023 8:19:47 AM,Internally Displaced People,10491,6253,13102,13278,43124,10063,5940,12631,12766,41400
70,Syria Cross border,2021,TUR-21/3559/SA2/WASH/INGO/20769,2/19/2023 8:19:47 AM,Overall,27889,16531,34529,34921,113870,27268,16072,33840,34173,111353
70,Syria Cross border,2021,TUR-21/3559/SA2/WASH/NGO/20544,10/17/2022 8:25:22 AM,Host Communities,1184,1319,2154,2292,6949,1184,1319,2154,2292,6949
70,Syria Cross border,2021,TUR-21/3559/SA2/WASH/NGO/20544,10/17/2022 8:25:22 AM,Internally Displaced People,691,780,1145,1213,3829,691,780,1145,1213,3829
70,Syria Cross border,2021,TUR-21/3559/SA2/WASH/NGO/20544,10/17/2022 8:25:22 AM,Overall,1875,2099,3299,3505,10778,1875,2099,3299,3505,10778
70,Syria Cross border,2021,TUR-21/3559/SA2/WASH/NGO/20569,11/18/2022 9:52:01 AM,Host Communities,2031,2685,3283,3937,11936,2965,3277,4525,4838,15605
70,Syria Cross border,2021,TUR-21/3559/SA2/WASH/NGO/20569,11/18/2022 9:52:01 AM,Internally Displaced People,272,362,443,533,1610,488,540,745,797,2570
70,Syria Cross border,2021,TUR-21/3559/SA2/WASH/NGO/20569,11/18/2022 9:52:01 AM,Overall,2303,3047,3726,4470,13546,3453,3817,5270,5635,18175
70,Syria Cross border,2021,TUR-21/3559/SA2/WASH/NGO/20633,4/13/2023 7:32:56 AM,Host Communities,6620,7316,10103,10797,34836,6593,7286,10064,10752,34695
70,Syria Cross border,2021,TUR-21/3559/SA2/WASH/NGO/20633,4/13/2023 7:32:56 AM,Internally Displaced People,1986,2195,3032,3241,10454,2048,2264,2995,3097,10404
70,Syria Cross border,2021,TUR-21/3559/SA2/WASH/NGO/20633,4/13/2023 7:32:56 AM,Overall,8606,9511,13135,14038,45290,8641,9550,13059,13849,45099
70,Syria Cross border,2021,TUR-21/3559/SA2/WASH/NGO/20706,3/27/2023 6:30:53 AM,Host Communities,13920,14920,13585,15338,57763,11026,11219,17504,17339,57088
70,Syria Cross border,2021,TUR-21/3559/SA2/WASH/NGO/20706,3/27/2023 6:30:53 AM,Internally Displaced People,3786,4452,3958,4224,16420,3839,3913,5459,5433,18644
70,Syria Cross border,2021,TUR-21/3559/SA2/WASH/NGO/20706,3/27/2023 6:30:53 AM,Overall,17706,19372,17543,19562,74183,14865,15132,22963,22772,75732
70,Syria Cross border,2021,TUR-21/3559/SA2/WASH/NGO/20743,2/20/2023 1:36:50 PM,Host Communities,5090,5395,5095,5334,20914,5383,5373,5373,5334,21463
70,Syria Cross border,2021,TUR-21/3559/SA2/WASH/NGO/20743,2/20/2023 1:36:50 PM,Internally Displaced People,3831,3975,4206,3924,15936,3790,3903,3943,3844,15480
70,Syria Cross border,2021,TUR-21/3559/SA2/WASH/NGO/20743,2/20/2023 1:36:50 PM,Overall,8921,9370,9301,9258,36850,9173,9276,9316,9178,36943
70,Syria Cross border,2021,TUR-21/3559/SA2/WASH/NGO/20838,2/22/2023 7:22:42 AM,Host Communities,10582,11063,12993,13468,48106,8246,8620,10120,10495,37481
70,Syria Cross border,2021,TUR-21/3559/SA2/WASH/NGO/20838,2/22/2023 7:22:42 AM,Internally Displaced People,13640,14260,16740,17360,62000,19241,20117,23615,24489,87462
70,Syria Cross border,2021,TUR-21/3559/SA2/WASH/NGO/20838,2/22/2023 7:22:42 AM,Overall,24222,25323,29733,30828,110106,27487,28737,33735,34984,124943
70,Syria Cross border,2021,TUR-21/3559/SA2/WASH/NGO/20848,3/15/2023 10:02:17 AM,Host Communities,7653,8125,9300,11035,36113,6811,7232,8277,9821,32141
70,Syria Cross border,2021,TUR-21/3559/SA2/WASH/NGO/20848,3/15/2023 10:02:17 AM,Internally Displaced People,4300,5125,5300,5638,20363,3827,4561,4717,5018,18123
70,Syria Cross border,2021,TUR-21/3559/SA2/WASH/NGO/20848,3/15/2023 10:02:17 AM,Overall,11953,13250,14600,16673,56476,10638,11793,12994,14839,50264
70,Syria Cross border,2021,TUR-21/3559/SA2/WASH-NFI/INGO/20861,3/30/2023 8:38:23 AM,Host Communities,2003,2395,2333,2010,8741,2501,2192,3448,3231,11372
70,Syria Cross border,2021,TUR-21/3559/SA2/WASH-NFI/INGO/20861,3/30/2023 8:38:23 AM,Internally Displaced People,6862,8210,8001,6894,29967,8569,7513,11816,11075,38973
70,Syria Cross border,2021,TUR-21/3559/SA2/WASH-NFI/INGO/20861,3/30/2023 8:38:23 AM,Overall,8865,10605,10334,8904,38708,11070,9705,15264,14306,50345
70,Syria Cross border,2022,TUR-22/3559/RA1/FS/UN/23536,4/14/2023 11:28:35 AM,Host Communities,11319,11781,14405,14994,52499,10318,10781,13405,13994,48498
70,Syria Cross border,2022,TUR-22/3559/RA1/FS/UN/23536,4/14/2023 11:28:35 AM,Internally Displaced People,26411,27489,33614,34986,122500,25099,27177,31552,32674,116502
70,Syria Cross border,2022,TUR-22/3559/RA1/FS/UN/23536,4/14/2023 11:28:35 AM,Overall,37730,39270,48019,49980,174999,35417,37958,44957,46668,165000
70,Syria Cross border,2022,TUR-22/3559/RA1/FS/UN/23537,7/11/2023 6:29:42 AM,Host Communities,28123,33628,46439,59810,168000,21410,21478,28430,25884,97202
70,Syria Cross border,2022,TUR-22/3559/RA1/FS/UN/23537,7/11/2023 6:29:42 AM,Internally Displaced People,11410,14142,20961,25487,72000,10472,10458,13947,12662,47539
70,Syria Cross border,2022,TUR-22/3559/RA1/FS/UN/23537,7/11/2023 6:29:42 AM,Overall,39533,47770,67400,85297,240000,31882,31936,42377,38546,144741
70,Syria Cross border,2022,TUR-22/3559/RA1/NFI/INGO/23540,4/11/2023 9:34:38 AM,Host Communities,6641,7193,9260,6986,30080,5207,9165,6550,6279,27201
70,Syria Cross border,2022,TUR-22/3559/RA1/NFI/INGO/23540,4/11/2023 9:34:38 AM,Internally Displaced People,15971,17301,22271,16801,72344,14321,18051,20509,20095,72976
70,Syria Cross border,2022,TUR-22/3559/RA1/NFI/INGO/23540,4/11/2023 9:34:38 AM,Overall,22622,24505,31545,23798,102470,19536,27227,27061,26383,100207
70,Syria Cross border,2022,TUR-22/3559/RA1/NFI/INGO/23540,4/11/2023 9:34:38 AM,Returnees,10,11,14,11,46,8,11,2,9,30
70,Syria Cross border,2022,TUR-22/3559/RA1/NFI/INGO/23542,3/27/2023 9:11:37 AM,Host Communities,1422,1549,1712,1634,6317,955,1161,1091,1118,4325
70,Syria Cross border,2022,TUR-22/3559/RA1/NFI/INGO/23542,3/27/2023 9:11:37 AM,Internally Displaced People,10786,12526,15370,14032,52714,10668,13352,15637,15579,55236
70,Syria Cross border,2022,TUR-22/3559/RA1/NFI/INGO/23542,3/27/2023 9:11:37 AM,Overall,12208,14075,17082,15666,59031,11623,14513,16728,16697,59561
70,Syria Cross border,2022,TUR-22/3559/RA1/NFI/NGO/23541,3/24/2023 9:29:38 AM,Host Communities,298,364,464,530,1656,246,300,382,436,1364
70,Syria Cross border,2022,TUR-22/3559/RA1/NFI/NGO/23541,3/24/2023 9:29:38 AM,Internally Displaced People,12122,14816,18856,21550,67344,9779,11952,15211,17384,54326
70,Syria Cross border,2022,TUR-22/3559/RA1/NFI/NGO/23541,3/24/2023 9:29:38 AM,Overall,12420,15180,19320,22080,69000,10025,12252,15593,17820,55690
70,Syria Cross border,2022,TUR-22/3559/RA1/NFI/UN/23534,7/3/2023 12:14:59 PM,Internally Displaced People,6086,6087,9131,9131,30435,6698,7724,9257,8203,31882
70,Syria Cross border,2022,TUR-22/3559/RA1/NFI/UN/23534,7/3/2023 12:14:59 PM,Overall,6086,6087,9131,9131,30435,6698,7724,9257,8203,31882
70,Syria Cross border,2022,TUR-22/3559/RA1/NFI/UN/23535,6/22/2023 9:41:07 AM,Host Communities,2100,2300,1120,1120,6640,2095,2089,3001,3187,10372
70,Syria Cross border,2022,TUR-22/3559/RA1/NFI/UN/23535,6/22/2023 9:41:07 AM,Internally Displaced People,8400,9200,12880,12880,43360,8729,9480,11893,12154,42256
70,Syria Cross border,2022,TUR-22/3559/RA1/NFI/UN/23535,6/22/2023 9:41:07 AM,Overall,10500,11500,14000,14000,50000,10824,11569,14894,15341,52628
70,Syria Cross border,2022,TUR-22/3559/RA1/P/UN/23539,9/4/2023 10:37:59 AM,Host Communities,0,12725,0,5250,17975,0,12311,0,6287,18598
70,Syria Cross border,2022,TUR-22/3559/RA1/P/UN/23539,9/4/2023 10:37:59 AM,Internally Displaced People,0,37492,0,14533,52025,0,36377,0,15025,51402
70,Syria Cross border,2022,TUR-22/3559/RA1/P/UN/23539,9/4/2023 10:37:59 AM,Overall,0,50217,0,19783,70000,0,48688,0,21312,70000
70,Syria Cross border,2022,TUR-22/3559/SA1/E/INGO/21955,9/25/2023 1:33:36 PM,Host Communities,122,132,2625,2780,5659,119,205,3018,3090,6432
70,Syria Cross border,2022,TUR-22/3559/SA1/E/INGO/21955,9/25/2023 1:33:36 PM,Internally Displaced People,99,95,1745,1750,3689,119,119,2121,1701,4060
70,Syria Cross border,2022,TUR-22/3559/SA1/E/INGO/21955,9/25/2023 1:33:36 PM,Overall,221,227,4370,4530,9348,238,324,5139,4791,10492
70,Syria Cross border,2022,TUR-22/3559/SA1/E/INGO/22190,8/7/2023 1:19:32 PM,Host Communities,21,24,0,0,45,7,7,0,0,14
70,Syria Cross border,2022,TUR-22/3559/SA1/E/INGO/22190,8/7/2023 1:19:32 PM,Internally Displaced People,62,74,1548,1548,3232,80,55,1589,1569,3293
70,Syria Cross border,2022,TUR-22/3559/SA1/E/INGO/22190,8/7/2023 1:19:32 PM,Overall,83,98,1548,1548,3277,87,62,1589,1569,3307
70,Syria Cross border,2022,TUR-22/3559/SA1/E/NGO/22016,10/9/2023 9:39:29 AM,Host Communities,171,179,4509,4157,9016,146,229,4215,4471,9061
70,Syria Cross border,2022,TUR-22/3559/SA1/E/NGO/22016,10/9/2023 9:39:29 AM,Internally Displaced People,175,83,3055,2862,6175,182,103,3557,3639,7481
70,Syria Cross border,2022,TUR-22/3559/SA1/E/NGO/22016,10/9/2023 9:39:29 AM,Overall,346,262,7594,7049,15251,328,332,7772,8110,16542
70,Syria Cross border,2022,TUR-22/3559/SA1/E/NGO/22016,10/9/2023 9:39:29 AM,Returnees,0,0,30,30,60,0,0,0,0,0
70,Syria Cross border,2022,TUR-22/3559/SA1/E/NGO/22215,8/7/2023 6:28:19 AM,Host Communities,5,1,9,35,50,13,9,121,153,296
70,Syria Cross border,2022,TUR-22/3559/SA1/E/NGO/22215,8/7/2023 6:28:19 AM,Internally Displaced People,98,57,2085,2375,4615,121,102,2623,2803,5649
70,Syria Cross border,2022,TUR-22/3559/SA1/E/NGO/22215,8/7/2023 6:28:19 AM,Overall,103,58,2094,2410,4665,134,111,2744,2956,5945
70,Syria Cross border,2022,TUR-22/3559/SA1/E-P/NGO/21931,9/7/2023 11:37:53 AM,Internally Displaced People,2180,2235,5274,5289,14978,2005,2164,6815,6473,17457
70,Syria Cross border,2022,TUR-22/3559/SA1/E-P/NGO/21931,9/7/2023 11:37:53 AM,Overall,2180,2235,5274,5289,14978,2005,2164,6815,6473,17457
70,Syria Cross border,2022,TUR-22/3559/SA1/E-P/NGO/22178,8/2/2023 1:16:44 PM,Internally Displaced People,1055,1086,7625,9153,18919,1706,899,8409,8724,19738
70,Syria Cross border,2022,TUR-22/3559/SA1/E-P/NGO/22178,8/2/2023 1:16:44 PM,Overall,1055,1086,7625,9153,18919,1706,899,8409,8724,19738
70,Syria Cross border,2022,TUR-22/3559/SA1/ER/NGO/22047,7/4/2023 9:07:24 AM,Host Communities,9522,10011,12119,12741,44393,14931,13573,15144,14652,58300
70,Syria Cross border,2022,TUR-22/3559/SA1/ER/NGO/22047,7/4/2023 9:07:24 AM,Internally Displaced People,11284,11863,14362,15098,52607,8949,9147,10378,10226,38700
70,Syria Cross border,2022,TUR-22/3559/SA1/ER/NGO/22047,7/4/2023 9:07:24 AM,Overall,20806,21874,26481,27839,97000,23880,22720,25522,24878,97000
70,Syria Cross border,2022,TUR-22/3559/SA1/ER/NGO/22241,10/13/2023 7:55:24 AM,Host Communities,231,277,282,263,1053,181,209,175,290,855
70,Syria Cross border,2022,TUR-22/3559/SA1/ER/NGO/22241,10/13/2023 7:55:24 AM,Internally Displaced People,231,277,282,263,1053,179,186,256,254,875
70,Syria Cross border,2022,TUR-22/3559/SA1/ER/NGO/22241,10/13/2023 7:55:24 AM,Overall,462,554,564,526,2106,360,395,431,544,1730
70,Syria Cross border,2022,TUR-22/3559/SA1/ER/UN/22100,10/5/2023 9:46:02 AM,Host Communities,19158,21240,27708,22294,90400,19158,21240,27708,22294,90400
70,Syria Cross border,2022,TUR-22/3559/SA1/ER/UN/22100,10/5/2023 9:46:02 AM,Internally Displaced People,151580,145486,188435,169080,654581,151580,145486,188435,169080,654581
70,Syria Cross border,2022,TUR-22/3559/SA1/ER/UN/22100,10/5/2023 9:46:02 AM,Overall,170738,166726,216143,191374,744981,170738,166726,216143,191374,744981
70,Syria Cross border,2022,TUR-22/3559/SA1/ER-FS/INGO/21933,10/4/2023 11:30:27 AM,Host Communities,9414,11057,10673,8765,39909,19220,22575,21790,17895,81480
70,Syria Cross border,2022,TUR-22/3559/SA1/ER-FS/INGO/21933,10/4/2023 11:30:27 AM,Internally Displaced People,4591,5428,5293,4349,19661,12601,14898,14527,11937,53963
70,Syria Cross border,2022,TUR-22/3559/SA1/ER-FS/INGO/21933,10/4/2023 11:30:27 AM,Overall,14005,16485,15966,13114,59570,31821,37473,36317,29832,135443
70,Syria Cross border,2022,TUR-22/3559/SA1/ER-FS/NGO/22249,8/18/2023 11:34:56 AM,Host Communities,8634,10809,12108,11732,43283,7059,7554,9230,7978,31821
70,Syria Cross border,2022,TUR-22/3559/SA1/ER-FS/NGO/22249,8/18/2023 11:34:56 AM,Internally Displaced People,10847,12765,14884,14894,53390,11714,11573,14534,15693,53514
70,Syria Cross border,2022,TUR-22/3559/SA1/ER-FS/NGO/22249,8/18/2023 11:34:56 AM,Overall,19481,23574,26992,26626,96673,18773,19127,23764,23671,85335
70,Syria Cross border,2022,TUR-22/3559/SA1/ER-FS-P/INGO/22041,10/16/2023 8:28:31 AM,Host Communities,1031,990,700,800,3521,417,502,376,376,1671
70,Syria Cross border,2022,TUR-22/3559/SA1/ER-FS-P/INGO/22041,10/16/2023 8:28:31 AM,Internally Displaced People,964,921,776,764,3425,1100,1220,1484,1411,5215
70,Syria Cross border,2022,TUR-22/3559/SA1/ER-FS-P/INGO/22041,10/16/2023 8:28:31 AM,Overall,1995,1911,1476,1564,6946,1517,1722,1860,1787,6886
70,Syria Cross border,2022,TUR-22/3559/SA1/FS/NGO/21968,7/26/2023 11:40:39 AM,Host Communities,1152,1318,1211,1265,4946,1298,1260,1598,1271,5427
70,Syria Cross border,2022,TUR-22/3559/SA1/FS/NGO/21968,7/26/2023 11:40:39 AM,Internally Displaced People,6370,7280,6674,6977,27301,7666,8038,10625,10940,37269
70,Syria Cross border,2022,TUR-22/3559/SA1/FS/NGO/21968,7/26/2023 11:40:39 AM,Overall,7522,8598,7885,8242,32247,8964,9298,12223,12211,42696
70,Syria Cross border,2022,TUR-22/3559/SA1/FS/UN/22157,7/3/2023 9:44:05 AM,Internally Displaced People,4200,4200,6300,6300,21000,4066,4591,5922,5289,19868
70,Syria Cross border,2022,TUR-22/3559/SA1/FS/UN/22157,7/3/2023 9:44:05 AM,Overall,4200,4200,6300,6300,21000,4066,4591,5922,5289,19868
70,Syria Cross border,2022,TUR-22/3559/SA1/FS-CCM-H/NGO/22227,4/4/2023 7:36:11 AM,Host Communities,702,555,0,0,1257,708,2032,945,946,4631
70,Syria Cross border,2022,TUR-22/3559/SA1/FS-CCM-H/NGO/22227,4/4/2023 7:36:11 AM,Internally Displaced People,2698,2845,2882,2782,11207,2437,6977,4214,3880,17508
70,Syria Cross border,2022,TUR-22/3559/SA1/FS-CCM-H/NGO/22227,4/4/2023 7:36:11 AM,Overall,3400,3400,2882,2782,12464,3145,9009,5159,4826,22139
70,Syria Cross border,2022,TUR-22/3559/SA1/FS-ER/NGO/22042,9/18/2023 12:29:34 PM,Host Communities,297,126,76,78,577,293,130,82,73,578
70,Syria Cross border,2022,TUR-22/3559/SA1/FS-ER/NGO/22042,9/18/2023 12:29:34 PM,Internally Displaced People,4830,5072,5384,5409,20695,4719,5131,4716,4752,19318
70,Syria Cross border,2022,TUR-22/3559/SA1/FS-ER/NGO/22042,9/18/2023 12:29:34 PM,Overall,5127,5198,5460,5487,21272,5012,5261,4798,4825,19896
70,Syria Cross border,2022,TUR-22/3559/SA1/FS-ER/NGO/22050,6/5/2023 5:54:11 AM,Host Communities,1675,2012,1338,1676,6701,1075,1224,1434,1329,5062
70,Syria Cross border,2022,TUR-22/3559/SA1/FS-ER/NGO/22050,6/5/2023 5:54:11 AM,Internally Displaced People,826,989,666,818,3299,1306,1453,1837,1741,6337
70,Syria Cross border,2022,TUR-22/3559/SA1/FS-ER/NGO/22050,6/5/2023 5:54:11 AM,Overall,2501,3001,2004,2494,10000,2381,2677,3271,3070,11399
70,Syria Cross border,2022,TUR-22/3559/SA1/FS-ER/NGO/22170,5/4/2023 1:19:22 PM,Host Communities,112,127,129,151,519,587,254,0,0,841
70,Syria Cross border,2022,TUR-22/3559/SA1/FS-ER/NGO/22170,5/4/2023 1:19:22 PM,Internally Displaced People,4349,4790,4646,5163,18948,3882,5536,6400,5292,21110
70,Syria Cross border,2022,TUR-22/3559/SA1/FS-ER/NGO/22170,5/4/2023 1:19:22 PM,Overall,4461,4917,4775,5314,19467,4469,5790,6400,5292,21951
70,Syria Cross border,2022,TUR-22/3559/SA1/FS-ER/NGO/22213,9/6/2023 12:16:47 PM,Host Communities,19088,21522,12674,14298,67582,14705,15437,14474,13765,58381
70,Syria Cross border,2022,TUR-22/3559/SA1/FS-ER/NGO/22213,9/6/2023 12:16:47 PM,Internally Displaced People,3492,3923,2277,2540,12232,6844,7145,6531,6210,26730
70,Syria Cross border,2022,TUR-22/3559/SA1/FS-ER/NGO/22213,9/6/2023 12:16:47 PM,Overall,23279,26182,15368,17313,82142,22329,23410,21767,20699,88205
70,Syria Cross border,2022,TUR-22/3559/SA1/FS-ER/NGO/22213,9/6/2023 12:16:47 PM,Returnees,699,737,417,475,2328,780,828,762,724,3094
70,Syria Cross border,2022,TUR-22/3559/SA1/FS-ER-N/NGO/21964,9/25/2023 9:08:40 AM,Host Communities,510,20416,31431,29584,81941,636,31903,36106,30203,98848
70,Syria Cross border,2022,TUR-22/3559/SA1/FS-ER-N/NGO/21964,9/25/2023 9:08:40 AM,Internally Displaced People,5053,48998,72035,67870,193956,4990,63572,64565,63902,197029
70,Syria Cross border,2022,TUR-22/3559/SA1/FS-ER-N/NGO/21964,9/25/2023 9:08:40 AM,Overall,5563,69414,103466,97454,275897,5626,95475,100671,94105,295877
70,Syria Cross border,2022,TUR-22/3559/SA1/H/INGO/22167,10/19/2023 7:07:10 AM,Host Communities,24,4286,2465,2602,9377,18,4356,3550,3585,11509
70,Syria Cross border,2022,TUR-22/3559/SA1/H/INGO/22167,10/19/2023 7:07:10 AM,Internally Displaced People,76,17252,9924,10471,37723,73,13067,10649,10754,34543
70,Syria Cross border,2022,TUR-22/3559/SA1/H/INGO/22167,10/19/2023 7:07:10 AM,Overall,100,21538,12389,13073,47100,91,17423,14199,14339,46052
70,Syria Cross border,2022,TUR-22/3559/SA1/H/NGO/22079,10/16/2023 10:28:25 AM,Host Communities,12690,24547,12776,11450,61463,20391,30326,18306,15312,84335
70,Syria Cross border,2022,TUR-22/3559/SA1/H/NGO/22079,10/16/2023 10:28:25 AM,Internally Displaced People,20366,38251,19940,17610,96167,15264,26235,16597,13094,71190
70,Syria Cross border,2022,TUR-22/3559/SA1/H/NGO/22079,10/16/2023 10:28:25 AM,Overall,33056,62798,32716,29060,157630,35655,56561,34903,28406,155525
70,Syria Cross border,2022,TUR-22/3559/SA1/H/NGO/22083,6/26/2023 6:30:45 AM,Host Communities,20,3805,1740,2165,7730,88,1720,843,1113,3764
70,Syria Cross border,2022,TUR-22/3559/SA1/H/NGO/22083,6/26/2023 6:30:45 AM,Internally Displaced People,540,15775,13420,12875,42610,1399,21239,12022,11553,46213
70,Syria Cross border,2022,TUR-22/3559/SA1/H/NGO/22083,6/26/2023 6:30:45 AM,Overall,560,19580,15160,15040,50340,1487,22959,12865,12666,49977
70,Syria Cross border,2022,TUR-22/3559/SA1/H/NGO/22125,9/20/2023 2:43:58 PM,Host Communities,6146,7007,2580,2820,18553,8574,6605,4726,2213,22118
70,Syria Cross border,2022,TUR-22/3559/SA1/H/NGO/22125,9/20/2023 2:43:58 PM,Internally Displaced People,11415,13012,4792,5236,34455,8101,5754,4055,1943,19853
70,Syria Cross border,2022,TUR-22/3559/SA1/H/NGO/22125,9/20/2023 2:43:58 PM,Overall,17561,20019,7372,8056,53008,16675,12359,8781,4156,41971
70,Syria Cross border,2022,TUR-22/3559/SA1/H/NGO/22207,7/7/2023 8:28:44 AM,Host Communities,17578,16871,11903,8009,54361,18595,16589,10762,7294,53240
70,Syria Cross border,2022,TUR-22/3559/SA1/H/NGO/22207,7/7/2023 8:28:44 AM,Internally Displaced People,8325,7527,5479,3285,24616,8410,7343,4958,3533,24244
70,Syria Cross border,2022,TUR-22/3559/SA1/H/NGO/22207,7/7/2023 8:28:44 AM,Overall,25903,24398,17382,11294,78977,27005,23932,15720,10827,77484
70,Syria Cross border,2022,TUR-22/3559/SA1/H/NGO/22212,9/25/2023 2:19:01 PM,Host Communities,6737,4669,2900,2200,16506,8486,8831,3655,2684,23656
70,Syria Cross border,2022,TUR-22/3559/SA1/H/NGO/22212,9/25/2023 2:19:01 PM,Internally Displaced People,9123,8911,4790,5090,27914,9755,11849,5741,4793,32138
70,Syria Cross border,2022,TUR-22/3559/SA1/H/NGO/22212,9/25/2023 2:19:01 PM,Overall,15900,13600,7700,7300,44500,18281,20711,9397,7477,55866
70,Syria Cross border,2022,TUR-22/3559/SA1/H/NGO/22212,9/25/2023 2:19:01 PM,Returnees,40,20,10,10,80,40,31,1,0,72
70,Syria Cross border,2022,TUR-22/3559/SA1/H-E/NGO/21956,10/5/2023 10:28:57 AM,Host Communities,8705,17222,11472,11023,48422,8537,15760,10168,10319,44784
70,Syria Cross border,2022,TUR-22/3559/SA1/H-E/NGO/21956,10/5/2023 10:28:57 AM,Internally Displaced People,5616,13645,8706,8705,36672,5435,13040,9017,9543,37035
70,Syria Cross border,2022,TUR-22/3559/SA1/H-E/NGO/21956,10/5/2023 10:28:57 AM,Overall,14321,30867,20178,19728,85094,13972,28800,19185,19862,81819
70,Syria Cross border,2022,TUR-22/3559/SA1/H-P/NGO/21963,9/28/2023 1:01:35 PM,Host Communities,4785,8886,4284,4384,22339,5784,10617,5741,6157,28299
70,Syria Cross border,2022,TUR-22/3559/SA1/H-P/NGO/21963,9/28/2023 1:01:35 PM,Internally Displaced People,12805,20516,8855,8763,50939,12919,20873,10526,10536,54854
70,Syria Cross border,2022,TUR-22/3559/SA1/H-P/NGO/21963,9/28/2023 1:01:35 PM,Overall,17590,29402,13139,13147,73278,18703,31490,16267,16693,83153
70,Syria Cross border,2022,TUR-22/3559/SA1/H-WASH/INGO/22022,10/17/2023 7:46:01 AM,Host Communities,129989,140508,154749,136074,561320,100480,107680,120326,111848,440334
70,Syria Cross border,2022,TUR-22/3559/SA1/H-WASH/INGO/22022,10/17/2023 7:46:01 AM,Internally Displaced People,223559,248644,309380,279694,1061277,263701,284478,349166,337003,1234348
70,Syria Cross border,2022,TUR-22/3559/SA1/H-WASH/INGO/22022,10/17/2023 7:46:01 AM,Overall,353548,389152,464129,415768,1622597,364181,392158,469492,448851,1674682
70,Syria Cross border,2022,TUR-22/3559/SA1/N/INGO/22210,9/18/2023 9:59:23 AM,Host Communities,229,34161,31251,30844,96485,411,15338,13074,12969,41792
70,Syria Cross border,2022,TUR-22/3559/SA1/N/INGO/22210,9/18/2023 9:59:23 AM,Internally Displaced People,535,79709,72920,71970,225134,4358,102995,92798,92393,292544
70,Syria Cross border,2022,TUR-22/3559/SA1/N/INGO/22210,9/18/2023 9:59:23 AM,Overall,764,113870,104171,102814,321619,4769,118333,105872,105362,334336
70,Syria Cross border,2022,TUR-22/3559/SA1/NFI/INGO/22224,9/14/2023 6:44:51 AM,Internally Displaced People,2096,2157,2795,1986,9034,2063,2103,2781,1967,8914
70,Syria Cross border,2022,TUR-22/3559/SA1/NFI/INGO/22224,9/14/2023 6:44:51 AM,Overall,2096,2157,2795,1986,9034,2063,2103,2781,1967,8914
70,Syria Cross border,2022,TUR-22/3559/SA1/NFI-ER-WASH/NGO/21944,7/26/2023 12:39:15 PM,Internally Displaced People,265,321,385,409,1380,297,312,324,337,1270
70,Syria Cross border,2022,TUR-22/3559/SA1/NFI-ER-WASH/NGO/21944,7/26/2023 12:39:15 PM,Overall,265,321,385,409,1380,297,312,324,337,1270
70,Syria Cross border,2022,TUR-22/3559/SA1/NFI-N/NGO/22204,6/16/2023 7:34:05 AM,Host Communities,453,999,928,1020,3400,376,5857,5939,5557,17729
70,Syria Cross border,2022,TUR-22/3559/SA1/NFI-N/NGO/22204,6/16/2023 7:34:05 AM,Internally Displaced People,8160,19497,19427,21442,68526,4223,27161,27461,24672,83517
70,Syria Cross border,2022,TUR-22/3559/SA1/NFI-N/NGO/22204,6/16/2023 7:34:05 AM,Overall,8626,20570,20413,22517,72126,4604,33071,33452,30283,101410
70,Syria Cross border,2022,TUR-22/3559/SA1/NFI-N/NGO/22204,6/16/2023 7:34:05 AM,Returnees,13,74,58,55,200,5,53,52,54,164
70,Syria Cross border,2022,TUR-22/3559/SA1/NFI-WASH/INGO/22140,10/17/2023 7:45:40 AM,Internally Displaced People,331,394,377,332,1434,229,244,361,378,1212
70,Syria Cross border,2022,TUR-22/3559/SA1/NFI-WASH/INGO/22140,10/17/2023 7:45:40 AM,Overall,331,394,377,332,1434,229,244,361,378,1212
70,Syria Cross border,2022,TUR-22/3559/SA1/NFI-WASH/NGO/22246,8/18/2023 11:44:05 AM,Internally Displaced People,443,457,647,637,2184,377,382,529,611,1899
70,Syria Cross border,2022,TUR-22/3559/SA1/NFI-WASH/NGO/22246,8/18/2023 11:44:05 AM,Overall,443,457,647,637,2184,377,382,529,611,1899
70,Syria Cross border,2022,TUR-22/3559/SA1/NFI-WASH-E/INGO/21969,9/6/2023 11:39:26 AM,Internally Displaced People,459,486,257,253,1455,277,307,401,329,1314
70,Syria Cross border,2022,TUR-22/3559/SA1/NFI-WASH-E/INGO/21969,9/6/2023 11:39:26 AM,Overall,459,486,257,253,1455,277,307,401,329,1314
70,Syria Cross border,2022,TUR-22/3559/SA1/NFI-WASH-FS/NGO/22028,7/6/2023 9:39:05 AM,Host Communities,883,936,1265,1189,4273,335,334,493,449,1611
70,Syria Cross border,2022,TUR-22/3559/SA1/NFI-WASH-FS/NGO/22028,7/6/2023 9:39:05 AM,Internally Displaced People,5427,5953,6184,5712,23276,6358,7156,8842,8675,31031
70,Syria Cross border,2022,TUR-22/3559/SA1/NFI-WASH-FS/NGO/22028,7/6/2023 9:39:05 AM,Overall,6310,6889,7449,6901,27549,6693,7490,9335,9124,32642
70,Syria Cross border,2022,TUR-22/3559/SA1/P/INGO/22092,6/7/2023 6:45:18 AM,Host Communities,367,1050,635,920,2972,9,149,16,76,250
70,Syria Cross border,2022,TUR-22/3559/SA1/P/INGO/22092,6/7/2023 6:45:18 AM,Internally Displaced People,1308,4200,2540,3680,11728,1521,7639,2828,4679,16667
70,Syria Cross border,2022,TUR-22/3559/SA1/P/INGO/22092,6/7/2023 6:45:18 AM,Overall,1675,5250,3175,4600,14700,1530,7788,2844,4755,16917
70,Syria Cross border,2022,TUR-22/3559/SA1/P/NGO/21950,9/19/2023 9:26:13 AM,Host Communities,1109,1189,2240,1969,6507,331,361,880,369,1941
70,Syria Cross border,2022,TUR-22/3559/SA1/P/NGO/21950,9/19/2023 9:26:13 AM,Internally Displaced People,2586,2775,5228,4595,15184,3574,3945,7760,6904,22183
70,Syria Cross border,2022,TUR-22/3559/SA1/P/NGO/21950,9/19/2023 9:26:13 AM,Overall,3695,3964,7468,6564,21691,3905,4306,8640,7273,24124
70,Syria Cross border,2022,TUR-22/3559/SA1/P/NGO/22059,10/11/2023 8:45:56 AM,Host Communities,2749,4762,1605,2691,11807,2594,4070,1402,2331,10397
70,Syria Cross border,2022,TUR-22/3559/SA1/P/NGO/22059,10/11/2023 8:45:56 AM,Internally Displaced People,2611,4513,1520,2549,11193,2808,5269,1823,3014,12914
70,Syria Cross border,2022,TUR-22/3559/SA1/P/NGO/22059,10/11/2023 8:45:56 AM,Overall,5360,9275,3125,5240,23000,5402,9339,3225,5345,23311
70,Syria Cross border,2022,TUR-22/3559/SA1/P/NGO/22114,9/26/2023 1:16:01 PM,Host Communities,170,1000,175,420,1765,55,937,25,438,1455
70,Syria Cross border,2022,TUR-22/3559/SA1/P/NGO/22114,9/26/2023 1:16:01 PM,Internally Displaced People,350,1859,375,790,3374,467,2005,525,786,3783
70,Syria Cross border,2022,TUR-22/3559/SA1/P/NGO/22114,9/26/2023 1:16:01 PM,Overall,520,2859,550,1210,5139,522,2942,550,1224,5238
70,Syria Cross border,2022,TUR-22/3559/SA1/P/NGO/22192,9/25/2023 11:44:08 AM,Host Communities,156,500,70,300,1026,59,216,100,162,537
70,Syria Cross border,2022,TUR-22/3559/SA1/P/NGO/22192,9/25/2023 11:44:08 AM,Internally Displaced People,234,748,105,450,1537,573,1441,216,719,2949
70,Syria Cross border,2022,TUR-22/3559/SA1/P/NGO/22192,9/25/2023 11:44:08 AM,Overall,390,1248,175,750,2563,632,1657,316,881,3486
70,Syria Cross border,2022,TUR-22/3559/SA1/P/NGO/22209,10/19/2023 7:44:58 AM,Host Communities,1135,2077,3456,3394,10062,949,1309,2850,2638,7746
70,Syria Cross border,2022,TUR-22/3559/SA1/P/NGO/22209,10/19/2023 7:44:58 AM,Internally Displaced People,5089,7668,7661,7585,28003,4950,8045,8862,8872,30729
70,Syria Cross border,2022,TUR-22/3559/SA1/P/NGO/22209,10/19/2023 7:44:58 AM,Overall,6224,9745,11117,10979,38065,5899,9354,11712,11510,38475
70,Syria Cross border,2022,TUR-22/3559/SA1/P-WASH/INGO/21954,9/25/2023 10:59:14 AM,Internally Displaced People,1266,1421,3555,3636,9878,1623,1663,5948,5777,15011
70,Syria Cross border,2022,TUR-22/3559/SA1/P-WASH/INGO/21954,9/25/2023 10:59:14 AM,Overall,1266,1421,3555,3636,9878,1623,1663,5948,5777,15011
70,Syria Cross border,2022,TUR-22/3559/SA1/WASH-NFI/NGO/22211,8/18/2023 9:17:34 AM,Host Communities,82,85,109,111,387,35,26,18,35,114
70,Syria Cross border,2022,TUR-22/3559/SA1/WASH-NFI/NGO/22211,8/18/2023 9:17:34 AM,Internally Displaced People,4171,6805,7053,8066,26095,5238,7594,5801,6917,25550
70,Syria Cross border,2022,TUR-22/3559/SA1/WASH-NFI/NGO/22211,8/18/2023 9:17:34 AM,Overall,4253,6890,7162,8177,26482,5273,7620,5819,6952,25664
70,Syria Cross border,2022,TUR-22/3559/SA2/CCM/NGO/24395,9/14/2023 6:52:20 AM,Internally Displaced People,32352,37958,43776,45751,159837,49330,54346,59317,62072,225065
70,Syria Cross border,2022,TUR-22/3559/SA2/CCM/NGO/24395,9/14/2023 6:52:20 AM,Overall,32352,37958,43776,45751,159837,49330,54346,59317,62072,225065
70,Syria Cross border,2022,TUR-22/3559/SA2/E-P/NGO/24409,9/13/2023 7:54:26 AM,Host Communities,250,111,1443,2175,3979,200,174,3935,3309,7618
70,Syria Cross border,2022,TUR-22/3559/SA2/E-P/NGO/24409,9/13/2023 7:54:26 AM,Internally Displaced People,16,78,2165,1449,3708,35,14,580,359,988
70,Syria Cross border,2022,TUR-22/3559/SA2/E-P/NGO/24409,9/13/2023 7:54:26 AM,Overall,266,189,3608,3624,7687,235,188,4515,3668,8606
70,Syria Cross border,2022,TUR-22/3559/SA2/FS/NGO/24401,10/5/2023 6:22:03 AM,Host Communities,80,88,110,115,393,209,235,221,230,895
70,Syria Cross border,2022,TUR-22/3559/SA2/FS/NGO/24401,10/5/2023 6:22:03 AM,Internally Displaced People,357,393,512,529,1791,264,258,361,324,1207
70,Syria Cross border,2022,TUR-22/3559/SA2/FS/NGO/24401,10/5/2023 6:22:03 AM,Overall,437,481,622,644,2184,473,493,582,554,2102
70,Syria Cross border,2022,TUR-22/3559/SA2/H/INGO/24367,10/17/2023 7:32:35 AM,Host Communities,3449,7078,5135,4209,19871,2842,6878,5605,5047,20372
70,Syria Cross border,2022,TUR-22/3559/SA2/H/INGO/24367,10/17/2023 7:32:35 AM,Internally Displaced People,912,3582,3452,3199,11145,103,5065,4995,4400,14563
70,Syria Cross border,2022,TUR-22/3559/SA2/H/INGO/24367,10/17/2023 7:32:35 AM,Overall,4361,10660,8587,7408,31016,2945,11943,10600,9447,34935
70,Syria Cross border,2022,TUR-22/3559/SA2/L/O/24346,10/19/2023 7:40:11 AM,Other,5,20,35,100,160,5,21,35,49,110
70,Syria Cross border,2022,TUR-22/3559/SA2/L/O/24346,10/19/2023 7:40:11 AM,Overall,5,20,35,100,160,5,21,35,49,110
70,Syria Cross border,2022,TUR-22/3559/SA2/NFI/INGO/24338,10/16/2023 1:14:13 PM,Internally Displaced People,7650,9145,9030,8050,33875,6518,9153,8263,7387,31321
70,Syria Cross border,2022,TUR-22/3559/SA2/NFI/INGO/24338,10/16/2023 1:14:13 PM,Overall,7650,9145,9030,8050,33875,6518,9153,8263,7387,31321
81,Ukraine,2019,UKR-19/UKR_CBPF/SA1/FSL/NGO/13624,2/12/2021 12:36:43 PM,Host Communities,205,307,51,77,640,296,430,42,36,804
81,Ukraine,2019,UKR-19/UKR_CBPF/SA1/FSL/NGO/13624,2/12/2021 12:36:43 PM,Internally Displaced People,38,58,10,14,120,0,0,0,0,0
81,Ukraine,2019,UKR-19/UKR_CBPF/SA1/FSL/NGO/13624,2/12/2021 12:36:43 PM,Overall,256,384,64,96,800,296,430,42,36,804
81,Ukraine,2019,UKR-19/UKR_CBPF/SA1/FSL/NGO/13624,2/12/2021 12:36:43 PM,Returnees,13,19,3,5,40,0,0,0,0,0
81,Ukraine,2019,UKR-19/UKR_CBPF/SA1/H-N/INGO/14396,10/15/2021 9:49:29 AM,Host Communities,650,1100,203,243,2196,706,1122,606,936,3370
81,Ukraine,2019,UKR-19/UKR_CBPF/SA1/H-N/INGO/14396,10/15/2021 9:49:29 AM,Overall,650,1100,203,243,2196,706,1122,606,936,3370
81,Ukraine,2019,UKR-19/UKR_CBPF/SA1/H-N-WASH/NGO/13737,2/12/2021 12:30:29 PM,Other,656,760,0,0,1416,645,1144,0,0,1789
81,Ukraine,2019,UKR-19/UKR_CBPF/SA1/H-N-WASH/NGO/13737,2/12/2021 12:30:29 PM,Overall,656,760,0,0,1416,645,1144,0,0,1789
81,Ukraine,2019,UKR-19/UKR_CBPF/SA1/P-FSL/INGO/13730,8/21/2020 1:06:37 PM,Other,225,805,0,0,1030,240,872,0,0,1112
81,Ukraine,2019,UKR-19/UKR_CBPF/SA1/P-FSL/INGO/13730,8/21/2020 1:06:37 PM,Overall,225,805,0,0,1030,240,872,0,0,1112
81,Ukraine,2019,UKR-19/UKR_CBPF/SA1/P-FSL-H-N-WASH-S-NFI/NGO/13694,2/12/2021 11:51:30 AM,Host Communities,100,130,20,22,272,131,247,20,12,410
81,Ukraine,2019,UKR-19/UKR_CBPF/SA1/P-FSL-H-N-WASH-S-NFI/NGO/13694,2/12/2021 11:51:30 AM,Internally Displaced People,90,150,30,35,305,0,0,0,0,0
81,Ukraine,2019,UKR-19/UKR_CBPF/SA1/P-FSL-H-N-WASH-S-NFI/NGO/13694,2/12/2021 11:51:30 AM,Other,258,239,84,69,650,667,1172,114,106,2059
81,Ukraine,2019,UKR-19/UKR_CBPF/SA1/P-FSL-H-N-WASH-S-NFI/NGO/13694,2/12/2021 11:51:30 AM,Overall,508,619,149,144,1420,835,1531,144,123,2633
81,Ukraine,2019,UKR-19/UKR_CBPF/SA1/P-FSL-H-N-WASH-S-NFI/NGO/13694,2/12/2021 11:51:30 AM,Returnees,60,100,15,18,193,37,112,10,5,164
81,Ukraine,2019,UKR-19/UKR_CBPF/SA1/P-WASH/NGO/13752,3/9/2021 9:38:46 AM,Other,168,351,0,0,519,136,316,0,0,452
81,Ukraine,2019,UKR-19/UKR_CBPF/SA1/P-WASH/NGO/13752,3/9/2021 9:38:46 AM,Overall,168,351,0,0,519,136,316,0,0,452
81,Ukraine,2019,UKR-19/UKR_CBPF/SA1/P-WASH-FSL/INGO/13701,6/14/2021 12:22:32 PM,Host Communities,365,715,43,43,1166,222,801,0,0,1023
81,Ukraine,2019,UKR-19/UKR_CBPF/SA1/P-WASH-FSL/INGO/13701,6/14/2021 12:22:32 PM,Overall,365,715,43,43,1166,222,801,0,0,1023
81,Ukraine,2019,UKR-19/UKR_CBPF/SA1/P-WASH-H-N/INGO/13680,2/2/2021 5:25:30 PM,Host Communities,527,894,0,0,1421,518,1222,0,0,1740
81,Ukraine,2019,UKR-19/UKR_CBPF/SA1/P-WASH-H-N/INGO/13680,2/2/2021 5:25:30 PM,Internally Displaced People,72,168,0,0,240,46,73,0,0,119
81,Ukraine,2019,UKR-19/UKR_CBPF/SA1/P-WASH-H-N/INGO/13680,2/2/2021 5:25:30 PM,Overall,599,1062,0,0,1661,564,1295,0,0,1859
81,Ukraine,2019,UKR-19/UKR_CBPF/SA1/S-NFI/NGO/13777,11/30/2020 1:12:16 PM,Other,190,331,0,0,521,181,295,24,25,525
81,Ukraine,2019,UKR-19/UKR_CBPF/SA1/S-NFI/NGO/13777,11/30/2020 1:12:16 PM,Overall,190,331,0,0,521,181,295,24,25,525
81,Ukraine,2019,UKR-19/UKR_CBPF/SA1/S-NFI-H-N-FSL/INGO/13722,6/15/2020 1:51:55 PM,Other,296,444,0,0,740,189,658,1,0,848
81,Ukraine,2019,UKR-19/UKR_CBPF/SA1/S-NFI-H-N-FSL/INGO/13722,6/15/2020 1:51:55 PM,Overall,296,444,0,0,740,189,658,1,0,848
81,Ukraine,2019,UKR-19/UKR_CBPF/SA1/WASH-P/INGO/13773,2/2/2021 5:35:05 PM,Host Communities,212,1438,4544,3840,10034,799,3720,4784,4563,13866
81,Ukraine,2019,UKR-19/UKR_CBPF/SA1/WASH-P/INGO/13773,2/2/2021 5:35:05 PM,Other,608,1304,0,0,1912,149,368,0,0,517
81,Ukraine,2019,UKR-19/UKR_CBPF/SA1/WASH-P/INGO/13773,2/2/2021 5:35:05 PM,Overall,820,2742,4544,3840,11946,948,4088,4784,4563,14383
81,Ukraine,2019,UKR-19/UKR_CBPF/SA1/WASH-S-NFI/NGO/13707,8/20/2020 12:03:40 PM,Other,356,543,43,28,970,349,540,47,30,966
81,Ukraine,2019,UKR-19/UKR_CBPF/SA1/WASH-S-NFI/NGO/13707,8/20/2020 12:03:40 PM,Overall,356,543,43,28,970,349,540,47,30,966
81,Ukraine,2020,UKR-20/UKR_CBPF/RA1/COVID-19/INGO/15730,1/18/2021 9:59:05 AM,Host Communities,877,1123,250,249,2499,2275,3550,668,556,7049
81,Ukraine,2020,UKR-20/UKR_CBPF/RA1/COVID-19/INGO/15730,1/18/2021 9:59:05 AM,Internally Displaced People,81,104,23,24,232,25,38,7,6,76
81,Ukraine,2020,UKR-20/UKR_CBPF/RA1/COVID-19/INGO/15730,1/18/2021 9:59:05 AM,Other,80,108,24,24,236,0,0,0,0,0
81,Ukraine,2020,UKR-20/UKR_CBPF/RA1/COVID-19/INGO/15730,1/18/2021 9:59:05 AM,Overall,1038,1335,297,297,2967,2300,3588,675,562,7125
81,Ukraine,2020,UKR-20/UKR_CBPF/RA1/COVID-19/INGO/15731,2/11/2021 12:24:36 PM,Other,942,1627,0,0,2569,1002,1783,0,0,2785
81,Ukraine,2020,UKR-20/UKR_CBPF/RA1/COVID-19/INGO/15731,2/11/2021 12:24:36 PM,Overall,942,1627,0,0,2569,1002,1783,0,0,2785
81,Ukraine,2020,UKR-20/UKR_CBPF/RA1/COVID-19/INGO/15732,1/2/2021 7:51:06 PM,Host Communities,15,15,15,15,60,0,0,0,0,0
81,Ukraine,2020,UKR-20/UKR_CBPF/RA1/COVID-19/INGO/15732,1/2/2021 7:51:06 PM,Internally Displaced People,10,10,10,10,40,0,0,0,0,0
81,Ukraine,2020,UKR-20/UKR_CBPF/RA1/COVID-19/INGO/15732,1/2/2021 7:51:06 PM,Other,20,20,0,0,40,0,0,0,0,0
81,Ukraine,2020,UKR-20/UKR_CBPF/RA1/COVID-19/INGO/15732,1/2/2021 7:51:06 PM,Overall,45,45,25,25,140,0,0,0,0,0
81,Ukraine,2020,UKR-20/UKR_CBPF/RA1/COVID-19/INGO/15734,1/18/2021 9:56:03 AM,Other,706,1423,8,13,2150,754,1405,8,3,2170
81,Ukraine,2020,UKR-20/UKR_CBPF/RA1/COVID-19/INGO/15734,1/18/2021 9:56:03 AM,Overall,706,1423,8,13,2150,754,1405,8,3,2170
81,Ukraine,2020,UKR-20/UKR_CBPF/RA1/COVID-19/NGO/15733,2/12/2021 11:51:55 AM,Other,1500,3000,0,0,4500,1800,2755,0,0,4555
81,Ukraine,2020,UKR-20/UKR_CBPF/RA1/COVID-19/NGO/15733,2/12/2021 11:51:55 AM,Overall,1500,3000,0,0,4500,1800,2755,0,0,4555
81,Ukraine,2020,UKR-20/UKR_CBPF/RA1/COVID-19/NGO/15736,1/18/2021 9:51:02 AM,Other,1164,2068,0,0,3232,1037,2266,0,0,3303
81,Ukraine,2020,UKR-20/UKR_CBPF/RA1/COVID-19/NGO/15736,1/18/2021 9:51:02 AM,Overall,1164,2068,0,0,3232,1037,2266,0,0,3303
81,Ukraine,2020,UKR-20/UKR_CBPF/SA1/CSS/INGO/16136,12/16/2021 1:07:58 PM,Host Communities,2570,3405,0,0,5975,2566,3400,0,0,5966
81,Ukraine,2020,UKR-20/UKR_CBPF/SA1/CSS/INGO/16136,12/16/2021 1:07:58 PM,Overall,2570,3405,0,0,5975,2566,3400,0,0,5966
81,Ukraine,2020,UKR-20/UKR_CBPF/SA1/FSL-CSS-WASH/NGO/16120,11/29/2021 8:55:58 AM,Host Communities,773,1158,255,260,2446,1213,2272,160,133,3778
81,Ukraine,2020,UKR-20/UKR_CBPF/SA1/FSL-CSS-WASH/NGO/16120,11/29/2021 8:55:58 AM,Internally Displaced People,97,135,100,100,432,173,772,31,21,997
81,Ukraine,2020,UKR-20/UKR_CBPF/SA1/FSL-CSS-WASH/NGO/16120,11/29/2021 8:55:58 AM,Overall,890,1313,384,388,2975,1417,3112,196,160,4885
81,Ukraine,2020,UKR-20/UKR_CBPF/SA1/FSL-CSS-WASH/NGO/16120,11/29/2021 8:55:58 AM,Returnees,20,20,29,28,97,31,68,5,6,110
81,Ukraine,2020,UKR-20/UKR_CBPF/SA1/H-N/INGO/16156,10/24/2022 3:13:01 PM,Host Communities,2772,2842,112,112,5838,106361,108330,1206,1206,217103
81,Ukraine,2020,UKR-20/UKR_CBPF/SA1/H-N/INGO/16156,10/24/2022 3:13:01 PM,Internally Displaced People,200,230,16,16,462,8629,9432,409,409,18879
81,Ukraine,2020,UKR-20/UKR_CBPF/SA1/H-N/INGO/16156,10/24/2022 3:13:01 PM,Overall,2972,3072,128,128,6300,114990,117762,1615,1615,235982
81,Ukraine,2020,UKR-20/UKR_CBPF/SA1/H-N/NGO/16125,2/4/2021 10:07:10 AM,Other,100,100,10,10,220,881,853,43,73,1850
81,Ukraine,2020,UKR-20/UKR_CBPF/SA1/H-N/NGO/16125,2/4/2021 10:07:10 AM,Overall,100,100,10,10,220,881,853,43,73,1850
81,Ukraine,2020,UKR-20/UKR_CBPF/SA1/H-N/UN/16186,2/18/2021 11:20:11 AM,Other,1036,5884,0,0,6920,1102,6348,0,0,7450
81,Ukraine,2020,UKR-20/UKR_CBPF/SA1/H-N/UN/16186,2/18/2021 11:20:11 AM,Overall,1036,5884,0,0,6920,1102,6348,0,0,7450
81,Ukraine,2020,UKR-20/UKR_CBPF/SA1/H-N/UN/17556,5/9/2022 9:11:49 AM,Other,130000,190000,0,0,320000,130000,190000,0,0,320000
81,Ukraine,2020,UKR-20/UKR_CBPF/SA1/H-N/UN/17556,5/9/2022 9:11:49 AM,Overall,130000,190000,0,0,320000,130000,190000,0,0,320000
81,Ukraine,2020,UKR-20/UKR_CBPF/SA1/H-N-P-WASH/INGO/17845,7/26/2023 9:15:16 AM,Host Communities,6082,9795,566,577,17020,24951,29028,620,656,55255
81,Ukraine,2020,UKR-20/UKR_CBPF/SA1/H-N-P-WASH/INGO/17845,7/26/2023 9:15:16 AM,Internally Displaced People,4467,9916,325,315,15023,3952,5139,942,1191,11224
81,Ukraine,2020,UKR-20/UKR_CBPF/SA1/H-N-P-WASH/INGO/17845,7/26/2023 9:15:16 AM,Overall,10549,19711,891,892,32043,28903,34167,1562,1847,66479
81,Ukraine,2020,UKR-20/UKR_CBPF/SA1/P-CSS-WASH/INGO/17645,10/6/2022 12:18:07 PM,Host Communities,26709,31209,4864,5806,68588,40910,49154,8360,9982,108406
81,Ukraine,2020,UKR-20/UKR_CBPF/SA1/P-CSS-WASH/INGO/17645,10/6/2022 12:18:07 PM,Internally Displaced People,1707,1996,357,428,4488,4874,5857,940,1164,12835
81,Ukraine,2020,UKR-20/UKR_CBPF/SA1/P-CSS-WASH/INGO/17645,10/6/2022 12:18:07 PM,Overall,28416,33205,5221,6234,73076,45784,55011,9300,11146,121241
81,Ukraine,2020,UKR-20/UKR_CBPF/SA1/S-NFI/INGO/17501,10/5/2021 1:27:50 PM,Host Communities,371,866,466,547,2250,631,994,581,601,2807
81,Ukraine,2020,UKR-20/UKR_CBPF/SA1/S-NFI/INGO/17501,10/5/2021 1:27:50 PM,Overall,371,866,466,547,2250,631,994,581,601,2807
81,Ukraine,2020,UKR-20/UKR_CBPF/SA1/S-NFI-P/UN/17545,5/2/2023 9:27:00 AM,Other,5000,6000,3000,4000,18000,1656,1953,960,1291,5860
81,Ukraine,2020,UKR-20/UKR_CBPF/SA1/S-NFI-P/UN/17545,5/2/2023 9:27:00 AM,Overall,5000,6000,3000,4000,18000,1656,1953,960,1291,5860
81,Ukraine,2020,UKR-20/UKR_CBPF/SA1/S-NFI-P-FSL-WASH-E/NGO/17513,10/5/2022 9:32:01 AM,Host Communities,470,270,1520,1350,3610,3008,1294,2549,2602,9453
81,Ukraine,2020,UKR-20/UKR_CBPF/SA1/S-NFI-P-FSL-WASH-E/NGO/17513,10/5/2022 9:32:01 AM,Internally Displaced People,255,115,350,320,1040,226,212,494,443,1375
81,Ukraine,2020,UKR-20/UKR_CBPF/SA1/S-NFI-P-FSL-WASH-E/NGO/17513,10/5/2022 9:32:01 AM,Overall,725,385,1870,1670,4650,3234,1506,3043,3045,10828
81,Ukraine,2020,UKR-20/UKR_CBPF/SA1/WASH/INGO/16141,3/9/2021 9:39:50 AM,Other,1660,2116,0,0,3776,1599,2177,0,0,3776
81,Ukraine,2020,UKR-20/UKR_CBPF/SA1/WASH/INGO/16141,3/9/2021 9:39:50 AM,Overall,1660,2116,0,0,3776,1599,2177,0,0,3776
81,Ukraine,2020,UKR-20/UKR_CBPF/SA1/WASH/INGO/16963,10/6/2022 2:47:57 PM,Host Communities,1067,1417,20,20,2524,640,1360,0,0,2000
81,Ukraine,2020,UKR-20/UKR_CBPF/SA1/WASH/INGO/16963,10/6/2022 2:47:57 PM,Internally Displaced People,2452,3251,295,286,6284,2242,4892,455,450,8039
81,Ukraine,2020,UKR-20/UKR_CBPF/SA1/WASH/INGO/16963,10/6/2022 2:47:57 PM,Overall,3519,4668,315,306,8808,2882,6252,455,450,10039
81,Ukraine,2020,UKR-20/UKR_CBPF/SA1/WASH/NGO/17140,10/22/2021 5:49:01 AM,Internally Displaced People,220,320,200,230,970,247,366,214,260,1087
81,Ukraine,2020,UKR-20/UKR_CBPF/SA1/WASH/NGO/17140,10/22/2021 5:49:01 AM,Overall,220,320,200,230,970,247,366,214,260,1087
81,Ukraine,2020,UKR-20/UKR_CBPF/SA1/WASH/NGO/17493,2/4/2022 12:58:30 PM,Other,234,366,0,0,600,201,374,1,4,580
81,Ukraine,2020,UKR-20/UKR_CBPF/SA1/WASH/NGO/17493,2/4/2022 12:58:30 PM,Overall,234,366,0,0,600,201,374,1,4,580
81,Ukraine,2020,UKR-20/UKR_CBPF/SA1/WASH-CSS-FSL/INGO/16133,5/10/2021 2:10:39 PM,Host Communities,861,2008,710,834,4413,1058,2076,1357,1289,5780
81,Ukraine,2020,UKR-20/UKR_CBPF/SA1/WASH-CSS-FSL/INGO/16133,5/10/2021 2:10:39 PM,Overall,861,2008,710,834,4413,1058,2076,1357,1289,5780
81,Ukraine,2020,UKR-20/UKR_CBPF/SA1/WASH-E-H-N/UN/17536,5/16/2022 1:37:57 PM,Host Communities,721,3879,995,1005,6600,1166,6329,1340,1362,10197
81,Ukraine,2020,UKR-20/UKR_CBPF/SA1/WASH-E-H-N/UN/17536,5/16/2022 1:37:57 PM,Overall,721,3879,995,1005,6600,1166,6329,1340,1362,10197
81,Ukraine,2020,UKR-20/UKR_CBPF/SA1/WASH-FSL/INGO/16131,9/30/2021 2:43:47 PM,Host Communities,340,632,14,14,1000,518,673,0,0,1191
81,Ukraine,2020,UKR-20/UKR_CBPF/SA1/WASH-FSL/INGO/16131,9/30/2021 2:43:47 PM,Overall,340,632,14,14,1000,518,673,0,0,1191
81,Ukraine,2020,UKR-20/UKR_CBPF/SA1/WASH-H-N-P/UN/17827,3/29/2023 2:03:10 PM,Host Communities,2653,4016,608,1310,8587,1776,2160,432,432,4800
81,Ukraine,2020,UKR-20/UKR_CBPF/SA1/WASH-H-N-P/UN/17827,3/29/2023 2:03:10 PM,Internally Displaced People,1793,2896,726,1797,7212,8004,9732,1947,1947,21630
81,Ukraine,2020,UKR-20/UKR_CBPF/SA1/WASH-H-N-P/UN/17827,3/29/2023 2:03:10 PM,Overall,4446,6912,1334,3107,15799,9780,11892,2379,2379,26430
81,Ukraine,2021,UKR-21/UKR_CBPF/RA3/E-P/INGO/18487,12/27/2022 5:07:46 PM,Host Communities,85,750,3180,3055,7070,246,1169,3685,3600,8700
81,Ukraine,2021,UKR-21/UKR_CBPF/RA3/E-P/INGO/18487,12/27/2022 5:07:46 PM,Overall,85,750,3180,3055,7070,246,1169,3685,3600,8700
81,Ukraine,2021,UKR-21/UKR_CBPF/RA3/E-P/UN/18486,10/4/2023 1:13:44 PM,Host Communities,19,135,1689,1691,3534,5,90,8362,8027,16484
81,Ukraine,2021,UKR-21/UKR_CBPF/RA3/E-P/UN/18486,10/4/2023 1:13:44 PM,Overall,19,135,1689,1691,3534,5,90,8362,8027,16484
81,Ukraine,2021,UKR-21/UKR_CBPF/RA3/P/NGO/18484,4/10/2023 11:42:25 AM,Other,1600,5800,100,100,7600,5497,19925,344,344,26110
81,Ukraine,2021,UKR-21/UKR_CBPF/RA3/P/NGO/18484,4/10/2023 11:42:25 AM,Overall,1600,5800,100,100,7600,5497,19925,344,344,26110
81,Ukraine,2021,UKR-21/UKR_CBPF/RA3/P-H-N/NGO/18483,4/10/2023 9:49:39 AM,Host Communities,4887,11077,1094,1990,19048,8221,21815,1235,1243,32514
81,Ukraine,2021,UKR-21/UKR_CBPF/RA3/P-H-N/NGO/18483,4/10/2023 9:49:39 AM,Internally Displaced People,570,723,124,213,1630,617,1308,118,167,2210
81,Ukraine,2021,UKR-21/UKR_CBPF/RA3/P-H-N/NGO/18483,4/10/2023 9:49:39 AM,Overall,5457,11800,1218,2203,20678,8838,23123,1353,1410,34724
81,Ukraine,2021,UKR-21/UKR_CBPF/SA3/E-WASH/NGO/19951,5/12/2022 9:35:19 AM,Other,206,1259,2665,2739,6869,221,1407,3332,3155,8115
81,Ukraine,2021,UKR-21/UKR_CBPF/SA3/E-WASH/NGO/19951,5/12/2022 9:35:19 AM,Overall,206,1259,2665,2739,6869,221,1407,3332,3155,8115
81,Ukraine,2021,UKR-21/UKR_CBPF/SA3/H-N/UN/19934,10/25/2022 11:09:46 AM,Other,9600,14400,3000,3000,30000,3665,5630,1261,1196,11752
81,Ukraine,2021,UKR-21/UKR_CBPF/SA3/H-N/UN/19934,10/25/2022 11:09:46 AM,Overall,9600,14400,3000,3000,30000,3665,5630,1261,1196,11752
81,Ukraine,2021,UKR-21/UKR_CBPF/SA3/P/NGO/19895,9/13/2023 7:49:41 AM,Host Communities,161,839,73,126,1199,105,375,22,25,527
81,Ukraine,2021,UKR-21/UKR_CBPF/SA3/P/NGO/19895,9/13/2023 7:49:41 AM,Internally Displaced People,5,45,5,5,60,7,21,3,4,35
81,Ukraine,2021,UKR-21/UKR_CBPF/SA3/P/NGO/19895,9/13/2023 7:49:41 AM,Other,30,110,0,0,140,0,0,0,0,0
81,Ukraine,2021,UKR-21/UKR_CBPF/SA3/P/NGO/19895,9/13/2023 7:49:41 AM,Overall,196,994,78,131,1399,112,396,25,29,562
81,Ukraine,2021,UKR-21/UKR_CBPF/SA3/P/NGO/19957,1/31/2023 9:15:26 AM,Host Communities,950,2600,0,0,3550,2422,4121,152,245,6940
81,Ukraine,2021,UKR-21/UKR_CBPF/SA3/P/NGO/19957,1/31/2023 9:15:26 AM,Internally Displaced People,300,1200,0,0,1500,2579,4794,235,338,7946
81,Ukraine,2021,UKR-21/UKR_CBPF/SA3/P/NGO/19957,1/31/2023 9:15:26 AM,Overall,1250,3800,0,0,5050,5001,8915,387,583,14886
81,Ukraine,2021,UKR-21/UKR_CBPF/SA3/P-FSL/INGO/19936,1/12/2023 4:13:35 PM,Host Communities,200,450,200,150,1000,1505,2211,51,30,3797
81,Ukraine,2021,UKR-21/UKR_CBPF/SA3/P-FSL/INGO/19936,1/12/2023 4:13:35 PM,Internally Displaced People,975,920,385,470,2750,362,1180,1795,1921,5258
81,Ukraine,2021,UKR-21/UKR_CBPF/SA3/P-FSL/INGO/19936,1/12/2023 4:13:35 PM,Overall,1175,1370,585,620,3750,1867,3391,1846,1951,9055
81,Ukraine,2021,UKR-21/UKR_CBPF/SA3/P-WASH-FSL/INGO/19946,4/7/2023 7:53:24 AM,Host Communities,812,1036,676,776,3300,2872,3476,2252,2065,10665
81,Ukraine,2021,UKR-21/UKR_CBPF/SA3/P-WASH-FSL/INGO/19946,4/7/2023 7:53:24 AM,Overall,812,1036,676,776,3300,2872,3476,2252,2065,10665
81,Ukraine,2021,UKR-21/UKR_CBPF/SA3/S-NFI-FSL-WASH/INGO/19942,12/27/2022 4:05:08 PM,Host Communities,1925,4490,2415,2835,11665,1807,4315,3438,3865,13425
81,Ukraine,2021,UKR-21/UKR_CBPF/SA3/S-NFI-FSL-WASH/INGO/19942,12/27/2022 4:05:08 PM,Overall,1925,4490,2415,2835,11665,1807,4315,3438,3865,13425
81,Ukraine,2021,UKR-21/UKR_CBPF/SA3/S-NFI-P/UN/19954,4/28/2023 1:40:01 PM,Other,8192,14563,2845,2845,28445,13348,21020,3790,3708,41866
81,Ukraine,2021,UKR-21/UKR_CBPF/SA3/S-NFI-P/UN/19954,4/28/2023 1:40:01 PM,Overall,8192,14563,2845,2845,28445,13348,21020,3790,3708,41866
81,Ukraine,2021,UKR-21/UKR_CBPF/SA3/S-NFI-WASH/UN/19963,3/31/2023 8:41:16 AM,Host Communities,3168,5096,1048,2230,11542,4554,5906,1100,1123,12683
81,Ukraine,2021,UKR-21/UKR_CBPF/SA3/S-NFI-WASH/UN/19963,3/31/2023 8:41:16 AM,Overall,3168,5096,1048,2230,11542,4554,5906,1100,1123,12683
81,Ukraine,2021,UKR-21/UKR_CBPF/SA3/WASH/NGO/19931,10/6/2022 12:49:09 PM,Other,1876,2421,307,345,4949,4308,5396,812,900,11416
81,Ukraine,2021,UKR-21/UKR_CBPF/SA3/WASH/NGO/19931,10/6/2022 12:49:09 PM,Overall,1876,2421,307,345,4949,4308,5396,812,900,11416
81,Ukraine,2021,UKR-21/UKR_CBPF/SA3/WASH-FSL-S-NFI/INGO/19834,3/27/2023 2:26:35 PM,Other,664,1930,251,206,3051,664,1930,251,206,3051
81,Ukraine,2021,UKR-21/UKR_CBPF/SA3/WASH-FSL-S-NFI/INGO/19834,3/27/2023 2:26:35 PM,Overall,664,1930,251,206,3051,664,1930,251,206,3051
81,Ukraine,2022,UKR-22/UKR_CBPF/RA1/FSL/UN/21353,5/5/2023 11:30:38 AM,Host Communities,1700,2500,700,700,5600,2909,3906,790,796,8401
81,Ukraine,2022,UKR-22/UKR_CBPF/RA1/FSL/UN/21353,5/5/2023 11:30:38 AM,Overall,1700,2500,700,700,5600,2909,3906,790,796,8401
81,Ukraine,2022,UKR-22/UKR_CBPF/RA1/H-WASH/NGO/21347,10/4/2023 1:22:37 PM,Host Communities,1300,2200,531,545,4576,2905,5224,1733,1741,11603
81,Ukraine,2022,UKR-22/UKR_CBPF/RA1/H-WASH/NGO/21347,10/4/2023 1:22:37 PM,Internally Displaced People,1051,1382,55,50,2538,1356,2649,763,786,5554
81,Ukraine,2022,UKR-22/UKR_CBPF/RA1/H-WASH/NGO/21347,10/4/2023 1:22:37 PM,Overall,2372,3622,598,605,7197,4378,8126,2537,2576,17617
81,Ukraine,2022,UKR-22/UKR_CBPF/RA1/H-WASH/NGO/21347,10/4/2023 1:22:37 PM,Returnees,21,40,12,10,83,117,253,41,49,460
81,Ukraine,2022,UKR-22/UKR_CBPF/RA2/CSS-FSL-P-S-NFI-WASH/INGO/21581,4/10/2023 9:13:30 AM,Host Communities,31230,44396,8000,8000,91626,74467,96974,14346,14324,200111
81,Ukraine,2022,UKR-22/UKR_CBPF/RA2/CSS-FSL-P-S-NFI-WASH/INGO/21581,4/10/2023 9:13:30 AM,Internally Displaced People,42300,59900,11000,11000,124200,25077,31534,4982,5007,66600
81,Ukraine,2022,UKR-22/UKR_CBPF/RA2/CSS-FSL-P-S-NFI-WASH/INGO/21581,4/10/2023 9:13:30 AM,Overall,73530,104296,19000,19000,215826,99544,128508,19328,19331,266711
81,Ukraine,2022,UKR-22/UKR_CBPF/RA2/FSL/INGO/21668,10/17/2022 2:47:18 PM,Host Communities,1200,2160,1200,1200,5760,1346,3048,2257,2074,8725
81,Ukraine,2022,UKR-22/UKR_CBPF/RA2/FSL/INGO/21668,10/17/2022 2:47:18 PM,Internally Displaced People,1300,2340,1300,1300,6240,510,1289,900,860,3559
81,Ukraine,2022,UKR-22/UKR_CBPF/RA2/FSL/INGO/21668,10/17/2022 2:47:18 PM,Overall,2500,4500,2500,2500,12000,1856,4337,3157,2934,12284
81,Ukraine,2022,UKR-22/UKR_CBPF/RA2/FSL-WASH/INGO/21579,4/3/2023 7:07:49 AM,Host Communities,3397,4245,425,425,8492,23431,28498,5699,5699,63327
81,Ukraine,2022,UKR-22/UKR_CBPF/RA2/FSL-WASH/INGO/21579,4/3/2023 7:07:49 AM,Internally Displaced People,13587,16985,1698,1698,33968,24639,43756,7006,7327,82728
81,Ukraine,2022,UKR-22/UKR_CBPF/RA2/FSL-WASH/INGO/21579,4/3/2023 7:07:49 AM,Overall,16984,21230,2123,2123,42460,48070,72254,12705,13026,146055
81,Ukraine,2022,UKR-22/UKR_CBPF/RA2/H/UN/21685,3/27/2023 2:52:56 PM,Host Communities,28000,28000,7000,7000,70000,41385,41385,3858,3858,90486
81,Ukraine,2022,UKR-22/UKR_CBPF/RA2/H/UN/21685,3/27/2023 2:52:56 PM,Internally Displaced People,8000,16000,3000,3000,30000,4597,4598,432,432,10059
81,Ukraine,2022,UKR-22/UKR_CBPF/RA2/H/UN/21685,3/27/2023 2:52:56 PM,Overall,36000,44000,10000,10000,100000,45982,45983,4290,4290,100545
81,Ukraine,2022,UKR-22/UKR_CBPF/RA2/S-NFI-P-FSL/INGO/21633,1/31/2023 11:00:04 AM,Host Communities,0,0,0,0,0,10,26,0,0,36
81,Ukraine,2022,UKR-22/UKR_CBPF/RA2/S-NFI-P-FSL/INGO/21633,1/31/2023 11:00:04 AM,Internally Displaced People,1185,1930,1075,1075,5265,1971,4717,1098,1026,8812
81,Ukraine,2022,UKR-22/UKR_CBPF/RA2/S-NFI-P-FSL/INGO/21633,1/31/2023 11:00:04 AM,Overall,1185,1930,1075,1075,5265,1981,4743,1098,1026,8848
81,Ukraine,2022,UKR-22/UKR_CBPF/RA2/WASH-E-CSS/UN/21655,4/26/2023 9:48:03 AM,Host Communities,34020,43470,18743,18008,114241,68841,93100,30442,27834,220217
81,Ukraine,2022,UKR-22/UKR_CBPF/RA2/WASH-E-CSS/UN/21655,4/26/2023 9:48:03 AM,Internally Displaced People,14580,18630,8029,7718,48957,14932,19453,13033,11803,59221
81,Ukraine,2022,UKR-22/UKR_CBPF/RA2/WASH-E-CSS/UN/21655,4/26/2023 9:48:03 AM,Overall,48600,62100,26772,25726,163198,83773,112553,43475,39637,279438
81,Ukraine,2022,UKR-22/UKR_CBPF/RA2/WASH-S-NFI/NGO/21572,12/27/2022 2:21:02 PM,Host Communities,9679,11633,1696,1941,24949,9679,11633,1697,1941,24950
81,Ukraine,2022,UKR-22/UKR_CBPF/RA2/WASH-S-NFI/NGO/21572,12/27/2022 2:21:02 PM,Internally Displaced People,667,1162,356,334,2519,787,1433,368,347,2935
81,Ukraine,2022,UKR-22/UKR_CBPF/RA2/WASH-S-NFI/NGO/21572,12/27/2022 2:21:02 PM,Overall,10346,12795,2052,2275,27468,10466,13066,2065,2288,27885
81,Ukraine,2022,UKR-22/UKR_CBPF/RA3/E-P/INGO/21915,9/8/2023 1:59:16 PM,Host Communities,1549,3806,2125,2125,9605,45,648,4237,4816,9746
81,Ukraine,2022,UKR-22/UKR_CBPF/RA3/E-P/INGO/21915,9/8/2023 1:59:16 PM,Internally Displaced People,273,672,375,375,1695,1,15,245,293,554
81,Ukraine,2022,UKR-22/UKR_CBPF/RA3/E-P/INGO/21915,9/8/2023 1:59:16 PM,Overall,1822,4478,2500,2500,11300,46,663,4482,5109,10300
81,Ukraine,2022,UKR-22/UKR_CBPF/RA3/FSL-WASH-H-CSS/INGO/21891,3/23/2023 2:36:45 PM,Internally Displaced People,548,1097,574,574,2793,1627,2163,791,625,5206
81,Ukraine,2022,UKR-22/UKR_CBPF/RA3/FSL-WASH-H-CSS/INGO/21891,3/23/2023 2:36:45 PM,Other,3104,5429,2587,2587,13707,3998,6522,4281,4503,19304
81,Ukraine,2022,UKR-22/UKR_CBPF/RA3/FSL-WASH-H-CSS/INGO/21891,3/23/2023 2:36:45 PM,Overall,3652,6526,3161,3161,16500,5625,8685,5072,5128,24510
81,Ukraine,2022,UKR-22/UKR_CBPF/RA3/H/UN/21916,4/7/2023 9:34:46 AM,Host Communities,225888,150592,47060,47060,470600,225888,150592,47060,47060,470600
81,Ukraine,2022,UKR-22/UKR_CBPF/RA3/H/UN/21916,4/7/2023 9:34:46 AM,Internally Displaced People,121632,81088,25340,25340,253400,121632,81088,25340,25340,253400
81,Ukraine,2022,UKR-22/UKR_CBPF/RA3/H/UN/21916,4/7/2023 9:34:46 AM,Overall,347520,231680,72400,72400,724000,347520,231680,72400,72400,724000
81,Ukraine,2022,UKR-22/UKR_CBPF/RA3/MPC/INGO/21882,3/27/2023 1:26:49 PM,Internally Displaced People,836,1672,836,836,4180,714,2183,1007,929,4833
81,Ukraine,2022,UKR-22/UKR_CBPF/RA3/MPC/INGO/21882,3/27/2023 1:26:49 PM,Overall,836,1672,836,836,4180,714,2183,1007,929,4833
81,Ukraine,2022,UKR-22/UKR_CBPF/RA3/MPC/NGO/21912,4/27/2023 1:43:27 PM,Internally Displaced People,5090,11878,3636,3636,24240,5576,13758,4311,3980,27625
81,Ukraine,2022,UKR-22/UKR_CBPF/RA3/MPC/NGO/21912,4/27/2023 1:43:27 PM,Overall,5090,11878,3636,3636,24240,5576,13758,4311,3980,27625
81,Ukraine,2022,UKR-22/UKR_CBPF/RA3/MPC/UN/21929,3/29/2023 11:55:45 AM,Internally Displaced People,6400,9600,2000,2000,20000,6054,10217,2000,2000,20271
81,Ukraine,2022,UKR-22/UKR_CBPF/RA3/MPC/UN/21929,3/29/2023 11:55:45 AM,Overall,6400,9600,2000,2000,20000,6054,10217,2000,2000,20271
81,Ukraine,2022,UKR-22/UKR_CBPF/RA3/P/NGO/21899,11/14/2022 3:41:13 PM,Other,8,92,0,0,100,7,99,0,0,106
81,Ukraine,2022,UKR-22/UKR_CBPF/RA3/P/NGO/21899,11/14/2022 3:41:13 PM,Overall,8,92,0,0,100,7,99,0,0,106
81,Ukraine,2022,UKR-22/UKR_CBPF/RA3/WASH-CSS-H-FSL/NGO/21903,3/24/2023 2:10:04 PM,Other,41551,49009,7458,8523,106541,111310,143967,26337,26544,308158
81,Ukraine,2022,UKR-22/UKR_CBPF/RA3/WASH-CSS-H-FSL/NGO/21903,3/24/2023 2:10:04 PM,Overall,41551,49009,7458,8523,106541,111310,143967,26337,26544,308158
81,Ukraine,2022,UKR-22/UKR_CBPF/RA4/S-NFI/INGO/22936,4/27/2023 12:14:09 PM,Host Communities,178,356,178,178,890,376,462,51,54,943
81,Ukraine,2022,UKR-22/UKR_CBPF/RA4/S-NFI/INGO/22936,4/27/2023 12:14:09 PM,Internally Displaced People,382,764,382,382,1910,163,434,11,19,627
81,Ukraine,2022,UKR-22/UKR_CBPF/RA4/S-NFI/INGO/22936,4/27/2023 12:14:09 PM,Overall,560,1120,560,560,2800,539,896,62,73,1570
81,Ukraine,2022,UKR-22/UKR_CBPF/RA4/S-NFI/NGO/22991,5/5/2023 9:22:07 AM,Internally Displaced People,68,81,12,14,175,63,116,45,69,293
81,Ukraine,2022,UKR-22/UKR_CBPF/RA4/S-NFI/NGO/22991,5/5/2023 9:22:07 AM,Other,1008,1190,181,206,2585,799,1155,237,223,2414
81,Ukraine,2022,UKR-22/UKR_CBPF/RA4/S-NFI/NGO/22991,5/5/2023 9:22:07 AM,Overall,1076,1271,193,220,2760,862,1271,282,292,2707
83,Venezuela,2021,VEN-21/VEN_CBPF/SA1/EDU/NGO/18092,1/20/2022 3:24:27 PM,Host Communities,56,209,1592,1453,3310,45,191,1428,1374,3038
83,Venezuela,2021,VEN-21/VEN_CBPF/SA1/EDU/NGO/18092,1/20/2022 3:24:27 PM,Overall,56,209,1592,1453,3310,45,191,1428,1374,3038
83,Venezuela,2021,VEN-21/VEN_CBPF/SA1/EDU-PRO/NGO/18087,6/15/2022 1:05:00 PM,Other,0,0,0,3050,3050,0,0,0,3050,3050
83,Venezuela,2021,VEN-21/VEN_CBPF/SA1/EDU-PRO/NGO/18087,6/15/2022 1:05:00 PM,Overall,0,0,0,3050,3050,0,0,0,3050,3050
83,Venezuela,2021,VEN-21/VEN_CBPF/SA1/FSC/NGO/18073,3/28/2022 6:07:10 PM,Host Communities,952,1238,1264,1255,4709,1707,1988,1393,1225,6313
83,Venezuela,2021,VEN-21/VEN_CBPF/SA1/FSC/NGO/18073,3/28/2022 6:07:10 PM,Overall,952,1238,1264,1255,4709,1707,1988,1393,1225,6313
83,Venezuela,2021,VEN-21/VEN_CBPF/SA1/HEA-PRO/NGO/18088,4/26/2022 4:58:46 PM,Host Communities,0,850,0,900,1750,0,850,0,900,1750
83,Venezuela,2021,VEN-21/VEN_CBPF/SA1/HEA-PRO/NGO/18088,4/26/2022 4:58:46 PM,Other,160,920,0,0,1080,160,920,0,73,1153
83,Venezuela,2021,VEN-21/VEN_CBPF/SA1/HEA-PRO/NGO/18088,4/26/2022 4:58:46 PM,Overall,160,1770,0,900,2830,160,1770,0,973,2903
83,Venezuela,2021,VEN-21/VEN_CBPF/SA1/NUT-FSC/NGO/18086,6/15/2022 1:24:43 PM,Host Communities,900,1760,694,722,4076,167,2795,596,534,4092
83,Venezuela,2021,VEN-21/VEN_CBPF/SA1/NUT-FSC/NGO/18086,6/15/2022 1:24:43 PM,Overall,900,1760,694,722,4076,167,2795,596,534,4092
83,Venezuela,2021,VEN-21/VEN_CBPF/SA1/NUT-PRO/NGO/18093,2/18/2023 2:33:31 PM,Host Communities,65,1040,2340,2340,5785,27,871,2481,2580,5959
83,Venezuela,2021,VEN-21/VEN_CBPF/SA1/NUT-PRO/NGO/18093,2/18/2023 2:33:31 PM,Overall,65,1040,2340,2340,5785,27,871,2481,2580,5959
83,Venezuela,2021,VEN-21/VEN_CBPF/SA1/PRO/NGO/18089,8/8/2022 8:10:40 PM,Host Communities,786,5916,28,70,6800,2172,5772,547,737,9228
83,Venezuela,2021,VEN-21/VEN_CBPF/SA1/PRO/NGO/18089,8/8/2022 8:10:40 PM,Overall,786,5916,28,70,6800,2172,5772,547,737,9228
83,Venezuela,2021,VEN-21/VEN_CBPF/SA1/PRO-FSC-HEA-WSH/INGO/18074,12/14/2022 10:00:08 PM,Host Communities,650,2400,1370,2080,6500,1440,3086,827,1454,6807
83,Venezuela,2021,VEN-21/VEN_CBPF/SA1/PRO-FSC-HEA-WSH/INGO/18074,12/14/2022 10:00:08 PM,Overall,650,2400,1370,2080,6500,1440,3086,827,1454,6807
83,Venezuela,2021,VEN-21/VEN_CBPF/SA1/PRO-WSH-SHL-FSC-HEA/NGO/18080,12/16/2022 2:07:50 PM,Host Communities,1150,1724,300,500,3674,5427,10697,464,552,17140
83,Venezuela,2021,VEN-21/VEN_CBPF/SA1/PRO-WSH-SHL-FSC-HEA/NGO/18080,12/16/2022 2:07:50 PM,Other,1244,1752,0,0,2996,1344,1833,0,0,3177
83,Venezuela,2021,VEN-21/VEN_CBPF/SA1/PRO-WSH-SHL-FSC-HEA/NGO/18080,12/16/2022 2:07:50 PM,Overall,2394,3476,300,500,6670,6771,12530,464,552,20317
83,Venezuela,2021,VEN-21/VEN_CBPF/SA1/SHL/NGO/18078,4/11/2022 3:40:57 PM,Host Communities,1698,2103,705,774,5280,4199,5642,2933,2717,15491
83,Venezuela,2021,VEN-21/VEN_CBPF/SA1/SHL/NGO/18078,4/11/2022 3:40:57 PM,Overall,1698,2103,705,774,5280,4199,5642,2933,2717,15491
83,Venezuela,2021,VEN-21/VEN_CBPF/SA1/SHL-FSC-HEA-WSH-EDU/NGO/18081,12/21/2021 1:03:50 PM,Host Communities,1130,1723,1303,1361,5517,1326,2009,1508,1544,6387
83,Venezuela,2021,VEN-21/VEN_CBPF/SA1/SHL-FSC-HEA-WSH-EDU/NGO/18081,12/21/2021 1:03:50 PM,Overall,1130,1723,1303,1361,5517,1326,2009,1508,1544,6387
83,Venezuela,2021,VEN-21/VEN_CBPF/SA1/WSH-FSC/NGO/18082,12/16/2022 1:33:53 PM,Host Communities,1920,3840,1920,1920,9600,3614,4428,2163,2470,12675
83,Venezuela,2021,VEN-21/VEN_CBPF/SA1/WSH-FSC/NGO/18082,12/16/2022 1:33:53 PM,Overall,1920,3840,1920,1920,9600,3614,4428,2163,2470,12675
83,Venezuela,2021,VEN-21/VEN_CBPF/SA2/EDU/NGO/20286,11/2/2022 6:29:13 PM,Other,384,3464,0,0,3848,587,3392,0,0,3979
83,Venezuela,2021,VEN-21/VEN_CBPF/SA2/EDU/NGO/20286,11/2/2022 6:29:13 PM,Overall,384,3464,0,0,3848,587,3392,0,0,3979
83,Venezuela,2021,VEN-21/VEN_CBPF/SA2/EDU/NGO/20314,12/8/2022 8:07:53 PM,Other,572,1408,0,0,1980,572,1408,0,0,1980
83,Venezuela,2021,VEN-21/VEN_CBPF/SA2/EDU/NGO/20314,12/8/2022 8:07:53 PM,Overall,572,1408,0,0,1980,572,1408,0,0,1980
83,Venezuela,2021,VEN-21/VEN_CBPF/SA2/EDU-PRO-WSH/NGO/20281,12/16/2022 1:20:11 PM,Other,25,1066,6297,6299,13687,1243,2471,6199,6158,16071
83,Venezuela,2021,VEN-21/VEN_CBPF/SA2/EDU-PRO-WSH/NGO/20281,12/16/2022 1:20:11 PM,Overall,25,1066,6297,6299,13687,1243,2471,6199,6158,16071
83,Venezuela,2021,VEN-21/VEN_CBPF/SA2/EDU-PRO-WSH-NUT/NGO/20316,11/24/2022 12:28:23 PM,Other,150,210,750,750,1860,110,801,378,395,1684
83,Venezuela,2021,VEN-21/VEN_CBPF/SA2/EDU-PRO-WSH-NUT/NGO/20316,11/24/2022 12:28:23 PM,Overall,150,210,750,750,1860,110,801,378,395,1684
83,Venezuela,2021,VEN-21/VEN_CBPF/SA2/EDU-WSH/NGO/20295,12/14/2022 9:49:24 PM,Other,125,187,160,240,712,40,365,174,229,808
83,Venezuela,2021,VEN-21/VEN_CBPF/SA2/EDU-WSH/NGO/20295,12/14/2022 9:49:24 PM,Overall,125,187,160,240,712,40,365,174,229,808
83,Venezuela,2021,VEN-21/VEN_CBPF/SA2/EDU-WSH-PRO/NGO/20277,12/16/2022 1:39:12 PM,Other,288,2598,0,0,2886,489,2397,0,0,2886
83,Venezuela,2021,VEN-21/VEN_CBPF/SA2/EDU-WSH-PRO/NGO/20277,12/16/2022 1:39:12 PM,Overall,288,2598,0,0,2886,489,2397,0,0,2886
83,Venezuela,2021,VEN-21/VEN_CBPF/SA2/EDU-WSH-SHL/INGO/20273,11/22/2022 5:16:48 PM,Other,93,279,1329,1495,3196,93,279,1329,1495,3196
83,Venezuela,2021,VEN-21/VEN_CBPF/SA2/EDU-WSH-SHL/INGO/20273,11/22/2022 5:16:48 PM,Overall,93,279,1329,1495,3196,93,279,1329,1495,3196
83,Venezuela,2021,VEN-21/VEN_CBPF/SA2/EDU-WSH-SHL-PRO-FSC/NGO/20274,2/6/2023 3:10:15 PM,Other,2392,2659,5590,6349,16990,1468,1994,5410,5844,14716
83,Venezuela,2021,VEN-21/VEN_CBPF/SA2/EDU-WSH-SHL-PRO-FSC/NGO/20274,2/6/2023 3:10:15 PM,Overall,2392,2659,5590,6349,16990,1468,1994,5410,5844,14716
83,Venezuela,2021,VEN-21/VEN_CBPF/SA2/FSC-SHL-PRO/INGO/20275,12/12/2022 1:05:38 PM,Other,665,685,0,0,1350,439,950,0,0,1389
83,Venezuela,2021,VEN-21/VEN_CBPF/SA2/FSC-SHL-PRO/INGO/20275,12/12/2022 1:05:38 PM,Overall,665,685,0,0,1350,439,950,0,0,1389
83,Venezuela,2021,VEN-21/VEN_CBPF/SA2/HEA-FSC-WSH/NGO/20271,2/22/2023 7:20:54 PM,Other,1150,2040,1990,2420,7600,2700,3889,2957,3276,12822
83,Venezuela,2021,VEN-21/VEN_CBPF/SA2/HEA-FSC-WSH/NGO/20271,2/22/2023 7:20:54 PM,Overall,1150,2040,1990,2420,7600,2700,3889,2957,3276,12822
83,Venezuela,2021,VEN-21/VEN_CBPF/SA2/HEA-PRO/INGO/20264,1/31/2023 4:35:54 PM,Other,3579,4689,2093,2704,13065,2340,5145,3095,3936,14516
83,Venezuela,2021,VEN-21/VEN_CBPF/SA2/HEA-PRO/INGO/20264,1/31/2023 4:35:54 PM,Overall,3579,4689,2093,2704,13065,2340,5145,3095,3936,14516
83,Venezuela,2021,VEN-21/VEN_CBPF/SA2/NUT-WSH-PRO/INGO/20317,3/16/2023 10:40:06 PM,Other,152,404,2644,2689,5889,223,534,3564,3769,8090
83,Venezuela,2021,VEN-21/VEN_CBPF/SA2/NUT-WSH-PRO/INGO/20317,3/16/2023 10:40:06 PM,Overall,152,404,2644,2689,5889,223,534,3564,3769,8090
83,Venezuela,2021,VEN-21/VEN_CBPF/SA2/PRO-WSH-SHL-FSC/INGO/20262,8/15/2023 11:01:36 PM,Host Communities,1000,6000,2000,3000,12000,591,2874,2311,3205,8981
83,Venezuela,2021,VEN-21/VEN_CBPF/SA2/PRO-WSH-SHL-FSC/INGO/20262,8/15/2023 11:01:36 PM,Other,60,75,90,100,325,26,257,445,357,1085
83,Venezuela,2021,VEN-21/VEN_CBPF/SA2/PRO-WSH-SHL-FSC/INGO/20262,8/15/2023 11:01:36 PM,Overall,1060,6075,2090,3100,12325,617,3131,2756,3562,10066
83,Venezuela,2021,VEN-21/VEN_CBPF/SA2/SHL-FSC-WSH-PRO/NGO/20260,6/8/2023 8:24:56 PM,Host Communities,1240,1445,1077,1193,4955,1829,2344,1001,836,6010
83,Venezuela,2021,VEN-21/VEN_CBPF/SA2/SHL-FSC-WSH-PRO/NGO/20260,6/8/2023 8:24:56 PM,Overall,1240,1445,1077,1193,4955,1829,2344,1001,836,6010
83,Venezuela,2021,VEN-21/VEN_CBPF/SA2/SHL-WSH-PRO/NGO/20323,12/16/2022 1:25:06 PM,Other,125,627,276,400,1428,223,1223,195,285,1926
83,Venezuela,2021,VEN-21/VEN_CBPF/SA2/SHL-WSH-PRO/NGO/20323,12/16/2022 1:25:06 PM,Overall,125,627,276,400,1428,223,1223,195,285,1926
83,Venezuela,2021,VEN-21/VEN_CBPF/SA2/WSH-EDU-NUT-PRO-FSC/NGO/20294,3/31/2023 2:05:26 PM,Other,450,900,1349,1800,4499,361,2250,2127,1907,6645
83,Venezuela,2021,VEN-21/VEN_CBPF/SA2/WSH-EDU-NUT-PRO-FSC/NGO/20294,3/31/2023 2:05:26 PM,Overall,450,900,1349,1800,4499,361,2250,2127,1907,6645
83,Venezuela,2021,VEN-21/VEN_CBPF/SA2/WSH-EDU-PRO-FSC/INGO/20328,12/16/2022 7:31:19 PM,Other,2204,2782,600,800,6386,2204,2782,600,800,6386
83,Venezuela,2021,VEN-21/VEN_CBPF/SA2/WSH-EDU-PRO-FSC/INGO/20328,12/16/2022 7:31:19 PM,Overall,2204,2782,600,800,6386,2204,2782,600,800,6386
83,Venezuela,2021,VEN-21/VEN_CBPF/SA2/WSH-EDU-SHL-NUT-FSC/INGO/20279,4/28/2023 8:02:31 PM,Other,296,690,230,230,1446,205,363,455,537,1560
83,Venezuela,2021,VEN-21/VEN_CBPF/SA2/WSH-EDU-SHL-NUT-FSC/INGO/20279,4/28/2023 8:02:31 PM,Overall,296,690,230,230,1446,205,363,455,537,1560
83,Venezuela,2021,VEN-21/VEN_CBPF/SA2/WSH-SHL-PRO-FSC-EDU/INGO/20263,8/18/2023 12:51:11 PM,Other,1552,2057,880,1110,5599,2004,5047,1055,1270,9376
83,Venezuela,2021,VEN-21/VEN_CBPF/SA2/WSH-SHL-PRO-FSC-EDU/INGO/20263,8/18/2023 12:51:11 PM,Overall,1552,2057,880,1110,5599,2004,5047,1055,1270,9376
83,Venezuela,2022,VEN-22/VEN_CBPF/SA1/EDU/NGO/22618,10/17/2023 11:50:24 PM,Other,708,799,216,236,1959,596,581,514,345,2036
83,Venezuela,2022,VEN-22/VEN_CBPF/SA1/EDU/NGO/22618,10/17/2023 11:50:24 PM,Overall,708,799,216,236,1959,596,581,514,345,2036
83,Venezuela,2022,VEN-22/VEN_CBPF/SA1/EDU-FSC-PRO/NGO/22590,10/5/2023 10:33:13 PM,Other,1796,2694,0,0,4490,1796,2694,0,0,4490
83,Venezuela,2022,VEN-22/VEN_CBPF/SA1/EDU-FSC-PRO/NGO/22590,10/5/2023 10:33:13 PM,Overall,1796,2694,0,0,4490,1796,2694,0,0,4490
83,Venezuela,2022,VEN-22/VEN_CBPF/SA1/PRO-HEA-SHL/NGO/22592,10/18/2023 12:15:03 AM,Host Communities,608,4540,1614,3330,10092,2044,4302,2404,2751,11501
83,Venezuela,2022,VEN-22/VEN_CBPF/SA1/PRO-HEA-SHL/NGO/22592,10/18/2023 12:15:03 AM,Overall,608,4540,1614,3330,10092,2044,4302,2404,2751,11501
83,Venezuela,2022,VEN-22/VEN_CBPF/SA2/HEA-NUT-FSC-WSH/NGO/24081,10/17/2023 11:45:24 PM,Other,128,1128,888,972,3116,170,1076,966,926,3138
83,Venezuela,2022,VEN-22/VEN_CBPF/SA2/HEA-NUT-FSC-WSH/NGO/24081,10/17/2023 11:45:24 PM,Overall,128,1128,888,972,3116,170,1076,966,926,3138
83,Venezuela,2022,VEN-22/VEN_CBPF/SA2/PRO-WSH-NUT-FSC-SHL/NGO/24033,10/9/2023 6:20:42 PM,Other,2258,2259,3455,3456,11428,1924,5417,844,933,9118
83,Venezuela,2022,VEN-22/VEN_CBPF/SA2/PRO-WSH-NUT-FSC-SHL/NGO/24033,10/9/2023 6:20:42 PM,Overall,2258,2259,3455,3456,11428,1924,5417,844,933,9118
64,Yemen,2015,YEM-15/3420/RA/FS/INGO/1289,1/8/2016 2:41:15 PM,Host Communities,580,605,603,627,2415,0,0,0,0,0
64,Yemen,2015,YEM-15/3420/RA/FS/INGO/1289,1/8/2016 2:41:15 PM,Internally Displaced People,1353,1409,1408,1465,5635,1812,1304,2021,1902,7039
64,Yemen,2015,YEM-15/3420/RA/FS/INGO/1289,1/8/2016 2:41:15 PM,Overall,1934,2012,2011,2093,8050,1812,1304,2021,1902,7039
64,Yemen,2015,YEM-15/3420/RA/FS/INGO/1351,3/14/2016 2:00:36 PM,Host Communities,1751,1542,3475,3400,10168,2492,2687,5081,5649,15909
64,Yemen,2015,YEM-15/3420/RA/FS/INGO/1351,3/14/2016 2:00:36 PM,Internally Displaced People,662,750,1489,1457,4358,31,31,63,71,196
64,Yemen,2015,YEM-15/3420/RA/FS/INGO/1351,3/14/2016 2:00:36 PM,Overall,2502,2203,4964,4857,14526,2523,2718,5144,5720,16105
64,Yemen,2015,YEM-15/3420/RA/FS/INGO/1373,2/29/2016 11:07:14 AM,Internally Displaced People,4064,4740,6773,6998,22575,3250,3649,5338,5417,17654
64,Yemen,2015,YEM-15/3420/RA/FS/INGO/1373,2/29/2016 11:07:14 AM,Overall,4064,4740,6773,6998,22575,3250,3649,5338,5417,17654
64,Yemen,2015,YEM-15/3420/RA/FS/INGO/1401,6/7/2016 8:38:15 PM,Host Communities,933,972,953,992,3850,767,798,798,831,3194
64,Yemen,2015,YEM-15/3420/RA/FS/INGO/1401,6/7/2016 8:38:15 PM,Internally Displaced People,2801,2916,2975,2858,11550,3068,3194,3194,3324,12780
64,Yemen,2015,YEM-15/3420/RA/FS/INGO/1401,6/7/2016 8:38:15 PM,Overall,0,0,0,0,0,3835,3992,3992,4155,15974
64,Yemen,2015,YEM-15/3420/RA/H/INGO/1280,5/8/2016 12:08:15 PM,Internally Displaced People,15995,13226,7154,14065,50440,8227,13036,10050,9119,40432
64,Yemen,2015,YEM-15/3420/RA/H/INGO/1280,5/8/2016 12:08:15 PM,Other,2130,1889,1361,1180,6560,0,0,0,0,0
64,Yemen,2015,YEM-15/3420/RA/H/INGO/1280,5/8/2016 12:08:15 PM,Overall,22627,19027,14763,21269,77686,11696,19223,16102,16532,63553
64,Yemen,2015,YEM-15/3420/RA/H/INGO/1299,8/14/2016 5:30:05 PM,Host Communities,527,248,0,0,775,0,0,0,0,0
64,Yemen,2015,YEM-15/3420/RA/H/INGO/1299,8/14/2016 5:30:05 PM,Other,17,8,0,0,25,0,0,0,0,0
64,Yemen,2015,YEM-15/3420/RA/H/INGO/1299,8/14/2016 5:30:05 PM,Overall,544,256,0,0,800,452,348,0,0,800
64,Yemen,2015,YEM-15/3420/RA/H/INGO/1393,12/22/2015 10:46:39 AM,Overall,14280,21420,17850,17850,71400,22289,34988,8339,8056,73672
64,Yemen,2015,YEM-15/3420/RA/H/INGO/1406,9/11/2016 6:34:40 AM,Host Communities,8662,8889,1749,1820,21120,0,0,0,0,0
64,Yemen,2015,YEM-15/3420/RA/H/INGO/1406,9/11/2016 6:34:40 AM,Internally Displaced People,3539,3810,750,781,8880,0,0,0,0,0
64,Yemen,2015,YEM-15/3420/RA/H/INGO/1406,9/11/2016 6:34:40 AM,Overall,12201,12699,2499,2601,30000,9176,18585,12804,13081,53646
64,Yemen,2015,YEM-15/3420/RA/H/NGO/1283,1/14/2016 6:48:24 AM,Host Communities,7800,11700,6370,6630,32500,0,0,0,0,0
64,Yemen,2015,YEM-15/3420/RA/H/NGO/1283,1/14/2016 6:48:24 AM,Internally Displaced People,6240,9360,5096,5304,26000,0,0,0,0,0
64,Yemen,2015,YEM-15/3420/RA/H/NGO/1283,1/14/2016 6:48:24 AM,Other,1560,2340,1274,1326,6500,0,0,0,0,0
64,Yemen,2015,YEM-15/3420/RA/H/NGO/1283,1/14/2016 6:48:24 AM,Overall,15600,23400,12740,13260,65000,12487,20180,17793,19493,69953
64,Yemen,2015,YEM-15/3420/RA/H/NGO/1326,8/28/2016 9:39:32 AM,Host Communities,1000,1650,900,950,4500,5496,7148,2650,3447,18741
64,Yemen,2015,YEM-15/3420/RA/H/NGO/1326,8/28/2016 9:39:32 AM,Internally Displaced People,4500,5000,3000,3000,15500,8245,10724,3976,5171,28116
64,Yemen,2015,YEM-15/3420/RA/H/NGO/1326,8/28/2016 9:39:32 AM,Overall,5500,6650,3900,3950,20000,13741,17872,6626,8618,46857
64,Yemen,2015,YEM-15/3420/RA/L/UN/1286,2/24/2016 1:37:51 PM,Other,720,0,0,0,720,724,0,0,0,724
64,Yemen,2015,YEM-15/3420/RA/L/UN/1286,2/24/2016 1:37:51 PM,Overall,400,320,0,0,720,404,320,0,0,724
64,Yemen,2015,YEM-15/3420/RA/N/INGO/1382,6/21/2016 11:15:45 AM,Host Communities,0,0,1025,1025,2050,0,0,371,374,745
64,Yemen,2015,YEM-15/3420/RA/N/INGO/1382,6/21/2016 11:15:45 AM,Internally Displaced People,0,0,1025,1025,2050,0,0,365,325,690
64,Yemen,2015,YEM-15/3420/RA/N/INGO/1382,6/21/2016 11:15:45 AM,Overall,0,0,2050,2050,4100,0,0,736,699,1435
64,Yemen,2015,YEM-15/3420/RA/NFI/INGO/1300,1/9/2016 8:14:18 PM,Internally Displaced People,8580,7920,0,0,16500,2485,2293,0,0,4778
64,Yemen,2015,YEM-15/3420/RA/NFI/INGO/1300,1/9/2016 8:14:18 PM,Overall,8580,7920,0,0,16500,2485,2293,0,0,4778
64,Yemen,2015,YEM-15/3420/RA/NFI/UN/1384,8/10/2016 2:58:07 PM,Internally Displaced People,490,490,490,490,1960,666,687,313,294,1960
64,Yemen,2015,YEM-15/3420/RA/NFI/UN/1384,8/10/2016 2:58:07 PM,Overall,490,490,490,490,1960,666,687,313,294,1960
64,Yemen,2015,YEM-15/3420/RA/NFI/UN/1398,8/22/2016 9:32:08 AM,Host Communities,1740,2175,2175,2609,8699,2052,3912,3704,1320,10988
64,Yemen,2015,YEM-15/3420/RA/NFI/UN/1398,8/22/2016 9:32:08 AM,Internally Displaced People,6959,8698,8698,10438,34793,8207,11735,8643,7483,36068
64,Yemen,2015,YEM-15/3420/RA/NFI/UN/1398,8/22/2016 9:32:08 AM,Overall,8698,10873,10873,13047,43491,10259,15647,12347,8803,47056
64,Yemen,2015,YEM-15/3420/RA/P/INGO/1367,8/4/2016 6:51:19 PM,Host Communities,0,0,100,55,155,3637,2102,17,50,5806
64,Yemen,2015,YEM-15/3420/RA/P/INGO/1367,8/4/2016 6:51:19 PM,Internally Displaced People,1048,1182,2230,2230,6690,8485,4905,38404,13096,64890
64,Yemen,2015,YEM-15/3420/RA/P/INGO/1367,8/4/2016 6:51:19 PM,Overall,1048,1182,2330,2285,6845,12122,7007,38421,13146,70696
64,Yemen,2015,YEM-15/3420/RA/P/UN/1325,1/20/2016 8:59:32 AM,Overall,221,167,510,400,1298,0,0,0,0,0
64,Yemen,2015,YEM-15/3420/RA/P/UN/1325,1/20/2016 8:59:32 AM,Refugees,221,167,510,400,1298,312,498,0,0,810
64,Yemen,2015,YEM-15/3420/RA/WASH/INGO/1349,1/26/2016 7:45:22 AM,Internally Displaced People,17006,15698,0,0,32704,45861,44062,0,0,89923
64,Yemen,2015,YEM-15/3420/RA/WASH/INGO/1349,1/26/2016 7:45:22 AM,Overall,17006,15698,0,0,32704,45861,44062,0,0,89923
64,Yemen,2015,YEM-15/3420/RA/WASH/INGO/1381,7/3/2016 9:38:38 PM,Host Communities,2976,3274,4166,4464,14880,2676,2636,2971,2874,11157
64,Yemen,2015,YEM-15/3420/RA/WASH/INGO/1381,7/3/2016 9:38:38 PM,Internally Displaced People,4494,4943,6292,6741,22470,4014,3953,4457,4311,16735
64,Yemen,2015,YEM-15/3420/RA/WASH/INGO/1381,7/3/2016 9:38:38 PM,Overall,7470,8217,10458,11205,37350,7923,7804,8797,8509,33033
64,Yemen,2015,YEM-15/3420/RA/WASH/INGO/1405,3/27/2016 8:54:19 AM,Host Communities,1647,1617,2303,2217,7784,1553,1573,3119,3250,9495
64,Yemen,2015,YEM-15/3420/RA/WASH/INGO/1405,3/27/2016 8:54:19 AM,Internally Displaced People,2945,2893,4119,3965,13922,3326,3362,4621,4834,16143
64,Yemen,2015,YEM-15/3420/RA/WASH/INGO/1405,3/27/2016 8:54:19 AM,Overall,4592,4510,6422,6182,21706,4879,4935,7740,8084,25638
64,Yemen,2015,YEM-15/3420/RA2/H/INGO/1484,8/14/2016 5:25:04 PM,Overall,612,263,0,0,875,495,380,0,0,875
64,Yemen,2015,YEM-15/3420/RA2/H/INGO/1490,3/24/2016 7:24:21 AM,Host Communities,19126,19906,4198,4682,47912,6742,15131,5673,5406,32952
64,Yemen,2015,YEM-15/3420/RA2/H/INGO/1490,3/24/2016 7:24:21 AM,Internally Displaced People,4098,4266,900,936,10200,1264,2837,1064,1014,6179
64,Yemen,2015,YEM-15/3420/RA2/H/INGO/1490,3/24/2016 7:24:21 AM,Other,4098,4266,900,936,10200,421,946,355,338,2060
64,Yemen,2015,YEM-15/3420/RA2/H/INGO/1490,3/24/2016 7:24:21 AM,Overall,27322,28438,5998,6242,68000,8427,18914,7092,6758,41191
64,Yemen,2015,YEM-15/3420/RA2/H/INGO/1506,8/22/2016 6:59:19 AM,Host Communities,0,67035,0,0,67035,0,47341,0,0,47341
64,Yemen,2015,YEM-15/3420/RA2/H/INGO/1506,8/22/2016 6:59:19 AM,Overall,0,73354,0,0,73354,0,47341,0,0,47341
64,Yemen,2015,YEM-15/3420/RA2/H-WASH/NGO/1520,5/12/2016 11:56:43 AM,Host Communities,980,2566,213,312,4071,557,8208,3501,4453,16719
64,Yemen,2015,YEM-15/3420/RA2/H-WASH/NGO/1520,5/12/2016 11:56:43 AM,Internally Displaced People,3079,6137,736,884,10836,222,2080,1039,1253,4594
64,Yemen,2015,YEM-15/3420/RA2/H-WASH/NGO/1520,5/12/2016 11:56:43 AM,Overall,4059,8703,949,1196,14907,779,10288,4540,5706,21313
64,Yemen,2015,YEM-15/3420/RA2/H-WASH/NGO/1527,11/20/2016 7:23:24 PM,Host Communities,8400,10080,11289,12264,42033,3863,21056,10265,9704,44888
64,Yemen,2015,YEM-15/3420/RA2/H-WASH/NGO/1527,11/20/2016 7:23:24 PM,Internally Displaced People,3600,4320,4839,5256,18015,2254,8454,4106,4345,19159
64,Yemen,2015,YEM-15/3420/RA2/H-WASH/NGO/1527,11/20/2016 7:23:24 PM,Overall,12000,14400,16128,17520,60048,7309,34979,16431,15831,74550
64,Yemen,2015,YEM-15/3420/RA2/NFI/INGO/1523,12/29/2015 7:56:35 AM,Internally Displaced People,2981,4248,3361,4789,15379,3917,4017,6982,6816,21732
64,Yemen,2015,YEM-15/3420/RA2/NFI/INGO/1523,12/29/2015 7:56:35 AM,Overall,2981,4248,3361,4789,15379,3917,4017,6982,6816,21732
64,Yemen,2015,YEM-15/3420/RA2/NFI/INGO/1525,3/9/2016 1:58:29 PM,Internally Displaced People,3293,3427,2195,2285,11200,4219,4391,2813,2927,14350
64,Yemen,2015,YEM-15/3420/RA2/NFI/INGO/1525,3/9/2016 1:58:29 PM,Overall,3293,3427,2195,2285,11200,4219,4391,2813,2927,14350
64,Yemen,2015,YEM-15/3420/RA2/NFI/INGO/1533,9/1/2016 6:57:46 AM,Host Communities,574,674,530,622,2400,0,0,0,0,0
64,Yemen,2015,YEM-15/3420/RA2/NFI/INGO/1533,9/1/2016 6:57:46 AM,Internally Displaced People,5168,6066,4768,5598,21600,5593,6254,9799,9051,30697
64,Yemen,2015,YEM-15/3420/RA2/NFI/INGO/1533,9/1/2016 6:57:46 AM,Other,5,5,0,0,10,0,0,0,0,0
64,Yemen,2015,YEM-15/3420/RA2/NFI/INGO/1533,9/1/2016 6:57:46 AM,Overall,5748,6746,5298,6218,24010,5593,6254,9799,9051,30697
64,Yemen,2015,YEM-15/3420/RA2/NFI/NGO/1496,8/31/2016 2:06:27 PM,Host Communities,39,44,73,41,197,61,86,77,78,302
64,Yemen,2015,YEM-15/3420/RA2/NFI/NGO/1496,8/31/2016 2:06:27 PM,Internally Displaced People,1265,1560,1643,1585,6053,1231,1640,1523,1554,5948
64,Yemen,2015,YEM-15/3420/RA2/NFI/NGO/1496,8/31/2016 2:06:27 PM,Overall,652,802,858,813,3125,646,863,800,816,3125
64,Yemen,2015,YEM-15/3420/RA2/NFI/NGO/1519,1/28/2016 12:36:55 PM,Internally Displaced People,1614,1550,1242,1194,5600,1831,1729,1382,1358,6300
64,Yemen,2015,YEM-15/3420/RA2/NFI/NGO/1519,1/28/2016 12:36:55 PM,Overall,1614,1550,1242,1194,5600,1831,1729,1382,1358,6300
64,Yemen,2015,YEM-15/3420/RA2/P/INGO/1504,8/4/2016 6:55:03 PM,Host Communities,300,300,700,700,2000,743,590,317,382,2032
64,Yemen,2015,YEM-15/3420/RA2/P/INGO/1504,8/4/2016 6:55:03 PM,Internally Displaced People,1500,1500,2000,2000,7000,1735,1379,739,892,4745
64,Yemen,2015,YEM-15/3420/RA2/P/INGO/1504,8/4/2016 6:55:03 PM,Overall,1800,1800,2700,2700,9000,2478,1969,1056,1274,6777
64,Yemen,2015,YEM-15/3420/RA2/P-NFI/NGO/1510,3/20/2016 6:53:11 AM,Host Communities,1166,1522,1273,1359,5320,0,0,0,0,0
64,Yemen,2015,YEM-15/3420/RA2/P-NFI/NGO/1510,3/20/2016 6:53:11 AM,Internally Displaced People,1457,1903,1591,1699,6650,0,0,0,0,0
64,Yemen,2015,YEM-15/3420/RA2/P-NFI/NGO/1510,3/20/2016 6:53:11 AM,Other,292,381,318,340,1331,0,0,0,0,0
64,Yemen,2015,YEM-15/3420/RA2/P-NFI/NGO/1510,3/20/2016 6:53:11 AM,Overall,2915,3805,3182,3398,13300,2068,7223,1448,3110,13849
64,Yemen,2015,YEM-15/3420/RA2/WASH/INGO/1488,4/28/2016 8:07:02 AM,Host Communities,2229,2143,1591,3000,8963,6093,4917,1266,1317,13593
64,Yemen,2015,YEM-15/3420/RA2/WASH/INGO/1488,4/28/2016 8:07:02 AM,Internally Displaced People,6242,6001,4454,4303,21000,7015,6740,1266,1317,16338
64,Yemen,2015,YEM-15/3420/RA2/WASH/INGO/1488,4/28/2016 8:07:02 AM,Overall,8471,8144,6045,7303,29963,11657,13108,2501,2833,30099
64,Yemen,2015,YEM-15/3420/RA2/WASH/INGO/1505,8/24/2016 12:48:53 PM,Host Communities,17364,17112,12893,12680,60049,98664,95262,74849,71447,340222
64,Yemen,2015,YEM-15/3420/RA2/WASH/INGO/1505,8/24/2016 12:48:53 PM,Internally Displaced People,29323,28257,21481,20589,99650,48310,46644,36649,34983,166586
64,Yemen,2015,YEM-15/3420/RA2/WASH/INGO/1505,8/24/2016 12:48:53 PM,Other,27903,26005,20039,18453,92400,42684,41212,32381,30909,147186
64,Yemen,2015,YEM-15/3420/RA2/WASH/INGO/1505,8/24/2016 12:48:53 PM,Overall,3821,4416,3167,3671,15075,6200,7208,5191,6003,24602
64,Yemen,2015,YEM-15/3420/RA2/WASH/INGO/1511,11/16/2016 10:21:37 AM,Host Communities,1487,1488,2887,2888,8750,1411,1410,2738,2737,8296
64,Yemen,2015,YEM-15/3420/RA2/WASH/INGO/1511,11/16/2016 10:21:37 AM,Internally Displaced People,1488,1487,2888,2887,8750,1553,1539,3016,2987,9095
64,Yemen,2015,YEM-15/3420/RA2/WASH/INGO/1511,11/16/2016 10:21:37 AM,Overall,2975,2975,5775,5775,17500,2964,2948,5754,5723,17389
64,Yemen,2015,YEM-15/3420/RA2/WASH/INGO/1526,4/14/2016 9:56:31 AM,Host Communities,910,875,875,840,3500,8396,7796,7197,6596,29985
64,Yemen,2015,YEM-15/3420/RA2/WASH/INGO/1526,4/14/2016 9:56:31 AM,Internally Displaced People,4550,4375,4373,4202,17500,6817,6330,5843,5356,24346
64,Yemen,2015,YEM-15/3420/RA2/WASH/INGO/1526,4/14/2016 9:56:31 AM,Overall,5460,5250,5248,5042,21000,15213,14126,13040,11952,54331
64,Yemen,2015,YEM-15/3420/RA2/WASH/INGO/1528,8/10/2016 6:27:04 AM,Host Communities,799,831,1996,2078,5704,457,3121,5476,7078,16132
64,Yemen,2015,YEM-15/3420/RA2/WASH/INGO/1528,8/10/2016 6:27:04 AM,Internally Displaced People,637,663,1593,1658,4551,1960,2040,4900,5100,14000
64,Yemen,2015,YEM-15/3420/RA2/WASH/INGO/1528,8/10/2016 6:27:04 AM,Overall,1436,1494,3589,3736,10255,2417,5161,10376,12178,30132
64,Yemen,2015,YEM-15/3420/RA2/WASH-H/NGO/1503,4/21/2016 4:42:52 PM,Host Communities,3600,5400,2850,3150,15000,0,0,0,0,0
64,Yemen,2015,YEM-15/3420/RA2/WASH-H/NGO/1503,4/21/2016 4:42:52 PM,Internally Displaced People,1800,2700,1425,1575,7500,0,0,0,0,0
64,Yemen,2015,YEM-15/3420/RA2/WASH-H/NGO/1503,4/21/2016 4:42:52 PM,Other,600,900,475,525,2500,0,0,0,0,0
64,Yemen,2015,YEM-15/3420/RA2/WASH-H/NGO/1503,4/21/2016 4:42:52 PM,Overall,6000,9000,4750,5250,25000,7434,11155,7026,6170,31785
64,Yemen,2015,YEM-15/3420/RA2/WASH-H/NGO/1516,5/2/2016 4:56:53 PM,Host Communities,488,563,1021,1200,3272,123,928,854,751,2656
64,Yemen,2015,YEM-15/3420/RA2/WASH-H/NGO/1516,5/2/2016 4:56:53 PM,Internally Displaced People,805,1238,3852,4033,9928,2038,2873,2857,2994,10762
64,Yemen,2015,YEM-15/3420/RA2/WASH-H/NGO/1516,5/2/2016 4:56:53 PM,Overall,1333,1459,4695,5713,13200,2966,4497,2767,3188,13418
64,Yemen,2015,YEM-15/3420/RA3/FS/INGO/1957,7/17/2016 5:51:06 PM,Host Communities,253,351,369,392,1365,0,0,0,0,0
64,Yemen,2015,YEM-15/3420/RA3/FS/INGO/1957,7/17/2016 5:51:06 PM,Internally Displaced People,843,1173,1228,1306,4550,1657,1718,1847,1964,7186
64,Yemen,2015,YEM-15/3420/RA3/FS/INGO/1957,7/17/2016 5:51:06 PM,Other,421,586,615,653,2275,494,535,514,557,2100
64,Yemen,2015,YEM-15/3420/RA3/FS/INGO/1957,7/17/2016 5:51:06 PM,Overall,1686,2343,2458,2613,9100,2151,2253,2361,2521,9286
64,Yemen,2015,YEM-15/3420/RA3/FS/INGO/1957,7/17/2016 5:51:06 PM,Refugees,169,234,246,261,910,0,0,0,0,0
64,Yemen,2015,YEM-15/3420/RA3/FS/INGO/2008,8/4/2016 7:24:51 PM,Host Communities,483,630,420,567,2100,2230,2509,3969,3619,12327
64,Yemen,2015,YEM-15/3420/RA3/FS/INGO/2008,8/4/2016 7:24:51 PM,Internally Displaced People,2737,3570,2380,3213,11900,577,677,1012,965,3231
64,Yemen,2015,YEM-15/3420/RA3/FS/INGO/2008,8/4/2016 7:24:51 PM,Overall,3220,4200,2800,3780,14000,2807,3186,4981,4584,15558
64,Yemen,2015,YEM-15/3420/RA3/FS/INGO/2041,9/5/2016 2:03:21 PM,Host Communities,1698,1767,3295,3430,10190,3309,3444,3445,3585,13783
64,Yemen,2015,YEM-15/3420/RA3/FS/INGO/2041,9/5/2016 2:03:21 PM,Internally Displaced People,566,589,1099,1143,3397,761,792,793,825,3171
64,Yemen,2015,YEM-15/3420/RA3/FS/INGO/2041,9/5/2016 2:03:21 PM,Overall,2264,2356,4394,4573,13587,4071,4236,4237,4410,16954
64,Yemen,2015,YEM-15/3420/RA3/FS/NGO/2007,4/21/2016 4:45:36 PM,Internally Displaced People,161,242,128,141,672,154,203,187,202,746
64,Yemen,2015,YEM-15/3420/RA3/FS/NGO/2007,4/21/2016 4:45:36 PM,Other,1519,2278,1203,1328,6328,1293,1510,1219,1135,5157
64,Yemen,2015,YEM-15/3420/RA3/FS/NGO/2007,4/21/2016 4:45:36 PM,Overall,1680,2520,1330,1470,7000,1447,1713,1406,1337,5903
64,Yemen,2015,YEM-15/3420/RA3/FS/UN/1961,12/28/2016 9:57:53 AM,Host Communities,3623,343,0,0,3966,3423,363,0,0,3786
64,Yemen,2015,YEM-15/3420/RA3/FS/UN/1961,12/28/2016 9:57:53 AM,Internally Displaced People,1812,172,0,0,1984,1812,152,0,0,1964
64,Yemen,2015,YEM-15/3420/RA3/FS/UN/1961,12/28/2016 9:57:53 AM,Overall,5435,515,0,0,5950,5235,515,0,0,5750
64,Yemen,2015,YEM-15/3420/RA3/H/INGO/1942,8/31/2016 7:35:25 AM,Host Communities,6900,14750,7300,7300,36250,10156,14443,8803,9786,43188
64,Yemen,2015,YEM-15/3420/RA3/H/INGO/1942,8/31/2016 7:35:25 AM,Internally Displaced People,6900,14750,7100,7100,35850,3034,4314,2630,2922,12900
64,Yemen,2015,YEM-15/3420/RA3/H/INGO/1942,8/31/2016 7:35:25 AM,Other,52,52,0,0,104,45,45,0,0,90
64,Yemen,2015,YEM-15/3420/RA3/H/INGO/1942,8/31/2016 7:35:25 AM,Overall,13852,29552,14400,14400,72204,13235,18802,11433,12708,56178
64,Yemen,2015,YEM-15/3420/RA3/H/INGO/1982,8/26/2016 7:37:13 PM,Host Communities,5440,11313,4423,4603,25779,5374,9953,4228,4061,23616
64,Yemen,2015,YEM-15/3420/RA3/H/INGO/1982,8/26/2016 7:37:13 PM,Internally Displaced People,2679,5572,2178,2267,12696,2679,5572,2178,2267,12696
64,Yemen,2015,YEM-15/3420/RA3/H/INGO/1982,8/26/2016 7:37:13 PM,Overall,8119,16885,6601,6870,38475,8021,14855,6311,6061,35248
64,Yemen,2015,YEM-15/3420/RA3/H/INGO/1991,8/1/2016 6:58:21 AM,Overall,30200,30200,25725,25726,111851,10032,9675,8548,8245,36500
64,Yemen,2015,YEM-15/3420/RA3/H/INGO/2016,11/27/2016 1:32:08 PM,Overall,963,412,0,0,1375,783,567,0,0,1350
64,Yemen,2015,YEM-15/3420/RA3/H/INGO/2038,1/9/2018 12:48:54 PM,Host Communities,1709,1637,300,290,3936,1966,864,210,199,3239
64,Yemen,2015,YEM-15/3420/RA3/H/INGO/2038,1/9/2018 12:48:54 PM,Overall,1709,1637,300,290,3936,1966,864,210,199,3239
64,Yemen,2015,YEM-15/3420/RA3/H/NGO/1958,12/14/2016 10:22:58 AM,Host Communities,1241,3076,6671,6612,17600,2755,9103,3228,3342,18428
64,Yemen,2015,YEM-15/3420/RA3/H/NGO/1958,12/14/2016 10:22:58 AM,Internally Displaced People,2072,4787,3841,4300,15000,2599,4896,3533,3994,15022
64,Yemen,2015,YEM-15/3420/RA3/H/NGO/1958,12/14/2016 10:22:58 AM,Other,1025,4025,0,0,5050,1030,4021,0,0,5051
64,Yemen,2015,YEM-15/3420/RA3/H/NGO/1958,12/14/2016 10:22:58 AM,Overall,4338,11888,10512,10912,37650,6384,18020,6761,7336,38501
64,Yemen,2015,YEM-15/3420/RA3/H/NGO/1995,8/1/2016 2:39:29 PM,Host Communities,4010,7452,4248,5880,21590,8350,7102,14763,7695,37910
64,Yemen,2015,YEM-15/3420/RA3/H/NGO/1995,8/1/2016 2:39:29 PM,Internally Displaced People,2690,4968,2832,3920,14410,4143,3558,7438,3903,19042
64,Yemen,2015,YEM-15/3420/RA3/H/NGO/1995,8/1/2016 2:39:29 PM,Overall,6700,12420,7080,9800,36000,11599,22200,10660,12493,56952
64,Yemen,2015,YEM-15/3420/RA3/N/UN/2009,12/4/2016 1:43:35 PM,Host Communities,0,1500,1500,1500,4500,0,3050,1501,1745,6296
64,Yemen,2015,YEM-15/3420/RA3/N/UN/2009,12/4/2016 1:43:35 PM,Internally Displaced People,0,500,500,500,1500,0,1016,500,582,2098
64,Yemen,2015,YEM-15/3420/RA3/N/UN/2009,12/4/2016 1:43:35 PM,Overall,0,2000,2000,2000,6000,0,4066,2001,2327,8394
64,Yemen,2015,YEM-15/3420/RA3/N/UN/2044,8/22/2016 2:38:29 PM,Host Communities,0,0,5610,5390,11000,0,0,6998,6724,13722
64,Yemen,2015,YEM-15/3420/RA3/N/UN/2044,8/22/2016 2:38:29 PM,Internally Displaced People,0,0,2643,2540,5183,0,0,3293,3165,6458
64,Yemen,2015,YEM-15/3420/RA3/N/UN/2044,8/22/2016 2:38:29 PM,Overall,0,0,8254,7929,16183,0,0,10292,9888,20180
64,Yemen,2015,YEM-15/3420/RA3/P/INGO/2002,11/6/2016 1:54:40 PM,Host Communities,7500,7572,12710,7602,35384,608,160,4464,3734,8966
64,Yemen,2015,YEM-15/3420/RA3/P/INGO/2002,11/6/2016 1:54:40 PM,Internally Displaced People,7500,7500,7650,7650,30300,3951,2130,2283,1941,10305
64,Yemen,2015,YEM-15/3420/RA3/P/INGO/2002,11/6/2016 1:54:40 PM,Other,24,22,0,0,46,12,12,0,0,24
64,Yemen,2015,YEM-15/3420/RA3/P/INGO/2002,11/6/2016 1:54:40 PM,Overall,5008,5032,5084,5084,20208,9653,3458,7075,6419,26605
64,Yemen,2015,YEM-15/3420/RA3/P/INGO/2006,8/4/2016 7:44:33 PM,Host Communities,500,500,1000,1000,3000,571,540,634,611,2356
64,Yemen,2015,YEM-15/3420/RA3/P/INGO/2006,8/4/2016 7:44:33 PM,Internally Displaced People,1300,1300,2000,2000,6600,1333,1668,1480,1427,5908
64,Yemen,2015,YEM-15/3420/RA3/P/INGO/2006,8/4/2016 7:44:33 PM,Overall,1800,1800,3000,3000,9600,1904,2208,2114,2038,8264
64,Yemen,2015,YEM-15/3420/RA3/P/NGO/2037,3/19/2017 7:43:35 AM,Host Communities,64,320,80,80,544,0,903,194,152,1249
64,Yemen,2015,YEM-15/3420/RA3/P/NGO/2037,3/19/2017 7:43:35 AM,Internally Displaced People,256,960,320,320,1856,0,996,289,315,1600
64,Yemen,2015,YEM-15/3420/RA3/P/NGO/2037,3/19/2017 7:43:35 AM,Overall,320,1280,400,400,2400,0,1899,440,442,2781
64,Yemen,2015,YEM-15/3420/RA3/WASH/INGO/1951,9/11/2016 7:18:18 AM,Host Communities,5657,5511,5508,5366,22042,36009,34953,49313,47398,167673
64,Yemen,2015,YEM-15/3420/RA3/WASH/INGO/1951,9/11/2016 7:18:18 AM,Internally Displaced People,9427,9137,9134,8850,36548,15503,14826,20321,19557,70207
64,Yemen,2015,YEM-15/3420/RA3/WASH/INGO/1951,9/11/2016 7:18:18 AM,Overall,15084,14648,14642,14216,58590,51512,49779,69634,66955,237880
64,Yemen,2015,YEM-15/3420/RA3/WASH/INGO/1973,7/17/2016 5:29:56 PM,Host Communities,19096,20010,2058,1204,42368,16613,17265,7024,6567,47469
64,Yemen,2015,YEM-15/3420/RA3/WASH/INGO/1973,7/17/2016 5:29:56 PM,Internally Displaced People,2737,2849,1825,1899,9310,2669,2449,4066,3633,12817
64,Yemen,2015,YEM-15/3420/RA3/WASH/INGO/1973,7/17/2016 5:29:56 PM,Overall,21833,22859,3883,3103,51678,19282,19714,11090,10200,60286
64,Yemen,2015,YEM-15/3420/RA3/WASH/INGO/2027,10/24/2016 10:32:51 AM,Host Communities,5479,5413,5595,5027,21514,5013,4736,6053,5915,21717
64,Yemen,2015,YEM-15/3420/RA3/WASH/INGO/2027,10/24/2016 10:32:51 AM,Overall,5479,5413,5595,5027,21514,5138,4853,6313,6100,22404
64,Yemen,2015,YEM-15/3420/RA3/WASH/NGO/1983,7/25/2016 6:45:59 AM,Host Communities,0,0,4500,3000,7500,193,297,2216,5580,8286
64,Yemen,2015,YEM-15/3420/RA3/WASH/NGO/1983,7/25/2016 6:45:59 AM,Internally Displaced People,1490,1550,2234,2326,7600,1838,1634,5432,9734,18638
64,Yemen,2015,YEM-15/3420/RA3/WASH/NGO/1983,7/25/2016 6:45:59 AM,Overall,1490,1550,6734,5326,15100,2031,1931,7648,15314,26924
64,Yemen,2015,YEM-15/3420/RA3/WASH/UN/2015,8/22/2016 11:58:32 AM,Host Communities,13758,12271,5206,5950,37185,0,0,0,0,0
64,Yemen,2015,YEM-15/3420/RA3/WASH/UN/2015,8/22/2016 11:58:32 AM,Overall,20535,18315,7770,8880,55500,16964,15130,6419,7336,45849
64,Yemen,2015,YEM-15/3420/RA4/FS/UN/2239,2/26/2017 6:35:26 AM,Other,1900,1400,2000,1770,7070,1900,1400,2000,1770,7070
64,Yemen,2015,YEM-15/3420/RA4/FS/UN/2239,2/26/2017 6:35:26 AM,Overall,1900,1400,2000,1770,7070,1900,1400,2000,1770,7070
64,Yemen,2015,YEM-15/3420/RA4/FS/UN/2279,12/18/2016 2:35:21 PM,Overall,8000,8000,7200,6800,30000,9310,9690,9650,9350,38000
64,Yemen,2015,YEM-15/3420/RA4/H/UN/2277,1/3/2017 1:51:04 PM,Host Communities,134139,149345,187063,206295,676842,143858,166573,227573,219574,757578
64,Yemen,2015,YEM-15/3420/RA4/H/UN/2277,1/3/2017 1:51:04 PM,Overall,134139,149345,187063,206295,676842,143858,166573,227573,219574,757578
64,Yemen,2015,YEM-15/3420/RA4/H/UN/2281,5/16/2017 12:11:15 PM,Host Communities,55000,69000,0,0,124000,97,40745,0,0,40842
64,Yemen,2015,YEM-15/3420/RA4/H/UN/2281,5/16/2017 12:11:15 PM,Internally Displaced People,10000,11358,0,0,21358,312,6708,0,0,7020
64,Yemen,2015,YEM-15/3420/RA4/H/UN/2281,5/16/2017 12:11:15 PM,Overall,5000,25000,0,0,30000,409,47453,0,0,47862
64,Yemen,2015,YEM-15/3420/RA4/H/UN/2284,4/3/2017 7:07:27 AM,Host Communities,22500,28800,117000,112500,280800,22500,105091,168294,154795,450680
64,Yemen,2015,YEM-15/3420/RA4/H/UN/2284,4/3/2017 7:07:27 AM,Internally Displaced People,2500,3200,13000,12500,31200,2500,11677,18699,17199,50075
64,Yemen,2015,YEM-15/3420/RA4/H/UN/2284,4/3/2017 7:07:27 AM,Overall,25000,32000,130000,125000,312000,25000,116768,186993,171994,500755
64,Yemen,2015,YEM-15/3420/RA4/L/UN/2252,6/7/2016 3:34:19 PM,Overall,9713,9715,9714,9715,38857,9713,9715,9714,9715,38857
64,Yemen,2015,YEM-15/3420/RA4/NFI/UN/2272,11/6/2016 1:39:33 PM,Internally Displaced People,2940,4116,3234,4410,14700,2946,4124,3240,4418,14728
64,Yemen,2015,YEM-15/3420/RA4/NFI/UN/2272,11/6/2016 1:39:33 PM,Overall,2940,4116,3234,4410,14700,2946,4124,3240,4418,14728
64,Yemen,2015,YEM-15/3420/RA4/NFI/UN/2278,6/1/2016 7:47:26 PM,Other,0,0,0,0,0,7678,7510,8272,8040,31500
64,Yemen,2015,YEM-15/3420/RA4/NFI/UN/2278,6/1/2016 7:47:26 PM,Overall,9551,9020,6643,6286,31500,7678,7510,8272,8040,31500
64,Yemen,2015,YEM-15/3420/RA4/WASH/UN/2274,12/21/2016 12:16:29 PM,Host Communities,48016,67222,52817,72023,240078,52672,73740,57939,79007,263358
64,Yemen,2015,YEM-15/3420/RA4/WASH/UN/2274,12/21/2016 12:16:29 PM,Internally Displaced People,23650,33109,26015,35474,118248,25943,36319,28538,38914,129714
64,Yemen,2015,YEM-15/3420/RA4/WASH/UN/2274,12/21/2016 12:16:29 PM,Overall,71665,100331,78832,107498,358326,78614,110060,86476,117922,393072
64,Yemen,2015,YEM-15/3420/RA4/WASH/UN/2275,12/13/2016 11:24:40 AM,Internally Displaced People,11856,11856,12844,12844,49400,11350,11350,12305,12305,47310
64,Yemen,2015,YEM-15/3420/RA4/WASH/UN/2275,12/13/2016 11:24:40 AM,Other,2964,2964,3211,3211,12350,2847,2847,3088,3088,11870
64,Yemen,2015,YEM-15/3420/RA4/WASH/UN/2275,12/13/2016 11:24:40 AM,Overall,14820,14820,16055,16055,61750,14197,14197,15393,15393,59180
64,Yemen,2016,YEM-16/3420/1RA/Health-WASH/INGO/4321,5/16/2017 1:13:44 PM,Host Communities,3850,4575,9321,10216,27962,4502,4801,10115,10927,30345
64,Yemen,2016,YEM-16/3420/1RA/Health-WASH/INGO/4321,5/16/2017 1:13:44 PM,Internally Displaced People,1651,1960,3994,4378,11983,1568,2019,5369,4737,13693
64,Yemen,2016,YEM-16/3420/1RA/Health-WASH/INGO/4321,5/16/2017 1:13:44 PM,Overall,5501,6535,13315,14594,39945,6070,6820,15484,15664,44038
64,Yemen,2016,YEM-16/3420/1RA/WASH/INGO/4315,7/17/2017 10:03:36 AM,Host Communities,3780,4620,5670,6930,21000,6182,5297,9382,9645,30506
64,Yemen,2016,YEM-16/3420/1RA/WASH/INGO/4315,7/17/2017 10:03:36 AM,Overall,3780,4620,5670,6930,21000,6182,5297,9382,9645,30506
64,Yemen,2016,YEM-16/3420/1RA/WASH/INGO/4318,4/18/2017 8:41:13 PM,Host Communities,0,0,0,0,0,5596,5840,7651,7949,27036
64,Yemen,2016,YEM-16/3420/1RA/WASH/INGO/4318,4/18/2017 8:41:13 PM,Overall,5655,5410,6860,6615,24540,5596,5840,7651,7949,27036
64,Yemen,2016,YEM-16/3420/1RA/WASH/INGO/4327,11/21/2017 11:16:03 AM,Overall,24682,24263,17798,17211,83954,164100,157961,87001,84058,493120
64,Yemen,2016,YEM-16/3420/1RA/WASH-Health/NGO/4317,9/29/2017 5:52:50 PM,Host Communities,0,0,0,0,0,25455,22729,32965,31269,112418
64,Yemen,2016,YEM-16/3420/1RA/WASH-Health/NGO/4317,9/29/2017 5:52:50 PM,Other,0,0,0,0,0,1061,947,1373,1303,4684
64,Yemen,2016,YEM-16/3420/1RA/WASH-Health/NGO/4317,9/29/2017 5:52:50 PM,Overall,27166,28274,18110,18850,92400,26516,23676,34338,32572,117102
64,Yemen,2016,YEM-16/3420/1SA 2016/FSAC/NGO/2920,5/17/2017 11:14:43 AM,Host Communities,609,546,462,483,2100,636,630,663,617,2546
64,Yemen,2016,YEM-16/3420/1SA 2016/FSAC/NGO/2920,5/17/2017 11:14:43 AM,Internally Displaced People,1421,1274,1078,1127,4900,1487,1472,1547,1439,5945
64,Yemen,2016,YEM-16/3420/1SA 2016/FSAC/NGO/2920,5/17/2017 11:14:43 AM,Overall,2030,1820,1540,1610,7000,2123,2102,2210,2056,8491
64,Yemen,2016,YEM-16/3420/1SA 2016/FSAC/UN/2894,7/19/2018 10:11:32 AM,Host Communities,1150,1300,3266,3544,9260,1571,1739,4111,4361,11782
64,Yemen,2016,YEM-16/3420/1SA 2016/FSAC/UN/2894,7/19/2018 10:11:32 AM,Internally Displaced People,1650,1800,4062,4228,11740,1509,1670,3949,4190,11318
64,Yemen,2016,YEM-16/3420/1SA 2016/FSAC/UN/2894,7/19/2018 10:11:32 AM,Overall,2800,3100,7328,7772,21000,3080,3410,8060,8550,23100
64,Yemen,2016,YEM-16/3420/1SA 2016/FSAC-SHNFICCM/INGO/2904,1/5/2018 10:10:46 AM,Host Communities,1500,1674,1270,1330,5774,2780,2905,3257,2883,11825
64,Yemen,2016,YEM-16/3420/1SA 2016/FSAC-SHNFICCM/INGO/2904,1/5/2018 10:10:46 AM,Internally Displaced People,3500,3908,2968,3100,13476,610,664,636,564,2474
64,Yemen,2016,YEM-16/3420/1SA 2016/FSAC-SHNFICCM/INGO/2904,1/5/2018 10:10:46 AM,Overall,5000,5582,4238,4430,19250,3390,3569,3893,3447,14299
64,Yemen,2016,YEM-16/3420/1SA 2016/FSAC-WASH-Protection/INGO/2954,1/2/2018 9:49:31 AM,Host Communities,5168,5465,5560,5435,21628,6438,6930,4600,4760,22728
64,Yemen,2016,YEM-16/3420/1SA 2016/FSAC-WASH-Protection/INGO/2954,1/2/2018 9:49:31 AM,Internally Displaced People,5406,5656,6320,6767,24149,3430,3415,3798,5315,15958
64,Yemen,2016,YEM-16/3420/1SA 2016/FSAC-WASH-Protection/INGO/2954,1/2/2018 9:49:31 AM,Other,0,0,0,0,0,243,225,27939,20626,49033
64,Yemen,2016,YEM-16/3420/1SA 2016/FSAC-WASH-Protection/INGO/2954,1/2/2018 9:49:31 AM,Overall,10574,11121,11880,12202,45777,10111,10570,36337,30701,87719
64,Yemen,2016,YEM-16/3420/1SA 2016/Health/INGO/2802,11/14/2017 11:08:15 AM,Host Communities,9768,14719,14863,14621,53971,100,587,305,381,1373
64,Yemen,2016,YEM-16/3420/1SA 2016/Health/INGO/2802,11/14/2017 11:08:15 AM,Internally Displaced People,1724,2597,2623,2581,9525,6439,21707,10368,13024,51538
64,Yemen,2016,YEM-16/3420/1SA 2016/Health/INGO/2802,11/14/2017 11:08:15 AM,Overall,11492,17316,17486,17202,63496,10100,21905,8241,17863,58109
64,Yemen,2016,YEM-16/3420/1SA 2016/Health/INGO/2883,5/24/2017 4:40:51 PM,Host Communities,13468,22104,10670,10255,56497,21270,34909,16851,16196,89226
64,Yemen,2016,YEM-16/3420/1SA 2016/Health/INGO/2883,5/24/2017 4:40:51 PM,Internally Displaced People,7017,9893,5685,6147,28742,11082,15624,8979,9708,45393
64,Yemen,2016,YEM-16/3420/1SA 2016/Health/INGO/2883,5/24/2017 4:40:51 PM,Other,10793,14146,6604,9797,41340,17046,22342,10430,15473,65291
64,Yemen,2016,YEM-16/3420/1SA 2016/Health/INGO/2883,5/24/2017 4:40:51 PM,Overall,31278,46143,22959,26199,126579,49398,72875,36260,41377,199910
64,Yemen,2016,YEM-16/3420/1SA 2016/Health/NGO/2805,7/5/2017 12:52:14 PM,Host Communities,6326,9474,5422,5217,26439,10736,11587,9196,16405,47924
64,Yemen,2016,YEM-16/3420/1SA 2016/Health/NGO/2805,7/5/2017 12:52:14 PM,Internally Displaced People,4217,6316,3615,3478,17626,282,288,220,436,1226
64,Yemen,2016,YEM-16/3420/1SA 2016/Health/NGO/2805,7/5/2017 12:52:14 PM,Overall,10543,15790,9037,8695,44065,11018,11875,9416,16841,49150
64,Yemen,2016,YEM-16/3420/1SA 2016/Health/NGO/2852,5/12/2017 6:20:57 PM,Host Communities,4380,5170,4700,4715,18965,6121,13495,6498,6228,32342
64,Yemen,2016,YEM-16/3420/1SA 2016/Health/NGO/2852,5/12/2017 6:20:57 PM,Internally Displaced People,4300,5170,4700,4715,18885,2829,13934,4557,4523,25843
64,Yemen,2016,YEM-16/3420/1SA 2016/Health/NGO/2852,5/12/2017 6:20:57 PM,Overall,8680,10340,9400,9430,37850,8950,27429,11055,10751,58185
64,Yemen,2016,YEM-16/3420/1SA 2016/Health/UN/2845,7/12/2017 11:30:45 AM,Host Communities,14000,70000,0,0,84000,5756,83524,0,0,89280
64,Yemen,2016,YEM-16/3420/1SA 2016/Health/UN/2845,7/12/2017 11:30:45 AM,Internally Displaced People,14000,70000,0,0,84000,14038,49536,0,0,63574
64,Yemen,2016,YEM-16/3420/1SA 2016/Health/UN/2845,7/12/2017 11:30:45 AM,Overall,28000,140000,0,0,168000,19794,133060,0,0,152854
64,Yemen,2016,YEM-16/3420/1SA 2016/Health-Protection/NGO/2829,10/2/2017 9:31:11 AM,Host Communities,94,94,62,62,312,71,40,62,40,213
64,Yemen,2016,YEM-16/3420/1SA 2016/Health-Protection/NGO/2829,10/2/2017 9:31:11 AM,Internally Displaced People,93,94,63,62,312,76,40,62,62,240
64,Yemen,2016,YEM-16/3420/1SA 2016/Health-Protection/NGO/2829,10/2/2017 9:31:11 AM,Overall,187,188,125,125,625,146,80,124,85,435
64,Yemen,2016,YEM-16/3420/1SA 2016/Health-Protection/NGO/2902,11/26/2017 12:50:13 PM,Host Communities,2410,2160,1828,1911,8309,1100,11742,2665,5283,20790
64,Yemen,2016,YEM-16/3420/1SA 2016/Health-Protection/NGO/2902,11/26/2017 12:50:13 PM,Internally Displaced People,5623,5041,4265,4459,19388,3493,27892,12829,13030,57244
64,Yemen,2016,YEM-16/3420/1SA 2016/Health-Protection/NGO/2902,11/26/2017 12:50:13 PM,Overall,8033,7201,6093,6370,27697,4593,39634,15494,18313,78034
64,Yemen,2016,YEM-16/3420/1SA 2016/Logistics/UN/2960,3/22/2017 7:21:14 AM,Overall,125,125,0,0,250,86,86,0,0,172
64,Yemen,2016,YEM-16/3420/1SA 2016/Nutrition/INGO/2895,11/21/2017 12:21:23 PM,Host Communities,50,6488,5422,5645,17605,119,7099,9292,10021,26531
64,Yemen,2016,YEM-16/3420/1SA 2016/Nutrition/INGO/2895,11/21/2017 12:21:23 PM,Overall,50,6488,5422,5645,17605,119,7099,9292,10021,26531
64,Yemen,2016,YEM-16/3420/1SA 2016/Nutrition/NGO/2905,12/20/2017 10:31:51 AM,Host Communities,88,1208,1160,1160,3616,40,2082,974,1187,4283
64,Yemen,2016,YEM-16/3420/1SA 2016/Nutrition/NGO/2905,12/20/2017 10:31:51 AM,Internally Displaced People,40,3360,3480,3480,10360,93,3864,2271,2761,8989
64,Yemen,2016,YEM-16/3420/1SA 2016/Nutrition/NGO/2905,12/20/2017 10:31:51 AM,Overall,128,4568,4640,4640,13976,133,5946,3245,3948,13272
64,Yemen,2016,YEM-16/3420/1SA 2016/Nutrition/UN/2959,4/10/2017 11:27:40 AM,Host Communities,0,0,3774,3626,7400,0,0,3774,3626,7400
64,Yemen,2016,YEM-16/3420/1SA 2016/Nutrition/UN/2959,4/10/2017 11:27:40 AM,Internally Displaced People,0,0,943,907,1850,0,0,943,907,1850
64,Yemen,2016,YEM-16/3420/1SA 2016/Nutrition/UN/2959,4/10/2017 11:27:40 AM,Overall,0,0,4717,4533,9250,0,0,4717,4533,9250
64,Yemen,2016,YEM-16/3420/1SA 2016/Protection/NGO/2830,10/2/2017 10:54:24 AM,Host Communities,877,1514,986,1019,4396,0,0,0,0,0
64,Yemen,2016,YEM-16/3420/1SA 2016/Protection/NGO/2830,10/2/2017 10:54:24 AM,Internally Displaced People,1023,1767,1152,1187,5129,0,0,0,0,0
64,Yemen,2016,YEM-16/3420/1SA 2016/Protection/NGO/2830,10/2/2017 10:54:24 AM,Other,1022,1766,1152,1187,5127,0,0,0,0,0
64,Yemen,2016,YEM-16/3420/1SA 2016/Protection/NGO/2830,10/2/2017 10:54:24 AM,Overall,2922,5047,3290,3393,14652,3025,4951,3659,3568,15203
64,Yemen,2016,YEM-16/3420/1SA 2016/Protection/UN/2893,4/3/2017 7:43:43 AM,Internally Displaced People,471529,525937,398985,417122,1813573,427448,452398,565311,546183,1991340
64,Yemen,2016,YEM-16/3420/1SA 2016/Protection/UN/2893,4/3/2017 7:43:43 AM,Overall,471529,525937,398985,417122,1813573,427448,452398,565311,546183,1991340
64,Yemen,2016,YEM-16/3420/1SA 2016/Protection/UN/2917,3/22/2017 8:02:46 AM,Overall,369756,395759,306973,313086,1385574,341758,350471,427595,358234,1478058
64,Yemen,2016,YEM-16/3420/1SA 2016/Protection-CP/NGO/2857,5/31/2017 8:23:42 AM,Host Communities,1057,1510,431,905,3903,1418,1430,552,577,3977
64,Yemen,2016,YEM-16/3420/1SA 2016/Protection-CP/NGO/2857,5/31/2017 8:23:42 AM,Internally Displaced People,1500,1832,804,1315,5451,1731,4029,980,2545,9285
64,Yemen,2016,YEM-16/3420/1SA 2016/Protection-CP/NGO/2857,5/31/2017 8:23:42 AM,Overall,2557,3342,1235,2220,9354,3149,5459,1532,3122,13262
64,Yemen,2016,YEM-16/3420/1SA 2016/Protection-CP/NGO/2874,12/12/2017 8:12:03 AM,Host Communities,1204,1306,770,768,4048,774,743,600,572,2689
64,Yemen,2016,YEM-16/3420/1SA 2016/Protection-CP/NGO/2874,12/12/2017 8:12:03 AM,Internally Displaced People,12035,13058,7702,7680,40475,11874,13264,16181,15220,56539
64,Yemen,2016,YEM-16/3420/1SA 2016/Protection-CP/NGO/2874,12/12/2017 8:12:03 AM,Overall,13239,14364,8472,8448,44523,12648,14007,16781,15792,59228
64,Yemen,2016,YEM-16/3420/1SA 2016/Protection-SHNFICCM/NGO/2946,11/26/2017 1:21:09 PM,Host Communities,50,350,50,150,600,50,350,50,150,600
64,Yemen,2016,YEM-16/3420/1SA 2016/Protection-SHNFICCM/NGO/2946,11/26/2017 1:21:09 PM,Internally Displaced People,50,350,50,150,600,50,350,50,150,600
64,Yemen,2016,YEM-16/3420/1SA 2016/Protection-SHNFICCM/NGO/2946,11/26/2017 1:21:09 PM,Overall,100,700,100,300,1200,100,700,100,300,1200
64,Yemen,2016,YEM-16/3420/1SA 2016/SHNFICCM/NGO/2850,7/5/2017 9:10:00 AM,Host Communities,415,461,692,712,2280,713,669,818,788,2988
64,Yemen,2016,YEM-16/3420/1SA 2016/SHNFICCM/NGO/2850,7/5/2017 9:10:00 AM,Internally Displaced People,4147,4603,6928,7110,22788,5287,5322,7732,7699,26040
64,Yemen,2016,YEM-16/3420/1SA 2016/SHNFICCM/NGO/2850,7/5/2017 9:10:00 AM,Overall,4562,5064,7620,7822,25068,6000,5991,8550,8487,29028
64,Yemen,2016,YEM-16/3420/1SA 2016/SHNFICCM/NGO/2868,1/17/2018 9:19:10 AM,Internally Displaced People,2160,2070,1914,1836,7980,1389,1504,1507,1359,5759
64,Yemen,2016,YEM-16/3420/1SA 2016/SHNFICCM/NGO/2868,1/17/2018 9:19:10 AM,Other,0,0,0,0,0,463,529,530,478,2000
64,Yemen,2016,YEM-16/3420/1SA 2016/SHNFICCM/NGO/2868,1/17/2018 9:19:10 AM,Overall,2160,2070,1914,1836,7980,1782,2033,2037,1837,7689
64,Yemen,2016,YEM-16/3420/1SA 2016/SHNFICCM/NGO/2927,11/20/2017 12:57:49 PM,Internally Displaced People,668,707,1182,1112,3669,1561,1693,2099,2087,7440
64,Yemen,2016,YEM-16/3420/1SA 2016/SHNFICCM/NGO/2927,11/20/2017 12:57:49 PM,Overall,668,707,1182,1112,3669,1561,1693,2099,2087,7440
64,Yemen,2016,YEM-16/3420/1SA 2016/SHNFICCM/UN/2962,2/26/2018 7:43:45 AM,Internally Displaced People,4480,6272,4928,6720,22400,4480,6272,4928,6720,22400
64,Yemen,2016,YEM-16/3420/1SA 2016/SHNFICCM/UN/2962,2/26/2018 7:43:45 AM,Overall,4480,6272,4928,6720,22400,4480,6272,4928,6720,22400
64,Yemen,2016,YEM-16/3420/1SA 2016/SHNFICCM-FSAC/NGO/2867,9/25/2017 7:12:09 AM,Internally Displaced People,2633,2528,2334,2242,9737,2139,2739,2774,2779,10431
64,Yemen,2016,YEM-16/3420/1SA 2016/SHNFICCM-FSAC/NGO/2867,9/25/2017 7:12:09 AM,Overall,2633,2528,2334,2242,9737,2139,2739,2774,2779,10431
64,Yemen,2016,YEM-16/3420/1SA 2016/SHNFICCM-WASH-FSAC/INGO/2800,8/9/2017 9:34:07 AM,Internally Displaced People,917,1205,1518,1505,5145,1171,1318,1529,1548,5566
64,Yemen,2016,YEM-16/3420/1SA 2016/SHNFICCM-WASH-FSAC/INGO/2800,8/9/2017 9:34:07 AM,Overall,5661,5661,5878,5445,22645,4725,4717,5856,5720,21018
64,Yemen,2016,YEM-16/3420/1SA 2016/SHNFICCM-WASH-FSAC/INGO/2842,10/24/2017 12:49:17 PM,Host Communities,734,766,830,862,3192,533,556,603,626,2318
64,Yemen,2016,YEM-16/3420/1SA 2016/SHNFICCM-WASH-FSAC/INGO/2842,10/24/2017 12:49:17 PM,Internally Displaced People,2937,3064,3320,3447,12768,4798,5006,5423,5632,20859
64,Yemen,2016,YEM-16/3420/1SA 2016/SHNFICCM-WASH-FSAC/INGO/2842,10/24/2017 12:49:17 PM,Overall,3671,3830,4150,4309,15960,5331,5562,6026,6258,23177
64,Yemen,2016,YEM-16/3420/1SA 2016/WASH/INGO/2811,12/13/2016 12:02:09 PM,Host Communities,1310,1287,944,914,4455,1310,1287,944,914,4455
64,Yemen,2016,YEM-16/3420/1SA 2016/WASH/INGO/2811,12/13/2016 12:02:09 PM,Internally Displaced People,5331,5240,3843,3717,18131,5331,5240,3843,3717,18131
64,Yemen,2016,YEM-16/3420/1SA 2016/WASH/INGO/2811,12/13/2016 12:02:09 PM,Overall,6641,6527,4787,4631,22586,6641,6527,4787,4631,22586
64,Yemen,2016,YEM-16/3420/1SA 2016/WASH/INGO/2947,5/17/2017 12:49:44 PM,Host Communities,1174,1131,860,825,3990,1025,1034,1093,1051,4203
64,Yemen,2016,YEM-16/3420/1SA 2016/WASH/INGO/2947,5/17/2017 12:49:44 PM,Internally Displaced People,10700,10276,7838,7486,36300,9229,9305,9836,9457,37827
64,Yemen,2016,YEM-16/3420/1SA 2016/WASH/INGO/2947,5/17/2017 12:49:44 PM,Overall,11874,11407,8698,8311,40290,10254,10339,10929,10508,42030
64,Yemen,2016,YEM-16/3420/1SA 2016/WASH/UN/2877,8/15/2017 9:27:27 AM,Internally Displaced People,7300,10220,8030,10950,36500,8303,11623,9134,12454,41514
64,Yemen,2016,YEM-16/3420/1SA 2016/WASH/UN/2877,8/15/2017 9:27:27 AM,Overall,7300,10220,8030,10950,36500,8303,11623,9134,12454,41514
64,Yemen,2016,YEM-16/3420/1SA 2016/WASH/UN/2915,2/7/2018 9:40:09 AM,Host Communities,8747,8410,8407,8079,33643,11100,11090,9176,8090,39456
64,Yemen,2016,YEM-16/3420/1SA 2016/WASH/UN/2915,2/7/2018 9:40:09 AM,Internally Displaced People,10176,9785,9782,9399,39142,10076,10122,8904,7069,36171
64,Yemen,2016,YEM-16/3420/1SA 2016/WASH/UN/2915,2/7/2018 9:40:09 AM,Overall,18923,18195,18189,17478,72785,21176,21212,18080,15159,75627
64,Yemen,2016,YEM-16/3420/1SA 2016/WASH-FSAC/INGO/2956,10/26/2017 10:24:42 AM,Overall,42626,41902,30738,29723,144989,53620,52709,38665,37389,182383
64,Yemen,2016,YEM-16/3420/1SA 2016/WASH-FSAC/NGO/2813,11/18/2017 2:59:28 PM,Host Communities,6170,6540,9708,10104,32522,14985,15545,19613,20774,70917
64,Yemen,2016,YEM-16/3420/1SA 2016/WASH-FSAC/NGO/2813,11/18/2017 2:59:28 PM,Internally Displaced People,2064,2031,2644,2753,9492,4625,4800,6531,6888,22844
64,Yemen,2016,YEM-16/3420/1SA 2016/WASH-FSAC/NGO/2813,11/18/2017 2:59:28 PM,Overall,8234,8571,12352,12857,42014,19610,20345,26144,27662,93761
64,Yemen,2016,YEM-16/3420/1SA 2016/WASH-FSAC-Nutrition/INGO/2909,7/22/2018 7:36:07 AM,Host Communities,5625,16365,4909,4509,31408,14604,16991,15931,15291,62817
64,Yemen,2016,YEM-16/3420/1SA 2016/WASH-FSAC-Nutrition/INGO/2909,7/22/2018 7:36:07 AM,Internally Displaced People,1851,5169,2074,2073,11167,968,1127,1056,1014,4165
64,Yemen,2016,YEM-16/3420/1SA 2016/WASH-FSAC-Nutrition/INGO/2909,7/22/2018 7:36:07 AM,Other,3032,3658,3280,3283,13253,0,0,0,0,0
64,Yemen,2016,YEM-16/3420/1SA 2016/WASH-FSAC-Nutrition/INGO/2909,7/22/2018 7:36:07 AM,Overall,10508,25192,10263,9865,55828,15573,18117,16987,16305,66982
64,Yemen,2016,YEM-16/3420/1SA 2016/WASH-Health/INGO/2848,1/24/2018 6:14:34 AM,Host Communities,27105,35264,11371,11227,84967,28647,27708,19255,18315,93925
64,Yemen,2016,YEM-16/3420/1SA 2016/WASH-Health/INGO/2848,1/24/2018 6:14:34 AM,Internally Displaced People,5552,7222,2330,2299,17403,5773,5584,2752,4820,18929
64,Yemen,2016,YEM-16/3420/1SA 2016/WASH-Health/INGO/2848,1/24/2018 6:14:34 AM,Overall,32657,42486,13701,13526,102370,34420,33292,23135,22007,112854
64,Yemen,2016,YEM-16/3420/1SA 2016/WASH-SHNFICCM/INGO/2957,10/23/2017 11:22:58 AM,Host Communities,4106,6248,3659,3838,17851,11072,12462,11472,12684,47690
64,Yemen,2016,YEM-16/3420/1SA 2016/WASH-SHNFICCM/INGO/2957,10/23/2017 11:22:58 AM,Internally Displaced People,10955,16672,9765,10242,47634,5454,6138,5651,6247,23490
64,Yemen,2016,YEM-16/3420/1SA 2016/WASH-SHNFICCM/INGO/2957,10/23/2017 11:22:58 AM,Overall,15061,22920,13424,14080,65485,16526,18600,17123,18931,71180
64,Yemen,2016,YEM-16/3420/2SA 2016/FSAC/NGO/4232,10/24/2017 7:10:59 AM,Host Communities,0,1990,0,0,1990,0,2381,0,0,2381
64,Yemen,2016,YEM-16/3420/2SA 2016/FSAC/NGO/4232,10/24/2017 7:10:59 AM,Internally Displaced People,1488,1573,1482,1457,6000,1498,1584,1493,1467,6042
64,Yemen,2016,YEM-16/3420/2SA 2016/FSAC/NGO/4232,10/24/2017 7:10:59 AM,Other,0,320,330,331,981,0,320,314,347,981
64,Yemen,2016,YEM-16/3420/2SA 2016/FSAC/NGO/4232,10/24/2017 7:10:59 AM,Overall,1488,3883,1812,1788,8971,1499,4355,1806,1815,9475
64,Yemen,2016,YEM-16/3420/2SA 2016/FSAC/NGO/4267,10/16/2017 8:55:44 AM,Host Communities,850,2540,1222,2213,6825,1107,929,1084,1289,4409
64,Yemen,2016,YEM-16/3420/2SA 2016/FSAC/NGO/4267,10/16/2017 8:55:44 AM,Internally Displaced People,1500,5000,1333,2000,9833,3322,2786,3251,3867,13226
64,Yemen,2016,YEM-16/3420/2SA 2016/FSAC/NGO/4267,10/16/2017 8:55:44 AM,Overall,2350,7540,2555,4213,16658,4429,3714,4334,5156,17633
64,Yemen,2016,YEM-16/3420/2SA 2016/FSAC/UN/4201,8/15/2018 6:23:11 AM,Host Communities,0,0,0,0,0,44662,41353,38042,41353,165410
64,Yemen,2016,YEM-16/3420/2SA 2016/FSAC/UN/4201,8/15/2018 6:23:11 AM,Overall,44661,41353,38044,41353,165411,44661,41353,38044,41353,165411
64,Yemen,2016,YEM-16/3420/2SA 2016/FSAC-SHNFICCM-WASH/INGO/4181,4/19/2018 6:21:58 AM,Host Communities,2013,2100,2275,2362,8750,1798,1886,2029,2124,7837
64,Yemen,2016,YEM-16/3420/2SA 2016/FSAC-SHNFICCM-WASH/INGO/4181,4/19/2018 6:21:58 AM,Internally Displaced People,7044,7350,7962,8269,30625,6748,7074,7608,7585,29015
64,Yemen,2016,YEM-16/3420/2SA 2016/FSAC-SHNFICCM-WASH/INGO/4181,4/19/2018 6:21:58 AM,Other,1006,1050,1138,1181,4375,452,472,508,912,2344
64,Yemen,2016,YEM-16/3420/2SA 2016/FSAC-SHNFICCM-WASH/INGO/4181,4/19/2018 6:21:58 AM,Overall,10063,10500,11375,11812,43750,8998,9432,10145,10621,39196
64,Yemen,2016,YEM-16/3420/2SA 2016/FSAC-WASH-SHNFICCM/INGO/4163,5/29/2018 10:54:31 AM,Host Communities,2588,2566,2222,2224,9600,3452,3481,4162,3801,14896
64,Yemen,2016,YEM-16/3420/2SA 2016/FSAC-WASH-SHNFICCM/INGO/4163,5/29/2018 10:54:31 AM,Internally Displaced People,862,855,741,742,3200,4832,5412,8662,7361,26267
64,Yemen,2016,YEM-16/3420/2SA 2016/FSAC-WASH-SHNFICCM/INGO/4163,5/29/2018 10:54:31 AM,Other,863,855,741,741,3200,0,0,0,0,0
64,Yemen,2016,YEM-16/3420/2SA 2016/FSAC-WASH-SHNFICCM/INGO/4163,5/29/2018 10:54:31 AM,Overall,4313,4276,3704,3707,16000,8284,8893,12824,11162,41163
64,Yemen,2016,YEM-16/3420/2SA 2016/Health/NGO/4259,2/15/2018 2:23:12 PM,Host Communities,5702,7793,2851,2662,19008,0,0,0,0,0
64,Yemen,2016,YEM-16/3420/2SA 2016/Health/NGO/4259,2/15/2018 2:23:12 PM,Internally Displaced People,8554,11690,4277,3991,28512,0,0,0,0,0
64,Yemen,2016,YEM-16/3420/2SA 2016/Health/NGO/4259,2/15/2018 2:23:12 PM,Overall,14256,19483,7128,6653,47520,11351,51694,16895,17482,97422
64,Yemen,2016,YEM-16/3420/2SA 2016/Health/UN/4238,4/15/2018 7:16:02 AM,Host Communities,32400,97200,0,0,129600,14282,107829,0,0,122111
64,Yemen,2016,YEM-16/3420/2SA 2016/Health/UN/4238,4/15/2018 7:16:02 AM,Internally Displaced People,3600,10800,0,0,14400,8671,15506,0,0,24177
64,Yemen,2016,YEM-16/3420/2SA 2016/Health/UN/4238,4/15/2018 7:16:02 AM,Overall,36000,108000,0,0,144000,13084,133204,0,0,146288
64,Yemen,2016,YEM-16/3420/2SA 2016/Health-Nutrition/INGO/4148,4/23/2018 9:31:43 AM,Host Communities,13562,33323,5162,5962,58009,5267,15449,10023,9292,40031
64,Yemen,2016,YEM-16/3420/2SA 2016/Health-Nutrition/INGO/4148,4/23/2018 9:31:43 AM,Internally Displaced People,243,598,92,107,1040,94,275,179,166,714
64,Yemen,2016,YEM-16/3420/2SA 2016/Health-Nutrition/INGO/4148,4/23/2018 9:31:43 AM,Other,501,1230,191,220,2142,194,570,370,343,1477
64,Yemen,2016,YEM-16/3420/2SA 2016/Health-Nutrition/INGO/4148,4/23/2018 9:31:43 AM,Overall,14306,35151,5445,6289,61191,5555,16295,10572,9801,42223
64,Yemen,2016,YEM-16/3420/2SA 2016/Health-Nutrition/INGO/4272,4/23/2018 6:37:36 AM,Host Communities,20843,19719,20241,20117,80920,9416,58742,20548,23075,111781
64,Yemen,2016,YEM-16/3420/2SA 2016/Health-Nutrition/INGO/4272,4/23/2018 6:37:36 AM,Internally Displaced People,8189,7763,7938,7910,31800,3660,22844,7990,8974,43468
64,Yemen,2016,YEM-16/3420/2SA 2016/Health-Nutrition/INGO/4272,4/23/2018 6:37:36 AM,Overall,29032,27482,28179,28027,112720,13078,81584,28540,32047,155249
64,Yemen,2016,YEM-16/3420/2SA 2016/Health-Nutrition/INGO/4716,6/21/2018 6:25:04 AM,Overall,9960,14038,25220,25220,74438,33622,42099,17960,16592,110273
64,Yemen,2016,YEM-16/3420/2SA 2016/Health-Nutrition/UN/4283,3/13/2018 1:14:07 PM,Other,0,140000,399208,364852,904060,0,0,0,0,0
64,Yemen,2016,YEM-16/3420/2SA 2016/Health-Nutrition/UN/4283,3/13/2018 1:14:07 PM,Overall,0,140000,399208,364852,904060,0,140000,399208,364852,904060
64,Yemen,2016,YEM-16/3420/2SA 2016/Health-Nutrition-WASH/NGO/4220,2/12/2018 1:21:36 PM,Host Communities,5100,18750,14425,15870,54145,7024,29388,27133,27960,91505
64,Yemen,2016,YEM-16/3420/2SA 2016/Health-Nutrition-WASH/NGO/4220,2/12/2018 1:21:36 PM,Internally Displaced People,3100,10750,8425,5130,27405,2360,9797,6766,6989,25912
64,Yemen,2016,YEM-16/3420/2SA 2016/Health-Nutrition-WASH/NGO/4220,2/12/2018 1:21:36 PM,Overall,8200,29500,22850,21000,81550,9366,39185,33917,34949,117417
64,Yemen,2016,YEM-16/3420/2SA 2016/Health-Nutrition-WASH/NGO/4245,3/11/2018 8:23:28 AM,Host Communities,13310,16520,19418,23118,72366,14142,30431,19213,22104,85890
64,Yemen,2016,YEM-16/3420/2SA 2016/Health-Nutrition-WASH/NGO/4245,3/11/2018 8:23:28 AM,Internally Displaced People,10000,10400,6740,3040,30180,6205,8211,5408,7322,27146
64,Yemen,2016,YEM-16/3420/2SA 2016/Health-Nutrition-WASH/NGO/4245,3/11/2018 8:23:28 AM,Overall,23310,26920,26158,26158,102546,20347,38642,24621,29426,113036
64,Yemen,2016,YEM-16/3420/2SA 2016/Health-Nutrition-WASH/UN/4227,4/10/2019 12:35:25 PM,Overall,76337,88390,120532,116514,401773,86649,100331,136815,132254,456049
64,Yemen,2016,YEM-16/3420/2SA 2016/Health-WASH/NGO/4171,1/2/2018 10:17:55 AM,Host Communities,11530,19570,4800,5100,41000,10611,21893,7282,7660,47446
64,Yemen,2016,YEM-16/3420/2SA 2016/Health-WASH/NGO/4171,1/2/2018 10:17:55 AM,Internally Displaced People,900,3000,3000,3000,9900,1200,2900,2900,2964,9964
64,Yemen,2016,YEM-16/3420/2SA 2016/Health-WASH/NGO/4171,1/2/2018 10:17:55 AM,Other,66,66,0,0,132,68,68,0,0,136
64,Yemen,2016,YEM-16/3420/2SA 2016/Health-WASH/NGO/4171,1/2/2018 10:17:55 AM,Overall,12496,22636,7800,8100,51032,11879,24861,10182,10624,57546
64,Yemen,2016,YEM-16/3420/2SA 2016/Health-WASH-Nutrition/INGO/4276,2/4/2019 6:26:31 AM,Host Communities,11299,14427,12775,13600,52101,0,0,0,0,0
64,Yemen,2016,YEM-16/3420/2SA 2016/Health-WASH-Nutrition/INGO/4276,2/4/2019 6:26:31 AM,Internally Displaced People,7534,9619,8517,9067,34737,0,0,0,0,0
64,Yemen,2016,YEM-16/3420/2SA 2016/Health-WASH-Nutrition/INGO/4276,2/4/2019 6:26:31 AM,Overall,18833,24046,21292,22667,86838,10426,11198,7213,6537,35374
64,Yemen,2016,YEM-16/3420/2SA 2016/Nutrition-FSAC/UN/4236,10/10/2018 7:38:48 AM,Overall,0,35579,62657,57837,156073,0,52644,58322,59879,170845
64,Yemen,2016,YEM-16/3420/2SA 2016/Nutrition-FSAC-Health/INGO/4212,10/16/2018 6:49:56 AM,Host Communities,491,9328,22366,21466,53651,372,25561,27531,29379,82843
64,Yemen,2016,YEM-16/3420/2SA 2016/Nutrition-FSAC-Health/INGO/4212,10/16/2018 6:49:56 AM,Internally Displaced People,10,182,438,420,1050,1,478,516,552,1547
64,Yemen,2016,YEM-16/3420/2SA 2016/Nutrition-FSAC-Health/INGO/4212,10/16/2018 6:49:56 AM,Overall,501,9510,22804,21886,54701,373,26038,28049,29930,84390
64,Yemen,2016,YEM-16/3420/2SA 2016/Nutrition-FSAC-WASH/INGO/4263,8/27/2018 8:33:17 AM,Host Communities,6060,14168,10480,9868,40576,0,0,0,0,0
64,Yemen,2016,YEM-16/3420/2SA 2016/Nutrition-FSAC-WASH/INGO/4263,8/27/2018 8:33:17 AM,Overall,6060,14168,10480,9868,40576,7544,9277,6739,6681,30241
64,Yemen,2016,YEM-16/3420/2SA 2016/Nutrition-Health/INGO/4255,8/26/2018 9:05:03 AM,Other,6753,10278,1055,1019,19105,2210,11904,2531,4546,21191
64,Yemen,2016,YEM-16/3420/2SA 2016/Nutrition-Health/INGO/4255,8/26/2018 9:05:03 AM,Overall,6753,10278,1055,1019,19105,2210,11866,2531,4546,21153
64,Yemen,2016,YEM-16/3420/2SA 2016/Nutrition-Health/NGO/4235,12/18/2017 8:07:23 AM,Host Communities,6258,9362,9922,9540,35082,4247,8561,19496,18380,50684
64,Yemen,2016,YEM-16/3420/2SA 2016/Nutrition-Health/NGO/4235,12/18/2017 8:07:23 AM,Internally Displaced People,1552,2328,2480,2385,8745,151,184,46,45,426
64,Yemen,2016,YEM-16/3420/2SA 2016/Nutrition-Health/NGO/4235,12/18/2017 8:07:23 AM,Overall,7810,11690,12402,11925,43827,4398,8745,19542,18425,51110
64,Yemen,2016,YEM-16/3420/2SA 2016/Nutrition-Health-WASH/INGO/4179,4/15/2018 8:37:22 AM,Host Communities,2537,4538,3000,3000,13075,6713,32757,8876,9365,57711
64,Yemen,2016,YEM-16/3420/2SA 2016/Nutrition-Health-WASH/INGO/4179,4/15/2018 8:37:22 AM,Internally Displaced People,2500,4500,3000,3000,13000,55,132,81,76,344
64,Yemen,2016,YEM-16/3420/2SA 2016/Nutrition-Health-WASH/INGO/4179,4/15/2018 8:37:22 AM,Overall,5037,9038,6000,6000,26075,6768,32889,8957,9441,58055
64,Yemen,2016,YEM-16/3420/2SA 2016/Nutrition-WASH/INGO/4193,8/2/2018 9:46:00 AM,Host Communities,286,3920,3651,3390,11247,250,7315,4935,5301,17801
64,Yemen,2016,YEM-16/3420/2SA 2016/Nutrition-WASH/INGO/4193,8/2/2018 9:46:00 AM,Overall,286,3920,3651,3390,11247,309,8199,5607,6026,20141
64,Yemen,2016,YEM-16/3420/2SA 2016/SHNFICCM/INGO/4248,8/9/2018 11:33:26 AM,Host Communities,480,480,1200,1200,3360,0,0,0,0,0
64,Yemen,2016,YEM-16/3420/2SA 2016/SHNFICCM/INGO/4248,8/9/2018 11:33:26 AM,Internally Displaced People,1920,1920,4800,4800,13440,5053,5114,13382,13565,37114
64,Yemen,2016,YEM-16/3420/2SA 2016/SHNFICCM/INGO/4248,8/9/2018 11:33:26 AM,Overall,2400,2400,6000,6000,16800,5053,5114,13382,13565,37114
64,Yemen,2016,YEM-16/3420/2SA 2016/SHNFICCM/NGO/4226,11/28/2017 8:18:37 AM,Overall,4010,4962,8035,8797,25804,3590,4341,8780,9187,25898
64,Yemen,2016,YEM-16/3420/2SA 2016/SHNFICCM-WASH-FSAC/INGO/4209,1/15/2019 7:03:55 AM,Overall,8887,8886,9242,8531,35546,18466,19159,14941,15052,67618
64,Yemen,2016,YEM-16/3420/2SA 2016/SHNFICCM-WASH-Health-Nutrition/UN/4233,9/18/2019 5:43:52 PM,Overall,41418,47131,25707,28564,142820,74552,83855,16767,18891,194065
64,Yemen,2016,YEM-16/3420/2SA 2016/WASH/NGO/4192,1/29/2018 7:25:15 AM,Host Communities,3364,3528,3345,3263,13500,6457,6341,6226,5565,24589
64,Yemen,2016,YEM-16/3420/2SA 2016/WASH/NGO/4192,1/29/2018 7:25:15 AM,Internally Displaced People,1495,1568,1487,1450,6000,158,163,211,189,721
64,Yemen,2016,YEM-16/3420/2SA 2016/WASH/NGO/4192,1/29/2018 7:25:15 AM,Other,2616,2744,2602,2538,10500,0,0,0,0,0
64,Yemen,2016,YEM-16/3420/2SA 2016/WASH/NGO/4192,1/29/2018 7:25:15 AM,Overall,7475,7840,7434,7251,30000,6615,6504,6437,5754,25310
64,Yemen,2016,YEM-16/3420/2SA 2016/WASH/NGO/4244,12/10/2017 7:25:41 AM,Host Communities,19250,20036,12833,13357,65476,27775,28908,18516,19272,94471
64,Yemen,2016,YEM-16/3420/2SA 2016/WASH/NGO/4244,12/10/2017 7:25:41 AM,Internally Displaced People,965,1004,643,670,3282,3258,3391,2172,2261,11082
64,Yemen,2016,YEM-16/3420/2SA 2016/WASH/NGO/4244,12/10/2017 7:25:41 AM,Overall,20215,21040,13477,14027,68759,31033,32300,20689,21533,105555
64,Yemen,2016,YEM-16/3420/2SA 2016/WASH-FSAC/INGO/4265,4/9/2018 12:42:45 PM,Host Communities,4826,4737,3528,3418,16509,9641,8898,2462,1825,22826
64,Yemen,2016,YEM-16/3420/2SA 2016/WASH-FSAC/INGO/4265,4/9/2018 12:42:45 PM,Internally Displaced People,11556,11370,8340,8065,39331,18212,18482,17623,17597,71914
64,Yemen,2016,YEM-16/3420/2SA 2016/WASH-FSAC/INGO/4265,4/9/2018 12:42:45 PM,Overall,16382,16107,11868,11483,55840,27853,27380,20085,19421,94739
64,Yemen,2016,YEM-16/3420/2SA 2016/WASH-SHNFICCM-FSAC/INGO/4204,2/12/2018 12:25:47 PM,Host Communities,2012,2094,4023,4188,12317,9076,10015,12607,14214,45912
64,Yemen,2016,YEM-16/3420/2SA 2016/WASH-SHNFICCM-FSAC/INGO/4204,2/12/2018 12:25:47 PM,Internally Displaced People,503,523,1006,1047,3079,3027,3340,4204,4740,15311
64,Yemen,2016,YEM-16/3420/2SA 2016/WASH-SHNFICCM-FSAC/INGO/4204,2/12/2018 12:25:47 PM,Overall,2515,2617,5029,5235,15396,12103,13355,16812,18955,61225
64,Yemen,2017,YEM-17/3420/1SA 2017/FSAC/NGO/5953,5/28/2018 11:30:16 AM,Host Communities,336,346,335,320,1337,191,191,387,401,1170
64,Yemen,2017,YEM-17/3420/1SA 2017/FSAC/NGO/5953,5/28/2018 11:30:16 AM,Internally Displaced People,792,815,788,755,3150,328,328,641,680,1977
64,Yemen,2017,YEM-17/3420/1SA 2017/FSAC/NGO/5953,5/28/2018 11:30:16 AM,Other,880,1265,876,839,3860,881,981,2124,1947,5933
64,Yemen,2017,YEM-17/3420/1SA 2017/FSAC/NGO/5953,5/28/2018 11:30:16 AM,Overall,2008,2426,1999,1914,8347,1400,1500,3152,3028,9080
64,Yemen,2017,YEM-17/3420/1SA 2017/FSAC/NGO/6016,7/25/2018 10:58:41 AM,Internally Displaced People,708,741,870,901,3220,175,223,246,281,925
64,Yemen,2017,YEM-17/3420/1SA 2017/FSAC/NGO/6016,7/25/2018 10:58:41 AM,Other,2834,2962,3478,3606,12880,5649,6668,7977,7789,28083
64,Yemen,2017,YEM-17/3420/1SA 2017/FSAC/NGO/6016,7/25/2018 10:58:41 AM,Overall,3542,3703,4348,4507,16100,5824,6891,8078,8215,29008
64,Yemen,2017,YEM-17/3420/1SA 2017/FSAC/NGO/6025,3/15/2018 8:34:01 AM,Overall,2998,3120,614,639,7371,5730,5964,1173,1224,14091
64,Yemen,2017,YEM-17/3420/1SA 2017/FSAC/NGO/6132,6/4/2018 10:15:32 AM,Host Communities,2230,2321,3344,3481,11376,7162,7834,9687,9341,34024
64,Yemen,2017,YEM-17/3420/1SA 2017/FSAC/NGO/6132,6/4/2018 10:15:32 AM,Overall,2230,2321,3344,3481,11376,4932,5513,6343,5860,22648
64,Yemen,2017,YEM-17/3420/1SA 2017/FSAC/UN/6005,12/23/2018 7:49:06 AM,Host Communities,39270,36000,45817,42549,163636,46316,44399,51179,48380,190274
64,Yemen,2017,YEM-17/3420/1SA 2017/FSAC/UN/6005,12/23/2018 7:49:06 AM,Internally Displaced People,6393,5860,7459,6926,26638,0,0,0,0,0
64,Yemen,2017,YEM-17/3420/1SA 2017/FSAC/UN/6005,12/23/2018 7:49:06 AM,Overall,45663,41860,53276,49475,190274,46316,44399,51179,48380,190274
64,Yemen,2017,YEM-17/3420/1SA 2017/FSAC-Nutrition-WASH/NGO/5998,6/12/2018 9:40:01 PM,Overall,2234,3617,3585,3729,13165,4965,5188,4147,3852,18152
64,Yemen,2017,YEM-17/3420/1SA 2017/FSAC-Protection-SHNFICCM/NGO/6014,4/9/2018 10:03:06 AM,Internally Displaced People,3200,3000,6660,6672,19532,5258,5123,7630,6437,24448
64,Yemen,2017,YEM-17/3420/1SA 2017/FSAC-Protection-SHNFICCM/NGO/6014,4/9/2018 10:03:06 AM,Overall,3200,3000,6660,6672,19532,5258,5123,7630,6437,24448
64,Yemen,2017,YEM-17/3420/1SA 2017/FSAC-WASH/INGO/6019,12/16/2018 12:16:32 PM,Host Communities,4422,4713,3166,4187,16488,16726,13937,17406,14507,62576
64,Yemen,2017,YEM-17/3420/1SA 2017/FSAC-WASH/INGO/6019,12/16/2018 12:16:32 PM,Internally Displaced People,6633,7067,4749,6280,24729,1099,1029,1142,1071,4341
64,Yemen,2017,YEM-17/3420/1SA 2017/FSAC-WASH/INGO/6019,12/16/2018 12:16:32 PM,Overall,11055,11780,7915,10467,41217,16347,13432,17014,13982,60775
64,Yemen,2017,YEM-17/3420/1SA 2017/FSAC-WASH/INGO/6116,1/15/2019 12:24:43 PM,Host Communities,10058,9723,7042,6705,33528,11188,10907,7947,7629,37671
64,Yemen,2017,YEM-17/3420/1SA 2017/FSAC-WASH/INGO/6116,1/15/2019 12:24:43 PM,Internally Displaced People,3666,3479,2644,2554,12343,3182,3113,2326,2194,10815
64,Yemen,2017,YEM-17/3420/1SA 2017/FSAC-WASH/INGO/6116,1/15/2019 12:24:43 PM,Overall,13724,13202,9686,9259,45871,21566,17192,15558,16138,70454
64,Yemen,2017,YEM-17/3420/1SA 2017/FSAC-WASH/INGO/6166,11/21/2018 10:13:40 AM,Host Communities,6771,6309,8801,8359,30240,10471,11642,13030,13600,48743
64,Yemen,2017,YEM-17/3420/1SA 2017/FSAC-WASH/INGO/6166,11/21/2018 10:13:40 AM,Internally Displaced People,4513,4207,5867,5573,20160,1942,2282,2570,2700,9494
64,Yemen,2017,YEM-17/3420/1SA 2017/FSAC-WASH/INGO/6166,11/21/2018 10:13:40 AM,Overall,11284,10516,14668,13932,50400,14875,15668,13104,14590,58237
64,Yemen,2017,YEM-17/3420/1SA 2017/FSAC-WASH/NGO/5982,10/24/2018 10:08:48 AM,Host Communities,1190,3220,717,717,5844,0,0,0,0,0
64,Yemen,2017,YEM-17/3420/1SA 2017/FSAC-WASH/NGO/5982,10/24/2018 10:08:48 AM,Internally Displaced People,1890,7560,53,53,9556,0,0,0,0,0
64,Yemen,2017,YEM-17/3420/1SA 2017/FSAC-WASH/NGO/5982,10/24/2018 10:08:48 AM,Overall,3080,10780,770,770,15400,5190,5106,7630,7652,25578
64,Yemen,2017,YEM-17/3420/1SA 2017/Health/NGO/6138,9/10/2018 11:01:02 AM,Host Communities,10644,11080,15966,16632,54322,21222,20161,23065,35790,100238
64,Yemen,2017,YEM-17/3420/1SA 2017/Health/NGO/6138,9/10/2018 11:01:02 AM,Internally Displaced People,4562,4748,6842,7128,23280,204,141,108,237,690
64,Yemen,2017,YEM-17/3420/1SA 2017/Health/NGO/6138,9/10/2018 11:01:02 AM,Other,48,48,0,0,96,0,0,0,0,0
64,Yemen,2017,YEM-17/3420/1SA 2017/Health/NGO/6138,9/10/2018 11:01:02 AM,Overall,15254,15876,22808,23760,77698,21333,20302,23173,36027,100835
64,Yemen,2017,YEM-17/3420/1SA 2017/Health/UN/6069,6/28/2018 9:14:26 AM,Host Communities,1520,1760,2400,2320,8000,1900,2200,3000,2900,10000
64,Yemen,2017,YEM-17/3420/1SA 2017/Health/UN/6069,6/28/2018 9:14:26 AM,Internally Displaced People,380,440,600,580,2000,475,550,750,725,2500
64,Yemen,2017,YEM-17/3420/1SA 2017/Health/UN/6069,6/28/2018 9:14:26 AM,Overall,1900,2200,3000,2900,10000,2375,2750,3750,3625,12500
64,Yemen,2017,YEM-17/3420/1SA 2017/Health/UN/6120,10/17/2018 8:21:06 AM,Host Communities,3400,14840,212,212,18664,3142,95369,0,0,98511
64,Yemen,2017,YEM-17/3420/1SA 2017/Health/UN/6120,10/17/2018 8:21:06 AM,Internally Displaced People,13600,63285,913,913,78711,205,5316,0,0,5521
64,Yemen,2017,YEM-17/3420/1SA 2017/Health/UN/6120,10/17/2018 8:21:06 AM,Overall,17000,78125,1125,1125,97375,3363,100701,0,0,104064
64,Yemen,2017,YEM-17/3420/1SA 2017/Health-Nutrition/INGO/6165,12/20/2018 8:31:46 AM,Host Communities,25781,24331,25927,24844,100883,15434,49645,23939,23059,112077
64,Yemen,2017,YEM-17/3420/1SA 2017/Health-Nutrition/INGO/6165,12/20/2018 8:31:46 AM,Internally Displaced People,3516,3318,3535,3388,13757,2104,6770,3265,3282,15421
64,Yemen,2017,YEM-17/3420/1SA 2017/Health-Nutrition/INGO/6165,12/20/2018 8:31:46 AM,Overall,29297,27649,29462,28232,114640,17538,56415,27204,27352,128509
64,Yemen,2017,YEM-17/3420/1SA 2017/Health-Nutrition-WASH/INGO/5887,12/15/2018 9:14:39 AM,Host Communities,10000,38300,18900,19300,86500,8764,32738,15936,17140,74578
64,Yemen,2017,YEM-17/3420/1SA 2017/Health-Nutrition-WASH/INGO/5887,12/15/2018 9:14:39 AM,Internally Displaced People,220,254,140,280,894,1541,5778,2813,3025,13157
64,Yemen,2017,YEM-17/3420/1SA 2017/Health-Nutrition-WASH/INGO/5887,12/15/2018 9:14:39 AM,Overall,10220,38554,19040,19580,87394,10305,38516,18749,20165,87735
64,Yemen,2017,YEM-17/3420/1SA 2017/Health-Nutrition-WASH/INGO/6012,2/14/2019 10:22:02 AM,Overall,12328,12831,12831,13354,51344,28299,69253,43527,39580,180659
64,Yemen,2017,YEM-17/3420/1SA 2017/Health-Nutrition-WASH-FSAC/INGO/5838,2/4/2019 7:05:46 AM,Host Communities,10191,9803,7387,6422,33803,12538,19123,14680,13998,60339
64,Yemen,2017,YEM-17/3420/1SA 2017/Health-Nutrition-WASH-FSAC/INGO/5838,2/4/2019 7:05:46 AM,Internally Displaced People,4367,4221,3204,2766,14558,0,0,0,0,0
64,Yemen,2017,YEM-17/3420/1SA 2017/Health-Nutrition-WASH-FSAC/INGO/5838,2/4/2019 7:05:46 AM,Overall,14558,14024,10591,9188,48361,12538,19123,14680,13998,60339
64,Yemen,2017,YEM-17/3420/1SA 2017/Health-WASH/NGO/5977,12/16/2018 8:38:20 AM,Host Communities,16303,50158,18282,18678,103421,17570,43772,24004,27078,112424
64,Yemen,2017,YEM-17/3420/1SA 2017/Health-WASH/NGO/5977,12/16/2018 8:38:20 AM,Internally Displaced People,7123,12981,12345,12354,44803,16134,29884,17757,20425,84200
64,Yemen,2017,YEM-17/3420/1SA 2017/Health-WASH/NGO/5977,12/16/2018 8:38:20 AM,Overall,23426,63139,30627,31032,148224,33704,73656,41761,47503,196624
64,Yemen,2017,YEM-17/3420/1SA 2017/Nutrition/INGO/6159,1/6/2019 11:49:29 AM,Host Communities,61,15975,5339,4733,26108,41,7610,9075,9325,26051
64,Yemen,2017,YEM-17/3420/1SA 2017/Nutrition/INGO/6159,1/6/2019 11:49:29 AM,Overall,61,15975,5339,4733,26108,41,7610,9075,9325,26051
64,Yemen,2017,YEM-17/3420/1SA 2017/Nutrition-FSAC-WASH/INGO/6140,1/8/2019 6:47:55 AM,Host Communities,9611,9234,2167,2082,23094,8120,17744,5109,4654,35627
64,Yemen,2017,YEM-17/3420/1SA 2017/Nutrition-FSAC-WASH/INGO/6140,1/8/2019 6:47:55 AM,Overall,9611,9234,2167,2082,23094,5210,11895,3571,3247,23923
64,Yemen,2017,YEM-17/3420/1SA 2017/Nutrition-Health/NGO/5933,10/24/2018 9:30:37 AM,Overall,20418,21250,4182,4352,50202,11585,26003,17996,17567,73151
64,Yemen,2017,YEM-17/3420/1SA 2017/Nutrition-Health-WASH/NGO/6142,1/6/2019 11:28:49 AM,Host Communities,9764,13018,19527,22782,65091,7412,42220,20096,35074,104802
64,Yemen,2017,YEM-17/3420/1SA 2017/Nutrition-Health-WASH/NGO/6142,1/6/2019 11:28:49 AM,Overall,9764,13018,19527,22782,65091,7412,42220,20095,35075,104802
64,Yemen,2017,YEM-17/3420/1SA 2017/Nutrition-Health-WASH/UN/6097,6/10/2019 8:50:10 AM,Host Communities,9440,23354,15716,15716,64226,0,0,0,0,0
64,Yemen,2017,YEM-17/3420/1SA 2017/Nutrition-Health-WASH/UN/6097,6/10/2019 8:50:10 AM,Internally Displaced People,95,236,159,159,649,57541,73003,92047,81327,303918
64,Yemen,2017,YEM-17/3420/1SA 2017/Nutrition-Health-WASH/UN/6097,6/10/2019 8:50:10 AM,Overall,9535,23590,15875,15875,64875,57541,73003,92047,81327,303918
64,Yemen,2017,YEM-17/3420/1SA 2017/SHNFICCM/NGO/6164,3/22/2018 11:47:51 AM,Host Communities,270,257,331,355,1213,101,80,73,93,347
64,Yemen,2017,YEM-17/3420/1SA 2017/SHNFICCM/NGO/6164,3/22/2018 11:47:51 AM,Internally Displaced People,270,257,331,355,1213,373,409,423,420,1625
64,Yemen,2017,YEM-17/3420/1SA 2017/SHNFICCM/NGO/6164,3/22/2018 11:47:51 AM,Overall,540,514,662,710,2426,588,618,599,621,2426
64,Yemen,2017,YEM-17/3420/1SA 2017/SHNFICCM-WASH/INGO/6020,12/16/2018 12:08:02 PM,Host Communities,1179,1228,1228,1278,4913,713,463,742,481,2399
64,Yemen,2017,YEM-17/3420/1SA 2017/SHNFICCM-WASH/INGO/6020,12/16/2018 12:08:02 PM,Internally Displaced People,1769,1841,1841,1916,7367,1665,1079,1732,1124,5600
64,Yemen,2017,YEM-17/3420/1SA 2017/SHNFICCM-WASH/INGO/6020,12/16/2018 12:08:02 PM,Overall,2949,3069,3069,3194,12281,2937,2896,3057,3015,11905
64,Yemen,2017,YEM-17/3420/1SA 2017/SHNFICCM-WASH/NGO/5834,11/25/2018 7:09:48 AM,Host Communities,254,259,902,976,2391,146,125,288,320,879
64,Yemen,2017,YEM-17/3420/1SA 2017/SHNFICCM-WASH/NGO/5834,11/25/2018 7:09:48 AM,Internally Displaced People,2345,2814,3369,3199,11727,2535,2907,3942,3851,13235
64,Yemen,2017,YEM-17/3420/1SA 2017/SHNFICCM-WASH/NGO/5834,11/25/2018 7:09:48 AM,Overall,2599,3073,4271,4175,14118,2598,3072,4270,4174,14114
64,Yemen,2017,YEM-17/3420/1SA 2017/WASH/INGO/6114,6/17/2019 7:11:15 AM,Host Communities,7494,7302,12105,11529,38430,19304,19304,30798,29591,98997
64,Yemen,2017,YEM-17/3420/1SA 2017/WASH/INGO/6114,6/17/2019 7:11:15 AM,Internally Displaced People,2498,2434,4035,3843,12810,1233,1233,1965,1887,6318
64,Yemen,2017,YEM-17/3420/1SA 2017/WASH/INGO/6114,6/17/2019 7:11:15 AM,Overall,9992,9736,16140,15372,51240,20536,20536,32763,31488,105323
64,Yemen,2017,YEM-17/3420/1SA 2017/WASH/NGO/6096,10/7/2018 10:57:19 AM,Host Communities,1533,2046,1530,1891,7000,0,0,0,0,0
64,Yemen,2017,YEM-17/3420/1SA 2017/WASH/NGO/6096,10/7/2018 10:57:19 AM,Internally Displaced People,656,877,657,810,3000,0,0,0,0,0
64,Yemen,2017,YEM-17/3420/1SA 2017/WASH/NGO/6096,10/7/2018 10:57:19 AM,Other,2190,2923,2186,2701,10000,0,0,0,0,0
64,Yemen,2017,YEM-17/3420/1SA 2017/WASH/NGO/6096,10/7/2018 10:57:19 AM,Overall,4379,5846,4373,5402,20000,5268,7033,5260,6499,24060
64,Yemen,2017,YEM-17/3420/1SA 2017/WASH/NGO/6137,7/19/2018 8:56:46 AM,Host Communities,1500,1500,1900,1900,6800,2333,2428,3499,3642,11902
64,Yemen,2017,YEM-17/3420/1SA 2017/WASH/NGO/6137,7/19/2018 8:56:46 AM,Internally Displaced People,485,411,817,928,2641,0,0,0,0,0
64,Yemen,2017,YEM-17/3420/1SA 2017/WASH/NGO/6137,7/19/2018 8:56:46 AM,Overall,2011,2058,2767,2878,9714,2332,2428,3499,3641,11900
64,Yemen,2017,YEM-17/3420/1SA 2017/WASH-FSAC/NGO/6107,5/17/2023 6:35:00 AM,Host Communities,7,11,16,19,53,0,0,0,0,0
64,Yemen,2017,YEM-17/3420/1SA 2017/WASH-FSAC/NGO/6107,5/17/2023 6:35:00 AM,Internally Displaced People,13,15,19,22,69,0,0,0,0,0
64,Yemen,2017,YEM-17/3420/1SA 2017/WASH-FSAC/NGO/6107,5/17/2023 6:35:00 AM,Other,6864,7165,9503,10032,33564,4581,4659,5983,6352,21575
64,Yemen,2017,YEM-17/3420/1SA 2017/WASH-FSAC/NGO/6107,5/17/2023 6:35:00 AM,Overall,6884,7191,9538,10073,33686,4581,4659,5983,6352,21575
64,Yemen,2017,YEM-17/3420/1SA 2017/WASH-FSAC-Nutrition/NGO/6163,6/7/2018 8:22:02 AM,Overall,1788,2953,674,647,6062,2067,3307,827,689,6890
64,Yemen,2017,YEM-17/3420/1SA 2017/WASH-FSAC-SHNFICCM/INGO/5861,10/11/2018 8:09:16 AM,Host Communities,2818,2701,3170,3053,11742,7482,6522,8713,9047,31764
64,Yemen,2017,YEM-17/3420/1SA 2017/WASH-FSAC-SHNFICCM/INGO/5861,10/11/2018 8:09:16 AM,Internally Displaced People,2818,2701,3170,3053,11742,1968,2230,2733,2882,9813
64,Yemen,2017,YEM-17/3420/1SA 2017/WASH-FSAC-SHNFICCM/INGO/5861,10/11/2018 8:09:16 AM,Other,1410,1350,1586,1528,5874,181,224,236,224,865
64,Yemen,2017,YEM-17/3420/1SA 2017/WASH-FSAC-SHNFICCM/INGO/5861,10/11/2018 8:09:16 AM,Overall,7046,6752,7926,7634,29358,9631,8976,11682,12153,42442
64,Yemen,2017,YEM-17/3420/1SA 2017/WASH-Health-Nutrition/NGO/5999,1/9/2019 6:27:33 AM,Host Communities,31822,37293,31723,34464,135302,19453,25733,23453,24935,93574
64,Yemen,2017,YEM-17/3420/1SA 2017/WASH-Health-Nutrition/NGO/5999,1/9/2019 6:27:33 AM,Overall,31822,37293,31723,34464,135302,19453,25733,23453,24935,93574
64,Yemen,2017,YEM-17/3420/1SA 2017/WASH-Health-SHNFICCM-Protection/NGO/6172,12/11/2018 12:12:11 PM,Host Communities,4750,5250,2250,2750,15000,9429,14654,9555,12998,46636
64,Yemen,2017,YEM-17/3420/1SA 2017/WASH-Health-SHNFICCM-Protection/NGO/6172,12/11/2018 12:12:11 PM,Internally Displaced People,2639,2821,1729,1911,9100,1166,1905,4193,1607,8871
64,Yemen,2017,YEM-17/3420/1SA 2017/WASH-Health-SHNFICCM-Protection/NGO/6172,12/11/2018 12:12:11 PM,Overall,7477,8159,4065,4749,24450,10595,16559,13748,14605,55507
64,Yemen,2017,YEM-17/3420/1SA 2017/WASH-Protection/UN/5995,1/14/2019 6:10:37 AM,Host Communities,119858,115405,53877,52027,341167,30067,36295,66891,77563,210816
64,Yemen,2017,YEM-17/3420/1SA 2017/WASH-Protection/UN/5995,1/14/2019 6:10:37 AM,Internally Displaced People,29965,28851,13469,13007,85292,5741,6393,19449,20760,52343
64,Yemen,2017,YEM-17/3420/1SA 2017/WASH-Protection/UN/5995,1/14/2019 6:10:37 AM,Overall,149823,144256,67347,65034,426460,80778,96934,58161,87241,323114
64,Yemen,2017,YEM-17/3420/2RA 2017/Health/INGO/6261,1/24/2018 8:36:42 AM,Host Communities,25675,24577,25038,24962,100252,12069,22416,0,0,34485
64,Yemen,2017,YEM-17/3420/2RA 2017/Health/INGO/6261,1/24/2018 8:36:42 AM,Internally Displaced People,13448,12682,13038,12980,52148,36209,67246,0,0,103455
64,Yemen,2017,YEM-17/3420/2RA 2017/Health/INGO/6261,1/24/2018 8:36:42 AM,Overall,39123,37259,38076,37942,152400,54583,83357,0,0,137940
64,Yemen,2017,YEM-17/3420/2RA 2017/Health/NGO/6276,2/18/2018 7:57:44 AM,Host Communities,6000,6000,7200,7026,26226,9832,19327,14773,17675,61607
64,Yemen,2017,YEM-17/3420/2RA 2017/Health/NGO/6276,2/18/2018 7:57:44 AM,Overall,6000,6000,7200,7026,26226,9832,19127,14673,17475,61107
64,Yemen,2017,YEM-17/3420/2RA 2017/Health-WASH/INGO/6258,2/7/2018 8:49:55 AM,Host Communities,12672,13068,6732,7128,39600,1477,1850,4208,3167,10702
64,Yemen,2017,YEM-17/3420/2RA 2017/Health-WASH/INGO/6258,2/7/2018 8:49:55 AM,Internally Displaced People,128,132,68,72,400,2,0,0,0,2
64,Yemen,2017,YEM-17/3420/2RA 2017/Health-WASH/INGO/6258,2/7/2018 8:49:55 AM,Overall,12800,13200,6800,7200,40000,1479,1850,4208,3167,10704
64,Yemen,2017,YEM-17/3420/2RA 2017/Health-WASH/INGO/6264,1/11/2018 10:06:37 AM,Host Communities,7105,7350,4900,5145,24500,5609,5740,4239,4230,19818
64,Yemen,2017,YEM-17/3420/2RA 2017/Health-WASH/INGO/6264,1/11/2018 10:06:37 AM,Internally Displaced People,3045,3150,2100,2205,10500,2069,2127,1521,1542,7259
64,Yemen,2017,YEM-17/3420/2RA 2017/Health-WASH/INGO/6264,1/11/2018 10:06:37 AM,Overall,10150,10500,7000,7350,35000,7308,7698,6082,5989,27077
64,Yemen,2017,YEM-17/3420/2RA 2017/Health-WASH/INGO/6277,1/29/2018 11:40:30 AM,Host Communities,6643,6914,13286,13828,40671,9108,10210,12998,12662,44978
64,Yemen,2017,YEM-17/3420/2RA 2017/Health-WASH/INGO/6277,1/29/2018 11:40:30 AM,Internally Displaced People,1360,1416,2721,2832,8329,3890,3667,2510,2430,12497
64,Yemen,2017,YEM-17/3420/2RA 2017/Health-WASH/INGO/6277,1/29/2018 11:40:30 AM,Overall,8003,8330,16007,16660,49000,12998,13877,15508,15092,57475
64,Yemen,2017,YEM-17/3420/2RA 2017/Health-WASH/INGO/6280,2/7/2018 2:30:00 PM,Host Communities,13993,13662,14318,13388,55361,9718,8134,9267,7322,34441
64,Yemen,2017,YEM-17/3420/2RA 2017/Health-WASH/INGO/6280,2/7/2018 2:30:00 PM,Internally Displaced People,1554,1518,1590,1487,6149,1079,903,1029,813,3824
64,Yemen,2017,YEM-17/3420/2RA 2017/Health-WASH/INGO/6280,2/7/2018 2:30:00 PM,Overall,15547,15180,15908,14875,61510,10797,9037,10296,8135,38265
64,Yemen,2017,YEM-17/3420/2RA 2017/Health-WASH/NGO/6262,1/9/2018 9:08:43 AM,Overall,45208,47053,9259,9637,111157,45386,39358,35602,29227,149573
64,Yemen,2017,YEM-17/3420/2RA 2017/Health-WASH/NGO/6265,1/11/2018 8:54:04 AM,Host Communities,12744,13961,15409,15891,58005,19026,36758,22143,23164,101091
64,Yemen,2017,YEM-17/3420/2RA 2017/Health-WASH/NGO/6265,1/11/2018 8:54:04 AM,Internally Displaced People,2489,2540,2356,2578,9963,981,1150,1023,1055,4209
64,Yemen,2017,YEM-17/3420/2RA 2017/Health-WASH/NGO/6265,1/11/2018 8:54:04 AM,Overall,15233,30462,17765,18469,81929,20007,37908,23166,24219,105300
64,Yemen,2017,YEM-17/3420/2RA 2017/Health-WASH/NGO/6267,3/27/2018 8:53:29 AM,Host Communities,11178,11981,27398,28164,78721,28432,24462,25862,22847,101603
64,Yemen,2017,YEM-17/3420/2RA 2017/Health-WASH/NGO/6267,3/27/2018 8:53:29 AM,Internally Displaced People,1397,1498,3425,3521,9841,813,750,735,645,2943
64,Yemen,2017,YEM-17/3420/2RA 2017/Health-WASH/NGO/6267,3/27/2018 8:53:29 AM,Other,1397,1497,3424,3520,9838,5960,6346,8238,7351,27895
64,Yemen,2017,YEM-17/3420/2RA 2017/Health-WASH/NGO/6267,3/27/2018 8:53:29 AM,Overall,13972,14976,34247,35205,98400,35205,31558,34835,30843,132441
64,Yemen,2017,YEM-17/3420/2RA 2017/Health-WASH/NGO/6271,11/23/2017 12:30:57 PM,Host Communities,8208,8892,8311,8789,34200,0,0,0,0,0
64,Yemen,2017,YEM-17/3420/2RA 2017/Health-WASH/NGO/6271,11/23/2017 12:30:57 PM,Overall,8208,8892,8311,8789,34200,12750,14250,13800,15200,56000
64,Yemen,2017,YEM-17/3420/2RA 2017/WASH/INGO/6268,1/21/2018 11:09:20 AM,Host Communities,12600,15400,18900,23100,70000,18877,20002,22639,21407,82925
64,Yemen,2017,YEM-17/3420/2RA 2017/WASH/INGO/6268,1/21/2018 11:09:20 AM,Overall,12600,15400,18900,23100,70000,18877,20002,22639,21407,82925
64,Yemen,2017,YEM-17/3420/2RA 2017/WASH/INGO/6272,1/17/2018 8:38:13 AM,Host Communities,55087,52927,67328,64688,240030,39580,38027,48375,46478,172460
64,Yemen,2017,YEM-17/3420/2RA 2017/WASH/INGO/6272,1/17/2018 8:38:13 AM,Overall,55087,52927,67328,64688,240030,39580,38027,48375,46478,172460
64,Yemen,2017,YEM-17/3420/2RA 2017/WASH/INGO/6279,4/16/2018 12:14:40 PM,Host Communities,3969,3902,2862,2768,13501,13108,12854,13068,12486,51516
64,Yemen,2017,YEM-17/3420/2RA 2017/WASH/INGO/6279,4/16/2018 12:14:40 PM,Internally Displaced People,9261,9103,6678,6457,31499,5144,4933,4661,4599,19337
64,Yemen,2017,YEM-17/3420/2RA 2017/WASH/INGO/6279,4/16/2018 12:14:40 PM,Overall,13230,13005,9540,9225,45000,18384,18007,17485,16976,70852
64,Yemen,2017,YEM-17/3420/2RA 2017/WASH/INGO/6282,11/15/2017 1:00:06 PM,Host Communities,5073,4851,6174,5953,22051,9944,10341,9177,9548,39010
64,Yemen,2017,YEM-17/3420/2RA 2017/WASH/INGO/6282,11/15/2017 1:00:06 PM,Internally Displaced People,2172,2079,2646,2552,9449,177,184,163,170,694
64,Yemen,2017,YEM-17/3420/2RA 2017/WASH/INGO/6282,11/15/2017 1:00:06 PM,Overall,7245,6930,8820,8505,31500,10121,10525,9340,9718,39704
64,Yemen,2017,YEM-17/3420/2RA 2017/WASH/NGO/6263,12/14/2022 1:24:36 PM,Overall,8232,8568,12348,12852,42000,19398,19087,23692,24801,86978
64,Yemen,2017,YEM-17/3420/2RA 2017/WASH/NGO/6269,2/20/2018 12:18:49 PM,Overall,25444,30369,12312,13955,82080,22369,30129,11378,16913,80789
64,Yemen,2017,YEM-17/3420/2RA 2017/WASH/NGO/6270,1/14/2018 8:08:11 AM,Overall,8528,8431,25601,25306,67866,15554,15760,19398,19917,70629
64,Yemen,2017,YEM-17/3420/2RA 2017/WASH/UN/6275,2/20/2018 10:45:32 AM,Overall,105672,101528,37128,35672,280000,105672,101528,37128,39172,283500
64,Yemen,2017,YEM-17/3420/2SA 2017/FSAC/INGO/7158,4/26/2019 11:38:50 AM,Other,2205,2205,2744,2646,9800,0,0,0,0,0
64,Yemen,2017,YEM-17/3420/2SA 2017/FSAC/INGO/7158,4/26/2019 11:38:50 AM,Overall,2205,2205,2744,2646,9800,2205,2205,2744,2646,9800
64,Yemen,2017,YEM-17/3420/2SA 2017/FSAC/NGO/6979,11/26/2018 5:59:29 AM,Overall,8541,8889,1749,1821,21000,3938,4107,3526,3142,14713
64,Yemen,2017,YEM-17/3420/2SA 2017/FSAC/NGO/7018,3/27/2019 8:56:40 PM,Host Communities,1834,2106,1950,1824,7714,1583,1816,1572,1681,6652
64,Yemen,2017,YEM-17/3420/2SA 2017/FSAC/NGO/7018,3/27/2019 8:56:40 PM,Internally Displaced People,2330,2676,2316,2478,9800,3504,4034,3471,3688,14697
64,Yemen,2017,YEM-17/3420/2SA 2017/FSAC/NGO/7018,3/27/2019 8:56:40 PM,Other,3325,3819,3180,3662,13986,0,0,0,0,0
64,Yemen,2017,YEM-17/3420/2SA 2017/FSAC/NGO/7018,3/27/2019 8:56:40 PM,Overall,7489,8601,7446,7964,31500,8722,10026,8652,9231,36631
64,Yemen,2017,YEM-17/3420/2SA 2017/FSAC/NGO/7061,6/16/2019 7:19:18 AM,Host Communities,4610,4798,6915,7197,23520,6257,6889,12083,11176,36405
64,Yemen,2017,YEM-17/3420/2SA 2017/FSAC/NGO/7061,6/16/2019 7:19:18 AM,Other,1152,1200,1729,1799,5880,0,0,0,0,0
64,Yemen,2017,YEM-17/3420/2SA 2017/FSAC/NGO/7061,6/16/2019 7:19:18 AM,Overall,5762,5998,8644,8996,29400,6257,6889,12083,11176,36405
64,Yemen,2017,YEM-17/3420/2SA 2017/FSAC/NGO/7121,2/19/2019 6:52:29 AM,Overall,5355,5145,5355,5145,21000,6048,5629,5286,5002,21965
64,Yemen,2017,YEM-17/3420/2SA 2017/FSAC/UN/7002,9/8/2021 3:00:31 PM,Other,3650,3080,3990,3280,14000,5293,4466,4785,5756,20300
64,Yemen,2017,YEM-17/3420/2SA 2017/FSAC/UN/7002,9/8/2021 3:00:31 PM,Overall,3650,3080,3990,3280,14000,5293,4466,4785,5756,20300
64,Yemen,2017,YEM-17/3420/2SA 2017/FSAC-Health/NGO/7044,12/11/2018 1:09:17 PM,Host Communities,5721,11755,5850,5983,29309,8882,19498,10629,10181,49190
64,Yemen,2017,YEM-17/3420/2SA 2017/FSAC-Health/NGO/7044,12/11/2018 1:09:17 PM,Internally Displaced People,385,665,350,350,1750,52,105,69,65,291
64,Yemen,2017,YEM-17/3420/2SA 2017/FSAC-Health/NGO/7044,12/11/2018 1:09:17 PM,Overall,6106,12420,6200,6333,31059,8934,19603,10246,10698,49481
64,Yemen,2017,YEM-17/3420/2SA 2017/FSAC-Health/NGO/7118,9/23/2018 4:48:28 PM,Host Communities,5147,8830,3327,3711,21015,0,0,0,0,0
64,Yemen,2017,YEM-17/3420/2SA 2017/FSAC-Health/NGO/7118,9/23/2018 4:48:28 PM,Internally Displaced People,710,730,510,530,2480,0,0,0,0,0
64,Yemen,2017,YEM-17/3420/2SA 2017/FSAC-Health/NGO/7118,9/23/2018 4:48:28 PM,Other,233,423,153,169,978,0,0,0,0,0
64,Yemen,2017,YEM-17/3420/2SA 2017/FSAC-Health/NGO/7118,9/23/2018 4:48:28 PM,Overall,6090,9983,3990,4410,24473,8215,11801,6983,6289,33288
64,Yemen,2017,YEM-17/3420/2SA 2017/FSAC-Health-Nutrition/INGO/7017,5/30/2019 9:54:42 AM,Host Communities,6771,8983,7209,6927,29890,1869,14537,6457,6239,29102
64,Yemen,2017,YEM-17/3420/2SA 2017/FSAC-Health-Nutrition/INGO/7017,5/30/2019 9:54:42 AM,Overall,6771,8983,7209,6927,29890,1869,14537,6457,6237,29100
64,Yemen,2017,YEM-17/3420/2SA 2017/FSAC-Protection/NGO/7035,5/7/2019 11:16:18 AM,Host Communities,1982,2073,2433,2521,9009,6523,12232,9281,9456,37492
64,Yemen,2017,YEM-17/3420/2SA 2017/FSAC-Protection/NGO/7035,5/7/2019 11:16:18 AM,Internally Displaced People,3964,4145,4866,5045,18020,3056,5060,3487,3652,15255
64,Yemen,2017,YEM-17/3420/2SA 2017/FSAC-Protection/NGO/7035,5/7/2019 11:16:18 AM,Other,3964,4145,4866,5045,18020,6,38,9,9,62
64,Yemen,2017,YEM-17/3420/2SA 2017/FSAC-Protection/NGO/7035,5/7/2019 11:16:18 AM,Overall,9911,10363,12165,12611,45050,9585,17330,12777,13117,52809
64,Yemen,2017,YEM-17/3420/2SA 2017/FSAC-WASH/INGO/7105,3/11/2019 7:00:30 AM,Host Communities,3960,3740,7260,7040,22000,3258,3738,5674,4980,17650
64,Yemen,2017,YEM-17/3420/2SA 2017/FSAC-WASH/INGO/7105,3/11/2019 7:00:30 AM,Internally Displaced People,360,340,660,640,2000,294,340,327,333,1294
64,Yemen,2017,YEM-17/3420/2SA 2017/FSAC-WASH/INGO/7105,3/11/2019 7:00:30 AM,Overall,4320,4080,7920,7680,24000,3552,4078,6001,5313,18944
64,Yemen,2017,YEM-17/3420/2SA 2017/FSAC-WASH/NGO/6975,3/10/2019 9:09:23 AM,Overall,16635,19070,17769,17926,71400,13159,15111,19466,19153,66889
64,Yemen,2017,YEM-17/3420/2SA 2017/FSAC-WASH/NGO/7014,5/21/2019 12:33:15 PM,Overall,5600,19600,1400,1400,28000,5923,6239,6182,6750,25094
64,Yemen,2017,YEM-17/3420/2SA 2017/FSAC-WASH-Health/NGO/6990,2/13/2019 7:34:28 AM,Host Communities,7013,7299,10519,10958,35789,10858,12396,15480,15138,53872
64,Yemen,2017,YEM-17/3420/2SA 2017/FSAC-WASH-Health/NGO/6990,2/13/2019 7:34:28 AM,Overall,7013,7299,10519,10958,35789,10858,12396,15480,15138,53872
64,Yemen,2017,YEM-17/3420/2SA 2017/FSAC-WASH-SHNFICCM-Protection/INGO/6970,4/30/2019 1:07:53 PM,Host Communities,2843,3474,4264,5212,15793,7375,8717,10153,11934,38179
64,Yemen,2017,YEM-17/3420/2SA 2017/FSAC-WASH-SHNFICCM-Protection/INGO/6970,4/30/2019 1:07:53 PM,Internally Displaced People,2843,3474,4264,5212,15793,1271,1468,2121,2251,7111
64,Yemen,2017,YEM-17/3420/2SA 2017/FSAC-WASH-SHNFICCM-Protection/INGO/6970,4/30/2019 1:07:53 PM,Other,631,773,948,1157,3509,0,0,0,0,0
64,Yemen,2017,YEM-17/3420/2SA 2017/FSAC-WASH-SHNFICCM-Protection/INGO/6970,4/30/2019 1:07:53 PM,Overall,6317,7721,9476,11581,35095,8646,10185,12274,14185,45290
64,Yemen,2017,YEM-17/3420/2SA 2017/Health/NGO/7079,11/10/2018 9:40:18 AM,Host Communities,10000,20000,10000,10000,50000,21603,38126,23196,24653,107578
64,Yemen,2017,YEM-17/3420/2SA 2017/Health/NGO/7079,11/10/2018 9:40:18 AM,Overall,10000,20000,10000,10000,50000,21603,38126,23196,24653,107578
64,Yemen,2017,YEM-17/3420/2SA 2017/Health/NGO/7150,10/29/2018 12:47:32 PM,Host Communities,1650,1100,1127,1622,5499,16236,18544,10467,10228,55475
64,Yemen,2017,YEM-17/3420/2SA 2017/Health/NGO/7150,10/29/2018 12:47:32 PM,Internally Displaced People,1350,900,923,1328,4501,2858,3076,2212,2243,10389
64,Yemen,2017,YEM-17/3420/2SA 2017/Health/NGO/7150,10/29/2018 12:47:32 PM,Overall,3000,2000,2050,2950,10000,19094,21620,12679,12471,65864
64,Yemen,2017,YEM-17/3420/2SA 2017/Health-Nutrition/NGO/6998,2/14/2019 9:16:41 AM,Host Communities,0,0,0,0,0,19411,58383,23785,21732,123311
64,Yemen,2017,YEM-17/3420/2SA 2017/Health-Nutrition/NGO/6998,2/14/2019 9:16:41 AM,Overall,16098,52146,6369,6629,81242,19411,58383,23785,21732,123311
64,Yemen,2017,YEM-17/3420/2SA 2017/Health-Nutrition-FSAC/INGO/7160,2/14/2019 10:36:51 AM,Overall,15420,22378,12728,12228,62754,0,0,0,0,0
64,Yemen,2017,YEM-17/3420/2SA 2017/Health-WASH/NGO/7024,8/28/2018 7:09:19 AM,Host Communities,35886,37351,14036,14610,101883,25506,32984,58148,53890,170528
64,Yemen,2017,YEM-17/3420/2SA 2017/Health-WASH/NGO/7024,8/28/2018 7:09:19 AM,Internally Displaced People,3987,4150,1559,1623,11319,584,317,1500,1401,3802
64,Yemen,2017,YEM-17/3420/2SA 2017/Health-WASH/NGO/7024,8/28/2018 7:09:19 AM,Overall,39873,41501,15595,16233,113202,26090,33301,59648,55291,174330
64,Yemen,2017,YEM-17/3420/2SA 2017/Health-WASH/NGO/7080,9/12/2018 11:24:28 AM,Internally Displaced People,1300,2502,3600,6040,13442,2661,3458,3009,3212,12340
64,Yemen,2017,YEM-17/3420/2SA 2017/Health-WASH/NGO/7080,9/12/2018 11:24:28 AM,Overall,12387,12502,13659,20040,58588,12753,15846,19016,19884,67499
64,Yemen,2017,YEM-17/3420/2SA 2017/Health-WASH/NGO/7130,10/28/2018 8:06:24 AM,Host Communities,0,0,0,0,0,14383,17029,13820,12110,57342
64,Yemen,2017,YEM-17/3420/2SA 2017/Health-WASH/NGO/7130,10/28/2018 8:06:24 AM,Overall,12230,11290,18346,16934,58800,14383,17029,13820,12110,57342
64,Yemen,2017,YEM-17/3420/2SA 2017/Health-WASH-Nutrition/NGO/7067,5/26/2019 7:50:15 AM,Host Communities,0,0,0,0,0,9847,9587,8173,9591,37198
64,Yemen,2017,YEM-17/3420/2SA 2017/Health-WASH-Nutrition/NGO/7067,5/26/2019 7:50:15 AM,Overall,12463,20250,16053,15760,64526,13271,21261,14121,13239,61892
64,Yemen,2017,YEM-17/3420/2SA 2017/Health-WASH-SHNFICCM/NGO/6969,4/29/2019 9:58:33 AM,Host Communities,1865,2735,2950,3900,11450,964,5272,1383,1443,9062
64,Yemen,2017,YEM-17/3420/2SA 2017/Health-WASH-SHNFICCM/NGO/6969,4/29/2019 9:58:33 AM,Internally Displaced People,10000,20000,8000,10000,48000,3721,21339,7347,8688,41095
64,Yemen,2017,YEM-17/3420/2SA 2017/Health-WASH-SHNFICCM/NGO/6969,4/29/2019 9:58:33 AM,Overall,11865,22735,10950,13900,59450,10836,37126,14162,21081,83205
64,Yemen,2017,YEM-17/3420/2SA 2017/Nutrition-FSAC/NGO/6947,12/16/2018 5:51:52 AM,Overall,11949,12427,2689,2808,29873,3663,6805,9271,9452,29191
64,Yemen,2017,YEM-17/3420/2SA 2017/Nutrition-Health/O/7098,5/7/2019 8:08:36 AM,Host Communities,29947,49755,50874,47116,177692,40589,274480,157844,175135,648048
64,Yemen,2017,YEM-17/3420/2SA 2017/Nutrition-Health/O/7098,5/7/2019 8:08:36 AM,Internally Displaced People,16125,26791,27394,25371,95681,11042,11490,9790,10191,42513
64,Yemen,2017,YEM-17/3420/2SA 2017/Nutrition-Health/O/7098,5/7/2019 8:08:36 AM,Overall,46072,76546,78268,72487,273373,51681,285970,167634,185326,690611
64,Yemen,2017,YEM-17/3420/2SA 2017/Nutrition-Health-FSAC/NGO/6926,3/10/2019 7:34:27 AM,Overall,9694,10089,14495,15100,49378,18956,31593,13010,14932,78491
64,Yemen,2017,YEM-17/3420/2SA 2017/Nutrition-Protection-Health/INGO/6966,3/5/2019 6:49:39 AM,Internally Displaced People,25242,26272,12433,12940,76887,27377,43073,34485,35425,140360
64,Yemen,2017,YEM-17/3420/2SA 2017/Nutrition-Protection-Health/INGO/6966,3/5/2019 6:49:39 AM,Overall,25242,26272,12433,12940,76887,14084,28507,25661,27497,95749
64,Yemen,2017,YEM-17/3420/2SA 2017/Nutrition-WASH/UN/7135,4/14/2019 6:26:08 AM,Host Communities,0,0,13005,12495,25500,0,0,11219,14281,25500
64,Yemen,2017,YEM-17/3420/2SA 2017/Nutrition-WASH/UN/7135,4/14/2019 6:26:08 AM,Internally Displaced People,0,0,2295,2205,4500,0,0,1981,2519,4500
64,Yemen,2017,YEM-17/3420/2SA 2017/Nutrition-WASH/UN/7135,4/14/2019 6:26:08 AM,Overall,0,0,15300,14700,30000,0,0,13200,17000,30200
64,Yemen,2017,YEM-17/3420/2SA 2017/Protection/INGO/7007,8/25/2019 7:15:55 AM,Host Communities,1434,3206,886,886,6412,4307,5858,1914,1658,13737
64,Yemen,2017,YEM-17/3420/2SA 2017/Protection/INGO/7007,8/25/2019 7:15:55 AM,Internally Displaced People,1793,4007,1107,1107,8014,1845,2511,821,711,5888
64,Yemen,2017,YEM-17/3420/2SA 2017/Protection/INGO/7007,8/25/2019 7:15:55 AM,Other,359,801,221,221,1602,0,0,0,0,0
64,Yemen,2017,YEM-17/3420/2SA 2017/Protection/INGO/7007,8/25/2019 7:15:55 AM,Overall,3586,8014,2214,2214,16028,6152,8370,2734,2369,19625
64,Yemen,2017,YEM-17/3420/2SA 2017/Protection/NGO/7164,2/18/2019 11:27:10 AM,Host Communities,8308,5092,5628,7772,26800,12302,11868,11838,10346,46354
64,Yemen,2017,YEM-17/3420/2SA 2017/Protection/NGO/7164,2/18/2019 11:27:10 AM,Internally Displaced People,12462,7638,8442,11658,40200,6108,5863,5548,5350,22869
64,Yemen,2017,YEM-17/3420/2SA 2017/Protection/NGO/7164,2/18/2019 11:27:10 AM,Overall,20770,12730,14070,19430,67000,18419,17752,17386,15696,69253
64,Yemen,2017,YEM-17/3420/2SA 2017/Protection/NGO/7168,10/10/2019 12:49:32 PM,Host Communities,924,1338,1082,1119,4463,2074,2364,1580,1445,7463
64,Yemen,2017,YEM-17/3420/2SA 2017/Protection/NGO/7168,10/10/2019 12:49:32 PM,Internally Displaced People,1078,1561,1262,1306,5207,704,861,1157,1187,3909
64,Yemen,2017,YEM-17/3420/2SA 2017/Protection/NGO/7168,10/10/2019 12:49:32 PM,Other,1077,1561,1261,1305,5204,927,1635,2000,2249,6811
64,Yemen,2017,YEM-17/3420/2SA 2017/Protection/NGO/7168,10/10/2019 12:49:32 PM,Overall,3079,4460,3605,3730,14874,3705,4860,4737,4881,18183
64,Yemen,2017,YEM-17/3420/2SA 2017/Protection/NGO/7169,11/13/2018 9:25:50 AM,Host Communities,325,213,213,369,1120,348,448,344,292,1432
64,Yemen,2017,YEM-17/3420/2SA 2017/Protection/NGO/7169,11/13/2018 9:25:50 AM,Internally Displaced People,1624,1064,1064,1848,5600,1501,1755,1391,1348,5995
64,Yemen,2017,YEM-17/3420/2SA 2017/Protection/NGO/7169,11/13/2018 9:25:50 AM,Overall,1949,1277,1277,2217,6720,1849,2203,1735,1640,7427
64,Yemen,2017,YEM-17/3420/2SA 2017/Protection-FSAC-SHNFICCM/UN/7152,5/26/2019 6:06:55 PM,Overall,3950,3542,2997,3133,13622,1820,2045,4483,4301,12649
64,Yemen,2017,YEM-17/3420/2SA 2017/Protection-SHNFICCM/NGO/7015,2/15/2019 11:32:23 AM,Host Communities,2343,1278,1348,2130,7099,1538,1609,2056,1895,7098
64,Yemen,2017,YEM-17/3420/2SA 2017/Protection-SHNFICCM/NGO/7015,2/15/2019 11:32:23 AM,Internally Displaced People,11713,6389,6744,10648,35494,8719,9119,11649,10732,40219
64,Yemen,2017,YEM-17/3420/2SA 2017/Protection-SHNFICCM/NGO/7015,2/15/2019 11:32:23 AM,Overall,14056,7667,8092,12778,42593,10257,10728,13705,12626,47316
64,Yemen,2017,YEM-17/3420/2SA 2017/Protection-SHNFICCM/UN/7009,1/22/2019 6:51:50 AM,Internally Displaced People,10500,15750,10500,15750,52500,10500,15750,10500,15750,52500
64,Yemen,2017,YEM-17/3420/2SA 2017/Protection-SHNFICCM/UN/7009,1/22/2019 6:51:50 AM,Overall,10500,15750,10500,15750,52500,10500,15750,10500,15750,52500
64,Yemen,2017,YEM-17/3420/2SA 2017/SHNFICCM/NGO/7161,11/26/2018 5:46:25 AM,Host Communities,303,200,190,357,1050,183,227,227,186,823
64,Yemen,2017,YEM-17/3420/2SA 2017/SHNFICCM/NGO/7161,11/26/2018 5:46:25 AM,Internally Displaced People,1218,797,756,1429,4200,863,960,1175,1059,4057
64,Yemen,2017,YEM-17/3420/2SA 2017/SHNFICCM/NGO/7161,11/26/2018 5:46:25 AM,Overall,1521,997,946,1786,5250,1046,1187,1402,1245,4880
64,Yemen,2017,YEM-17/3420/2SA 2017/SHNFICCM-Protection-WASH/NGO/7023,5/21/2019 12:31:07 PM,Host Communities,2726,2586,1501,1605,8418,0,0,0,0,0
64,Yemen,2017,YEM-17/3420/2SA 2017/SHNFICCM-Protection-WASH/NGO/7023,5/21/2019 12:31:07 PM,Internally Displaced People,4957,4701,2729,2918,15305,0,0,0,0,0
64,Yemen,2017,YEM-17/3420/2SA 2017/SHNFICCM-Protection-WASH/NGO/7023,5/21/2019 12:31:07 PM,Overall,7683,7287,4230,4523,23723,5459,6477,7499,8186,27621
64,Yemen,2017,YEM-17/3420/2SA 2017/SHNFICCM-WASH/NGO/7042,12/3/2018 12:00:37 PM,Overall,4446,5291,9171,9465,28373,4429,5229,9372,9659,28689
64,Yemen,2017,YEM-17/3420/2SA 2017/SHNFICCM-WASH/NGO/7043,1/9/2019 12:17:08 PM,Host Communities,140,146,164,190,640,858,881,542,651,2932
64,Yemen,2017,YEM-17/3420/2SA 2017/SHNFICCM-WASH/NGO/7043,1/9/2019 12:17:08 PM,Internally Displaced People,326,339,383,441,1489,151,156,96,115,518
64,Yemen,2017,YEM-17/3420/2SA 2017/SHNFICCM-WASH/NGO/7043,1/9/2019 12:17:08 PM,Overall,466,485,547,631,2129,1284,1061,798,687,3830
64,Yemen,2017,YEM-17/3420/2SA 2017/WASH/INGO/6974,1/20/2019 9:01:44 AM,Host Communities,3500,4300,7000,7000,21800,11449,11929,13723,13026,50127
64,Yemen,2017,YEM-17/3420/2SA 2017/WASH/INGO/6974,1/20/2019 9:01:44 AM,Internally Displaced People,500,700,500,500,2200,1708,1942,1036,979,5665
64,Yemen,2017,YEM-17/3420/2SA 2017/WASH/INGO/6974,1/20/2019 9:01:44 AM,Overall,4000,5000,7500,7500,24000,4754,4585,5169,4959,19467
64,Yemen,2017,YEM-17/3420/2SA 2017/WASH/NGO/6934,1/21/2019 7:16:13 AM,Host Communities,6005,5830,7680,7988,27503,6005,5830,7680,7988,27503
64,Yemen,2017,YEM-17/3420/2SA 2017/WASH/NGO/6934,1/21/2019 7:16:13 AM,Overall,6005,5830,7680,7988,27503,6005,5830,7680,7988,27503
64,Yemen,2017,YEM-17/3420/2SA 2017/WASH/NGO/7076,4/29/2019 9:30:11 AM,Host Communities,0,0,0,0,0,19377,20475,7024,7040,53916
64,Yemen,2017,YEM-17/3420/2SA 2017/WASH/NGO/7076,4/29/2019 9:30:11 AM,Other,62,62,0,0,124,487,460,132,174,1253
64,Yemen,2017,YEM-17/3420/2SA 2017/WASH/NGO/7076,4/29/2019 9:30:11 AM,Overall,17600,17600,6400,6400,48000,19864,20935,7156,7214,55169
64,Yemen,2017,YEM-17/3420/2SA 2017/WASH-FSAC/INGO/6983,9/12/2019 12:34:33 PM,Host Communities,13839,13180,19770,19111,65900,13035,12523,17999,17294,60851
64,Yemen,2017,YEM-17/3420/2SA 2017/WASH-FSAC/INGO/6983,9/12/2019 12:34:33 PM,Internally Displaced People,10873,10350,15533,15015,51771,3476,3338,4801,4611,16226
64,Yemen,2017,YEM-17/3420/2SA 2017/WASH-FSAC/INGO/6983,9/12/2019 12:34:33 PM,Overall,24712,23536,35303,34126,117677,18325,17606,24831,24788,85550
64,Yemen,2017,YEM-17/3420/2SA 2017/WASH-FSAC/INGO/7103,3/7/2019 7:09:40 AM,Host Communities,4232,4166,4698,4544,17640,6044,6320,7821,7506,27691
64,Yemen,2017,YEM-17/3420/2SA 2017/WASH-FSAC/INGO/7103,3/7/2019 7:09:40 AM,Internally Displaced People,1588,1663,2268,2041,7560,0,0,0,0,0
64,Yemen,2017,YEM-17/3420/2SA 2017/WASH-FSAC/INGO/7103,3/7/2019 7:09:40 AM,Overall,5820,5829,6966,6585,25200,6044,6320,7821,7506,27691
64,Yemen,2017,YEM-17/3420/2SA 2017/WASH-FSAC/NGO/6981,3/6/2019 12:42:13 PM,Other,4650,4536,4623,4191,18000,0,0,0,0,0
64,Yemen,2017,YEM-17/3420/2SA 2017/WASH-FSAC/NGO/6981,3/6/2019 12:42:13 PM,Overall,4650,4536,4623,4191,18000,7168,8602,12443,11598,39811
64,Yemen,2017,YEM-17/3420/2SA 2017/WASH-FSAC-Health-Nutrition/INGO/7008,10/15/2019 6:49:51 AM,Host Communities,10454,10185,16877,16073,53589,16783,16053,26885,25443,85164
64,Yemen,2017,YEM-17/3420/2SA 2017/WASH-FSAC-Health-Nutrition/INGO/7008,10/15/2019 6:49:51 AM,Internally Displaced People,1161,1132,1875,1786,5954,1914,1842,3075,2937,9768
64,Yemen,2017,YEM-17/3420/2SA 2017/WASH-FSAC-Health-Nutrition/INGO/7008,10/15/2019 6:49:51 AM,Overall,11615,11317,18752,17859,59543,18148,18443,29961,28412,94964
64,Yemen,2017,YEM-17/3420/2SA 2017/WASH-Protection/NGO/7088,5/8/2019 7:09:51 AM,Host Communities,2141,2240,2163,2206,8750,1836,1965,1868,2031,7700
64,Yemen,2017,YEM-17/3420/2SA 2017/WASH-Protection/NGO/7088,5/8/2019 7:09:51 AM,Internally Displaced People,320,335,312,314,1281,556,595,565,615,2331
64,Yemen,2017,YEM-17/3420/2SA 2017/WASH-Protection/NGO/7088,5/8/2019 7:09:51 AM,Overall,2461,2575,2475,2520,10031,2392,2560,2433,2646,10031
64,Yemen,2017,YEM-17/3420/3RA 2017/Logistics/UN/6303,1/7/2018 1:23:16 PM,Overall,1210,623,0,0,1833,1732,892,0,0,2624
64,Yemen,2017,YEM-17/3420/3RA 2017/SHNFICCM/UN/6308,8/12/2018 10:35:22 AM,Internally Displaced People,2100,3150,2100,3150,10500,1431,2800,1700,2800,8731
64,Yemen,2017,YEM-17/3420/3RA 2017/SHNFICCM/UN/6308,8/12/2018 10:35:22 AM,Overall,2100,3150,2100,3150,10500,1431,2800,1700,2800,8731
64,Yemen,2017,YEM-17/3420/RA1 2017/Health-WASH/INGO/4526,1/14/2018 1:13:33 PM,Host Communities,2723,2555,4240,3967,13485,2567,3520,3985,3520,13592
64,Yemen,2017,YEM-17/3420/RA1 2017/Health-WASH/INGO/4526,1/14/2018 1:13:33 PM,Internally Displaced People,545,535,870,814,2764,526,721,816,721,2784
64,Yemen,2017,YEM-17/3420/RA1 2017/Health-WASH/INGO/4526,1/14/2018 1:13:33 PM,Overall,3268,3090,5110,4782,16250,3093,4241,4801,4241,16376
64,Yemen,2017,YEM-17/3420/RA1 2017/Health-WASH/NGO/4537,11/21/2017 11:58:03 AM,Host Communities,4059,4349,10147,10437,28992,12576,12782,16939,17701,59998
64,Yemen,2017,YEM-17/3420/RA1 2017/Health-WASH/NGO/4537,11/21/2017 11:58:03 AM,Internally Displaced People,1268,1358,3172,3260,9058,936,1360,1669,1180,5145
64,Yemen,2017,YEM-17/3420/RA1 2017/Health-WASH/NGO/4537,11/21/2017 11:58:03 AM,Other,186,202,194,194,776,0,0,0,0,0
64,Yemen,2017,YEM-17/3420/RA1 2017/Health-WASH/NGO/4537,11/21/2017 11:58:03 AM,Overall,5513,5909,13513,13891,38826,13512,14142,18608,18881,65143
64,Yemen,2017,YEM-17/3420/RA1 2017/WASH/INGO/4530,9/18/2017 8:07:12 AM,Host Communities,7245,6930,8820,8505,31500,10761,10973,9823,10252,41809
64,Yemen,2017,YEM-17/3420/RA1 2017/WASH/INGO/4530,9/18/2017 8:07:12 AM,Internally Displaced People,2415,2310,2940,2835,10500,178,166,59,26,429
64,Yemen,2017,YEM-17/3420/RA1 2017/WASH/INGO/4530,9/18/2017 8:07:12 AM,Overall,9660,9240,11760,11340,42000,10939,11139,9882,10278,42238
64,Yemen,2017,YEM-17/3420/RA1 2017/WASH/INGO/4533,10/16/2017 11:13:34 AM,Host Communities,72905,72790,76350,70611,292656,74803,74756,77717,71739,299015
64,Yemen,2017,YEM-17/3420/RA1 2017/WASH/INGO/4533,10/16/2017 11:13:34 AM,Overall,72905,72790,76350,70611,292656,74803,74756,77717,71739,299015
64,Yemen,2017,YEM-17/3420/RA1 2017/WASH/UN/4522,3/8/2018 7:33:42 AM,Overall,52836,50764,18564,17836,140000,52836,50764,18564,17836,140000
64,Yemen,2017,YEM-17/3420/RA1 2017/WASH-Health/NGO/4521,10/26/2017 11:06:30 AM,Host Communities,22866,22913,5701,5495,56975,18062,19407,22607,21796,81872
64,Yemen,2017,YEM-17/3420/RA1 2017/WASH-Health/NGO/4521,10/26/2017 11:06:30 AM,Internally Displaced People,953,955,237,230,2375,593,636,729,696,2654
64,Yemen,2017,YEM-17/3420/RA1 2017/WASH-Health/NGO/4521,10/26/2017 11:06:30 AM,Overall,23819,23868,5939,5725,59351,18655,20043,23336,22492,84526
64,Yemen,2018,YEM-18/3420/RA1-2018/Education/INGO/9529,6/19/2019 8:19:13 AM,Host Communities,0,0,5581,5581,11162,0,0,0,0,0
64,Yemen,2018,YEM-18/3420/RA1-2018/Education/INGO/9529,6/19/2019 8:19:13 AM,Internally Displaced People,0,0,13025,13026,26051,0,0,18606,18607,37213
64,Yemen,2018,YEM-18/3420/RA1-2018/Education/INGO/9529,6/19/2019 8:19:13 AM,Overall,0,0,18606,18607,37213,0,0,18606,18607,37213
64,Yemen,2018,YEM-18/3420/RA1-2018/ETC/UN/9517,9/15/2019 4:51:15 PM,Overall,0,0,0,32,32,0,0,0,39,39
64,Yemen,2018,YEM-18/3420/RA1-2018/FSAC/UN/9514,9/25/2019 1:24:41 PM,Internally Displaced People,253000,264000,286000,297000,1100000,465763,448512,414011,396761,1725047
64,Yemen,2018,YEM-18/3420/RA1-2018/FSAC/UN/9514,9/25/2019 1:24:41 PM,Overall,253000,264000,286000,297000,1100000,465763,448512,414011,396761,1725047
64,Yemen,2018,YEM-18/3420/RA1-2018/FSAC/UN/9557,5/26/2019 3:12:24 PM,Host Communities,52678,60782,141826,149930,405216,57873,66777,155813,164716,445179
64,Yemen,2018,YEM-18/3420/RA1-2018/FSAC/UN/9557,5/26/2019 3:12:24 PM,Internally Displaced People,549,633,1477,1562,4221,0,0,0,0,0
64,Yemen,2018,YEM-18/3420/RA1-2018/FSAC/UN/9557,5/26/2019 3:12:24 PM,Other,1646,1900,4432,4685,12663,0,0,0,0,0
64,Yemen,2018,YEM-18/3420/RA1-2018/FSAC/UN/9557,5/26/2019 3:12:24 PM,Overall,54873,63315,147735,156177,422100,57873,66777,155813,164716,445179
64,Yemen,2018,YEM-18/3420/RA1-2018/Health/NGO/9527,3/28/2019 8:42:16 AM,Overall,24864,26936,23828,27972,103600,24864,26936,23828,27972,103600
64,Yemen,2018,YEM-18/3420/RA1-2018/Health/NGO/9554,5/21/2019 7:27:52 AM,Host Communities,3000,4000,2000,6000,15000,4897,10320,2854,3149,21220
64,Yemen,2018,YEM-18/3420/RA1-2018/Health/NGO/9554,5/21/2019 7:27:52 AM,Internally Displaced People,645,1467,733,378,3223,862,1821,503,560,3746
64,Yemen,2018,YEM-18/3420/RA1-2018/Health/NGO/9554,5/21/2019 7:27:52 AM,Overall,3645,5467,2733,6378,18223,6035,12809,3527,3908,26279
64,Yemen,2018,YEM-18/3420/RA1-2018/Health/NGO/9556,3/10/2019 12:18:25 PM,Host Communities,570,685,875,1000,3130,3195,3262,3385,3056,12898
64,Yemen,2018,YEM-18/3420/RA1-2018/Health/NGO/9556,3/10/2019 12:18:25 PM,Overall,570,685,875,1000,3130,3195,3262,3385,3056,12898
64,Yemen,2018,YEM-18/3420/RA1-2018/Health/NGO/9561,3/7/2019 10:32:21 AM,Host Communities,8858,11389,10546,11389,42182,0,0,0,0,0
64,Yemen,2018,YEM-18/3420/RA1-2018/Health/NGO/9561,3/7/2019 10:32:21 AM,Internally Displaced People,3653,4697,4349,4696,17395,0,0,0,0,0
64,Yemen,2018,YEM-18/3420/RA1-2018/Health/NGO/9561,3/7/2019 10:32:21 AM,Overall,12511,16086,14895,16085,59577,13411,16886,15694,17186,63177
64,Yemen,2018,YEM-18/3420/RA1-2018/Health/NGO/9564,3/6/2019 11:24:31 AM,Host Communities,597,1790,298,298,2983,5658,7325,4607,4240,21830
64,Yemen,2018,YEM-18/3420/RA1-2018/Health/NGO/9564,3/6/2019 11:24:31 AM,Internally Displaced People,1193,3578,597,597,5965,246,355,227,221,1049
64,Yemen,2018,YEM-18/3420/RA1-2018/Health/NGO/9564,3/6/2019 11:24:31 AM,Overall,1790,5368,895,895,8948,5904,7680,4834,4461,22879
64,Yemen,2018,YEM-18/3420/RA1-2018/Health/O/9558,5/13/2019 7:58:14 AM,Host Communities,8027,12538,8114,9281,37960,14666,45873,15408,16914,92861
64,Yemen,2018,YEM-18/3420/RA1-2018/Health/O/9558,5/13/2019 7:58:14 AM,Internally Displaced People,3440,5374,3478,3978,16270,6285,19661,6605,7249,39800
64,Yemen,2018,YEM-18/3420/RA1-2018/Health/O/9558,5/13/2019 7:58:14 AM,Overall,11467,17912,11592,13259,54230,20950,65532,22014,24165,132661
64,Yemen,2018,YEM-18/3420/RA1-2018/Health/UN/9519,6/17/2019 9:20:56 AM,Host Communities,76085,88099,120135,116129,400448,61611,96268,115522,111671,385072
64,Yemen,2018,YEM-18/3420/RA1-2018/Health/UN/9519,6/17/2019 9:20:56 AM,Internally Displaced People,38043,44049,60067,58065,200224,10873,16988,20386,19707,67954
64,Yemen,2018,YEM-18/3420/RA1-2018/Health/UN/9519,6/17/2019 9:20:56 AM,Overall,114128,132148,180202,174194,600672,72484,113257,135908,131377,453026
64,Yemen,2018,YEM-18/3420/RA1-2018/Health/UN/9543,5/26/2019 3:13:38 PM,Host Communities,800,900,900,800,3400,1228,1348,169,606,3351
64,Yemen,2018,YEM-18/3420/RA1-2018/Health/UN/9543,5/26/2019 3:13:38 PM,Internally Displaced People,5000,7000,4000,3000,19000,6150,8600,4045,4700,23495
64,Yemen,2018,YEM-18/3420/RA1-2018/Health/UN/9543,5/26/2019 3:13:38 PM,Overall,6000,8000,5000,4000,23000,7378,9948,4214,5306,26846
64,Yemen,2018,YEM-18/3420/RA1-2018/Health/UN/9543,5/26/2019 3:13:38 PM,Refugees,200,100,100,200,600,1500,2000,45,1000,4545
64,Yemen,2018,YEM-18/3420/RA1-2018/Health-Nutrition/NGO/9538,4/17/2019 12:34:10 PM,Host Communities,26076,27230,25940,25209,104455,13300,11506,12445,10390,47641
64,Yemen,2018,YEM-18/3420/RA1-2018/Health-Nutrition/NGO/9538,4/17/2019 12:34:10 PM,Internally Displaced People,1898,1979,1888,1832,7597,2672,2252,2827,1962,9713
64,Yemen,2018,YEM-18/3420/RA1-2018/Health-Nutrition/NGO/9538,4/17/2019 12:34:10 PM,Overall,27974,29209,27828,27041,112052,43211,38023,35128,29788,146150
64,Yemen,2018,YEM-18/3420/RA1-2018/Logistics/UN/9516,8/19/2019 6:46:46 AM,Overall,0,0,0,25,25,0,0,0,21,21
64,Yemen,2018,YEM-18/3420/RA1-2018/MSREFMIG/UN/9553,9/15/2019 5:06:53 PM,Other,22500,3300,3600,600,30000,9912,1451,2647,446,14456
64,Yemen,2018,YEM-18/3420/RA1-2018/MSREFMIG/UN/9553,9/15/2019 5:06:53 PM,Overall,22500,3300,3600,600,30000,9912,1451,2647,446,14456
64,Yemen,2018,YEM-18/3420/RA1-2018/MSREFMIG/UN/9559,3/5/2019 6:51:15 AM,Host Communities,80,120,120,180,500,0,0,0,0,0
64,Yemen,2018,YEM-18/3420/RA1-2018/MSREFMIG/UN/9559,3/5/2019 6:51:15 AM,Overall,800,1200,1200,1800,5000,800,1200,1200,1800,5000
64,Yemen,2018,YEM-18/3420/RA1-2018/MSREFMIG/UN/9559,3/5/2019 6:51:15 AM,Refugees,720,1080,1080,1620,4500,0,0,0,0,0
64,Yemen,2018,YEM-18/3420/RA1-2018/Nutrition/UN/9515,10/9/2019 7:07:34 AM,Internally Displaced People,0,29000,38637,40213,107850,0,249967,152496,146515,548978
64,Yemen,2018,YEM-18/3420/RA1-2018/Nutrition/UN/9515,10/9/2019 7:07:34 AM,Overall,0,29000,38637,40213,107850,0,249967,152496,146515,548978
64,Yemen,2018,YEM-18/3420/RA1-2018/Nutrition/UN/9534,12/8/2019 10:12:25 AM,Internally Displaced People,0,0,0,0,0,0,598817,242982,252896,1094695
64,Yemen,2018,YEM-18/3420/RA1-2018/Nutrition/UN/9534,12/8/2019 10:12:25 AM,Overall,0,292549,195987,203987,692523,0,598817,242982,252896,1094695
64,Yemen,2018,YEM-18/3420/RA1-2018/Nutrition/UN/9573,3/17/2019 7:54:18 PM,Host Communities,0,0,9780,10220,20000,0,0,970,1010,1980
64,Yemen,2018,YEM-18/3420/RA1-2018/Nutrition/UN/9573,3/17/2019 7:54:18 PM,Internally Displaced People,0,0,1000,1000,2000,0,0,9810,10210,20020
64,Yemen,2018,YEM-18/3420/RA1-2018/Nutrition/UN/9573,3/17/2019 7:54:18 PM,Overall,0,0,10780,11220,22000,0,0,10780,11220,22000
64,Yemen,2018,YEM-18/3420/RA1-2018/Protection/INGO/9540,6/3/2019 8:04:23 PM,Host Communities,11381,6975,7342,11014,36712,73878,46855,59677,60152,240562
64,Yemen,2018,YEM-18/3420/RA1-2018/Protection/INGO/9540,6/3/2019 8:04:23 PM,Internally Displaced People,26555,16275,17132,25698,85660,55692,35593,41325,42688,175298
64,Yemen,2018,YEM-18/3420/RA1-2018/Protection/INGO/9540,6/3/2019 8:04:23 PM,Overall,37936,23250,24474,36712,122372,129570,82448,101002,102840,415860
64,Yemen,2018,YEM-18/3420/RA1-2018/Protection/INGO/9563,8/3/2019 5:48:13 PM,Host Communities,1647,2536,825,1275,6283,1618,2511,811,1254,6194
64,Yemen,2018,YEM-18/3420/RA1-2018/Protection/INGO/9563,8/3/2019 5:48:13 PM,Internally Displaced People,550,845,275,425,2095,570,885,287,443,2185
64,Yemen,2018,YEM-18/3420/RA1-2018/Protection/INGO/9563,8/3/2019 5:48:13 PM,Overall,2197,3382,1100,1700,8379,2188,3396,1098,1697,8379
64,Yemen,2018,YEM-18/3420/RA1-2018/Protection/NGO/9568,3/13/2019 9:08:00 AM,Host Communities,1479,1421,261,250,3411,3568,3620,992,876,9056
64,Yemen,2018,YEM-18/3420/RA1-2018/Protection/NGO/9568,3/13/2019 9:08:00 AM,Internally Displaced People,17595,16906,3105,2983,40589,19856,19734,4997,4825,49412
64,Yemen,2018,YEM-18/3420/RA1-2018/Protection/NGO/9568,3/13/2019 9:08:00 AM,Overall,19508,18743,3442,3307,45000,23935,23855,6141,5789,59720
64,Yemen,2018,YEM-18/3420/RA1-2018/Protection/NGO/9568,3/13/2019 9:08:00 AM,Refugees,434,416,76,74,1000,511,501,152,88,1252
64,Yemen,2018,YEM-18/3420/RA1-2018/Protection/UN/9551,10/2/2019 12:34:13 PM,Internally Displaced People,0,40000,0,30000,70000,0,149566,0,74783,224349
64,Yemen,2018,YEM-18/3420/RA1-2018/Protection/UN/9551,10/2/2019 12:34:13 PM,Overall,0,40000,0,30000,70000,0,149566,0,74783,224349
64,Yemen,2018,YEM-18/3420/RA1-2018/SHNFICCM/INGO/9518,10/13/2019 9:52:04 AM,Internally Displaced People,23408,24472,29792,28728,106400,26334,27531,33516,32319,119700
64,Yemen,2018,YEM-18/3420/RA1-2018/SHNFICCM/INGO/9518,10/13/2019 9:52:04 AM,Overall,23408,24472,29792,28728,106400,26334,27531,33516,32319,119700
64,Yemen,2018,YEM-18/3420/RA1-2018/SHNFICCM/NGO/9520,3/10/2019 11:41:42 AM,Other,49,49,49,49,196,42,41,38,38,159
64,Yemen,2018,YEM-18/3420/RA1-2018/SHNFICCM/NGO/9520,3/10/2019 11:41:42 AM,Overall,49,49,49,49,196,40,40,40,39,159
64,Yemen,2018,YEM-18/3420/RA1-2018/WASH/INGO/9530,6/9/2019 8:42:20 AM,Host Communities,0,0,0,0,0,22970,23502,28283,27676,102431
64,Yemen,2018,YEM-18/3420/RA1-2018/WASH/INGO/9530,6/9/2019 8:42:20 AM,Internally Displaced People,30800,32200,39200,37800,140000,11770,11857,18986,18482,61095
64,Yemen,2018,YEM-18/3420/RA1-2018/WASH/INGO/9530,6/9/2019 8:42:20 AM,Overall,30800,32200,39200,37800,140000,34739,35359,47270,46158,163526
64,Yemen,2018,YEM-18/3420/RA1-2018/WASH/UN/9523,5/21/2019 12:00:48 PM,Host Communities,297972,286288,104693,100587,789540,200960,193080,70609,69904,534553
64,Yemen,2018,YEM-18/3420/RA1-2018/WASH/UN/9523,5/21/2019 12:00:48 PM,Internally Displaced People,103944,99867,36521,35089,275421,159607,163901,54935,54271,432714
64,Yemen,2018,YEM-18/3420/RA1-2018/WASH/UN/9523,5/21/2019 12:00:48 PM,Overall,401916,386155,141214,135676,1064961,360563,475691,125539,124170,1085963
64,Yemen,2018,YEM-18/3420/RA2/Health/NGO/9865,4/23/2019 10:33:25 AM,Host Communities,3944,15681,808,3590,24023,4929,15577,6403,6364,33273
64,Yemen,2018,YEM-18/3420/RA2/Health/NGO/9865,4/23/2019 10:33:25 AM,Internally Displaced People,438,1743,90,106,2377,238,1368,313,350,2269
64,Yemen,2018,YEM-18/3420/RA2/Health/NGO/9865,4/23/2019 10:33:25 AM,Overall,4382,17424,898,3696,26400,5167,16945,6716,6714,35542
64,Yemen,2018,YEM-18/3420/RA2/Health/UN/9846,6/3/2019 7:51:27 AM,Host Communities,0,52174,0,7826,60000,0,21122,0,0,21122
64,Yemen,2018,YEM-18/3420/RA2/Health/UN/9846,6/3/2019 7:51:27 AM,Internally Displaced People,0,52174,0,7826,60000,0,21122,0,0,21122
64,Yemen,2018,YEM-18/3420/RA2/Health/UN/9846,6/3/2019 7:51:27 AM,Overall,0,104348,0,15652,120000,0,126956,0,12863,139819
64,Yemen,2018,YEM-18/3420/RA2/Protection/NGO/10013,5/23/2019 7:36:59 AM,Internally Displaced People,1000,1670,0,0,2670,1574,860,1,1,2436
64,Yemen,2018,YEM-18/3420/RA2/Protection/NGO/10013,5/23/2019 7:36:59 AM,Other,0,0,40,20,60,0,0,0,0,0
64,Yemen,2018,YEM-18/3420/RA2/Protection/NGO/10013,5/23/2019 7:36:59 AM,Overall,1000,1670,40,20,2730,1569,842,1,1,2413
64,Yemen,2018,YEM-18/3420/RA2/Protection/UN/9864,6/13/2019 7:33:47 AM,Host Communities,57079,53786,77307,73178,261350,42492,30511,0,0,73003
64,Yemen,2018,YEM-18/3420/RA2/Protection/UN/9864,6/13/2019 7:33:47 AM,Internally Displaced People,39665,37376,53722,50853,181616,0,0,0,0,0
64,Yemen,2018,YEM-18/3420/RA2/Protection/UN/9864,6/13/2019 7:33:47 AM,Overall,96745,91162,131029,124031,442967,306000,205000,0,0,511000
64,Yemen,2018,YEM-18/3420/RA2/Protection/UN/9881,9/24/2019 6:11:29 AM,Overall,17940,17160,21840,21060,78000,13800,13200,16800,16200,60000
64,Yemen,2018,YEM-18/3420/RA2/SHNFICCM/UN/9950,12/20/2019 3:02:33 PM,Internally Displaced People,6183,7869,6464,7589,28105,13577,12640,10768,9831,46816
64,Yemen,2018,YEM-18/3420/RA2/SHNFICCM/UN/9950,12/20/2019 3:02:33 PM,Overall,6183,7869,6464,7589,28105,13577,12640,10768,9831,46816
64,Yemen,2018,YEM-18/3420/RA3/SHNFICCM/INGO/11169,5/12/2019 7:50:38 AM,Internally Displaced People,8050,8400,9100,9450,35000,6640,7178,6977,7262,28057
64,Yemen,2018,YEM-18/3420/RA3/SHNFICCM/INGO/11169,5/12/2019 7:50:38 AM,Overall,8050,8400,9100,9450,35000,6640,7178,6977,7262,28057
64,Yemen,2018,YEM-18/3420/RA3/SHNFICCM/NGO/11183,6/17/2019 5:52:26 AM,Internally Displaced People,2530,2608,3626,3836,12600,2556,2729,2509,2533,10327
64,Yemen,2018,YEM-18/3420/RA3/SHNFICCM/NGO/11183,6/17/2019 5:52:26 AM,Overall,2530,2608,3626,3836,12600,2556,2729,2509,2533,10327
64,Yemen,2018,YEM-18/3420/RA3/SHNFICCM/O/11167,5/7/2019 8:10:13 AM,Internally Displaced People,4727,4919,4191,4363,18200,1790,814,9090,7585,19279
64,Yemen,2018,YEM-18/3420/RA3/SHNFICCM/O/11167,5/7/2019 8:10:13 AM,Overall,4727,4919,4191,4363,18200,1790,814,9090,7585,19279
64,Yemen,2018,YEM-18/3420/RA3/SHNFICCM/UN/11189,5/8/2019 11:17:40 AM,Internally Displaced People,9975,9975,9975,9975,39900,9797,10153,9797,2798,32545
64,Yemen,2018,YEM-18/3420/RA3/SHNFICCM/UN/11189,5/8/2019 11:17:40 AM,Overall,9975,9975,9975,9975,39900,9797,10153,9797,10153,39900
64,Yemen,2018,YEM-18/3420/SA1/Education/INGO/10280,4/27/2020 2:11:51 PM,Host Communities,0,0,7000,7000,14000,0,0,0,0,0
64,Yemen,2018,YEM-18/3420/SA1/Education/INGO/10280,4/27/2020 2:11:51 PM,Internally Displaced People,0,0,8750,8750,17500,336,109,17014,17362,34821
64,Yemen,2018,YEM-18/3420/SA1/Education/INGO/10280,4/27/2020 2:11:51 PM,Overall,0,0,15750,15750,31500,336,109,17014,17362,34821
64,Yemen,2018,YEM-18/3420/SA1/Education/NGO/10310,11/19/2019 11:49:05 AM,Host Communities,280,120,5000,5300,10700,339,107,7429,8146,16021
64,Yemen,2018,YEM-18/3420/SA1/Education/NGO/10310,11/19/2019 11:49:05 AM,Internally Displaced People,0,0,1000,700,1700,40,4,652,1029,1725
64,Yemen,2018,YEM-18/3420/SA1/Education/NGO/10310,11/19/2019 11:49:05 AM,Overall,280,120,6000,6000,12400,379,111,8081,9175,17746
64,Yemen,2018,YEM-18/3420/SA1/Education/NGO/10376,12/7/2019 12:56:59 PM,Host Communities,16,52,6731,6975,13774,25,77,6966,8009,15077
64,Yemen,2018,YEM-18/3420/SA1/Education/NGO/10376,12/7/2019 12:56:59 PM,Internally Displaced People,0,30,585,607,1222,2,8,830,970,1810
64,Yemen,2018,YEM-18/3420/SA1/Education/NGO/10376,12/7/2019 12:56:59 PM,Overall,16,82,7316,7582,14996,27,85,7796,8979,16887
64,Yemen,2018,YEM-18/3420/SA1/FSAC/INGO/10261,10/22/2019 12:39:50 PM,Host Communities,8148,8013,9030,8759,33950,7027,7502,10301,9798,34628
64,Yemen,2018,YEM-18/3420/SA1/FSAC/INGO/10261,10/22/2019 12:39:50 PM,Internally Displaced People,3837,4484,4862,5332,18515,1720,1600,1855,1798,6973
64,Yemen,2018,YEM-18/3420/SA1/FSAC/INGO/10261,10/22/2019 12:39:50 PM,Overall,11985,12497,13892,14091,52465,8747,9102,12156,11596,41601
64,Yemen,2018,YEM-18/3420/SA1/FSAC/INGO/10322,12/8/2019 9:50:07 AM,Host Communities,2998,2498,1999,2099,9594,3765,3666,3240,3107,13778
64,Yemen,2018,YEM-18/3420/SA1/FSAC/INGO/10322,12/8/2019 9:50:07 AM,Internally Displaced People,6996,5830,4664,6229,23719,6554,6487,5661,5416,24118
64,Yemen,2018,YEM-18/3420/SA1/FSAC/INGO/10322,12/8/2019 9:50:07 AM,Overall,9994,8328,6663,8328,33313,10319,10153,8901,8523,37896
64,Yemen,2018,YEM-18/3420/SA1/FSAC/INGO/10377,10/3/2019 12:53:07 PM,Host Communities,2474,2562,3072,3074,11182,2463,2573,3072,3054,11162
64,Yemen,2018,YEM-18/3420/SA1/FSAC/INGO/10377,10/3/2019 12:53:07 PM,Internally Displaced People,56,58,75,78,267,56,58,75,78,267
64,Yemen,2018,YEM-18/3420/SA1/FSAC/INGO/10377,10/3/2019 12:53:07 PM,Overall,2530,2620,3147,3152,11449,2519,2631,3147,3132,11429
64,Yemen,2018,YEM-18/3420/SA1/FSAC/INGO/10387,11/7/2019 6:04:56 AM,Host Communities,3429,3568,3568,3714,14279,1904,1875,1981,1952,7712
64,Yemen,2018,YEM-18/3420/SA1/FSAC/INGO/10387,11/7/2019 6:04:56 AM,Internally Displaced People,8000,8327,8327,8667,33321,9916,9831,11229,11276,42252
64,Yemen,2018,YEM-18/3420/SA1/FSAC/INGO/10387,11/7/2019 6:04:56 AM,Overall,11429,11895,11895,12381,47600,11820,11706,13210,13228,49964
64,Yemen,2018,YEM-18/3420/SA1/FSAC/INGO/10409,11/10/2019 12:36:23 PM,Overall,2415,2310,2940,2835,10500,2415,2310,2940,2835,10500
64,Yemen,2018,YEM-18/3420/SA1/FSAC/NGO/10239,11/26/2019 10:14:59 AM,Host Communities,3650,3798,5474,5698,18620,3650,3798,5474,5698,18620
64,Yemen,2018,YEM-18/3420/SA1/FSAC/NGO/10239,11/26/2019 10:14:59 AM,Internally Displaced People,1564,1621,2325,2470,7980,1564,1621,2325,2470,7980
64,Yemen,2018,YEM-18/3420/SA1/FSAC/NGO/10239,11/26/2019 10:14:59 AM,Overall,5214,5419,7799,8168,26600,5214,5419,7799,8168,26600
64,Yemen,2018,YEM-18/3420/SA1/FSAC/NGO/10343,12/10/2019 12:16:35 PM,Host Communities,4508,5292,4704,5096,19600,5275,6193,5505,5963,22936
64,Yemen,2018,YEM-18/3420/SA1/FSAC/NGO/10343,12/10/2019 12:16:35 PM,Internally Displaced People,1127,1323,1176,1274,4900,0,0,0,0,0
64,Yemen,2018,YEM-18/3420/SA1/FSAC/NGO/10343,12/10/2019 12:16:35 PM,Overall,5635,6615,5880,6370,24500,5275,6193,5505,5963,22936
64,Yemen,2018,YEM-18/3420/SA1/FSAC/NGO/10350,1/13/2020 9:40:29 AM,Host Communities,4007,4346,3590,3342,15285,3898,4214,3417,3146,14675
64,Yemen,2018,YEM-18/3420/SA1/FSAC/NGO/10350,1/13/2020 9:40:29 AM,Internally Displaced People,176,184,265,278,903,534,573,538,528,2173
64,Yemen,2018,YEM-18/3420/SA1/FSAC/NGO/10350,1/13/2020 9:40:29 AM,Overall,4183,4530,3855,3620,16188,4432,4787,3955,3674,16848
64,Yemen,2018,YEM-18/3420/SA1/FSAC/NGO/10354,1/15/2020 12:29:53 PM,Host Communities,1728,1413,1545,1417,6103,1894,1901,2945,2945,9685
64,Yemen,2018,YEM-18/3420/SA1/FSAC/NGO/10354,1/15/2020 12:29:53 PM,Internally Displaced People,310,254,433,397,1394,239,215,479,463,1396
64,Yemen,2018,YEM-18/3420/SA1/FSAC/NGO/10354,1/15/2020 12:29:53 PM,Overall,2038,1667,2850,2615,9170,2133,2116,3424,3408,11081
64,Yemen,2018,YEM-18/3420/SA1/FSAC/NGO/10355,1/22/2020 10:07:59 AM,Host Communities,2450,2551,3676,3826,12503,2017,2366,3942,3846,12171
64,Yemen,2018,YEM-18/3420/SA1/FSAC/NGO/10355,1/22/2020 10:07:59 AM,Internally Displaced People,129,134,193,201,657,0,0,0,0,0
64,Yemen,2018,YEM-18/3420/SA1/FSAC/NGO/10355,1/22/2020 10:07:59 AM,Overall,2579,2685,3869,4027,13160,2017,2366,3942,3846,12171
64,Yemen,2018,YEM-18/3420/SA1/FSAC/NGO/10365,9/12/2019 6:46:01 AM,Host Communities,1700,1870,2142,3213,8925,1906,2255,2385,2119,8665
64,Yemen,2018,YEM-18/3420/SA1/FSAC/NGO/10365,9/12/2019 6:46:01 AM,Internally Displaced People,300,330,378,567,1575,226,230,406,338,1200
64,Yemen,2018,YEM-18/3420/SA1/FSAC/NGO/10365,9/12/2019 6:46:01 AM,Overall,2000,2200,2520,3780,10500,2132,2485,2791,2457,9865
64,Yemen,2018,YEM-18/3420/SA1/FSAC/NGO/10366,1/22/2020 10:06:41 AM,Host Communities,1777,2073,2961,3260,10071,1778,2074,2962,3260,10074
64,Yemen,2018,YEM-18/3420/SA1/FSAC/NGO/10366,1/22/2020 10:06:41 AM,Internally Displaced People,2003,2337,3339,3250,10929,2700,3151,4501,4452,14804
64,Yemen,2018,YEM-18/3420/SA1/FSAC/NGO/10366,1/22/2020 10:06:41 AM,Overall,3780,4410,6300,6510,21000,4478,5225,7463,7712,24878
64,Yemen,2018,YEM-18/3420/SA1/FSAC/NGO/10371,1/15/2020 6:05:00 PM,Host Communities,3843,4000,788,819,9450,1784,2104,3135,2770,9793
64,Yemen,2018,YEM-18/3420/SA1/FSAC/NGO/10371,1/15/2020 6:05:00 PM,Internally Displaced People,427,445,87,91,1050,131,153,233,204,721
64,Yemen,2018,YEM-18/3420/SA1/FSAC/NGO/10371,1/15/2020 6:05:00 PM,Overall,4270,4445,875,910,10500,1915,2257,3368,2974,10514
64,Yemen,2018,YEM-18/3420/SA1/FSAC/NGO/10383,1/23/2020 7:22:22 AM,Host Communities,4448,5635,563,563,11209,2844,3087,4133,4070,14134
64,Yemen,2018,YEM-18/3420/SA1/FSAC/NGO/10383,1/23/2020 7:22:22 AM,Internally Displaced People,1992,2415,242,242,4891,502,545,730,719,2496
64,Yemen,2018,YEM-18/3420/SA1/FSAC/NGO/10383,1/23/2020 7:22:22 AM,Overall,6440,8050,805,805,16100,3346,3632,4863,4789,16630
64,Yemen,2018,YEM-18/3420/SA1/FSAC/NGO/10393,11/13/2019 11:48:42 AM,Host Communities,183,198,255,234,870,2036,2204,1620,1523,7383
64,Yemen,2018,YEM-18/3420/SA1/FSAC/NGO/10393,11/13/2019 11:48:42 AM,Internally Displaced People,61,66,85,78,290,33,35,36,25,129
64,Yemen,2018,YEM-18/3420/SA1/FSAC/NGO/10393,11/13/2019 11:48:42 AM,Other,1739,1731,1634,1536,6640,52,54,46,54,206
64,Yemen,2018,YEM-18/3420/SA1/FSAC/NGO/10393,11/13/2019 11:48:42 AM,Overall,1983,1995,1974,1848,7800,2121,2293,1702,1602,7718
64,Yemen,2018,YEM-18/3420/SA1/FSAC/NGO/10408,11/10/2019 6:31:23 AM,Host Communities,2276,2187,402,385,5250,889,854,168,154,2065
64,Yemen,2018,YEM-18/3420/SA1/FSAC/NGO/10408,11/10/2019 6:31:23 AM,Internally Displaced People,4551,4373,803,772,10499,2660,2324,630,574,6188
64,Yemen,2018,YEM-18/3420/SA1/FSAC/NGO/10408,11/10/2019 6:31:23 AM,Overall,7586,7289,1339,1286,17500,8869,8372,1764,1638,20643
64,Yemen,2018,YEM-18/3420/SA1/FSAC/NGO/10408,11/10/2019 6:31:23 AM,Refugees,759,729,134,129,1751,5320,5194,966,910,12390
64,Yemen,2018,YEM-18/3420/SA1/FSAC/NGO/10413,12/18/2019 9:05:37 AM,Host Communities,3953,4875,2633,2574,14035,3923,4687,2616,2691,13917
64,Yemen,2018,YEM-18/3420/SA1/FSAC/NGO/10413,12/18/2019 9:05:37 AM,Internally Displaced People,689,543,918,822,2972,360,517,412,400,1689
64,Yemen,2018,YEM-18/3420/SA1/FSAC/NGO/10413,12/18/2019 9:05:37 AM,Overall,4642,5418,3551,3396,17007,4283,5204,3028,3091,15606
64,Yemen,2018,YEM-18/3420/SA1/FSAC/NGO/10446,11/13/2019 11:11:06 AM,Host Communities,1465,898,945,1417,4725,1271,1719,2346,2211,7547
64,Yemen,2018,YEM-18/3420/SA1/FSAC/NGO/10446,11/13/2019 11:11:06 AM,Internally Displaced People,1790,1097,1155,1733,5775,614,725,899,867,3105
64,Yemen,2018,YEM-18/3420/SA1/FSAC/NGO/10446,11/13/2019 11:11:06 AM,Overall,3255,1995,2100,3150,10500,1885,2444,3245,3078,10652
64,Yemen,2018,YEM-18/3420/SA1/FSAC-WASH/NGO/10380,1/16/2020 6:01:19 AM,Host Communities,2530,2070,3150,2750,10500,2195,2199,2384,2276,9054
64,Yemen,2018,YEM-18/3420/SA1/FSAC-WASH/NGO/10380,1/16/2020 6:01:19 AM,Overall,2530,2070,3150,2750,10500,2195,2199,2384,2276,9054
64,Yemen,2018,YEM-18/3420/SA1/Health/INGO/10276,3/18/2020 9:00:15 AM,Host Communities,12457,21216,19746,19746,73165,17125,36580,23853,25247,102805
64,Yemen,2018,YEM-18/3420/SA1/Health/INGO/10276,3/18/2020 9:00:15 AM,Internally Displaced People,2198,3744,3484,3484,12910,3022,6455,4210,4455,18142
64,Yemen,2018,YEM-18/3420/SA1/Health/INGO/10276,3/18/2020 9:00:15 AM,Overall,14655,24960,23230,23230,86075,20147,43035,28063,29702,120947
64,Yemen,2018,YEM-18/3420/SA1/Health/INGO/10332,4/7/2020 4:14:24 PM,Host Communities,4791,25706,11132,10810,52439,18737,24849,19768,16459,79813
64,Yemen,2018,YEM-18/3420/SA1/Health/INGO/10332,4/7/2020 4:14:24 PM,Internally Displaced People,252,1353,586,569,2760,1402,3511,1043,1036,6992
64,Yemen,2018,YEM-18/3420/SA1/Health/INGO/10332,4/7/2020 4:14:24 PM,Overall,5043,27059,11718,11379,55199,20139,28360,20811,17495,86805
64,Yemen,2018,YEM-18/3420/SA1/Health/INGO/10345,1/14/2020 5:53:22 AM,Host Communities,0,398,2711,2766,5875,0,932,1656,1496,4084
64,Yemen,2018,YEM-18/3420/SA1/Health/INGO/10345,1/14/2020 5:53:22 AM,Overall,0,398,2711,2766,5875,0,932,1656,1496,4084
64,Yemen,2018,YEM-18/3420/SA1/Health/INGO/10392,9/21/2020 12:07:25 PM,Host Communities,12363,12563,3511,3374,31811,0,0,0,0,0
64,Yemen,2018,YEM-18/3420/SA1/Health/INGO/10392,9/21/2020 12:07:25 PM,Internally Displaced People,935,951,266,255,2407,13385,12710,19299,18519,63913
64,Yemen,2018,YEM-18/3420/SA1/Health/INGO/10392,9/21/2020 12:07:25 PM,Overall,13298,13514,3777,3630,34219,13385,12710,19299,18519,63913
64,Yemen,2018,YEM-18/3420/SA1/Health/INGO/10416,1/28/2020 8:24:15 AM,Host Communities,3388,3388,4325,4325,15426,2867,4744,3654,3295,14560
64,Yemen,2018,YEM-18/3420/SA1/Health/INGO/10416,1/28/2020 8:24:15 AM,Internally Displaced People,377,376,481,481,1715,0,0,0,0,0
64,Yemen,2018,YEM-18/3420/SA1/Health/INGO/10416,1/28/2020 8:24:15 AM,Overall,3765,3764,4806,4806,17141,2867,4744,3654,3295,14560
64,Yemen,2018,YEM-18/3420/SA1/Health/NGO/10384,1/27/2020 1:08:19 PM,Host Communities,18250,17193,16149,15128,66720,11765,23438,15867,15383,66453
64,Yemen,2018,YEM-18/3420/SA1/Health/NGO/10384,1/27/2020 1:08:19 PM,Internally Displaced People,3834,3383,2931,2515,12663,3988,3968,4999,4246,17201
64,Yemen,2018,YEM-18/3420/SA1/Health/NGO/10384,1/27/2020 1:08:19 PM,Overall,22084,20576,19080,17643,79383,15753,27406,20866,19629,83654
64,Yemen,2018,YEM-18/3420/SA1/Health/NGO/10400,9/9/2019 9:45:30 AM,Host Communities,4000,4000,6000,6000,20000,7185,7448,7128,7306,29067
64,Yemen,2018,YEM-18/3420/SA1/Health/NGO/10400,9/9/2019 9:45:30 AM,Internally Displaced People,208,380,312,570,1470,0,0,0,0,0
64,Yemen,2018,YEM-18/3420/SA1/Health/NGO/10400,9/9/2019 9:45:30 AM,Overall,4208,4380,6312,6570,21470,7185,7448,7128,7306,29067
64,Yemen,2018,YEM-18/3420/SA1/Health/NGO/10421,1/27/2020 6:12:15 AM,Host Communities,6500,9000,3000,4000,22500,5728,6586,5695,5001,23010
64,Yemen,2018,YEM-18/3420/SA1/Health/NGO/10421,1/27/2020 6:12:15 AM,Internally Displaced People,620,513,249,234,1616,0,0,0,0,0
64,Yemen,2018,YEM-18/3420/SA1/Health/NGO/10421,1/27/2020 6:12:15 AM,Overall,7120,9513,3249,4234,24116,5728,6586,5695,5001,23010
64,Yemen,2018,YEM-18/3420/SA1/Health/O/10290,1/28/2020 6:39:51 AM,Host Communities,22017,49220,35098,36749,143084,34220,88747,34208,44072,201247
64,Yemen,2018,YEM-18/3420/SA1/Health/O/10290,1/28/2020 6:39:51 AM,Internally Displaced People,9436,21094,15042,15750,61322,13573,34642,18424,13528,80167
64,Yemen,2018,YEM-18/3420/SA1/Health/O/10290,1/28/2020 6:39:51 AM,Overall,31453,70314,50140,52499,204406,47793,123389,52632,57600,281414
64,Yemen,2018,YEM-18/3420/SA1/Health-Nutrition/INGO/10283,1/5/2020 8:01:31 AM,Host Communities,0,0,0,0,0,12533,24435,18861,20738,76567
64,Yemen,2018,YEM-18/3420/SA1/Health-Nutrition/INGO/10283,1/5/2020 8:01:31 AM,Internally Displaced People,1996,2079,2078,2163,8316,3211,4852,4765,5541,18369
64,Yemen,2018,YEM-18/3420/SA1/Health-Nutrition/INGO/10283,1/5/2020 8:01:31 AM,Overall,25798,26852,11056,11508,75214,15744,29287,23626,26279,94936
64,Yemen,2018,YEM-18/3420/SA1/Health-Nutrition/NGO/10241,1/22/2020 10:27:34 AM,Host Communities,5527,7369,11054,12896,36846,11130,21997,18358,19256,70741
64,Yemen,2018,YEM-18/3420/SA1/Health-Nutrition/NGO/10241,1/22/2020 10:27:34 AM,Overall,5527,7369,11054,12896,36846,11130,21997,18358,19256,70741
64,Yemen,2018,YEM-18/3420/SA1/Health-Nutrition-WASH/NGO/10338,1/26/2020 8:11:33 AM,Host Communities,13603,14028,6878,7317,41826,7752,12711,10042,12258,42763
64,Yemen,2018,YEM-18/3420/SA1/Health-Nutrition-WASH/NGO/10338,1/26/2020 8:11:33 AM,Internally Displaced People,349,360,185,196,1090,0,0,0,0,0
64,Yemen,2018,YEM-18/3420/SA1/Health-Nutrition-WASH/NGO/10338,1/26/2020 8:11:33 AM,Overall,13952,14388,7063,7513,42916,7752,12711,10042,12258,42763
64,Yemen,2018,YEM-18/3420/SA1/Health-WASH/NGO/10417,11/14/2019 11:57:24 AM,Host Communities,14734,16993,13554,13554,58835,11029,21190,16040,16949,65208
64,Yemen,2018,YEM-18/3420/SA1/Health-WASH/NGO/10417,11/14/2019 11:57:24 AM,Internally Displaced People,2909,2910,3273,3032,12124,1795,3450,2612,2759,10616
64,Yemen,2018,YEM-18/3420/SA1/Health-WASH/NGO/10417,11/14/2019 11:57:24 AM,Overall,17643,19903,16827,16586,70959,12824,24640,18652,19708,75824
64,Yemen,2018,YEM-18/3420/SA1/Nutrition/INGO/10259,4/2/2020 9:07:00 AM,Host Communities,302,35703,26091,29424,91520,175,36375,22109,24160,82819
64,Yemen,2018,YEM-18/3420/SA1/Nutrition/INGO/10259,4/2/2020 9:07:00 AM,Overall,302,35703,26091,29424,91520,175,36375,22109,24160,82819
64,Yemen,2018,YEM-18/3420/SA1/Nutrition/INGO/10293,4/22/2020 7:33:58 AM,Host Communities,0,7947,1809,1737,11493,0,0,0,0,0
64,Yemen,2018,YEM-18/3420/SA1/Nutrition/INGO/10293,4/22/2020 7:33:58 AM,Internally Displaced People,0,806,338,325,1469,40,5898,4840,6318,17096
64,Yemen,2018,YEM-18/3420/SA1/Nutrition/INGO/10293,4/22/2020 7:33:58 AM,Overall,0,8889,5983,6017,20889,40,5898,4840,6318,17096
64,Yemen,2018,YEM-18/3420/SA1/Nutrition/INGO/10333,1/28/2020 12:18:44 PM,Host Communities,4571,16572,8314,8653,38110,1599,26185,8236,7705,43725
64,Yemen,2018,YEM-18/3420/SA1/Nutrition/INGO/10333,1/28/2020 12:18:44 PM,Internally Displaced People,241,873,437,455,2006,277,1280,586,656,2799
64,Yemen,2018,YEM-18/3420/SA1/Nutrition/INGO/10333,1/28/2020 12:18:44 PM,Overall,4812,17445,8751,9108,40116,1876,27465,8822,8361,46524
64,Yemen,2018,YEM-18/3420/SA1/Nutrition/INGO/10361,1/14/2020 5:46:38 AM,Host Communities,0,398,2711,2766,5875,1909,2440,2566,2502,9417
64,Yemen,2018,YEM-18/3420/SA1/Nutrition/INGO/10361,1/14/2020 5:46:38 AM,Overall,0,398,2711,2766,5875,1909,2440,2566,2502,9417
64,Yemen,2018,YEM-18/3420/SA1/Protection/INGO/10182,5/14/2020 7:59:03 AM,Host Communities,1124,873,748,751,3496,1688,2308,246,323,4565
64,Yemen,2018,YEM-18/3420/SA1/Protection/INGO/10182,5/14/2020 7:59:03 AM,Internally Displaced People,920,715,612,615,2862,957,1214,262,256,2689
64,Yemen,2018,YEM-18/3420/SA1/Protection/INGO/10182,5/14/2020 7:59:03 AM,Overall,2044,1588,1360,1366,6358,2645,3522,508,579,7254
64,Yemen,2018,YEM-18/3420/SA1/Protection/INGO/10275,3/18/2020 9:06:29 AM,Host Communities,1414,3348,1105,1105,6972,1530,3382,1450,1690,8052
64,Yemen,2018,YEM-18/3420/SA1/Protection/INGO/10275,3/18/2020 9:06:29 AM,Internally Displaced People,1766,4230,1382,1382,8760,2880,6366,2728,3183,15157
64,Yemen,2018,YEM-18/3420/SA1/Protection/INGO/10275,3/18/2020 9:06:29 AM,Other,354,846,276,276,1752,90,199,85,100,474
64,Yemen,2018,YEM-18/3420/SA1/Protection/INGO/10275,3/18/2020 9:06:29 AM,Overall,3534,8460,2763,2763,17520,4500,9947,4263,4973,23683
64,Yemen,2018,YEM-18/3420/SA1/Protection/INGO/10281,4/27/2020 2:20:14 PM,Host Communities,1228,2375,3455,3348,10406,1083,923,1319,1007,4332
64,Yemen,2018,YEM-18/3420/SA1/Protection/INGO/10281,4/27/2020 2:20:14 PM,Internally Displaced People,1722,2961,4840,4823,14346,3128,2497,2291,1883,9799
64,Yemen,2018,YEM-18/3420/SA1/Protection/INGO/10281,4/27/2020 2:20:14 PM,Other,167,168,0,0,335,63,15,0,0,78
64,Yemen,2018,YEM-18/3420/SA1/Protection/INGO/10281,4/27/2020 2:20:14 PM,Overall,3117,5504,8295,8171,25087,4274,3435,3610,2890,14209
64,Yemen,2018,YEM-18/3420/SA1/Protection/NGO/10254,1/15/2020 1:21:31 PM,Host Communities,1378,1538,863,870,4649,1477,1621,854,857,4809
64,Yemen,2018,YEM-18/3420/SA1/Protection/NGO/10254,1/15/2020 1:21:31 PM,Internally Displaced People,646,662,217,246,1771,647,729,272,330,1978
64,Yemen,2018,YEM-18/3420/SA1/Protection/NGO/10254,1/15/2020 1:21:31 PM,Overall,2051,2207,1080,1116,6454,2124,2350,1126,1187,6787
64,Yemen,2018,YEM-18/3420/SA1/Protection/NGO/10271,1/26/2020 8:22:56 AM,Host Communities,1184,1237,1452,1504,5377,4250,8391,1444,1329,15414
64,Yemen,2018,YEM-18/3420/SA1/Protection/NGO/10271,1/26/2020 8:22:56 AM,Internally Displaced People,2760,2886,3389,3513,12548,7830,12633,1249,1314,23026
64,Yemen,2018,YEM-18/3420/SA1/Protection/NGO/10271,1/26/2020 8:22:56 AM,Overall,3944,4123,4841,5017,17925,12080,21024,2693,2643,38440
64,Yemen,2018,YEM-18/3420/SA1/Protection/NGO/10286,3/25/2020 8:28:43 AM,Host Communities,2769,2157,896,798,6620,2291,1943,456,438,5128
64,Yemen,2018,YEM-18/3420/SA1/Protection/NGO/10286,3/25/2020 8:28:43 AM,Internally Displaced People,1845,1438,598,532,4413,2916,2472,580,556,6524
64,Yemen,2018,YEM-18/3420/SA1/Protection/NGO/10286,3/25/2020 8:28:43 AM,Overall,4614,3595,1494,1330,11033,5207,4415,1036,994,11652
64,Yemen,2018,YEM-18/3420/SA1/Protection/NGO/10311,11/5/2019 9:34:04 AM,Host Communities,1011,3290,3161,3290,10752,5416,5151,3363,1717,15647
64,Yemen,2018,YEM-18/3420/SA1/Protection/NGO/10311,11/5/2019 9:34:04 AM,Internally Displaced People,433,1410,1355,1410,4608,1799,1850,831,355,4835
64,Yemen,2018,YEM-18/3420/SA1/Protection/NGO/10311,11/5/2019 9:34:04 AM,Overall,1444,4700,4516,4700,15360,7215,7001,4194,2072,20482
64,Yemen,2018,YEM-18/3420/SA1/Protection/NGO/10316,1/6/2020 12:22:10 PM,Host Communities,1266,691,729,1151,3837,1086,1155,1230,1192,4663
64,Yemen,2018,YEM-18/3420/SA1/Protection/NGO/10316,1/6/2020 12:22:10 PM,Internally Displaced People,6332,3454,3646,5756,19188,4344,4622,4919,4766,18651
64,Yemen,2018,YEM-18/3420/SA1/Protection/NGO/10316,1/6/2020 12:22:10 PM,Overall,7598,4145,4375,6908,23026,5430,5777,6149,5958,23314
64,Yemen,2018,YEM-18/3420/SA1/Protection/NGO/10336,9/17/2019 12:54:53 PM,Host Communities,196,175,117,127,615,182,389,347,294,1212
64,Yemen,2018,YEM-18/3420/SA1/Protection/NGO/10336,9/17/2019 12:54:53 PM,Internally Displaced People,300,800,300,500,1900,486,1225,364,362,2437
64,Yemen,2018,YEM-18/3420/SA1/Protection/NGO/10336,9/17/2019 12:54:53 PM,Overall,496,975,417,627,2515,668,1614,711,656,3649
64,Yemen,2018,YEM-18/3420/SA1/Protection/NGO/10340,1/16/2020 9:40:30 AM,Host Communities,343,435,480,404,1662,1207,1543,1153,1078,4981
64,Yemen,2018,YEM-18/3420/SA1/Protection/NGO/10340,1/16/2020 9:40:30 AM,Internally Displaced People,1372,1737,1922,1616,6647,3011,3503,3479,3096,13089
64,Yemen,2018,YEM-18/3420/SA1/Protection/NGO/10340,1/16/2020 9:40:30 AM,Overall,1715,2172,2402,2020,8309,4218,5046,4632,4174,18070
64,Yemen,2018,YEM-18/3420/SA1/Protection/NGO/10351,4/8/2020 8:35:25 AM,Host Communities,965,1447,964,643,4019,812,663,279,220,1974
64,Yemen,2018,YEM-18/3420/SA1/Protection/NGO/10351,4/8/2020 8:35:25 AM,Internally Displaced People,643,964,643,429,2679,1731,1385,531,441,4088
64,Yemen,2018,YEM-18/3420/SA1/Protection/NGO/10351,4/8/2020 8:35:25 AM,Overall,1608,2411,1607,1072,6698,2543,2048,810,661,6062
64,Yemen,2018,YEM-18/3420/SA1/Protection/NGO/10431,12/18/2019 7:15:41 AM,Host Communities,753,1130,565,1318,3766,614,959,507,992,3072
64,Yemen,2018,YEM-18/3420/SA1/Protection/NGO/10431,12/18/2019 7:15:41 AM,Internally Displaced People,503,754,377,880,2514,642,925,435,1206,3208
64,Yemen,2018,YEM-18/3420/SA1/Protection/NGO/10431,12/18/2019 7:15:41 AM,Overall,1256,1884,942,2198,6280,1256,1884,942,2198,6280
64,Yemen,2018,YEM-18/3420/SA1/Protection/UN/10240,4/19/2020 11:31:12 AM,Host Communities,2240,1171,272,313,3996,368,286,269,160,1083
64,Yemen,2018,YEM-18/3420/SA1/Protection/UN/10240,4/19/2020 11:31:12 AM,Internally Displaced People,500,300,100,100,1000,1391,916,1522,80,3909
64,Yemen,2018,YEM-18/3420/SA1/Protection/UN/10240,4/19/2020 11:31:12 AM,Other,4720,906,1342,652,7620,5077,1787,2757,824,10445
64,Yemen,2018,YEM-18/3420/SA1/Protection/UN/10240,4/19/2020 11:31:12 AM,Overall,7460,2377,1714,1065,12616,6836,2989,4548,1064,15437
64,Yemen,2018,YEM-18/3420/SA1/Protection/UN/10420,1/31/2020 7:50:42 PM,Host Communities,0,14000,0,14000,28000,0,22500,0,9650,32150
64,Yemen,2018,YEM-18/3420/SA1/Protection/UN/10420,1/31/2020 7:50:42 PM,Internally Displaced People,56250,70250,56250,70250,253000,90909,154463,90909,138113,474394
64,Yemen,2018,YEM-18/3420/SA1/Protection/UN/10420,1/31/2020 7:50:42 PM,Overall,56250,84250,56250,84250,281000,90909,176963,90909,147763,506544
64,Yemen,2018,YEM-18/3420/SA1/SHNFICCM/INGO/10388,2/18/2020 7:48:37 AM,Internally Displaced People,5644,5901,6352,6570,24467,4895,3499,5094,3641,17129
64,Yemen,2018,YEM-18/3420/SA1/SHNFICCM/INGO/10388,2/18/2020 7:48:37 AM,Other,2272,2370,2568,2667,9877,3756,3803,3908,3959,15426
64,Yemen,2018,YEM-18/3420/SA1/SHNFICCM/INGO/10388,2/18/2020 7:48:37 AM,Overall,7916,8271,8920,9237,34344,8651,7302,9002,7600,32555
64,Yemen,2018,YEM-18/3420/SA1/SHNFICCM/NGO/10249,1/13/2020 11:32:19 AM,Internally Displaced People,2665,1743,1682,3115,9205,2544,2919,2679,2367,10509
64,Yemen,2018,YEM-18/3420/SA1/SHNFICCM/NGO/10249,1/13/2020 11:32:19 AM,Overall,2665,1743,1682,3115,9205,2544,2919,2679,2367,10509
64,Yemen,2018,YEM-18/3420/SA1/SHNFICCM/NGO/10257,12/12/2019 9:03:19 AM,Host Communities,185,194,246,255,880,185,205,222,183,795
64,Yemen,2018,YEM-18/3420/SA1/SHNFICCM/NGO/10257,12/12/2019 9:03:19 AM,Internally Displaced People,1663,1742,2218,2297,7920,1542,1740,2261,2167,7710
64,Yemen,2018,YEM-18/3420/SA1/SHNFICCM/NGO/10257,12/12/2019 9:03:19 AM,Overall,1848,1936,2464,2552,8800,1727,1945,2483,2350,8505
64,Yemen,2018,YEM-18/3420/SA1/SHNFICCM/NGO/10303,1/26/2020 6:50:37 AM,Host Communities,1541,1788,4218,4470,12017,661,731,1479,1492,4363
64,Yemen,2018,YEM-18/3420/SA1/SHNFICCM/NGO/10303,1/26/2020 6:50:37 AM,Internally Displaced People,4170,4470,7295,6987,22922,5130,5625,10027,9941,30723
64,Yemen,2018,YEM-18/3420/SA1/SHNFICCM/NGO/10303,1/26/2020 6:50:37 AM,Overall,5711,6258,11513,11457,34939,5791,6356,11506,11433,35086
64,Yemen,2018,YEM-18/3420/SA1/SHNFICCM/NGO/10339,1/22/2020 7:50:23 AM,Host Communities,364,510,455,492,1821,0,0,0,0,0
64,Yemen,2018,YEM-18/3420/SA1/SHNFICCM/NGO/10339,1/22/2020 7:50:23 AM,Internally Displaced People,1456,2038,1820,1965,7279,2202,2709,2112,2427,9450
64,Yemen,2018,YEM-18/3420/SA1/SHNFICCM/NGO/10339,1/22/2020 7:50:23 AM,Overall,1820,2548,2275,2457,9100,2202,2709,2112,2427,9450
64,Yemen,2018,YEM-18/3420/SA1/SHNFICCM/NGO/10342,4/22/2020 7:44:24 PM,Internally Displaced People,3452,3334,3442,3072,13300,2119,2352,2934,2642,10047
64,Yemen,2018,YEM-18/3420/SA1/SHNFICCM/NGO/10342,4/22/2020 7:44:24 PM,Overall,3452,3334,3442,3072,13300,2119,2352,2934,2642,10047
64,Yemen,2018,YEM-18/3420/SA1/SHNFICCM/NGO/10382,4/9/2020 6:06:51 AM,Internally Displaced People,6874,6019,5378,5176,23447,6762,7088,9005,9540,32395
64,Yemen,2018,YEM-18/3420/SA1/SHNFICCM/NGO/10382,4/9/2020 6:06:51 AM,Overall,6874,6019,5378,5176,23447,6762,7088,9005,9540,32395
64,Yemen,2018,YEM-18/3420/SA1/SHNFICCM/NGO/10402,1/16/2020 8:52:11 AM,Host Communities,260,330,363,305,1258,283,366,327,343,1319
64,Yemen,2018,YEM-18/3420/SA1/SHNFICCM/NGO/10402,1/16/2020 8:52:11 AM,Internally Displaced People,1427,1806,1999,1680,6912,1357,1555,1550,1371,5833
64,Yemen,2018,YEM-18/3420/SA1/SHNFICCM/NGO/10402,1/16/2020 8:52:11 AM,Overall,1687,2136,2362,1985,8170,1640,1921,1877,1714,7152
64,Yemen,2018,YEM-18/3420/SA1/WASH/INGO/10243,6/23/2020 6:52:30 AM,Host Communities,3918,4457,3884,4115,16374,3678,4184,3645,3867,15374
64,Yemen,2018,YEM-18/3420/SA1/WASH/INGO/10243,6/23/2020 6:52:30 AM,Overall,3918,4457,3884,4115,16374,3678,4184,3645,3867,15374
64,Yemen,2018,YEM-18/3420/SA1/WASH/INGO/10260,3/10/2020 6:35:45 AM,Host Communities,9408,9251,10428,10113,39200,2602,4108,4088,3741,14539
64,Yemen,2018,YEM-18/3420/SA1/WASH/INGO/10260,3/10/2020 6:35:45 AM,Internally Displaced People,1832,1916,2250,2332,8330,7740,11411,10514,10648,40313
64,Yemen,2018,YEM-18/3420/SA1/WASH/INGO/10260,3/10/2020 6:35:45 AM,Overall,11240,11167,12678,12445,47530,10342,15519,14602,14389,54852
64,Yemen,2018,YEM-18/3420/SA1/WASH/INGO/10279,4/22/2020 7:40:39 AM,Host Communities,7206,7206,11496,11044,36952,9562,9460,13036,12316,44374
64,Yemen,2018,YEM-18/3420/SA1/WASH/INGO/10279,4/22/2020 7:40:39 AM,Internally Displaced People,1476,1476,2354,2262,7568,0,0,0,0,0
64,Yemen,2018,YEM-18/3420/SA1/WASH/INGO/10279,4/22/2020 7:40:39 AM,Overall,8682,8682,13850,13306,44520,9562,9460,13036,12316,44374
64,Yemen,2018,YEM-18/3420/SA1/WASH/INGO/10320,5/13/2020 10:56:05 AM,Host Communities,9789,8788,8781,8642,36000,0,0,0,0,0
64,Yemen,2018,YEM-18/3420/SA1/WASH/INGO/10320,5/13/2020 10:56:05 AM,Internally Displaced People,21193,19104,19656,19120,79073,20250,23285,27964,28867,100366
64,Yemen,2018,YEM-18/3420/SA1/WASH/INGO/10320,5/13/2020 10:56:05 AM,Overall,30982,27892,28437,27762,115073,20250,23285,27964,28867,100366
64,Yemen,2018,YEM-18/3420/SA1/WASH/INGO/10391,7/1/2020 4:28:04 PM,Host Communities,6044,5827,5431,5168,22470,0,0,0,0,0
64,Yemen,2018,YEM-18/3420/SA1/WASH/INGO/10391,7/1/2020 4:28:04 PM,Internally Displaced People,2590,2498,2327,2215,9630,4579,11276,9119,8751,33725
64,Yemen,2018,YEM-18/3420/SA1/WASH/INGO/10391,7/1/2020 4:28:04 PM,Overall,8634,8325,7758,7383,32100,4579,11276,9119,8751,33725
64,Yemen,2018,YEM-18/3420/SA1/WASH/NGO/10274,9/12/2019 9:13:00 AM,Host Communities,7600,8000,11500,12000,39100,7681,7980,11546,11999,39206
64,Yemen,2018,YEM-18/3420/SA1/WASH/NGO/10274,9/12/2019 9:13:00 AM,Internally Displaced People,298,221,347,330,1196,217,241,301,331,1090
64,Yemen,2018,YEM-18/3420/SA1/WASH/NGO/10274,9/12/2019 9:13:00 AM,Overall,7898,8221,11847,12330,40296,7898,8221,11847,12330,40296
64,Yemen,2018,YEM-18/3420/SA1/WASH/NGO/10289,12/29/2019 7:38:00 AM,Host Communities,12896,8452,8215,14826,44389,12100,12723,9776,13945,48544
64,Yemen,2018,YEM-18/3420/SA1/WASH/NGO/10289,12/29/2019 7:38:00 AM,Internally Displaced People,1722,1140,1072,1892,5826,1200,1300,1000,1700,5200
64,Yemen,2018,YEM-18/3420/SA1/WASH/NGO/10289,12/29/2019 7:38:00 AM,Overall,14618,9592,9287,16718,50215,13300,14023,10776,15645,53744
64,Yemen,2018,YEM-18/3420/SA1/WASH/NGO/10298,11/17/2019 6:57:13 AM,Host Communities,8238,9422,19536,21904,59100,16514,18163,12958,13958,61593
64,Yemen,2018,YEM-18/3420/SA1/WASH/NGO/10298,11/17/2019 6:57:13 AM,Internally Displaced People,252,288,594,666,1800,197,223,462,519,1401
64,Yemen,2018,YEM-18/3420/SA1/WASH/NGO/10298,11/17/2019 6:57:13 AM,Other,50,50,0,0,100,0,0,0,0,0
64,Yemen,2018,YEM-18/3420/SA1/WASH/NGO/10298,11/17/2019 6:57:13 AM,Overall,8540,9760,20130,22570,61000,16711,18386,13420,14477,62994
64,Yemen,2018,YEM-18/3420/SA1/WASH/NGO/10367,4/12/2020 8:24:12 PM,Host Communities,4180,4035,4166,3720,16101,10512,11054,10206,9277,41049
64,Yemen,2018,YEM-18/3420/SA1/WASH/NGO/10367,4/12/2020 8:24:12 PM,Internally Displaced People,5232,5288,5134,4960,20614,940,932,991,915,3778
64,Yemen,2018,YEM-18/3420/SA1/WASH/NGO/10367,4/12/2020 8:24:12 PM,Overall,9412,9323,9300,8680,36715,11452,11986,11197,10192,44827
64,Yemen,2018,YEM-18/3420/SA1/WASH/NGO/10395,3/16/2020 10:35:49 AM,Host Communities,4996,5087,7211,6604,23898,6183,5507,5920,5327,22937
64,Yemen,2018,YEM-18/3420/SA1/WASH/NGO/10395,3/16/2020 10:35:49 AM,Internally Displaced People,555,565,801,734,2655,1091,972,1044,940,4047
64,Yemen,2018,YEM-18/3420/SA1/WASH/NGO/10395,3/16/2020 10:35:49 AM,Overall,5552,5652,8012,7338,26554,7274,6479,6964,6267,26984
64,Yemen,2018,YEM-18/3420/SA1/WASH/NGO/10398,1/26/2020 7:44:03 AM,Host Communities,1278,1255,1962,2127,6622,4502,4799,8882,8395,26578
64,Yemen,2018,YEM-18/3420/SA1/WASH/NGO/10398,1/26/2020 7:44:03 AM,Internally Displaced People,6225,6744,12842,11864,37675,3001,3200,5922,5596,17719
64,Yemen,2018,YEM-18/3420/SA1/WASH/NGO/10398,1/26/2020 7:44:03 AM,Overall,7503,7999,14804,13991,44297,7503,7999,14804,13991,44297
64,Yemen,2018,YEM-18/3420/SA1/WASH/NGO/10405,4/20/2020 9:56:10 PM,Host Communities,3086,3821,3821,3968,14696,89910,111316,111316,115598,428140
64,Yemen,2018,YEM-18/3420/SA1/WASH/NGO/10405,4/20/2020 9:56:10 PM,Internally Displaced People,294,364,364,378,1400,2195,2718,2718,2822,10453
64,Yemen,2018,YEM-18/3420/SA1/WASH/NGO/10405,4/20/2020 9:56:10 PM,Other,904,1119,1119,1162,4304,0,0,0,0,0
64,Yemen,2018,YEM-18/3420/SA1/WASH/NGO/10405,4/20/2020 9:56:10 PM,Overall,90782,112396,112396,116719,432293,92105,114034,114034,118420,438593
64,Yemen,2018,YEM-18/3420/SA1/WASH-FSAC/NGO/10309,11/4/2019 6:18:53 AM,Host Communities,13194,13733,8797,9154,44878,14998,15610,22497,23415,76520
64,Yemen,2018,YEM-18/3420/SA1/WASH-FSAC/NGO/10309,11/4/2019 6:18:53 AM,Internally Displaced People,3690,3841,2460,2561,12552,4230,4403,6345,6604,21582
64,Yemen,2018,YEM-18/3420/SA1/WASH-FSAC/NGO/10309,11/4/2019 6:18:53 AM,Overall,16884,17574,11257,11715,57430,19228,20013,28842,30019,98102
64,Yemen,2018,YEM-18/3420/SA1/WASH-Health/NGO/10368,1/22/2020 10:01:53 AM,Host Communities,37893,32535,35137,30315,135880,49018,75274,81320,83182,288794
64,Yemen,2018,YEM-18/3420/SA1/WASH-Health/NGO/10368,1/22/2020 10:01:53 AM,Internally Displaced People,4210,5741,3905,3368,17224,0,0,0,0,0
64,Yemen,2018,YEM-18/3420/SA1/WASH-Health/NGO/10368,1/22/2020 10:01:53 AM,Overall,42103,38276,39042,33683,153104,49018,75274,81320,83182,288794
64,Yemen,2019,YEM-19/3420/RA1/Health/INGO/12780,8/23/2020 10:41:20 AM,Host Communities,4278,4825,3793,4278,17174,1577,1395,1329,1326,5627
64,Yemen,2019,YEM-19/3420/RA1/Health/INGO/12780,8/23/2020 10:41:20 AM,Overall,4278,4825,3793,4278,17174,1577,1395,1329,1326,5627
64,Yemen,2019,YEM-19/3420/RA1/Health/NGO/12766,4/16/2020 4:49:25 AM,Host Communities,2850,2967,4275,4450,14542,2450,3179,6319,6035,17983
64,Yemen,2019,YEM-19/3420/RA1/Health/NGO/12766,4/16/2020 4:49:25 AM,Overall,2850,2967,4275,4450,14542,2450,3179,6319,6035,17983
64,Yemen,2019,YEM-19/3420/RA1/Health/NGO/12774,1/22/2020 10:00:15 AM,Host Communities,4647,4066,3195,2614,14522,7279,9332,8208,7628,32447
64,Yemen,2019,YEM-19/3420/RA1/Health/NGO/12774,1/22/2020 10:00:15 AM,Internally Displaced People,506,443,348,285,1582,899,1153,1014,944,4010
64,Yemen,2019,YEM-19/3420/RA1/Health/NGO/12774,1/22/2020 10:00:15 AM,Overall,5153,4509,3543,2899,16104,8178,10485,9222,8572,36457
64,Yemen,2019,YEM-19/3420/RA1/Health/NGO/12776,3/31/2020 6:20:27 PM,Host Communities,2862,2795,2834,2877,11368,934,1044,1349,1144,4471
64,Yemen,2019,YEM-19/3420/RA1/Health/NGO/12776,3/31/2020 6:20:27 PM,Internally Displaced People,272,262,271,275,1080,2,13,7,4,26
64,Yemen,2019,YEM-19/3420/RA1/Health/NGO/12776,3/31/2020 6:20:27 PM,Overall,3134,3057,3105,3152,12448,936,1057,1356,1148,4497
64,Yemen,2019,YEM-19/3420/RA1/Health/NGO/12777,1/19/2020 6:49:35 AM,Host Communities,8651,9005,12979,13519,44154,7163,15108,9401,10468,42140
64,Yemen,2019,YEM-19/3420/RA1/Health/NGO/12777,1/19/2020 6:49:35 AM,Overall,8651,9005,12979,13519,44154,7163,15108,9401,10468,42140
64,Yemen,2019,YEM-19/3420/RA1/Health/UN/12788,9/9/2020 1:33:03 PM,Host Communities,30247,30991,29751,32974,123963,114037,118788,114037,128291,475153
64,Yemen,2019,YEM-19/3420/RA1/Health/UN/12788,9/9/2020 1:33:03 PM,Internally Displaced People,3361,3443,3306,3664,13774,14095,14682,14094,15856,58727
64,Yemen,2019,YEM-19/3420/RA1/Health/UN/12788,9/9/2020 1:33:03 PM,Overall,33608,34434,33057,36638,137737,128132,133470,128131,144147,533880
64,Yemen,2019,YEM-19/3420/RA1/WASH/INGO/12760,10/13/2020 2:55:38 PM,Host Communities,18522,22638,27784,33956,102900,22025,24200,33106,36296,115627
64,Yemen,2019,YEM-19/3420/RA1/WASH/INGO/12760,10/13/2020 2:55:38 PM,Internally Displaced People,7938,9702,11907,14553,44100,7281,8066,10910,12097,38354
64,Yemen,2019,YEM-19/3420/RA1/WASH/INGO/12760,10/13/2020 2:55:38 PM,Overall,26460,32340,39691,48509,147000,29306,32266,44016,48393,153981
64,Yemen,2019,YEM-19/3420/RA1/WASH/INGO/12761,6/17/2020 10:33:53 AM,Host Communities,3488,3336,4246,4095,15165,7181,7897,6011,6408,27497
64,Yemen,2019,YEM-19/3420/RA1/WASH/INGO/12761,6/17/2020 10:33:53 AM,Internally Displaced People,10464,10009,12738,12284,45495,21542,23692,18032,19223,82489
64,Yemen,2019,YEM-19/3420/RA1/WASH/INGO/12761,6/17/2020 10:33:53 AM,Overall,13952,13345,16984,16379,60660,28723,31589,24043,25631,109986
64,Yemen,2019,YEM-19/3420/RA1/WASH/INGO/12773,6/7/2020 12:52:00 PM,Host Communities,27527,28703,30395,31583,118208,62362,65978,65866,67629,261835
64,Yemen,2019,YEM-19/3420/RA1/WASH/INGO/12773,6/7/2020 12:52:00 PM,Internally Displaced People,8340,8702,9428,9790,36260,21959,23618,22856,24582,93015
64,Yemen,2019,YEM-19/3420/RA1/WASH/INGO/12773,6/7/2020 12:52:00 PM,Overall,35867,37405,39823,41373,154468,84321,89596,88722,92211,354850
64,Yemen,2019,YEM-19/3420/RA1/WASH/INGO/12792,6/24/2020 7:20:44 AM,Host Communities,8738,8496,10801,10597,38632,23676,31936,38921,42637,137170
64,Yemen,2019,YEM-19/3420/RA1/WASH/INGO/12792,6/24/2020 7:20:44 AM,Internally Displaced People,1374,1314,1705,1561,5954,498,521,576,612,2207
64,Yemen,2019,YEM-19/3420/RA1/WASH/INGO/12792,6/24/2020 7:20:44 AM,Overall,10404,10116,12966,12653,46139,24174,32457,39497,43249,139377
64,Yemen,2019,YEM-19/3420/RA1/WASH/INGO/12792,6/24/2020 7:20:44 AM,Returnees,292,306,460,495,1553,0,0,0,0,0
64,Yemen,2019,YEM-19/3420/RA1/WASH/INGO/12810,7/1/2020 4:34:15 PM,Host Communities,4503,4698,5091,5285,19577,5418,5639,6116,6355,23528
64,Yemen,2019,YEM-19/3420/RA1/WASH/INGO/12810,7/1/2020 4:34:15 PM,Internally Displaced People,500,523,566,587,2176,956,996,1079,1121,4152
64,Yemen,2019,YEM-19/3420/RA1/WASH/INGO/12810,7/1/2020 4:34:15 PM,Overall,5003,5221,5657,5872,21753,6374,6635,7195,7476,27680
64,Yemen,2019,YEM-19/3420/RA1/WASH/INGO/12826,8/17/2020 5:47:57 AM,Host Communities,11370,11875,13662,13451,50358,18420,17585,19779,18982,74766
64,Yemen,2019,YEM-19/3420/RA1/WASH/INGO/12826,8/17/2020 5:47:57 AM,Internally Displaced People,2305,2408,2790,2739,10242,1414,1477,1701,1674,6266
64,Yemen,2019,YEM-19/3420/RA1/WASH/INGO/12826,8/17/2020 5:47:57 AM,Overall,13675,14283,16452,16190,60600,19834,19062,21480,20656,81032
64,Yemen,2019,YEM-19/3420/RA1/WASH/UN/12821,7/22/2020 8:46:32 AM,Host Communities,110559,229129,230131,198781,768600,116177,240771,241824,208881,807653
64,Yemen,2019,YEM-19/3420/RA1/WASH/UN/12821,7/22/2020 8:46:32 AM,Internally Displaced People,47382,98198,98628,85192,329400,49790,103187,103639,89521,346137
64,Yemen,2019,YEM-19/3420/RA1/WASH/UN/12821,7/22/2020 8:46:32 AM,Overall,157941,327327,328759,283973,1098000,165967,343958,345463,298402,1153790
64,Yemen,2019,YEM-19/3420/RA2/Health/UN/13161,8/29/2021 12:19:28 PM,Host Communities,490,510,250,250,1500,46,52,6,14,118
64,Yemen,2019,YEM-19/3420/RA2/Health/UN/13161,8/29/2021 12:19:28 PM,Overall,490,510,250,250,1500,46,52,6,14,118
64,Yemen,2019,YEM-19/3420/RA3/CCS/UN/13999,11/17/2022 7:24:09 AM,Other,0,261,0,0,261,0,261,0,0,261
64,Yemen,2019,YEM-19/3420/RA3/CCS/UN/13999,11/17/2022 7:24:09 AM,Overall,0,261,0,0,261,0,261,0,0,261
64,Yemen,2019,YEM-19/3420/RA3/Health/UN/14002,4/26/2020 7:55:12 AM,Host Communities,3600,68000,400,4000,76000,11311,72020,0,5945,89276
64,Yemen,2019,YEM-19/3420/RA3/Health/UN/14002,4/26/2020 7:55:12 AM,Internally Displaced People,900,17000,100,1000,19000,2345,16230,0,805,19380
64,Yemen,2019,YEM-19/3420/RA3/Health/UN/14002,4/26/2020 7:55:12 AM,Overall,4500,85000,500,5000,95000,13656,88250,0,6750,108656
64,Yemen,2019,YEM-19/3420/RA3/Health/UN/14032,9/5/2020 2:32:52 PM,Host Communities,472200,217758,133185,89365,912508,302389,312815,229397,198116,1042717
64,Yemen,2019,YEM-19/3420/RA3/Health/UN/14032,9/5/2020 2:32:52 PM,Overall,472200,217758,133185,89365,912508,302389,312815,229397,198116,1042717
64,Yemen,2019,YEM-19/3420/RA3/Protection/UN/13996,5/4/2020 10:38:41 AM,Host Communities,0,12450,0,1950,14400,0,12450,0,1950,14400
64,Yemen,2019,YEM-19/3420/RA3/Protection/UN/13996,5/4/2020 10:38:41 AM,Internally Displaced People,0,12450,0,1950,14400,0,12450,0,1950,14400
64,Yemen,2019,YEM-19/3420/RA3/Protection/UN/13996,5/4/2020 10:38:41 AM,Overall,0,24900,0,3900,28800,0,24900,0,3900,28800
64,Yemen,2019,YEM-19/3420/RA3/SHNFICCM/UN/14000,4/20/2020 7:12:34 PM,Internally Displaced People,20713,21521,20529,21236,83999,18635,18309,23174,24218,84336
64,Yemen,2019,YEM-19/3420/RA3/SHNFICCM/UN/14000,4/20/2020 7:12:34 PM,Overall,20713,21521,20529,21236,83999,18635,18309,23174,24218,84336
64,Yemen,2019,YEM-19/3420/SA1/Education/INGO/11840,8/12/2020 6:54:14 PM,Internally Displaced People,20,15,1120,880,2035,56,144,4552,3563,8315
64,Yemen,2019,YEM-19/3420/SA1/Education/INGO/11840,8/12/2020 6:54:14 PM,Overall,20,15,1120,880,2035,56,144,4552,3563,8315
64,Yemen,2019,YEM-19/3420/SA1/Education/NGO/11810,6/7/2020 7:00:31 AM,Host Communities,252,252,3500,4375,8379,131,105,5327,6506,12069
64,Yemen,2019,YEM-19/3420/SA1/Education/NGO/11810,6/7/2020 7:00:31 AM,Internally Displaced People,107,107,1500,1875,3589,80,80,1129,787,2076
64,Yemen,2019,YEM-19/3420/SA1/Education/NGO/11810,6/7/2020 7:00:31 AM,Overall,359,359,5000,6250,11968,211,185,6456,7293,14145
64,Yemen,2019,YEM-19/3420/SA1/Education/NGO/11894,5/16/2020 12:13:26 PM,Host Communities,20,20,6511,2190,8741,46,112,6367,2361,8886
64,Yemen,2019,YEM-19/3420/SA1/Education/NGO/11894,5/16/2020 12:13:26 PM,Overall,20,20,6511,2190,8741,46,112,6367,2361,8886
64,Yemen,2019,YEM-19/3420/SA1/Education-FSAC/NGO/11802,8/16/2020 11:03:55 AM,Host Communities,1926,2010,6814,6184,16934,1926,2010,7049,6243,17228
64,Yemen,2019,YEM-19/3420/SA1/Education-FSAC/NGO/11802,8/16/2020 11:03:55 AM,Internally Displaced People,66,75,65,70,276,66,75,65,70,276
64,Yemen,2019,YEM-19/3420/SA1/Education-FSAC/NGO/11802,8/16/2020 11:03:55 AM,Overall,1992,2085,6879,6254,17210,1992,2085,7114,6313,17504
64,Yemen,2019,YEM-19/3420/SA1/Education-FSAC/NGO/11855,6/9/2020 9:30:46 PM,Host Communities,1149,1141,4527,3812,10629,1011,1064,5492,5428,12995
64,Yemen,2019,YEM-19/3420/SA1/Education-FSAC/NGO/11855,6/9/2020 9:30:46 PM,Internally Displaced People,233,243,396,402,1274,99,101,191,186,577
64,Yemen,2019,YEM-19/3420/SA1/Education-FSAC/NGO/11855,6/9/2020 9:30:46 PM,Overall,1492,1498,5088,4385,12463,1203,1256,5818,5741,14018
64,Yemen,2019,YEM-19/3420/SA1/Education-FSAC/NGO/11855,6/9/2020 9:30:46 PM,Returnees,110,114,165,171,560,93,91,135,127,446
64,Yemen,2019,YEM-19/3420/SA1/Education-Nutrition/NGO/11816,7/28/2020 12:26:40 PM,Host Communities,268,155,5150,5233,10806,195,144,4873,5042,10254
64,Yemen,2019,YEM-19/3420/SA1/Education-Nutrition/NGO/11816,7/28/2020 12:26:40 PM,Internally Displaced People,7,277,726,755,1765,163,189,775,802,1929
64,Yemen,2019,YEM-19/3420/SA1/Education-Nutrition/NGO/11816,7/28/2020 12:26:40 PM,Overall,275,432,5876,5988,12571,358,333,5648,5844,12183
64,Yemen,2019,YEM-19/3420/SA1/Education-Protection/INGO/11841,8/5/2020 9:35:54 AM,Internally Displaced People,3730,3695,4711,4230,16366,4729,5165,11219,10896,32009
64,Yemen,2019,YEM-19/3420/SA1/Education-Protection/INGO/11841,8/5/2020 9:35:54 AM,Overall,3730,3695,4711,4230,16366,4729,5165,11219,10896,32009
64,Yemen,2019,YEM-19/3420/SA1/Education-WASH/INGO/11857,2/11/2021 7:28:16 AM,Host Communities,840,874,874,910,3498,1438,1809,1060,1027,5334
64,Yemen,2019,YEM-19/3420/SA1/Education-WASH/INGO/11857,2/11/2021 7:28:16 AM,Internally Displaced People,3762,3189,3733,3914,14598,4231,3679,4380,4998,17288
64,Yemen,2019,YEM-19/3420/SA1/Education-WASH/INGO/11857,2/11/2021 7:28:16 AM,Overall,4602,4063,4607,4824,18096,5669,5488,5440,6025,22622
64,Yemen,2019,YEM-19/3420/SA1/FSAC/INGO/11818,7/28/2020 12:32:15 PM,Host Communities,25,29,26,31,111,25,29,26,31,111
64,Yemen,2019,YEM-19/3420/SA1/FSAC/INGO/11818,7/28/2020 12:32:15 PM,Internally Displaced People,1421,1355,1343,1275,5394,1421,1355,1343,1275,5394
64,Yemen,2019,YEM-19/3420/SA1/FSAC/INGO/11818,7/28/2020 12:32:15 PM,Overall,1446,1384,1369,1306,5505,1446,1384,1369,1306,5505
64,Yemen,2019,YEM-19/3420/SA1/FSAC/INGO/11911,7/4/2021 3:34:59 PM,Host Communities,2971,2871,2078,1979,9899,2804,2665,2857,3049,11375
64,Yemen,2019,YEM-19/3420/SA1/FSAC/INGO/11911,7/4/2021 3:34:59 PM,Internally Displaced People,1272,1230,890,849,4241,872,836,824,863,3395
64,Yemen,2019,YEM-19/3420/SA1/FSAC/INGO/11911,7/4/2021 3:34:59 PM,Overall,4243,4101,2968,2828,14140,3676,3501,3681,3912,14770
64,Yemen,2019,YEM-19/3420/SA1/FSAC/NGO/11798,5/19/2020 8:52:50 AM,Host Communities,515,588,1213,1360,3676,554,593,664,761,2572
64,Yemen,2019,YEM-19/3420/SA1/FSAC/NGO/11798,5/19/2020 8:52:50 AM,Internally Displaced People,172,196,404,453,1225,324,345,567,540,1776
64,Yemen,2019,YEM-19/3420/SA1/FSAC/NGO/11798,5/19/2020 8:52:50 AM,Overall,687,784,1617,1813,4901,878,938,1231,1301,4348
64,Yemen,2019,YEM-19/3420/SA1/FSAC/NGO/11944,8/26/2020 6:50:50 AM,Host Communities,900,1100,1500,1750,5250,1237,1408,1823,1585,6053
64,Yemen,2019,YEM-19/3420/SA1/FSAC/NGO/11944,8/26/2020 6:50:50 AM,Internally Displaced People,300,350,500,600,1750,262,285,419,378,1344
64,Yemen,2019,YEM-19/3420/SA1/FSAC/NGO/11944,8/26/2020 6:50:50 AM,Overall,1200,1450,2000,2350,7000,1499,1693,2242,1963,7397
64,Yemen,2019,YEM-19/3420/SA1/FSAC/NGO/11993,6/10/2020 8:32:25 AM,Internally Displaced People,774,743,137,131,1785,774,743,137,131,1785
64,Yemen,2019,YEM-19/3420/SA1/FSAC/NGO/11993,6/10/2020 8:32:25 AM,Overall,774,743,137,131,1785,774,743,137,131,1785
64,Yemen,2019,YEM-19/3420/SA1/FSAC-Health/NGO/11920,5/21/2020 8:33:32 AM,Internally Displaced People,1927,1951,2644,3183,9705,7947,18162,8168,8282,42559
64,Yemen,2019,YEM-19/3420/SA1/FSAC-Health/NGO/11920,5/21/2020 8:33:32 AM,Overall,1927,1951,2644,3183,9705,7947,18162,8168,8282,42559
64,Yemen,2019,YEM-19/3420/SA1/FSAC-Health-Nutrition-WASH/NGO/11853,8/10/2020 10:52:43 AM,Host Communities,447,465,670,698,2280,2531,4442,3314,2894,13181
64,Yemen,2019,YEM-19/3420/SA1/FSAC-Health-Nutrition-WASH/NGO/11853,8/10/2020 10:52:43 AM,Internally Displaced People,2235,2326,3353,3489,11403,2554,2713,3846,3901,13014
64,Yemen,2019,YEM-19/3420/SA1/FSAC-Health-Nutrition-WASH/NGO/11853,8/10/2020 10:52:43 AM,Overall,2682,2791,4023,4187,13683,5085,7155,7160,6795,26195
64,Yemen,2019,YEM-19/3420/SA1/FSAC-WASH-Protection/INGO/11996,6/6/2021 6:33:15 PM,Host Communities,5004,6019,5388,5331,21742,6606,6727,6566,6366,26265
64,Yemen,2019,YEM-19/3420/SA1/FSAC-WASH-Protection/INGO/11996,6/6/2021 6:33:15 PM,Internally Displaced People,7616,8768,9746,9278,35408,11884,12476,11869,11399,47628
64,Yemen,2019,YEM-19/3420/SA1/FSAC-WASH-Protection/INGO/11996,6/6/2021 6:33:15 PM,Overall,12620,14787,15134,14609,57150,18490,19203,18435,17765,73893
64,Yemen,2019,YEM-19/3420/SA1/Health/INGO/11878,6/15/2021 1:21:16 PM,Host Communities,9226,14688,11626,12221,47761,6523,10877,3464,2798,23662
64,Yemen,2019,YEM-19/3420/SA1/Health/INGO/11878,6/15/2021 1:21:16 PM,Overall,9226,14688,11626,12221,47761,6523,10877,3464,2798,23662
64,Yemen,2019,YEM-19/3420/SA1/Health/NGO/11945,5/18/2020 11:03:32 AM,Host Communities,1968,2008,844,860,5680,7507,13683,5804,6065,33059
64,Yemen,2019,YEM-19/3420/SA1/Health/NGO/11945,5/18/2020 11:03:32 AM,Internally Displaced People,678,690,290,296,1954,7156,11195,6364,6623,31338
64,Yemen,2019,YEM-19/3420/SA1/Health/NGO/11945,5/18/2020 11:03:32 AM,Overall,2646,2698,1134,1156,7634,14663,24878,12168,12688,64397
64,Yemen,2019,YEM-19/3420/SA1/Health/NGO/11948,8/26/2020 5:57:40 AM,Host Communities,11589,17383,14485,14485,57942,9256,9801,13514,11530,44101
64,Yemen,2019,YEM-19/3420/SA1/Health/NGO/11948,8/26/2020 5:57:40 AM,Internally Displaced People,2060,3068,2556,2556,10240,6770,7342,8379,7847,30338
64,Yemen,2019,YEM-19/3420/SA1/Health/NGO/11948,8/26/2020 5:57:40 AM,Overall,13649,20451,17041,17041,68182,16026,17143,21893,19377,74439
64,Yemen,2019,YEM-19/3420/SA1/Health/NGO/11950,7/26/2020 5:54:50 AM,Host Communities,6806,11610,9850,9765,38031,16235,15968,13625,12245,58073
64,Yemen,2019,YEM-19/3420/SA1/Health/NGO/11950,7/26/2020 5:54:50 AM,Overall,6806,11610,9850,9765,38031,16235,15968,13625,12245,58073
64,Yemen,2019,YEM-19/3420/SA1/Health/NGO/12005,6/23/2020 7:01:37 AM,Host Communities,6823,6969,7259,7549,28600,3599,8511,4184,3078,19372
64,Yemen,2019,YEM-19/3420/SA1/Health/NGO/12005,6/23/2020 7:01:37 AM,Internally Displaced People,1002,1023,1066,1109,4200,3781,9428,4590,4298,22097
64,Yemen,2019,YEM-19/3420/SA1/Health/NGO/12005,6/23/2020 7:01:37 AM,Overall,7825,7992,8325,8658,32800,7380,17939,8774,7376,41469
64,Yemen,2019,YEM-19/3420/SA1/Health/O/11833,6/22/2020 12:13:38 PM,Host Communities,5278,33491,25906,25086,89761,22802,96179,35038,34209,188228
64,Yemen,2019,YEM-19/3420/SA1/Health/O/11833,6/22/2020 12:13:38 PM,Internally Displaced People,2262,14353,11102,10752,38469,5793,13722,5338,5453,30306
64,Yemen,2019,YEM-19/3420/SA1/Health/O/11833,6/22/2020 12:13:38 PM,Overall,7540,47844,37008,35838,128230,28595,109901,40376,39662,218534
64,Yemen,2019,YEM-19/3420/SA1/Health/UN/11817,7/22/2020 8:54:39 AM,Host Communities,2417,2749,2636,3186,10988,14527,27916,17757,19471,79671
64,Yemen,2019,YEM-19/3420/SA1/Health/UN/11817,7/22/2020 8:54:39 AM,Internally Displaced People,18131,20603,19779,23899,82412,835,1529,1344,1316,5024
64,Yemen,2019,YEM-19/3420/SA1/Health/UN/11817,7/22/2020 8:54:39 AM,Overall,20548,23352,22415,27085,93400,15362,29445,19101,20787,84695
64,Yemen,2019,YEM-19/3420/SA1/Health/UN/11824,9/13/2020 1:04:31 PM,Host Communities,19496,233100,900,24300,277796,4048,240811,0,22274,267133
64,Yemen,2019,YEM-19/3420/SA1/Health/UN/11824,9/13/2020 1:04:31 PM,Internally Displaced People,2164,25900,100,2700,30864,241,4682,0,719,5642
64,Yemen,2019,YEM-19/3420/SA1/Health/UN/11824,9/13/2020 1:04:31 PM,Overall,21660,259000,1000,27000,308660,4289,245493,0,22993,272775
64,Yemen,2019,YEM-19/3420/SA1/Health/UN/11979,5/4/2021 7:48:11 AM,Host Communities,50264,52438,50434,53357,206493,73550,85163,112261,116132,387106
64,Yemen,2019,YEM-19/3420/SA1/Health/UN/11979,5/4/2021 7:48:11 AM,Internally Displaced People,8446,8780,7480,7800,32506,12979,15029,19811,20494,68313
64,Yemen,2019,YEM-19/3420/SA1/Health/UN/11979,5/4/2021 7:48:11 AM,Overall,58710,61218,57914,61157,238999,86529,100192,132072,136626,455419
64,Yemen,2019,YEM-19/3420/SA1/Health-FSAC-WASH-Protection/INGO/11941,1/21/2021 8:49:57 AM,Internally Displaced People,6313,6454,6962,7268,26997,1116,1270,1349,1453,5188
64,Yemen,2019,YEM-19/3420/SA1/Health-FSAC-WASH-Protection/INGO/11941,1/21/2021 8:49:57 AM,Overall,6313,6454,6962,7268,26997,1116,1270,1349,1453,5188
64,Yemen,2019,YEM-19/3420/SA1/Health-Nutrition-Education-SHNFICCM/NGO/11917,9/23/2020 11:42:24 AM,Host Communities,14825,16235,2123,2522,35705,28913,42242,6010,5787,82952
64,Yemen,2019,YEM-19/3420/SA1/Health-Nutrition-Education-SHNFICCM/NGO/11917,9/23/2020 11:42:24 AM,Internally Displaced People,1771,1844,2656,2767,9038,6142,7874,5469,5498,24983
64,Yemen,2019,YEM-19/3420/SA1/Health-Nutrition-Education-SHNFICCM/NGO/11917,9/23/2020 11:42:24 AM,Overall,16596,18079,4779,5289,44743,35055,50116,11479,11285,107935
64,Yemen,2019,YEM-19/3420/SA1/Health-Nutrition-FSAC-WASH/INGO/11801,1/21/2021 1:29:55 PM,Host Communities,18592,27265,36107,37656,119620,25337,38713,36778,36155,136983
64,Yemen,2019,YEM-19/3420/SA1/Health-Nutrition-FSAC-WASH/INGO/11801,1/21/2021 1:29:55 PM,Internally Displaced People,286,294,594,615,1789,824,465,888,620,2797
64,Yemen,2019,YEM-19/3420/SA1/Health-Nutrition-FSAC-WASH/INGO/11801,1/21/2021 1:29:55 PM,Overall,18878,27559,36701,38271,121409,26161,39178,37666,36775,139780
64,Yemen,2019,YEM-19/3420/SA1/Health-Nutrition-WASH/NGO/11861,9/6/2020 9:02:13 AM,Host Communities,8888,23126,11544,11743,55301,26518,36518,31860,29756,124652
64,Yemen,2019,YEM-19/3420/SA1/Health-Nutrition-WASH/NGO/11861,9/6/2020 9:02:13 AM,Internally Displaced People,2221,5781,2885,2935,13822,5385,5014,3963,3699,18061
64,Yemen,2019,YEM-19/3420/SA1/Health-Nutrition-WASH/NGO/11861,9/6/2020 9:02:13 AM,Overall,11109,28907,14429,14678,69123,31903,41532,35823,33455,142713
64,Yemen,2019,YEM-19/3420/SA1/Health-Nutrition-WASH/NGO/11908,8/12/2020 8:50:47 AM,Host Communities,4264,7069,7885,8567,27785,4216,7656,8019,7881,27772
64,Yemen,2019,YEM-19/3420/SA1/Health-Nutrition-WASH/NGO/11908,8/12/2020 8:50:47 AM,Internally Displaced People,716,830,658,658,2862,643,793,710,707,2853
64,Yemen,2019,YEM-19/3420/SA1/Health-Nutrition-WASH/NGO/11908,8/12/2020 8:50:47 AM,Overall,5972,9050,9456,10138,34616,5588,9234,9605,9732,34159
64,Yemen,2019,YEM-19/3420/SA1/Health-Nutrition-WASH/NGO/11908,8/12/2020 8:50:47 AM,Returnees,992,1151,913,913,3969,729,785,876,1144,3534
64,Yemen,2019,YEM-19/3420/SA1/Health-Nutrition-WASH/NGO/11926,9/28/2020 9:42:12 AM,Host Communities,8718,24416,12515,11817,57466,12426,19974,12917,11640,56957
64,Yemen,2019,YEM-19/3420/SA1/Health-Nutrition-WASH/NGO/11926,9/28/2020 9:42:12 AM,Internally Displaced People,444,1216,686,692,3038,1822,2831,1710,2395,8758
64,Yemen,2019,YEM-19/3420/SA1/Health-Nutrition-WASH/NGO/11926,9/28/2020 9:42:12 AM,Overall,9162,25632,13201,12509,60504,14248,22805,14627,14035,65715
64,Yemen,2019,YEM-19/3420/SA1/Nutrition/INGO/11974,9/22/2020 11:52:09 AM,Host Communities,0,1490,31046,29766,62302,23,605,770,804,2202
64,Yemen,2019,YEM-19/3420/SA1/Nutrition/INGO/11974,9/22/2020 11:52:09 AM,Internally Displaced People,0,1400,1194,1209,3803,0,2617,0,0,2617
64,Yemen,2019,YEM-19/3420/SA1/Nutrition/INGO/11974,9/22/2020 11:52:09 AM,Overall,0,2890,32240,30975,66105,23,3222,770,804,4819
64,Yemen,2019,YEM-19/3420/SA1/Nutrition-Health-WASH/NGO/11804,11/22/2020 12:00:19 PM,Host Communities,23569,24767,13961,13271,75568,22785,29093,19536,19092,90506
64,Yemen,2019,YEM-19/3420/SA1/Nutrition-Health-WASH/NGO/11804,11/22/2020 12:00:19 PM,Internally Displaced People,2961,3080,1698,1610,9349,2886,3160,1872,2435,10353
64,Yemen,2019,YEM-19/3420/SA1/Nutrition-Health-WASH/NGO/11804,11/22/2020 12:00:19 PM,Overall,26530,27847,15659,14881,84917,25671,32253,21408,21527,100859
64,Yemen,2019,YEM-19/3420/SA1/Protection/INGO/11821,2/22/2021 6:51:44 AM,Host Communities,266,100,24,10,400,621,220,94,28,963
64,Yemen,2019,YEM-19/3420/SA1/Protection/INGO/11821,2/22/2021 6:51:44 AM,Internally Displaced People,267,100,24,10,401,97,40,12,5,154
64,Yemen,2019,YEM-19/3420/SA1/Protection/INGO/11821,2/22/2021 6:51:44 AM,Overall,799,300,71,30,1200,736,269,120,34,1159
64,Yemen,2019,YEM-19/3420/SA1/Protection/INGO/11821,2/22/2021 6:51:44 AM,Returnees,266,100,23,10,399,18,9,14,1,42
64,Yemen,2019,YEM-19/3420/SA1/Protection/INGO/11863,10/15/2020 8:51:57 AM,Host Communities,1406,2109,352,527,4394,1143,1363,18,24,2548
64,Yemen,2019,YEM-19/3420/SA1/Protection/INGO/11863,10/15/2020 8:51:57 AM,Internally Displaced People,3281,4922,819,1230,10252,1942,1362,24,34,3362
64,Yemen,2019,YEM-19/3420/SA1/Protection/INGO/11863,10/15/2020 8:51:57 AM,Overall,4687,7031,1171,1757,14646,3085,2725,42,58,5910
64,Yemen,2019,YEM-19/3420/SA1/Protection/O/11864,9/1/2020 7:28:41 AM,Internally Displaced People,3271,3351,5180,5680,17482,6922,5505,6949,6560,25936
64,Yemen,2019,YEM-19/3420/SA1/Protection/O/11864,9/1/2020 7:28:41 AM,Overall,3271,3351,5180,5680,17482,6922,5505,6949,6560,25936
64,Yemen,2019,YEM-19/3420/SA1/Protection/UN/11977,12/16/2020 5:08:18 PM,Host Communities,0,1000,0,250,1250,0,1000,0,250,1250
64,Yemen,2019,YEM-19/3420/SA1/Protection/UN/11977,12/16/2020 5:08:18 PM,Internally Displaced People,1000,10644,250,3631,15525,1000,10644,250,3631,15525
64,Yemen,2019,YEM-19/3420/SA1/Protection/UN/11977,12/16/2020 5:08:18 PM,Overall,1000,11644,250,3881,16775,1000,11644,250,3881,16775
64,Yemen,2019,YEM-19/3420/SA1/Protection-SHNFICCM/UN/11912,1/26/2021 12:22:27 PM,Internally Displaced People,5104,5313,5103,5317,20837,14321,15569,12228,13148,55266
64,Yemen,2019,YEM-19/3420/SA1/Protection-SHNFICCM/UN/11912,1/26/2021 12:22:27 PM,Overall,5104,5313,5103,5317,20837,14321,15569,12228,13148,55266
64,Yemen,2019,YEM-19/3420/SA1/RRM/UN/11837,1/31/2020 7:43:35 PM,Internally Displaced People,86400,95040,51840,54720,288000,86400,95040,51840,54720,288000
64,Yemen,2019,YEM-19/3420/SA1/RRM/UN/11837,1/31/2020 7:43:35 PM,Overall,86400,95040,51840,54720,288000,86400,95040,51840,54720,288000
64,Yemen,2019,YEM-19/3420/SA1/RRM/UN/12000,3/30/2020 9:22:21 AM,Internally Displaced People,86400,95040,51840,54720,288000,84000,92400,50400,53200,280000
64,Yemen,2019,YEM-19/3420/SA1/RRM/UN/12000,3/30/2020 9:22:21 AM,Overall,86400,95040,51840,54720,288000,84000,92400,50400,53200,280000
64,Yemen,2019,YEM-19/3420/SA1/SHNFICCM/NGO/11815,5/17/2020 8:26:34 PM,Host Communities,5008,4834,4992,4457,19291,3196,3405,3591,3227,13419
64,Yemen,2019,YEM-19/3420/SA1/SHNFICCM/NGO/11815,5/17/2020 8:26:34 PM,Internally Displaced People,586,663,764,781,2794,830,869,1019,914,3632
64,Yemen,2019,YEM-19/3420/SA1/SHNFICCM/NGO/11815,5/17/2020 8:26:34 PM,Overall,5594,5497,5756,5238,22085,4026,4274,4610,4141,17051
64,Yemen,2019,YEM-19/3420/SA1/SHNFICCM/UN/11916,6/24/2020 8:46:37 AM,Internally Displaced People,2087,2371,2276,2751,9485,2466,2690,4110,3718,12984
64,Yemen,2019,YEM-19/3420/SA1/SHNFICCM/UN/11916,6/24/2020 8:46:37 AM,Overall,2087,2371,2276,2751,9485,2466,2690,4110,3718,12984
64,Yemen,2019,YEM-19/3420/SA1/SHNFICCM-FSAC-WASH-Protection/NGO/11882,6/22/2020 8:28:59 AM,Internally Displaced People,2830,3015,5072,5268,16185,2613,2866,5033,4959,15471
64,Yemen,2019,YEM-19/3420/SA1/SHNFICCM-FSAC-WASH-Protection/NGO/11882,6/22/2020 8:28:59 AM,Overall,2830,3015,5072,5268,16185,2613,2866,5033,4959,15471
64,Yemen,2019,YEM-19/3420/SA1/WASH/INGO/11823,11/9/2020 7:01:53 AM,Host Communities,3899,3699,4664,4398,16660,4239,4021,5139,4832,18231
64,Yemen,2019,YEM-19/3420/SA1/WASH/INGO/11823,11/9/2020 7:01:53 AM,Internally Displaced People,1365,1295,1633,1539,5832,634,601,759,715,2709
64,Yemen,2019,YEM-19/3420/SA1/WASH/INGO/11823,11/9/2020 7:01:53 AM,Overall,6882,6529,8234,7762,29407,5960,5655,7228,6775,25618
64,Yemen,2019,YEM-19/3420/SA1/WASH/INGO/11823,11/9/2020 7:01:53 AM,Returnees,1618,1535,1937,1825,6915,1087,1033,1330,1228,4678
64,Yemen,2019,YEM-19/3420/SA1/WASH/INGO/11830,6/7/2020 10:58:21 AM,Host Communities,300,300,600,600,1800,1314,1355,2435,2197,7301
64,Yemen,2019,YEM-19/3420/SA1/WASH/INGO/11830,6/7/2020 10:58:21 AM,Internally Displaced People,1000,1000,1700,1700,5400,468,464,938,796,2666
64,Yemen,2019,YEM-19/3420/SA1/WASH/INGO/11830,6/7/2020 10:58:21 AM,Overall,1600,1600,2900,2900,9000,1787,1825,3384,3002,9998
64,Yemen,2019,YEM-19/3420/SA1/WASH/INGO/11830,6/7/2020 10:58:21 AM,Returnees,300,300,600,600,1800,5,6,11,9,31
64,Yemen,2019,YEM-19/3420/SA1/WASH/INGO/11858,10/27/2020 12:15:33 PM,Host Communities,3400,3700,3600,3900,14600,13331,13875,13875,14441,55522
64,Yemen,2019,YEM-19/3420/SA1/WASH/INGO/11858,10/27/2020 12:15:33 PM,Internally Displaced People,8591,8942,8942,9307,35782,5977,6193,6221,6446,24837
64,Yemen,2019,YEM-19/3420/SA1/WASH/INGO/11858,10/27/2020 12:15:33 PM,Overall,13071,13767,13667,14377,54882,19309,20068,20096,20887,80360
64,Yemen,2019,YEM-19/3420/SA1/WASH/INGO/11858,10/27/2020 12:15:33 PM,Returnees,1080,1125,1125,1170,4500,1,0,0,0,1
64,Yemen,2019,YEM-19/3420/SA1/WASH/INGO/11883,12/2/2020 5:17:05 AM,Host Communities,1944,2224,1936,2059,8163,2041,2125,2030,1967,8163
64,Yemen,2019,YEM-19/3420/SA1/WASH/INGO/11883,12/2/2020 5:17:05 AM,Internally Displaced People,224,256,223,237,940,235,245,234,226,940
64,Yemen,2019,YEM-19/3420/SA1/WASH/INGO/11883,12/2/2020 5:17:05 AM,Overall,2168,2480,2159,2296,9103,2276,2370,2264,2193,9103
64,Yemen,2019,YEM-19/3420/SA1/WASH/INGO/11905,5/6/2021 9:57:50 AM,Host Communities,1743,1665,1863,1784,7055,12887,12533,10960,10627,47007
64,Yemen,2019,YEM-19/3420/SA1/WASH/INGO/11905,5/6/2021 9:57:50 AM,Internally Displaced People,5396,5155,5767,5527,21845,717,731,783,739,2970
64,Yemen,2019,YEM-19/3420/SA1/WASH/INGO/11905,5/6/2021 9:57:50 AM,Overall,7139,6820,7630,7311,28900,13604,13264,11743,11366,49977
64,Yemen,2019,YEM-19/3420/SA1/WASH/NGO/11803,7/20/2020 6:39:30 AM,Host Communities,686,714,1029,1071,3500,973,1029,1482,1555,5039
64,Yemen,2019,YEM-19/3420/SA1/WASH/NGO/11803,7/20/2020 6:39:30 AM,Internally Displaced People,1772,1844,2657,2765,9038,1770,1844,2656,2765,9035
64,Yemen,2019,YEM-19/3420/SA1/WASH/NGO/11803,7/20/2020 6:39:30 AM,Overall,2458,2558,3686,3836,12538,2743,2873,4138,4320,14074
64,Yemen,2019,YEM-19/3420/SA1/WASH/NGO/11806,3/12/2020 6:44:33 AM,Host Communities,650,900,1600,1850,5000,911,969,927,962,3769
64,Yemen,2019,YEM-19/3420/SA1/WASH/NGO/11806,3/12/2020 6:44:33 AM,Overall,650,900,1600,1850,5000,911,969,927,962,3769
64,Yemen,2019,YEM-19/3420/SA1/WASH/NGO/11829,6/4/2020 7:31:28 PM,Host Communities,4722,5295,3902,5351,19270,5733,5907,6934,6981,25555
64,Yemen,2019,YEM-19/3420/SA1/WASH/NGO/11829,6/4/2020 7:31:28 PM,Internally Displaced People,1947,2055,1096,1272,6370,1380,1269,1575,1521,5745
64,Yemen,2019,YEM-19/3420/SA1/WASH/NGO/11829,6/4/2020 7:31:28 PM,Overall,6669,7350,4998,6623,25640,7113,7176,8509,8502,31300
64,Yemen,2019,YEM-19/3420/SA1/WASH/NGO/11843,1/31/2021 7:40:01 AM,Other,17511,21680,21680,22514,83385,20239,25057,25057,26021,96374
64,Yemen,2019,YEM-19/3420/SA1/WASH/NGO/11843,1/31/2021 7:40:01 AM,Overall,17511,21680,21680,22514,83385,20239,25057,25057,26021,96374
64,Yemen,2019,YEM-19/3420/SA1/WASH/NGO/11852,6/4/2020 10:22:24 AM,Host Communities,1509,1572,2263,2357,7701,2195,2892,5854,5147,16088
64,Yemen,2019,YEM-19/3420/SA1/WASH/NGO/11852,6/4/2020 10:22:24 AM,Overall,1509,1572,2263,2357,7701,2195,2892,5854,5147,16088
64,Yemen,2019,YEM-19/3420/SA1/WASH/NGO/11906,1/30/2020 6:58:14 PM,Host Communities,4500,4300,5470,5200,19470,8000,5400,4200,4000,21600
64,Yemen,2019,YEM-19/3420/SA1/WASH/NGO/11906,1/30/2020 6:58:14 PM,Internally Displaced People,2784,2776,3667,3583,12810,6462,6484,8664,9131,30741
64,Yemen,2019,YEM-19/3420/SA1/WASH/NGO/11906,1/30/2020 6:58:14 PM,Overall,7284,7076,9137,8783,32280,14462,11884,12864,13131,52341
64,Yemen,2019,YEM-19/3420/SA1/WASH-Education/INGO/11856,10/26/2020 8:03:08 AM,Host Communities,1509,1578,1765,1832,6684,5042,5248,5248,5462,21000
64,Yemen,2019,YEM-19/3420/SA1/WASH-Education/INGO/11856,10/26/2020 8:03:08 AM,Internally Displaced People,770,805,1624,1660,4859,3029,2249,2249,1473,9000
64,Yemen,2019,YEM-19/3420/SA1/WASH-Education/INGO/11856,10/26/2020 8:03:08 AM,Overall,3079,3221,4322,4463,15085,8071,7497,7497,6935,30000
64,Yemen,2019,YEM-19/3420/SA1/WASH-Education/INGO/11856,10/26/2020 8:03:08 AM,Returnees,800,838,933,971,3542,0,0,0,0,0
64,Yemen,2019,YEM-19/3420/SA1/WASH-Education/NGO/11860,7/22/2020 10:41:40 AM,Host Communities,9959,6220,6339,6029,28547,1530,1587,1757,2433,7307
64,Yemen,2019,YEM-19/3420/SA1/WASH-Education/NGO/11860,7/22/2020 10:41:40 AM,Internally Displaced People,4501,3536,3963,3888,15888,11323,13994,14475,18797,58589
64,Yemen,2019,YEM-19/3420/SA1/WASH-Education/NGO/11860,7/22/2020 10:41:40 AM,Overall,14460,9756,10302,9917,44435,12853,15581,16232,21230,65896
64,Yemen,2019,YEM-19/3420/SA1/WASH-FSAC/NGO/11797,7/1/2020 8:46:44 AM,Host Communities,2567,2536,2550,2347,10000,2161,4084,5463,3987,15695
64,Yemen,2019,YEM-19/3420/SA1/WASH-FSAC/NGO/11797,7/1/2020 8:46:44 AM,Overall,2567,2536,2550,2347,10000,2161,4084,5463,3987,15695
64,Yemen,2019,YEM-19/3420/SA1/WASH-FSAC-Education/INGO/11800,4/7/2021 12:27:29 PM,Host Communities,140751,154783,187140,175053,657727,21641,12429,28907,33739,96716
64,Yemen,2019,YEM-19/3420/SA1/WASH-FSAC-Education/INGO/11800,4/7/2021 12:27:29 PM,Internally Displaced People,14428,12882,20688,23586,71584,14428,8286,19271,22492,64477
64,Yemen,2019,YEM-19/3420/SA1/WASH-FSAC-Education/INGO/11800,4/7/2021 12:27:29 PM,Overall,158901,171100,212515,202611,745127,36071,20717,48180,56233,161201
64,Yemen,2019,YEM-19/3420/SA1/WASH-FSAC-Education/INGO/11800,4/7/2021 12:27:29 PM,Returnees,3722,3435,4687,3972,15816,2,2,2,2,8
64,Yemen,2019,YEM-19/3420/SA1/WASH-FSAC-Health/NGO/11809,7/5/2020 9:33:43 AM,Host Communities,5320,5537,7979,8314,27150,8384,10285,6854,6641,32164
64,Yemen,2019,YEM-19/3420/SA1/WASH-FSAC-Health/NGO/11809,7/5/2020 9:33:43 AM,Overall,5320,5537,7979,8314,27150,8384,10285,6854,6641,32164
64,Yemen,2019,YEM-19/3420/SA1/WASH-Health/NGO/11813,8/10/2020 10:38:49 AM,Host Communities,22205,22936,20517,24007,89665,37731,32632,27729,27221,125313
64,Yemen,2019,YEM-19/3420/SA1/WASH-Health/NGO/11813,8/10/2020 10:38:49 AM,Internally Displaced People,3670,3976,3517,4128,15291,3946,3703,3728,4208,15585
64,Yemen,2019,YEM-19/3420/SA1/WASH-Health/NGO/11813,8/10/2020 10:38:49 AM,Overall,25875,26912,24034,28135,104956,41677,36335,31457,31429,140898
64,Yemen,2019,YEM-19/3420/SA1/WASH-Health/NGO/11868,9/2/2020 8:05:59 AM,Host Communities,7899,8318,11875,12453,40545,10346,20636,7746,6166,44894
64,Yemen,2019,YEM-19/3420/SA1/WASH-Health/NGO/11868,9/2/2020 8:05:59 AM,Internally Displaced People,608,701,775,789,2873,1052,1535,1146,915,4648
64,Yemen,2019,YEM-19/3420/SA1/WASH-Health/NGO/11868,9/2/2020 8:05:59 AM,Overall,8507,9019,12650,13242,43418,11398,22171,8892,7081,49542
64,Yemen,2019,YEM-19/3420/SA2/CCM/INGO/14591,8/9/2021 12:11:32 PM,Internally Displaced People,373,374,373,374,1494,509,551,539,591,2190
64,Yemen,2019,YEM-19/3420/SA2/CCM/INGO/14591,8/9/2021 12:11:32 PM,Other,124,124,124,124,496,124,124,124,124,496
64,Yemen,2019,YEM-19/3420/SA2/CCM/INGO/14591,8/9/2021 12:11:32 PM,Overall,497,498,497,498,1990,633,675,663,715,2686
64,Yemen,2019,YEM-19/3420/SA2/CCM/NGO/14573,4/12/2021 8:18:59 AM,Internally Displaced People,609,581,638,688,2516,905,1043,1625,1482,5055
64,Yemen,2019,YEM-19/3420/SA2/CCM/NGO/14573,4/12/2021 8:18:59 AM,Overall,609,581,638,688,2516,905,1043,1625,1482,5055
64,Yemen,2019,YEM-19/3420/SA2/CCM/NGO/14574,1/25/2021 11:02:19 AM,Host Communities,4813,4692,4728,4275,18508,2605,2822,2740,2425,10592
64,Yemen,2019,YEM-19/3420/SA2/CCM/NGO/14574,1/25/2021 11:02:19 AM,Internally Displaced People,563,595,811,768,2737,819,852,1054,972,3697
64,Yemen,2019,YEM-19/3420/SA2/CCM/NGO/14574,1/25/2021 11:02:19 AM,Overall,5376,5287,5539,5043,21245,3424,3674,3794,3397,14289
64,Yemen,2019,YEM-19/3420/SA2/CCM/NGO/14730,5/19/2021 11:39:43 AM,Internally Displaced People,2936,3057,4405,4582,14980,2959,3049,2952,3190,12150
64,Yemen,2019,YEM-19/3420/SA2/CCM/NGO/14730,5/19/2021 11:39:43 AM,Overall,2936,3057,4405,4582,14980,2959,3049,2952,3190,12150
64,Yemen,2019,YEM-19/3420/SA2/CCM-SHNFI/NGO/14613,6/23/2021 5:43:06 AM,Host Communities,650,755,573,624,2602,243,290,237,260,1030
64,Yemen,2019,YEM-19/3420/SA2/CCM-SHNFI/NGO/14613,6/23/2021 5:43:06 AM,Internally Displaced People,3072,3365,4242,3950,14629,1334,1321,2168,2127,6950
64,Yemen,2019,YEM-19/3420/SA2/CCM-SHNFI/NGO/14613,6/23/2021 5:43:06 AM,Overall,3722,4120,4815,4574,17231,1577,1611,2405,2387,7980
64,Yemen,2019,YEM-19/3420/SA2/CCM-SHNFI-Health/NGO/14610,8/5/2021 7:03:29 AM,Host Communities,7739,7483,6592,6375,28189,5812,10412,9319,9705,35248
64,Yemen,2019,YEM-19/3420/SA2/CCM-SHNFI-Health/NGO/14610,8/5/2021 7:03:29 AM,Internally Displaced People,4113,3977,3504,3388,14982,4581,5415,5608,5267,20871
64,Yemen,2019,YEM-19/3420/SA2/CCM-SHNFI-Health/NGO/14610,8/5/2021 7:03:29 AM,Overall,11852,11460,10096,9763,43171,10393,15827,14927,14972,56119
64,Yemen,2019,YEM-19/3420/SA2/CCM-SHNFI-WASH/INGO/14762,5/12/2022 6:44:04 AM,Host Communities,4741,5679,6962,8295,25677,1333,1606,1973,2399,7311
64,Yemen,2019,YEM-19/3420/SA2/CCM-SHNFI-WASH/INGO/14762,5/12/2022 6:44:04 AM,Internally Displaced People,13487,14218,17316,16956,61977,16249,13874,19208,19460,68791
64,Yemen,2019,YEM-19/3420/SA2/CCM-SHNFI-WASH/INGO/14762,5/12/2022 6:44:04 AM,Overall,18228,19897,24278,25251,87654,17582,15480,21181,21859,76102
64,Yemen,2019,YEM-19/3420/SA2/CCS/INGO/14657,6/22/2022 6:52:14 AM,Host Communities,3375,3375,3375,3375,13500,9701,6588,7344,7014,30647
64,Yemen,2019,YEM-19/3420/SA2/CCS/INGO/14657,6/22/2022 6:52:14 AM,Other,42,0,0,0,42,85,0,0,0,85
64,Yemen,2019,YEM-19/3420/SA2/CCS/INGO/14657,6/22/2022 6:52:14 AM,Overall,3417,3375,3375,3375,13542,9786,6588,7344,7014,30732
64,Yemen,2019,YEM-19/3420/SA2/CCS/UN/14539,5/18/2022 11:55:55 AM,Host Communities,11875,9523,13668,14264,49330,22393,11790,26180,27409,87772
64,Yemen,2019,YEM-19/3420/SA2/CCS/UN/14539,5/18/2022 11:55:55 AM,Internally Displaced People,106876,117206,123011,132159,479252,157184,175936,184531,204060,721711
64,Yemen,2019,YEM-19/3420/SA2/CCS/UN/14539,5/18/2022 11:55:55 AM,Overall,118751,126729,136679,146423,528582,179577,187726,210711,231469,809483
64,Yemen,2019,YEM-19/3420/SA2/Education/INGO/14563,6/22/2021 8:46:25 AM,Host Communities,150,100,3500,3500,7250,407,140,6338,6032,12917
64,Yemen,2019,YEM-19/3420/SA2/Education/INGO/14563,6/22/2021 8:46:25 AM,Internally Displaced People,250,200,5500,4500,10450,209,92,2720,1910,4931
64,Yemen,2019,YEM-19/3420/SA2/Education/INGO/14563,6/22/2021 8:46:25 AM,Overall,400,300,9000,8000,17700,616,232,9058,7942,17848
64,Yemen,2019,YEM-19/3420/SA2/Education/NGO/14618,6/9/2021 12:33:26 PM,Host Communities,223,104,6571,7440,14338,203,74,7993,8596,16866
64,Yemen,2019,YEM-19/3420/SA2/Education/NGO/14618,6/9/2021 12:33:26 PM,Internally Displaced People,0,0,471,485,956,6,2,718,679,1405
64,Yemen,2019,YEM-19/3420/SA2/Education/NGO/14618,6/9/2021 12:33:26 PM,Overall,223,104,7042,7925,15294,209,76,8711,9275,18271
64,Yemen,2019,YEM-19/3420/SA2/Education/NGO/14619,3/28/2021 3:34:19 PM,Host Communities,30,30,1002,1610,2672,31,34,1846,3672,5583
64,Yemen,2019,YEM-19/3420/SA2/Education/NGO/14619,3/28/2021 3:34:19 PM,Internally Displaced People,10,10,1411,2226,3657,6,9,1295,1741,3051
64,Yemen,2019,YEM-19/3420/SA2/Education/NGO/14619,3/28/2021 3:34:19 PM,Overall,40,40,2413,3836,6329,37,43,3141,5413,8634
64,Yemen,2019,YEM-19/3420/SA2/Education/NGO/14640,10/4/2021 9:26:20 AM,Host Communities,95,18,1903,1582,3598,223,76,2800,2114,5213
64,Yemen,2019,YEM-19/3420/SA2/Education/NGO/14640,10/4/2021 9:26:20 AM,Internally Displaced People,0,0,173,87,260,2,1,41,24,68
64,Yemen,2019,YEM-19/3420/SA2/Education/NGO/14640,10/4/2021 9:26:20 AM,Overall,95,18,2076,1669,3858,225,77,2841,2138,5281
64,Yemen,2019,YEM-19/3420/SA2/Education/NGO/14647,3/18/2021 10:06:18 AM,Host Communities,0,0,3995,6464,10459,0,0,6116,6917,13033
64,Yemen,2019,YEM-19/3420/SA2/Education/NGO/14647,3/18/2021 10:06:18 AM,Internally Displaced People,0,0,434,957,1391,0,0,265,925,1190
64,Yemen,2019,YEM-19/3420/SA2/Education/NGO/14647,3/18/2021 10:06:18 AM,Overall,0,0,4429,7421,11850,0,0,6381,7842,14223
64,Yemen,2019,YEM-19/3420/SA2/Education-FSAC/NGO/14548,5/8/2021 11:29:25 PM,Host Communities,675,436,4400,4559,10070,675,436,4400,4559,10070
64,Yemen,2019,YEM-19/3420/SA2/Education-FSAC/NGO/14548,5/8/2021 11:29:25 PM,Internally Displaced People,38,39,79,68,224,38,39,79,68,224
64,Yemen,2019,YEM-19/3420/SA2/Education-FSAC/NGO/14548,5/8/2021 11:29:25 PM,Overall,1189,898,5351,5509,12947,1189,898,5351,5509,12947
64,Yemen,2019,YEM-19/3420/SA2/Education-FSAC/NGO/14548,5/8/2021 11:29:25 PM,Returnees,476,423,872,882,2653,476,423,872,882,2653
64,Yemen,2019,YEM-19/3420/SA2/Education-SHNFI-WASH-CCM/INGO/14651,1/12/2022 9:12:50 AM,Host Communities,1691,1763,2233,2199,7886,12138,13344,10961,11907,48350
64,Yemen,2019,YEM-19/3420/SA2/Education-SHNFI-WASH-CCM/INGO/14651,1/12/2022 9:12:50 AM,Internally Displaced People,15724,16338,20186,19955,72203,35898,38701,32906,35809,143314
64,Yemen,2019,YEM-19/3420/SA2/Education-SHNFI-WASH-CCM/INGO/14651,1/12/2022 9:12:50 AM,Overall,17415,18101,22419,22154,80089,48036,52045,43867,47716,191664
64,Yemen,2019,YEM-19/3420/SA2/Education-WASH/INGO/14542,9/13/2021 8:31:26 AM,Host Communities,1389,1440,3853,3822,10504,1707,1843,3205,3356,10111
64,Yemen,2019,YEM-19/3420/SA2/Education-WASH/INGO/14542,9/13/2021 8:31:26 AM,Internally Displaced People,891,960,2023,2044,5918,3170,3423,2916,3170,12679
64,Yemen,2019,YEM-19/3420/SA2/Education-WASH/INGO/14542,9/13/2021 8:31:26 AM,Overall,2280,2400,5876,5866,16422,4877,5266,6121,6526,22790
64,Yemen,2019,YEM-19/3420/SA2/FSAC/INGO/14576,2/2/2022 3:06:04 PM,Host Communities,2675,2630,1929,1866,9100,2675,2630,1929,1866,9100
64,Yemen,2019,YEM-19/3420/SA2/FSAC/INGO/14576,2/2/2022 3:06:04 PM,Overall,2675,2630,1929,1866,9100,2675,2630,1929,1866,9100
64,Yemen,2019,YEM-19/3420/SA2/FSAC/INGO/14577,9/1/2021 12:09:26 PM,Host Communities,7633,7023,10533,9923,35112,9036,8859,9241,8605,35741
64,Yemen,2019,YEM-19/3420/SA2/FSAC/INGO/14577,9/1/2021 12:09:26 PM,Overall,10045,9240,13860,13055,46200,9077,8916,9313,8669,35975
64,Yemen,2019,YEM-19/3420/SA2/FSAC/INGO/14577,9/1/2021 12:09:26 PM,Returnees,2412,2217,3327,3132,11088,41,57,72,64,234
64,Yemen,2019,YEM-19/3420/SA2/FSAC/INGO/14593,6/24/2021 6:54:22 AM,Host Communities,3220,2940,4060,3780,14000,1590,1632,2673,2554,8449
64,Yemen,2019,YEM-19/3420/SA2/FSAC/INGO/14593,6/24/2021 6:54:22 AM,Overall,3220,2940,4060,3780,14000,1590,1632,2673,2554,8449
64,Yemen,2019,YEM-19/3420/SA2/FSAC/INGO/14636,6/27/2021 5:58:33 AM,Host Communities,2672,2686,2661,2481,10500,2002,2058,2619,2461,9140
64,Yemen,2019,YEM-19/3420/SA2/FSAC/INGO/14636,6/27/2021 5:58:33 AM,Overall,2672,2686,2661,2481,10500,2002,2058,2619,2461,9140
64,Yemen,2019,YEM-19/3420/SA2/FSAC/INGO/14650,8/10/2021 12:02:27 PM,Host Communities,11431,11928,12922,13419,49700,14282,13796,14951,14598,57627
64,Yemen,2019,YEM-19/3420/SA2/FSAC/INGO/14650,8/10/2021 12:02:27 PM,Overall,11431,11928,12922,13419,49700,14282,13796,14951,14598,57627
64,Yemen,2019,YEM-19/3420/SA2/FSAC/INGO/14668,2/9/2022 9:42:34 AM,Host Communities,757,750,1525,1525,4557,330,236,500,500,1566
64,Yemen,2019,YEM-19/3420/SA2/FSAC/INGO/14668,2/9/2022 9:42:34 AM,Overall,1514,1500,3050,3050,9114,660,473,1000,1000,3133
64,Yemen,2019,YEM-19/3420/SA2/FSAC/INGO/14668,2/9/2022 9:42:34 AM,Returnees,757,750,1525,1525,4557,330,237,500,500,1567
64,Yemen,2019,YEM-19/3420/SA2/FSAC/NGO/14581,6/23/2021 7:37:25 AM,Host Communities,2984,2844,2809,2563,11200,4031,4133,3334,3168,14666
64,Yemen,2019,YEM-19/3420/SA2/FSAC/NGO/14581,6/23/2021 7:37:25 AM,Overall,2984,2844,2809,2563,11200,4031,4133,3334,3168,14666
64,Yemen,2019,YEM-19/3420/SA2/FSAC/NGO/14592,7/24/2021 8:29:15 PM,Host Communities,3187,3743,3327,3603,13860,3637,4068,4059,3869,15633
64,Yemen,2019,YEM-19/3420/SA2/FSAC/NGO/14592,7/24/2021 8:29:15 PM,Overall,3187,3743,3327,3603,13860,3637,4068,4059,3869,15633
64,Yemen,2019,YEM-19/3420/SA2/FSAC/NGO/14607,5/30/2021 12:54:08 PM,Host Communities,1197,1463,1796,2194,6650,10,10,0,0,20
64,Yemen,2019,YEM-19/3420/SA2/FSAC/NGO/14607,5/30/2021 12:54:08 PM,Overall,1197,1463,1796,2194,6650,10,10,0,0,20
64,Yemen,2019,YEM-19/3420/SA2/FSAC/NGO/14633,7/18/2021 6:37:20 AM,Host Communities,3329,3822,3309,3540,14000,3284,3757,5100,4840,16981
64,Yemen,2019,YEM-19/3420/SA2/FSAC/NGO/14633,7/18/2021 6:37:20 AM,Overall,3329,3822,3309,3540,14000,3284,3757,5100,4840,16981
64,Yemen,2019,YEM-19/3420/SA2/FSAC/NGO/14731,5/31/2021 7:04:43 AM,Host Communities,3050,2864,550,536,7000,1482,1597,1349,1336,5764
64,Yemen,2019,YEM-19/3420/SA2/FSAC/NGO/14731,5/31/2021 7:04:43 AM,Overall,3050,2864,550,536,7000,1482,1597,1349,1336,5764
64,Yemen,2019,YEM-19/3420/SA2/FSAC/UN/14776,7/24/2023 12:00:12 PM,Host Communities,31550,36404,84942,89794,242690,51641,51671,67220,64076,234608
64,Yemen,2019,YEM-19/3420/SA2/FSAC/UN/14776,7/24/2023 12:00:12 PM,Overall,31550,36404,84942,89794,242690,51641,51671,67220,64076,234608
64,Yemen,2019,YEM-19/3420/SA2/FSAC-Education/INGO/14663,1/19/2022 1:47:22 PM,Host Communities,11295,13365,19478,21138,65276,10576,10841,14488,17010,52915
64,Yemen,2019,YEM-19/3420/SA2/FSAC-Education/INGO/14663,1/19/2022 1:47:22 PM,Internally Displaced People,3408,3335,5712,5020,17475,63,46,364,510,983
64,Yemen,2019,YEM-19/3420/SA2/FSAC-Education/INGO/14663,1/19/2022 1:47:22 PM,Overall,14703,16700,25190,26158,82751,10639,10887,14852,17520,53898
64,Yemen,2019,YEM-19/3420/SA2/Health/INGO/14541,6/27/2021 5:56:28 AM,Host Communities,32534,33862,27714,28845,122955,32232,37271,34571,28404,132478
64,Yemen,2019,YEM-19/3420/SA2/Health/INGO/14541,6/27/2021 5:56:28 AM,Internally Displaced People,3904,4063,3326,3462,14755,4387,6626,4870,4259,20142
64,Yemen,2019,YEM-19/3420/SA2/Health/INGO/14541,6/27/2021 5:56:28 AM,Overall,36438,37925,31040,32307,137710,36619,43897,39441,32663,152620
64,Yemen,2019,YEM-19/3420/SA2/Health/INGO/14612,3/30/2022 9:54:12 AM,Host Communities,17203,17905,14654,15253,65015,6562,6861,8352,8055,29830
64,Yemen,2019,YEM-19/3420/SA2/Health/INGO/14612,3/30/2022 9:54:12 AM,Internally Displaced People,14367,14953,12238,12737,54295,6562,6861,8352,8055,29830
64,Yemen,2019,YEM-19/3420/SA2/Health/INGO/14612,3/30/2022 9:54:12 AM,Overall,31570,32858,26892,27990,119310,13124,13722,16704,16110,59660
64,Yemen,2019,YEM-19/3420/SA2/Health/INGO/14626,8/10/2021 12:01:09 PM,Host Communities,15654,25616,15654,14231,71155,4629,6815,9288,8743,29475
64,Yemen,2019,YEM-19/3420/SA2/Health/INGO/14626,8/10/2021 12:01:09 PM,Internally Displaced People,5218,8539,5218,4744,23719,514,757,1031,971,3273
64,Yemen,2019,YEM-19/3420/SA2/Health/INGO/14626,8/10/2021 12:01:09 PM,Overall,20872,34155,20872,18975,94874,5143,7572,10319,9714,32748
64,Yemen,2019,YEM-19/3420/SA2/Health/INGO/14706,5/6/2021 9:12:14 AM,Host Communities,23625,24187,3938,4500,56250,11503,23861,20814,21147,77325
64,Yemen,2019,YEM-19/3420/SA2/Health/INGO/14706,5/6/2021 9:12:14 AM,Internally Displaced People,7086,7258,1183,1350,16877,2312,5145,2847,3967,14271
64,Yemen,2019,YEM-19/3420/SA2/Health/INGO/14706,5/6/2021 9:12:14 AM,Overall,30711,31445,5121,5850,73127,13815,29006,23661,25114,91596
64,Yemen,2019,YEM-19/3420/SA2/Health/INGO/14772,6/7/2021 8:13:17 AM,Host Communities,34171,79734,14404,14494,142803,46561,71539,51689,54830,224619
64,Yemen,2019,YEM-19/3420/SA2/Health/INGO/14772,6/7/2021 8:13:17 AM,Internally Displaced People,3231,7540,1159,1206,13136,7744,14405,5752,6652,34553
64,Yemen,2019,YEM-19/3420/SA2/Health/INGO/14772,6/7/2021 8:13:17 AM,Overall,37402,87274,15563,15700,155939,54305,85944,57441,61482,259172
64,Yemen,2019,YEM-19/3420/SA2/Health/NGO/14545,6/28/2021 4:17:50 PM,Host Communities,6160,9100,5400,9700,30360,9468,10958,13252,12962,46640
64,Yemen,2019,YEM-19/3420/SA2/Health/NGO/14545,6/28/2021 4:17:50 PM,Internally Displaced People,2500,3600,2300,4000,12400,217,225,130,147,719
64,Yemen,2019,YEM-19/3420/SA2/Health/NGO/14545,6/28/2021 4:17:50 PM,Overall,8660,12700,7700,13700,42760,9685,11183,13382,13109,47359
64,Yemen,2019,YEM-19/3420/SA2/Health/NGO/14575,6/10/2021 11:55:25 AM,Host Communities,5412,10867,11542,10726,38547,5505,15160,10437,8813,39915
64,Yemen,2019,YEM-19/3420/SA2/Health/NGO/14575,6/10/2021 11:55:25 AM,Internally Displaced People,12627,25356,16235,17095,71313,2013,5104,3060,2926,13103
64,Yemen,2019,YEM-19/3420/SA2/Health/NGO/14575,6/10/2021 11:55:25 AM,Overall,18039,36223,27777,27821,109860,7518,20264,13497,11739,53018
64,Yemen,2019,YEM-19/3420/SA2/Health/NGO/14580,3/23/2021 12:59:27 PM,Host Communities,982,1499,1460,1521,5462,1715,3233,2281,1903,9132
64,Yemen,2019,YEM-19/3420/SA2/Health/NGO/14580,3/23/2021 12:59:27 PM,Internally Displaced People,876,912,1314,1368,4470,548,1004,996,787,3335
64,Yemen,2019,YEM-19/3420/SA2/Health/NGO/14580,3/23/2021 12:59:27 PM,Overall,1858,2411,2774,2889,9932,2263,4237,3277,2690,12467
64,Yemen,2019,YEM-19/3420/SA2/Health/NGO/14588,5/8/2021 11:24:20 PM,Host Communities,15141,15759,22711,23639,77250,27409,45675,24101,23666,120851
64,Yemen,2019,YEM-19/3420/SA2/Health/NGO/14588,5/8/2021 11:24:20 PM,Internally Displaced People,4542,4728,6813,7092,23175,1312,1988,1633,1696,6629
64,Yemen,2019,YEM-19/3420/SA2/Health/NGO/14588,5/8/2021 11:24:20 PM,Overall,19683,20487,29524,30731,100425,28721,47663,25734,25362,127480
64,Yemen,2019,YEM-19/3420/SA2/Health/NGO/14627,6/7/2021 12:32:35 PM,Host Communities,6796,14045,12233,12233,45307,12275,23289,13309,11337,60210
64,Yemen,2019,YEM-19/3420/SA2/Health/NGO/14627,6/7/2021 12:32:35 PM,Internally Displaced People,3991,8249,7184,7184,26608,2406,3534,3196,2787,11923
64,Yemen,2019,YEM-19/3420/SA2/Health/NGO/14627,6/7/2021 12:32:35 PM,Overall,10787,22294,19417,19417,71915,14681,26823,16505,14124,72133
64,Yemen,2019,YEM-19/3420/SA2/Health/NGO/14635,6/10/2021 5:40:40 AM,Host Communities,2830,5585,4902,4829,18146,6763,20023,7185,6682,40653
64,Yemen,2019,YEM-19/3420/SA2/Health/NGO/14635,6/10/2021 5:40:40 AM,Internally Displaced People,1213,2394,2100,2070,7777,187,293,233,192,905
64,Yemen,2019,YEM-19/3420/SA2/Health/NGO/14635,6/10/2021 5:40:40 AM,Overall,4043,7979,7002,6899,25923,6950,20316,7418,6874,41558
64,Yemen,2019,YEM-19/3420/SA2/Health-WASH/NGO/14738,5/31/2021 9:41:42 AM,Host Communities,10470,12145,9214,10051,41880,8380,10026,9305,9393,37104
64,Yemen,2019,YEM-19/3420/SA2/Health-WASH/NGO/14738,5/31/2021 9:41:42 AM,Internally Displaced People,4398,4816,6072,5654,20940,2054,2452,2587,2573,9666
64,Yemen,2019,YEM-19/3420/SA2/Health-WASH/NGO/14738,5/31/2021 9:41:42 AM,Overall,15582,17788,15914,16390,65674,11244,13634,12841,13060,50779
64,Yemen,2019,YEM-19/3420/SA2/Health-WASH/NGO/14738,5/31/2021 9:41:42 AM,Returnees,714,827,628,685,2854,810,1156,949,1094,4009
64,Yemen,2019,YEM-19/3420/SA2/Protection/INGO/14685,8/2/2021 10:45:06 AM,Host Communities,957,1226,594,594,3371,908,1683,731,474,3796
64,Yemen,2019,YEM-19/3420/SA2/Protection/INGO/14685,8/2/2021 10:45:06 AM,Internally Displaced People,1761,2249,1078,1078,6166,2216,2638,631,798,6283
64,Yemen,2019,YEM-19/3420/SA2/Protection/INGO/14685,8/2/2021 10:45:06 AM,Overall,3190,4086,1979,1979,11234,3128,4328,1363,1272,10091
64,Yemen,2019,YEM-19/3420/SA2/Protection/INGO/14685,8/2/2021 10:45:06 AM,Returnees,472,611,307,307,1697,4,7,1,0,12
64,Yemen,2019,YEM-19/3420/SA2/Protection/INGO/14686,10/25/2021 6:09:09 PM,Host Communities,658,730,170,159,1717,333,633,265,208,1439
64,Yemen,2019,YEM-19/3420/SA2/Protection/INGO/14686,10/25/2021 6:09:09 PM,Internally Displaced People,634,712,164,153,1663,728,673,449,351,2201
64,Yemen,2019,YEM-19/3420/SA2/Protection/INGO/14686,10/25/2021 6:09:09 PM,Other,24,28,7,7,66,2,2,5,6,15
64,Yemen,2019,YEM-19/3420/SA2/Protection/INGO/14686,10/25/2021 6:09:09 PM,Overall,1410,1584,362,339,3695,1063,1308,719,565,3655
64,Yemen,2019,YEM-19/3420/SA2/Protection/INGO/14686,10/25/2021 6:09:09 PM,Refugees,32,41,9,9,91,0,0,0,0,0
64,Yemen,2019,YEM-19/3420/SA2/Protection/INGO/14686,10/25/2021 6:09:09 PM,Returnees,62,73,12,11,158,0,0,0,0,0
64,Yemen,2019,YEM-19/3420/SA2/Protection/INGO/14721,3/4/2021 7:22:54 AM,Host Communities,701,1306,415,415,2837,645,2487,663,879,4674
64,Yemen,2019,YEM-19/3420/SA2/Protection/INGO/14721,3/4/2021 7:22:54 AM,Internally Displaced People,1636,3047,968,968,6619,972,2139,697,703,4511
64,Yemen,2019,YEM-19/3420/SA2/Protection/INGO/14721,3/4/2021 7:22:54 AM,Overall,2337,4353,1383,1383,9456,1617,4626,1360,1582,9185
64,Yemen,2019,YEM-19/3420/SA2/Protection/UN/14764,4/9/2021 9:05:38 PM,Host Communities,0,32055,0,8010,40065,0,55143,0,33540,88683
64,Yemen,2019,YEM-19/3420/SA2/Protection/UN/14764,4/9/2021 9:05:38 PM,Internally Displaced People,0,32055,0,8010,40065,0,45011,0,24324,69335
64,Yemen,2019,YEM-19/3420/SA2/Protection/UN/14764,4/9/2021 9:05:38 PM,Overall,0,64110,0,16020,80130,0,100154,0,57864,158018
64,Yemen,2019,YEM-19/3420/SA2/Protection/UN/14778,3/2/2022 7:54:39 AM,Host Communities,55200,52800,67200,64800,240000,55200,52800,67200,64800,240000
64,Yemen,2019,YEM-19/3420/SA2/Protection/UN/14778,3/2/2022 7:54:39 AM,Overall,55200,52800,67200,64800,240000,55200,52800,67200,64800,240000
64,Yemen,2019,YEM-19/3420/SA2/RRM/UN/14765,1/29/2021 11:10:42 AM,Internally Displaced People,30000,60000,30000,60000,180000,30000,60000,30000,60000,180000
64,Yemen,2019,YEM-19/3420/SA2/RRM/UN/14765,1/29/2021 11:10:42 AM,Overall,30000,60000,30000,60000,180000,30000,60000,30000,60000,180000
64,Yemen,2019,YEM-19/3420/SA2/SHNFI/NGO/14620,3/18/2021 11:58:26 AM,Host Communities,407,222,234,370,1233,92,71,109,99,371
64,Yemen,2019,YEM-19/3420/SA2/SHNFI/NGO/14620,3/18/2021 11:58:26 AM,Internally Displaced People,1626,887,936,1478,4927,1337,924,1563,1339,5163
64,Yemen,2019,YEM-19/3420/SA2/SHNFI/NGO/14620,3/18/2021 11:58:26 AM,Overall,2033,1109,1170,1848,6160,1429,995,1672,1438,5534
64,Yemen,2019,YEM-19/3420/SA2/SHNFI/NGO/14677,2/24/2021 12:09:49 PM,Host Communities,2311,2225,2054,1956,8546,1450,1805,1736,1565,6556
64,Yemen,2019,YEM-19/3420/SA2/SHNFI/NGO/14677,2/24/2021 12:09:49 PM,Internally Displaced People,5392,5192,4793,4564,19941,4830,5961,7109,6720,24620
64,Yemen,2019,YEM-19/3420/SA2/SHNFI/NGO/14677,2/24/2021 12:09:49 PM,Overall,7703,7417,6847,6520,28487,6280,7766,8845,8285,31176
64,Yemen,2019,YEM-19/3420/SA2/SHNFI/NGO/14746,3/18/2021 8:06:58 AM,Host Communities,630,787,725,1008,3150,285,298,442,480,1505
64,Yemen,2019,YEM-19/3420/SA2/SHNFI/NGO/14746,3/18/2021 8:06:58 AM,Internally Displaced People,2310,2888,2656,3696,11550,2667,2847,4928,5044,15486
64,Yemen,2019,YEM-19/3420/SA2/SHNFI/NGO/14746,3/18/2021 8:06:58 AM,Overall,2940,3675,3381,4704,14700,2952,3145,5370,5524,16991
64,Yemen,2019,YEM-19/3420/SA2/SHNFI/NGO/14760,5/31/2021 12:09:23 PM,Host Communities,1512,1488,1503,1378,5881,1553,1719,2405,2185,7862
64,Yemen,2019,YEM-19/3420/SA2/SHNFI/NGO/14760,5/31/2021 12:09:23 PM,Internally Displaced People,3526,3472,3507,3214,13719,2078,2461,3381,3021,10941
64,Yemen,2019,YEM-19/3420/SA2/SHNFI/NGO/14760,5/31/2021 12:09:23 PM,Overall,5038,4960,5010,4592,19600,3631,4180,5786,5206,18803
64,Yemen,2019,YEM-19/3420/SA2/SHNFI/O/14596,3/7/2021 7:21:53 AM,Internally Displaced People,10641,10247,9064,9458,39410,8163,8403,11212,10694,38472
64,Yemen,2019,YEM-19/3420/SA2/SHNFI/O/14596,3/7/2021 7:21:53 AM,Overall,10641,10247,9064,9458,39410,8163,8403,11212,10694,38472
64,Yemen,2019,YEM-19/3420/SA2/SHNFI/O/14597,3/7/2021 7:26:15 AM,Internally Displaced People,2835,2730,2520,2415,10500,2697,2806,3565,2984,12052
64,Yemen,2019,YEM-19/3420/SA2/SHNFI/O/14597,3/7/2021 7:26:15 AM,Overall,2835,2730,2520,2415,10500,2697,2806,3565,2984,12052
64,Yemen,2019,YEM-19/3420/SA2/SHNFI/O/14614,2/9/2021 8:02:53 AM,Host Communities,627,603,555,534,2319,450,504,650,635,2239
64,Yemen,2019,YEM-19/3420/SA2/SHNFI/O/14614,2/9/2021 8:02:53 AM,Internally Displaced People,3342,3219,2973,2847,12381,3396,3602,5190,4957,17145
64,Yemen,2019,YEM-19/3420/SA2/SHNFI/O/14614,2/9/2021 8:02:53 AM,Overall,3969,3822,3528,3381,14700,3846,4106,5840,5592,19384
64,Yemen,2019,YEM-19/3420/SA2/SHNFI-CCM/NGO/14595,6/9/2021 11:22:59 AM,Host Communities,446,292,278,524,1540,316,340,366,404,1426
64,Yemen,2019,YEM-19/3420/SA2/SHNFI-CCM/NGO/14595,6/9/2021 11:22:59 AM,Internally Displaced People,2967,1944,1845,3485,10241,1158,1252,1556,1481,5447
64,Yemen,2019,YEM-19/3420/SA2/SHNFI-CCM/NGO/14595,6/9/2021 11:22:59 AM,Overall,3413,2236,2123,4009,11781,1474,1592,1922,1885,6873
64,Yemen,2019,YEM-19/3420/SA2/SHNFI-CCM/NGO/14630,3/29/2021 9:21:17 AM,Host Communities,779,510,485,914,2688,527,624,543,634,2328
64,Yemen,2019,YEM-19/3420/SA2/SHNFI-CCM/NGO/14630,3/29/2021 9:21:17 AM,Internally Displaced People,4332,2840,2694,5087,14953,3392,3913,3768,4062,15135
64,Yemen,2019,YEM-19/3420/SA2/SHNFI-CCM/NGO/14630,3/29/2021 9:21:17 AM,Overall,5111,3350,3179,6001,17641,3919,4537,4311,4696,17463
64,Yemen,2019,YEM-19/3420/SA2/SHNFI-Protection-CCM/UN/14649,6/10/2021 12:42:40 PM,Host Communities,9813,7530,3848,3901,25092,10785,8296,4148,4424,27653
64,Yemen,2019,YEM-19/3420/SA2/SHNFI-Protection-CCM/UN/14649,6/10/2021 12:42:40 PM,Internally Displaced People,88409,67674,34629,35113,225825,87258,67122,33561,35798,223739
64,Yemen,2019,YEM-19/3420/SA2/SHNFI-Protection-CCM/UN/14649,6/10/2021 12:42:40 PM,Overall,98222,75204,38477,39014,250917,98043,75418,37709,40222,251392
64,Yemen,2019,YEM-19/3420/SA2/SHNFI-WASH/NGO/14615,6/9/2021 8:13:02 PM,Host Communities,2921,3725,3224,3290,13160,3553,3929,2925,2905,13312
64,Yemen,2019,YEM-19/3420/SA2/SHNFI-WASH/NGO/14615,6/9/2021 8:13:02 PM,Internally Displaced People,1017,1188,1054,1081,4340,948,1122,1239,1190,4499
64,Yemen,2019,YEM-19/3420/SA2/SHNFI-WASH/NGO/14615,6/9/2021 8:13:02 PM,Overall,3938,4913,4278,4371,17500,4501,5051,4164,4095,17811
64,Yemen,2019,YEM-19/3420/SA2/WASH/INGO/14536,6/15/2021 2:13:01 PM,Host Communities,4163,4738,4134,4379,17414,4401,4689,5214,5554,19858
64,Yemen,2019,YEM-19/3420/SA2/WASH/INGO/14536,6/15/2021 2:13:01 PM,Internally Displaced People,387,439,385,409,1620,131,110,237,212,690
64,Yemen,2019,YEM-19/3420/SA2/WASH/INGO/14536,6/15/2021 2:13:01 PM,Overall,4550,5177,4519,4788,19034,4532,4799,5451,5766,20548
64,Yemen,2019,YEM-19/3420/SA2/WASH/INGO/14559,4/19/2021 11:24:01 PM,Host Communities,10853,11325,12269,12740,47187,10482,11324,12176,10101,44083
64,Yemen,2019,YEM-19/3420/SA2/WASH/INGO/14559,4/19/2021 11:24:01 PM,Overall,10853,11325,12269,12740,47187,10482,11324,12176,10101,44083
64,Yemen,2019,YEM-19/3420/SA2/WASH/INGO/14569,6/21/2021 10:56:11 AM,Host Communities,6174,6069,4452,4305,21000,7199,7078,4982,5275,24534
64,Yemen,2019,YEM-19/3420/SA2/WASH/INGO/14569,6/21/2021 10:56:11 AM,Internally Displaced People,4116,4046,2968,2870,14000,1444,1420,1039,1060,4963
64,Yemen,2019,YEM-19/3420/SA2/WASH/INGO/14569,6/21/2021 10:56:11 AM,Overall,10290,10115,7420,7175,35000,8643,8498,6021,6335,29497
64,Yemen,2019,YEM-19/3420/SA2/WASH/INGO/14628,7/1/2021 4:57:22 PM,Host Communities,7948,7604,11222,10826,37600,20689,19117,14607,16454,70867
64,Yemen,2019,YEM-19/3420/SA2/WASH/INGO/14628,7/1/2021 4:57:22 PM,Internally Displaced People,5300,5068,4906,4726,20000,8867,8192,6260,7052,30371
64,Yemen,2019,YEM-19/3420/SA2/WASH/INGO/14628,7/1/2021 4:57:22 PM,Overall,13248,12672,16128,15552,57600,29556,27309,20867,23506,101238
64,Yemen,2019,YEM-19/3420/SA2/WASH/INGO/14638,11/7/2021 1:00:32 PM,Host Communities,3731,3589,4948,4430,16698,3517,2677,5515,3991,15700
64,Yemen,2019,YEM-19/3420/SA2/WASH/INGO/14638,11/7/2021 1:00:32 PM,Internally Displaced People,2973,2857,3942,3530,13302,2890,2184,4440,3263,12777
64,Yemen,2019,YEM-19/3420/SA2/WASH/INGO/14638,11/7/2021 1:00:32 PM,Overall,6704,6446,8890,7960,30000,6407,4861,9955,7254,28477
64,Yemen,2019,YEM-19/3420/SA2/WASH/NGO/14537,3/1/2021 9:04:41 AM,Host Communities,53147,34838,33056,62407,183448,56089,36766,34885,65859,193599
64,Yemen,2019,YEM-19/3420/SA2/WASH/NGO/14537,3/1/2021 9:04:41 AM,Internally Displaced People,13503,8851,8398,15855,46607,14248,9339,8861,16730,49178
64,Yemen,2019,YEM-19/3420/SA2/WASH/NGO/14537,3/1/2021 9:04:41 AM,Other,4213,2762,2620,4947,14542,4448,2917,2767,5223,15355
64,Yemen,2019,YEM-19/3420/SA2/WASH/NGO/14537,3/1/2021 9:04:41 AM,Overall,70863,46451,44074,83209,244597,74785,49022,46513,87812,258132
64,Yemen,2019,YEM-19/3420/SA2/WASH/NGO/14538,6/16/2021 10:09:47 AM,Host Communities,67984,84171,84171,87409,323735,68320,84586,84586,87840,325332
64,Yemen,2019,YEM-19/3420/SA2/WASH/NGO/14538,6/16/2021 10:09:47 AM,Internally Displaced People,1984,2457,2457,2551,9449,107,133,133,138,511
64,Yemen,2019,YEM-19/3420/SA2/WASH/NGO/14538,6/16/2021 10:09:47 AM,Overall,69968,86628,86628,89960,333184,68427,84719,84719,87978,325843
64,Yemen,2019,YEM-19/3420/SA2/WASH/NGO/14544,4/14/2021 11:00:31 AM,Host Communities,1933,2016,2899,3022,9870,1912,1977,2847,2954,9690
64,Yemen,2019,YEM-19/3420/SA2/WASH/NGO/14544,4/14/2021 11:00:31 AM,Internally Displaced People,100,100,150,150,500,21,39,52,68,180
64,Yemen,2019,YEM-19/3420/SA2/WASH/NGO/14544,4/14/2021 11:00:31 AM,Overall,2033,2116,3049,3172,10370,1933,2016,2899,3022,9870
64,Yemen,2019,YEM-19/3420/SA2/WASH/NGO/14550,1/24/2021 1:18:23 PM,Host Communities,4235,4408,6352,6617,21612,5890,6125,8924,8392,29331
64,Yemen,2019,YEM-19/3420/SA2/WASH/NGO/14550,1/24/2021 1:18:23 PM,Internally Displaced People,716,745,1074,1119,3654,864,928,1080,1124,3996
64,Yemen,2019,YEM-19/3420/SA2/WASH/NGO/14550,1/24/2021 1:18:23 PM,Overall,4951,5153,7426,7736,25266,6754,7053,10004,9516,33327
64,Yemen,2019,YEM-19/3420/SA2/WASH/NGO/14608,3/1/2021 8:36:06 AM,Internally Displaced People,622,598,552,529,2301,622,598,552,529,2301
64,Yemen,2019,YEM-19/3420/SA2/WASH/NGO/14608,3/1/2021 8:36:06 AM,Overall,622,598,552,529,2301,622,598,552,529,2301
64,Yemen,2019,YEM-19/3420/SA2/WASH/NGO/14642,8/4/2021 11:40:54 AM,Host Communities,4011,5146,3590,5601,18348,4751,5651,4134,6287,20823
64,Yemen,2019,YEM-19/3420/SA2/WASH/NGO/14642,8/4/2021 11:40:54 AM,Internally Displaced People,480,597,433,653,2163,238,258,261,308,1065
64,Yemen,2019,YEM-19/3420/SA2/WASH/NGO/14642,8/4/2021 11:40:54 AM,Overall,4491,5743,4023,6254,20511,4989,5909,4395,6595,21888
64,Yemen,2019,YEM-19/3420/SA2/WASH/NGO/14699,1/20/2021 11:29:02 AM,Host Communities,4750,5110,7580,9560,27000,10619,8558,9951,9081,38209
64,Yemen,2019,YEM-19/3420/SA2/WASH/NGO/14699,1/20/2021 11:29:02 AM,Internally Displaced People,850,890,1320,1440,4500,954,941,1281,1291,4467
64,Yemen,2019,YEM-19/3420/SA2/WASH/NGO/14699,1/20/2021 11:29:02 AM,Overall,5600,6000,8900,11000,31500,11573,9499,11232,10372,42676
64,Yemen,2019,YEM-19/3420/SA2/WASH-CCM-SHNFI/NGO/14616,5/18/2021 11:02:11 AM,Host Communities,2463,2041,1691,1485,7680,2657,2575,2544,2640,10416
64,Yemen,2019,YEM-19/3420/SA2/WASH-CCM-SHNFI/NGO/14616,5/18/2021 11:02:11 AM,Internally Displaced People,2004,1604,1490,1308,6406,1860,1735,1756,1728,7079
64,Yemen,2019,YEM-19/3420/SA2/WASH-CCM-SHNFI/NGO/14616,5/18/2021 11:02:11 AM,Overall,4467,3645,3181,2793,14086,4517,4310,4300,4368,17495
64,Yemen,2019,YEM-19/3420/SA2/WASH-SHNFI/NGO/14589,5/8/2021 11:22:14 PM,Host Communities,23326,25270,22354,26242,97192,28760,31156,27561,32354,119831
64,Yemen,2019,YEM-19/3420/SA2/WASH-SHNFI/NGO/14589,5/8/2021 11:22:14 PM,Internally Displaced People,4444,4814,4259,4999,18516,4853,5257,4651,5459,20220
64,Yemen,2019,YEM-19/3420/SA2/WASH-SHNFI/NGO/14589,5/8/2021 11:22:14 PM,Overall,27770,30084,26613,31241,115708,33613,36413,32212,37813,140051
64,Yemen,2019,YEM-19/3420/SA2/WASH-SHNFI/NGO/14624,6/23/2021 8:11:43 AM,Host Communities,2431,2530,3703,3736,12400,2697,2956,4482,4613,14748
64,Yemen,2019,YEM-19/3420/SA2/WASH-SHNFI/NGO/14624,6/23/2021 8:11:43 AM,Internally Displaced People,2845,2961,4402,4305,14513,2333,2865,5031,3979,14208
64,Yemen,2019,YEM-19/3420/SA2/WASH-SHNFI/NGO/14624,6/23/2021 8:11:43 AM,Overall,5276,5491,8105,8041,26913,5030,5821,9513,8592,28956
64,Yemen,2020,YEM-20/3420/RA/Health/UN/17170,11/15/2021 11:52:54 AM,Other,2090,2085,0,0,4175,1346,579,0,0,1925
64,Yemen,2020,YEM-20/3420/RA/Health/UN/17170,11/15/2021 11:52:54 AM,Overall,2090,2085,0,0,4175,1346,579,0,0,1925
64,Yemen,2020,YEM-20/3420/RA/Health/UN/17178,11/24/2022 9:25:33 AM,Host Communities,478712,441888,0,0,920600,2758921,1108758,1069352,1017111,5954142
64,Yemen,2020,YEM-20/3420/RA/Health/UN/17178,11/24/2022 9:25:33 AM,Internally Displaced People,40000,60000,0,0,100000,115648,127630,175400,187355,606033
64,Yemen,2020,YEM-20/3420/RA/Health/UN/17178,11/24/2022 9:25:33 AM,Other,2505,1670,0,0,4175,959,966,0,0,1925
64,Yemen,2020,YEM-20/3420/RA/Health/UN/17178,11/24/2022 9:25:33 AM,Overall,540117,514658,0,0,1054775,2875528,1237354,1244752,1204466,6562100
64,Yemen,2020,YEM-20/3420/RA/Health/UN/17178,11/24/2022 9:25:33 AM,Refugees,8500,1500,0,0,10000,0,0,0,0,0
64,Yemen,2020,YEM-20/3420/RA/Health/UN/17178,11/24/2022 9:25:33 AM,Returnees,10400,9600,0,0,20000,0,0,0,0,0
64,Yemen,2020,YEM-20/3420/RA/RRM/UN/17179,4/9/2021 9:09:54 PM,Internally Displaced People,40000,60000,30000,50000,180000,40000,60000,30000,50000,180000
64,Yemen,2020,YEM-20/3420/RA/RRM/UN/17179,4/9/2021 9:09:54 PM,Overall,40000,60000,30000,50000,180000,40000,60000,30000,50000,180000
64,Yemen,2020,YEM-20/3420/RA1/Logistics-ETC/UN/15362,3/21/2021 10:19:12 AM,Other,93,0,0,0,93,84,0,0,0,84
64,Yemen,2020,YEM-20/3420/RA1/Logistics-ETC/UN/15362,3/21/2021 10:19:12 AM,Overall,93,0,0,0,93,84,0,0,0,84
64,Yemen,2020,YEM-20/3420/SA1/CCM-SHNFI/NGO/17889,3/15/2022 8:20:55 AM,Host Communities,276,181,172,324,953,4751,5055,4154,3683,17643
64,Yemen,2020,YEM-20/3420/SA1/CCM-SHNFI/NGO/17889,3/15/2022 8:20:55 AM,Internally Displaced People,2788,1778,1761,3035,9362,1118,1200,1659,1409,5386
64,Yemen,2020,YEM-20/3420/SA1/CCM-SHNFI/NGO/17889,3/15/2022 8:20:55 AM,Overall,3202,2049,2019,3521,10791,5941,6331,5868,5166,23306
64,Yemen,2020,YEM-20/3420/SA1/CCM-SHNFI/NGO/17889,3/15/2022 8:20:55 AM,Returnees,138,90,86,162,476,72,76,55,74,277
64,Yemen,2020,YEM-20/3420/SA1/CCM-SHNFI-WASH/INGO/17939,11/14/2022 6:09:31 AM,Host Communities,400,413,510,484,1807,688,838,1018,1245,3789
64,Yemen,2020,YEM-20/3420/SA1/CCM-SHNFI-WASH/INGO/17939,11/14/2022 6:09:31 AM,Internally Displaced People,9194,9631,11588,11247,41660,13304,12461,14675,15863,56303
64,Yemen,2020,YEM-20/3420/SA1/CCM-SHNFI-WASH/INGO/17939,11/14/2022 6:09:31 AM,Overall,9648,10102,12157,11794,43701,14085,13376,15725,17153,60339
64,Yemen,2020,YEM-20/3420/SA1/CCM-SHNFI-WASH/INGO/17939,11/14/2022 6:09:31 AM,Refugees,54,58,59,63,234,93,77,32,45,247
64,Yemen,2020,YEM-20/3420/SA1/Education/NGO/17882,3/27/2022 6:09:31 AM,Host Communities,0,0,6000,3000,9000,180,84,4559,3903,8726
64,Yemen,2020,YEM-20/3420/SA1/Education/NGO/17882,3/27/2022 6:09:31 AM,Internally Displaced People,0,0,795,655,1450,0,0,253,257,510
64,Yemen,2020,YEM-20/3420/SA1/Education/NGO/17882,3/27/2022 6:09:31 AM,Overall,0,0,6855,3695,10550,180,84,4812,4160,9236
64,Yemen,2020,YEM-20/3420/SA1/Education/NGO/17882,3/27/2022 6:09:31 AM,Returnees,0,0,60,40,100,0,0,0,0,0
64,Yemen,2020,YEM-20/3420/SA1/Education-Protection-WASH/INGO/17856,9/6/2022 6:54:44 AM,Host Communities,1420,1496,3455,3629,10000,7207,7602,9723,11912,36444
64,Yemen,2020,YEM-20/3420/SA1/Education-Protection-WASH/INGO/17856,9/6/2022 6:54:44 AM,Internally Displaced People,1120,1177,2800,4819,9916,1243,1515,1376,1405,5539
64,Yemen,2020,YEM-20/3420/SA1/Education-Protection-WASH/INGO/17856,9/6/2022 6:54:44 AM,Overall,2540,2673,6255,8448,19916,8450,9117,11099,13317,41983
64,Yemen,2020,YEM-20/3420/SA1/Education-WASH-SHNFI/INGO/17836,9/26/2022 9:17:29 AM,Host Communities,5146,7046,12940,12788,37920,7665,6885,14240,12783,41573
64,Yemen,2020,YEM-20/3420/SA1/Education-WASH-SHNFI/INGO/17836,9/26/2022 9:17:29 AM,Internally Displaced People,8343,9574,12674,12391,42982,7846,7809,14570,14503,44728
64,Yemen,2020,YEM-20/3420/SA1/Education-WASH-SHNFI/INGO/17836,9/26/2022 9:17:29 AM,Overall,15449,19070,28357,27825,90701,15629,14826,29028,27531,87014
64,Yemen,2020,YEM-20/3420/SA1/Education-WASH-SHNFI/INGO/17836,9/26/2022 9:17:29 AM,Returnees,1960,2450,2743,2646,9799,118,132,218,245,713
64,Yemen,2020,YEM-20/3420/SA1/ETC/UN/17894,4/16/2023 8:45:30 AM,Other,39,0,0,0,39,47,0,0,0,47
64,Yemen,2020,YEM-20/3420/SA1/ETC/UN/17894,4/16/2023 8:45:30 AM,Overall,39,0,0,0,39,47,0,0,0,47
64,Yemen,2020,YEM-20/3420/SA1/FSAC/INGO/17834,10/11/2022 9:27:12 AM,Host Communities,161,168,182,189,700,204,210,182,192,788
64,Yemen,2020,YEM-20/3420/SA1/FSAC/INGO/17834,10/11/2022 9:27:12 AM,Internally Displaced People,10534,10992,11908,12366,45800,9668,6209,12008,12866,40751
64,Yemen,2020,YEM-20/3420/SA1/FSAC/INGO/17834,10/11/2022 9:27:12 AM,Overall,10695,11160,12090,12555,46500,9872,6419,12190,13058,41539
64,Yemen,2020,YEM-20/3420/SA1/FSAC/INGO/17842,6/20/2022 6:46:31 AM,Internally Displaced People,3361,3375,3526,3402,13664,2280,2651,3995,3770,12696
64,Yemen,2020,YEM-20/3420/SA1/FSAC/INGO/17842,6/20/2022 6:46:31 AM,Overall,3361,3375,3526,3402,13664,2280,2651,3995,3770,12696
64,Yemen,2020,YEM-20/3420/SA1/FSAC/INGO/17859,9/11/2022 8:19:39 AM,Internally Displaced People,6851,6702,7750,7397,28700,4383,4627,5916,5877,20803
64,Yemen,2020,YEM-20/3420/SA1/FSAC/INGO/17859,9/11/2022 8:19:39 AM,Overall,6851,6702,7750,7397,28700,4383,4627,5916,5877,20803
64,Yemen,2020,YEM-20/3420/SA1/FSAC/INGO/17919,4/5/2022 5:54:54 AM,Internally Displaced People,946,869,1304,1228,4347,689,599,708,784,2780
64,Yemen,2020,YEM-20/3420/SA1/FSAC/INGO/17919,4/5/2022 5:54:54 AM,Overall,1051,966,1449,1364,4830,1178,883,1055,1043,4159
64,Yemen,2020,YEM-20/3420/SA1/FSAC/INGO/17919,4/5/2022 5:54:54 AM,Returnees,105,97,145,136,483,489,284,347,259,1379
64,Yemen,2020,YEM-20/3420/SA1/FSAC/INGO/17920,4/5/2022 5:51:47 AM,Internally Displaced People,3296,1158,1276,3636,9366,2511,2671,1938,1898,9018
64,Yemen,2020,YEM-20/3420/SA1/FSAC/INGO/17920,4/5/2022 5:51:47 AM,Overall,3296,1158,1276,3636,9366,2511,2671,1938,1898,9018
64,Yemen,2020,YEM-20/3420/SA1/FSAC/NGO/17888,6/20/2022 8:18:23 PM,Internally Displaced People,960,1000,1440,1500,4900,817,907,942,856,3522
64,Yemen,2020,YEM-20/3420/SA1/FSAC/NGO/17888,6/20/2022 8:18:23 PM,Overall,960,1000,1440,1500,4900,817,907,942,856,3522
64,Yemen,2020,YEM-20/3420/SA1/FSAC/NGO/17898,11/24/2022 4:23:33 AM,Internally Displaced People,3676,4315,3835,4155,15981,2672,2857,3520,3071,12120
64,Yemen,2020,YEM-20/3420/SA1/FSAC/NGO/17898,11/24/2022 4:23:33 AM,Overall,3676,4315,3835,4155,15981,2672,2857,3520,3071,12120
64,Yemen,2020,YEM-20/3420/SA1/FSAC/NGO/17908,8/1/2022 9:18:30 AM,Internally Displaced People,666,764,662,708,2800,474,455,985,936,2850
64,Yemen,2020,YEM-20/3420/SA1/FSAC/NGO/17908,8/1/2022 9:18:30 AM,Overall,666,764,662,708,2800,474,455,985,936,2850
64,Yemen,2020,YEM-20/3420/SA1/FSAC/NGO/17930,3/27/2022 7:33:15 AM,Internally Displaced People,3050,2864,550,536,7000,1048,1148,1595,1363,5154
64,Yemen,2020,YEM-20/3420/SA1/FSAC/NGO/17930,3/27/2022 7:33:15 AM,Overall,3050,2864,550,536,7000,1048,1148,1595,1363,5154
64,Yemen,2020,YEM-20/3420/SA1/FSAC-Education/NGO/17890,7/17/2022 12:46:48 PM,Host Communities,307,314,1594,1611,3826,312,434,5510,4037,10293
64,Yemen,2020,YEM-20/3420/SA1/FSAC-Education/NGO/17890,7/17/2022 12:46:48 PM,Internally Displaced People,3154,3384,5940,5688,18166,2760,2828,8596,6799,20983
64,Yemen,2020,YEM-20/3420/SA1/FSAC-Education/NGO/17890,7/17/2022 12:46:48 PM,Overall,3461,3698,7534,7299,21992,3072,3262,14106,10836,31276
64,Yemen,2020,YEM-20/3420/SA1/Health/INGO/17901,3/8/2022 8:43:15 AM,Host Communities,2528,2889,6501,6140,18058,7197,8616,10356,10708,36877
64,Yemen,2020,YEM-20/3420/SA1/Health/INGO/17901,3/8/2022 8:43:15 AM,Internally Displaced People,915,1046,2353,2222,6536,520,499,435,427,1881
64,Yemen,2020,YEM-20/3420/SA1/Health/INGO/17901,3/8/2022 8:43:15 AM,Overall,3443,3935,8854,8362,24594,7717,9115,10791,11135,38758
64,Yemen,2020,YEM-20/3420/SA1/Health/INGO/17904,5/8/2022 8:28:43 AM,Host Communities,4762,4972,5369,4783,19886,4762,4972,5369,4783,19886
64,Yemen,2020,YEM-20/3420/SA1/Health/INGO/17904,5/8/2022 8:28:43 AM,Internally Displaced People,829,892,947,841,3509,829,892,947,841,3509
64,Yemen,2020,YEM-20/3420/SA1/Health/INGO/17904,5/8/2022 8:28:43 AM,Overall,5591,5864,6316,5624,23395,5591,5864,6316,5624,23395
64,Yemen,2020,YEM-20/3420/SA1/Health/INGO/17935,11/24/2022 4:08:37 AM,Host Communities,5392,5240,4903,4651,20186,3538,14030,1961,1895,21424
64,Yemen,2020,YEM-20/3420/SA1/Health/INGO/17935,11/24/2022 4:08:37 AM,Internally Displaced People,198,189,430,391,1208,464,1292,722,569,3047
64,Yemen,2020,YEM-20/3420/SA1/Health/INGO/17935,11/24/2022 4:08:37 AM,Overall,5590,5429,5333,5042,21394,4002,15322,2683,2464,24471
64,Yemen,2020,YEM-20/3420/SA1/Health/NGO/17861,2/15/2022 7:50:56 AM,Host Communities,11104,11881,14113,13996,51094,5847,34599,10491,10174,61111
64,Yemen,2020,YEM-20/3420/SA1/Health/NGO/17861,2/15/2022 7:50:56 AM,Internally Displaced People,595,613,722,708,2638,1003,6335,2624,2615,12577
64,Yemen,2020,YEM-20/3420/SA1/Health/NGO/17861,2/15/2022 7:50:56 AM,Overall,11699,12494,14835,14704,53732,6850,40934,13115,12789,73688
64,Yemen,2020,YEM-20/3420/SA1/Health/NGO/17876,4/7/2022 9:16:08 AM,Host Communities,3677,3819,5477,5706,18679,3919,11799,7665,7238,30621
64,Yemen,2020,YEM-20/3420/SA1/Health/NGO/17876,4/7/2022 9:16:08 AM,Internally Displaced People,104,108,156,163,531,721,895,0,0,1616
64,Yemen,2020,YEM-20/3420/SA1/Health/NGO/17876,4/7/2022 9:16:08 AM,Overall,3781,3927,5633,5869,19210,4640,12694,7665,7238,32237
64,Yemen,2020,YEM-20/3420/SA1/Health-Nutrition/INGO/17909,11/16/2022 3:52:49 AM,Host Communities,9842,24174,15991,17315,67322,31779,55209,54698,51260,192946
64,Yemen,2020,YEM-20/3420/SA1/Health-Nutrition/INGO/17909,11/16/2022 3:52:49 AM,Internally Displaced People,2716,5427,3573,3858,15574,2423,6021,1892,2193,12529
64,Yemen,2020,YEM-20/3420/SA1/Health-Nutrition/INGO/17909,11/16/2022 3:52:49 AM,Overall,12558,29601,19564,21173,82896,34202,61230,56590,53453,205475
64,Yemen,2020,YEM-20/3420/SA1/Health-Nutrition/INGO/17915,3/13/2022 8:24:37 AM,Host Communities,227,526,574,574,1901,417,856,798,855,2926
64,Yemen,2020,YEM-20/3420/SA1/Health-Nutrition/INGO/17915,3/13/2022 8:24:37 AM,Internally Displaced People,681,1577,1721,1721,5700,1146,2351,2191,2347,8035
64,Yemen,2020,YEM-20/3420/SA1/Health-Nutrition/INGO/17915,3/13/2022 8:24:37 AM,Overall,908,2103,2295,2295,7601,1563,3207,2989,3202,10961
64,Yemen,2020,YEM-20/3420/SA1/Health-Nutrition/INGO/17926,8/29/2022 6:00:29 AM,Host Communities,37885,39431,39431,41041,157788,46327,96894,83120,89230,315571
64,Yemen,2020,YEM-20/3420/SA1/Health-Nutrition/INGO/17926,8/29/2022 6:00:29 AM,Internally Displaced People,1835,1910,1910,1988,7643,4631,14907,6381,7854,33773
64,Yemen,2020,YEM-20/3420/SA1/Health-Nutrition/INGO/17926,8/29/2022 6:00:29 AM,Overall,39720,41341,41341,43029,165431,50958,111801,89501,97084,349344
64,Yemen,2020,YEM-20/3420/SA1/Health-Nutrition/INGO/17933,8/3/2022 8:08:17 AM,Host Communities,4584,10514,8796,8796,32690,10831,21131,25994,25994,83950
64,Yemen,2020,YEM-20/3420/SA1/Health-Nutrition/INGO/17933,8/3/2022 8:08:17 AM,Internally Displaced People,2731,6348,6251,6251,21581,4866,9494,11679,11681,37720
64,Yemen,2020,YEM-20/3420/SA1/Health-Nutrition/INGO/17933,8/3/2022 8:08:17 AM,Overall,7315,16862,15047,15047,54271,15697,30625,37673,37675,121670
64,Yemen,2020,YEM-20/3420/SA1/Health-Nutrition/INGO/17940,8/8/2022 7:07:47 PM,Host Communities,20944,27363,19807,20614,88728,39711,71229,38241,31719,180900
64,Yemen,2020,YEM-20/3420/SA1/Health-Nutrition/INGO/17940,8/8/2022 7:07:47 PM,Internally Displaced People,2850,4439,3578,3173,14040,3788,8548,6558,6227,25121
64,Yemen,2020,YEM-20/3420/SA1/Health-Nutrition/INGO/17940,8/8/2022 7:07:47 PM,Overall,23794,31802,23385,23787,102768,43499,79777,44799,37946,206021
64,Yemen,2020,YEM-20/3420/SA1/Health-Nutrition/NGO/17913,5/31/2022 7:27:41 AM,Host Communities,6585,8528,12846,12846,40805,27183,28292,5805,6047,67327
64,Yemen,2020,YEM-20/3420/SA1/Health-Nutrition/NGO/17913,5/31/2022 7:27:41 AM,Internally Displaced People,2760,4830,6904,7249,21743,7203,7497,1538,1605,17843
64,Yemen,2020,YEM-20/3420/SA1/Health-Nutrition/NGO/17913,5/31/2022 7:27:41 AM,Overall,9345,13358,19750,20095,62548,34386,35789,7343,7652,85170
64,Yemen,2020,YEM-20/3420/SA1/Health-Nutrition/O/17849,6/5/2022 5:51:41 AM,Host Communities,19992,29988,64141,52479,166600,19291,69472,23682,26040,138485
64,Yemen,2020,YEM-20/3420/SA1/Health-Nutrition/O/17849,6/5/2022 5:51:41 AM,Internally Displaced People,8568,12852,27489,22491,71400,1814,3888,1852,2474,10028
64,Yemen,2020,YEM-20/3420/SA1/Health-Nutrition/O/17849,6/5/2022 5:51:41 AM,Overall,28560,42840,91630,74970,238000,21105,73360,25534,28514,148513
64,Yemen,2020,YEM-20/3420/SA1/Health-Nutrition/O/17850,6/5/2022 11:57:50 AM,Host Communities,19320,28980,61985,50715,161000,47896,138098,69834,68539,324367
64,Yemen,2020,YEM-20/3420/SA1/Health-Nutrition/O/17850,6/5/2022 11:57:50 AM,Internally Displaced People,8280,12420,26565,21735,69000,9073,18939,13434,12599,54045
64,Yemen,2020,YEM-20/3420/SA1/Health-Nutrition/O/17850,6/5/2022 11:57:50 AM,Overall,27600,41400,88550,72450,230000,56969,157037,83268,81138,378412
64,Yemen,2020,YEM-20/3420/SA1/Health-Nutrition-Education/NGO/17884,5/23/2022 4:22:32 PM,Host Communities,11666,13871,4290,4228,34055,6777,11481,10543,9498,38299
64,Yemen,2020,YEM-20/3420/SA1/Health-Nutrition-Education/NGO/17884,5/23/2022 4:22:32 PM,Internally Displaced People,219,372,163,155,909,161,325,296,259,1041
64,Yemen,2020,YEM-20/3420/SA1/Health-Nutrition-Education/NGO/17884,5/23/2022 4:22:32 PM,Overall,11885,14243,4453,4383,34964,6938,11806,10839,9757,39340
64,Yemen,2020,YEM-20/3420/SA1/Health-SHNFI/NGO/17899,3/20/2022 8:09:01 AM,Host Communities,9165,9539,13747,14308,46759,5846,8770,6085,9128,29829
64,Yemen,2020,YEM-20/3420/SA1/Health-SHNFI/NGO/17899,3/20/2022 8:09:01 AM,Internally Displaced People,3727,3879,5590,5818,19014,7068,7397,10722,11038,36225
64,Yemen,2020,YEM-20/3420/SA1/Health-SHNFI/NGO/17899,3/20/2022 8:09:01 AM,Overall,12892,13418,19337,20126,65773,12914,16167,16807,20166,66054
64,Yemen,2020,YEM-20/3420/SA1/Health-WASH/NGO/17907,7/19/2022 2:00:41 PM,Host Communities,15224,16898,15371,15780,63273,4519,18536,7606,7805,38466
64,Yemen,2020,YEM-20/3420/SA1/Health-WASH/NGO/17907,7/19/2022 2:00:41 PM,Internally Displaced People,674,749,690,709,2822,576,1247,846,817,3486
64,Yemen,2020,YEM-20/3420/SA1/Health-WASH/NGO/17907,7/19/2022 2:00:41 PM,Overall,15898,17647,16061,16489,66095,5095,19783,8452,8622,41952
64,Yemen,2020,YEM-20/3420/SA1/Nutrition/INGO/17902,8/10/2022 4:46:10 PM,Host Communities,16989,16652,14472,14186,62299,1161,47631,4348,4803,57943
64,Yemen,2020,YEM-20/3420/SA1/Nutrition/INGO/17902,8/10/2022 4:46:10 PM,Internally Displaced People,1274,1248,1085,1064,4671,60,4131,81,89,4361
64,Yemen,2020,YEM-20/3420/SA1/Nutrition/INGO/17902,8/10/2022 4:46:10 PM,Overall,18263,17900,15557,15250,66970,1221,51762,4429,4892,62304
64,Yemen,2020,YEM-20/3420/SA1/Nutrition/INGO/17911,11/28/2022 6:51:29 PM,Host Communities,44,7765,7376,7676,22861,46,19041,4582,5369,29038
64,Yemen,2020,YEM-20/3420/SA1/Nutrition/INGO/17911,11/28/2022 6:51:29 PM,Internally Displaced People,0,131,551,573,1255,0,139,11,17,167
64,Yemen,2020,YEM-20/3420/SA1/Nutrition/INGO/17911,11/28/2022 6:51:29 PM,Overall,44,7896,7927,8249,24116,46,19180,4593,5386,29205
64,Yemen,2020,YEM-20/3420/SA1/Nutrition-Health-Protection/INGO/17932,8/29/2022 6:16:56 AM,Host Communities,35631,49204,51436,51436,187707,12055,19760,18794,17244,67853
64,Yemen,2020,YEM-20/3420/SA1/Nutrition-Health-Protection/INGO/17932,8/29/2022 6:16:56 AM,Internally Displaced People,18292,31445,13528,13740,77005,4230,3817,7336,6704,22087
64,Yemen,2020,YEM-20/3420/SA1/Nutrition-Health-Protection/INGO/17932,8/29/2022 6:16:56 AM,Overall,53923,80649,64964,65176,264712,16285,23577,26130,23948,89940
64,Yemen,2020,YEM-20/3420/SA1/Protection/INGO/17855,7/19/2022 11:31:17 AM,Host Communities,779,420,263,252,1714,1125,835,170,137,2267
64,Yemen,2020,YEM-20/3420/SA1/Protection/INGO/17855,7/19/2022 11:31:17 AM,Internally Displaced People,96,52,32,31,211,73,24,15,6,118
64,Yemen,2020,YEM-20/3420/SA1/Protection/INGO/17855,7/19/2022 11:31:17 AM,Overall,875,472,295,283,1925,1198,859,185,143,2385
64,Yemen,2020,YEM-20/3420/SA1/Protection/INGO/17877,8/2/2022 11:45:58 AM,Host Communities,408,1156,816,916,3296,614,1456,2032,1854,5956
64,Yemen,2020,YEM-20/3420/SA1/Protection/INGO/17877,8/2/2022 11:45:58 AM,Internally Displaced People,408,1156,816,916,3296,712,964,1886,1472,5034
64,Yemen,2020,YEM-20/3420/SA1/Protection/INGO/17877,8/2/2022 11:45:58 AM,Overall,816,2312,1632,1832,6592,1326,2420,3918,3326,10990
64,Yemen,2020,YEM-20/3420/SA1/Protection/INGO/17910,5/8/2022 6:35:43 AM,Host Communities,416,916,293,293,1918,694,1561,403,180,2838
64,Yemen,2020,YEM-20/3420/SA1/Protection/INGO/17910,5/8/2022 6:35:43 AM,Internally Displaced People,1249,2748,878,878,5753,1818,3714,617,397,6546
64,Yemen,2020,YEM-20/3420/SA1/Protection/INGO/17910,5/8/2022 6:35:43 AM,Overall,1734,3817,1220,1220,7991,2512,5289,1022,577,9400
64,Yemen,2020,YEM-20/3420/SA1/Protection/INGO/17910,5/8/2022 6:35:43 AM,Returnees,69,153,49,49,320,0,14,2,0,16
64,Yemen,2020,YEM-20/3420/SA1/Protection/INGO/17924,8/10/2022 4:57:29 PM,Host Communities,435,164,193,96,888,516,128,152,51,847
64,Yemen,2020,YEM-20/3420/SA1/Protection/INGO/17924,8/10/2022 4:57:29 PM,Internally Displaced People,95,37,39,24,195,80,37,41,10,168
64,Yemen,2020,YEM-20/3420/SA1/Protection/INGO/17924,8/10/2022 4:57:29 PM,Other,10,7,0,0,17,9,1,0,0,10
64,Yemen,2020,YEM-20/3420/SA1/Protection/INGO/17924,8/10/2022 4:57:29 PM,Overall,540,208,232,120,1100,605,166,193,61,1025
64,Yemen,2020,YEM-20/3420/SA1/Protection/UN/17881,5/18/2022 12:13:48 PM,Host Communities,1013,21025,989,12955,35982,1013,16025,989,7455,25482
64,Yemen,2020,YEM-20/3420/SA1/Protection/UN/17881,5/18/2022 12:13:48 PM,Internally Displaced People,1995,31029,1498,12532,47054,1260,25452,1710,8532,36954
64,Yemen,2020,YEM-20/3420/SA1/Protection/UN/17881,5/18/2022 12:13:48 PM,Overall,3008,52054,2487,25487,83036,2273,41477,2699,15987,62436
64,Yemen,2020,YEM-20/3420/SA1/RRM/INGO/17916,4/3/2022 10:01:33 AM,Internally Displaced People,4028,4026,4745,4736,17535,3343,3740,3822,3415,14320
64,Yemen,2020,YEM-20/3420/SA1/RRM/INGO/17916,4/3/2022 10:01:33 AM,Overall,4028,4026,4745,4736,17535,3343,3740,3822,3415,14320
64,Yemen,2020,YEM-20/3420/SA1/RRM/UN/17858,5/24/2022 7:40:47 AM,Internally Displaced People,8165,8533,10397,10015,37110,7475,8730,10209,10816,37230
64,Yemen,2020,YEM-20/3420/SA1/RRM/UN/17858,5/24/2022 7:40:47 AM,Overall,8165,8533,10397,10015,37110,7475,8730,10209,10816,37230
64,Yemen,2020,YEM-20/3420/SA1/RRM/UN/17879,8/25/2021 9:15:08 AM,Internally Displaced People,45000,72000,35000,58000,210000,24750,40286,19250,31900,116186
64,Yemen,2020,YEM-20/3420/SA1/RRM/UN/17879,8/25/2021 9:15:08 AM,Overall,45000,72000,35000,58000,210000,24750,40286,19250,31900,116186
64,Yemen,2020,YEM-20/3420/SA1/RRM/UN/17936,9/15/2021 2:29:31 PM,Internally Displaced People,29165,38884,19447,29166,116662,27232,33442,21262,27432,109368
64,Yemen,2020,YEM-20/3420/SA1/RRM/UN/17936,9/15/2021 2:29:31 PM,Overall,29165,38884,19447,29166,116662,27232,33442,21262,27432,109368
64,Yemen,2020,YEM-20/3420/SA1/SHNFI/NGO/17931,5/8/2022 10:56:58 AM,Host Communities,297,363,275,165,1100,170,181,264,215,830
64,Yemen,2020,YEM-20/3420/SA1/SHNFI/NGO/17931,5/8/2022 10:56:58 AM,Internally Displaced People,1188,1452,1100,660,4400,1154,1227,1922,1755,6058
64,Yemen,2020,YEM-20/3420/SA1/SHNFI/NGO/17931,5/8/2022 10:56:58 AM,Overall,1485,1815,1375,825,5500,1324,1408,2186,1970,6888
64,Yemen,2020,YEM-20/3420/SA1/SHNFI/O/17886,11/20/2022 5:52:07 AM,Host Communities,1907,1836,1625,1695,7063,1053,1188,1487,1333,5061
64,Yemen,2020,YEM-20/3420/SA1/SHNFI/O/17886,11/20/2022 5:52:07 AM,Internally Displaced People,7628,7346,6954,6780,28708,5745,6440,8045,7668,27898
64,Yemen,2020,YEM-20/3420/SA1/SHNFI/O/17886,11/20/2022 5:52:07 AM,Overall,9535,9182,8579,8475,35771,6798,7628,9532,9001,32959
64,Yemen,2020,YEM-20/3420/SA1/WASH/INGO/17833,11/4/2022 11:18:57 AM,Host Communities,10105,9674,12039,11180,42998,13174,12499,15765,14864,56302
64,Yemen,2020,YEM-20/3420/SA1/WASH/INGO/17833,11/4/2022 11:18:57 AM,Internally Displaced People,3368,3225,4013,3726,14332,2100,2082,1879,2009,8070
64,Yemen,2020,YEM-20/3420/SA1/WASH/INGO/17833,11/4/2022 11:18:57 AM,Overall,13473,12899,16052,14906,57330,15274,14581,17644,16873,64372
64,Yemen,2020,YEM-20/3420/SA1/WASH/INGO/17860,10/31/2022 12:52:24 PM,Host Communities,2598,2714,3396,3370,12078,8985,9272,9989,9051,37297
64,Yemen,2020,YEM-20/3420/SA1/WASH/INGO/17860,10/31/2022 12:52:24 PM,Internally Displaced People,4345,4541,5575,5426,19887,9626,8238,11794,9468,39126
64,Yemen,2020,YEM-20/3420/SA1/WASH/INGO/17860,10/31/2022 12:52:24 PM,Overall,6943,7255,8971,8796,31965,18611,17510,21783,18519,76423
64,Yemen,2020,YEM-20/3420/SA1/WASH/INGO/17896,3/6/2022 9:57:34 AM,Host Communities,500,500,2000,2000,5000,0,0,0,0,0
64,Yemen,2020,YEM-20/3420/SA1/WASH/INGO/17896,3/6/2022 9:57:34 AM,Internally Displaced People,2010,2010,3020,3024,10064,0,0,0,0,0
64,Yemen,2020,YEM-20/3420/SA1/WASH/INGO/17896,3/6/2022 9:57:34 AM,Overall,3010,3010,7020,7024,20064,0,0,0,0,0
64,Yemen,2020,YEM-20/3420/SA1/WASH/INGO/17896,3/6/2022 9:57:34 AM,Returnees,500,500,2000,2000,5000,0,0,0,0,0
64,Yemen,2020,YEM-20/3420/SA1/WASH/INGO/17903,7/5/2022 6:42:30 AM,Host Communities,21056,20138,25626,24705,91525,48192,53764,44203,46613,192772
64,Yemen,2020,YEM-20/3420/SA1/WASH/INGO/17903,7/5/2022 6:42:30 AM,Internally Displaced People,3428,3279,4173,4024,14904,7845,8752,7195,7589,31381
64,Yemen,2020,YEM-20/3420/SA1/WASH/INGO/17903,7/5/2022 6:42:30 AM,Overall,24484,23417,29799,28729,106429,56037,62516,51398,54202,224153
64,Yemen,2020,YEM-20/3420/SA1/WASH/INGO/17921,9/26/2022 1:41:57 PM,Host Communities,7644,7514,5512,5330,26000,10290,10115,7420,7175,35000
64,Yemen,2020,YEM-20/3420/SA1/WASH/INGO/17921,9/26/2022 1:41:57 PM,Internally Displaced People,2646,2601,1908,1845,9000,2179,2142,1572,1520,7413
64,Yemen,2020,YEM-20/3420/SA1/WASH/INGO/17921,9/26/2022 1:41:57 PM,Overall,10290,10115,7420,7175,35000,12469,12257,8992,8695,42413
64,Yemen,2020,YEM-20/3420/SA1/WASH/NGO/17837,7/26/2022 11:08:15 AM,Host Communities,1751,1823,2626,2736,8936,1307,1360,1960,2043,6670
64,Yemen,2020,YEM-20/3420/SA1/WASH/NGO/17837,7/26/2022 11:08:15 AM,Internally Displaced People,1674,1743,2511,2615,8543,2079,2179,3288,3366,10912
64,Yemen,2020,YEM-20/3420/SA1/WASH/NGO/17837,7/26/2022 11:08:15 AM,Overall,3425,3566,5137,5351,17479,3386,3539,5248,5409,17582
64,Yemen,2020,YEM-20/3420/SA1/WASH/NGO/17918,5/5/2022 6:34:07 AM,Host Communities,1685,1754,2528,2630,8597,1685,1754,2528,2630,8597
64,Yemen,2020,YEM-20/3420/SA1/WASH/NGO/17918,5/5/2022 6:34:07 AM,Internally Displaced People,854,890,1282,1335,4361,854,890,1282,1335,4361
64,Yemen,2020,YEM-20/3420/SA1/WASH/NGO/17918,5/5/2022 6:34:07 AM,Overall,2539,2644,3810,3965,12958,2539,2644,3810,3965,12958
64,Yemen,2020,YEM-20/3420/SA1/WASH/NGO/17927,4/30/2022 11:26:23 AM,Host Communities,13650,8366,8807,13210,44033,6954,7090,10887,11312,36243
64,Yemen,2020,YEM-20/3420/SA1/WASH/NGO/17927,4/30/2022 11:26:23 AM,Internally Displaced People,3410,2090,2200,3300,11000,1753,1871,2854,2932,9410
64,Yemen,2020,YEM-20/3420/SA1/WASH/NGO/17927,4/30/2022 11:26:23 AM,Overall,17060,10456,11007,16510,55033,8707,8961,13741,14244,45653
64,Yemen,2020,YEM-20/3420/SA1/WASH/UN/17943,7/14/2022 6:23:43 AM,Host Communities,1243,1607,1276,1624,5750,2942,3589,3889,3947,14367
64,Yemen,2020,YEM-20/3420/SA1/WASH/UN/17943,7/14/2022 6:23:43 AM,Internally Displaced People,1877,1796,2254,2123,8050,2868,3486,3759,3797,13910
64,Yemen,2020,YEM-20/3420/SA1/WASH/UN/17943,7/14/2022 6:23:43 AM,Overall,3120,3403,3530,3747,13800,5810,7075,7648,7744,28277
64,Yemen,2020,YEM-20/3420/SA1/WASH-CCM/NGO/17897,8/15/2022 1:13:04 PM,Host Communities,1338,1514,1868,1939,6659,968,1018,1405,1453,4844
64,Yemen,2020,YEM-20/3420/SA1/WASH-CCM/NGO/17897,8/15/2022 1:13:04 PM,Internally Displaced People,2798,3254,3346,3418,12816,3268,3399,4507,4279,15453
64,Yemen,2020,YEM-20/3420/SA1/WASH-CCM/NGO/17897,8/15/2022 1:13:04 PM,Overall,4136,4768,5214,5357,19475,4236,4417,5912,5732,20297
64,Yemen,2020,YEM-20/3420/SA1/WASH-CCM/NGO/17900,11/4/2022 5:45:58 PM,Host Communities,14476,15683,13873,16286,60318,21003,23372,21677,23495,89547
64,Yemen,2020,YEM-20/3420/SA1/WASH-CCM/NGO/17900,11/4/2022 5:45:58 PM,Internally Displaced People,5611,6079,5377,6313,23380,11045,12014,12384,13203,48646
64,Yemen,2020,YEM-20/3420/SA1/WASH-CCM/NGO/17900,11/4/2022 5:45:58 PM,Overall,20087,21762,19250,22599,83698,32048,35386,34061,36698,138193
64,Yemen,2020,YEM-20/3420/SA1/WASH-SHNFI-CCM/INGO/17835,4/9/2023 8:15:27 AM,Host Communities,20445,21336,23111,24003,88895,44982,47266,48333,50797,191378
64,Yemen,2020,YEM-20/3420/SA1/WASH-SHNFI-CCM/INGO/17835,4/9/2023 8:15:27 AM,Internally Displaced People,66324,69209,74976,77862,288371,19262,19495,19943,20655,79355
64,Yemen,2020,YEM-20/3420/SA1/WASH-SHNFI-CCM/INGO/17835,4/9/2023 8:15:27 AM,Overall,86769,90545,98087,101865,377266,64244,66761,68276,71452,270733
64,Yemen,2021,YEM-21/3420/RA1/Health/UN/19969,4/10/2022 10:49:42 AM,Host Communities,1687500,1125000,562500,375000,3750000,206813,239468,326548,315662,1088491
64,Yemen,2021,YEM-21/3420/RA1/Health/UN/19969,4/10/2022 10:49:42 AM,Internally Displaced People,562500,375000,187500,125000,1250000,30903,35783,48794,47168,162648
64,Yemen,2021,YEM-21/3420/RA1/Health/UN/19969,4/10/2022 10:49:42 AM,Overall,2250000,1500000,750000,500000,5000000,237716,275251,375342,362830,1251139
64,Yemen,2021,YEM-21/3420/RA1/WASH/UN/19970,2/14/2022 7:02:34 AM,Host Communities,330447,364734,504366,539152,1738699,330447,364734,504366,539152,1738699
64,Yemen,2021,YEM-21/3420/RA1/WASH/UN/19970,2/14/2022 7:02:34 AM,Internally Displaced People,140782,155602,214876,229696,740956,140782,155602,214876,229696,740956
64,Yemen,2021,YEM-21/3420/RA1/WASH/UN/19970,2/14/2022 7:02:34 AM,Overall,471229,520336,719242,768848,2479655,471229,520336,719242,768848,2479655
64,Yemen,2021,YEM-21/3420/RA2/RRM/UN/20500,11/7/2022 8:25:10 AM,Internally Displaced People,35280,38220,35280,38220,147000,35280,38220,35280,38220,147000
64,Yemen,2021,YEM-21/3420/RA2/RRM/UN/20500,11/7/2022 8:25:10 AM,Overall,35280,38220,35280,38220,147000,35280,38220,35280,38220,147000
64,Yemen,2021,YEM-21/3420/RA3/Logistics/UN/21063,3/18/2023 10:07:06 PM,Other,560,560,0,0,1120,737,737,0,0,1474
64,Yemen,2021,YEM-21/3420/RA3/Logistics/UN/21063,3/18/2023 10:07:06 PM,Overall,560,560,0,0,1120,737,737,0,0,1474
64,Yemen,2021,YEM-21/3420/RA4/Protection/UN/21150,10/1/2023 8:10:45 AM,Host Communities,216546,265761,226390,275604,984301,196000,235400,205000,248000,884400
64,Yemen,2021,YEM-21/3420/RA4/Protection/UN/21150,10/1/2023 8:10:45 AM,Internally Displaced People,1150,1100,1400,1350,5000,0,0,0,0,0
64,Yemen,2021,YEM-21/3420/RA4/Protection/UN/21150,10/1/2023 8:10:45 AM,Overall,217696,266861,227790,276954,989301,196000,235400,205000,248000,884400
64,Yemen,2021,YEM-21/3420/RA4/Protection-Health/NGO/21138,5/21/2023 12:06:34 AM,Host Communities,5003,10328,4034,5346,24711,15755,23598,12180,11262,62795
64,Yemen,2021,YEM-21/3420/RA4/Protection-Health/NGO/21138,5/21/2023 12:06:34 AM,Internally Displaced People,841,1640,1025,1469,4975,686,1316,520,527,3049
64,Yemen,2021,YEM-21/3420/RA4/Protection-Health/NGO/21138,5/21/2023 12:06:34 AM,Overall,5844,11968,5059,6815,29686,16441,24914,12700,11789,65844
64,Yemen,2021,YEM-21/3420/RA4/WASH-Education/NGO/21153,10/11/2023 7:29:41 AM,Host Communities,23532,24519,33859,35026,116936,17350,18217,31050,30365,96982
64,Yemen,2021,YEM-21/3420/RA4/WASH-Education/NGO/21153,10/11/2023 7:29:41 AM,Internally Displaced People,1142,1198,1656,1712,5708,8074,8478,11707,12112,40371
64,Yemen,2021,YEM-21/3420/RA4/WASH-Education/NGO/21153,10/11/2023 7:29:41 AM,Overall,24674,25717,35515,36738,122644,25424,26695,42757,42477,137353
64,Yemen,2021,YEM-21/3420/SA 2/CCM/NGO/20717,6/5/2023 8:52:51 AM,Host Communities,274,286,412,428,1400,320,359,260,227,1166
64,Yemen,2021,YEM-21/3420/SA 2/CCM/NGO/20717,6/5/2023 8:52:51 AM,Internally Displaced People,1016,1097,1513,1292,4918,1399,1484,1517,1289,5689
64,Yemen,2021,YEM-21/3420/SA 2/CCM/NGO/20717,6/5/2023 8:52:51 AM,Overall,1290,1383,1925,1720,6318,1719,1843,1777,1516,6855
64,Yemen,2021,YEM-21/3420/SA 2/CCM-Health-Protection-WASH/UN/20527,10/11/2023 6:43:35 AM,Host Communities,3092,3977,4387,4206,15662,4659,6493,6368,6284,23804
64,Yemen,2021,YEM-21/3420/SA 2/CCM-Health-Protection-WASH/UN/20527,10/11/2023 6:43:35 AM,Internally Displaced People,9309,11707,13857,12775,47648,12263,18754,17398,17550,65965
64,Yemen,2021,YEM-21/3420/SA 2/CCM-Health-Protection-WASH/UN/20527,10/11/2023 6:43:35 AM,Overall,12401,15684,18244,16981,63310,16922,25247,23766,23834,89769
64,Yemen,2021,YEM-21/3420/SA 2/CCM-Health-SHNFI-WASH/INGO/20539,6/11/2023 7:57:41 AM,Host Communities,2835,4475,4315,4356,15981,1758,1781,1815,1726,7080
64,Yemen,2021,YEM-21/3420/SA 2/CCM-Health-SHNFI-WASH/INGO/20539,6/11/2023 7:57:41 AM,Internally Displaced People,3209,3339,4813,5008,16369,3850,3910,4099,3894,15753
64,Yemen,2021,YEM-21/3420/SA 2/CCM-Health-SHNFI-WASH/INGO/20539,6/11/2023 7:57:41 AM,Overall,6044,7814,9128,9364,32350,5608,5691,5914,5620,22833
64,Yemen,2021,YEM-21/3420/SA 2/CCM-SHNFI/NGO/20657,2/1/2023 6:11:25 AM,Internally Displaced People,270,177,168,316,931,204,204,230,199,837
64,Yemen,2021,YEM-21/3420/SA 2/CCM-SHNFI/NGO/20657,2/1/2023 6:11:25 AM,Overall,270,177,168,316,931,204,204,230,199,837
64,Yemen,2021,YEM-21/3420/SA 2/CCM-WASH-SHNFI-Protection-Education/INGO/20530,10/17/2023 1:07:48 PM,Host Communities,4037,4310,5998,5782,20127,7578,7859,10293,9974,35704
64,Yemen,2021,YEM-21/3420/SA 2/CCM-WASH-SHNFI-Protection-Education/INGO/20530,10/17/2023 1:07:48 PM,Internally Displaced People,14300,14502,18129,17464,64395,12365,12653,18059,16590,59667
64,Yemen,2021,YEM-21/3420/SA 2/CCM-WASH-SHNFI-Protection-Education/INGO/20530,10/17/2023 1:07:48 PM,Overall,18337,18812,24127,23246,84522,19943,20512,28352,26564,95371
64,Yemen,2021,YEM-21/3420/SA 2/Education/NGO/20529,6/4/2023 8:13:32 PM,Host Communities,17,19,2220,2074,4330,15,21,2391,2270,4697
64,Yemen,2021,YEM-21/3420/SA 2/Education/NGO/20529,6/4/2023 8:13:32 PM,Internally Displaced People,0,0,611,453,1064,0,0,219,151,370
64,Yemen,2021,YEM-21/3420/SA 2/Education/NGO/20529,6/4/2023 8:13:32 PM,Overall,17,19,2831,2527,5394,15,21,2610,2421,5067
64,Yemen,2021,YEM-21/3420/SA 2/Education/NGO/20666,3/1/2023 12:29:13 PM,Host Communities,29,46,686,1297,2058,29,46,686,1297,2058
64,Yemen,2021,YEM-21/3420/SA 2/Education/NGO/20666,3/1/2023 12:29:13 PM,Internally Displaced People,0,0,207,253,460,0,0,207,253,460
64,Yemen,2021,YEM-21/3420/SA 2/Education/NGO/20666,3/1/2023 12:29:13 PM,Overall,29,46,893,1550,2518,29,46,893,1550,2518
64,Yemen,2021,YEM-21/3420/SA 2/Education-Protection/NGO/20637,7/16/2023 4:13:33 PM,Host Communities,320,231,2655,2757,5963,336,647,3397,5302,9682
64,Yemen,2021,YEM-21/3420/SA 2/Education-Protection/NGO/20637,7/16/2023 4:13:33 PM,Internally Displaced People,21,14,264,165,464,34,29,531,685,1279
64,Yemen,2021,YEM-21/3420/SA 2/Education-Protection/NGO/20637,7/16/2023 4:13:33 PM,Other,0,0,146,79,225,0,0,70,140,210
64,Yemen,2021,YEM-21/3420/SA 2/Education-Protection/NGO/20637,7/16/2023 4:13:33 PM,Overall,341,245,3065,3001,6652,370,676,3998,6127,11171
64,Yemen,2021,YEM-21/3420/SA 2/FSAC-Education/NGO/20682,6/13/2023 12:55:51 PM,Internally Displaced People,999,1146,993,1062,4200,867,1046,1347,1259,4519
64,Yemen,2021,YEM-21/3420/SA 2/FSAC-Education/NGO/20682,6/13/2023 12:55:51 PM,Overall,999,1146,993,1062,4200,867,1046,1347,1259,4519
64,Yemen,2021,YEM-21/3420/SA 2/FSAC-WASH/INGO/20713,4/10/2023 11:48:40 AM,Host Communities,5850,5460,4290,3900,19500,9953,10283,9317,9490,39043
64,Yemen,2021,YEM-21/3420/SA 2/FSAC-WASH/INGO/20713,4/10/2023 11:48:40 AM,Internally Displaced People,3510,3276,2574,2340,11700,20,30,15,25,90
64,Yemen,2021,YEM-21/3420/SA 2/FSAC-WASH/INGO/20713,4/10/2023 11:48:40 AM,Overall,11700,10920,8580,7800,39000,9973,10313,9332,9515,39133
64,Yemen,2021,YEM-21/3420/SA 2/FSAC-WASH/INGO/20713,4/10/2023 11:48:40 AM,Returnees,2340,2184,1716,1560,7800,0,0,0,0,0
64,Yemen,2021,YEM-21/3420/SA 2/FSAC-WASH/NGO/20668,12/27/2022 6:48:37 AM,Internally Displaced People,530,576,553,645,2304,720,680,847,935,3182
64,Yemen,2021,YEM-21/3420/SA 2/FSAC-WASH/NGO/20668,12/27/2022 6:48:37 AM,Overall,530,576,553,645,2304,720,680,847,935,3182
64,Yemen,2021,YEM-21/3420/SA 2/Health/INGO/20680,6/3/2023 8:40:31 PM,Host Communities,13688,13216,10384,9912,47200,23239,21062,26556,25640,96497
64,Yemen,2021,YEM-21/3420/SA 2/Health/INGO/20680,6/3/2023 8:40:31 PM,Internally Displaced People,9512,9184,7216,6888,32800,4884,5616,7082,6837,24419
64,Yemen,2021,YEM-21/3420/SA 2/Health/INGO/20680,6/3/2023 8:40:31 PM,Overall,23200,22400,17600,16800,80000,28123,26678,33638,32477,120916
64,Yemen,2021,YEM-21/3420/SA 2/Health-Education/NGO/20662,8/20/2023 12:15:04 AM,Host Communities,1909,1845,1336,1272,6362,1755,2332,1705,1696,7488
64,Yemen,2021,YEM-21/3420/SA 2/Health-Education/NGO/20662,8/20/2023 12:15:04 AM,Internally Displaced People,2359,2281,1838,1760,8238,3008,4987,4217,4117,16329
64,Yemen,2021,YEM-21/3420/SA 2/Health-Education/NGO/20662,8/20/2023 12:15:04 AM,Overall,4268,4126,3174,3032,14600,4763,7319,5922,5813,23817
64,Yemen,2021,YEM-21/3420/SA 2/Health-Nutrition/INGO/20534,8/14/2023 7:17:57 AM,Host Communities,7492,10270,8046,7779,33587,5089,8786,9067,8858,31800
64,Yemen,2021,YEM-21/3420/SA 2/Health-Nutrition/INGO/20534,8/14/2023 7:17:57 AM,Internally Displaced People,1007,2600,2188,2144,7939,397,440,1580,1763,4180
64,Yemen,2021,YEM-21/3420/SA 2/Health-Nutrition/INGO/20534,8/14/2023 7:17:57 AM,Overall,8499,12870,10234,9923,41526,5486,9226,10647,10621,35980
64,Yemen,2021,YEM-21/3420/SA 2/Health-Nutrition/NGO/20664,6/16/2023 9:10:29 AM,Host Communities,2335,2432,3503,3650,11920,5828,10183,5868,4923,26802
64,Yemen,2021,YEM-21/3420/SA 2/Health-Nutrition/NGO/20664,6/16/2023 9:10:29 AM,Internally Displaced People,1552,1615,2327,2425,7919,2356,2443,1998,1727,8524
64,Yemen,2021,YEM-21/3420/SA 2/Health-Nutrition/NGO/20664,6/16/2023 9:10:29 AM,Overall,3887,4047,5830,6075,19839,8184,12626,7866,6650,35326
64,Yemen,2021,YEM-21/3420/SA 2/Health-Nutrition/UN/20667,8/20/2023 1:12:54 AM,Host Communities,339178,185733,168072,123052,816035,147933,196823,243949,236926,825631
64,Yemen,2021,YEM-21/3420/SA 2/Health-Nutrition/UN/20667,8/20/2023 1:12:54 AM,Internally Displaced People,131650,99037,101556,86120,418363,22106,29410,36452,35402,123370
64,Yemen,2021,YEM-21/3420/SA 2/Health-Nutrition/UN/20667,8/20/2023 1:12:54 AM,Overall,470828,284770,269628,209172,1234398,170039,226233,280401,272328,949001
64,Yemen,2021,YEM-21/3420/SA 2/Health-Nutrition-Protection/NGO/20580,6/18/2023 9:27:35 AM,Host Communities,2268,2179,1932,1856,8235,2527,4388,6039,6316,19270
64,Yemen,2021,YEM-21/3420/SA 2/Health-Nutrition-Protection/NGO/20580,6/18/2023 9:27:35 AM,Internally Displaced People,972,934,828,795,3529,505,756,1160,1142,3563
64,Yemen,2021,YEM-21/3420/SA 2/Health-Nutrition-Protection/NGO/20580,6/18/2023 9:27:35 AM,Overall,3240,3113,2760,2651,11764,3032,5144,7199,7458,22833
64,Yemen,2021,YEM-21/3420/SA 2/Health-Nutrition-SHNFI-WASH/O/20542,7/16/2023 4:09:48 PM,Host Communities,12771,39796,28356,27893,108816,14209,44333,31222,30512,120276
64,Yemen,2021,YEM-21/3420/SA 2/Health-Nutrition-SHNFI-WASH/O/20542,7/16/2023 4:09:48 PM,Internally Displaced People,6043,17605,12660,12441,48749,8087,19655,15530,15267,58539
64,Yemen,2021,YEM-21/3420/SA 2/Health-Nutrition-SHNFI-WASH/O/20542,7/16/2023 4:09:48 PM,Overall,18814,57401,41016,40334,157565,22296,63988,46752,45779,178815
64,Yemen,2021,YEM-21/3420/SA 2/Health-Nutrition-WASH-Education-SHNFI/NGO/20643,7/29/2023 6:31:22 PM,Host Communities,4950,5054,4733,4826,19563,7762,8079,1658,1726,19225
64,Yemen,2021,YEM-21/3420/SA 2/Health-Nutrition-WASH-Education-SHNFI/NGO/20643,7/29/2023 6:31:22 PM,Internally Displaced People,1975,1964,1327,1215,6481,2690,1226,2890,1976,8782
64,Yemen,2021,YEM-21/3420/SA 2/Health-Nutrition-WASH-Education-SHNFI/NGO/20643,7/29/2023 6:31:22 PM,Overall,6925,7018,6060,6041,26044,10452,9305,4548,3702,28007
64,Yemen,2021,YEM-21/3420/SA 2/Health-Protection/NGO/20617,2/28/2023 12:34:45 PM,Host Communities,2314,7350,3067,2720,15451,9748,37234,9772,10556,67310
64,Yemen,2021,YEM-21/3420/SA 2/Health-Protection/NGO/20617,2/28/2023 12:34:45 PM,Internally Displaced People,1215,2780,1306,2154,7455,2299,6897,2418,2764,14378
64,Yemen,2021,YEM-21/3420/SA 2/Health-Protection/NGO/20617,2/28/2023 12:34:45 PM,Other,20,20,0,20,60,21,22,0,5,48
64,Yemen,2021,YEM-21/3420/SA 2/Health-Protection/NGO/20617,2/28/2023 12:34:45 PM,Overall,3700,11083,4587,5376,24746,12079,45557,12327,13605,83568
64,Yemen,2021,YEM-21/3420/SA 2/Health-Protection/NGO/20617,2/28/2023 12:34:45 PM,Returnees,151,933,214,482,1780,11,1404,137,280,1832
64,Yemen,2021,YEM-21/3420/SA 2/Health-WASH-Education-SHNFI/NGO/20665,7/30/2023 10:55:30 AM,Host Communities,16666,18053,17199,20130,72048,31373,33987,30066,35295,130721
64,Yemen,2021,YEM-21/3420/SA 2/Health-WASH-Education-SHNFI/NGO/20665,7/30/2023 10:55:30 AM,Internally Displaced People,6412,6950,6454,7562,27378,9931,10759,9517,11137,41344
64,Yemen,2021,YEM-21/3420/SA 2/Health-WASH-Education-SHNFI/NGO/20665,7/30/2023 10:55:30 AM,Overall,23078,25003,23653,27692,99426,41304,44746,39583,46432,172065
64,Yemen,2021,YEM-21/3420/SA 2/Protection/INGO/20551,6/3/2023 9:38:16 PM,Host Communities,643,449,703,569,2364,819,975,2754,3146,7694
64,Yemen,2021,YEM-21/3420/SA 2/Protection/INGO/20551,6/3/2023 9:38:16 PM,Internally Displaced People,429,299,469,379,1576,789,1102,1247,1299,4437
64,Yemen,2021,YEM-21/3420/SA 2/Protection/INGO/20551,6/3/2023 9:38:16 PM,Overall,1072,748,1172,948,3940,1608,2077,4001,4445,12131
64,Yemen,2021,YEM-21/3420/SA 2/Protection/INGO/20570,10/1/2023 7:34:35 AM,Host Communities,1520,2780,1440,1200,6940,2335,1446,4987,3408,12176
64,Yemen,2021,YEM-21/3420/SA 2/Protection/INGO/20570,10/1/2023 7:34:35 AM,Internally Displaced People,880,1720,760,600,3960,29,90,49,39,207
64,Yemen,2021,YEM-21/3420/SA 2/Protection/INGO/20570,10/1/2023 7:34:35 AM,Other,50,50,0,0,100,34,14,0,0,48
64,Yemen,2021,YEM-21/3420/SA 2/Protection/INGO/20570,10/1/2023 7:34:35 AM,Overall,2450,4550,2200,1800,11000,2398,1550,5036,3447,12431
64,Yemen,2021,YEM-21/3420/SA 2/Protection/INGO/20710,9/5/2023 9:32:57 AM,Host Communities,482,1133,338,338,2291,1667,3339,524,425,5955
64,Yemen,2021,YEM-21/3420/SA 2/Protection/INGO/20710,9/5/2023 9:32:57 AM,Internally Displaced People,1926,4531,1351,1351,9159,2763,4807,843,806,9219
64,Yemen,2021,YEM-21/3420/SA 2/Protection/INGO/20710,9/5/2023 9:32:57 AM,Overall,2408,5664,1689,1689,11450,4430,8146,1367,1231,15174
64,Yemen,2021,YEM-21/3420/SA 2/Protection/INGO/20740,10/10/2023 4:09:29 AM,Host Communities,1512,840,504,504,3360,2125,1045,452,168,3790
64,Yemen,2021,YEM-21/3420/SA 2/Protection/INGO/20740,10/10/2023 4:09:29 AM,Internally Displaced People,648,360,216,216,1440,544,246,512,234,1536
64,Yemen,2021,YEM-21/3420/SA 2/Protection/INGO/20740,10/10/2023 4:09:29 AM,Overall,2160,1200,720,720,4800,2669,1291,964,402,5326
64,Yemen,2021,YEM-21/3420/SA 2/RRM/UN/20690,11/7/2022 8:38:29 AM,Internally Displaced People,16800,16800,18200,18200,70000,16800,16800,18200,18200,70000
64,Yemen,2021,YEM-21/3420/SA 2/RRM/UN/20690,11/7/2022 8:38:29 AM,Overall,16800,16800,18200,18200,70000,16800,16800,18200,18200,70000
64,Yemen,2021,YEM-21/3420/SA 2/RRM/UN/20789,4/16/2023 11:58:51 AM,Internally Displaced People,25200,27300,25200,27300,105000,27798,30115,27798,30115,115826
64,Yemen,2021,YEM-21/3420/SA 2/RRM/UN/20789,4/16/2023 11:58:51 AM,Overall,25200,27300,25200,27300,105000,27798,30115,27798,30115,115826
64,Yemen,2021,YEM-21/3420/SA 2/RRM/UN/20793,11/26/2022 3:48:54 PM,Internally Displaced People,28000,28000,28000,28000,112000,29168,29167,29167,29167,116669
64,Yemen,2021,YEM-21/3420/SA 2/RRM/UN/20793,11/26/2022 3:48:54 PM,Overall,28000,28000,28000,28000,112000,29168,29167,29167,29167,116669
64,Yemen,2021,YEM-21/3420/SA 2/SHNFI/NGO/20692,3/24/2023 11:19:09 PM,Host Communities,240,288,276,396,1200,431,487,666,573,2157
64,Yemen,2021,YEM-21/3420/SA 2/SHNFI/NGO/20692,3/24/2023 11:19:09 PM,Internally Displaced People,960,1152,1104,1584,4800,1026,1070,1431,1231,4758
64,Yemen,2021,YEM-21/3420/SA 2/SHNFI/NGO/20692,3/24/2023 11:19:09 PM,Overall,1200,1440,1380,1980,6000,1457,1557,2097,1804,6915
64,Yemen,2021,YEM-21/3420/SA 2/SHNFI-CCM-WASH-Protection/NGO/20571,4/16/2023 9:27:21 AM,Host Communities,123,116,122,108,469,5,4,2,2,13
64,Yemen,2021,YEM-21/3420/SA 2/SHNFI-CCM-WASH-Protection/NGO/20571,4/16/2023 9:27:21 AM,Internally Displaced People,536,507,533,470,2046,435,541,910,943,2829
64,Yemen,2021,YEM-21/3420/SA 2/SHNFI-CCM-WASH-Protection/NGO/20571,4/16/2023 9:27:21 AM,Overall,659,623,655,578,2515,440,545,912,945,2842
64,Yemen,2021,YEM-21/3420/SA 2/SHNFI-Protection/NGO/20642,11/26/2022 3:21:03 PM,Internally Displaced People,12,7,9,14,42,8,8,4,4,24
64,Yemen,2021,YEM-21/3420/SA 2/SHNFI-Protection/NGO/20642,11/26/2022 3:21:03 PM,Overall,92,62,71,83,308,126,148,69,91,434
64,Yemen,2021,YEM-21/3420/SA 2/SHNFI-Protection/NGO/20642,11/26/2022 3:21:03 PM,Returnees,80,55,62,69,266,118,140,65,87,410
64,Yemen,2021,YEM-21/3420/SA 2/WASH-Education-SHNFI/NGO/20644,7/27/2023 8:50:33 AM,Host Communities,2099,2204,3222,3338,10863,9252,9630,1976,2056,22914
64,Yemen,2021,YEM-21/3420/SA 2/WASH-Education-SHNFI/NGO/20644,7/27/2023 8:50:33 AM,Internally Displaced People,1894,1988,2746,2840,9468,2663,2592,1752,1675,8682
64,Yemen,2021,YEM-21/3420/SA 2/WASH-Education-SHNFI/NGO/20644,7/27/2023 8:50:33 AM,Overall,3993,4192,5968,6178,20331,11915,12222,3728,3731,31596
64,Yemen,2021,YEM-21/3420/SA 2/WASH-FSAC/INGO/20533,8/15/2023 7:24:29 AM,Internally Displaced People,831,788,994,939,3552,582,765,710,583,2640
64,Yemen,2021,YEM-21/3420/SA 2/WASH-FSAC/INGO/20533,8/15/2023 7:24:29 AM,Overall,1158,1237,1386,1309,5090,1682,2261,1959,1734,7636
64,Yemen,2021,YEM-21/3420/SA 2/WASH-FSAC/INGO/20533,8/15/2023 7:24:29 AM,Returnees,327,449,392,370,1538,1100,1496,1249,1151,4996
64,Yemen,2021,YEM-21/3420/SA 2/WASH-FSAC-Protection/INGO/20677,6/18/2023 7:39:32 AM,Host Communities,711,586,743,687,2727,802,789,579,560,2730
64,Yemen,2021,YEM-21/3420/SA 2/WASH-FSAC-Protection/INGO/20677,6/18/2023 7:39:32 AM,Internally Displaced People,2950,2496,3064,2837,11347,4712,4631,3397,3285,16025
64,Yemen,2021,YEM-21/3420/SA 2/WASH-FSAC-Protection/INGO/20677,6/18/2023 7:39:32 AM,Overall,3661,3082,3807,3524,14074,5514,5420,3976,3845,18755
64,Yemen,2021,YEM-21/3420/SA 2/WASH-Health-Protection/NGO/20620,2/13/2023 6:44:51 AM,Host Communities,36334,27947,26587,24132,115000,45303,46777,28699,27618,148397
64,Yemen,2021,YEM-21/3420/SA 2/WASH-Health-Protection/NGO/20620,2/13/2023 6:44:51 AM,Internally Displaced People,2592,2484,2808,2916,10800,22893,30097,24676,24727,102393
64,Yemen,2021,YEM-21/3420/SA 2/WASH-Health-Protection/NGO/20620,2/13/2023 6:44:51 AM,Overall,38926,30431,29395,27048,125800,68196,76874,53375,52345,250790
64,Yemen,2021,YEM-21/3420/SA 2/WASH-SHNFI/UN/20725,3/21/2023 7:28:27 AM,Host Communities,246,234,243,249,972,343,346,477,450,1616
64,Yemen,2021,YEM-21/3420/SA 2/WASH-SHNFI/UN/20725,3/21/2023 7:28:27 AM,Internally Displaced People,2284,2324,2056,2154,8818,3106,3182,4319,3913,14520
64,Yemen,2021,YEM-21/3420/SA 2/WASH-SHNFI/UN/20725,3/21/2023 7:28:27 AM,Overall,2530,2558,2299,2403,9790,3449,3528,4796,4363,16136
64,Yemen,2021,YEM-21/3420/SA1/CCM/NGO/19406,12/7/2022 6:33:08 AM,Host Communities,1798,1867,1591,1660,6916,1825,1898,1616,1686,7025
64,Yemen,2021,YEM-21/3420/SA1/CCM/NGO/19406,12/7/2022 6:33:08 AM,Internally Displaced People,7193,7470,6363,6640,27666,7300,7593,6462,6744,28099
64,Yemen,2021,YEM-21/3420/SA1/CCM/NGO/19406,12/7/2022 6:33:08 AM,Overall,8991,9337,7954,8300,34582,9125,9491,8078,8430,35124
64,Yemen,2021,YEM-21/3420/SA1/CCM/UN/19251,2/26/2023 7:54:36 AM,Host Communities,787,826,1260,1063,3936,3433,3612,4517,4059,15621
64,Yemen,2021,YEM-21/3420/SA1/CCM/UN/19251,2/26/2023 7:54:36 AM,Internally Displaced People,3784,3974,6056,5110,18924,4884,5146,7393,6588,24011
64,Yemen,2021,YEM-21/3420/SA1/CCM/UN/19251,2/26/2023 7:54:36 AM,Overall,4571,4800,7316,6173,22860,8317,8758,11910,10647,39632
64,Yemen,2021,YEM-21/3420/SA1/CCM-FSAC-Protection-SHNFI/INGO/19350,5/3/2023 2:30:17 PM,Host Communities,3214,3507,3246,3438,13405,1277,1884,1367,1566,6094
64,Yemen,2021,YEM-21/3420/SA1/CCM-FSAC-Protection-SHNFI/INGO/19350,5/3/2023 2:30:17 PM,Internally Displaced People,10198,10824,10116,10604,41742,4892,5534,6091,5595,22112
64,Yemen,2021,YEM-21/3420/SA1/CCM-FSAC-Protection-SHNFI/INGO/19350,5/3/2023 2:30:17 PM,Overall,14620,15591,14727,15467,60405,6681,7991,8122,7750,30544
64,Yemen,2021,YEM-21/3420/SA1/CCM-FSAC-Protection-SHNFI/INGO/19350,5/3/2023 2:30:17 PM,Returnees,1208,1260,1365,1425,5258,512,573,664,589,2338
64,Yemen,2021,YEM-21/3420/SA1/CCM-SHNFI/INGO/19160,9/14/2023 9:24:19 AM,Host Communities,46193,46184,46222,46190,184789,998,1096,1302,1390,4786
64,Yemen,2021,YEM-21/3420/SA1/CCM-SHNFI/INGO/19160,9/14/2023 9:24:19 AM,Internally Displaced People,46725,46063,50423,48348,191559,18804,19013,22784,20785,81386
64,Yemen,2021,YEM-21/3420/SA1/CCM-SHNFI/INGO/19160,9/14/2023 9:24:19 AM,Other,9376,9369,9402,9381,37528,1,1,5,1,8
64,Yemen,2021,YEM-21/3420/SA1/CCM-SHNFI/INGO/19160,9/14/2023 9:24:19 AM,Overall,102294,101616,106047,103919,413876,19803,20110,24091,22176,86180
64,Yemen,2021,YEM-21/3420/SA1/CCM-SHNFI/NGO/19354,9/19/2022 10:40:35 AM,Host Communities,973,638,605,1143,3359,2496,2763,2559,2805,10623
64,Yemen,2021,YEM-21/3420/SA1/CCM-SHNFI/NGO/19354,9/19/2022 10:40:35 AM,Internally Displaced People,8723,5718,5426,10243,30110,8104,8532,8369,8496,33501
64,Yemen,2021,YEM-21/3420/SA1/CCM-SHNFI/NGO/19354,9/19/2022 10:40:35 AM,Overall,9696,6356,6031,11386,33469,10600,11295,10928,11301,44124
64,Yemen,2021,YEM-21/3420/SA1/CCM-WASH/INGO/19696,2/27/2023 8:08:25 AM,Internally Displaced People,7475,6766,6107,5751,26099,8654,8278,10160,10536,37628
64,Yemen,2021,YEM-21/3420/SA1/CCM-WASH/INGO/19696,2/27/2023 8:08:25 AM,Overall,7475,6766,6107,5751,26099,8654,8278,10160,10536,37628
64,Yemen,2021,YEM-21/3420/SA1/Education/INGO/19439,10/5/2023 11:05:06 AM,Host Communities,0,0,840,660,1500,3,81,1943,716,2743
64,Yemen,2021,YEM-21/3420/SA1/Education/INGO/19439,10/5/2023 11:05:06 AM,Internally Displaced People,0,0,840,660,1500,0,0,648,283,931
64,Yemen,2021,YEM-21/3420/SA1/Education/INGO/19439,10/5/2023 11:05:06 AM,Overall,0,0,1680,1320,3000,3,81,2591,999,3674
64,Yemen,2021,YEM-21/3420/SA1/Education/NGO/19269,3/1/2023 8:42:12 AM,Host Communities,300,300,3867,2623,7090,619,434,3746,2707,7506
64,Yemen,2021,YEM-21/3420/SA1/Education/NGO/19269,3/1/2023 8:42:12 AM,Internally Displaced People,200,200,472,197,1069,394,174,294,160,1022
64,Yemen,2021,YEM-21/3420/SA1/Education/NGO/19269,3/1/2023 8:42:12 AM,Overall,500,500,4339,2820,8159,1013,608,4040,2867,8528
64,Yemen,2021,YEM-21/3420/SA1/Education/NGO/19417,9/4/2022 3:32:29 PM,Host Communities,233,707,4714,5930,11584,685,1211,12887,10870,25653
64,Yemen,2021,YEM-21/3420/SA1/Education/NGO/19417,9/4/2022 3:32:29 PM,Internally Displaced People,105,105,2539,2626,5375,200,200,2600,2660,5660
64,Yemen,2021,YEM-21/3420/SA1/Education/NGO/19417,9/4/2022 3:32:29 PM,Overall,338,812,7253,8556,16959,885,1411,15487,13530,31313
64,Yemen,2021,YEM-21/3420/SA1/Education/NGO/19423,7/19/2022 12:04:08 PM,Host Communities,40,160,1020,1205,2425,150,850,1666,1968,4634
64,Yemen,2021,YEM-21/3420/SA1/Education/NGO/19423,7/19/2022 12:04:08 PM,Internally Displaced People,0,0,553,282,835,0,0,903,461,1364
64,Yemen,2021,YEM-21/3420/SA1/Education/NGO/19423,7/19/2022 12:04:08 PM,Overall,40,160,2592,2702,5494,150,850,6596,6555,14151
64,Yemen,2021,YEM-21/3420/SA1/Education/NGO/19423,7/19/2022 12:04:08 PM,Returnees,0,0,1019,1215,2234,0,0,4027,4126,8153
64,Yemen,2021,YEM-21/3420/SA1/Education/NGO/19496,8/15/2022 1:28:02 PM,Host Communities,30,30,2214,2304,4578,35,72,3196,3620,6923
64,Yemen,2021,YEM-21/3420/SA1/Education/NGO/19496,8/15/2022 1:28:02 PM,Internally Displaced People,15,15,1192,1241,2463,22,3,452,582,1059
64,Yemen,2021,YEM-21/3420/SA1/Education/NGO/19496,8/15/2022 1:28:02 PM,Overall,45,45,3406,3545,7041,57,75,3648,4202,7982
64,Yemen,2021,YEM-21/3420/SA1/Education/NGO/19540,11/21/2022 11:47:50 AM,Host Communities,225,264,1944,2118,4551,234,253,1856,1548,3891
64,Yemen,2021,YEM-21/3420/SA1/Education/NGO/19540,11/21/2022 11:47:50 AM,Internally Displaced People,0,0,638,453,1091,0,0,614,968,1582
64,Yemen,2021,YEM-21/3420/SA1/Education/NGO/19540,11/21/2022 11:47:50 AM,Overall,225,264,2582,2571,5642,234,253,2470,2516,5473
64,Yemen,2021,YEM-21/3420/SA1/Education/NGO/19612,11/14/2022 7:13:32 AM,Host Communities,82,37,1392,1272,2783,90,43,1436,1495,3064
64,Yemen,2021,YEM-21/3420/SA1/Education/NGO/19612,11/14/2022 7:13:32 AM,Internally Displaced People,33,48,942,911,1934,20,57,777,888,1742
64,Yemen,2021,YEM-21/3420/SA1/Education/NGO/19612,11/14/2022 7:13:32 AM,Overall,115,85,2334,2183,4717,110,100,2213,2383,4806
64,Yemen,2021,YEM-21/3420/SA1/Education/NGO/19662,11/22/2022 7:35:00 AM,Host Communities,40,32,4378,3604,8054,21,91,5759,4721,10592
64,Yemen,2021,YEM-21/3420/SA1/Education/NGO/19662,11/22/2022 7:35:00 AM,Internally Displaced People,0,133,1967,1619,3719,9,84,652,524,1269
64,Yemen,2021,YEM-21/3420/SA1/Education/NGO/19662,11/22/2022 7:35:00 AM,Overall,40,165,6345,5223,11773,30,175,6411,5245,11861
64,Yemen,2021,YEM-21/3420/SA1/Education-CCM-SHNFI-Protection/INGO/19351,7/11/2023 11:42:32 AM,Host Communities,868,991,5729,6011,13599,193,367,4137,5422,10119
64,Yemen,2021,YEM-21/3420/SA1/Education-CCM-SHNFI-Protection/INGO/19351,7/11/2023 11:42:32 AM,Internally Displaced People,6971,7597,8755,9601,32924,5381,5814,8177,9348,28720
64,Yemen,2021,YEM-21/3420/SA1/Education-CCM-SHNFI-Protection/INGO/19351,7/11/2023 11:42:32 AM,Overall,7839,8588,14484,15612,46523,5574,6181,12314,14770,38839
64,Yemen,2021,YEM-21/3420/SA1/Education-Health-WASH/INGO/19531,4/3/2023 6:45:06 AM,Host Communities,5519,7621,9061,8757,30958,16769,23351,19850,20536,80506
64,Yemen,2021,YEM-21/3420/SA1/Education-Health-WASH/INGO/19531,4/3/2023 6:45:06 AM,Internally Displaced People,4073,5483,6895,7113,23564,878,1818,1194,1399,5289
64,Yemen,2021,YEM-21/3420/SA1/Education-Health-WASH/INGO/19531,4/3/2023 6:45:06 AM,Overall,9592,13104,15956,15870,54522,17647,25169,21044,21935,85795
64,Yemen,2021,YEM-21/3420/SA1/Education-WASH-SHNFI-FSAC/INGO/19174,2/26/2023 12:24:58 PM,Host Communities,8796,9110,10155,10659,38720,10683,10896,11575,11805,44959
64,Yemen,2021,YEM-21/3420/SA1/Education-WASH-SHNFI-FSAC/INGO/19174,2/26/2023 12:24:58 PM,Internally Displaced People,9730,10214,10417,11013,41374,11377,12200,12323,13218,49118
64,Yemen,2021,YEM-21/3420/SA1/Education-WASH-SHNFI-FSAC/INGO/19174,2/26/2023 12:24:58 PM,Overall,18526,19324,20572,21672,80094,22060,23096,23898,25023,94077
64,Yemen,2021,YEM-21/3420/SA1/FSAC/NGO/19189,11/14/2022 8:10:41 AM,Internally Displaced People,1848,1827,1837,1691,7203,1110,1374,2171,2089,6744
64,Yemen,2021,YEM-21/3420/SA1/FSAC/NGO/19189,11/14/2022 8:10:41 AM,Overall,1848,1827,1837,1691,7203,1110,1374,2171,2089,6744
64,Yemen,2021,YEM-21/3420/SA1/FSAC/NGO/19300,2/22/2023 8:05:10 AM,Host Communities,403,405,712,720,2240,375,531,719,717,2342
64,Yemen,2021,YEM-21/3420/SA1/FSAC/NGO/19300,2/22/2023 8:05:10 AM,Internally Displaced People,247,257,370,386,1260,187,209,374,372,1142
64,Yemen,2021,YEM-21/3420/SA1/FSAC/NGO/19300,2/22/2023 8:05:10 AM,Overall,650,662,1082,1106,3500,562,740,1093,1089,3484
64,Yemen,2021,YEM-21/3420/SA1/FSAC/NGO/19412,11/4/2022 4:12:27 PM,Host Communities,1449,1701,1512,1638,6300,1164,1727,1165,1034,5090
64,Yemen,2021,YEM-21/3420/SA1/FSAC/NGO/19412,11/4/2022 4:12:27 PM,Overall,1449,1701,1512,1638,6300,1164,1727,1165,1034,5090
64,Yemen,2021,YEM-21/3420/SA1/FSAC/NGO/19548,6/11/2023 8:00:02 AM,Host Communities,832,956,827,885,3500,813,841,1044,987,3685
64,Yemen,2021,YEM-21/3420/SA1/FSAC/NGO/19548,6/11/2023 8:00:02 AM,Internally Displaced People,167,191,165,177,700,47,52,75,109,283
64,Yemen,2021,YEM-21/3420/SA1/FSAC/NGO/19548,6/11/2023 8:00:02 AM,Overall,999,1147,992,1062,4200,860,893,1119,1096,3968
64,Yemen,2021,YEM-21/3420/SA1/FSAC-Nutrition/INGO/19574,5/30/2023 7:24:42 PM,Internally Displaced People,1534,1486,1282,1265,5567,473,510,736,727,2446
64,Yemen,2021,YEM-21/3420/SA1/FSAC-Nutrition/INGO/19574,5/30/2023 7:24:42 PM,Other,2504,2425,2091,2063,9083,778,1329,2573,2571,7251
64,Yemen,2021,YEM-21/3420/SA1/FSAC-Nutrition/INGO/19574,5/30/2023 7:24:42 PM,Overall,4038,3911,3373,3328,14650,1251,1839,3309,3298,9697
64,Yemen,2021,YEM-21/3420/SA1/FSAC-WASH/INGO/19411,4/10/2023 12:49:35 PM,Host Communities,4937,5110,4512,4407,18966,939,923,1145,1135,4142
64,Yemen,2021,YEM-21/3420/SA1/FSAC-WASH/INGO/19411,4/10/2023 12:49:35 PM,Internally Displaced People,3352,3587,3744,3408,14091,2085,2281,2454,2492,9312
64,Yemen,2021,YEM-21/3420/SA1/FSAC-WASH/INGO/19411,4/10/2023 12:49:35 PM,Overall,8289,8697,8256,7815,33057,3024,3204,3599,3627,13454
64,Yemen,2021,YEM-21/3420/SA1/FSAC-WASH/INGO/19520,4/17/2023 10:45:03 PM,Host Communities,2401,2288,3332,3417,11438,830,844,588,608,2870
64,Yemen,2021,YEM-21/3420/SA1/FSAC-WASH/INGO/19520,4/17/2023 10:45:03 PM,Internally Displaced People,2942,2801,4302,3962,14007,1598,1626,1134,1172,5530
64,Yemen,2021,YEM-21/3420/SA1/FSAC-WASH/INGO/19520,4/17/2023 10:45:03 PM,Overall,5343,5089,7634,7379,25445,2428,2470,1722,1780,8400
64,Yemen,2021,YEM-21/3420/SA1/Health/INGO/19186,9/26/2023 12:26:27 PM,Host Communities,21904,21045,17071,16402,76422,26384,61927,22987,28717,140015
64,Yemen,2021,YEM-21/3420/SA1/Health/INGO/19186,9/26/2023 12:26:27 PM,Internally Displaced People,12671,12175,9876,9488,44210,4727,7550,3277,4205,19759
64,Yemen,2021,YEM-21/3420/SA1/Health/INGO/19186,9/26/2023 12:26:27 PM,Overall,34575,33220,26947,25890,120632,31111,69477,26264,32922,159774
64,Yemen,2021,YEM-21/3420/SA1/Health/INGO/19428,2/22/2023 1:07:11 PM,Host Communities,2456,2556,2092,2177,9281,2423,3496,3866,2749,12534
64,Yemen,2021,YEM-21/3420/SA1/Health/INGO/19428,2/22/2023 1:07:11 PM,Internally Displaced People,273,284,232,242,1031,99,112,141,88,440
64,Yemen,2021,YEM-21/3420/SA1/Health/INGO/19428,2/22/2023 1:07:11 PM,Overall,2729,2840,2324,2419,10312,2522,3608,4007,2837,12974
64,Yemen,2021,YEM-21/3420/SA1/Health/INGO/19604,2/22/2023 7:39:15 AM,Host Communities,6757,6979,4273,4497,22506,1209,1624,1446,1061,5340
64,Yemen,2021,YEM-21/3420/SA1/Health/INGO/19604,2/22/2023 7:39:15 AM,Internally Displaced People,1192,1232,754,794,3972,71,133,179,132,515
64,Yemen,2021,YEM-21/3420/SA1/Health/INGO/19604,2/22/2023 7:39:15 AM,Overall,7949,8211,5027,5291,26478,1280,1757,1625,1193,5855
64,Yemen,2021,YEM-21/3420/SA1/Health/INGO/19664,3/20/2023 11:35:43 AM,Host Communities,7,9,4,4,24,13,21,8,3,45
64,Yemen,2021,YEM-21/3420/SA1/Health/INGO/19664,3/20/2023 11:35:43 AM,Internally Displaced People,21,29,11,11,72,17,11,14,4,46
64,Yemen,2021,YEM-21/3420/SA1/Health/INGO/19664,3/20/2023 11:35:43 AM,Overall,28,38,15,15,96,30,32,22,7,91
64,Yemen,2021,YEM-21/3420/SA1/Health/NGO/19453,10/5/2022 6:37:59 AM,Host Communities,3250,3397,3988,4136,14771,2911,11178,4250,4284,22623
64,Yemen,2021,YEM-21/3420/SA1/Health/NGO/19453,10/5/2022 6:37:59 AM,Internally Displaced People,910,952,1117,1158,4137,633,3408,1014,1069,6124
64,Yemen,2021,YEM-21/3420/SA1/Health/NGO/19453,10/5/2022 6:37:59 AM,Overall,4160,4349,5105,5294,18908,3544,14586,5264,5353,28747
64,Yemen,2021,YEM-21/3420/SA1/Health-Nutrition/INGO/19181,11/29/2022 6:52:47 AM,Host Communities,110,1000,400,600,2110,952,3139,2491,2451,9033
64,Yemen,2021,YEM-21/3420/SA1/Health-Nutrition/INGO/19181,11/29/2022 6:52:47 AM,Internally Displaced People,219,1800,200,600,2819,513,1682,1340,1319,4854
64,Yemen,2021,YEM-21/3420/SA1/Health-Nutrition/INGO/19181,11/29/2022 6:52:47 AM,Overall,329,2800,600,1200,4929,1465,4821,3831,3770,13887
64,Yemen,2021,YEM-21/3420/SA1/Health-Nutrition/NGO/19503,2/28/2023 10:02:24 AM,Host Communities,5198,6782,4556,4348,20884,7113,9903,7764,7381,32161
64,Yemen,2021,YEM-21/3420/SA1/Health-Nutrition/NGO/19503,2/28/2023 10:02:24 AM,Internally Displaced People,1961,2558,1718,1640,7877,1186,1012,1648,1075,4921
64,Yemen,2021,YEM-21/3420/SA1/Health-Nutrition/NGO/19503,2/28/2023 10:02:24 AM,Overall,7159,9340,6274,5988,28761,8299,10915,9412,8456,37082
64,Yemen,2021,YEM-21/3420/SA1/Health-Nutrition/NGO/19679,2/13/2023 6:41:15 AM,Host Communities,1179,1133,1004,965,4281,1342,2906,2541,2955,9744
64,Yemen,2021,YEM-21/3420/SA1/Health-Nutrition/NGO/19679,2/13/2023 6:41:15 AM,Internally Displaced People,99,96,85,81,361,392,1420,1433,1393,4638
64,Yemen,2021,YEM-21/3420/SA1/Health-Nutrition/NGO/19679,2/13/2023 6:41:15 AM,Overall,1278,1229,1089,1046,4642,1734,4326,3974,4348,14382
64,Yemen,2021,YEM-21/3420/SA1/Health-Nutrition/O/19345,6/6/2023 11:57:13 AM,Host Communities,34575,78303,30351,33557,176786,31681,72715,29289,30106,163791
64,Yemen,2021,YEM-21/3420/SA1/Health-Nutrition/O/19345,6/6/2023 11:57:13 AM,Internally Displaced People,3172,7419,4458,3843,18892,6765,13743,5764,5850,32122
64,Yemen,2021,YEM-21/3420/SA1/Health-Nutrition/O/19345,6/6/2023 11:57:13 AM,Overall,37747,85722,34809,37400,195678,38446,86458,35053,35956,195913
64,Yemen,2021,YEM-21/3420/SA1/Health-Nutrition-Education/INGO/19553,11/20/2022 12:59:57 PM,Host Communities,11586,12059,2612,2719,28976,15003,25346,20123,23768,84240
64,Yemen,2021,YEM-21/3420/SA1/Health-Nutrition-Education/INGO/19553,11/20/2022 12:59:57 PM,Internally Displaced People,1159,1206,472,328,3165,2549,2495,4305,4351,13700
64,Yemen,2021,YEM-21/3420/SA1/Health-Nutrition-Education/INGO/19553,11/20/2022 12:59:57 PM,Overall,12745,13265,3084,3047,32141,17552,27841,24428,28119,97940
64,Yemen,2021,YEM-21/3420/SA1/Health-Nutrition-WASH/INGO/19292,2/27/2023 10:49:01 AM,Host Communities,1238,1735,1770,1721,6464,295,806,646,726,2473
64,Yemen,2021,YEM-21/3420/SA1/Health-Nutrition-WASH/INGO/19292,2/27/2023 10:49:01 AM,Internally Displaced People,1981,2364,2636,2555,9536,1855,6161,5431,5848,19295
64,Yemen,2021,YEM-21/3420/SA1/Health-Nutrition-WASH/INGO/19292,2/27/2023 10:49:01 AM,Overall,3219,4099,4406,4276,16000,2150,6967,6077,6574,21768
64,Yemen,2021,YEM-21/3420/SA1/Nutrition/INGO/19168,12/21/2022 6:06:07 AM,Host Communities,200,3315,1016,1058,5589,12,4384,722,832,5950
64,Yemen,2021,YEM-21/3420/SA1/Nutrition/INGO/19168,12/21/2022 6:06:07 AM,Internally Displaced People,22,368,113,117,620,0,274,73,96,443
64,Yemen,2021,YEM-21/3420/SA1/Nutrition/INGO/19168,12/21/2022 6:06:07 AM,Overall,222,3683,1129,1175,6209,12,4658,795,928,6393
64,Yemen,2021,YEM-21/3420/SA1/Nutrition/UN/19187,12/5/2022 5:42:25 AM,Host Communities,0,0,3262,3263,6525,0,0,2768,3757,6525
64,Yemen,2021,YEM-21/3420/SA1/Nutrition/UN/19187,12/5/2022 5:42:25 AM,Internally Displaced People,0,0,487,488,975,0,0,411,564,975
64,Yemen,2021,YEM-21/3420/SA1/Nutrition/UN/19187,12/5/2022 5:42:25 AM,Overall,0,0,3749,3751,7500,0,0,3179,4321,7500
64,Yemen,2021,YEM-21/3420/SA1/Nutrition-Health-WASH/INGO/19164,10/5/2023 6:22:51 AM,Host Communities,3828,10271,9273,9381,32753,1308,8674,6573,6558,23113
64,Yemen,2021,YEM-21/3420/SA1/Nutrition-Health-WASH/INGO/19164,10/5/2023 6:22:51 AM,Internally Displaced People,872,3311,3336,3443,10962,5047,10887,7001,6646,29581
64,Yemen,2021,YEM-21/3420/SA1/Nutrition-Health-WASH/INGO/19164,10/5/2023 6:22:51 AM,Overall,4700,13582,12609,12824,43715,6355,19561,13574,13204,52694
64,Yemen,2021,YEM-21/3420/SA1/Protection/INGO/19159,11/21/2022 11:49:56 AM,Host Communities,2016,2016,2016,2016,8064,4325,1051,5267,2875,13518
64,Yemen,2021,YEM-21/3420/SA1/Protection/INGO/19159,11/21/2022 11:49:56 AM,Internally Displaced People,2016,2016,2016,2016,8064,138,44,351,252,785
64,Yemen,2021,YEM-21/3420/SA1/Protection/INGO/19159,11/21/2022 11:49:56 AM,Overall,4032,4032,4032,4032,16128,4463,1095,5618,3127,14303
64,Yemen,2021,YEM-21/3420/SA1/Protection/INGO/19441,5/21/2023 10:59:44 AM,Host Communities,25,248,390,265,928,89,87,364,198,738
64,Yemen,2021,YEM-21/3420/SA1/Protection/INGO/19441,5/21/2023 10:59:44 AM,Internally Displaced People,25,248,392,267,932,0,0,121,91,212
64,Yemen,2021,YEM-21/3420/SA1/Protection/INGO/19441,5/21/2023 10:59:44 AM,Overall,50,496,782,532,1860,89,87,485,289,950
64,Yemen,2021,YEM-21/3420/SA1/Protection/INGO/19524,12/14/2022 6:12:37 AM,Host Communities,1050,1960,910,700,4620,426,1373,1041,1005,3845
64,Yemen,2021,YEM-21/3420/SA1/Protection/INGO/19524,12/14/2022 6:12:37 AM,Internally Displaced People,450,840,390,300,1980,575,1209,782,585,3151
64,Yemen,2021,YEM-21/3420/SA1/Protection/INGO/19524,12/14/2022 6:12:37 AM,Overall,1500,2800,1300,1000,6600,1001,2582,1823,1590,6996
64,Yemen,2021,YEM-21/3420/SA1/Protection/NGO/19324,6/4/2023 5:03:51 PM,Host Communities,1553,1018,966,1824,5361,4891,5212,4547,4113,18763
64,Yemen,2021,YEM-21/3420/SA1/Protection/NGO/19324,6/4/2023 5:03:51 PM,Internally Displaced People,2331,1528,1449,2736,8044,752,1161,979,873,3765
64,Yemen,2021,YEM-21/3420/SA1/Protection/NGO/19324,6/4/2023 5:03:51 PM,Overall,3884,2546,2415,4560,13405,5643,6373,5526,4986,22528
64,Yemen,2021,YEM-21/3420/SA1/Protection/UN/19486,11/7/2022 7:54:58 AM,Host Communities,400,4800,800,2000,8000,410,5411,996,2274,9091
64,Yemen,2021,YEM-21/3420/SA1/Protection/UN/19486,11/7/2022 7:54:58 AM,Internally Displaced People,1600,19200,3200,8000,32000,1688,20100,3330,9600,34718
64,Yemen,2021,YEM-21/3420/SA1/Protection/UN/19486,11/7/2022 7:54:58 AM,Overall,2000,24000,4000,10000,40000,2098,25511,4326,11874,43809
64,Yemen,2021,YEM-21/3420/SA1/RRM/INGO/19534,9/25/2023 3:48:05 AM,Host Communities,738,799,738,799,3074,0,0,0,0,0
64,Yemen,2021,YEM-21/3420/SA1/RRM/INGO/19534,9/25/2023 3:48:05 AM,Internally Displaced People,3366,3204,2744,2917,12231,3838,4162,3852,4157,16009
64,Yemen,2021,YEM-21/3420/SA1/RRM/INGO/19534,9/25/2023 3:48:05 AM,Overall,4230,4136,3608,3853,15827,3838,4162,3852,4157,16009
64,Yemen,2021,YEM-21/3420/SA1/RRM/INGO/19534,9/25/2023 3:48:05 AM,Returnees,126,133,126,137,522,0,0,0,0,0
64,Yemen,2021,YEM-21/3420/SA1/RRM/UN/19249,12/11/2022 6:15:39 AM,Internally Displaced People,3850,4024,4903,4723,17500,7818,8204,8332,8870,33224
64,Yemen,2021,YEM-21/3420/SA1/RRM/UN/19249,12/11/2022 6:15:39 AM,Overall,3850,4024,4903,4723,17500,7818,8204,8332,8870,33224
64,Yemen,2021,YEM-21/3420/SA1/SHNFI/NGO/19421,2/1/2023 6:15:14 AM,Host Communities,339,222,211,398,1170,228,132,228,160,748
64,Yemen,2021,YEM-21/3420/SA1/SHNFI/NGO/19421,2/1/2023 6:15:14 AM,Internally Displaced People,3305,2167,2056,3881,11409,1624,992,1791,1502,5909
64,Yemen,2021,YEM-21/3420/SA1/SHNFI/NGO/19421,2/1/2023 6:15:14 AM,Overall,3644,2389,2267,4279,12579,1852,1124,2019,1662,6657
64,Yemen,2021,YEM-21/3420/SA1/SHNFI/NGO/19505,8/29/2022 7:37:29 AM,Host Communities,260,270,230,240,1000,230,300,256,266,1052
64,Yemen,2021,YEM-21/3420/SA1/SHNFI/NGO/19505,8/29/2022 7:37:29 AM,Internally Displaced People,1138,1178,1068,1108,4492,955,1155,1204,1257,4571
64,Yemen,2021,YEM-21/3420/SA1/SHNFI/NGO/19505,8/29/2022 7:37:29 AM,Overall,1398,1448,1298,1348,5492,1185,1455,1460,1523,5623
64,Yemen,2021,YEM-21/3420/SA1/SHNFI/NGO/19533,8/24/2022 10:27:32 AM,Host Communities,162,156,138,144,600,21,24,23,32,100
64,Yemen,2021,YEM-21/3420/SA1/SHNFI/NGO/19533,8/24/2022 10:27:32 AM,Internally Displaced People,576,624,552,648,2400,747,774,1007,971,3499
64,Yemen,2021,YEM-21/3420/SA1/SHNFI/NGO/19533,8/24/2022 10:27:32 AM,Overall,738,780,690,792,3000,768,798,1030,1003,3599
64,Yemen,2021,YEM-21/3420/SA1/SHNFI/NGO/19539,11/4/2022 5:14:46 PM,Host Communities,130,136,196,203,665,69,91,134,113,407
64,Yemen,2021,YEM-21/3420/SA1/SHNFI/NGO/19539,11/4/2022 5:14:46 PM,Internally Displaced People,1172,1220,1758,1830,5980,1320,1463,1994,1911,6688
64,Yemen,2021,YEM-21/3420/SA1/SHNFI/NGO/19539,11/4/2022 5:14:46 PM,Overall,1302,1356,1954,2033,6645,1389,1554,2128,2024,7095
64,Yemen,2021,YEM-21/3420/SA1/SHNFI/NGO/19546,11/5/2022 9:42:13 PM,Host Communities,25,29,62,73,189,0,0,0,0,0
64,Yemen,2021,YEM-21/3420/SA1/SHNFI/NGO/19546,11/5/2022 9:42:13 PM,Internally Displaced People,518,586,1049,1115,3268,756,655,1065,1008,3484
64,Yemen,2021,YEM-21/3420/SA1/SHNFI/NGO/19546,11/5/2022 9:42:13 PM,Overall,543,615,1111,1188,3457,756,655,1065,1008,3484
64,Yemen,2021,YEM-21/3420/SA1/SHNFI/NGO/19549,5/16/2022 6:20:59 AM,Host Communities,154,126,217,203,700,207,255,235,260,957
64,Yemen,2021,YEM-21/3420/SA1/SHNFI/NGO/19549,5/16/2022 6:20:59 AM,Internally Displaced People,1718,1260,1561,1411,5950,1331,1344,1744,1795,6214
64,Yemen,2021,YEM-21/3420/SA1/SHNFI/NGO/19549,5/16/2022 6:20:59 AM,Overall,1872,1386,1778,1614,6650,1538,1599,1979,2055,7171
64,Yemen,2021,YEM-21/3420/SA1/SHNFI/NGO/19552,9/4/2022 4:04:19 PM,Internally Displaced People,1646,1714,2470,2570,8400,541,565,553,513,2172
64,Yemen,2021,YEM-21/3420/SA1/SHNFI/NGO/19552,9/4/2022 4:04:19 PM,Overall,823,857,1235,1285,4200,541,565,553,513,2172
64,Yemen,2021,YEM-21/3420/SA1/SHNFI/O/19234,2/1/2023 7:54:05 AM,Host Communities,1351,1301,1201,1152,5005,1142,1298,1768,1647,5855
64,Yemen,2021,YEM-21/3420/SA1/SHNFI/O/19234,2/1/2023 7:54:05 AM,Internally Displaced People,5407,5207,4807,4606,20027,4125,4663,7010,6650,22448
64,Yemen,2021,YEM-21/3420/SA1/SHNFI/O/19234,2/1/2023 7:54:05 AM,Overall,6758,6508,6008,5758,25032,5267,5961,8778,8297,28303
64,Yemen,2021,YEM-21/3420/SA1/WASH/INGO/19214,5/20/2023 5:53:04 AM,Host Communities,12636,13211,16019,15630,57496,17747,18906,15541,17445,69639
64,Yemen,2021,YEM-21/3420/SA1/WASH/INGO/19214,5/20/2023 5:53:04 AM,Internally Displaced People,1415,1354,1723,1662,6154,1972,2101,1727,1938,7738
64,Yemen,2021,YEM-21/3420/SA1/WASH/INGO/19214,5/20/2023 5:53:04 AM,Overall,14051,14565,17742,17292,63650,19719,21007,17268,19383,77377
64,Yemen,2021,YEM-21/3420/SA1/WASH/INGO/19218,4/18/2023 7:40:29 AM,Host Communities,438,439,778,692,2347,540,542,960,854,2896
64,Yemen,2021,YEM-21/3420/SA1/WASH/INGO/19218,4/18/2023 7:40:29 AM,Internally Displaced People,529,530,939,835,2833,652,654,1159,1030,3495
64,Yemen,2021,YEM-21/3420/SA1/WASH/INGO/19218,4/18/2023 7:40:29 AM,Overall,967,969,1717,1527,5180,1192,1196,2119,1884,6391
64,Yemen,2021,YEM-21/3420/SA1/WASH/INGO/19519,11/20/2022 7:58:10 AM,Host Communities,3928,3883,3947,3607,15365,2627,2594,2638,2410,10269
64,Yemen,2021,YEM-21/3420/SA1/WASH/INGO/19519,11/20/2022 7:58:10 AM,Internally Displaced People,508,502,511,467,1988,1949,1925,1958,1791,7623
64,Yemen,2021,YEM-21/3420/SA1/WASH/INGO/19519,11/20/2022 7:58:10 AM,Overall,4436,4385,4458,4074,17353,4576,4519,4596,4201,17892
64,Yemen,2021,YEM-21/3420/SA1/WASH/NGO/19232,11/17/2022 9:54:51 AM,Host Communities,12530,8213,7793,14713,43249,38966,34951,38427,53623,165967
64,Yemen,2021,YEM-21/3420/SA1/WASH/NGO/19232,11/17/2022 9:54:51 AM,Internally Displaced People,37590,24640,23380,44140,129750,25375,26990,34204,35429,121998
64,Yemen,2021,YEM-21/3420/SA1/WASH/NGO/19232,11/17/2022 9:54:51 AM,Overall,50120,32853,31173,58853,172999,64341,61941,72631,89052,287965
64,Yemen,2021,YEM-21/3420/SA1/WASH/NGO/19277,10/21/2022 7:42:35 PM,Host Communities,1548,1658,1540,1536,6282,523,573,901,835,2832
64,Yemen,2021,YEM-21/3420/SA1/WASH/NGO/19277,10/21/2022 7:42:35 PM,Internally Displaced People,106,114,106,106,432,546,566,1018,950,3080
64,Yemen,2021,YEM-21/3420/SA1/WASH/NGO/19277,10/21/2022 7:42:35 PM,Overall,1654,1772,1646,1642,6714,1069,1139,1919,1785,5912
64,Yemen,2021,YEM-21/3420/SA1/WASH/NGO/19419,9/11/2022 9:57:06 AM,Host Communities,1203,1407,2000,2300,6910,1277,1406,2031,2314,7028
64,Yemen,2021,YEM-21/3420/SA1/WASH/NGO/19419,9/11/2022 9:57:06 AM,Internally Displaced People,900,1300,1750,1882,5832,1314,1467,2256,1949,6986
64,Yemen,2021,YEM-21/3420/SA1/WASH/NGO/19419,9/11/2022 9:57:06 AM,Overall,2103,2707,3750,4182,12742,2591,2873,4287,4263,14014
64,Yemen,2021,YEM-21/3420/SA1/WASH/NGO/19536,8/17/2023 4:50:12 AM,Host Communities,14980,16229,14356,16853,62418,17626,19069,16976,19926,73597
64,Yemen,2021,YEM-21/3420/SA1/WASH/NGO/19536,8/17/2023 4:50:12 AM,Internally Displaced People,5608,6076,5375,6309,23368,4778,5202,4495,5279,19754
64,Yemen,2021,YEM-21/3420/SA1/WASH/NGO/19536,8/17/2023 4:50:12 AM,Overall,20588,22305,19731,23162,85786,22404,24271,21471,25205,93351
64,Yemen,2021,YEM-21/3420/SA1/WASH-Health-Nutrition-SHNFI/NGO/19514,3/9/2023 9:27:51 AM,Host Communities,5491,5422,5138,5169,21220,11128,11582,2377,2473,27560
64,Yemen,2021,YEM-21/3420/SA1/WASH-Health-Nutrition-SHNFI/NGO/19514,3/9/2023 9:27:51 AM,Internally Displaced People,1065,1117,1552,1598,5332,1264,1315,270,281,3130
64,Yemen,2021,YEM-21/3420/SA1/WASH-Health-Nutrition-SHNFI/NGO/19514,3/9/2023 9:27:51 AM,Overall,6556,6539,6690,6767,26552,12392,12897,2647,2754,30690
64,Yemen,2022,YEM-22/3420/RA1/WASH/UN/22494,3/5/2023 6:47:18 AM,Host Communities,754642,744496,919970,887718,3306826,754644,744497,920507,887717,3307365
64,Yemen,2022,YEM-22/3420/RA1/WASH/UN/22494,3/5/2023 6:47:18 AM,Internally Displaced People,84675,82468,105299,95240,367682,84675,82468,105299,95240,367682
64,Yemen,2022,YEM-22/3420/RA1/WASH/UN/22494,3/5/2023 6:47:18 AM,Overall,839317,826964,1025269,982958,3674508,839319,826965,1025806,982957,3675047
64,Yemen,2022,YEM-22/3420/RA2/WASH/UN/23507,3/22/2023 1:21:31 PM,Host Communities,754644,744497,920507,887717,3307365,754644,744497,920507,887717,3307365
64,Yemen,2022,YEM-22/3420/RA2/WASH/UN/23507,3/22/2023 1:21:31 PM,Internally Displaced People,84675,82468,105299,95240,367682,84675,82468,105299,95240,367682
64,Yemen,2022,YEM-22/3420/RA2/WASH/UN/23507,3/22/2023 1:21:31 PM,Overall,839319,826965,1025806,982957,3675047,839319,826965,1025806,982957,3675047
64,Yemen,2022,YEM-22/3420/SA1/CCM/NGO/22791,8/21/2023 4:22:50 AM,Host Communities,235,246,325,314,1120,244,255,320,350,1169
64,Yemen,2022,YEM-22/3420/SA1/CCM/NGO/22791,8/21/2023 4:22:50 AM,Internally Displaced People,1568,1643,2166,2091,7468,1637,1781,1895,1590,6903
64,Yemen,2022,YEM-22/3420/SA1/CCM/NGO/22791,8/21/2023 4:22:50 AM,Overall,1803,1889,2491,2405,8588,1881,2036,2215,1940,8072
64,Yemen,2022,YEM-22/3420/SA1/Education/NGO/22675,9/13/2023 8:06:37 AM,Host Communities,55,40,681,1135,1911,53,42,591,1405,2091
64,Yemen,2022,YEM-22/3420/SA1/Education/NGO/22675,9/13/2023 8:06:37 AM,Internally Displaced People,0,0,7,34,41,0,0,32,28,60
64,Yemen,2022,YEM-22/3420/SA1/Education/NGO/22675,9/13/2023 8:06:37 AM,Overall,55,40,688,1169,1952,53,42,623,1433,2151
64,Yemen,2022,YEM-22/3420/SA1/Education/NGO/22706,8/24/2023 8:46:59 AM,Host Communities,0,0,310,322,632,0,0,356,308,664
64,Yemen,2022,YEM-22/3420/SA1/Education/NGO/22706,8/24/2023 8:46:59 AM,Internally Displaced People,0,0,54,51,105,0,0,3,17,20
64,Yemen,2022,YEM-22/3420/SA1/Education/NGO/22706,8/24/2023 8:46:59 AM,Overall,0,0,364,373,737,0,0,359,325,684
64,Yemen,2022,YEM-22/3420/SA1/Education/NGO/22847,10/17/2023 1:16:21 PM,Host Communities,30,170,1237,1328,2765,44,356,1240,1338,2978
64,Yemen,2022,YEM-22/3420/SA1/Education/NGO/22847,10/17/2023 1:16:21 PM,Internally Displaced People,0,0,553,282,835,0,0,553,282,835
64,Yemen,2022,YEM-22/3420/SA1/Education/NGO/22847,10/17/2023 1:16:21 PM,Overall,30,170,3005,2825,6030,44,356,3008,2835,6243
64,Yemen,2022,YEM-22/3420/SA1/Education/NGO/22847,10/17/2023 1:16:21 PM,Returnees,0,0,1215,1215,2430,0,0,1215,1215,2430
64,Yemen,2022,YEM-22/3420/SA1/Education/NGO/22941,10/10/2023 2:31:38 PM,Internally Displaced People,68,64,2122,2048,4302,47,43,2122,2048,4260
64,Yemen,2022,YEM-22/3420/SA1/Education/NGO/22941,10/10/2023 2:31:38 PM,Other,0,0,149,142,291,21,21,114,114,270
64,Yemen,2022,YEM-22/3420/SA1/Education/NGO/22941,10/10/2023 2:31:38 PM,Overall,68,64,2271,2190,4593,68,64,2236,2162,4530
64,Yemen,2022,YEM-22/3420/SA1/Education/NGO/23080,7/11/2023 6:56:09 PM,Host Communities,0,0,239,218,457,0,0,0,0,0
64,Yemen,2022,YEM-22/3420/SA1/Education/NGO/23080,7/11/2023 6:56:09 PM,Internally Displaced People,0,0,1194,1089,2283,0,0,1732,1008,2740
64,Yemen,2022,YEM-22/3420/SA1/Education/NGO/23080,7/11/2023 6:56:09 PM,Overall,0,0,1433,1307,2740,0,0,1732,1008,2740
64,Yemen,2022,YEM-22/3420/SA1/ETC/UN/22993,7/25/2023 8:45:31 AM,Other,0,47,0,0,47,0,49,0,0,49
64,Yemen,2022,YEM-22/3420/SA1/ETC/UN/22993,7/25/2023 8:45:31 AM,Overall,0,47,0,0,47,0,49,0,0,49
64,Yemen,2022,YEM-22/3420/SA1/MSREFMIG/UN/22968,9/21/2023 7:21:45 AM,Overall,1258,1870,813,833,4774,886,1547,755,630,3818
64,Yemen,2022,YEM-22/3420/SA1/MSREFMIG/UN/22968,9/21/2023 7:21:45 AM,Refugees,1258,1870,813,833,4774,886,1547,755,630,3818
64,Yemen,2022,YEM-22/3420/SA1/Protection/UN/22778,9/17/2023 10:36:16 AM,Host Communities,14091,13476,17155,16539,61261,13910,13700,17050,16700,61360
64,Yemen,2022,YEM-22/3420/SA1/Protection/UN/22778,9/17/2023 10:36:16 AM,Internally Displaced People,2980,2852,3629,3500,12961,2970,2840,3730,3600,13140
64,Yemen,2022,YEM-22/3420/SA1/Protection/UN/22778,9/17/2023 10:36:16 AM,Overall,17071,16328,20784,20039,74222,16880,16540,20780,20300,74500
64,Yemen,2022,YEM-22/3420/SA1/RRM/UN/22661,9/25/2023 9:01:33 AM,Internally Displaced People,17500,17500,17500,17500,70000,17500,17500,17500,17500,70000
64,Yemen,2022,YEM-22/3420/SA1/RRM/UN/22661,9/25/2023 9:01:33 AM,Overall,17500,17500,17500,17500,70000,17500,17500,17500,17500,70000
64,Yemen,2022,YEM-22/3420/SA1/RRM/UN/22726,7/5/2023 11:51:17 AM,Internally Displaced People,30000,40000,10000,18000,98000,31210,41005,10544,17570,100329
64,Yemen,2022,YEM-22/3420/SA1/RRM/UN/22726,7/5/2023 11:51:17 AM,Overall,30000,40000,10000,18000,98000,31210,41005,10544,17570,100329
64,Yemen,2022,YEM-22/3420/SA1/RRM/UN/22976,5/17/2023 5:48:56 AM,Internally Displaced People,23520,25480,23520,25480,98000,34310,37168,34310,37168,142956
64,Yemen,2022,YEM-22/3420/SA1/RRM/UN/22976,5/17/2023 5:48:56 AM,Overall,23520,25480,23520,25480,98000,34310,37168,34310,37168,142956
64,Yemen,2022,YEM-22/3420/SA1/WASH/NGO/22794,10/10/2023 1:57:18 PM,Host Communities,16161,14334,14021,13020,57536,5553,6565,10761,11553,34432
64,Yemen,2022,YEM-22/3420/SA1/WASH/NGO/22794,10/10/2023 1:57:18 PM,Internally Displaced People,531,633,996,1115,3275,548,654,1031,1180,3413
64,Yemen,2022,YEM-22/3420/SA1/WASH/NGO/22794,10/10/2023 1:57:18 PM,Overall,16692,14967,15017,14135,60811,6101,7219,11792,12733,37845
64,Yemen,2022,YEM-22/3420/SA1/WASH/NGO/22830,10/10/2023 1:32:40 PM,Host Communities,1539,1748,1741,1810,6838,1336,1444,1789,2078,6647
64,Yemen,2022,YEM-22/3420/SA1/WASH/NGO/22830,10/10/2023 1:32:40 PM,Internally Displaced People,861,899,974,1011,3745,1019,1103,1276,1450,4848
64,Yemen,2022,YEM-22/3420/SA1/WASH/NGO/22830,10/10/2023 1:32:40 PM,Overall,2400,2647,2715,2821,10583,2355,2547,3065,3528,11495
64,Yemen,2022,YEM-22/3420/SA1/WASH/NGO/22854,10/10/2023 3:50:16 AM,Host Communities,1395,1203,1155,1059,4812,1395,1203,1155,1059,4812
64,Yemen,2022,YEM-22/3420/SA1/WASH/NGO/22854,10/10/2023 3:50:16 AM,Internally Displaced People,930,802,770,706,3208,930,802,770,706,3208
64,Yemen,2022,YEM-22/3420/SA1/WASH/NGO/22854,10/10/2023 3:50:16 AM,Overall,2325,2005,1925,1765,8020,2325,2005,1925,1765,8020
